Sample;coverage;median_coverage;ALTF;RDR;RDA;Complexity;MAF
Control.SRR15539874;30;32;0.366666666666667;19;11;0.133333333333333;0.366666666666667
Control.SRR15539874;30;32;0.466666666666667;16;14;0.0333333333333333;0.466666666666667
Control.SRR15539874;33;32;0.545454545454545;15;18;0.0454545454545454;0.454545454545455
Control.SRR15539874;35;32;0.542857142857143;16;19;0.0428571428571428;0.457142857142857
Control.SRR15539874;33;32;0.393939393939394;20;13;0.106060606060606;0.393939393939394
Control.SRR15539874;35;32;0.485714285714286;18;17;0.0142857142857143;0.485714285714286
Control.SRR15539874;36;32;0.666666666666667;12;24;0.166666666666667;0.333333333333333
Control.SRR15539874;31;32;0.516129032258065;15;16;0.0161290322580645;0.483870967741935
Control.SRR15539874;29;32;0.517241379310345;14;15;0.0172413793103449;0.482758620689655
Control.SRR15539874;30;32;0.633333333333333;11;19;0.133333333333333;0.366666666666667
Control.SRR15539874;30;32;0.5;15;15;0;0.5
Control.SRR15539874;37;32;0.540540540540541;17;20;0.0405405405405406;0.459459459459459
Control.SRR15539874;29;32;0.517241379310345;14;15;0.0172413793103449;0.482758620689655
Control.SRR15539874;29;32;0.448275862068966;16;13;0.0517241379310345;0.448275862068966
Control.SRR15539874;29;32;0.344827586206897;19;10;0.155172413793103;0.344827586206897
Control.SRR15539874;36;32;0.555555555555556;16;20;0.0555555555555556;0.444444444444444
Control.SRR15539874;39;32;0.461538461538462;21;18;0.0384615384615384;0.461538461538462
Control.SRR15539874;39;32;0.615384615384615;15;24;0.115384615384615;0.384615384615385
Control.SRR15539874;33;32;0.484848484848485;17;16;0.0151515151515151;0.484848484848485
Control.SRR15539874;33;32;0.424242424242424;19;14;0.0757575757575757;0.424242424242424
Control.SRR15539874;33;32;0.454545454545455;18;15;0.0454545454545455;0.454545454545455
Control.SRR15539874;29;32;0.517241379310345;14;15;0.0172413793103449;0.482758620689655
Control.SRR15539874;32;32;0.375;20;12;0.125;0.375
Control.SRR15539874;30;32;0.366666666666667;19;11;0.133333333333333;0.366666666666667
Control.SRR15539874;34;32;0.5;17;17;0;0.5
Control.SRR15539874;31;32;0.354838709677419;20;11;0.145161290322581;0.354838709677419
Control.SRR15539874;34;32;0.441176470588235;19;15;0.0588235294117647;0.441176470588235
Control.SRR15539874;33;32;0.545454545454545;15;18;0.0454545454545454;0.454545454545455
Control.SRR15539874;36;32;0.527777777777778;17;19;0.0277777777777778;0.472222222222222
Control.SRR15539874;31;32;0.483870967741935;16;15;0.0161290322580645;0.483870967741935
Control.SRR15539874;37;32;0.540540540540541;17;20;0.0405405405405406;0.459459459459459
Control.SRR15539874;38;32;0.394736842105263;23;15;0.105263157894737;0.394736842105263
Control.SRR15539874;36;32;0.388888888888889;22;14;0.111111111111111;0.388888888888889
Control.SRR15539874;29;32;0.620689655172414;11;18;0.120689655172414;0.379310344827586
Control.SRR15539874;34;32;0.382352941176471;21;13;0.117647058823529;0.382352941176471
Control.SRR15539874;35;32;0.485714285714286;18;17;0.0142857142857143;0.485714285714286
Control.SRR15539874;33;32;0.545454545454545;15;18;0.0454545454545454;0.454545454545455
Control.SRR15539874;34;32;0.529411764705882;16;18;0.0294117647058824;0.470588235294118
Control.SRR15539874;34;32;0.470588235294118;18;16;0.0294117647058824;0.470588235294118
Control.SRR15539874;33;32;0.575757575757576;14;19;0.0757575757575758;0.424242424242424
Control.SRR15539874;31;32;0.354838709677419;20;11;0.145161290322581;0.354838709677419
Control.SRR15539874;39;32;0.692307692307692;12;27;0.192307692307692;0.307692307692308
Control.SRR15539874;32;32;0.5625;14;18;0.0625;0.4375
Control.SRR15539874;30;32;0.5;15;15;0;0.5
Control.SRR15539874;36;32;0.472222222222222;19;17;0.0277777777777778;0.472222222222222
Control.SRR15539874;29;32;0.448275862068966;16;13;0.0517241379310345;0.448275862068966
Control.SRR15539874;32;32;0.40625;19;13;0.09375;0.40625
Control.SRR15539874;34;32;0.441176470588235;19;15;0.0588235294117647;0.441176470588235
Control.SRR15539874;32;32;0.625;12;20;0.125;0.375
Control.SRR15539874;38;32;0.394736842105263;23;15;0.105263157894737;0.394736842105263
Control.SRR15539874;31;32;0.548387096774194;14;17;0.0483870967741935;0.451612903225806
Control.SRR15539874;34;32;0.647058823529412;12;22;0.147058823529412;0.352941176470588
Control.SRR15539874;34;32;0.411764705882353;20;14;0.0882352941176471;0.411764705882353
Control.SRR15539874;35;32;0.457142857142857;19;16;0.0428571428571429;0.457142857142857
Control.SRR15539874;35;32;0.257142857142857;26;9;0.242857142857143;0.257142857142857
Control.SRR15539874;33;32;0.575757575757576;14;19;0.0757575757575758;0.424242424242424
Control.SRR15539874;38;32;0.447368421052632;21;17;0.0526315789473684;0.447368421052632
Control.SRR15539874;35;32;0.428571428571429;20;15;0.0714285714285715;0.428571428571429
Control.SRR15539874;30;32;0.566666666666667;13;17;0.0666666666666667;0.433333333333333
Control.SRR15539874;32;32;0.375;20;12;0.125;0.375
Control.SRR15539874;37;32;0.459459459459459;20;17;0.0405405405405405;0.459459459459459
Control.SRR15539874;37;32;0.351351351351351;24;13;0.148648648648649;0.351351351351351
Control.SRR15539874;34;32;0.529411764705882;16;18;0.0294117647058824;0.470588235294118
Control.SRR15539874;35;32;0.457142857142857;19;16;0.0428571428571429;0.457142857142857
Control.SRR15539874;29;32;0.482758620689655;15;14;0.0172413793103448;0.482758620689655
Control.SRR15539874;36;32;0.472222222222222;19;17;0.0277777777777778;0.472222222222222
Control.SRR15539874;32;32;0.375;20;12;0.125;0.375
Control.SRR15539874;34;32;0.441176470588235;19;15;0.0588235294117647;0.441176470588235
Control.SRR15539874;36;32;0.416666666666667;21;15;0.0833333333333333;0.416666666666667
Control.SRR15539874;34;32;0.529411764705882;16;18;0.0294117647058824;0.470588235294118
Control.SRR15539874;38;32;0.684210526315789;12;26;0.184210526315789;0.315789473684211
Control.SRR15539874;33;32;0.575757575757576;14;19;0.0757575757575758;0.424242424242424
Control.SRR15539874;33;32;0.606060606060606;13;20;0.106060606060606;0.393939393939394
Control.SRR15539874;33;32;0.575757575757576;14;19;0.0757575757575758;0.424242424242424
Control.SRR15539874;39;32;0.435897435897436;22;17;0.0641025641025641;0.435897435897436
Control.SRR15539874;31;32;0.612903225806452;12;19;0.112903225806452;0.387096774193548
Control.SRR15539874;33;32;0.454545454545455;18;15;0.0454545454545455;0.454545454545455
Control.SRR15539874;37;32;0.486486486486487;19;18;0.0135135135135135;0.486486486486487
Control.SRR15539874;36;32;0.472222222222222;19;17;0.0277777777777778;0.472222222222222
Control.SRR15539874;30;32;0.4;18;12;0.1;0.4
Control.SRR15539874;30;32;0.5;15;15;0;0.5
Control.SRR15539874;29;32;0.517241379310345;14;15;0.0172413793103449;0.482758620689655
Control.SRR15539874;30;32;0.666666666666667;10;20;0.166666666666667;0.333333333333333
Control.SRR15539874;29;32;0.517241379310345;14;15;0.0172413793103449;0.482758620689655
Control.SRR15539874;35;32;0.628571428571429;13;22;0.128571428571429;0.371428571428571
Control.SRR15539874;38;32;0.368421052631579;24;14;0.131578947368421;0.368421052631579
Control.SRR15539874;30;32;0.733333333333333;8;22;0.233333333333333;0.266666666666667
Control.SRR15539874;29;32;0.413793103448276;17;12;0.0862068965517241;0.413793103448276
Control.SRR15539874;33;32;0.575757575757576;14;19;0.0757575757575758;0.424242424242424
Control.SRR15539874;37;32;0.540540540540541;17;20;0.0405405405405406;0.459459459459459
Control.SRR15539874;36;32;0.5;18;18;0;0.5
Control.SRR15539874;33;32;0.515151515151515;16;17;0.0151515151515151;0.484848484848485
Control.SRR15539874;33;32;0.636363636363636;12;21;0.136363636363636;0.363636363636364
Control.SRR15539874;32;32;0.40625;19;13;0.09375;0.40625
Control.SRR15539874;32;32;0.53125;15;17;0.03125;0.46875
Control.SRR15539874;33;32;0.454545454545455;18;15;0.0454545454545455;0.454545454545455
Control.SRR15539874;35;32;0.371428571428571;22;13;0.128571428571429;0.371428571428571
Control.SRR15539874;35;32;0.628571428571429;13;22;0.128571428571429;0.371428571428571
Control.SRR15539874;39;32;0.538461538461538;18;21;0.0384615384615384;0.461538461538462
Control.SRR15539874;38;32;0.473684210526316;20;18;0.0263157894736842;0.473684210526316
Control.SRR15539874;39;32;0.41025641025641;23;16;0.0897435897435898;0.41025641025641
Control.SRR15539874;31;32;0.419354838709677;18;13;0.0806451612903226;0.419354838709677
Control.SRR15539874;33;32;0.424242424242424;19;14;0.0757575757575757;0.424242424242424
Control.SRR15539874;34;32;0.529411764705882;16;18;0.0294117647058824;0.470588235294118
Control.SRR15539874;35;32;0.485714285714286;18;17;0.0142857142857143;0.485714285714286
Control.SRR15539874;38;32;0.421052631578947;22;16;0.0789473684210527;0.421052631578947
Control.SRR15539874;37;32;0.351351351351351;24;13;0.148648648648649;0.351351351351351
Control.SRR15539874;36;32;0.555555555555556;16;20;0.0555555555555556;0.444444444444444
Control.SRR15539874;33;32;0.696969696969697;10;23;0.196969696969697;0.303030303030303
Control.SRR15539874;38;32;0.368421052631579;24;14;0.131578947368421;0.368421052631579
Control.SRR15539874;34;32;0.676470588235294;11;23;0.176470588235294;0.323529411764706
Control.SRR15539874;35;32;0.571428571428571;15;20;0.0714285714285714;0.428571428571429
Control.SRR15539874;32;32;0.75;8;24;0.25;0.25
Control.SRR15539874;37;32;0.486486486486487;19;18;0.0135135135135135;0.486486486486487
Control.SRR15539874;32;32;0.46875;17;15;0.03125;0.46875
Control.SRR15539874;36;32;0.444444444444444;20;16;0.0555555555555556;0.444444444444444
Control.SRR15539874;29;32;0.379310344827586;18;11;0.120689655172414;0.379310344827586
Control.SRR15539874;34;32;0.5;17;17;0;0.5
Control.SRR15539874;39;32;0.487179487179487;20;19;0.0128205128205128;0.487179487179487
Control.SRR15539874;38;32;0.421052631578947;22;16;0.0789473684210527;0.421052631578947
Control.SRR15539874;34;32;0.588235294117647;14;20;0.0882352941176471;0.411764705882353
Control.SRR15539874;31;32;0.451612903225806;17;14;0.0483870967741936;0.451612903225806
Control.SRR15539874;34;32;0.617647058823529;13;21;0.117647058823529;0.382352941176471
Control.SRR15539874;33;32;0.606060606060606;13;20;0.106060606060606;0.393939393939394
Control.SRR15539874;33;32;0.636363636363636;12;21;0.136363636363636;0.363636363636364
Control.SRR15539874;38;32;0.447368421052632;21;17;0.0526315789473684;0.447368421052632
Control.SRR15539874;30;32;0.4;18;12;0.1;0.4
Control.SRR15539874;36;32;0.638888888888889;13;23;0.138888888888889;0.361111111111111
Control.SRR15539874;35;32;0.6;14;21;0.1;0.4
Control.SRR15539874;38;32;0.421052631578947;22;16;0.0789473684210527;0.421052631578947
Control.SRR15539874;35;32;0.485714285714286;18;17;0.0142857142857143;0.485714285714286
Control.SRR15539874;35;32;0.571428571428571;15;20;0.0714285714285714;0.428571428571429
Control.SRR15539874;39;32;0.384615384615385;24;15;0.115384615384615;0.384615384615385
Control.SRR15539874;36;32;0.555555555555556;16;20;0.0555555555555556;0.444444444444444
Control.SRR15539874;35;32;0.571428571428571;15;20;0.0714285714285714;0.428571428571429
Control.SRR15539874;30;32;0.4;18;12;0.1;0.4
Control.SRR15539874;30;32;0.566666666666667;13;17;0.0666666666666667;0.433333333333333
Control.SRR15539874;31;32;0.516129032258065;15;16;0.0161290322580645;0.483870967741935
Control.SRR15539874;31;32;0.387096774193548;19;12;0.112903225806452;0.387096774193548
Control.SRR15539874;34;32;0.558823529411765;15;19;0.0588235294117647;0.441176470588235
Control.SRR15539874;36;32;0.361111111111111;23;13;0.138888888888889;0.361111111111111
Control.SRR15539874;37;32;0.378378378378378;23;14;0.121621621621622;0.378378378378378
Control.SRR15539874;32;32;0.40625;19;13;0.09375;0.40625
Control.SRR15539874;30;32;0.4;18;12;0.1;0.4
Control.SRR15539874;32;32;0.4375;18;14;0.0625;0.4375
Control.SRR15539874;29;32;0.482758620689655;15;14;0.0172413793103448;0.482758620689655
Control.SRR15539874;31;32;0.387096774193548;19;12;0.112903225806452;0.387096774193548
Control.SRR15539874;36;32;0.444444444444444;20;16;0.0555555555555556;0.444444444444444
Control.SRR15539874;36;32;0.444444444444444;20;16;0.0555555555555556;0.444444444444444
Control.SRR15539874;36;32;0.638888888888889;13;23;0.138888888888889;0.361111111111111
Control.SRR15539874;38;32;0.368421052631579;24;14;0.131578947368421;0.368421052631579
Control.SRR15539874;36;32;0.444444444444444;20;16;0.0555555555555556;0.444444444444444
Control.SRR15539874;30;32;0.566666666666667;13;17;0.0666666666666667;0.433333333333333
Control.SRR15539874;34;32;0.5;17;17;0;0.5
Control.SRR15539874;31;32;0.516129032258065;15;16;0.0161290322580645;0.483870967741935
Control.SRR15539874;33;32;0.484848484848485;17;16;0.0151515151515151;0.484848484848485
Control.SRR15539874;32;32;0.40625;19;13;0.09375;0.40625
Control.SRR15539874;31;32;0.419354838709677;18;13;0.0806451612903226;0.419354838709677
Control.SRR15539874;37;32;0.486486486486487;19;18;0.0135135135135135;0.486486486486487
Control.SRR15539874;37;32;0.432432432432432;21;16;0.0675675675675675;0.432432432432432
Control.SRR15539874;32;32;0.34375;21;11;0.15625;0.34375
Control.SRR15539874;33;32;0.393939393939394;20;13;0.106060606060606;0.393939393939394
Control.SRR15539874;30;32;0.566666666666667;13;17;0.0666666666666667;0.433333333333333
Control.SRR15539874;29;32;0.482758620689655;15;14;0.0172413793103448;0.482758620689655
Control.SRR15539874;37;32;0.432432432432432;21;16;0.0675675675675675;0.432432432432432
Control.SRR15539874;32;32;0.4375;18;14;0.0625;0.4375
Control.SRR15539874;32;32;0.59375;13;19;0.09375;0.40625
Control.SRR15539874;38;32;0.447368421052632;21;17;0.0526315789473684;0.447368421052632
Control.SRR15539874;34;32;0.470588235294118;18;16;0.0294117647058824;0.470588235294118
Control.SRR15539874;38;32;0.447368421052632;21;17;0.0526315789473684;0.447368421052632
Control.SRR15539874;29;32;0.517241379310345;14;15;0.0172413793103449;0.482758620689655
Control.SRR15539874;29;32;0.689655172413793;9;20;0.189655172413793;0.310344827586207
Control.SRR15539874;35;32;0.457142857142857;19;16;0.0428571428571429;0.457142857142857
Control.SRR15539874;38;32;0.605263157894737;15;23;0.105263157894737;0.394736842105263
Control.SRR15539874;39;32;0.41025641025641;23;16;0.0897435897435898;0.41025641025641
Control.SRR15539874;38;32;0.473684210526316;20;18;0.0263157894736842;0.473684210526316
Control.SRR15539874;32;32;0.5;16;16;0;0.5
Control.SRR15539874;32;32;0.34375;21;11;0.15625;0.34375
Control.SRR15539874;30;32;0.566666666666667;13;17;0.0666666666666667;0.433333333333333
Control.SRR15539874;34;32;0.470588235294118;18;16;0.0294117647058824;0.470588235294118
Control.SRR15539874;34;32;0.529411764705882;16;18;0.0294117647058824;0.470588235294118
Control.SRR15539874;39;32;0.435897435897436;22;17;0.0641025641025641;0.435897435897436
Control.SRR15539874;38;32;0.578947368421053;16;22;0.0789473684210527;0.421052631578947
Control.SRR15539874;37;32;0.486486486486487;19;18;0.0135135135135135;0.486486486486487
Control.SRR15539874;39;32;0.487179487179487;20;19;0.0128205128205128;0.487179487179487
Control.SRR15539874;39;32;0.58974358974359;16;23;0.0897435897435898;0.41025641025641
Control.SRR15539874;34;32;0.5;17;17;0;0.5
Control.SRR15539874;36;32;0.527777777777778;17;19;0.0277777777777778;0.472222222222222
Control.SRR15539874;37;32;0.594594594594595;15;22;0.0945945945945946;0.405405405405405
Control.SRR15539874;37;32;0.378378378378378;23;14;0.121621621621622;0.378378378378378
Control.SRR15539874;36;32;0.527777777777778;17;19;0.0277777777777778;0.472222222222222
Control.SRR15539874;31;32;0.612903225806452;12;19;0.112903225806452;0.387096774193548
Control.SRR15539874;32;32;0.53125;15;17;0.03125;0.46875
Control.SRR15539874;32;32;0.40625;19;13;0.09375;0.40625
Control.SRR15539874;29;32;0.586206896551724;12;17;0.0862068965517241;0.413793103448276
Control.SRR15539874;34;32;0.470588235294118;18;16;0.0294117647058824;0.470588235294118
Control.SRR15539874;33;32;0.575757575757576;14;19;0.0757575757575758;0.424242424242424
Control.SRR15539874;38;32;0.473684210526316;20;18;0.0263157894736842;0.473684210526316
Control.SRR15539874;37;32;0.513513513513513;18;19;0.0135135135135135;0.486486486486487
Control.SRR15539874;30;32;0.466666666666667;16;14;0.0333333333333333;0.466666666666667
Control.SRR15539874;36;32;0.388888888888889;22;14;0.111111111111111;0.388888888888889
Control.SRR15539874;36;32;0.527777777777778;17;19;0.0277777777777778;0.472222222222222
Control.SRR15539874;32;32;0.625;12;20;0.125;0.375
Control.SRR15539874;31;32;0.548387096774194;14;17;0.0483870967741935;0.451612903225806
Control.SRR15539874;31;32;0.483870967741935;16;15;0.0161290322580645;0.483870967741935
Control.SRR15539874;32;32;0.34375;21;11;0.15625;0.34375
Control.SRR15539874;37;32;0.513513513513513;18;19;0.0135135135135135;0.486486486486487
Control.SRR15539874;38;32;0.473684210526316;20;18;0.0263157894736842;0.473684210526316
Control.SRR15539874;29;32;0.586206896551724;12;17;0.0862068965517241;0.413793103448276
Control.SRR15539874;32;32;0.46875;17;15;0.03125;0.46875
Control.SRR15539874;30;32;0.266666666666667;22;8;0.233333333333333;0.266666666666667
Control.SRR15539874;29;32;0.655172413793103;10;19;0.155172413793103;0.344827586206897
Control.SRR15539874;30;32;0.633333333333333;11;19;0.133333333333333;0.366666666666667
Control.SRR15539874;37;32;0.756756756756757;9;28;0.256756756756757;0.243243243243243
Control.SRR15539874;33;32;0.666666666666667;11;22;0.166666666666667;0.333333333333333
Control.SRR15539874;35;32;0.428571428571429;20;15;0.0714285714285715;0.428571428571429
Control.SRR15539874;35;32;0.628571428571429;13;22;0.128571428571429;0.371428571428571
Control.SRR15539874;36;32;0.472222222222222;19;17;0.0277777777777778;0.472222222222222
Control.SRR15539874;29;32;0.379310344827586;18;11;0.120689655172414;0.379310344827586
Control.SRR15539874;38;32;0.578947368421053;16;22;0.0789473684210527;0.421052631578947
Control.SRR15539874;37;32;0.513513513513513;18;19;0.0135135135135135;0.486486486486487
Control.SRR15539874;33;32;0.575757575757576;14;19;0.0757575757575758;0.424242424242424
Control.SRR15539874;39;32;0.512820512820513;19;20;0.0128205128205128;0.487179487179487
Control.SRR15539874;32;32;0.46875;17;15;0.03125;0.46875
Control.SRR15539874;38;32;0.552631578947368;17;21;0.0526315789473685;0.447368421052632
Control.SRR15539874;30;32;0.466666666666667;16;14;0.0333333333333333;0.466666666666667
Control.SRR15539874;33;32;0.515151515151515;16;17;0.0151515151515151;0.484848484848485
Control.SRR15539874;35;32;0.6;14;21;0.1;0.4
Control.SRR15539874;29;32;0.482758620689655;15;14;0.0172413793103448;0.482758620689655
Control.SRR15539874;32;32;0.625;12;20;0.125;0.375
Control.SRR15539874;30;32;0.6;12;18;0.1;0.4
Control.SRR15539874;32;32;0.40625;19;13;0.09375;0.40625
Control.SRR15539874;37;32;0.540540540540541;17;20;0.0405405405405406;0.459459459459459
Control.SRR15539874;33;32;0.515151515151515;16;17;0.0151515151515151;0.484848484848485
Control.SRR15539874;36;32;0.527777777777778;17;19;0.0277777777777778;0.472222222222222
Control.SRR15539874;30;32;0.6;12;18;0.1;0.4
Control.SRR15539874;38;32;0.526315789473684;18;20;0.0263157894736842;0.473684210526316
Control.SRR15539874;34;32;0.441176470588235;19;15;0.0588235294117647;0.441176470588235
Control.SRR15539874;34;32;0.441176470588235;19;15;0.0588235294117647;0.441176470588235
Control.SRR15539874;38;32;0.552631578947368;17;21;0.0526315789473685;0.447368421052632
Control.SRR15539874;34;32;0.411764705882353;20;14;0.0882352941176471;0.411764705882353
Control.SRR15539874;33;32;0.484848484848485;17;16;0.0151515151515151;0.484848484848485
Control.SRR15539874;37;32;0.594594594594595;15;22;0.0945945945945946;0.405405405405405
Control.SRR15539874;30;32;0.566666666666667;13;17;0.0666666666666667;0.433333333333333
Control.SRR15539874;35;32;0.742857142857143;9;26;0.242857142857143;0.257142857142857
Control.SRR15539874;32;32;0.46875;17;15;0.03125;0.46875
Control.SRR15539874;29;32;0.551724137931034;13;16;0.0517241379310345;0.448275862068966
Control.SRR15539874;30;32;0.466666666666667;16;14;0.0333333333333333;0.466666666666667
Control.SRR15539874;39;32;0.564102564102564;17;22;0.0641025641025641;0.435897435897436
Control.SRR15539874;34;32;0.529411764705882;16;18;0.0294117647058824;0.470588235294118
Control.SRR15539874;39;32;0.58974358974359;16;23;0.0897435897435898;0.41025641025641
Control.SRR15539874;38;32;0.473684210526316;20;18;0.0263157894736842;0.473684210526316
Control.SRR15539874;37;32;0.486486486486487;19;18;0.0135135135135135;0.486486486486487
Control.SRR15539874;38;32;0.526315789473684;18;20;0.0263157894736842;0.473684210526316
Control.SRR15539874;39;32;0.41025641025641;23;16;0.0897435897435898;0.41025641025641
Control.SRR15539874;32;32;0.4375;18;14;0.0625;0.4375
Control.SRR15539874;36;32;0.444444444444444;20;16;0.0555555555555556;0.444444444444444
Control.SRR15539874;38;32;0.605263157894737;15;23;0.105263157894737;0.394736842105263
Control.SRR15539874;35;32;0.657142857142857;12;23;0.157142857142857;0.342857142857143
Control.SRR15539874;37;32;0.594594594594595;15;22;0.0945945945945946;0.405405405405405
Control.SRR15539874;36;32;0.444444444444444;20;16;0.0555555555555556;0.444444444444444
Control.SRR15539874;39;32;0.666666666666667;13;26;0.166666666666667;0.333333333333333
Control.SRR15539874;34;32;0.441176470588235;19;15;0.0588235294117647;0.441176470588235
Control.SRR15539874;31;32;0.483870967741935;16;15;0.0161290322580645;0.483870967741935
Control.SRR15539874;30;32;0.4;18;12;0.1;0.4
Control.SRR15539874;30;32;0.533333333333333;14;16;0.0333333333333333;0.466666666666667
Control.SRR15539874;29;32;0.586206896551724;12;17;0.0862068965517241;0.413793103448276
Control.SRR15539874;30;32;0.6;12;18;0.1;0.4
Control.SRR15539874;34;32;0.382352941176471;21;13;0.117647058823529;0.382352941176471
Control.SRR15539874;39;32;0.461538461538462;21;18;0.0384615384615384;0.461538461538462
Control.SRR15539874;33;32;0.484848484848485;17;16;0.0151515151515151;0.484848484848485
Control.SRR15539874;35;32;0.457142857142857;19;16;0.0428571428571429;0.457142857142857
Control.SRR15539874;37;32;0.459459459459459;20;17;0.0405405405405405;0.459459459459459
Control.SRR15539874;36;32;0.416666666666667;21;15;0.0833333333333333;0.416666666666667
Control.SRR15539874;37;32;0.432432432432432;21;16;0.0675675675675675;0.432432432432432
Control.SRR15539874;33;32;0.606060606060606;13;20;0.106060606060606;0.393939393939394
Control.SRR15539874;32;32;0.5625;14;18;0.0625;0.4375
Control.SRR15539874;34;32;0.352941176470588;22;12;0.147058823529412;0.352941176470588
Control.SRR15539874;29;32;0.482758620689655;15;14;0.0172413793103448;0.482758620689655
Control.SRR15539874;29;32;0.448275862068966;16;13;0.0517241379310345;0.448275862068966
Control.SRR15539874;32;32;0.46875;17;15;0.03125;0.46875
Control.SRR15539874;29;32;0.482758620689655;15;14;0.0172413793103448;0.482758620689655
Control.SRR15539874;30;32;0.466666666666667;16;14;0.0333333333333333;0.466666666666667
Control.SRR15539874;31;32;0.354838709677419;20;11;0.145161290322581;0.354838709677419
Control.SRR15539874;31;32;0.483870967741935;16;15;0.0161290322580645;0.483870967741935
Control.SRR15539874;28;32;0.392857142857143;17;11;0.107142857142857;0.392857142857143
Control.SRR15539874;36;32;0.5;18;18;0;0.5
Control.SRR15539874;28;32;0.535714285714286;13;15;0.0357142857142857;0.464285714285714
Control.SRR15539874;30;32;0.433333333333333;17;13;0.0666666666666667;0.433333333333333
Control.SRR15539874;30;32;0.566666666666667;13;17;0.0666666666666667;0.433333333333333
Control.SRR15539874;29;32;0.620689655172414;11;18;0.120689655172414;0.379310344827586
Control.SRR15539874;32;32;0.40625;19;13;0.09375;0.40625
Control.SRR15539874;31;32;0.419354838709677;18;13;0.0806451612903226;0.419354838709677
Control.SRR15539874;33;32;0.393939393939394;20;13;0.106060606060606;0.393939393939394
Control.SRR15539874;29;32;0.379310344827586;18;11;0.120689655172414;0.379310344827586
Control.SRR15539874;35;32;0.571428571428571;15;20;0.0714285714285714;0.428571428571429
Control.SRR15539874;32;32;0.5625;14;18;0.0625;0.4375
Control.SRR15539874;29;32;0.448275862068966;16;13;0.0517241379310345;0.448275862068966
Control.SRR15539874;35;32;0.571428571428571;15;20;0.0714285714285714;0.428571428571429
Control.SRR15539874;33;32;0.484848484848485;17;16;0.0151515151515151;0.484848484848485
Control.SRR15539874;32;32;0.40625;19;13;0.09375;0.40625
Control.SRR15539874;28;32;0.5;14;14;0;0.5
Control.SRR15539874;32;32;0.53125;15;17;0.03125;0.46875
Control.SRR15539874;33;32;0.545454545454545;15;18;0.0454545454545454;0.454545454545455
Control.SRR15539874;35;32;0.428571428571429;20;15;0.0714285714285715;0.428571428571429
Control.SRR15539874;34;32;0.441176470588235;19;15;0.0588235294117647;0.441176470588235
Control.SRR15539874;28;32;0.642857142857143;10;18;0.142857142857143;0.357142857142857
Control.SRR15539874;34;32;0.617647058823529;13;21;0.117647058823529;0.382352941176471
Control.SRR15539874;32;32;0.5;16;16;0;0.5
Control.SRR15539874;29;32;0.586206896551724;12;17;0.0862068965517241;0.413793103448276
Control.SRR15539874;28;32;0.535714285714286;13;15;0.0357142857142857;0.464285714285714
Control.SRR15539874;36;32;0.5;18;18;0;0.5
Control.SRR15539874;30;32;0.366666666666667;19;11;0.133333333333333;0.366666666666667
Control.SRR15539874;31;32;0.580645161290323;13;18;0.0806451612903226;0.419354838709677
Control.SRR15539874;31;32;0.419354838709677;18;13;0.0806451612903226;0.419354838709677
Control.SRR15539874;36;32;0.444444444444444;20;16;0.0555555555555556;0.444444444444444
Control.SRR15539874;34;32;0.382352941176471;21;13;0.117647058823529;0.382352941176471
Control.SRR15539874;34;32;0.441176470588235;19;15;0.0588235294117647;0.441176470588235
Control.SRR15539874;32;32;0.28125;23;9;0.21875;0.28125
Control.SRR15539874;31;32;0.612903225806452;12;19;0.112903225806452;0.387096774193548
Control.SRR15539874;28;32;0.714285714285714;8;20;0.214285714285714;0.285714285714286
Control.SRR15539874;34;32;0.529411764705882;16;18;0.0294117647058824;0.470588235294118
Control.SRR15539874;29;32;0.448275862068966;16;13;0.0517241379310345;0.448275862068966
Control.SRR15539874;34;32;0.441176470588235;19;15;0.0588235294117647;0.441176470588235
Control.SRR15539874;31;32;0.419354838709677;18;13;0.0806451612903226;0.419354838709677
Control.SRR15539874;34;32;0.470588235294118;18;16;0.0294117647058824;0.470588235294118
Control.SRR15539874;29;32;0.482758620689655;15;14;0.0172413793103448;0.482758620689655
Control.SRR15539874;29;32;0.413793103448276;17;12;0.0862068965517241;0.413793103448276
Control.SRR15539874;28;32;0.535714285714286;13;15;0.0357142857142857;0.464285714285714
Control.SRR15539874;35;32;0.514285714285714;17;18;0.0142857142857142;0.485714285714286
Control.SRR15539874;30;32;0.533333333333333;14;16;0.0333333333333333;0.466666666666667
Control.SRR15539874;33;32;0.515151515151515;16;17;0.0151515151515151;0.484848484848485
Control.SRR15539874;35;32;0.485714285714286;18;17;0.0142857142857143;0.485714285714286
Control.SRR15539874;35;32;0.571428571428571;15;20;0.0714285714285714;0.428571428571429
Control.SRR15539874;33;32;0.575757575757576;14;19;0.0757575757575758;0.424242424242424
Control.SRR15539874;30;32;0.433333333333333;17;13;0.0666666666666667;0.433333333333333
Control.SRR15539874;34;32;0.647058823529412;12;22;0.147058823529412;0.352941176470588
Control.SRR15539874;33;32;0.454545454545455;18;15;0.0454545454545455;0.454545454545455
Control.SRR15539874;30;32;0.366666666666667;19;11;0.133333333333333;0.366666666666667
Control.SRR15539874;36;32;0.5;18;18;0;0.5
Control.SRR15539874;33;32;0.575757575757576;14;19;0.0757575757575758;0.424242424242424
Control.SRR15539874;35;32;0.628571428571429;13;22;0.128571428571429;0.371428571428571
Control.SRR15539874;28;32;0.392857142857143;17;11;0.107142857142857;0.392857142857143
Control.SRR15539874;32;32;0.5;16;16;0;0.5
Control.SRR15539874;32;32;0.4375;18;14;0.0625;0.4375
Control.SRR15539874;32;32;0.59375;13;19;0.09375;0.40625
Control.SRR15539874;35;32;0.542857142857143;16;19;0.0428571428571428;0.457142857142857
Control.SRR15539874;32;32;0.5;16;16;0;0.5
Control.SRR15539874;33;32;0.545454545454545;15;18;0.0454545454545454;0.454545454545455
Control.SRR15539874;35;32;0.485714285714286;18;17;0.0142857142857143;0.485714285714286
Control.SRR15539874;30;32;0.433333333333333;17;13;0.0666666666666667;0.433333333333333
Control.SRR15539874;29;32;0.551724137931034;13;16;0.0517241379310345;0.448275862068966
Control.SRR15539874;33;32;0.606060606060606;13;20;0.106060606060606;0.393939393939394
Control.SRR15539874;31;32;0.612903225806452;12;19;0.112903225806452;0.387096774193548
Control.SRR15539874;29;32;0.448275862068966;16;13;0.0517241379310345;0.448275862068966
Control.SRR15539874;28;32;0.571428571428571;12;16;0.0714285714285714;0.428571428571429
Control.SRR15539874;28;32;0.607142857142857;11;17;0.107142857142857;0.392857142857143
Control.SRR15539874;29;32;0.379310344827586;18;11;0.120689655172414;0.379310344827586
Control.SRR15539874;30;32;0.566666666666667;13;17;0.0666666666666667;0.433333333333333
Control.SRR15539874;30;32;0.533333333333333;14;16;0.0333333333333333;0.466666666666667
Control.SRR15539874;33;32;0.545454545454545;15;18;0.0454545454545454;0.454545454545455
Control.SRR15539874;29;32;0.551724137931034;13;16;0.0517241379310345;0.448275862068966
Control.SRR15539874;31;32;0.612903225806452;12;19;0.112903225806452;0.387096774193548
Control.SRR15539874;31;32;0.451612903225806;17;14;0.0483870967741936;0.451612903225806
Control.SRR15539874;33;32;0.484848484848485;17;16;0.0151515151515151;0.484848484848485
Control.SRR15539874;33;32;0.424242424242424;19;14;0.0757575757575757;0.424242424242424
Control.SRR15539874;32;32;0.4375;18;14;0.0625;0.4375
Control.SRR15539874;32;32;0.40625;19;13;0.09375;0.40625
Control.SRR15539874;32;32;0.5;16;16;0;0.5
Control.SRR15539874;33;32;0.333333333333333;22;11;0.166666666666667;0.333333333333333
Control.SRR15539874;34;32;0.5;17;17;0;0.5
Control.SRR15539874;34;32;0.470588235294118;18;16;0.0294117647058824;0.470588235294118
Control.SRR15539874;35;32;0.542857142857143;16;19;0.0428571428571428;0.457142857142857
Control.SRR15539874;36;32;0.666666666666667;12;24;0.166666666666667;0.333333333333333
Control.SRR15539874;34;32;0.5;17;17;0;0.5
Control.SRR15539874;35;32;0.4;21;14;0.1;0.4
Control.SRR15539874;33;32;0.636363636363636;12;21;0.136363636363636;0.363636363636364
Control.SRR15539874;35;32;0.571428571428571;15;20;0.0714285714285714;0.428571428571429
Control.SRR15539874;33;32;0.575757575757576;14;19;0.0757575757575758;0.424242424242424
Control.SRR15539874;32;32;0.53125;15;17;0.03125;0.46875
Control.SRR15539874;33;32;0.515151515151515;16;17;0.0151515151515151;0.484848484848485
Control.SRR15539874;35;32;0.6;14;21;0.1;0.4
Control.SRR15539874;36;32;0.333333333333333;24;12;0.166666666666667;0.333333333333333
Control.SRR15539874;29;32;0.482758620689655;15;14;0.0172413793103448;0.482758620689655
Control.SRR15539874;36;32;0.5;18;18;0;0.5
Control.SRR15539874;36;32;0.555555555555556;16;20;0.0555555555555556;0.444444444444444
Control.SRR15539874;36;32;0.527777777777778;17;19;0.0277777777777778;0.472222222222222
Control.SRR15539874;32;32;0.3125;22;10;0.1875;0.3125
Control.SRR15539874;32;32;0.5625;14;18;0.0625;0.4375
Control.SRR15539874;30;32;0.433333333333333;17;13;0.0666666666666667;0.433333333333333
Control.SRR15539874;29;32;0.724137931034483;8;21;0.224137931034483;0.275862068965517
Control.SRR15539874;32;32;0.46875;17;15;0.03125;0.46875
Control.SRR15539874;31;32;0.387096774193548;19;12;0.112903225806452;0.387096774193548
Control.SRR15539874;35;32;0.542857142857143;16;19;0.0428571428571428;0.457142857142857
Control.SRR15539874;34;32;0.588235294117647;14;20;0.0882352941176471;0.411764705882353
Control.SRR15539874;34;32;0.441176470588235;19;15;0.0588235294117647;0.441176470588235
Control.SRR15539874;28;32;0.571428571428571;12;16;0.0714285714285714;0.428571428571429
Control.SRR15539874;33;32;0.515151515151515;16;17;0.0151515151515151;0.484848484848485
Control.SRR15539874;33;32;0.575757575757576;14;19;0.0757575757575758;0.424242424242424
Control.SRR15539874;32;32;0.34375;21;11;0.15625;0.34375
Control.SRR15539874;34;32;0.382352941176471;21;13;0.117647058823529;0.382352941176471
Control.SRR15539874;32;32;0.53125;15;17;0.03125;0.46875
Control.SRR15539874;31;32;0.580645161290323;13;18;0.0806451612903226;0.419354838709677
Control.SRR15539874;28;32;0.464285714285714;15;13;0.0357142857142857;0.464285714285714
Control.SRR15539874;28;32;0.357142857142857;18;10;0.142857142857143;0.357142857142857
Control.SRR15539874;30;32;0.5;15;15;0;0.5
Control.SRR15539874;36;32;0.583333333333333;15;21;0.0833333333333334;0.416666666666667
Control.SRR15539874;33;32;0.636363636363636;12;21;0.136363636363636;0.363636363636364
Control.SRR15539874;36;32;0.388888888888889;22;14;0.111111111111111;0.388888888888889
Control.SRR15539874;30;32;0.433333333333333;17;13;0.0666666666666667;0.433333333333333
Control.SRR15539874;30;32;0.433333333333333;17;13;0.0666666666666667;0.433333333333333
Control.SRR15539874;36;32;0.444444444444444;20;16;0.0555555555555556;0.444444444444444
Control.SRR15539874;31;32;0.451612903225806;17;14;0.0483870967741936;0.451612903225806
Control.SRR15539874;29;32;0.586206896551724;12;17;0.0862068965517241;0.413793103448276
Control.SRR15539874;28;32;0.607142857142857;11;17;0.107142857142857;0.392857142857143
Control.SRR15539874;29;32;0.551724137931034;13;16;0.0517241379310345;0.448275862068966
Control.SRR15539874;30;32;0.466666666666667;16;14;0.0333333333333333;0.466666666666667
Control.SRR15539874;32;32;0.53125;15;17;0.03125;0.46875
Control.SRR15539874;31;32;0.580645161290323;13;18;0.0806451612903226;0.419354838709677
Control.SRR15539874;31;32;0.516129032258065;15;16;0.0161290322580645;0.483870967741935
Control.SRR15539874;34;32;0.529411764705882;16;18;0.0294117647058824;0.470588235294118
Control.SRR15539874;35;32;0.514285714285714;17;18;0.0142857142857142;0.485714285714286
Control.SRR15539874;33;32;0.424242424242424;19;14;0.0757575757575757;0.424242424242424
Control.SRR15539874;34;32;0.441176470588235;19;15;0.0588235294117647;0.441176470588235
Control.SRR15539874;30;32;0.4;18;12;0.1;0.4
Control.SRR15539874;33;32;0.484848484848485;17;16;0.0151515151515151;0.484848484848485
Control.SRR15539874;30;32;0.533333333333333;14;16;0.0333333333333333;0.466666666666667
Control.SRR15539874;35;32;0.428571428571429;20;15;0.0714285714285715;0.428571428571429
Control.SRR15539874;35;32;0.428571428571429;20;15;0.0714285714285715;0.428571428571429
Control.SRR15539874;34;32;0.5;17;17;0;0.5
Control.SRR15539874;29;32;0.551724137931034;13;16;0.0517241379310345;0.448275862068966
Control.SRR15539874;30;32;0.433333333333333;17;13;0.0666666666666667;0.433333333333333
Control.SRR15539874;33;32;0.393939393939394;20;13;0.106060606060606;0.393939393939394
Control.SRR15539874;32;32;0.59375;13;19;0.09375;0.40625
Control.SRR15539874;31;32;0.451612903225806;17;14;0.0483870967741936;0.451612903225806
Control.SRR15539874;31;32;0.548387096774194;14;17;0.0483870967741935;0.451612903225806
Control.SRR15539874;35;32;0.428571428571429;20;15;0.0714285714285715;0.428571428571429
Control.SRR15539874;32;32;0.5;16;16;0;0.5
Control.SRR15539874;31;32;0.516129032258065;15;16;0.0161290322580645;0.483870967741935
Control.SRR15539874;29;32;0.448275862068966;16;13;0.0517241379310345;0.448275862068966
Control.SRR15539874;36;32;0.5;18;18;0;0.5
Control.SRR15539874;33;32;0.424242424242424;19;14;0.0757575757575757;0.424242424242424
Control.SRR15539874;32;32;0.4375;18;14;0.0625;0.4375
Control.SRR15539874;31;32;0.419354838709677;18;13;0.0806451612903226;0.419354838709677
Control.SRR15539874;31;32;0.67741935483871;10;21;0.17741935483871;0.32258064516129
Control.SRR15539874;34;32;0.441176470588235;19;15;0.0588235294117647;0.441176470588235
Control.SRR15539874;28;32;0.357142857142857;18;10;0.142857142857143;0.357142857142857
Control.SRR15539874;32;32;0.59375;13;19;0.09375;0.40625
Control.SRR15539874;32;32;0.40625;19;13;0.09375;0.40625
Control.SRR15539874;30;32;0.633333333333333;11;19;0.133333333333333;0.366666666666667
Control.SRR15539874;34;32;0.470588235294118;18;16;0.0294117647058824;0.470588235294118
Control.SRR15539874;30;32;0.6;12;18;0.1;0.4
Control.SRR15539874;33;32;0.606060606060606;13;20;0.106060606060606;0.393939393939394
Control.SRR15539874;29;32;0.448275862068966;16;13;0.0517241379310345;0.448275862068966
Control.SRR15539874;33;32;0.484848484848485;17;16;0.0151515151515151;0.484848484848485
Control.SRR15539874;34;32;0.470588235294118;18;16;0.0294117647058824;0.470588235294118
Control.SRR15539874;32;32;0.59375;13;19;0.09375;0.40625
Control.SRR15539874;32;32;0.28125;23;9;0.21875;0.28125
Control.SRR15539874;29;32;0.620689655172414;11;18;0.120689655172414;0.379310344827586
Control.SRR15539874;34;32;0.558823529411765;15;19;0.0588235294117647;0.441176470588235
Control.SRR15539874;35;32;0.457142857142857;19;16;0.0428571428571429;0.457142857142857
Control.SRR15539874;29;32;0.586206896551724;12;17;0.0862068965517241;0.413793103448276
Control.SRR15539874;28;32;0.642857142857143;10;18;0.142857142857143;0.357142857142857
Control.SRR15539874;30;32;0.466666666666667;16;14;0.0333333333333333;0.466666666666667
Control.SRR15539874;34;32;0.588235294117647;14;20;0.0882352941176471;0.411764705882353
Control.SRR15539874;34;32;0.470588235294118;18;16;0.0294117647058824;0.470588235294118
Control.SRR15539874;29;32;0.586206896551724;12;17;0.0862068965517241;0.413793103448276
Control.SRR15539874;31;32;0.451612903225806;17;14;0.0483870967741936;0.451612903225806
Control.SRR15539874;28;32;0.571428571428571;12;16;0.0714285714285714;0.428571428571429
Control.SRR15539874;31;32;0.580645161290323;13;18;0.0806451612903226;0.419354838709677
Control.SRR15539874;29;32;0.517241379310345;14;15;0.0172413793103449;0.482758620689655
Control.SRR15539874;30;32;0.4;18;12;0.1;0.4
Control.SRR15539874;29;32;0.551724137931034;13;16;0.0517241379310345;0.448275862068966
Control.SRR15539874;36;32;0.638888888888889;13;23;0.138888888888889;0.361111111111111
Control.SRR15539874;29;32;0.517241379310345;14;15;0.0172413793103449;0.482758620689655
Control.SRR15539874;34;32;0.529411764705882;16;18;0.0294117647058824;0.470588235294118
Control.SRR15539874;32;32;0.5;16;16;0;0.5
Control.SRR15539874;34;32;0.588235294117647;14;20;0.0882352941176471;0.411764705882353
Control.SRR15539874;33;32;0.484848484848485;17;16;0.0151515151515151;0.484848484848485
Control.SRR15539874;30;32;0.766666666666667;7;23;0.266666666666667;0.233333333333333
Control.SRR15539874;32;32;0.46875;17;15;0.03125;0.46875
Control.SRR15539874;31;32;0.516129032258065;15;16;0.0161290322580645;0.483870967741935
Control.SRR15539874;31;32;0.483870967741935;16;15;0.0161290322580645;0.483870967741935
Control.SRR15539874;33;32;0.242424242424242;25;8;0.257575757575758;0.242424242424242
Control.SRR15539874;33;32;0.545454545454545;15;18;0.0454545454545454;0.454545454545455
Control.SRR15539874;32;32;0.625;12;20;0.125;0.375
Control.SRR15539874;33;32;0.424242424242424;19;14;0.0757575757575757;0.424242424242424
Control.SRR15539874;31;32;0.548387096774194;14;17;0.0483870967741935;0.451612903225806
Control.SRR15539874;28;32;0.535714285714286;13;15;0.0357142857142857;0.464285714285714
Control.SRR15539874;29;32;0.551724137931034;13;16;0.0517241379310345;0.448275862068966
Control.SRR15539874;29;32;0.310344827586207;20;9;0.189655172413793;0.310344827586207
Control.SRR15539874;29;32;0.413793103448276;17;12;0.0862068965517241;0.413793103448276
Control.SRR15539874;30;32;0.366666666666667;19;11;0.133333333333333;0.366666666666667
Control.SRR15539874;32;32;0.5;16;16;0;0.5
Control.SRR15539874;30;32;0.4;18;12;0.1;0.4
Control.SRR15539874;36;32;0.583333333333333;15;21;0.0833333333333334;0.416666666666667
Control.SRR15539874;32;32;0.46875;17;15;0.03125;0.46875
Control.SRR15539874;31;32;0.419354838709677;18;13;0.0806451612903226;0.419354838709677
Control.SRR15539874;31;32;0.225806451612903;24;7;0.274193548387097;0.225806451612903
Control.SRR15539874;35;32;0.428571428571429;20;15;0.0714285714285715;0.428571428571429
Control.SRR15539874;32;32;0.59375;13;19;0.09375;0.40625
Control.SRR15539874;33;32;0.515151515151515;16;17;0.0151515151515151;0.484848484848485
Control.SRR15539874;34;32;0.5;17;17;0;0.5
Control.SRR15539874;28;32;0.428571428571429;16;12;0.0714285714285715;0.428571428571429
Control.SRR15539874;29;32;0.551724137931034;13;16;0.0517241379310345;0.448275862068966
Control.SRR15539874;36;32;0.444444444444444;20;16;0.0555555555555556;0.444444444444444
Control.SRR15539874;35;32;0.428571428571429;20;15;0.0714285714285715;0.428571428571429
Control.SRR15539874;36;32;0.583333333333333;15;21;0.0833333333333334;0.416666666666667
Control.SRR15539874;33;32;0.575757575757576;14;19;0.0757575757575758;0.424242424242424
Control.SRR15539874;30;32;0.5;15;15;0;0.5
Control.SRR15539874;32;32;0.46875;17;15;0.03125;0.46875
Control.SRR15539874;34;32;0.5;17;17;0;0.5
Control.SRR15539874;31;32;0.451612903225806;17;14;0.0483870967741936;0.451612903225806
Control.SRR15539874;28;32;0.428571428571429;16;12;0.0714285714285715;0.428571428571429
Control.SRR15539874;34;32;0.529411764705882;16;18;0.0294117647058824;0.470588235294118
Control.SRR15539874;28;32;0.571428571428571;12;16;0.0714285714285714;0.428571428571429
Control.SRR15539874;28;32;0.607142857142857;11;17;0.107142857142857;0.392857142857143
Control.SRR15539874;30;32;0.533333333333333;14;16;0.0333333333333333;0.466666666666667
Control.SRR15539874;29;32;0.551724137931034;13;16;0.0517241379310345;0.448275862068966
Control.SRR15539874;31;32;0.516129032258065;15;16;0.0161290322580645;0.483870967741935
Control.SRR15539874;31;32;0.516129032258065;15;16;0.0161290322580645;0.483870967741935
Control.SRR15539874;34;32;0.411764705882353;20;14;0.0882352941176471;0.411764705882353
Control.SRR15539874;32;32;0.5;16;16;0;0.5
Control.SRR15539874;33;32;0.515151515151515;16;17;0.0151515151515151;0.484848484848485
Control.SRR15539874;29;32;0.413793103448276;17;12;0.0862068965517241;0.413793103448276
Control.SRR15539874;35;32;0.628571428571429;13;22;0.128571428571429;0.371428571428571
Control.SRR15539874;36;32;0.472222222222222;19;17;0.0277777777777778;0.472222222222222
Control.SRR15539874;33;32;0.545454545454545;15;18;0.0454545454545454;0.454545454545455
Control.SRR15539874;33;32;0.484848484848485;17;16;0.0151515151515151;0.484848484848485
Control.SRR15539874;31;32;0.548387096774194;14;17;0.0483870967741935;0.451612903225806
Control.SRR15539874;30;32;0.466666666666667;16;14;0.0333333333333333;0.466666666666667
Control.SRR15539874;34;32;0.470588235294118;18;16;0.0294117647058824;0.470588235294118
Control.SRR15539874;30;32;0.5;15;15;0;0.5
Control.SRR15539874;35;32;0.571428571428571;15;20;0.0714285714285714;0.428571428571429
Control.SRR15539874;29;32;0.413793103448276;17;12;0.0862068965517241;0.413793103448276
Control.SRR15539874;29;32;0.448275862068966;16;13;0.0517241379310345;0.448275862068966
Control.SRR15539874;34;32;0.470588235294118;18;16;0.0294117647058824;0.470588235294118
Control.SRR15539874;32;32;0.59375;13;19;0.09375;0.40625
Control.SRR15539874;34;32;0.470588235294118;18;16;0.0294117647058824;0.470588235294118
Control.SRR15539874;36;32;0.444444444444444;20;16;0.0555555555555556;0.444444444444444
Control.SRR15539874;35;32;0.457142857142857;19;16;0.0428571428571429;0.457142857142857
Control.SRR15539874;33;32;0.363636363636364;21;12;0.136363636363636;0.363636363636364
Control.SRR15539874;33;32;0.454545454545455;18;15;0.0454545454545455;0.454545454545455
Control.SRR15539874;31;32;0.451612903225806;17;14;0.0483870967741936;0.451612903225806
Control.SRR15539874;29;32;0.482758620689655;15;14;0.0172413793103448;0.482758620689655
Control.SRR15539874;28;32;0.607142857142857;11;17;0.107142857142857;0.392857142857143
Control.SRR15539874;30;32;0.466666666666667;16;14;0.0333333333333333;0.466666666666667
Control.SRR15539874;33;32;0.515151515151515;16;17;0.0151515151515151;0.484848484848485
Control.SRR15539874;34;32;0.558823529411765;15;19;0.0588235294117647;0.441176470588235
Control.SRR15539874;28;32;0.5;14;14;0;0.5
Control.SRR15539874;32;32;0.59375;13;19;0.09375;0.40625
Control.SRR15539874;34;32;0.529411764705882;16;18;0.0294117647058824;0.470588235294118
Control.SRR15539874;29;32;0.689655172413793;9;20;0.189655172413793;0.310344827586207
Control.SRR15539874;34;32;0.529411764705882;16;18;0.0294117647058824;0.470588235294118
Control.SRR15539874;30;32;0.7;9;21;0.2;0.3
Control.SRR15539874;29;32;0.413793103448276;17;12;0.0862068965517241;0.413793103448276
Control.SRR15539874;36;32;0.416666666666667;21;15;0.0833333333333333;0.416666666666667
Control.SRR15539874;36;32;0.444444444444444;20;16;0.0555555555555556;0.444444444444444
Control.SRR15539874;29;32;0.482758620689655;15;14;0.0172413793103448;0.482758620689655
Control.SRR15539874;28;32;0.642857142857143;10;18;0.142857142857143;0.357142857142857
Control.SRR15539874;32;32;0.28125;23;9;0.21875;0.28125
Control.SRR15539874;33;32;0.575757575757576;14;19;0.0757575757575758;0.424242424242424
Control.SRR15539874;34;32;0.470588235294118;18;16;0.0294117647058824;0.470588235294118
Control.SRR15539874;28;32;0.357142857142857;18;10;0.142857142857143;0.357142857142857
Control.SRR15539874;28;32;0.571428571428571;12;16;0.0714285714285714;0.428571428571429
Control.SRR15539874;32;32;0.65625;11;21;0.15625;0.34375
Control.SRR15539874;31;32;0.387096774193548;19;12;0.112903225806452;0.387096774193548
Control.SRR15539874;36;32;0.527777777777778;17;19;0.0277777777777778;0.472222222222222
Control.SRR15539874;32;32;0.5;16;16;0;0.5
Control.SRR15539874;30;32;0.633333333333333;11;19;0.133333333333333;0.366666666666667
Control.SRR15539874;30;32;0.4;18;12;0.1;0.4
Control.SRR15539874;29;32;0.344827586206897;19;10;0.155172413793103;0.344827586206897
Control.SRR15539874;30;32;0.5;15;15;0;0.5
Control.SRR15539874;29;32;0.482758620689655;15;14;0.0172413793103448;0.482758620689655
Control.SRR15539874;32;32;0.3125;22;10;0.1875;0.3125
Control.SRR15539874;35;32;0.428571428571429;20;15;0.0714285714285715;0.428571428571429
Control.SRR15539874;30;32;0.6;12;18;0.1;0.4
Control.SRR15539874;28;32;0.535714285714286;13;15;0.0357142857142857;0.464285714285714
Control.SRR15539874;31;32;0.387096774193548;19;12;0.112903225806452;0.387096774193548
Control.SRR15539874;36;32;0.472222222222222;19;17;0.0277777777777778;0.472222222222222
Control.SRR15539874;35;32;0.514285714285714;17;18;0.0142857142857142;0.485714285714286
Control.SRR15539874;33;32;0.696969696969697;10;23;0.196969696969697;0.303030303030303
Control.SRR15539874;36;32;0.527777777777778;17;19;0.0277777777777778;0.472222222222222
Control.SRR15539874;34;32;0.588235294117647;14;20;0.0882352941176471;0.411764705882353
Control.SRR15539874;36;32;0.388888888888889;22;14;0.111111111111111;0.388888888888889
Control.SRR15539874;36;32;0.527777777777778;17;19;0.0277777777777778;0.472222222222222
Control.SRR15539874;36;32;0.527777777777778;17;19;0.0277777777777778;0.472222222222222
Control.SRR15539874;36;32;0.611111111111111;14;22;0.111111111111111;0.388888888888889
Control.SRR15539874;36;32;0.388888888888889;22;14;0.111111111111111;0.388888888888889
Control.SRR15539874;31;32;0.516129032258065;15;16;0.0161290322580645;0.483870967741935
Control.SRR15539874;34;32;0.470588235294118;18;16;0.0294117647058824;0.470588235294118
Control.SRR15539874;28;32;0.571428571428571;12;16;0.0714285714285714;0.428571428571429
Control.SRR15539874;33;32;0.393939393939394;20;13;0.106060606060606;0.393939393939394
Control.SRR15539874;34;32;0.5;17;17;0;0.5
Control.SRR15539874;33;32;0.484848484848485;17;16;0.0151515151515151;0.484848484848485
Control.SRR15539874;35;32;0.371428571428571;22;13;0.128571428571429;0.371428571428571
Control.SRR15539874;30;32;0.466666666666667;16;14;0.0333333333333333;0.466666666666667
Control.SRR15539874;29;32;0.275862068965517;21;8;0.224137931034483;0.275862068965517
Control.SRR15539874;31;32;0.612903225806452;12;19;0.112903225806452;0.387096774193548
Control.SRR15539874;29;32;0.379310344827586;18;11;0.120689655172414;0.379310344827586
Control.SRR15539874;36;32;0.444444444444444;20;16;0.0555555555555556;0.444444444444444
Control.SRR15539874;28;32;0.464285714285714;15;13;0.0357142857142857;0.464285714285714
Control.SRR15539874;33;32;0.515151515151515;16;17;0.0151515151515151;0.484848484848485
Control.SRR15539874;33;32;0.363636363636364;21;12;0.136363636363636;0.363636363636364
Control.SRR15539874;31;32;0.548387096774194;14;17;0.0483870967741935;0.451612903225806
Control.SRR15539874;36;32;0.472222222222222;19;17;0.0277777777777778;0.472222222222222
Control.SRR15539874;30;32;0.433333333333333;17;13;0.0666666666666667;0.433333333333333
Control.SRR15539874;28;32;0.285714285714286;20;8;0.214285714285714;0.285714285714286
Control.SRR15539874;31;32;0.483870967741935;16;15;0.0161290322580645;0.483870967741935
Control.SRR15539874;34;32;0.647058823529412;12;22;0.147058823529412;0.352941176470588
Control.SRR15539874;32;32;0.40625;19;13;0.09375;0.40625
Control.SRR15539874;32;32;0.625;12;20;0.125;0.375
Control.SRR15539874;35;32;0.571428571428571;15;20;0.0714285714285714;0.428571428571429
Control.SRR15539874;34;32;0.441176470588235;19;15;0.0588235294117647;0.441176470588235
Control.SRR15539874;32;32;0.4375;18;14;0.0625;0.4375
Control.SRR15539874;32;32;0.40625;19;13;0.09375;0.40625
Control.SRR15539874;36;32;0.527777777777778;17;19;0.0277777777777778;0.472222222222222
Control.SRR15539874;36;32;0.666666666666667;12;24;0.166666666666667;0.333333333333333
Control.SRR15539874;36;32;0.555555555555556;16;20;0.0555555555555556;0.444444444444444
Control.SRR15539874;30;32;0.666666666666667;10;20;0.166666666666667;0.333333333333333
Control.SRR15539874;31;32;0.483870967741935;16;15;0.0161290322580645;0.483870967741935
Control.SRR15539874;33;32;0.545454545454545;15;18;0.0454545454545454;0.454545454545455
Control.SRR15539874;34;32;0.441176470588235;19;15;0.0588235294117647;0.441176470588235
Control.SRR15539874;35;32;0.514285714285714;17;18;0.0142857142857142;0.485714285714286
Control.SRR15539874;35;32;0.371428571428571;22;13;0.128571428571429;0.371428571428571
Control.SRR15539874;30;32;0.433333333333333;17;13;0.0666666666666667;0.433333333333333
Control.SRR15539874;29;32;0.620689655172414;11;18;0.120689655172414;0.379310344827586
Control.SRR15539874;37;32;0.567567567567568;16;21;0.0675675675675675;0.432432432432432
Control.SRR15539874;29;32;0.586206896551724;12;17;0.0862068965517241;0.413793103448276
Control.SRR15539874;31;32;0.451612903225806;17;14;0.0483870967741936;0.451612903225806
Control.SRR15539874;30;32;0.666666666666667;10;20;0.166666666666667;0.333333333333333
Control.SRR15539874;36;32;0.555555555555556;16;20;0.0555555555555556;0.444444444444444
Control.SRR15539874;34;32;0.5;17;17;0;0.5
Control.SRR15539874;34;32;0.617647058823529;13;21;0.117647058823529;0.382352941176471
Control.SRR15539874;33;32;0.606060606060606;13;20;0.106060606060606;0.393939393939394
Control.SRR15539874;32;32;0.5625;14;18;0.0625;0.4375
Control.SRR15539874;30;32;0.533333333333333;14;16;0.0333333333333333;0.466666666666667
Control.SRR15539874;29;32;0.448275862068966;16;13;0.0517241379310345;0.448275862068966
Control.SRR15539874;32;32;0.59375;13;19;0.09375;0.40625
Control.SRR15539874;36;32;0.472222222222222;19;17;0.0277777777777778;0.472222222222222
Control.SRR15539874;30;32;0.5;15;15;0;0.5
Control.SRR15539874;35;32;0.342857142857143;23;12;0.157142857142857;0.342857142857143
Control.SRR15539874;37;32;0.432432432432432;21;16;0.0675675675675675;0.432432432432432
Control.SRR15539874;37;32;0.513513513513513;18;19;0.0135135135135135;0.486486486486487
Control.SRR15539874;36;32;0.472222222222222;19;17;0.0277777777777778;0.472222222222222
Control.SRR15539874;36;32;0.444444444444444;20;16;0.0555555555555556;0.444444444444444
Control.SRR15539874;34;32;0.323529411764706;23;11;0.176470588235294;0.323529411764706
Control.SRR15539874;30;32;0.466666666666667;16;14;0.0333333333333333;0.466666666666667
Control.SRR15539874;34;32;0.558823529411765;15;19;0.0588235294117647;0.441176470588235
Control.SRR15539874;34;32;0.470588235294118;18;16;0.0294117647058824;0.470588235294118
Control.SRR15539874;33;32;0.606060606060606;13;20;0.106060606060606;0.393939393939394
Control.SRR15539874;33;32;0.545454545454545;15;18;0.0454545454545454;0.454545454545455
Control.SRR15539874;35;32;0.4;21;14;0.1;0.4
Control.SRR15539874;32;32;0.5625;14;18;0.0625;0.4375
Control.SRR15539874;36;32;0.444444444444444;20;16;0.0555555555555556;0.444444444444444
Control.SRR15539874;33;32;0.515151515151515;16;17;0.0151515151515151;0.484848484848485
Control.SRR15539874;35;32;0.342857142857143;23;12;0.157142857142857;0.342857142857143
Control.SRR15539874;31;32;0.451612903225806;17;14;0.0483870967741936;0.451612903225806
Control.SRR15539874;35;32;0.485714285714286;18;17;0.0142857142857143;0.485714285714286
Control.SRR15539874;36;32;0.416666666666667;21;15;0.0833333333333333;0.416666666666667
Control.SRR15539874;34;32;0.588235294117647;14;20;0.0882352941176471;0.411764705882353
Control.SRR15539874;33;32;0.606060606060606;13;20;0.106060606060606;0.393939393939394
Control.SRR15539874;35;32;0.457142857142857;19;16;0.0428571428571429;0.457142857142857
Control.SRR15539874;29;32;0.482758620689655;15;14;0.0172413793103448;0.482758620689655
Control.SRR15539874;36;32;0.527777777777778;17;19;0.0277777777777778;0.472222222222222
Control.SRR15539874;37;32;0.621621621621622;14;23;0.121621621621622;0.378378378378378
Control.SRR15539874;37;32;0.675675675675676;12;25;0.175675675675676;0.324324324324324
Control.SRR15539874;33;32;0.515151515151515;16;17;0.0151515151515151;0.484848484848485
Control.SRR15539874;31;32;0.516129032258065;15;16;0.0161290322580645;0.483870967741935
Control.SRR15539874;32;32;0.6875;10;22;0.1875;0.3125
Control.SRR15539874;30;32;0.4;18;12;0.1;0.4
Control.SRR15539874;30;32;0.5;15;15;0;0.5
Control.SRR15539874;35;32;0.628571428571429;13;22;0.128571428571429;0.371428571428571
Control.SRR15539874;34;32;0.588235294117647;14;20;0.0882352941176471;0.411764705882353
Control.SRR15539874;37;32;0.513513513513513;18;19;0.0135135135135135;0.486486486486487
Control.SRR15539874;33;32;0.393939393939394;20;13;0.106060606060606;0.393939393939394
Control.SRR15539874;33;32;0.545454545454545;15;18;0.0454545454545454;0.454545454545455
Control.SRR15539874;36;32;0.527777777777778;17;19;0.0277777777777778;0.472222222222222
Control.SRR15539874;33;32;0.575757575757576;14;19;0.0757575757575758;0.424242424242424
Control.SRR15539874;35;32;0.628571428571429;13;22;0.128571428571429;0.371428571428571
Control.SRR15539874;36;32;0.555555555555556;16;20;0.0555555555555556;0.444444444444444
Control.SRR15539874;36;32;0.472222222222222;19;17;0.0277777777777778;0.472222222222222
Control.SRR15539874;31;32;0.612903225806452;12;19;0.112903225806452;0.387096774193548
Control.SRR15539874;35;32;0.257142857142857;26;9;0.242857142857143;0.257142857142857
Control.SRR15539874;33;32;0.606060606060606;13;20;0.106060606060606;0.393939393939394
Control.SRR15539874;33;32;0.606060606060606;13;20;0.106060606060606;0.393939393939394
Control.SRR15539874;37;32;0.486486486486487;19;18;0.0135135135135135;0.486486486486487
Control.SRR15539874;34;32;0.529411764705882;16;18;0.0294117647058824;0.470588235294118
Control.SRR15539874;31;32;0.612903225806452;12;19;0.112903225806452;0.387096774193548
Control.SRR15539874;34;32;0.411764705882353;20;14;0.0882352941176471;0.411764705882353
Control.SRR15539874;30;32;0.466666666666667;16;14;0.0333333333333333;0.466666666666667
Control.SRR15539874;29;32;0.586206896551724;12;17;0.0862068965517241;0.413793103448276
Control.SRR15539874;30;32;0.533333333333333;14;16;0.0333333333333333;0.466666666666667
Control.SRR15539874;35;32;0.4;21;14;0.1;0.4
Control.SRR15539874;29;32;0.620689655172414;11;18;0.120689655172414;0.379310344827586
Control.SRR15539874;29;32;0.655172413793103;10;19;0.155172413793103;0.344827586206897
Control.SRR15539874;34;32;0.647058823529412;12;22;0.147058823529412;0.352941176470588
Control.SRR15539874;32;32;0.53125;15;17;0.03125;0.46875
Control.SRR15539874;30;32;0.366666666666667;19;11;0.133333333333333;0.366666666666667
Control.SRR15539874;33;32;0.545454545454545;15;18;0.0454545454545454;0.454545454545455
Control.SRR15539874;31;32;0.387096774193548;19;12;0.112903225806452;0.387096774193548
Control.SRR15539874;30;32;0.466666666666667;16;14;0.0333333333333333;0.466666666666667
Control.SRR15539874;37;32;0.540540540540541;17;20;0.0405405405405406;0.459459459459459
Control.SRR15539874;36;32;0.388888888888889;22;14;0.111111111111111;0.388888888888889
Control.SRR15539874;35;32;0.257142857142857;26;9;0.242857142857143;0.257142857142857
Control.SRR15539874;33;32;0.575757575757576;14;19;0.0757575757575758;0.424242424242424
Control.SRR15539874;36;32;0.416666666666667;21;15;0.0833333333333333;0.416666666666667
Control.SRR15539874;30;32;0.366666666666667;19;11;0.133333333333333;0.366666666666667
Control.SRR15539874;34;32;0.5;17;17;0;0.5
Control.SRR15539874;36;32;0.416666666666667;21;15;0.0833333333333333;0.416666666666667
Control.SRR15539874;36;32;0.444444444444444;20;16;0.0555555555555556;0.444444444444444
Control.SRR15539874;34;32;0.352941176470588;22;12;0.147058823529412;0.352941176470588
Control.SRR15539874;34;32;0.588235294117647;14;20;0.0882352941176471;0.411764705882353
Control.SRR15539874;30;32;0.6;12;18;0.1;0.4
Control.SRR15539874;36;32;0.527777777777778;17;19;0.0277777777777778;0.472222222222222
Control.SRR15539874;37;32;0.459459459459459;20;17;0.0405405405405405;0.459459459459459
Control.SRR15539874;36;32;0.611111111111111;14;22;0.111111111111111;0.388888888888889
Control.SRR15539874;31;32;0.290322580645161;22;9;0.209677419354839;0.290322580645161
Control.SRR15539874;31;32;0.451612903225806;17;14;0.0483870967741936;0.451612903225806
Control.SRR15539874;31;32;0.451612903225806;17;14;0.0483870967741936;0.451612903225806
Control.SRR15539874;35;32;0.571428571428571;15;20;0.0714285714285714;0.428571428571429
Control.SRR15539874;37;32;0.486486486486487;19;18;0.0135135135135135;0.486486486486487
Control.SRR15539874;34;32;0.5;17;17;0;0.5
Control.SRR15539874;36;32;0.555555555555556;16;20;0.0555555555555556;0.444444444444444
Control.SRR15539874;34;32;0.5;17;17;0;0.5
Control.SRR15539874;33;32;0.515151515151515;16;17;0.0151515151515151;0.484848484848485
Control.SRR15539874;32;32;0.5;16;16;0;0.5
Control.SRR15539874;33;32;0.393939393939394;20;13;0.106060606060606;0.393939393939394
Control.SRR15539874;29;32;0.620689655172414;11;18;0.120689655172414;0.379310344827586
Control.SRR15539874;29;32;0.482758620689655;15;14;0.0172413793103448;0.482758620689655
Control.SRR15539874;35;32;0.4;21;14;0.1;0.4
Control.SRR15539874;32;32;0.46875;17;15;0.03125;0.46875
Control.SRR15539874;30;32;0.433333333333333;17;13;0.0666666666666667;0.433333333333333
Control.SRR15539874;31;32;0.419354838709677;18;13;0.0806451612903226;0.419354838709677
Control.SRR15539874;34;32;0.529411764705882;16;18;0.0294117647058824;0.470588235294118
Control.SRR15539874;30;32;0.433333333333333;17;13;0.0666666666666667;0.433333333333333
Control.SRR15539874;30;32;0.7;9;21;0.2;0.3
Control.SRR15539874;32;32;0.5;16;16;0;0.5
Control.SRR15539874;37;32;0.540540540540541;17;20;0.0405405405405406;0.459459459459459
Control.SRR15539874;33;32;0.575757575757576;14;19;0.0757575757575758;0.424242424242424
Control.SRR15539874;33;32;0.606060606060606;13;20;0.106060606060606;0.393939393939394
Control.SRR15539874;35;32;0.514285714285714;17;18;0.0142857142857142;0.485714285714286
Control.SRR15539874;36;32;0.611111111111111;14;22;0.111111111111111;0.388888888888889
Control.SRR15539874;33;32;0.484848484848485;17;16;0.0151515151515151;0.484848484848485
Control.SRR15539874;33;32;0.515151515151515;16;17;0.0151515151515151;0.484848484848485
Control.SRR15539874;37;32;0.540540540540541;17;20;0.0405405405405406;0.459459459459459
Control.SRR15539874;36;32;0.583333333333333;15;21;0.0833333333333334;0.416666666666667
Control.SRR15539874;37;32;0.513513513513513;18;19;0.0135135135135135;0.486486486486487
Control.SRR15539874;36;32;0.527777777777778;17;19;0.0277777777777778;0.472222222222222
Control.SRR15539874;30;32;0.6;12;18;0.1;0.4
Control.SRR15539874;33;32;0.454545454545455;18;15;0.0454545454545455;0.454545454545455
Control.SRR15539874;36;32;0.416666666666667;21;15;0.0833333333333333;0.416666666666667
Control.SRR15539874;37;32;0.432432432432432;21;16;0.0675675675675675;0.432432432432432
Control.SRR15539874;30;32;0.466666666666667;16;14;0.0333333333333333;0.466666666666667
Control.SRR15539874;31;32;0.67741935483871;10;21;0.17741935483871;0.32258064516129
Control.SRR15539874;34;32;0.5;17;17;0;0.5
Control.SRR15539874;31;32;0.483870967741935;16;15;0.0161290322580645;0.483870967741935
Control.SRR15539874;29;32;0.517241379310345;14;15;0.0172413793103449;0.482758620689655
Control.SRR15539874;33;32;0.363636363636364;21;12;0.136363636363636;0.363636363636364
Control.SRR15539874;30;32;0.366666666666667;19;11;0.133333333333333;0.366666666666667
Control.SRR15539874;37;32;0.513513513513513;18;19;0.0135135135135135;0.486486486486487
Control.SRR15539874;35;32;0.485714285714286;18;17;0.0142857142857143;0.485714285714286
Control.SRR15539874;37;32;0.459459459459459;20;17;0.0405405405405405;0.459459459459459
Control.SRR15539874;37;32;0.621621621621622;14;23;0.121621621621622;0.378378378378378
Control.SRR15539874;33;32;0.484848484848485;17;16;0.0151515151515151;0.484848484848485
Control.SRR15539874;33;32;0.575757575757576;14;19;0.0757575757575758;0.424242424242424
Control.SRR15539874;29;32;0.620689655172414;11;18;0.120689655172414;0.379310344827586
Control.SRR15539874;31;32;0.387096774193548;19;12;0.112903225806452;0.387096774193548
Control.SRR15539874;30;32;0.4;18;12;0.1;0.4
Control.SRR15539874;36;32;0.5;18;18;0;0.5
Control.SRR15539874;33;32;0.393939393939394;20;13;0.106060606060606;0.393939393939394
Control.SRR15539874;30;32;0.433333333333333;17;13;0.0666666666666667;0.433333333333333
Control.SRR15539874;33;32;0.575757575757576;14;19;0.0757575757575758;0.424242424242424
Control.SRR15539874;31;32;0.548387096774194;14;17;0.0483870967741935;0.451612903225806
Control.SRR15539874;37;32;0.594594594594595;15;22;0.0945945945945946;0.405405405405405
Control.SRR15539874;35;32;0.571428571428571;15;20;0.0714285714285714;0.428571428571429
Control.SRR15539874;32;32;0.40625;19;13;0.09375;0.40625
Control.SRR15539874;33;32;0.545454545454545;15;18;0.0454545454545454;0.454545454545455
Control.SRR15539874;37;32;0.486486486486487;19;18;0.0135135135135135;0.486486486486487
Control.SRR15539874;35;32;0.542857142857143;16;19;0.0428571428571428;0.457142857142857
Control.SRR15539874;37;32;0.567567567567568;16;21;0.0675675675675675;0.432432432432432
Control.SRR15539874;31;32;0.774193548387097;7;24;0.274193548387097;0.225806451612903
Control.SRR15539874;32;32;0.46875;17;15;0.03125;0.46875
Control.SRR15539874;32;32;0.4375;18;14;0.0625;0.4375
Control.SRR15539874;29;32;0.517241379310345;14;15;0.0172413793103449;0.482758620689655
Control.SRR15539874;29;32;0.551724137931034;13;16;0.0517241379310345;0.448275862068966
Control.SRR15539874;30;32;0.333333333333333;20;10;0.166666666666667;0.333333333333333
Control.SRR15539874;37;32;0.675675675675676;12;25;0.175675675675676;0.324324324324324
Control.SRR15539874;34;32;0.588235294117647;14;20;0.0882352941176471;0.411764705882353
Control.SRR15539874;37;32;0.567567567567568;16;21;0.0675675675675675;0.432432432432432
Control.SRR15539874;31;32;0.645161290322581;11;20;0.145161290322581;0.354838709677419
Control.SRR15539874;36;32;0.527777777777778;17;19;0.0277777777777778;0.472222222222222
Control.SRR15539874;34;32;0.411764705882353;20;14;0.0882352941176471;0.411764705882353
Control.SRR15539874;31;32;0.516129032258065;15;16;0.0161290322580645;0.483870967741935
Control.SRR15539874;29;32;0.413793103448276;17;12;0.0862068965517241;0.413793103448276
Control.SRR15539874;37;32;0.567567567567568;16;21;0.0675675675675675;0.432432432432432
Control.SRR15539874;37;32;0.540540540540541;17;20;0.0405405405405406;0.459459459459459
Control.SRR15539874;33;32;0.363636363636364;21;12;0.136363636363636;0.363636363636364
Control.SRR15539874;33;32;0.484848484848485;17;16;0.0151515151515151;0.484848484848485
Control.SRR15539874;32;32;0.5;16;16;0;0.5
Control.SRR15539874;34;32;0.441176470588235;19;15;0.0588235294117647;0.441176470588235
Control.SRR15539874;31;32;0.483870967741935;16;15;0.0161290322580645;0.483870967741935
Control.SRR15539874;30;32;0.5;15;15;0;0.5
Control.SRR15539874;33;32;0.787878787878788;7;26;0.287878787878788;0.212121212121212
Control.SRR15539874;33;32;0.424242424242424;19;14;0.0757575757575757;0.424242424242424
Control.SRR15539874;36;32;0.444444444444444;20;16;0.0555555555555556;0.444444444444444
Control.SRR15539874;29;32;0.413793103448276;17;12;0.0862068965517241;0.413793103448276
Control.SRR15539874;30;32;0.466666666666667;16;14;0.0333333333333333;0.466666666666667
Control.SRR15539874;31;32;0.451612903225806;17;14;0.0483870967741936;0.451612903225806
Control.SRR15539874;31;32;0.483870967741935;16;15;0.0161290322580645;0.483870967741935
Control.SRR15539874;36;32;0.472222222222222;19;17;0.0277777777777778;0.472222222222222
Control.SRR15539874;34;32;0.470588235294118;18;16;0.0294117647058824;0.470588235294118
Control.SRR15539874;37;32;0.594594594594595;15;22;0.0945945945945946;0.405405405405405
Control.SRR15539874;36;32;0.472222222222222;19;17;0.0277777777777778;0.472222222222222
Control.SRR15539874;35;32;0.457142857142857;19;16;0.0428571428571429;0.457142857142857
Control.SRR15539874;37;32;0.540540540540541;17;20;0.0405405405405406;0.459459459459459
Control.SRR15539874;35;32;0.457142857142857;19;16;0.0428571428571429;0.457142857142857
Control.SRR15539874;37;32;0.459459459459459;20;17;0.0405405405405405;0.459459459459459
Control.SRR15539874;37;32;0.324324324324324;25;12;0.175675675675676;0.324324324324324
Control.SRR15539874;33;32;0.545454545454545;15;18;0.0454545454545454;0.454545454545455
Control.SRR15539874;34;32;0.676470588235294;11;23;0.176470588235294;0.323529411764706
Control.SRR15539874;34;32;0.617647058823529;13;21;0.117647058823529;0.382352941176471
Control.SRR15539874;32;32;0.375;20;12;0.125;0.375
Control.SRR15539874;30;32;0.6;12;18;0.1;0.4
Control.SRR15539874;34;32;0.5;17;17;0;0.5
Control.SRR15539874;31;32;0.354838709677419;20;11;0.145161290322581;0.354838709677419
Control.SRR15539874;32;32;0.53125;15;17;0.03125;0.46875
Control.SRR15539874;36;32;0.444444444444444;20;16;0.0555555555555556;0.444444444444444
Control.SRR15539874;36;32;0.555555555555556;16;20;0.0555555555555556;0.444444444444444
Control.SRR15539874;34;32;0.5;17;17;0;0.5
Control.SRR15539874;31;32;0.67741935483871;10;21;0.17741935483871;0.32258064516129
Control.SRR15539874;30;32;0.5;15;15;0;0.5
Control.SRR15539874;30;32;0.266666666666667;22;8;0.233333333333333;0.266666666666667
Control.SRR15539874;31;32;0.483870967741935;16;15;0.0161290322580645;0.483870967741935
Control.SRR15539874;30;32;0.533333333333333;14;16;0.0333333333333333;0.466666666666667
Control.SRR15539874;29;32;0.448275862068966;16;13;0.0517241379310345;0.448275862068966
Control.SRR15539874;32;32;0.625;12;20;0.125;0.375
Control.SRR15539874;31;32;0.548387096774194;14;17;0.0483870967741935;0.451612903225806
Control.SRR15539874;37;32;0.432432432432432;21;16;0.0675675675675675;0.432432432432432
Control.SRR15539874;31;32;0.354838709677419;20;11;0.145161290322581;0.354838709677419
Control.SRR15539874;29;32;0.517241379310345;14;15;0.0172413793103449;0.482758620689655
Control.SRR15539874;32;32;0.40625;19;13;0.09375;0.40625
Control.SRR15539874;29;32;0.413793103448276;17;12;0.0862068965517241;0.413793103448276
Control.SRR15539874;30;32;0.666666666666667;10;20;0.166666666666667;0.333333333333333
Control.SRR15539874;32;32;0.53125;15;17;0.03125;0.46875
Control.SRR15539874;33;32;0.393939393939394;20;13;0.106060606060606;0.393939393939394
Control.SRR15539874;33;32;0.545454545454545;15;18;0.0454545454545454;0.454545454545455
Control.SRR15539874;34;32;0.411764705882353;20;14;0.0882352941176471;0.411764705882353
Control.SRR15539874;33;32;0.454545454545455;18;15;0.0454545454545455;0.454545454545455
Control.SRR15539874;30;32;0.533333333333333;14;16;0.0333333333333333;0.466666666666667
Control.SRR15539874;29;32;0.655172413793103;10;19;0.155172413793103;0.344827586206897
Control.SRR15539874;31;32;0.516129032258065;15;16;0.0161290322580645;0.483870967741935
Control.SRR15539874;30;32;0.466666666666667;16;14;0.0333333333333333;0.466666666666667
Control.SRR15539874;36;32;0.555555555555556;16;20;0.0555555555555556;0.444444444444444
Control.SRR15539874;32;32;0.5625;14;18;0.0625;0.4375
Control.SRR15539874;31;32;0.516129032258065;15;16;0.0161290322580645;0.483870967741935
Control.SRR15539874;30;32;0.533333333333333;14;16;0.0333333333333333;0.466666666666667
Control.SRR15539874;31;32;0.612903225806452;12;19;0.112903225806452;0.387096774193548
Control.SRR15539874;30;32;0.366666666666667;19;11;0.133333333333333;0.366666666666667
Control.SRR15539874;36;32;0.444444444444444;20;16;0.0555555555555556;0.444444444444444
Control.SRR15539874;30;32;0.4;18;12;0.1;0.4
Control.SRR15539874;32;32;0.5;16;16;0;0.5
Control.SRR15539874;37;32;0.513513513513513;18;19;0.0135135135135135;0.486486486486487
Control.SRR15539874;34;32;0.5;17;17;0;0.5
Control.SRR15539874;29;32;0.551724137931034;13;16;0.0517241379310345;0.448275862068966
Control.SRR15539874;29;32;0.448275862068966;16;13;0.0517241379310345;0.448275862068966
Control.SRR15539874;35;32;0.371428571428571;22;13;0.128571428571429;0.371428571428571
Control.SRR15539874;33;32;0.606060606060606;13;20;0.106060606060606;0.393939393939394
Control.SRR15539874;35;32;0.571428571428571;15;20;0.0714285714285714;0.428571428571429
Control.SRR15539874;37;32;0.486486486486487;19;18;0.0135135135135135;0.486486486486487
Control.SRR15539874;34;32;0.382352941176471;21;13;0.117647058823529;0.382352941176471
Control.SRR15539874;35;32;0.542857142857143;16;19;0.0428571428571428;0.457142857142857
Control.SRR15539874;29;32;0.517241379310345;14;15;0.0172413793103449;0.482758620689655
Control.SRR15539874;31;32;0.516129032258065;15;16;0.0161290322580645;0.483870967741935
Control.SRR15539874;31;32;0.580645161290323;13;18;0.0806451612903226;0.419354838709677
Control.SRR15539874;31;32;0.580645161290323;13;18;0.0806451612903226;0.419354838709677
Control.SRR15539874;35;32;0.514285714285714;17;18;0.0142857142857142;0.485714285714286
Control.SRR15539874;32;32;0.46875;17;15;0.03125;0.46875
Control.SRR15539874;29;32;0.620689655172414;11;18;0.120689655172414;0.379310344827586
Control.SRR15539874;30;32;0.3;21;9;0.2;0.3
Control.SRR15539874;30;32;0.433333333333333;17;13;0.0666666666666667;0.433333333333333
Control.SRR15539874;31;32;0.548387096774194;14;17;0.0483870967741935;0.451612903225806
Control.SRR15539874;29;32;0.517241379310345;14;15;0.0172413793103449;0.482758620689655
Control.SRR15539874;33;32;0.424242424242424;19;14;0.0757575757575757;0.424242424242424
Control.SRR15539874;34;32;0.676470588235294;11;23;0.176470588235294;0.323529411764706
Control.SRR15539874;32;32;0.53125;15;17;0.03125;0.46875
Control.SRR15539874;37;32;0.459459459459459;20;17;0.0405405405405405;0.459459459459459
Control.SRR15539874;31;32;0.483870967741935;16;15;0.0161290322580645;0.483870967741935
Control.SRR15539874;32;32;0.5;16;16;0;0.5
Control.SRR15539874;30;32;0.466666666666667;16;14;0.0333333333333333;0.466666666666667
Control.SRR15539874;30;32;0.666666666666667;10;20;0.166666666666667;0.333333333333333
Control.SRR15539874;37;32;0.540540540540541;17;20;0.0405405405405406;0.459459459459459
Control.SRR15539874;35;32;0.4;21;14;0.1;0.4
Control.SRR15539874;36;32;0.416666666666667;21;15;0.0833333333333333;0.416666666666667
Control.SRR15539874;29;32;0.517241379310345;14;15;0.0172413793103449;0.482758620689655
Control.SRR15539874;30;32;0.466666666666667;16;14;0.0333333333333333;0.466666666666667
Control.SRR15539874;33;32;0.242424242424242;25;8;0.257575757575758;0.242424242424242
Control.SRR15539874;33;32;0.454545454545455;18;15;0.0454545454545455;0.454545454545455
Control.SRR15539874;36;32;0.388888888888889;22;14;0.111111111111111;0.388888888888889
Control.SRR15539874;36;32;0.527777777777778;17;19;0.0277777777777778;0.472222222222222
Control.SRR15539874;29;32;0.413793103448276;17;12;0.0862068965517241;0.413793103448276
Control.SRR15539874;29;32;0.586206896551724;12;17;0.0862068965517241;0.413793103448276
Control.SRR15539874;34;32;0.588235294117647;14;20;0.0882352941176471;0.411764705882353
Control.SRR15539874;37;32;0.432432432432432;21;16;0.0675675675675675;0.432432432432432
Control.SRR15539874;35;32;0.657142857142857;12;23;0.157142857142857;0.342857142857143
Control.SRR15539874;34;32;0.382352941176471;21;13;0.117647058823529;0.382352941176471
Control.SRR15539874;33;32;0.424242424242424;19;14;0.0757575757575757;0.424242424242424
Control.SRR15539874;30;32;0.466666666666667;16;14;0.0333333333333333;0.466666666666667
Control.SRR15539874;34;32;0.470588235294118;18;16;0.0294117647058824;0.470588235294118
Control.SRR15539874;31;32;0.387096774193548;19;12;0.112903225806452;0.387096774193548
Control.SRR15539874;32;32;0.40625;19;13;0.09375;0.40625
Control.SRR15539874;31;32;0.548387096774194;14;17;0.0483870967741935;0.451612903225806
Control.SRR15539874;33;32;0.515151515151515;16;17;0.0151515151515151;0.484848484848485
Control.SRR15539874;37;32;0.540540540540541;17;20;0.0405405405405406;0.459459459459459
Control.SRR15539874;31;32;0.548387096774194;14;17;0.0483870967741935;0.451612903225806
Control.SRR15539874;30;32;0.6;12;18;0.1;0.4
Control.SRR15539874;34;32;0.294117647058824;24;10;0.205882352941176;0.294117647058824
Control.SRR15539874;32;32;0.59375;13;19;0.09375;0.40625
Control.SRR15539874;34;32;0.470588235294118;18;16;0.0294117647058824;0.470588235294118
Control.SRR15539874;32;32;0.53125;15;17;0.03125;0.46875
Control.SRR15539874;36;32;0.611111111111111;14;22;0.111111111111111;0.388888888888889
Control.SRR15539874;31;32;0.419354838709677;18;13;0.0806451612903226;0.419354838709677
Control.SRR15539874;31;32;0.419354838709677;18;13;0.0806451612903226;0.419354838709677
Control.SRR15539874;31;32;0.548387096774194;14;17;0.0483870967741935;0.451612903225806
Control.SRR15539874;36;32;0.611111111111111;14;22;0.111111111111111;0.388888888888889
Control.SRR15539874;35;32;0.457142857142857;19;16;0.0428571428571429;0.457142857142857
Control.SRR15539874;31;32;0.483870967741935;16;15;0.0161290322580645;0.483870967741935
Control.SRR15539874;35;32;0.542857142857143;16;19;0.0428571428571428;0.457142857142857
Control.SRR15539874;34;32;0.470588235294118;18;16;0.0294117647058824;0.470588235294118
Control.SRR15539874;37;32;0.594594594594595;15;22;0.0945945945945946;0.405405405405405
Control.SRR15539874;33;32;0.424242424242424;19;14;0.0757575757575757;0.424242424242424
Control.SRR15539874;38;32;0.578947368421053;16;22;0.0789473684210527;0.421052631578947
Control.SRR15539874;36;32;0.444444444444444;20;16;0.0555555555555556;0.444444444444444
Control.SRR15539874;39;32;0.512820512820513;19;20;0.0128205128205128;0.487179487179487
Control.SRR15539874;32;32;0.375;20;12;0.125;0.375
Control.SRR15539874;37;32;0.432432432432432;21;16;0.0675675675675675;0.432432432432432
Control.SRR15539874;35;32;0.4;21;14;0.1;0.4
Control.SRR15539874;39;32;0.58974358974359;16;23;0.0897435897435898;0.41025641025641
Control.SRR15539874;35;32;0.428571428571429;20;15;0.0714285714285715;0.428571428571429
Control.SRR15539874;33;32;0.575757575757576;14;19;0.0757575757575758;0.424242424242424
Control.SRR15539874;34;32;0.5;17;17;0;0.5
Control.SRR15539874;36;32;0.416666666666667;21;15;0.0833333333333333;0.416666666666667
Control.SRR15539874;32;32;0.40625;19;13;0.09375;0.40625
Control.SRR15539874;38;32;0.421052631578947;22;16;0.0789473684210527;0.421052631578947
Control.SRR15539874;31;32;0.516129032258065;15;16;0.0161290322580645;0.483870967741935
Control.SRR15539874;37;32;0.567567567567568;16;21;0.0675675675675675;0.432432432432432
Control.SRR15539874;38;32;0.578947368421053;16;22;0.0789473684210527;0.421052631578947
Control.SRR15539874;36;32;0.5;18;18;0;0.5
Control.SRR15539874;33;32;0.636363636363636;12;21;0.136363636363636;0.363636363636364
Control.SRR15539874;32;32;0.5;16;16;0;0.5
Control.SRR15539874;39;32;0.487179487179487;20;19;0.0128205128205128;0.487179487179487
Control.SRR15539874;32;32;0.5625;14;18;0.0625;0.4375
Control.SRR15539874;36;32;0.5;18;18;0;0.5
Control.SRR15539874;32;32;0.5;16;16;0;0.5
Control.SRR15539874;35;32;0.485714285714286;18;17;0.0142857142857143;0.485714285714286
Control.SRR15539874;31;32;0.516129032258065;15;16;0.0161290322580645;0.483870967741935
Control.SRR15539874;35;32;0.657142857142857;12;23;0.157142857142857;0.342857142857143
Control.SRR15539874;39;32;0.538461538461538;18;21;0.0384615384615384;0.461538461538462
Control.SRR15539874;36;32;0.444444444444444;20;16;0.0555555555555556;0.444444444444444
Control.SRR15539874;33;32;0.575757575757576;14;19;0.0757575757575758;0.424242424242424
Control.SRR15539874;37;32;0.567567567567568;16;21;0.0675675675675675;0.432432432432432
Control.SRR15539874;34;32;0.558823529411765;15;19;0.0588235294117647;0.441176470588235
Control.SRR15539874;31;32;0.419354838709677;18;13;0.0806451612903226;0.419354838709677
Control.SRR15539874;37;32;0.459459459459459;20;17;0.0405405405405405;0.459459459459459
Control.SRR15539874;35;32;0.6;14;21;0.1;0.4
Control.SRR15539874;33;32;0.484848484848485;17;16;0.0151515151515151;0.484848484848485
Control.SRR15539874;35;32;0.571428571428571;15;20;0.0714285714285714;0.428571428571429
Control.SRR15539874;34;32;0.5;17;17;0;0.5
Control.SRR15539874;36;32;0.472222222222222;19;17;0.0277777777777778;0.472222222222222
Control.SRR15539874;31;32;0.548387096774194;14;17;0.0483870967741935;0.451612903225806
Control.SRR15539874;38;32;0.526315789473684;18;20;0.0263157894736842;0.473684210526316
Control.SRR15539874;38;32;0.684210526315789;12;26;0.184210526315789;0.315789473684211
Control.SRR15539874;29;32;0.551724137931034;13;16;0.0517241379310345;0.448275862068966
Control.SRR15539874;36;32;0.5;18;18;0;0.5
Control.SRR15539874;34;32;0.470588235294118;18;16;0.0294117647058824;0.470588235294118
Control.SRR15539874;33;32;0.666666666666667;11;22;0.166666666666667;0.333333333333333
Control.SRR15539874;35;32;0.542857142857143;16;19;0.0428571428571428;0.457142857142857
Control.SRR15539874;33;32;0.393939393939394;20;13;0.106060606060606;0.393939393939394
Control.SRR15539874;37;32;0.486486486486487;19;18;0.0135135135135135;0.486486486486487
Control.SRR15539874;37;32;0.540540540540541;17;20;0.0405405405405406;0.459459459459459
Control.SRR15539874;35;32;0.4;21;14;0.1;0.4
Control.SRR15539874;33;32;0.666666666666667;11;22;0.166666666666667;0.333333333333333
Control.SRR15539874;32;32;0.46875;17;15;0.03125;0.46875
Control.SRR15539874;30;32;0.366666666666667;19;11;0.133333333333333;0.366666666666667
Control.SRR15539874;32;32;0.4375;18;14;0.0625;0.4375
Control.SRR15539874;33;32;0.484848484848485;17;16;0.0151515151515151;0.484848484848485
Control.SRR15539874;32;32;0.53125;15;17;0.03125;0.46875
Control.SRR15539874;30;32;0.466666666666667;16;14;0.0333333333333333;0.466666666666667
Control.SRR15539874;34;32;0.470588235294118;18;16;0.0294117647058824;0.470588235294118
Control.SRR15539874;31;32;0.516129032258065;15;16;0.0161290322580645;0.483870967741935
Control.SRR15539874;31;32;0.419354838709677;18;13;0.0806451612903226;0.419354838709677
Control.SRR15539874;39;32;0.58974358974359;16;23;0.0897435897435898;0.41025641025641
Control.SRR15539874;34;32;0.676470588235294;11;23;0.176470588235294;0.323529411764706
Control.SRR15539874;33;32;0.333333333333333;22;11;0.166666666666667;0.333333333333333
Control.SRR15539874;34;32;0.558823529411765;15;19;0.0588235294117647;0.441176470588235
Control.SRR15539874;33;32;0.484848484848485;17;16;0.0151515151515151;0.484848484848485
Control.SRR15539874;33;32;0.636363636363636;12;21;0.136363636363636;0.363636363636364
Control.SRR15539874;39;32;0.487179487179487;20;19;0.0128205128205128;0.487179487179487
Control.SRR15539874;32;32;0.46875;17;15;0.03125;0.46875
Control.SRR15539874;33;32;0.454545454545455;18;15;0.0454545454545455;0.454545454545455
Control.SRR15539874;35;32;0.571428571428571;15;20;0.0714285714285714;0.428571428571429
Control.SRR15539874;30;32;0.366666666666667;19;11;0.133333333333333;0.366666666666667
Control.SRR15539874;38;32;0.605263157894737;15;23;0.105263157894737;0.394736842105263
Control.SRR15539874;39;32;0.58974358974359;16;23;0.0897435897435898;0.41025641025641
Control.SRR15539874;32;32;0.53125;15;17;0.03125;0.46875
Control.SRR15539874;29;32;0.517241379310345;14;15;0.0172413793103449;0.482758620689655
Control.SRR15539874;37;32;0.567567567567568;16;21;0.0675675675675675;0.432432432432432
Control.SRR15539874;39;32;0.564102564102564;17;22;0.0641025641025641;0.435897435897436
Control.SRR15539874;35;32;0.628571428571429;13;22;0.128571428571429;0.371428571428571
Control.SRR15539874;30;32;0.5;15;15;0;0.5
Control.SRR15539874;29;32;0.482758620689655;15;14;0.0172413793103448;0.482758620689655
Control.SRR15539874;39;32;0.487179487179487;20;19;0.0128205128205128;0.487179487179487
Control.SRR15539874;35;32;0.485714285714286;18;17;0.0142857142857143;0.485714285714286
Control.SRR15539874;38;32;0.657894736842105;13;25;0.157894736842105;0.342105263157895
Control.SRR15539874;37;32;0.648648648648649;13;24;0.148648648648649;0.351351351351351
Control.SRR15539874;31;32;0.548387096774194;14;17;0.0483870967741935;0.451612903225806
Control.SRR15539874;37;32;0.486486486486487;19;18;0.0135135135135135;0.486486486486487
Control.SRR15539874;35;32;0.685714285714286;11;24;0.185714285714286;0.314285714285714
Control.SRR15539874;35;32;0.514285714285714;17;18;0.0142857142857142;0.485714285714286
Control.SRR15539874;35;32;0.571428571428571;15;20;0.0714285714285714;0.428571428571429
Control.SRR15539874;34;32;0.411764705882353;20;14;0.0882352941176471;0.411764705882353
Control.SRR15539874;31;32;0.548387096774194;14;17;0.0483870967741935;0.451612903225806
Control.SRR15539874;37;32;0.405405405405405;22;15;0.0945945945945946;0.405405405405405
Control.SRR15539874;37;32;0.459459459459459;20;17;0.0405405405405405;0.459459459459459
Control.SRR15539874;33;32;0.666666666666667;11;22;0.166666666666667;0.333333333333333
Control.SRR15539874;37;32;0.432432432432432;21;16;0.0675675675675675;0.432432432432432
Control.SRR15539874;31;32;0.483870967741935;16;15;0.0161290322580645;0.483870967741935
Control.SRR15539874;29;32;0.482758620689655;15;14;0.0172413793103448;0.482758620689655
Control.SRR15539874;35;32;0.4;21;14;0.1;0.4
Control.SRR15539874;36;32;0.5;18;18;0;0.5
Control.SRR15539874;37;32;0.459459459459459;20;17;0.0405405405405405;0.459459459459459
Control.SRR15539874;33;32;0.545454545454545;15;18;0.0454545454545454;0.454545454545455
Control.SRR15539874;38;32;0.5;19;19;0;0.5
Control.SRR15539874;31;32;0.451612903225806;17;14;0.0483870967741936;0.451612903225806
Control.SRR15539874;35;32;0.542857142857143;16;19;0.0428571428571428;0.457142857142857
Control.SRR15539874;29;32;0.517241379310345;14;15;0.0172413793103449;0.482758620689655
Control.SRR15539874;30;32;0.466666666666667;16;14;0.0333333333333333;0.466666666666667
Control.SRR15539874;31;32;0.451612903225806;17;14;0.0483870967741936;0.451612903225806
Control.SRR15539874;34;32;0.411764705882353;20;14;0.0882352941176471;0.411764705882353
Control.SRR15539874;34;32;0.529411764705882;16;18;0.0294117647058824;0.470588235294118
Control.SRR15539874;34;32;0.588235294117647;14;20;0.0882352941176471;0.411764705882353
Control.SRR15539874;33;32;0.545454545454545;15;18;0.0454545454545454;0.454545454545455
Control.SRR15539874;33;32;0.484848484848485;17;16;0.0151515151515151;0.484848484848485
Control.SRR15539874;32;32;0.4375;18;14;0.0625;0.4375
Control.SRR15539874;31;32;0.548387096774194;14;17;0.0483870967741935;0.451612903225806
Control.SRR15539874;32;32;0.5625;14;18;0.0625;0.4375
Control.SRR15539874;39;32;0.487179487179487;20;19;0.0128205128205128;0.487179487179487
Control.SRR15539874;35;32;0.571428571428571;15;20;0.0714285714285714;0.428571428571429
Control.SRR15539874;39;32;0.487179487179487;20;19;0.0128205128205128;0.487179487179487
Control.SRR15539874;36;32;0.5;18;18;0;0.5
Control.SRR15539874;36;32;0.444444444444444;20;16;0.0555555555555556;0.444444444444444
Control.SRR15539874;39;32;0.461538461538462;21;18;0.0384615384615384;0.461538461538462
Control.SRR15539874;39;32;0.641025641025641;14;25;0.141025641025641;0.358974358974359
Control.SRR15539874;31;32;0.451612903225806;17;14;0.0483870967741936;0.451612903225806
Control.SRR15539874;35;32;0.457142857142857;19;16;0.0428571428571429;0.457142857142857
Control.SRR15539874;36;32;0.472222222222222;19;17;0.0277777777777778;0.472222222222222
Control.SRR15539874;35;32;0.571428571428571;15;20;0.0714285714285714;0.428571428571429
Control.SRR15539874;31;32;0.419354838709677;18;13;0.0806451612903226;0.419354838709677
Control.SRR15539874;39;32;0.538461538461538;18;21;0.0384615384615384;0.461538461538462
Control.SRR15539874;30;32;0.6;12;18;0.1;0.4
Control.SRR15539874;35;32;0.4;21;14;0.1;0.4
Control.SRR15539874;30;32;0.466666666666667;16;14;0.0333333333333333;0.466666666666667
Control.SRR15539874;36;32;0.638888888888889;13;23;0.138888888888889;0.361111111111111
Control.SRR15539874;37;32;0.486486486486487;19;18;0.0135135135135135;0.486486486486487
Control.SRR15539874;30;32;0.533333333333333;14;16;0.0333333333333333;0.466666666666667
Control.SRR15539874;38;32;0.526315789473684;18;20;0.0263157894736842;0.473684210526316
Control.SRR15539874;37;32;0.351351351351351;24;13;0.148648648648649;0.351351351351351
Control.SRR15539874;37;32;0.621621621621622;14;23;0.121621621621622;0.378378378378378
Control.SRR15539874;34;32;0.5;17;17;0;0.5
Control.SRR15539874;37;32;0.405405405405405;22;15;0.0945945945945946;0.405405405405405
Control.SRR15539874;37;32;0.72972972972973;10;27;0.22972972972973;0.27027027027027
Control.SRR15539874;38;32;0.5;19;19;0;0.5
Control.SRR15539874;38;32;0.421052631578947;22;16;0.0789473684210527;0.421052631578947
Control.SRR15539874;36;32;0.583333333333333;15;21;0.0833333333333334;0.416666666666667
Control.SRR15539874;29;32;0.448275862068966;16;13;0.0517241379310345;0.448275862068966
Control.SRR15539874;39;32;0.58974358974359;16;23;0.0897435897435898;0.41025641025641
Control.SRR15539874;35;32;0.6;14;21;0.1;0.4
Control.SRR15539874;29;32;0.517241379310345;14;15;0.0172413793103449;0.482758620689655
Control.SRR15539874;39;32;0.512820512820513;19;20;0.0128205128205128;0.487179487179487
Control.SRR15539874;39;32;0.564102564102564;17;22;0.0641025641025641;0.435897435897436
Control.SRR15539874;34;32;0.5;17;17;0;0.5
Control.SRR15539874;31;32;0.548387096774194;14;17;0.0483870967741935;0.451612903225806
Control.SRR15539874;32;32;0.53125;15;17;0.03125;0.46875
Control.SRR15539874;31;32;0.483870967741935;16;15;0.0161290322580645;0.483870967741935
Control.SRR15539874;36;32;0.555555555555556;16;20;0.0555555555555556;0.444444444444444
Control.SRR15539874;33;32;0.545454545454545;15;18;0.0454545454545454;0.454545454545455
Control.SRR15539874;39;32;0.538461538461538;18;21;0.0384615384615384;0.461538461538462
Control.SRR15539874;38;32;0.578947368421053;16;22;0.0789473684210527;0.421052631578947
Control.SRR15539874;34;32;0.5;17;17;0;0.5
Control.SRR15539874;33;32;0.424242424242424;19;14;0.0757575757575757;0.424242424242424
Control.SRR15539874;31;32;0.451612903225806;17;14;0.0483870967741936;0.451612903225806
Control.SRR15539874;31;32;0.451612903225806;17;14;0.0483870967741936;0.451612903225806
Control.SRR15539874;34;32;0.617647058823529;13;21;0.117647058823529;0.382352941176471
Control.SRR15539874;37;32;0.594594594594595;15;22;0.0945945945945946;0.405405405405405
Control.SRR15539874;33;32;0.393939393939394;20;13;0.106060606060606;0.393939393939394
Control.SRR15539874;35;32;0.228571428571429;27;8;0.271428571428571;0.228571428571429
Control.SRR15539874;31;32;0.516129032258065;15;16;0.0161290322580645;0.483870967741935
Control.SRR15539874;36;32;0.527777777777778;17;19;0.0277777777777778;0.472222222222222
Control.SRR15539874;29;32;0.344827586206897;19;10;0.155172413793103;0.344827586206897
Control.SRR15539874;31;32;0.548387096774194;14;17;0.0483870967741935;0.451612903225806
Control.SRR15539874;39;32;0.666666666666667;13;26;0.166666666666667;0.333333333333333
Control.SRR15539874;30;32;0.566666666666667;13;17;0.0666666666666667;0.433333333333333
Control.SRR15539874;34;32;0.529411764705882;16;18;0.0294117647058824;0.470588235294118
Control.SRR15539874;30;32;0.466666666666667;16;14;0.0333333333333333;0.466666666666667
Control.SRR15539874;31;32;0.548387096774194;14;17;0.0483870967741935;0.451612903225806
Control.SRR15539874;39;32;0.461538461538462;21;18;0.0384615384615384;0.461538461538462
Control.SRR15539874;39;32;0.461538461538462;21;18;0.0384615384615384;0.461538461538462
Control.SRR15539874;39;32;0.461538461538462;21;18;0.0384615384615384;0.461538461538462
Control.SRR15539874;36;32;0.5;18;18;0;0.5
Control.SRR15539874;37;32;0.540540540540541;17;20;0.0405405405405406;0.459459459459459
Control.SRR15539874;37;32;0.459459459459459;20;17;0.0405405405405405;0.459459459459459
Control.SRR15539874;36;32;0.583333333333333;15;21;0.0833333333333334;0.416666666666667
Control.SRR15539874;39;32;0.58974358974359;16;23;0.0897435897435898;0.41025641025641
Control.SRR15539874;34;32;0.470588235294118;18;16;0.0294117647058824;0.470588235294118
Control.SRR15539874;33;32;0.575757575757576;14;19;0.0757575757575758;0.424242424242424
Control.SRR15539874;31;32;0.451612903225806;17;14;0.0483870967741936;0.451612903225806
Control.SRR15539874;30;32;0.533333333333333;14;16;0.0333333333333333;0.466666666666667
Control.SRR15539874;30;32;0.566666666666667;13;17;0.0666666666666667;0.433333333333333
Control.SRR15539874;39;32;0.435897435897436;22;17;0.0641025641025641;0.435897435897436
Control.SRR15539874;35;32;0.514285714285714;17;18;0.0142857142857142;0.485714285714286
Control.SRR15539874;37;32;0.594594594594595;15;22;0.0945945945945946;0.405405405405405
Control.SRR15539874;34;32;0.617647058823529;13;21;0.117647058823529;0.382352941176471
Control.SRR15539874;33;32;0.545454545454545;15;18;0.0454545454545454;0.454545454545455
Control.SRR15539874;33;32;0.515151515151515;16;17;0.0151515151515151;0.484848484848485
Control.SRR15539874;32;32;0.53125;15;17;0.03125;0.46875
Control.SRR15539874;36;32;0.555555555555556;16;20;0.0555555555555556;0.444444444444444
Control.SRR15539874;38;32;0.578947368421053;16;22;0.0789473684210527;0.421052631578947
Control.SRR15539874;39;32;0.461538461538462;21;18;0.0384615384615384;0.461538461538462
Control.SRR15539874;34;32;0.5;17;17;0;0.5
Control.SRR15539874;32;32;0.5625;14;18;0.0625;0.4375
Control.SRR15539874;38;32;0.552631578947368;17;21;0.0526315789473685;0.447368421052632
Control.SRR15539874;33;32;0.424242424242424;19;14;0.0757575757575757;0.424242424242424
Control.SRR15539874;34;32;0.411764705882353;20;14;0.0882352941176471;0.411764705882353
Control.SRR15539874;37;32;0.540540540540541;17;20;0.0405405405405406;0.459459459459459
Control.SRR15539874;36;32;0.583333333333333;15;21;0.0833333333333334;0.416666666666667
Control.SRR15539874;33;32;0.575757575757576;14;19;0.0757575757575758;0.424242424242424
Control.SRR15539874;33;32;0.454545454545455;18;15;0.0454545454545455;0.454545454545455
Control.SRR15539874;34;32;0.647058823529412;12;22;0.147058823529412;0.352941176470588
Control.SRR15539874;38;32;0.394736842105263;23;15;0.105263157894737;0.394736842105263
Control.SRR15539874;38;32;0.447368421052632;21;17;0.0526315789473684;0.447368421052632
Control.SRR15539874;38;32;0.552631578947368;17;21;0.0526315789473685;0.447368421052632
Control.SRR15539874;33;32;0.424242424242424;19;14;0.0757575757575757;0.424242424242424
Control.SRR15539874;32;32;0.5;16;16;0;0.5
Control.SRR15539874;33;32;0.484848484848485;17;16;0.0151515151515151;0.484848484848485
Control.SRR15539874;33;32;0.363636363636364;21;12;0.136363636363636;0.363636363636364
Control.SRR15539874;37;32;0.594594594594595;15;22;0.0945945945945946;0.405405405405405
Control.SRR15539874;37;32;0.432432432432432;21;16;0.0675675675675675;0.432432432432432
Control.SRR15539874;36;32;0.5;18;18;0;0.5
Control.SRR15539874;37;32;0.594594594594595;15;22;0.0945945945945946;0.405405405405405
Control.SRR15539874;34;32;0.470588235294118;18;16;0.0294117647058824;0.470588235294118
Control.SRR15539874;38;32;0.578947368421053;16;22;0.0789473684210527;0.421052631578947
Control.SRR15539874;35;32;0.571428571428571;15;20;0.0714285714285714;0.428571428571429
Control.SRR15539874;32;32;0.59375;13;19;0.09375;0.40625
Control.SRR15539874;32;32;0.5625;14;18;0.0625;0.4375
Control.SRR15539874;33;32;0.424242424242424;19;14;0.0757575757575757;0.424242424242424
Control.SRR15539874;30;32;0.533333333333333;14;16;0.0333333333333333;0.466666666666667
Control.SRR15539874;33;32;0.575757575757576;14;19;0.0757575757575758;0.424242424242424
Control.SRR15539874;29;32;0.482758620689655;15;14;0.0172413793103448;0.482758620689655
Control.SRR15539874;31;32;0.483870967741935;16;15;0.0161290322580645;0.483870967741935
Control.SRR15539874;32;32;0.59375;13;19;0.09375;0.40625
Control.SRR15539874;34;32;0.5;17;17;0;0.5
Control.SRR15539874;32;32;0.625;12;20;0.125;0.375
Control.SRR15539874;31;32;0.516129032258065;15;16;0.0161290322580645;0.483870967741935
Control.SRR15539874;35;32;0.6;14;21;0.1;0.4
Control.SRR15539874;35;32;0.4;21;14;0.1;0.4
Control.SRR15539874;37;32;0.540540540540541;17;20;0.0405405405405406;0.459459459459459
Control.SRR15539874;37;32;0.486486486486487;19;18;0.0135135135135135;0.486486486486487
Control.SRR15539874;35;32;0.571428571428571;15;20;0.0714285714285714;0.428571428571429
Control.SRR15539874;36;32;0.527777777777778;17;19;0.0277777777777778;0.472222222222222
Control.SRR15539874;39;32;0.512820512820513;19;20;0.0128205128205128;0.487179487179487
Control.SRR15539874;39;32;0.435897435897436;22;17;0.0641025641025641;0.435897435897436
Control.SRR15539874;39;32;0.333333333333333;26;13;0.166666666666667;0.333333333333333
Control.SRR15539874;30;32;0.6;12;18;0.1;0.4
Control.SRR15539874;35;32;0.457142857142857;19;16;0.0428571428571429;0.457142857142857
Control.SRR15539874;39;32;0.538461538461538;18;21;0.0384615384615384;0.461538461538462
Control.SRR15539874;32;32;0.5;16;16;0;0.5
Control.SRR15539874;35;32;0.542857142857143;16;19;0.0428571428571428;0.457142857142857
Control.SRR15539874;35;32;0.428571428571429;20;15;0.0714285714285715;0.428571428571429
Control.SRR15539874;39;32;0.435897435897436;22;17;0.0641025641025641;0.435897435897436
Control.SRR15539874;29;32;0.551724137931034;13;16;0.0517241379310345;0.448275862068966
Control.SRR15539874;34;32;0.5;17;17;0;0.5
Control.SRR15539874;32;32;0.5;16;16;0;0.5
Control.SRR15539874;35;32;0.428571428571429;20;15;0.0714285714285715;0.428571428571429
Control.SRR15539874;36;32;0.5;18;18;0;0.5
Control.SRR15539874;31;32;0.516129032258065;15;16;0.0161290322580645;0.483870967741935
Control.SRR15539874;32;32;0.5625;14;18;0.0625;0.4375
Control.SRR15539874;32;32;0.46875;17;15;0.03125;0.46875
Control.SRR15539874;31;32;0.580645161290323;13;18;0.0806451612903226;0.419354838709677
Control.SRR15539874;36;32;0.472222222222222;19;17;0.0277777777777778;0.472222222222222
Control.SRR15539874;37;32;0.486486486486487;19;18;0.0135135135135135;0.486486486486487
Control.SRR15539874;35;32;0.542857142857143;16;19;0.0428571428571428;0.457142857142857
Control.SRR15539874;37;32;0.513513513513513;18;19;0.0135135135135135;0.486486486486487
Control.SRR15539874;33;32;0.515151515151515;16;17;0.0151515151515151;0.484848484848485
Control.SRR15539874;34;32;0.529411764705882;16;18;0.0294117647058824;0.470588235294118
Control.SRR15539874;31;32;0.419354838709677;18;13;0.0806451612903226;0.419354838709677
Control.SRR15539874;34;32;0.441176470588235;19;15;0.0588235294117647;0.441176470588235
Control.SRR15539874;29;32;0.517241379310345;14;15;0.0172413793103449;0.482758620689655
Control.SRR15539874;31;32;0.548387096774194;14;17;0.0483870967741935;0.451612903225806
Control.SRR15539874;32;32;0.4375;18;14;0.0625;0.4375
Control.SRR15539874;37;32;0.432432432432432;21;16;0.0675675675675675;0.432432432432432
Control.SRR15539874;37;32;0.675675675675676;12;25;0.175675675675676;0.324324324324324
Control.SRR15539874;34;32;0.676470588235294;11;23;0.176470588235294;0.323529411764706
Control.SRR15539874;38;32;0.473684210526316;20;18;0.0263157894736842;0.473684210526316
Control.SRR15539874;37;32;0.648648648648649;13;24;0.148648648648649;0.351351351351351
Control.SRR15539874;38;32;0.578947368421053;16;22;0.0789473684210527;0.421052631578947
Control.SRR15539874;32;32;0.40625;19;13;0.09375;0.40625
Control.SRR15539874;36;32;0.583333333333333;15;21;0.0833333333333334;0.416666666666667
Control.SRR15539874;34;32;0.647058823529412;12;22;0.147058823529412;0.352941176470588
Control.SRR15539874;36;32;0.5;18;18;0;0.5
Control.SRR15539874;33;32;0.545454545454545;15;18;0.0454545454545454;0.454545454545455
Control.SRR15539874;32;32;0.5625;14;18;0.0625;0.4375
Control.SRR15539874;36;32;0.555555555555556;16;20;0.0555555555555556;0.444444444444444
Control.SRR15539874;33;32;0.393939393939394;20;13;0.106060606060606;0.393939393939394
Control.SRR15539874;39;32;0.384615384615385;24;15;0.115384615384615;0.384615384615385
Control.SRR15539874;31;32;0.516129032258065;15;16;0.0161290322580645;0.483870967741935
Control.SRR15539874;29;32;0.586206896551724;12;17;0.0862068965517241;0.413793103448276
Control.SRR15539874;36;32;0.583333333333333;15;21;0.0833333333333334;0.416666666666667
Control.SRR15539874;34;32;0.529411764705882;16;18;0.0294117647058824;0.470588235294118
Control.SRR15539874;39;32;0.538461538461538;18;21;0.0384615384615384;0.461538461538462
Control.SRR15539874;33;32;0.424242424242424;19;14;0.0757575757575757;0.424242424242424
Control.SRR15539874;32;32;0.5625;14;18;0.0625;0.4375
Control.SRR15539874;36;32;0.444444444444444;20;16;0.0555555555555556;0.444444444444444
Control.SRR15539874;36;32;0.5;18;18;0;0.5
Control.SRR15539874;35;32;0.571428571428571;15;20;0.0714285714285714;0.428571428571429
Control.SRR15539874;35;32;0.485714285714286;18;17;0.0142857142857143;0.485714285714286
Control.SRR15539874;33;32;0.515151515151515;16;17;0.0151515151515151;0.484848484848485
Control.SRR15539874;32;32;0.53125;15;17;0.03125;0.46875
Control.SRR15539874;39;32;0.282051282051282;28;11;0.217948717948718;0.282051282051282
Control.SRR15539874;34;32;0.588235294117647;14;20;0.0882352941176471;0.411764705882353
Control.SRR15539874;33;32;0.424242424242424;19;14;0.0757575757575757;0.424242424242424
Control.SRR15539874;30;32;0.6;12;18;0.1;0.4
Control.SRR15539874;36;32;0.611111111111111;14;22;0.111111111111111;0.388888888888889
Control.SRR15539874;37;32;0.459459459459459;20;17;0.0405405405405405;0.459459459459459
Control.SRR15539874;30;32;0.633333333333333;11;19;0.133333333333333;0.366666666666667
Control.SRR15539874;36;32;0.527777777777778;17;19;0.0277777777777778;0.472222222222222
Control.SRR15539874;38;32;0.394736842105263;23;15;0.105263157894737;0.394736842105263
Control.SRR15539874;33;32;0.393939393939394;20;13;0.106060606060606;0.393939393939394
Control.SRR15539874;33;32;0.606060606060606;13;20;0.106060606060606;0.393939393939394
Control.SRR15539874;39;32;0.564102564102564;17;22;0.0641025641025641;0.435897435897436
Control.SRR15539874;30;32;0.433333333333333;17;13;0.0666666666666667;0.433333333333333
Control.SRR15539874;38;32;0.473684210526316;20;18;0.0263157894736842;0.473684210526316
Control.SRR15539874;35;32;0.542857142857143;16;19;0.0428571428571428;0.457142857142857
Control.SRR15539874;36;32;0.472222222222222;19;17;0.0277777777777778;0.472222222222222
Control.SRR15539874;29;32;0.448275862068966;16;13;0.0517241379310345;0.448275862068966
Control.SRR15539874;36;32;0.638888888888889;13;23;0.138888888888889;0.361111111111111
Control.SRR15539874;33;32;0.515151515151515;16;17;0.0151515151515151;0.484848484848485
Control.SRR15539874;38;32;0.552631578947368;17;21;0.0526315789473685;0.447368421052632
Control.SRR15539874;37;32;0.540540540540541;17;20;0.0405405405405406;0.459459459459459
Control.SRR15539874;37;32;0.486486486486487;19;18;0.0135135135135135;0.486486486486487
Control.SRR15539874;39;32;0.615384615384615;15;24;0.115384615384615;0.384615384615385
Control.SRR15539874;30;32;0.5;15;15;0;0.5
Control.SRR15539874;37;32;0.567567567567568;16;21;0.0675675675675675;0.432432432432432
Control.SRR15539874;38;32;0.552631578947368;17;21;0.0526315789473685;0.447368421052632
Control.SRR15539874;35;32;0.428571428571429;20;15;0.0714285714285715;0.428571428571429
Control.SRR15539874;31;32;0.451612903225806;17;14;0.0483870967741936;0.451612903225806
Control.SRR15539874;33;32;0.606060606060606;13;20;0.106060606060606;0.393939393939394
Control.SRR15539874;30;32;0.5;15;15;0;0.5
Control.SRR15539874;33;32;0.424242424242424;19;14;0.0757575757575757;0.424242424242424
Control.SRR15539874;30;32;0.433333333333333;17;13;0.0666666666666667;0.433333333333333
Control.SRR15539874;29;32;0.517241379310345;14;15;0.0172413793103449;0.482758620689655
Control.SRR15539874;34;32;0.441176470588235;19;15;0.0588235294117647;0.441176470588235
Control.SRR15539874;33;32;0.484848484848485;17;16;0.0151515151515151;0.484848484848485
Control.SRR15539874;35;32;0.6;14;21;0.1;0.4
Control.SRR15539874;30;32;0.4;18;12;0.1;0.4
Control.SRR15539874;30;32;0.633333333333333;11;19;0.133333333333333;0.366666666666667
Control.SRR15539874;32;32;0.46875;17;15;0.03125;0.46875
Control.SRR15539874;38;32;0.526315789473684;18;20;0.0263157894736842;0.473684210526316
Control.SRR15539874;29;32;0.379310344827586;18;11;0.120689655172414;0.379310344827586
Control.SRR15539874;29;32;0.517241379310345;14;15;0.0172413793103449;0.482758620689655
Control.SRR15539874;34;32;0.5;17;17;0;0.5
Control.SRR15539874;35;32;0.542857142857143;16;19;0.0428571428571428;0.457142857142857
Control.SRR15539874;33;32;0.454545454545455;18;15;0.0454545454545455;0.454545454545455
Control.SRR15539874;32;32;0.375;20;12;0.125;0.375
Control.SRR15539874;39;32;0.512820512820513;19;20;0.0128205128205128;0.487179487179487
Control.SRR15539874;32;32;0.5;16;16;0;0.5
Control.SRR15539874;32;32;0.59375;13;19;0.09375;0.40625
Control.SRR15539874;35;32;0.514285714285714;17;18;0.0142857142857142;0.485714285714286
Control.SRR15539874;33;32;0.454545454545455;18;15;0.0454545454545455;0.454545454545455
Control.SRR15539874;34;32;0.5;17;17;0;0.5
Control.SRR15539874;33;32;0.424242424242424;19;14;0.0757575757575757;0.424242424242424
Control.SRR15539874;32;32;0.5;16;16;0;0.5
Control.SRR15539874;31;32;0.483870967741935;16;15;0.0161290322580645;0.483870967741935
Control.SRR15539874;32;32;0.46875;17;15;0.03125;0.46875
Control.SRR15539874;35;32;0.628571428571429;13;22;0.128571428571429;0.371428571428571
Control.SRR15539874;29;32;0.344827586206897;19;10;0.155172413793103;0.344827586206897
Control.SRR15539874;38;32;0.368421052631579;24;14;0.131578947368421;0.368421052631579
Control.SRR15539874;36;32;0.333333333333333;24;12;0.166666666666667;0.333333333333333
Control.SRR15539874;38;32;0.421052631578947;22;16;0.0789473684210527;0.421052631578947
Control.SRR15539874;35;32;0.485714285714286;18;17;0.0142857142857143;0.485714285714286
Control.SRR15539874;35;32;0.542857142857143;16;19;0.0428571428571428;0.457142857142857
Control.SRR15539874;29;32;0.724137931034483;8;21;0.224137931034483;0.275862068965517
Control.SRR15539874;31;32;0.645161290322581;11;20;0.145161290322581;0.354838709677419
Control.SRR15539874;30;32;0.5;15;15;0;0.5
Control.SRR15539874;37;32;0.459459459459459;20;17;0.0405405405405405;0.459459459459459
Control.SRR15539874;39;32;0.41025641025641;23;16;0.0897435897435898;0.41025641025641
Control.SRR15539874;32;32;0.65625;11;21;0.15625;0.34375
Control.SRR15539874;34;32;0.5;17;17;0;0.5
Control.SRR15539874;33;32;0.515151515151515;16;17;0.0151515151515151;0.484848484848485
Control.SRR15539874;36;32;0.361111111111111;23;13;0.138888888888889;0.361111111111111
Control.SRR15539874;35;32;0.514285714285714;17;18;0.0142857142857142;0.485714285714286
Control.SRR15539874;30;32;0.633333333333333;11;19;0.133333333333333;0.366666666666667
Control.SRR15539874;35;32;0.457142857142857;19;16;0.0428571428571429;0.457142857142857
Control.SRR15539874;37;32;0.486486486486487;19;18;0.0135135135135135;0.486486486486487
Control.SRR15539874;31;32;0.516129032258065;15;16;0.0161290322580645;0.483870967741935
Control.SRR15539874;32;32;0.71875;9;23;0.21875;0.28125
Control.SRR15539874;34;32;0.264705882352941;25;9;0.235294117647059;0.264705882352941
Control.SRR15539874;32;32;0.40625;19;13;0.09375;0.40625
Control.SRR15539874;34;32;0.5;17;17;0;0.5
Control.SRR15539874;31;32;0.548387096774194;14;17;0.0483870967741935;0.451612903225806
Control.SRR15539874;30;32;0.466666666666667;16;14;0.0333333333333333;0.466666666666667
Control.SRR15539874;29;32;0.551724137931034;13;16;0.0517241379310345;0.448275862068966
Control.SRR15539874;34;32;0.647058823529412;12;22;0.147058823529412;0.352941176470588
Control.SRR15539874;33;32;0.454545454545455;18;15;0.0454545454545455;0.454545454545455
Control.SRR15539874;33;32;0.484848484848485;17;16;0.0151515151515151;0.484848484848485
Control.SRR15539874;39;32;0.461538461538462;21;18;0.0384615384615384;0.461538461538462
Control.SRR15539874;30;32;0.633333333333333;11;19;0.133333333333333;0.366666666666667
Control.SRR15539874;36;32;0.444444444444444;20;16;0.0555555555555556;0.444444444444444
Control.SRR15539874;37;32;0.540540540540541;17;20;0.0405405405405406;0.459459459459459
Control.SRR15539874;37;32;0.459459459459459;20;17;0.0405405405405405;0.459459459459459
Control.SRR15539874;35;32;0.457142857142857;19;16;0.0428571428571429;0.457142857142857
Control.SRR15539874;37;32;0.459459459459459;20;17;0.0405405405405405;0.459459459459459
Control.SRR15539874;31;32;0.483870967741935;16;15;0.0161290322580645;0.483870967741935
Control.SRR15539874;33;32;0.484848484848485;17;16;0.0151515151515151;0.484848484848485
Control.SRR15539874;35;32;0.571428571428571;15;20;0.0714285714285714;0.428571428571429
Control.SRR15539874;39;32;0.512820512820513;19;20;0.0128205128205128;0.487179487179487
Control.SRR15539874;38;32;0.473684210526316;20;18;0.0263157894736842;0.473684210526316
Control.SRR15539874;30;32;0.466666666666667;16;14;0.0333333333333333;0.466666666666667
Control.SRR15539874;33;32;0.515151515151515;16;17;0.0151515151515151;0.484848484848485
Control.SRR15539874;30;32;0.566666666666667;13;17;0.0666666666666667;0.433333333333333
Control.SRR15539874;32;32;0.5625;14;18;0.0625;0.4375
Control.SRR15539874;31;32;0.451612903225806;17;14;0.0483870967741936;0.451612903225806
Control.SRR15539874;34;32;0.617647058823529;13;21;0.117647058823529;0.382352941176471
Control.SRR15539874;31;32;0.290322580645161;22;9;0.209677419354839;0.290322580645161
Control.SRR15539874;38;32;0.631578947368421;14;24;0.131578947368421;0.368421052631579
Control.SRR15539874;33;32;0.545454545454545;15;18;0.0454545454545454;0.454545454545455
Control.SRR15539874;39;32;0.538461538461538;18;21;0.0384615384615384;0.461538461538462
Control.SRR15539874;36;32;0.361111111111111;23;13;0.138888888888889;0.361111111111111
Control.SRR15539874;37;32;0.567567567567568;16;21;0.0675675675675675;0.432432432432432
Control.SRR15539874;33;32;0.515151515151515;16;17;0.0151515151515151;0.484848484848485
Control.SRR15539874;29;32;0.379310344827586;18;11;0.120689655172414;0.379310344827586
Control.SRR15539874;37;32;0.378378378378378;23;14;0.121621621621622;0.378378378378378
Control.SRR15539874;33;32;0.393939393939394;20;13;0.106060606060606;0.393939393939394
Control.SRR15539874;32;32;0.40625;19;13;0.09375;0.40625
Control.SRR15539874;36;32;0.472222222222222;19;17;0.0277777777777778;0.472222222222222
Control.SRR15539874;36;32;0.5;18;18;0;0.5
Control.SRR15539874;30;32;0.466666666666667;16;14;0.0333333333333333;0.466666666666667
Control.SRR15539874;37;32;0.459459459459459;20;17;0.0405405405405405;0.459459459459459
Control.SRR15539874;33;32;0.363636363636364;21;12;0.136363636363636;0.363636363636364
Control.SRR15539874;32;32;0.4375;18;14;0.0625;0.4375
Control.SRR15539874;36;32;0.555555555555556;16;20;0.0555555555555556;0.444444444444444
Control.SRR15539874;37;32;0.297297297297297;26;11;0.202702702702703;0.297297297297297
Control.SRR15539874;38;32;0.421052631578947;22;16;0.0789473684210527;0.421052631578947
Control.SRR15539874;34;32;0.529411764705882;16;18;0.0294117647058824;0.470588235294118
Control.SRR15539874;33;32;0.575757575757576;14;19;0.0757575757575758;0.424242424242424
Control.SRR15539874;32;32;0.4375;18;14;0.0625;0.4375
Control.SRR15539874;29;32;0.413793103448276;17;12;0.0862068965517241;0.413793103448276
Control.SRR15539874;39;32;0.461538461538462;21;18;0.0384615384615384;0.461538461538462
Control.SRR15539874;35;32;0.4;21;14;0.1;0.4
Control.SRR15539874;35;32;0.371428571428571;22;13;0.128571428571429;0.371428571428571
Control.SRR15539874;35;32;0.485714285714286;18;17;0.0142857142857143;0.485714285714286
Control.SRR15539874;36;32;0.388888888888889;22;14;0.111111111111111;0.388888888888889
Control.SRR15539874;29;32;0.344827586206897;19;10;0.155172413793103;0.344827586206897
Control.SRR15539874;33;32;0.393939393939394;20;13;0.106060606060606;0.393939393939394
Control.SRR15539874;35;32;0.371428571428571;22;13;0.128571428571429;0.371428571428571
Control.SRR15539874;39;32;0.538461538461538;18;21;0.0384615384615384;0.461538461538462
Control.SRR15539874;38;32;0.447368421052632;21;17;0.0526315789473684;0.447368421052632
Control.SRR15539874;39;32;0.58974358974359;16;23;0.0897435897435898;0.41025641025641
Control.SRR15539874;39;32;0.538461538461538;18;21;0.0384615384615384;0.461538461538462
Control.SRR15539874;38;32;0.394736842105263;23;15;0.105263157894737;0.394736842105263
Control.SRR15539874;38;32;0.605263157894737;15;23;0.105263157894737;0.394736842105263
Control.SRR15539874;36;32;0.444444444444444;20;16;0.0555555555555556;0.444444444444444
Control.SRR15539874;30;32;0.333333333333333;20;10;0.166666666666667;0.333333333333333
Control.SRR15539874;36;32;0.583333333333333;15;21;0.0833333333333334;0.416666666666667
Control.SRR15539874;32;32;0.53125;15;17;0.03125;0.46875
Control.SRR15539874;34;32;0.470588235294118;18;16;0.0294117647058824;0.470588235294118
Control.SRR15539874;33;32;0.575757575757576;14;19;0.0757575757575758;0.424242424242424
Control.SRR15539874;32;32;0.53125;15;17;0.03125;0.46875
Control.SRR15539874;32;32;0.46875;17;15;0.03125;0.46875
Control.SRR15539874;34;32;0.470588235294118;18;16;0.0294117647058824;0.470588235294118
Control.SRR15539874;29;32;0.413793103448276;17;12;0.0862068965517241;0.413793103448276
Control.SRR15539874;34;32;0.441176470588235;19;15;0.0588235294117647;0.441176470588235
Control.SRR15539874;30;32;0.666666666666667;10;20;0.166666666666667;0.333333333333333
Control.SRR15539874;36;32;0.416666666666667;21;15;0.0833333333333333;0.416666666666667
Control.SRR15539874;33;32;0.484848484848485;17;16;0.0151515151515151;0.484848484848485
Control.SRR15539874;39;32;0.512820512820513;19;20;0.0128205128205128;0.487179487179487
Control.SRR15539874;30;32;0.433333333333333;17;13;0.0666666666666667;0.433333333333333
Control.SRR15539874;38;32;0.473684210526316;20;18;0.0263157894736842;0.473684210526316
Control.SRR15539874;33;32;0.636363636363636;12;21;0.136363636363636;0.363636363636364
Control.SRR15539874;34;32;0.5;17;17;0;0.5
Control.SRR15539874;33;32;0.545454545454545;15;18;0.0454545454545454;0.454545454545455
Control.SRR15539874;29;32;0.482758620689655;15;14;0.0172413793103448;0.482758620689655
Control.SRR15539874;34;32;0.323529411764706;23;11;0.176470588235294;0.323529411764706
Control.SRR15539874;31;32;0.516129032258065;15;16;0.0161290322580645;0.483870967741935
Control.SRR15539874;34;32;0.558823529411765;15;19;0.0588235294117647;0.441176470588235
Control.SRR15539874;32;32;0.375;20;12;0.125;0.375
Control.SRR15539874;35;32;0.485714285714286;18;17;0.0142857142857143;0.485714285714286
Control.SRR15539874;36;32;0.5;18;18;0;0.5
Control.SRR15539874;31;32;0.516129032258065;15;16;0.0161290322580645;0.483870967741935
Control.SRR15539874;34;32;0.470588235294118;18;16;0.0294117647058824;0.470588235294118
Control.SRR15539874;32;32;0.5;16;16;0;0.5
Control.SRR15539874;31;32;0.387096774193548;19;12;0.112903225806452;0.387096774193548
Control.SRR15539874;36;32;0.611111111111111;14;22;0.111111111111111;0.388888888888889
Control.SRR15539874;31;32;0.483870967741935;16;15;0.0161290322580645;0.483870967741935
Control.SRR15539874;34;32;0.558823529411765;15;19;0.0588235294117647;0.441176470588235
Control.SRR15539874;36;32;0.583333333333333;15;21;0.0833333333333334;0.416666666666667
Control.SRR15539874;32;32;0.53125;15;17;0.03125;0.46875
Control.SRR15539874;37;32;0.567567567567568;16;21;0.0675675675675675;0.432432432432432
Control.SRR15539874;34;32;0.382352941176471;21;13;0.117647058823529;0.382352941176471
Control.SRR15539874;34;32;0.382352941176471;21;13;0.117647058823529;0.382352941176471
Control.SRR15539874;38;32;0.552631578947368;17;21;0.0526315789473685;0.447368421052632
Control.SRR15539874;37;32;0.486486486486487;19;18;0.0135135135135135;0.486486486486487
Control.SRR15539874;29;32;0.517241379310345;14;15;0.0172413793103449;0.482758620689655
Control.SRR15539874;38;32;0.631578947368421;14;24;0.131578947368421;0.368421052631579
Control.SRR15539874;34;32;0.352941176470588;22;12;0.147058823529412;0.352941176470588
Control.SRR15539874;32;32;0.5;16;16;0;0.5
Control.SRR15539874;36;32;0.527777777777778;17;19;0.0277777777777778;0.472222222222222
Control.SRR15539874;33;32;0.454545454545455;18;15;0.0454545454545455;0.454545454545455
Control.SRR15539874;38;32;0.578947368421053;16;22;0.0789473684210527;0.421052631578947
Control.SRR15539874;32;32;0.34375;21;11;0.15625;0.34375
Control.SRR15539874;35;32;0.428571428571429;20;15;0.0714285714285715;0.428571428571429
Control.SRR15539874;38;32;0.342105263157895;25;13;0.157894736842105;0.342105263157895
Control.SRR15539874;39;32;0.384615384615385;24;15;0.115384615384615;0.384615384615385
Control.SRR15539874;33;32;0.606060606060606;13;20;0.106060606060606;0.393939393939394
Control.SRR15539874;34;32;0.558823529411765;15;19;0.0588235294117647;0.441176470588235
Control.SRR15539874;32;32;0.5625;14;18;0.0625;0.4375
Control.SRR15539874;32;32;0.34375;21;11;0.15625;0.34375
Control.SRR15539874;33;32;0.606060606060606;13;20;0.106060606060606;0.393939393939394
Control.SRR15539874;35;32;0.6;14;21;0.1;0.4
Control.SRR15539874;29;32;0.655172413793103;10;19;0.155172413793103;0.344827586206897
Control.SRR15539874;34;32;0.470588235294118;18;16;0.0294117647058824;0.470588235294118
Control.SRR15539874;32;32;0.5625;14;18;0.0625;0.4375
Control.SRR15539874;30;32;0.533333333333333;14;16;0.0333333333333333;0.466666666666667
Control.SRR15539874;29;32;0.517241379310345;14;15;0.0172413793103449;0.482758620689655
Control.SRR15539874;30;32;0.266666666666667;22;8;0.233333333333333;0.266666666666667
Control.SRR15539874;39;32;0.538461538461538;18;21;0.0384615384615384;0.461538461538462
Control.SRR15539874;29;32;0.482758620689655;15;14;0.0172413793103448;0.482758620689655
Control.SRR15539874;36;32;0.472222222222222;19;17;0.0277777777777778;0.472222222222222
Control.SRR15539874;30;32;0.5;15;15;0;0.5
Control.SRR15539874;35;32;0.542857142857143;16;19;0.0428571428571428;0.457142857142857
Control.SRR15539874;32;32;0.5;16;16;0;0.5
Control.SRR15539874;31;32;0.419354838709677;18;13;0.0806451612903226;0.419354838709677
Control.SRR15539874;36;32;0.5;18;18;0;0.5
Control.SRR15539874;33;32;0.606060606060606;13;20;0.106060606060606;0.393939393939394
Control.SRR15539874;31;32;0.451612903225806;17;14;0.0483870967741936;0.451612903225806
Control.SRR15539874;32;32;0.3125;22;10;0.1875;0.3125
Control.SRR15539874;31;32;0.483870967741935;16;15;0.0161290322580645;0.483870967741935
Control.SRR15539874;36;32;0.555555555555556;16;20;0.0555555555555556;0.444444444444444
Control.SRR15539874;37;32;0.594594594594595;15;22;0.0945945945945946;0.405405405405405
Control.SRR15539874;33;32;0.454545454545455;18;15;0.0454545454545455;0.454545454545455
Control.SRR15539874;33;32;0.515151515151515;16;17;0.0151515151515151;0.484848484848485
Control.SRR15539874;38;32;0.447368421052632;21;17;0.0526315789473684;0.447368421052632
Control.SRR15539874;37;32;0.405405405405405;22;15;0.0945945945945946;0.405405405405405
Control.SRR15539874;31;32;0.645161290322581;11;20;0.145161290322581;0.354838709677419
Control.SRR15539874;35;32;0.542857142857143;16;19;0.0428571428571428;0.457142857142857
Control.SRR15539874;33;32;0.666666666666667;11;22;0.166666666666667;0.333333333333333
Control.SRR15539874;34;32;0.470588235294118;18;16;0.0294117647058824;0.470588235294118
Control.SRR15539874;32;32;0.46875;17;15;0.03125;0.46875
Control.SRR15539874;35;32;0.514285714285714;17;18;0.0142857142857142;0.485714285714286
Control.SRR15539874;37;32;0.513513513513513;18;19;0.0135135135135135;0.486486486486487
Control.SRR15539874;35;32;0.342857142857143;23;12;0.157142857142857;0.342857142857143
Control.SRR15539874;34;32;0.441176470588235;19;15;0.0588235294117647;0.441176470588235
Control.SRR15539874;38;32;0.605263157894737;15;23;0.105263157894737;0.394736842105263
Control.SRR15539874;35;32;0.342857142857143;23;12;0.157142857142857;0.342857142857143
Control.SRR15539874;30;32;0.533333333333333;14;16;0.0333333333333333;0.466666666666667
Control.SRR15539874;35;32;0.428571428571429;20;15;0.0714285714285715;0.428571428571429
Control.SRR15539874;33;32;0.393939393939394;20;13;0.106060606060606;0.393939393939394
Control.SRR15539874;31;32;0.645161290322581;11;20;0.145161290322581;0.354838709677419
Control.SRR15539874;39;32;0.692307692307692;12;27;0.192307692307692;0.307692307692308
Control.SRR15539874;38;32;0.5;19;19;0;0.5
Control.SRR15539874;38;32;0.394736842105263;23;15;0.105263157894737;0.394736842105263
Control.SRR15539874;32;32;0.53125;15;17;0.03125;0.46875
Control.SRR15539874;29;32;0.241379310344828;22;7;0.258620689655172;0.241379310344828
Control.SRR15539874;32;32;0.53125;15;17;0.03125;0.46875
Control.SRR15539874;35;32;0.371428571428571;22;13;0.128571428571429;0.371428571428571
Control.SRR15539874;32;32;0.4375;18;14;0.0625;0.4375
Control.SRR15539874;32;32;0.5625;14;18;0.0625;0.4375
Control.SRR15539874;34;32;0.588235294117647;14;20;0.0882352941176471;0.411764705882353
Control.SRR15539874;33;32;0.424242424242424;19;14;0.0757575757575757;0.424242424242424
Control.SRR15539874;38;32;0.5;19;19;0;0.5
Control.SRR15539874;30;32;0.4;18;12;0.1;0.4
Control.SRR15539874;34;32;0.5;17;17;0;0.5
Control.SRR15539874;30;32;0.4;18;12;0.1;0.4
Control.SRR15539874;33;32;0.666666666666667;11;22;0.166666666666667;0.333333333333333
Control.SRR15539874;38;32;0.447368421052632;21;17;0.0526315789473684;0.447368421052632
Control.SRR15539874;34;32;0.470588235294118;18;16;0.0294117647058824;0.470588235294118
Control.SRR15539874;37;32;0.432432432432432;21;16;0.0675675675675675;0.432432432432432
Control.SRR15539874;31;32;0.290322580645161;22;9;0.209677419354839;0.290322580645161
Control.SRR15539874;32;32;0.53125;15;17;0.03125;0.46875
Control.SRR15539874;35;32;0.542857142857143;16;19;0.0428571428571428;0.457142857142857
Control.SRR15539874;33;32;0.454545454545455;18;15;0.0454545454545455;0.454545454545455
Control.SRR15539874;34;32;0.588235294117647;14;20;0.0882352941176471;0.411764705882353
Control.SRR15539874;37;32;0.486486486486487;19;18;0.0135135135135135;0.486486486486487
Control.SRR15539874;30;32;0.466666666666667;16;14;0.0333333333333333;0.466666666666667
Control.SRR15539874;34;32;0.441176470588235;19;15;0.0588235294117647;0.441176470588235
Control.SRR15539874;30;32;0.566666666666667;13;17;0.0666666666666667;0.433333333333333
Control.SRR15539874;31;32;0.225806451612903;24;7;0.274193548387097;0.225806451612903
Control.SRR15539874;32;32;0.5625;14;18;0.0625;0.4375
Control.SRR15539874;38;32;0.684210526315789;12;26;0.184210526315789;0.315789473684211
Control.SRR15539874;33;32;0.393939393939394;20;13;0.106060606060606;0.393939393939394
Control.SRR15539874;30;32;0.6;12;18;0.1;0.4
Control.SRR15539874;34;32;0.352941176470588;22;12;0.147058823529412;0.352941176470588
Control.SRR15539874;34;32;0.441176470588235;19;15;0.0588235294117647;0.441176470588235
Control.SRR15539874;38;32;0.473684210526316;20;18;0.0263157894736842;0.473684210526316
Control.SRR15539874;35;32;0.514285714285714;17;18;0.0142857142857142;0.485714285714286
Control.SRR15539874;35;32;0.542857142857143;16;19;0.0428571428571428;0.457142857142857
Control.SRR15539874;36;32;0.444444444444444;20;16;0.0555555555555556;0.444444444444444
Control.SRR15539874;39;32;0.435897435897436;22;17;0.0641025641025641;0.435897435897436
Control.SRR15539874;32;32;0.53125;15;17;0.03125;0.46875
Control.SRR15539874;32;32;0.5625;14;18;0.0625;0.4375
Control.SRR15539874;30;32;0.466666666666667;16;14;0.0333333333333333;0.466666666666667
Control.SRR15539874;33;32;0.575757575757576;14;19;0.0757575757575758;0.424242424242424
Control.SRR15539874;32;32;0.59375;13;19;0.09375;0.40625
Control.SRR15539874;33;32;0.424242424242424;19;14;0.0757575757575757;0.424242424242424
Control.SRR15539874;32;32;0.5;16;16;0;0.5
Control.SRR15539874;33;32;0.515151515151515;16;17;0.0151515151515151;0.484848484848485
Control.SRR15539874;34;32;0.617647058823529;13;21;0.117647058823529;0.382352941176471
Control.SRR15539874;30;32;0.433333333333333;17;13;0.0666666666666667;0.433333333333333
Control.SRR15539874;39;32;0.512820512820513;19;20;0.0128205128205128;0.487179487179487
Control.SRR15539874;29;32;0.413793103448276;17;12;0.0862068965517241;0.413793103448276
Control.SRR15539874;37;32;0.297297297297297;26;11;0.202702702702703;0.297297297297297
Control.SRR15539874;36;32;0.416666666666667;21;15;0.0833333333333333;0.416666666666667
Control.SRR15539874;37;32;0.513513513513513;18;19;0.0135135135135135;0.486486486486487
Control.SRR15539874;36;32;0.333333333333333;24;12;0.166666666666667;0.333333333333333
Control.SRR15539874;32;32;0.5;16;16;0;0.5
Control.SRR15539874;30;32;0.333333333333333;20;10;0.166666666666667;0.333333333333333
Control.SRR15539874;36;32;0.527777777777778;17;19;0.0277777777777778;0.472222222222222
Control.SRR15539874;39;32;0.538461538461538;18;21;0.0384615384615384;0.461538461538462
Control.SRR15539874;38;32;0.552631578947368;17;21;0.0526315789473685;0.447368421052632
Control.SRR15539874;39;32;0.512820512820513;19;20;0.0128205128205128;0.487179487179487
Control.SRR15539874;38;32;0.473684210526316;20;18;0.0263157894736842;0.473684210526316
Control.SRR15539874;35;32;0.571428571428571;15;20;0.0714285714285714;0.428571428571429
Control.SRR15539874;36;32;0.472222222222222;19;17;0.0277777777777778;0.472222222222222
Control.SRR15539874;34;32;0.588235294117647;14;20;0.0882352941176471;0.411764705882353
Control.SRR15539874;33;32;0.545454545454545;15;18;0.0454545454545454;0.454545454545455
Control.SRR15539874;32;32;0.59375;13;19;0.09375;0.40625
Control.SRR15539874;35;32;0.428571428571429;20;15;0.0714285714285715;0.428571428571429
Control.SRR15539874;35;32;0.542857142857143;16;19;0.0428571428571428;0.457142857142857
Control.SRR15539874;35;32;0.514285714285714;17;18;0.0142857142857142;0.485714285714286
Control.SRR15539874;36;32;0.305555555555556;25;11;0.194444444444444;0.305555555555556
Control.SRR15539874;39;32;0.615384615384615;15;24;0.115384615384615;0.384615384615385
Control.SRR15539874;38;32;0.473684210526316;20;18;0.0263157894736842;0.473684210526316
Control.SRR15539874;35;32;0.6;14;21;0.1;0.4
Control.SRR15539874;36;32;0.444444444444444;20;16;0.0555555555555556;0.444444444444444
Control.SRR15539874;36;32;0.555555555555556;16;20;0.0555555555555556;0.444444444444444
Control.SRR15539874;30;32;0.533333333333333;14;16;0.0333333333333333;0.466666666666667
Control.SRR15539874;35;32;0.6;14;21;0.1;0.4
Control.SRR15539874;35;32;0.542857142857143;16;19;0.0428571428571428;0.457142857142857
Control.SRR15539874;33;32;0.515151515151515;16;17;0.0151515151515151;0.484848484848485
Control.SRR15539874;33;32;0.545454545454545;15;18;0.0454545454545454;0.454545454545455
Control.SRR15539874;34;32;0.558823529411765;15;19;0.0588235294117647;0.441176470588235
Control.SRR15539874;39;32;0.435897435897436;22;17;0.0641025641025641;0.435897435897436
Control.SRR15539874;34;32;0.529411764705882;16;18;0.0294117647058824;0.470588235294118
Control.SRR15539874;33;32;0.515151515151515;16;17;0.0151515151515151;0.484848484848485
Control.SRR15539874;30;32;0.433333333333333;17;13;0.0666666666666667;0.433333333333333
Control.SRR15539874;33;32;0.575757575757576;14;19;0.0757575757575758;0.424242424242424
Control.SRR15539874;35;32;0.4;21;14;0.1;0.4
Control.SRR15539874;37;32;0.459459459459459;20;17;0.0405405405405405;0.459459459459459
Control.SRR15539874;31;32;0.451612903225806;17;14;0.0483870967741936;0.451612903225806
Control.SRR15539874;32;32;0.46875;17;15;0.03125;0.46875
Control.SRR15539874;37;32;0.459459459459459;20;17;0.0405405405405405;0.459459459459459
Control.SRR15539874;33;32;0.545454545454545;15;18;0.0454545454545454;0.454545454545455
Control.SRR15539874;31;32;0.419354838709677;18;13;0.0806451612903226;0.419354838709677
Control.SRR15539874;29;32;0.379310344827586;18;11;0.120689655172414;0.379310344827586
Control.SRR15539874;37;32;0.486486486486487;19;18;0.0135135135135135;0.486486486486487
Control.SRR15539874;39;32;0.435897435897436;22;17;0.0641025641025641;0.435897435897436
Control.SRR15539874;35;32;0.571428571428571;15;20;0.0714285714285714;0.428571428571429
Control.SRR15539874;31;32;0.225806451612903;24;7;0.274193548387097;0.225806451612903
Control.SRR15539874;34;32;0.5;17;17;0;0.5
Control.SRR15539874;33;32;0.424242424242424;19;14;0.0757575757575757;0.424242424242424
Control.SRR15539874;29;32;0.517241379310345;14;15;0.0172413793103449;0.482758620689655
Control.SRR15539874;33;32;0.545454545454545;15;18;0.0454545454545454;0.454545454545455
Control.SRR15539874;29;32;0.482758620689655;15;14;0.0172413793103448;0.482758620689655
Control.SRR15539874;31;32;0.483870967741935;16;15;0.0161290322580645;0.483870967741935
Control.SRR15539874;32;32;0.5;16;16;0;0.5
Control.SRR15539874;29;32;0.413793103448276;17;12;0.0862068965517241;0.413793103448276
Control.SRR15539874;33;32;0.575757575757576;14;19;0.0757575757575758;0.424242424242424
Control.SRR15539874;30;32;0.533333333333333;14;16;0.0333333333333333;0.466666666666667
Control.SRR15539874;29;32;0.448275862068966;16;13;0.0517241379310345;0.448275862068966
Control.SRR15539874;29;32;0.379310344827586;18;11;0.120689655172414;0.379310344827586
Control.SRR15539874;31;32;0.483870967741935;16;15;0.0161290322580645;0.483870967741935
Control.SRR15539874;33;32;0.393939393939394;20;13;0.106060606060606;0.393939393939394
Control.SRR15539874;36;32;0.555555555555556;16;20;0.0555555555555556;0.444444444444444
Control.SRR15539874;30;32;0.5;15;15;0;0.5
Control.SRR15539874;30;32;0.6;12;18;0.1;0.4
Control.SRR15539874;38;32;0.578947368421053;16;22;0.0789473684210527;0.421052631578947
Control.SRR15539874;32;32;0.46875;17;15;0.03125;0.46875
Control.SRR15539874;36;32;0.416666666666667;21;15;0.0833333333333333;0.416666666666667
Control.SRR15539874;38;32;0.473684210526316;20;18;0.0263157894736842;0.473684210526316
Control.SRR15539874;34;32;0.470588235294118;18;16;0.0294117647058824;0.470588235294118
Control.SRR15539874;33;32;0.303030303030303;23;10;0.196969696969697;0.303030303030303
Control.SRR15539874;33;32;0.606060606060606;13;20;0.106060606060606;0.393939393939394
Control.SRR15539874;35;32;0.514285714285714;17;18;0.0142857142857142;0.485714285714286
Control.SRR15539874;38;32;0.5;19;19;0;0.5
Control.SRR15539874;36;32;0.333333333333333;24;12;0.166666666666667;0.333333333333333
Control.SRR15539874;39;32;0.461538461538462;21;18;0.0384615384615384;0.461538461538462
Control.SRR15539874;34;32;0.588235294117647;14;20;0.0882352941176471;0.411764705882353
Control.SRR15539874;36;32;0.527777777777778;17;19;0.0277777777777778;0.472222222222222
Control.SRR15539874;32;32;0.46875;17;15;0.03125;0.46875
Control.SRR15539874;32;32;0.34375;21;11;0.15625;0.34375
Control.SRR15539874;33;32;0.575757575757576;14;19;0.0757575757575758;0.424242424242424
Control.SRR15539874;29;32;0.517241379310345;14;15;0.0172413793103449;0.482758620689655
Control.SRR15539874;34;32;0.352941176470588;22;12;0.147058823529412;0.352941176470588
Control.SRR15539874;29;32;0.413793103448276;17;12;0.0862068965517241;0.413793103448276
Control.SRR15539874;36;32;0.611111111111111;14;22;0.111111111111111;0.388888888888889
Control.SRR15539874;35;32;0.657142857142857;12;23;0.157142857142857;0.342857142857143
Control.SRR15539874;34;32;0.470588235294118;18;16;0.0294117647058824;0.470588235294118
Control.SRR15539874;39;32;0.564102564102564;17;22;0.0641025641025641;0.435897435897436
Control.SRR15539874;33;32;0.454545454545455;18;15;0.0454545454545455;0.454545454545455
Control.SRR15539874;39;32;0.538461538461538;18;21;0.0384615384615384;0.461538461538462
Control.SRR15539874;38;32;0.526315789473684;18;20;0.0263157894736842;0.473684210526316
Control.SRR15539874;36;32;0.583333333333333;15;21;0.0833333333333334;0.416666666666667
Control.SRR15539874;36;32;0.444444444444444;20;16;0.0555555555555556;0.444444444444444
Control.SRR15539874;29;32;0.379310344827586;18;11;0.120689655172414;0.379310344827586
Control.SRR15539874;36;32;0.444444444444444;20;16;0.0555555555555556;0.444444444444444
Control.SRR15539874;34;32;0.470588235294118;18;16;0.0294117647058824;0.470588235294118
Control.SRR15539874;33;32;0.454545454545455;18;15;0.0454545454545455;0.454545454545455
Control.SRR15539874;35;32;0.485714285714286;18;17;0.0142857142857143;0.485714285714286
Control.SRR15539874;32;32;0.34375;21;11;0.15625;0.34375
Control.SRR15539874;33;32;0.424242424242424;19;14;0.0757575757575757;0.424242424242424
Control.SRR15539874;36;32;0.416666666666667;21;15;0.0833333333333333;0.416666666666667
Control.SRR15539874;34;32;0.5;17;17;0;0.5
Control.SRR15539874;36;32;0.444444444444444;20;16;0.0555555555555556;0.444444444444444
Control.SRR15539874;33;32;0.393939393939394;20;13;0.106060606060606;0.393939393939394
Control.SRR15539874;31;32;0.612903225806452;12;19;0.112903225806452;0.387096774193548
Control.SRR15539874;29;32;0.413793103448276;17;12;0.0862068965517241;0.413793103448276
Control.SRR15539874;29;32;0.517241379310345;14;15;0.0172413793103449;0.482758620689655
Control.SRR15539874;35;32;0.571428571428571;15;20;0.0714285714285714;0.428571428571429
Control.SRR15539874;39;32;0.435897435897436;22;17;0.0641025641025641;0.435897435897436
Control.SRR15539874;30;32;0.566666666666667;13;17;0.0666666666666667;0.433333333333333
Control.SRR15539874;31;32;0.290322580645161;22;9;0.209677419354839;0.290322580645161
Control.SRR15539874;35;32;0.457142857142857;19;16;0.0428571428571429;0.457142857142857
Control.SRR15539874;30;32;0.633333333333333;11;19;0.133333333333333;0.366666666666667
Control.SRR15539874;35;32;0.428571428571429;20;15;0.0714285714285715;0.428571428571429
Control.SRR15539874;32;32;0.59375;13;19;0.09375;0.40625
Control.SRR15539874;39;32;0.487179487179487;20;19;0.0128205128205128;0.487179487179487
Control.SRR15539874;31;32;0.580645161290323;13;18;0.0806451612903226;0.419354838709677
Control.SRR15539874;38;32;0.368421052631579;24;14;0.131578947368421;0.368421052631579
Control.SRR15539874;34;32;0.529411764705882;16;18;0.0294117647058824;0.470588235294118
Control.SRR15539874;37;32;0.567567567567568;16;21;0.0675675675675675;0.432432432432432
Control.SRR15539874;38;32;0.473684210526316;20;18;0.0263157894736842;0.473684210526316
Control.SRR15539874;33;32;0.575757575757576;14;19;0.0757575757575758;0.424242424242424
Control.SRR15539874;34;32;0.411764705882353;20;14;0.0882352941176471;0.411764705882353
Control.SRR15539874;32;32;0.4375;18;14;0.0625;0.4375
Control.SRR15539874;37;32;0.621621621621622;14;23;0.121621621621622;0.378378378378378
Control.SRR15539874;36;32;0.555555555555556;16;20;0.0555555555555556;0.444444444444444
Control.SRR15539874;36;32;0.416666666666667;21;15;0.0833333333333333;0.416666666666667
Control.SRR15539874;39;32;0.487179487179487;20;19;0.0128205128205128;0.487179487179487
Control.SRR15539874;33;32;0.484848484848485;17;16;0.0151515151515151;0.484848484848485
Control.SRR15539874;31;32;0.548387096774194;14;17;0.0483870967741935;0.451612903225806
Control.SRR15539874;33;32;0.424242424242424;19;14;0.0757575757575757;0.424242424242424
Control.SRR15539874;31;32;0.67741935483871;10;21;0.17741935483871;0.32258064516129
Control.SRR15539874;31;32;0.645161290322581;11;20;0.145161290322581;0.354838709677419
Control.SRR15539874;33;32;0.575757575757576;14;19;0.0757575757575758;0.424242424242424
Control.SRR15539874;30;32;0.466666666666667;16;14;0.0333333333333333;0.466666666666667
Control.SRR15539874;37;32;0.405405405405405;22;15;0.0945945945945946;0.405405405405405
Control.SRR15539874;32;32;0.71875;9;23;0.21875;0.28125
Control.SRR15539874;34;32;0.647058823529412;12;22;0.147058823529412;0.352941176470588
Control.SRR15539874;39;32;0.461538461538462;21;18;0.0384615384615384;0.461538461538462
Control.SRR15539874;34;32;0.441176470588235;19;15;0.0588235294117647;0.441176470588235
Control.SRR15539874;39;32;0.384615384615385;24;15;0.115384615384615;0.384615384615385
Control.SRR15539874;30;32;0.666666666666667;10;20;0.166666666666667;0.333333333333333
Control.SRR15539874;35;32;0.571428571428571;15;20;0.0714285714285714;0.428571428571429
Control.SRR15539874;38;32;0.473684210526316;20;18;0.0263157894736842;0.473684210526316
Control.SRR15539874;35;32;0.485714285714286;18;17;0.0142857142857143;0.485714285714286
Control.SRR15539874;32;32;0.3125;22;10;0.1875;0.3125
Control.SRR15539874;32;32;0.625;12;20;0.125;0.375
Control.SRR15539874;32;32;0.46875;17;15;0.03125;0.46875
Control.SRR15539874;29;32;0.586206896551724;12;17;0.0862068965517241;0.413793103448276
Control.SRR15539874;29;32;0.379310344827586;18;11;0.120689655172414;0.379310344827586
Control.SRR15539874;37;32;0.540540540540541;17;20;0.0405405405405406;0.459459459459459
Control.SRR15539874;32;32;0.8125;6;26;0.3125;0.1875
Control.SRR15539874;35;32;0.542857142857143;16;19;0.0428571428571428;0.457142857142857
Control.SRR15539874;33;32;0.363636363636364;21;12;0.136363636363636;0.363636363636364
Control.SRR15539874;36;32;0.472222222222222;19;17;0.0277777777777778;0.472222222222222
Control.SRR15539874;30;32;0.6;12;18;0.1;0.4
Control.SRR15539874;39;32;0.512820512820513;19;20;0.0128205128205128;0.487179487179487
Control.SRR15539874;38;32;0.473684210526316;20;18;0.0263157894736842;0.473684210526316
Control.SRR15539874;33;32;0.515151515151515;16;17;0.0151515151515151;0.484848484848485
Control.SRR15539874;35;32;0.571428571428571;15;20;0.0714285714285714;0.428571428571429
Control.SRR15539874;32;32;0.5;16;16;0;0.5
Control.SRR15539874;38;32;0.5;19;19;0;0.5
Control.SRR15539874;38;32;0.526315789473684;18;20;0.0263157894736842;0.473684210526316
Control.SRR15539874;37;32;0.621621621621622;14;23;0.121621621621622;0.378378378378378
Control.SRR15539874;35;32;0.571428571428571;15;20;0.0714285714285714;0.428571428571429
Control.SRR15539874;37;32;0.594594594594595;15;22;0.0945945945945946;0.405405405405405
Control.SRR15539874;35;32;0.371428571428571;22;13;0.128571428571429;0.371428571428571
Control.SRR15539874;34;32;0.441176470588235;19;15;0.0588235294117647;0.441176470588235
Control.SRR15539874;35;32;0.485714285714286;18;17;0.0142857142857143;0.485714285714286
Control.SRR15539874;31;32;0.516129032258065;15;16;0.0161290322580645;0.483870967741935
Control.SRR15539874;32;32;0.53125;15;17;0.03125;0.46875
Control.SRR15539874;35;32;0.6;14;21;0.1;0.4
Control.SRR15539874;34;32;0.617647058823529;13;21;0.117647058823529;0.382352941176471
Control.SRR15539874;36;32;0.5;18;18;0;0.5
Control.SRR15539874;32;32;0.4375;18;14;0.0625;0.4375
Control.SRR15539874;35;32;0.628571428571429;13;22;0.128571428571429;0.371428571428571
Control.SRR15539874;36;32;0.5;18;18;0;0.5
Control.SRR15539874;31;32;0.419354838709677;18;13;0.0806451612903226;0.419354838709677
Control.SRR15539874;37;32;0.594594594594595;15;22;0.0945945945945946;0.405405405405405
Control.SRR15539874;39;32;0.487179487179487;20;19;0.0128205128205128;0.487179487179487
Control.SRR15539874;36;32;0.5;18;18;0;0.5
Control.SRR15539874;31;32;0.483870967741935;16;15;0.0161290322580645;0.483870967741935
Control.SRR15539874;29;32;0.379310344827586;18;11;0.120689655172414;0.379310344827586
Control.SRR15539874;31;32;0.451612903225806;17;14;0.0483870967741936;0.451612903225806
Control.SRR15539874;39;32;0.512820512820513;19;20;0.0128205128205128;0.487179487179487
Control.SRR15539874;29;32;0.655172413793103;10;19;0.155172413793103;0.344827586206897
Control.SRR15539874;32;32;0.5625;14;18;0.0625;0.4375
Control.SRR15539874;30;32;0.7;9;21;0.2;0.3
Control.SRR15539874;38;32;0.473684210526316;20;18;0.0263157894736842;0.473684210526316
Control.SRR15539874;39;32;0.512820512820513;19;20;0.0128205128205128;0.487179487179487
Control.SRR15539874;37;32;0.513513513513513;18;19;0.0135135135135135;0.486486486486487
Control.SRR15539874;32;32;0.53125;15;17;0.03125;0.46875
Control.SRR15539874;29;32;0.620689655172414;11;18;0.120689655172414;0.379310344827586
Control.SRR15539874;31;32;0.483870967741935;16;15;0.0161290322580645;0.483870967741935
Control.SRR15539874;36;32;0.472222222222222;19;17;0.0277777777777778;0.472222222222222
Control.SRR15539874;38;32;0.421052631578947;22;16;0.0789473684210527;0.421052631578947
Control.SRR15539874;34;32;0.529411764705882;16;18;0.0294117647058824;0.470588235294118
Control.SRR15539874;29;32;0.620689655172414;11;18;0.120689655172414;0.379310344827586
Control.SRR15539874;36;32;0.694444444444444;11;25;0.194444444444444;0.305555555555556
Control.SRR15539874;37;32;0.486486486486487;19;18;0.0135135135135135;0.486486486486487
Control.SRR15539874;38;32;0.631578947368421;14;24;0.131578947368421;0.368421052631579
Control.SRR15539874;35;32;0.485714285714286;18;17;0.0142857142857143;0.485714285714286
Control.SRR15539874;37;32;0.594594594594595;15;22;0.0945945945945946;0.405405405405405
Control.SRR15539874;38;32;0.631578947368421;14;24;0.131578947368421;0.368421052631579
Control.SRR15539874;31;32;0.483870967741935;16;15;0.0161290322580645;0.483870967741935
Control.SRR15539874;34;32;0.382352941176471;21;13;0.117647058823529;0.382352941176471
Control.SRR15539874;32;32;0.625;12;20;0.125;0.375
Control.SRR15539874;37;32;0.648648648648649;13;24;0.148648648648649;0.351351351351351
Control.SRR15539874;34;32;0.529411764705882;16;18;0.0294117647058824;0.470588235294118
Control.SRR15539874;33;32;0.424242424242424;19;14;0.0757575757575757;0.424242424242424
Control.SRR15539874;29;32;0.379310344827586;18;11;0.120689655172414;0.379310344827586
Control.SRR15539874;31;32;0.645161290322581;11;20;0.145161290322581;0.354838709677419
Control.SRR15539874;35;32;0.485714285714286;18;17;0.0142857142857143;0.485714285714286
Control.SRR15539874;33;32;0.484848484848485;17;16;0.0151515151515151;0.484848484848485
Control.SRR15539874;33;32;0.545454545454545;15;18;0.0454545454545454;0.454545454545455
Control.SRR15539874;36;32;0.5;18;18;0;0.5
Control.SRR15539874;35;32;0.657142857142857;12;23;0.157142857142857;0.342857142857143
Control.SRR15539874;37;32;0.486486486486487;19;18;0.0135135135135135;0.486486486486487
Control.SRR15539874;32;32;0.4375;18;14;0.0625;0.4375
Control.SRR15539874;32;32;0.4375;18;14;0.0625;0.4375
Control.SRR15539874;32;32;0.5625;14;18;0.0625;0.4375
Control.SRR15539874;33;32;0.393939393939394;20;13;0.106060606060606;0.393939393939394
Control.SRR15539874;37;32;0.540540540540541;17;20;0.0405405405405406;0.459459459459459
Control.SRR15539874;36;32;0.611111111111111;14;22;0.111111111111111;0.388888888888889
Control.SRR15539874;34;32;0.411764705882353;20;14;0.0882352941176471;0.411764705882353
Control.SRR15539874;35;32;0.514285714285714;17;18;0.0142857142857142;0.485714285714286
Control.SRR15539874;32;32;0.5625;14;18;0.0625;0.4375
Control.SRR15539874;35;32;0.514285714285714;17;18;0.0142857142857142;0.485714285714286
Control.SRR15539874;37;32;0.513513513513513;18;19;0.0135135135135135;0.486486486486487
Control.SRR15539874;31;32;0.387096774193548;19;12;0.112903225806452;0.387096774193548
Control.SRR15539874;36;32;0.694444444444444;11;25;0.194444444444444;0.305555555555556
Control.SRR15539874;33;32;0.575757575757576;14;19;0.0757575757575758;0.424242424242424
Control.SRR15539874;29;32;0.655172413793103;10;19;0.155172413793103;0.344827586206897
Control.SRR15539874;32;32;0.375;20;12;0.125;0.375
Control.SRR15539874;34;32;0.411764705882353;20;14;0.0882352941176471;0.411764705882353
Control.SRR15539874;35;32;0.571428571428571;15;20;0.0714285714285714;0.428571428571429
Control.SRR15539874;35;32;0.657142857142857;12;23;0.157142857142857;0.342857142857143
Control.SRR15539874;39;32;0.512820512820513;19;20;0.0128205128205128;0.487179487179487
Control.SRR15539874;32;32;0.40625;19;13;0.09375;0.40625
Control.SRR15539874;32;32;0.53125;15;17;0.03125;0.46875
Control.SRR15539874;34;32;0.5;17;17;0;0.5
Control.SRR15539874;35;32;0.571428571428571;15;20;0.0714285714285714;0.428571428571429
Control.SRR15539874;38;32;0.421052631578947;22;16;0.0789473684210527;0.421052631578947
Control.SRR15539874;39;32;0.487179487179487;20;19;0.0128205128205128;0.487179487179487
Control.SRR15539874;35;32;0.485714285714286;18;17;0.0142857142857143;0.485714285714286
Control.SRR15539874;31;32;0.483870967741935;16;15;0.0161290322580645;0.483870967741935
Control.SRR15539874;32;32;0.53125;15;17;0.03125;0.46875
Control.SRR15539874;37;32;0.513513513513513;18;19;0.0135135135135135;0.486486486486487
Control.SRR15539874;29;32;0.482758620689655;15;14;0.0172413793103448;0.482758620689655
Control.SRR15539874;30;32;0.533333333333333;14;16;0.0333333333333333;0.466666666666667
Control.SRR15539874;35;32;0.542857142857143;16;19;0.0428571428571428;0.457142857142857
Control.SRR15539874;30;32;0.566666666666667;13;17;0.0666666666666667;0.433333333333333
Control.SRR15539874;30;32;0.433333333333333;17;13;0.0666666666666667;0.433333333333333
Control.SRR15539874;37;32;0.486486486486487;19;18;0.0135135135135135;0.486486486486487
Control.SRR15539874;32;32;0.3125;22;10;0.1875;0.3125
Control.SRR15539874;31;32;0.645161290322581;11;20;0.145161290322581;0.354838709677419
Control.SRR15539874;30;32;0.4;18;12;0.1;0.4
Control.SRR15539874;30;32;0.666666666666667;10;20;0.166666666666667;0.333333333333333
Control.SRR15539874;35;32;0.514285714285714;17;18;0.0142857142857142;0.485714285714286
Control.SRR15539874;34;32;0.323529411764706;23;11;0.176470588235294;0.323529411764706
Control.SRR15539874;33;32;0.484848484848485;17;16;0.0151515151515151;0.484848484848485
Control.SRR15539874;38;32;0.473684210526316;20;18;0.0263157894736842;0.473684210526316
Control.SRR15539874;35;32;0.457142857142857;19;16;0.0428571428571429;0.457142857142857
Control.SRR15539874;38;32;0.421052631578947;22;16;0.0789473684210527;0.421052631578947
Control.SRR15539874;33;32;0.545454545454545;15;18;0.0454545454545454;0.454545454545455
Control.SRR15539874;30;32;0.533333333333333;14;16;0.0333333333333333;0.466666666666667
Control.SRR15539874;33;32;0.545454545454545;15;18;0.0454545454545454;0.454545454545455
Control.SRR15539874;38;32;0.552631578947368;17;21;0.0526315789473685;0.447368421052632
Control.SRR15539874;32;32;0.65625;11;21;0.15625;0.34375
Control.SRR15539874;30;32;0.6;12;18;0.1;0.4
Control.SRR15539874;33;32;0.545454545454545;15;18;0.0454545454545454;0.454545454545455
Control.SRR15539874;30;32;0.433333333333333;17;13;0.0666666666666667;0.433333333333333
Control.SRR15539874;32;32;0.4375;18;14;0.0625;0.4375
Control.SRR15539874;31;32;0.516129032258065;15;16;0.0161290322580645;0.483870967741935
Control.SRR15539874;38;32;0.526315789473684;18;20;0.0263157894736842;0.473684210526316
Control.SRR15539874;38;32;0.526315789473684;18;20;0.0263157894736842;0.473684210526316
Control.SRR15539874;37;32;0.594594594594595;15;22;0.0945945945945946;0.405405405405405
Control.SRR15539874;37;32;0.513513513513513;18;19;0.0135135135135135;0.486486486486487
Control.SRR15539874;37;32;0.513513513513513;18;19;0.0135135135135135;0.486486486486487
Control.SRR15539874;33;32;0.333333333333333;22;11;0.166666666666667;0.333333333333333
Control.SRR15539874;36;32;0.472222222222222;19;17;0.0277777777777778;0.472222222222222
Control.SRR15539874;30;32;0.533333333333333;14;16;0.0333333333333333;0.466666666666667
Control.SRR15539874;37;32;0.297297297297297;26;11;0.202702702702703;0.297297297297297
Control.SRR15539874;34;32;0.529411764705882;16;18;0.0294117647058824;0.470588235294118
Control.SRR15539874;39;32;0.487179487179487;20;19;0.0128205128205128;0.487179487179487
Control.SRR15539874;36;32;0.527777777777778;17;19;0.0277777777777778;0.472222222222222
Control.SRR15539874;39;32;0.538461538461538;18;21;0.0384615384615384;0.461538461538462
Control.SRR15539874;35;32;0.342857142857143;23;12;0.157142857142857;0.342857142857143
Control.SRR15539874;36;32;0.555555555555556;16;20;0.0555555555555556;0.444444444444444
Control.SRR15539874;31;32;0.387096774193548;19;12;0.112903225806452;0.387096774193548
Control.SRR15539874;37;32;0.432432432432432;21;16;0.0675675675675675;0.432432432432432
Control.SRR15539874;30;32;0.633333333333333;11;19;0.133333333333333;0.366666666666667
Control.SRR15539874;34;32;0.5;17;17;0;0.5
Control.SRR15539874;36;32;0.388888888888889;22;14;0.111111111111111;0.388888888888889
Control.SRR15539874;36;32;0.416666666666667;21;15;0.0833333333333333;0.416666666666667
Control.SRR15539874;32;32;0.65625;11;21;0.15625;0.34375
Control.SRR15539874;32;32;0.5;16;16;0;0.5
Control.SRR15539874;31;32;0.645161290322581;11;20;0.145161290322581;0.354838709677419
Control.SRR15539874;32;32;0.375;20;12;0.125;0.375
Control.SRR15539874;38;32;0.552631578947368;17;21;0.0526315789473685;0.447368421052632
Control.SRR15539874;31;32;0.387096774193548;19;12;0.112903225806452;0.387096774193548
Control.SRR15539874;39;32;0.615384615384615;15;24;0.115384615384615;0.384615384615385
Control.SRR15539874;35;32;0.6;14;21;0.1;0.4
Control.SRR15539874;36;32;0.583333333333333;15;21;0.0833333333333334;0.416666666666667
Control.SRR15539874;33;32;0.424242424242424;19;14;0.0757575757575757;0.424242424242424
Control.SRR15539874;32;32;0.40625;19;13;0.09375;0.40625
Control.SRR15539874;29;32;0.586206896551724;12;17;0.0862068965517241;0.413793103448276
Control.SRR15539874;34;32;0.529411764705882;16;18;0.0294117647058824;0.470588235294118
Control.SRR15539874;30;32;0.566666666666667;13;17;0.0666666666666667;0.433333333333333
Control.SRR15539874;29;32;0.482758620689655;15;14;0.0172413793103448;0.482758620689655
Control.SRR15539874;35;32;0.371428571428571;22;13;0.128571428571429;0.371428571428571
Control.SRR15539874;38;32;0.421052631578947;22;16;0.0789473684210527;0.421052631578947
Control.SRR15539874;32;32;0.40625;19;13;0.09375;0.40625
Control.SRR15539874;31;32;0.580645161290323;13;18;0.0806451612903226;0.419354838709677
Control.SRR15539874;33;32;0.454545454545455;18;15;0.0454545454545455;0.454545454545455
Control.SRR15539874;33;32;0.666666666666667;11;22;0.166666666666667;0.333333333333333
Control.SRR15539874;39;32;0.538461538461538;18;21;0.0384615384615384;0.461538461538462
Control.SRR15539874;39;32;0.435897435897436;22;17;0.0641025641025641;0.435897435897436
Control.SRR15539874;38;32;0.5;19;19;0;0.5
Control.SRR15539874;36;32;0.583333333333333;15;21;0.0833333333333334;0.416666666666667
Control.SRR15539874;35;32;0.514285714285714;17;18;0.0142857142857142;0.485714285714286
Control.SRR15539874;35;32;0.542857142857143;16;19;0.0428571428571428;0.457142857142857
Control.SRR15539874;35;32;0.428571428571429;20;15;0.0714285714285715;0.428571428571429
Control.SRR15539874;35;32;0.428571428571429;20;15;0.0714285714285715;0.428571428571429
Control.SRR15539874;32;32;0.375;20;12;0.125;0.375
Control.SRR15539874;29;32;0.344827586206897;19;10;0.155172413793103;0.344827586206897
Control.SRR15539874;30;32;0.333333333333333;20;10;0.166666666666667;0.333333333333333
Control.SRR15539874;36;32;0.472222222222222;19;17;0.0277777777777778;0.472222222222222
Control.SRR15539874;35;32;0.457142857142857;19;16;0.0428571428571429;0.457142857142857
Control.SRR15539874;36;32;0.5;18;18;0;0.5
Control.SRR15539874;34;32;0.441176470588235;19;15;0.0588235294117647;0.441176470588235
Control.SRR15539874;38;32;0.394736842105263;23;15;0.105263157894737;0.394736842105263
Control.SRR15539874;30;32;0.6;12;18;0.1;0.4
Control.SRR15539874;36;32;0.5;18;18;0;0.5
Control.SRR15539874;34;32;0.411764705882353;20;14;0.0882352941176471;0.411764705882353
Control.SRR15539874;38;32;0.368421052631579;24;14;0.131578947368421;0.368421052631579
Control.SRR15539874;30;32;0.4;18;12;0.1;0.4
Control.SRR15539874;34;32;0.382352941176471;21;13;0.117647058823529;0.382352941176471
Control.SRR15539874;32;32;0.5625;14;18;0.0625;0.4375
Control.SRR15539874;35;32;0.542857142857143;16;19;0.0428571428571428;0.457142857142857
Control.SRR15539874;36;32;0.5;18;18;0;0.5
Control.SRR15539874;31;32;0.387096774193548;19;12;0.112903225806452;0.387096774193548
Control.SRR15539874;33;32;0.696969696969697;10;23;0.196969696969697;0.303030303030303
Control.SRR15539874;34;32;0.5;17;17;0;0.5
Control.SRR15539874;38;32;0.526315789473684;18;20;0.0263157894736842;0.473684210526316
Control.SRR15539874;34;32;0.294117647058824;24;10;0.205882352941176;0.294117647058824
Control.SRR15539874;36;32;0.527777777777778;17;19;0.0277777777777778;0.472222222222222
Control.SRR15539874;32;32;0.4375;18;14;0.0625;0.4375
Control.SRR15539874;39;32;0.333333333333333;26;13;0.166666666666667;0.333333333333333
Control.SRR15539874;33;32;0.454545454545455;18;15;0.0454545454545455;0.454545454545455
Control.SRR15539874;37;32;0.432432432432432;21;16;0.0675675675675675;0.432432432432432
Control.SRR15539874;37;32;0.405405405405405;22;15;0.0945945945945946;0.405405405405405
Control.SRR15539874;36;32;0.555555555555556;16;20;0.0555555555555556;0.444444444444444
Control.SRR15539874;29;32;0.379310344827586;18;11;0.120689655172414;0.379310344827586
Control.SRR15539874;33;32;0.424242424242424;19;14;0.0757575757575757;0.424242424242424
Control.SRR15539874;35;32;0.542857142857143;16;19;0.0428571428571428;0.457142857142857
Control.SRR15539874;39;32;0.692307692307692;12;27;0.192307692307692;0.307692307692308
Control.SRR15539874;31;32;0.548387096774194;14;17;0.0483870967741935;0.451612903225806
Control.SRR15539874;35;32;0.542857142857143;16;19;0.0428571428571428;0.457142857142857
Control.SRR15539874;36;32;0.5;18;18;0;0.5
Control.SRR15539874;36;32;0.388888888888889;22;14;0.111111111111111;0.388888888888889
Control.SRR15539874;33;32;0.303030303030303;23;10;0.196969696969697;0.303030303030303
Control.SRR15539874;36;32;0.555555555555556;16;20;0.0555555555555556;0.444444444444444
Control.SRR15539874;38;32;0.5;19;19;0;0.5
Control.SRR15539874;39;32;0.333333333333333;26;13;0.166666666666667;0.333333333333333
Control.SRR15539874;34;32;0.529411764705882;16;18;0.0294117647058824;0.470588235294118
Control.SRR15539874;30;32;0.4;18;12;0.1;0.4
Control.SRR15539874;31;32;0.516129032258065;15;16;0.0161290322580645;0.483870967741935
Control.SRR15539874;29;32;0.206896551724138;23;6;0.293103448275862;0.206896551724138
Control.SRR15539874;29;32;0.379310344827586;18;11;0.120689655172414;0.379310344827586
Control.SRR15539874;33;32;0.484848484848485;17;16;0.0151515151515151;0.484848484848485
Control.SRR15539874;29;32;0.551724137931034;13;16;0.0517241379310345;0.448275862068966
Control.SRR15539874;39;32;0.512820512820513;19;20;0.0128205128205128;0.487179487179487
Control.SRR15539874;31;32;0.580645161290323;13;18;0.0806451612903226;0.419354838709677
Control.SRR15539874;34;32;0.470588235294118;18;16;0.0294117647058824;0.470588235294118
Control.SRR15539874;39;32;0.435897435897436;22;17;0.0641025641025641;0.435897435897436
Control.SRR15539874;31;32;0.548387096774194;14;17;0.0483870967741935;0.451612903225806
Control.SRR15539874;30;32;0.466666666666667;16;14;0.0333333333333333;0.466666666666667
Control.SRR15539874;34;32;0.441176470588235;19;15;0.0588235294117647;0.441176470588235
Control.SRR15539874;39;32;0.41025641025641;23;16;0.0897435897435898;0.41025641025641
Control.SRR15539874;31;32;0.548387096774194;14;17;0.0483870967741935;0.451612903225806
Control.SRR15539874;33;32;0.545454545454545;15;18;0.0454545454545454;0.454545454545455
Control.SRR15539874;29;32;0.379310344827586;18;11;0.120689655172414;0.379310344827586
Control.SRR15539874;31;32;0.580645161290323;13;18;0.0806451612903226;0.419354838709677
Control.SRR15539874;29;32;0.413793103448276;17;12;0.0862068965517241;0.413793103448276
Control.SRR15539874;33;32;0.515151515151515;16;17;0.0151515151515151;0.484848484848485
Control.SRR15539874;39;32;0.487179487179487;20;19;0.0128205128205128;0.487179487179487
Control.SRR15539874;37;32;0.513513513513513;18;19;0.0135135135135135;0.486486486486487
Control.SRR15539874;32;32;0.625;12;20;0.125;0.375
Control.SRR15539874;35;32;0.514285714285714;17;18;0.0142857142857142;0.485714285714286
Control.SRR15539874;32;32;0.6875;10;22;0.1875;0.3125
Control.SRR15539874;34;32;0.411764705882353;20;14;0.0882352941176471;0.411764705882353
Control.SRR15539874;29;32;0.482758620689655;15;14;0.0172413793103448;0.482758620689655
Control.SRR15539874;36;32;0.472222222222222;19;17;0.0277777777777778;0.472222222222222
Control.SRR15539874;34;32;0.323529411764706;23;11;0.176470588235294;0.323529411764706
Control.SRR15539874;30;32;0.433333333333333;17;13;0.0666666666666667;0.433333333333333
Control.SRR15539874;30;32;0.5;15;15;0;0.5
Control.SRR15539874;30;32;0.533333333333333;14;16;0.0333333333333333;0.466666666666667
Control.SRR15539874;31;32;0.580645161290323;13;18;0.0806451612903226;0.419354838709677
Control.SRR15539874;33;32;0.424242424242424;19;14;0.0757575757575757;0.424242424242424
Control.SRR15539874;33;32;0.545454545454545;15;18;0.0454545454545454;0.454545454545455
Control.SRR15539874;38;32;0.394736842105263;23;15;0.105263157894737;0.394736842105263
Control.SRR15539874;34;32;0.588235294117647;14;20;0.0882352941176471;0.411764705882353
Control.SRR15539874;39;32;0.487179487179487;20;19;0.0128205128205128;0.487179487179487
Control.SRR15539874;30;32;0.5;15;15;0;0.5
Control.SRR15539874;34;32;0.588235294117647;14;20;0.0882352941176471;0.411764705882353
Control.SRR15539874;36;32;0.555555555555556;16;20;0.0555555555555556;0.444444444444444
Control.SRR15539874;32;32;0.53125;15;17;0.03125;0.46875
Control.SRR15539874;38;32;0.5;19;19;0;0.5
Control.SRR15539874;31;32;0.516129032258065;15;16;0.0161290322580645;0.483870967741935
Control.SRR15539874;33;32;0.454545454545455;18;15;0.0454545454545455;0.454545454545455
Control.SRR15539874;36;32;0.527777777777778;17;19;0.0277777777777778;0.472222222222222
Control.SRR15539874;33;32;0.515151515151515;16;17;0.0151515151515151;0.484848484848485
Control.SRR15539874;31;32;0.516129032258065;15;16;0.0161290322580645;0.483870967741935
Control.SRR15539874;32;32;0.40625;19;13;0.09375;0.40625
Control.SRR15539874;38;32;0.368421052631579;24;14;0.131578947368421;0.368421052631579
Control.SRR15539874;29;32;0.448275862068966;16;13;0.0517241379310345;0.448275862068966
Control.SRR15539874;33;32;0.575757575757576;14;19;0.0757575757575758;0.424242424242424
Control.SRR15539874;34;32;0.617647058823529;13;21;0.117647058823529;0.382352941176471
Control.SRR15539874;32;32;0.5;16;16;0;0.5
Control.SRR15539874;34;32;0.294117647058824;24;10;0.205882352941176;0.294117647058824
Control.SRR15539874;37;32;0.540540540540541;17;20;0.0405405405405406;0.459459459459459
Control.SRR15539874;31;32;0.516129032258065;15;16;0.0161290322580645;0.483870967741935
Control.SRR15539874;33;32;0.515151515151515;16;17;0.0151515151515151;0.484848484848485
Control.SRR15539874;30;32;0.566666666666667;13;17;0.0666666666666667;0.433333333333333
Control.SRR15539874;31;32;0.451612903225806;17;14;0.0483870967741936;0.451612903225806
Control.SRR15539874;32;32;0.40625;19;13;0.09375;0.40625
Control.SRR15539874;31;32;0.451612903225806;17;14;0.0483870967741936;0.451612903225806
Control.SRR15539874;38;32;0.447368421052632;21;17;0.0526315789473684;0.447368421052632
Control.SRR15539874;39;32;0.58974358974359;16;23;0.0897435897435898;0.41025641025641
Control.SRR15539874;36;32;0.472222222222222;19;17;0.0277777777777778;0.472222222222222
Control.SRR15539874;32;32;0.375;20;12;0.125;0.375
Control.SRR15539874;29;32;0.586206896551724;12;17;0.0862068965517241;0.413793103448276
Control.SRR15539874;35;32;0.6;14;21;0.1;0.4
Control.SRR15539874;34;32;0.529411764705882;16;18;0.0294117647058824;0.470588235294118
Control.SRR15539874;36;32;0.416666666666667;21;15;0.0833333333333333;0.416666666666667
Control.SRR15539874;39;32;0.487179487179487;20;19;0.0128205128205128;0.487179487179487
Control.SRR15539874;38;32;0.631578947368421;14;24;0.131578947368421;0.368421052631579
Control.SRR15539874;31;32;0.516129032258065;15;16;0.0161290322580645;0.483870967741935
Control.SRR15539874;31;32;0.516129032258065;15;16;0.0161290322580645;0.483870967741935
Control.SRR15539874;30;32;0.4;18;12;0.1;0.4
Control.SRR15539874;36;32;0.611111111111111;14;22;0.111111111111111;0.388888888888889
Control.SRR15539874;32;32;0.59375;13;19;0.09375;0.40625
Control.SRR15539874;33;32;0.484848484848485;17;16;0.0151515151515151;0.484848484848485
Control.SRR15539874;39;32;0.512820512820513;19;20;0.0128205128205128;0.487179487179487
Control.SRR15539874;37;32;0.432432432432432;21;16;0.0675675675675675;0.432432432432432
Control.SRR15539874;29;32;0.413793103448276;17;12;0.0862068965517241;0.413793103448276
Control.SRR15539874;34;32;0.647058823529412;12;22;0.147058823529412;0.352941176470588
Control.SRR15539874;31;32;0.548387096774194;14;17;0.0483870967741935;0.451612903225806
Control.SRR15539874;30;32;0.5;15;15;0;0.5
Control.SRR15539874;35;32;0.457142857142857;19;16;0.0428571428571429;0.457142857142857
Control.SRR15539874;37;32;0.405405405405405;22;15;0.0945945945945946;0.405405405405405
Control.SRR15539874;36;32;0.416666666666667;21;15;0.0833333333333333;0.416666666666667
Control.SRR15539874;34;32;0.705882352941177;10;24;0.205882352941177;0.294117647058824
Control.SRR15539874;38;32;0.421052631578947;22;16;0.0789473684210527;0.421052631578947
Control.SRR15539874;33;32;0.545454545454545;15;18;0.0454545454545454;0.454545454545455
Control.SRR15539874;36;32;0.388888888888889;22;14;0.111111111111111;0.388888888888889
Control.SRR15539874;30;32;0.466666666666667;16;14;0.0333333333333333;0.466666666666667
Control.SRR15539874;31;32;0.419354838709677;18;13;0.0806451612903226;0.419354838709677
Control.SRR15539874;34;32;0.617647058823529;13;21;0.117647058823529;0.382352941176471
Control.SRR15539874;34;32;0.529411764705882;16;18;0.0294117647058824;0.470588235294118
Control.SRR15539874;37;32;0.459459459459459;20;17;0.0405405405405405;0.459459459459459
Control.SRR15539874;34;32;0.558823529411765;15;19;0.0588235294117647;0.441176470588235
Control.SRR15539874;37;32;0.513513513513513;18;19;0.0135135135135135;0.486486486486487
Control.SRR15539874;30;32;0.433333333333333;17;13;0.0666666666666667;0.433333333333333
Control.SRR15539874;29;32;0.413793103448276;17;12;0.0862068965517241;0.413793103448276
Control.SRR15539874;29;32;0.344827586206897;19;10;0.155172413793103;0.344827586206897
Control.SRR15539874;35;32;0.542857142857143;16;19;0.0428571428571428;0.457142857142857
Control.SRR15539874;38;32;0.394736842105263;23;15;0.105263157894737;0.394736842105263
Control.SRR15539874;29;32;0.482758620689655;15;14;0.0172413793103448;0.482758620689655
Control.SRR15539874;39;32;0.512820512820513;19;20;0.0128205128205128;0.487179487179487
Control.SRR15539874;32;32;0.46875;17;15;0.03125;0.46875
Control.SRR15539874;37;32;0.594594594594595;15;22;0.0945945945945946;0.405405405405405
Control.SRR15539874;31;32;0.451612903225806;17;14;0.0483870967741936;0.451612903225806
Control.SRR15539874;31;32;0.516129032258065;15;16;0.0161290322580645;0.483870967741935
Control.SRR15539874;30;32;0.3;21;9;0.2;0.3
Control.SRR15539874;37;32;0.594594594594595;15;22;0.0945945945945946;0.405405405405405
Control.SRR15539874;34;32;0.647058823529412;12;22;0.147058823529412;0.352941176470588
Control.SRR15539874;32;32;0.375;20;12;0.125;0.375
Control.SRR15539874;35;32;0.457142857142857;19;16;0.0428571428571429;0.457142857142857
Control.SRR15539874;36;32;0.472222222222222;19;17;0.0277777777777778;0.472222222222222
Control.SRR15539874;29;32;0.517241379310345;14;15;0.0172413793103449;0.482758620689655
Control.SRR15539874;31;32;0.645161290322581;11;20;0.145161290322581;0.354838709677419
Control.SRR15539874;29;32;0.379310344827586;18;11;0.120689655172414;0.379310344827586
Control.SRR15539874;38;32;0.473684210526316;20;18;0.0263157894736842;0.473684210526316
Control.SRR15539874;33;32;0.545454545454545;15;18;0.0454545454545454;0.454545454545455
Control.SRR15539874;31;32;0.451612903225806;17;14;0.0483870967741936;0.451612903225806
Control.SRR15539874;39;32;0.512820512820513;19;20;0.0128205128205128;0.487179487179487
Control.SRR15539874;35;32;0.485714285714286;18;17;0.0142857142857143;0.485714285714286
Control.SRR15539874;32;32;0.46875;17;15;0.03125;0.46875
Control.SRR15539874;32;32;0.375;20;12;0.125;0.375
Control.SRR15539874;29;32;0.517241379310345;14;15;0.0172413793103449;0.482758620689655
Control.SRR15539874;36;32;0.555555555555556;16;20;0.0555555555555556;0.444444444444444
Control.SRR15539874;39;32;0.538461538461538;18;21;0.0384615384615384;0.461538461538462
Control.SRR15539874;35;32;0.514285714285714;17;18;0.0142857142857142;0.485714285714286
Control.SRR15539874;33;32;0.575757575757576;14;19;0.0757575757575758;0.424242424242424
Control.SRR15539874;29;32;0.517241379310345;14;15;0.0172413793103449;0.482758620689655
Control.SRR15539874;36;32;0.416666666666667;21;15;0.0833333333333333;0.416666666666667
Control.SRR15539874;37;32;0.486486486486487;19;18;0.0135135135135135;0.486486486486487
Control.SRR15539874;35;32;0.542857142857143;16;19;0.0428571428571428;0.457142857142857
Control.SRR15539874;32;32;0.46875;17;15;0.03125;0.46875
Control.SRR15539874;33;32;0.484848484848485;17;16;0.0151515151515151;0.484848484848485
Control.SRR15539874;33;32;0.606060606060606;13;20;0.106060606060606;0.393939393939394
Control.SRR15539874;29;32;0.586206896551724;12;17;0.0862068965517241;0.413793103448276
Control.SRR15539874;30;32;0.333333333333333;20;10;0.166666666666667;0.333333333333333
Control.SRR15539874;32;32;0.59375;13;19;0.09375;0.40625
Control.SRR15539874;37;32;0.513513513513513;18;19;0.0135135135135135;0.486486486486487
Control.SRR15539874;38;32;0.5;19;19;0;0.5
Control.SRR15539874;32;32;0.46875;17;15;0.03125;0.46875
Control.SRR15539874;39;32;0.487179487179487;20;19;0.0128205128205128;0.487179487179487
Control.SRR15539874;37;32;0.486486486486487;19;18;0.0135135135135135;0.486486486486487
Control.SRR15539874;37;32;0.405405405405405;22;15;0.0945945945945946;0.405405405405405
Control.SRR15539874;38;32;0.473684210526316;20;18;0.0263157894736842;0.473684210526316
Control.SRR15539874;37;32;0.486486486486487;19;18;0.0135135135135135;0.486486486486487
Control.SRR15539874;36;32;0.444444444444444;20;16;0.0555555555555556;0.444444444444444
Control.SRR15539874;37;32;0.513513513513513;18;19;0.0135135135135135;0.486486486486487
Control.SRR15539874;32;32;0.5;16;16;0;0.5
Control.SRR15539874;31;32;0.580645161290323;13;18;0.0806451612903226;0.419354838709677
Control.SRR15539874;32;32;0.46875;17;15;0.03125;0.46875
Control.SRR15539874;38;32;0.578947368421053;16;22;0.0789473684210527;0.421052631578947
Control.SRR15539874;39;32;0.333333333333333;26;13;0.166666666666667;0.333333333333333
Control.SRR15539874;34;32;0.470588235294118;18;16;0.0294117647058824;0.470588235294118
Control.SRR15539874;35;32;0.457142857142857;19;16;0.0428571428571429;0.457142857142857
Control.SRR15539874;36;32;0.416666666666667;21;15;0.0833333333333333;0.416666666666667
Control.SRR15539874;38;32;0.526315789473684;18;20;0.0263157894736842;0.473684210526316
Control.SRR15539874;37;32;0.459459459459459;20;17;0.0405405405405405;0.459459459459459
Control.SRR15539874;29;32;0.689655172413793;9;20;0.189655172413793;0.310344827586207
Control.SRR15539874;29;32;0.620689655172414;11;18;0.120689655172414;0.379310344827586
Control.SRR15539874;38;32;0.5;19;19;0;0.5
Control.SRR15539874;31;32;0.483870967741935;16;15;0.0161290322580645;0.483870967741935
Control.SRR15539874;32;32;0.625;12;20;0.125;0.375
Control.SRR15539874;34;32;0.5;17;17;0;0.5
Control.SRR15539874;38;32;0.526315789473684;18;20;0.0263157894736842;0.473684210526316
Control.SRR15539874;34;32;0.5;17;17;0;0.5
Control.SRR15539874;38;32;0.5;19;19;0;0.5
Control.SRR15539874;35;32;0.428571428571429;20;15;0.0714285714285715;0.428571428571429
Control.SRR15539874;35;32;0.314285714285714;24;11;0.185714285714286;0.314285714285714
Control.SRR15539874;38;32;0.447368421052632;21;17;0.0526315789473684;0.447368421052632
Control.SRR15539874;34;32;0.529411764705882;16;18;0.0294117647058824;0.470588235294118
Control.SRR15539874;34;32;0.470588235294118;18;16;0.0294117647058824;0.470588235294118
Control.SRR15539874;31;32;0.580645161290323;13;18;0.0806451612903226;0.419354838709677
Control.SRR15539874;29;32;0.551724137931034;13;16;0.0517241379310345;0.448275862068966
Control.SRR15539874;30;32;0.533333333333333;14;16;0.0333333333333333;0.466666666666667
Control.SRR15539874;34;32;0.382352941176471;21;13;0.117647058823529;0.382352941176471
Control.SRR15539874;35;32;0.514285714285714;17;18;0.0142857142857142;0.485714285714286
Control.SRR15539874;29;32;0.517241379310345;14;15;0.0172413793103449;0.482758620689655
Control.SRR15539874;35;32;0.371428571428571;22;13;0.128571428571429;0.371428571428571
Control.SRR15539874;33;32;0.636363636363636;12;21;0.136363636363636;0.363636363636364
Control.SRR15539874;38;32;0.447368421052632;21;17;0.0526315789473684;0.447368421052632
Control.SRR15539874;37;32;0.540540540540541;17;20;0.0405405405405406;0.459459459459459
Control.SRR15539874;36;32;0.5;18;18;0;0.5
Control.SRR15539874;32;32;0.40625;19;13;0.09375;0.40625
Control.SRR15539874;30;32;0.566666666666667;13;17;0.0666666666666667;0.433333333333333
Control.SRR15539874;33;32;0.484848484848485;17;16;0.0151515151515151;0.484848484848485
Control.SRR15539874;29;32;0.413793103448276;17;12;0.0862068965517241;0.413793103448276
Control.SRR15539874;35;32;0.514285714285714;17;18;0.0142857142857142;0.485714285714286
Control.SRR15539874;35;32;0.571428571428571;15;20;0.0714285714285714;0.428571428571429
Control.SRR15539874;34;32;0.470588235294118;18;16;0.0294117647058824;0.470588235294118
Control.SRR15539874;35;32;0.485714285714286;18;17;0.0142857142857143;0.485714285714286
Control.SRR15539874;32;32;0.53125;15;17;0.03125;0.46875
Control.SRR15539874;32;32;0.53125;15;17;0.03125;0.46875
Control.SRR15539874;35;32;0.371428571428571;22;13;0.128571428571429;0.371428571428571
Control.SRR15539874;31;32;0.645161290322581;11;20;0.145161290322581;0.354838709677419
Control.SRR15539874;30;32;0.4;18;12;0.1;0.4
Control.SRR15539874;32;32;0.375;20;12;0.125;0.375
Control.SRR15539874;32;32;0.625;12;20;0.125;0.375
Control.SRR15539874;35;32;0.514285714285714;17;18;0.0142857142857142;0.485714285714286
Control.SRR15539874;35;32;0.542857142857143;16;19;0.0428571428571428;0.457142857142857
Control.SRR15539874;37;32;0.621621621621622;14;23;0.121621621621622;0.378378378378378
Control.SRR15539874;32;32;0.46875;17;15;0.03125;0.46875
Control.SRR15539874;35;32;0.514285714285714;17;18;0.0142857142857142;0.485714285714286
Control.SRR15539874;32;32;0.53125;15;17;0.03125;0.46875
Control.SRR15539874;37;32;0.567567567567568;16;21;0.0675675675675675;0.432432432432432
Control.SRR15539874;32;32;0.40625;19;13;0.09375;0.40625
Control.SRR15539874;31;32;0.451612903225806;17;14;0.0483870967741936;0.451612903225806
Control.SRR15539874;30;32;0.533333333333333;14;16;0.0333333333333333;0.466666666666667
Control.SRR15539874;33;32;0.545454545454545;15;18;0.0454545454545454;0.454545454545455
Control.SRR15539874;30;32;0.566666666666667;13;17;0.0666666666666667;0.433333333333333
Control.SRR15539874;34;32;0.5;17;17;0;0.5
Control.SRR15539874;36;32;0.388888888888889;22;14;0.111111111111111;0.388888888888889
Control.SRR15539874;35;32;0.542857142857143;16;19;0.0428571428571428;0.457142857142857
Control.SRR15539874;36;32;0.583333333333333;15;21;0.0833333333333334;0.416666666666667
Control.SRR15539874;35;32;0.457142857142857;19;16;0.0428571428571429;0.457142857142857
Control.SRR15539874;31;32;0.451612903225806;17;14;0.0483870967741936;0.451612903225806
Control.SRR15539874;36;32;0.5;18;18;0;0.5
Control.SRR15539874;34;32;0.441176470588235;19;15;0.0588235294117647;0.441176470588235
Control.SRR15539874;34;32;0.441176470588235;19;15;0.0588235294117647;0.441176470588235
Control.SRR15539874;39;32;0.512820512820513;19;20;0.0128205128205128;0.487179487179487
Control.SRR15539874;35;32;0.628571428571429;13;22;0.128571428571429;0.371428571428571
Control.SRR15539874;34;32;0.558823529411765;15;19;0.0588235294117647;0.441176470588235
Control.SRR15539874;29;32;0.379310344827586;18;11;0.120689655172414;0.379310344827586
Control.SRR15539874;35;32;0.457142857142857;19;16;0.0428571428571429;0.457142857142857
Control.SRR15539874;30;32;0.466666666666667;16;14;0.0333333333333333;0.466666666666667
Control.SRR15539874;38;32;0.578947368421053;16;22;0.0789473684210527;0.421052631578947
Control.SRR15539874;33;32;0.606060606060606;13;20;0.106060606060606;0.393939393939394
Control.SRR15539874;33;32;0.575757575757576;14;19;0.0757575757575758;0.424242424242424
Control.SRR15539874;33;32;0.666666666666667;11;22;0.166666666666667;0.333333333333333
Control.SRR15539874;37;32;0.540540540540541;17;20;0.0405405405405406;0.459459459459459
Control.SRR15539874;37;32;0.432432432432432;21;16;0.0675675675675675;0.432432432432432
Control.SRR15539874;39;32;0.487179487179487;20;19;0.0128205128205128;0.487179487179487
Control.SRR15539874;35;32;0.628571428571429;13;22;0.128571428571429;0.371428571428571
Control.SRR15539874;37;32;0.459459459459459;20;17;0.0405405405405405;0.459459459459459
Control.SRR15539874;31;32;0.645161290322581;11;20;0.145161290322581;0.354838709677419
Control.SRR15539874;34;32;0.470588235294118;18;16;0.0294117647058824;0.470588235294118
Control.SRR15539874;33;32;0.363636363636364;21;12;0.136363636363636;0.363636363636364
Control.SRR15539874;37;32;0.513513513513513;18;19;0.0135135135135135;0.486486486486487
Control.SRR15539874;37;32;0.540540540540541;17;20;0.0405405405405406;0.459459459459459
Control.SRR15539874;34;32;0.441176470588235;19;15;0.0588235294117647;0.441176470588235
Control.SRR15539874;29;32;0.620689655172414;11;18;0.120689655172414;0.379310344827586
Control.SRR15539874;32;32;0.46875;17;15;0.03125;0.46875
Control.SRR15539874;34;32;0.470588235294118;18;16;0.0294117647058824;0.470588235294118
Control.SRR15539874;29;32;0.620689655172414;11;18;0.120689655172414;0.379310344827586
Control.SRR15539874;35;32;0.514285714285714;17;18;0.0142857142857142;0.485714285714286
Control.SRR15539874;32;32;0.5625;14;18;0.0625;0.4375
Control.SRR15539874;32;32;0.5625;14;18;0.0625;0.4375
Control.SRR15539874;29;32;0.482758620689655;15;14;0.0172413793103448;0.482758620689655
Control.SRR15539874;32;32;0.375;20;12;0.125;0.375
Control.SRR15539874;30;32;0.466666666666667;16;14;0.0333333333333333;0.466666666666667
Control.SRR15539874;36;32;0.666666666666667;12;24;0.166666666666667;0.333333333333333
Control.SRR15539874;37;32;0.567567567567568;16;21;0.0675675675675675;0.432432432432432
Control.SRR15539874;39;32;0.564102564102564;17;22;0.0641025641025641;0.435897435897436
Control.SRR15539874;36;32;0.416666666666667;21;15;0.0833333333333333;0.416666666666667
Control.SRR15539874;34;32;0.529411764705882;16;18;0.0294117647058824;0.470588235294118
Control.SRR15539874;37;32;0.405405405405405;22;15;0.0945945945945946;0.405405405405405
Control.SRR15539874;32;32;0.46875;17;15;0.03125;0.46875
Control.SRR15539874;36;32;0.527777777777778;17;19;0.0277777777777778;0.472222222222222
Control.SRR15539874;38;32;0.526315789473684;18;20;0.0263157894736842;0.473684210526316
Control.SRR15539874;34;32;0.441176470588235;19;15;0.0588235294117647;0.441176470588235
Control.SRR15539874;30;32;0.6;12;18;0.1;0.4
Control.SRR15539874;39;32;0.384615384615385;24;15;0.115384615384615;0.384615384615385
Control.SRR15539874;33;32;0.575757575757576;14;19;0.0757575757575758;0.424242424242424
Control.SRR15539874;29;32;0.655172413793103;10;19;0.155172413793103;0.344827586206897
Control.SRR15539874;30;32;0.5;15;15;0;0.5
Control.SRR15539874;39;32;0.641025641025641;14;25;0.141025641025641;0.358974358974359
Control.SRR15539874;39;32;0.58974358974359;16;23;0.0897435897435898;0.41025641025641
Control.SRR15539874;35;32;0.342857142857143;23;12;0.157142857142857;0.342857142857143
Control.SRR15539874;34;32;0.5;17;17;0;0.5
Control.SRR15539874;29;32;0.379310344827586;18;11;0.120689655172414;0.379310344827586
Control.SRR15539874;32;32;0.4375;18;14;0.0625;0.4375
Control.SRR15539874;33;32;0.454545454545455;18;15;0.0454545454545455;0.454545454545455
Control.SRR15539874;33;32;0.545454545454545;15;18;0.0454545454545454;0.454545454545455
Control.SRR15539874;34;32;0.558823529411765;15;19;0.0588235294117647;0.441176470588235
Control.SRR15539874;35;32;0.514285714285714;17;18;0.0142857142857142;0.485714285714286
Control.SRR15539874;37;32;0.405405405405405;22;15;0.0945945945945946;0.405405405405405
Control.SRR15539874;38;32;0.473684210526316;20;18;0.0263157894736842;0.473684210526316
Control.SRR15539874;37;32;0.540540540540541;17;20;0.0405405405405406;0.459459459459459
Control.SRR15539874;30;32;0.533333333333333;14;16;0.0333333333333333;0.466666666666667
Control.SRR15539874;31;32;0.580645161290323;13;18;0.0806451612903226;0.419354838709677
Control.SRR15539874;38;32;0.5;19;19;0;0.5
Control.SRR15539874;38;32;0.526315789473684;18;20;0.0263157894736842;0.473684210526316
Control.SRR15539874;32;32;0.59375;13;19;0.09375;0.40625
Control.SRR15539874;38;32;0.394736842105263;23;15;0.105263157894737;0.394736842105263
Control.SRR15539874;35;32;0.542857142857143;16;19;0.0428571428571428;0.457142857142857
Control.SRR15539874;37;32;0.459459459459459;20;17;0.0405405405405405;0.459459459459459
Control.SRR15539874;31;32;0.612903225806452;12;19;0.112903225806452;0.387096774193548
Control.SRR15539874;30;32;0.466666666666667;16;14;0.0333333333333333;0.466666666666667
Control.SRR15539874;34;32;0.558823529411765;15;19;0.0588235294117647;0.441176470588235
Control.SRR15539874;35;32;0.428571428571429;20;15;0.0714285714285715;0.428571428571429
Control.SRR15539874;31;32;0.451612903225806;17;14;0.0483870967741936;0.451612903225806
Control.SRR15539874;38;32;0.394736842105263;23;15;0.105263157894737;0.394736842105263
Control.SRR15539874;30;32;0.566666666666667;13;17;0.0666666666666667;0.433333333333333
Control.SRR15539874;30;32;0.4;18;12;0.1;0.4
Control.SRR15539874;32;32;0.375;20;12;0.125;0.375
Control.SRR15539874;30;32;0.5;15;15;0;0.5
Control.SRR15539874;32;32;0.46875;17;15;0.03125;0.46875
Control.SRR15539874;29;32;0.517241379310345;14;15;0.0172413793103449;0.482758620689655
Control.SRR15539874;35;32;0.542857142857143;16;19;0.0428571428571428;0.457142857142857
Control.SRR15539874;32;32;0.34375;21;11;0.15625;0.34375
Control.SRR15539874;37;32;0.675675675675676;12;25;0.175675675675676;0.324324324324324
Control.SRR15539874;38;32;0.394736842105263;23;15;0.105263157894737;0.394736842105263
Control.SRR15539874;32;32;0.4375;18;14;0.0625;0.4375
Control.SRR15539874;32;32;0.4375;18;14;0.0625;0.4375
Control.SRR15539874;35;32;0.428571428571429;20;15;0.0714285714285715;0.428571428571429
Control.SRR15539874;30;32;0.5;15;15;0;0.5
Control.SRR15539874;33;32;0.484848484848485;17;16;0.0151515151515151;0.484848484848485
Control.SRR15539874;33;32;0.484848484848485;17;16;0.0151515151515151;0.484848484848485
Control.SRR15539874;37;32;0.594594594594595;15;22;0.0945945945945946;0.405405405405405
Control.SRR15539874;34;32;0.529411764705882;16;18;0.0294117647058824;0.470588235294118
Control.SRR15539874;36;32;0.5;18;18;0;0.5
Control.SRR15539874;37;32;0.594594594594595;15;22;0.0945945945945946;0.405405405405405
Control.SRR15539874;35;32;0.628571428571429;13;22;0.128571428571429;0.371428571428571
Control.SRR15539874;32;32;0.625;12;20;0.125;0.375
Control.SRR15539874;31;32;0.483870967741935;16;15;0.0161290322580645;0.483870967741935
Control.SRR15539874;39;32;0.435897435897436;22;17;0.0641025641025641;0.435897435897436
Control.SRR15539874;35;32;0.485714285714286;18;17;0.0142857142857143;0.485714285714286
Control.SRR15539874;35;32;0.371428571428571;22;13;0.128571428571429;0.371428571428571
Control.SRR15539874;31;32;0.419354838709677;18;13;0.0806451612903226;0.419354838709677
Control.SRR15539874;30;32;0.5;15;15;0;0.5
Control.SRR15539874;31;32;0.516129032258065;15;16;0.0161290322580645;0.483870967741935
Control.SRR15539874;37;32;0.378378378378378;23;14;0.121621621621622;0.378378378378378
Control.SRR15539874;30;32;0.4;18;12;0.1;0.4
Control.SRR15539874;38;32;0.394736842105263;23;15;0.105263157894737;0.394736842105263
Control.SRR15539874;37;32;0.351351351351351;24;13;0.148648648648649;0.351351351351351
Control.SRR15539874;34;32;0.5;17;17;0;0.5
Control.SRR15539874;35;32;0.571428571428571;15;20;0.0714285714285714;0.428571428571429
Control.SRR15539874;37;32;0.621621621621622;14;23;0.121621621621622;0.378378378378378
Control.SRR15539874;37;32;0.594594594594595;15;22;0.0945945945945946;0.405405405405405
Control.SRR15539874;39;32;0.58974358974359;16;23;0.0897435897435898;0.41025641025641
Control.SRR15539874;34;32;0.676470588235294;11;23;0.176470588235294;0.323529411764706
Control.SRR15539874;38;32;0.394736842105263;23;15;0.105263157894737;0.394736842105263
Control.SRR15539874;29;32;0.482758620689655;15;14;0.0172413793103448;0.482758620689655
Control.SRR15539874;35;32;0.571428571428571;15;20;0.0714285714285714;0.428571428571429
Control.SRR15539874;34;32;0.588235294117647;14;20;0.0882352941176471;0.411764705882353
Control.SRR15539874;34;32;0.558823529411765;15;19;0.0588235294117647;0.441176470588235
Control.SRR15539874;38;32;0.552631578947368;17;21;0.0526315789473685;0.447368421052632
Control.SRR15539874;34;32;0.617647058823529;13;21;0.117647058823529;0.382352941176471
Control.SRR15539874;30;32;0.466666666666667;16;14;0.0333333333333333;0.466666666666667
Control.SRR15539874;33;32;0.303030303030303;23;10;0.196969696969697;0.303030303030303
Control.SRR15539874;30;32;0.633333333333333;11;19;0.133333333333333;0.366666666666667
Control.SRR15539874;39;32;0.487179487179487;20;19;0.0128205128205128;0.487179487179487
Control.SRR15539874;32;32;0.5;16;16;0;0.5
Control.SRR15539874;35;32;0.6;14;21;0.1;0.4
Control.SRR15539874;34;32;0.588235294117647;14;20;0.0882352941176471;0.411764705882353
Control.SRR15539874;37;32;0.540540540540541;17;20;0.0405405405405406;0.459459459459459
Control.SRR15539874;37;32;0.648648648648649;13;24;0.148648648648649;0.351351351351351
Control.SRR15539874;38;32;0.526315789473684;18;20;0.0263157894736842;0.473684210526316
Control.SRR15539874;30;32;0.566666666666667;13;17;0.0666666666666667;0.433333333333333
Control.SRR15539874;32;32;0.46875;17;15;0.03125;0.46875
Control.SRR15539874;36;32;0.555555555555556;16;20;0.0555555555555556;0.444444444444444
Control.SRR15539874;34;32;0.5;17;17;0;0.5
Control.SRR15539874;33;32;0.484848484848485;17;16;0.0151515151515151;0.484848484848485
Control.SRR15539874;35;32;0.485714285714286;18;17;0.0142857142857143;0.485714285714286
Control.SRR15539874;36;32;0.527777777777778;17;19;0.0277777777777778;0.472222222222222
Control.SRR15539874;34;32;0.382352941176471;21;13;0.117647058823529;0.382352941176471
Control.SRR15539874;34;32;0.558823529411765;15;19;0.0588235294117647;0.441176470588235
Control.SRR15539874;35;32;0.514285714285714;17;18;0.0142857142857142;0.485714285714286
Control.SRR15539874;36;32;0.638888888888889;13;23;0.138888888888889;0.361111111111111
Control.SRR15539874;34;32;0.5;17;17;0;0.5
Control.SRR15539874;32;32;0.4375;18;14;0.0625;0.4375
Control.SRR15539874;38;32;0.394736842105263;23;15;0.105263157894737;0.394736842105263
Control.SRR15539874;33;32;0.515151515151515;16;17;0.0151515151515151;0.484848484848485
Control.SRR15539874;34;32;0.676470588235294;11;23;0.176470588235294;0.323529411764706
Control.SRR15539874;29;32;0.758620689655172;7;22;0.258620689655172;0.241379310344828
Control.SRR15539874;32;32;0.53125;15;17;0.03125;0.46875
Control.SRR15539874;29;32;0.448275862068966;16;13;0.0517241379310345;0.448275862068966
Control.SRR15539874;30;32;0.533333333333333;14;16;0.0333333333333333;0.466666666666667
Control.SRR15539874;29;32;0.517241379310345;14;15;0.0172413793103449;0.482758620689655
Control.SRR15539874;33;32;0.606060606060606;13;20;0.106060606060606;0.393939393939394
Control.SRR15539874;36;32;0.583333333333333;15;21;0.0833333333333334;0.416666666666667
Control.SRR15539874;37;32;0.567567567567568;16;21;0.0675675675675675;0.432432432432432
Control.SRR15539874;29;32;0.448275862068966;16;13;0.0517241379310345;0.448275862068966
Control.SRR15539874;31;32;0.419354838709677;18;13;0.0806451612903226;0.419354838709677
Control.SRR15539874;33;32;0.606060606060606;13;20;0.106060606060606;0.393939393939394
Control.SRR15539874;31;32;0.580645161290323;13;18;0.0806451612903226;0.419354838709677
Control.SRR15539874;35;32;0.542857142857143;16;19;0.0428571428571428;0.457142857142857
Control.SRR15539874;38;32;0.342105263157895;25;13;0.157894736842105;0.342105263157895
Control.SRR15539874;36;32;0.638888888888889;13;23;0.138888888888889;0.361111111111111
Control.SRR15539874;35;32;0.542857142857143;16;19;0.0428571428571428;0.457142857142857
Control.SRR15539874;37;32;0.540540540540541;17;20;0.0405405405405406;0.459459459459459
Control.SRR15539874;35;32;0.485714285714286;18;17;0.0142857142857143;0.485714285714286
Control.SRR15539874;39;32;0.358974358974359;25;14;0.141025641025641;0.358974358974359
Control.SRR15539874;39;32;0.384615384615385;24;15;0.115384615384615;0.384615384615385
Control.SRR15539874;39;32;0.564102564102564;17;22;0.0641025641025641;0.435897435897436
Control.SRR15539874;32;32;0.4375;18;14;0.0625;0.4375
Control.SRR15539874;29;32;0.482758620689655;15;14;0.0172413793103448;0.482758620689655
Control.SRR15539874;29;32;0.586206896551724;12;17;0.0862068965517241;0.413793103448276
Control.SRR15539874;33;32;0.484848484848485;17;16;0.0151515151515151;0.484848484848485
Control.SRR15539874;32;32;0.4375;18;14;0.0625;0.4375
Control.SRR15539874;35;32;0.485714285714286;18;17;0.0142857142857143;0.485714285714286
Control.SRR15539874;34;32;0.529411764705882;16;18;0.0294117647058824;0.470588235294118
Control.SRR15539874;36;32;0.583333333333333;15;21;0.0833333333333334;0.416666666666667
Control.SRR15539874;38;32;0.473684210526316;20;18;0.0263157894736842;0.473684210526316
Control.SRR15539874;37;32;0.513513513513513;18;19;0.0135135135135135;0.486486486486487
Control.SRR15539874;36;32;0.583333333333333;15;21;0.0833333333333334;0.416666666666667
Control.SRR15539874;30;32;0.433333333333333;17;13;0.0666666666666667;0.433333333333333
Control.SRR15539874;35;32;0.485714285714286;18;17;0.0142857142857143;0.485714285714286
Control.SRR15539874;37;32;0.486486486486487;19;18;0.0135135135135135;0.486486486486487
Control.SRR15539874;33;32;0.484848484848485;17;16;0.0151515151515151;0.484848484848485
Control.SRR15539874;38;32;0.526315789473684;18;20;0.0263157894736842;0.473684210526316
Control.SRR15539874;34;32;0.529411764705882;16;18;0.0294117647058824;0.470588235294118
Control.SRR15539874;34;32;0.470588235294118;18;16;0.0294117647058824;0.470588235294118
Control.SRR15539874;39;32;0.41025641025641;23;16;0.0897435897435898;0.41025641025641
Control.SRR15539874;31;32;0.483870967741935;16;15;0.0161290322580645;0.483870967741935
Control.SRR15539874;34;32;0.441176470588235;19;15;0.0588235294117647;0.441176470588235
Control.SRR15539874;32;32;0.65625;11;21;0.15625;0.34375
Control.SRR15539874;34;32;0.529411764705882;16;18;0.0294117647058824;0.470588235294118
Control.SRR15539874;39;32;0.512820512820513;19;20;0.0128205128205128;0.487179487179487
Control.SRR15539874;39;32;0.435897435897436;22;17;0.0641025641025641;0.435897435897436
Control.SRR15539874;30;32;0.366666666666667;19;11;0.133333333333333;0.366666666666667
Control.SRR15539874;34;32;0.294117647058824;24;10;0.205882352941176;0.294117647058824
Control.SRR15539874;33;32;0.424242424242424;19;14;0.0757575757575757;0.424242424242424
Control.SRR15539874;31;32;0.516129032258065;15;16;0.0161290322580645;0.483870967741935
Control.SRR15539874;31;32;0.580645161290323;13;18;0.0806451612903226;0.419354838709677
Control.SRR15539874;29;32;0.448275862068966;16;13;0.0517241379310345;0.448275862068966
Control.SRR15539874;33;32;0.515151515151515;16;17;0.0151515151515151;0.484848484848485
Control.SRR15539874;35;32;0.485714285714286;18;17;0.0142857142857143;0.485714285714286
Control.SRR15539874;29;32;0.655172413793103;10;19;0.155172413793103;0.344827586206897
Control.SRR15539874;31;32;0.483870967741935;16;15;0.0161290322580645;0.483870967741935
Control.SRR15539874;39;32;0.538461538461538;18;21;0.0384615384615384;0.461538461538462
Control.SRR15539874;34;32;0.647058823529412;12;22;0.147058823529412;0.352941176470588
Control.SRR15539874;35;32;0.428571428571429;20;15;0.0714285714285715;0.428571428571429
Control.SRR15539874;35;32;0.514285714285714;17;18;0.0142857142857142;0.485714285714286
Control.SRR15539874;36;32;0.444444444444444;20;16;0.0555555555555556;0.444444444444444
Control.SRR15539874;33;32;0.575757575757576;14;19;0.0757575757575758;0.424242424242424
Control.SRR15539874;34;32;0.5;17;17;0;0.5
Control.SRR15539874;36;32;0.638888888888889;13;23;0.138888888888889;0.361111111111111
Control.SRR15539874;34;32;0.558823529411765;15;19;0.0588235294117647;0.441176470588235
Control.SRR15539874;32;32;0.46875;17;15;0.03125;0.46875
Control.SRR15539874;29;32;0.482758620689655;15;14;0.0172413793103448;0.482758620689655
Control.SRR15539874;36;32;0.444444444444444;20;16;0.0555555555555556;0.444444444444444
Control.SRR15539874;37;32;0.702702702702703;11;26;0.202702702702703;0.297297297297297
Control.SRR15539874;35;32;0.6;14;21;0.1;0.4
Control.SRR15539874;34;32;0.5;17;17;0;0.5
Control.SRR15539874;36;32;0.444444444444444;20;16;0.0555555555555556;0.444444444444444
Control.SRR15539874;38;32;0.236842105263158;29;9;0.263157894736842;0.236842105263158
Control.SRR15539874;37;32;0.405405405405405;22;15;0.0945945945945946;0.405405405405405
Control.SRR15539874;33;32;0.515151515151515;16;17;0.0151515151515151;0.484848484848485
Control.SRR15539874;31;32;0.483870967741935;16;15;0.0161290322580645;0.483870967741935
Control.SRR15539874;33;32;0.636363636363636;12;21;0.136363636363636;0.363636363636364
Control.SRR15539874;31;32;0.419354838709677;18;13;0.0806451612903226;0.419354838709677
Control.SRR15539874;37;32;0.459459459459459;20;17;0.0405405405405405;0.459459459459459
Control.SRR15539874;29;32;0.413793103448276;17;12;0.0862068965517241;0.413793103448276
Control.SRR15539874;33;32;0.333333333333333;22;11;0.166666666666667;0.333333333333333
Control.SRR15539874;36;32;0.611111111111111;14;22;0.111111111111111;0.388888888888889
Control.SRR15539874;38;32;0.473684210526316;20;18;0.0263157894736842;0.473684210526316
Control.SRR15539874;34;32;0.470588235294118;18;16;0.0294117647058824;0.470588235294118
Control.SRR15539874;37;32;0.486486486486487;19;18;0.0135135135135135;0.486486486486487
Control.SRR15539874;39;32;0.538461538461538;18;21;0.0384615384615384;0.461538461538462
Control.SRR15539874;36;32;0.5;18;18;0;0.5
Control.SRR15539874;30;32;0.666666666666667;10;20;0.166666666666667;0.333333333333333
Control.SRR15539874;35;32;0.4;21;14;0.1;0.4
Control.SRR15539874;37;32;0.486486486486487;19;18;0.0135135135135135;0.486486486486487
Control.SRR15539874;38;32;0.5;19;19;0;0.5
Control.SRR15539874;33;32;0.393939393939394;20;13;0.106060606060606;0.393939393939394
Control.SRR15539874;34;32;0.5;17;17;0;0.5
Control.SRR15539874;33;32;0.575757575757576;14;19;0.0757575757575758;0.424242424242424
Control.SRR15539874;33;32;0.484848484848485;17;16;0.0151515151515151;0.484848484848485
Control.SRR15539874;33;32;0.545454545454545;15;18;0.0454545454545454;0.454545454545455
Control.SRR15539874;29;32;0.379310344827586;18;11;0.120689655172414;0.379310344827586
Control.SRR15539874;33;32;0.515151515151515;16;17;0.0151515151515151;0.484848484848485
Control.SRR15539874;32;32;0.5;16;16;0;0.5
Control.SRR15539874;35;32;0.485714285714286;18;17;0.0142857142857143;0.485714285714286
Control.SRR15539874;31;32;0.483870967741935;16;15;0.0161290322580645;0.483870967741935
Control.SRR15539874;32;32;0.4375;18;14;0.0625;0.4375
Control.SRR15539874;32;32;0.53125;15;17;0.03125;0.46875
Control.SRR15539874;31;32;0.612903225806452;12;19;0.112903225806452;0.387096774193548
Control.SRR15539874;35;32;0.685714285714286;11;24;0.185714285714286;0.314285714285714
Control.SRR15539874;38;32;0.526315789473684;18;20;0.0263157894736842;0.473684210526316
Control.SRR15539874;33;32;0.545454545454545;15;18;0.0454545454545454;0.454545454545455
Control.SRR15539874;37;32;0.648648648648649;13;24;0.148648648648649;0.351351351351351
Control.SRR15539874;33;32;0.424242424242424;19;14;0.0757575757575757;0.424242424242424
Control.SRR15539874;37;32;0.459459459459459;20;17;0.0405405405405405;0.459459459459459
Control.SRR15539874;34;32;0.411764705882353;20;14;0.0882352941176471;0.411764705882353
Control.SRR15539874;34;32;0.411764705882353;20;14;0.0882352941176471;0.411764705882353
Control.SRR15539874;30;32;0.433333333333333;17;13;0.0666666666666667;0.433333333333333
Control.SRR15539874;36;32;0.361111111111111;23;13;0.138888888888889;0.361111111111111
Control.SRR15539874;35;32;0.6;14;21;0.1;0.4
Control.SRR15539874;32;32;0.5;16;16;0;0.5
Control.SRR15539874;34;32;0.588235294117647;14;20;0.0882352941176471;0.411764705882353
Control.SRR15539874;29;32;0.448275862068966;16;13;0.0517241379310345;0.448275862068966
Control.SRR15539874;34;32;0.441176470588235;19;15;0.0588235294117647;0.441176470588235
Control.SRR15539874;32;32;0.5;16;16;0;0.5
Control.SRR15539874;39;32;0.512820512820513;19;20;0.0128205128205128;0.487179487179487
Control.SRR15539874;31;32;0.516129032258065;15;16;0.0161290322580645;0.483870967741935
Control.SRR15539874;30;32;0.4;18;12;0.1;0.4
Control.SRR15539874;37;32;0.594594594594595;15;22;0.0945945945945946;0.405405405405405
Control.SRR15539874;34;32;0.558823529411765;15;19;0.0588235294117647;0.441176470588235
Control.SRR15539874;30;32;0.466666666666667;16;14;0.0333333333333333;0.466666666666667
Control.SRR15539874;30;32;0.433333333333333;17;13;0.0666666666666667;0.433333333333333
Control.SRR15539874;38;32;0.5;19;19;0;0.5
Control.SRR15539874;39;32;0.538461538461538;18;21;0.0384615384615384;0.461538461538462
Control.SRR15539874;39;32;0.41025641025641;23;16;0.0897435897435898;0.41025641025641
Control.SRR15539874;34;32;0.441176470588235;19;15;0.0588235294117647;0.441176470588235
Control.SRR15539874;37;32;0.567567567567568;16;21;0.0675675675675675;0.432432432432432
Control.SRR15539874;37;32;0.432432432432432;21;16;0.0675675675675675;0.432432432432432
Control.SRR15539874;34;32;0.558823529411765;15;19;0.0588235294117647;0.441176470588235
Control.SRR15539874;34;32;0.411764705882353;20;14;0.0882352941176471;0.411764705882353
Control.SRR15539874;34;32;0.411764705882353;20;14;0.0882352941176471;0.411764705882353
Control.SRR15539874;32;32;0.59375;13;19;0.09375;0.40625
Control.SRR15539874;37;32;0.432432432432432;21;16;0.0675675675675675;0.432432432432432
Control.SRR15539874;37;32;0.594594594594595;15;22;0.0945945945945946;0.405405405405405
Control.SRR15539874;32;32;0.375;20;12;0.125;0.375
Control.SRR15539874;36;32;0.444444444444444;20;16;0.0555555555555556;0.444444444444444
Control.SRR15539874;29;32;0.586206896551724;12;17;0.0862068965517241;0.413793103448276
Control.SRR15539874;34;32;0.588235294117647;14;20;0.0882352941176471;0.411764705882353
Control.SRR15539874;35;32;0.457142857142857;19;16;0.0428571428571429;0.457142857142857
Control.SRR15539874;30;32;0.5;15;15;0;0.5
Control.SRR15539874;34;32;0.470588235294118;18;16;0.0294117647058824;0.470588235294118
Control.SRR15539874;34;32;0.5;17;17;0;0.5
Control.SRR15539874;39;32;0.512820512820513;19;20;0.0128205128205128;0.487179487179487
Control.SRR15539874;36;32;0.611111111111111;14;22;0.111111111111111;0.388888888888889
Control.SRR15539874;39;32;0.461538461538462;21;18;0.0384615384615384;0.461538461538462
Control.SRR15539874;31;32;0.483870967741935;16;15;0.0161290322580645;0.483870967741935
Control.SRR15539874;35;32;0.371428571428571;22;13;0.128571428571429;0.371428571428571
Control.SRR15539874;37;32;0.540540540540541;17;20;0.0405405405405406;0.459459459459459
Control.SRR15539874;36;32;0.472222222222222;19;17;0.0277777777777778;0.472222222222222
Control.SRR15539874;31;32;0.516129032258065;15;16;0.0161290322580645;0.483870967741935
Control.SRR15539874;30;32;0.5;15;15;0;0.5
Control.SRR15539874;37;32;0.540540540540541;17;20;0.0405405405405406;0.459459459459459
Control.SRR15539874;33;32;0.393939393939394;20;13;0.106060606060606;0.393939393939394
Control.SRR15539874;35;32;0.428571428571429;20;15;0.0714285714285715;0.428571428571429
Control.SRR15539874;30;32;0.5;15;15;0;0.5
Control.SRR15539874;34;32;0.470588235294118;18;16;0.0294117647058824;0.470588235294118
Control.SRR15539874;35;32;0.4;21;14;0.1;0.4
Control.SRR15539874;36;32;0.444444444444444;20;16;0.0555555555555556;0.444444444444444
Control.SRR15539874;36;32;0.416666666666667;21;15;0.0833333333333333;0.416666666666667
Control.SRR15539874;30;32;0.533333333333333;14;16;0.0333333333333333;0.466666666666667
Control.SRR15539874;34;32;0.529411764705882;16;18;0.0294117647058824;0.470588235294118
Control.SRR15539874;30;32;0.466666666666667;16;14;0.0333333333333333;0.466666666666667
Control.SRR15539874;37;32;0.486486486486487;19;18;0.0135135135135135;0.486486486486487
Control.SRR15539874;32;32;0.5;16;16;0;0.5
Control.SRR15539874;38;32;0.394736842105263;23;15;0.105263157894737;0.394736842105263
Control.SRR15539874;31;32;0.483870967741935;16;15;0.0161290322580645;0.483870967741935
Control.SRR15539874;32;32;0.4375;18;14;0.0625;0.4375
Control.SRR15539874;32;32;0.375;20;12;0.125;0.375
Control.SRR15539874;34;32;0.5;17;17;0;0.5
Control.SRR15539874;39;32;0.538461538461538;18;21;0.0384615384615384;0.461538461538462
Control.SRR15539874;35;32;0.514285714285714;17;18;0.0142857142857142;0.485714285714286
Control.SRR15539874;35;32;0.485714285714286;18;17;0.0142857142857143;0.485714285714286
Control.SRR15539874;34;32;0.529411764705882;16;18;0.0294117647058824;0.470588235294118
Control.SRR15539874;35;32;0.428571428571429;20;15;0.0714285714285715;0.428571428571429
Control.SRR15539874;29;32;0.689655172413793;9;20;0.189655172413793;0.310344827586207
Control.SRR15539874;32;32;0.5625;14;18;0.0625;0.4375
Control.SRR15539874;31;32;0.419354838709677;18;13;0.0806451612903226;0.419354838709677
Control.SRR15539874;39;32;0.512820512820513;19;20;0.0128205128205128;0.487179487179487
Control.SRR15539874;29;32;0.413793103448276;17;12;0.0862068965517241;0.413793103448276
Control.SRR15539874;39;32;0.461538461538462;21;18;0.0384615384615384;0.461538461538462
Control.SRR15539874;36;32;0.5;18;18;0;0.5
Control.SRR15539874;36;32;0.444444444444444;20;16;0.0555555555555556;0.444444444444444
Control.SRR15539874;37;32;0.486486486486487;19;18;0.0135135135135135;0.486486486486487
Control.SRR15539874;33;32;0.606060606060606;13;20;0.106060606060606;0.393939393939394
Control.SRR15539874;37;32;0.459459459459459;20;17;0.0405405405405405;0.459459459459459
Control.SRR15539874;29;32;0.689655172413793;9;20;0.189655172413793;0.310344827586207
Control.SRR15539874;32;32;0.46875;17;15;0.03125;0.46875
Control.SRR15539874;29;32;0.551724137931034;13;16;0.0517241379310345;0.448275862068966
Control.SRR15539874;34;32;0.5;17;17;0;0.5
Control.SRR15539874;35;32;0.571428571428571;15;20;0.0714285714285714;0.428571428571429
Control.SRR15539874;31;32;0.419354838709677;18;13;0.0806451612903226;0.419354838709677
Control.SRR15539874;30;32;0.466666666666667;16;14;0.0333333333333333;0.466666666666667
Control.SRR15539874;30;32;0.433333333333333;17;13;0.0666666666666667;0.433333333333333
Control.SRR15539874;33;32;0.454545454545455;18;15;0.0454545454545455;0.454545454545455
Control.SRR15539874;34;32;0.470588235294118;18;16;0.0294117647058824;0.470588235294118
Control.SRR15539874;29;32;0.551724137931034;13;16;0.0517241379310345;0.448275862068966
Control.SRR15539874;31;32;0.580645161290323;13;18;0.0806451612903226;0.419354838709677
Control.SRR15539874;31;32;0.483870967741935;16;15;0.0161290322580645;0.483870967741935
Control.SRR15539874;35;32;0.6;14;21;0.1;0.4
Control.SRR15539874;34;32;0.558823529411765;15;19;0.0588235294117647;0.441176470588235
Control.SRR15539874;29;32;0.586206896551724;12;17;0.0862068965517241;0.413793103448276
Control.SRR15539874;29;32;0.482758620689655;15;14;0.0172413793103448;0.482758620689655
Control.SRR15539874;30;32;0.533333333333333;14;16;0.0333333333333333;0.466666666666667
Control.SRR15539874;35;32;0.628571428571429;13;22;0.128571428571429;0.371428571428571
Control.SRR15539874;31;32;0.387096774193548;19;12;0.112903225806452;0.387096774193548
Control.SRR15539874;35;32;0.457142857142857;19;16;0.0428571428571429;0.457142857142857
Control.SRR15539874;31;32;0.451612903225806;17;14;0.0483870967741936;0.451612903225806
Control.SRR15539874;39;32;0.487179487179487;20;19;0.0128205128205128;0.487179487179487
Control.SRR15539874;39;32;0.615384615384615;15;24;0.115384615384615;0.384615384615385
Control.SRR15539874;36;32;0.472222222222222;19;17;0.0277777777777778;0.472222222222222
Control.SRR15539874;29;32;0.586206896551724;12;17;0.0862068965517241;0.413793103448276
Control.SRR15539874;29;32;0.551724137931034;13;16;0.0517241379310345;0.448275862068966
Control.SRR15539874;32;32;0.625;12;20;0.125;0.375
Control.SRR15539874;30;32;0.333333333333333;20;10;0.166666666666667;0.333333333333333
Control.SRR15539874;32;32;0.40625;19;13;0.09375;0.40625
Control.SRR15539874;29;32;0.482758620689655;15;14;0.0172413793103448;0.482758620689655
Control.SRR15539874;29;32;0.482758620689655;15;14;0.0172413793103448;0.482758620689655
Control.SRR15539874;34;32;0.470588235294118;18;16;0.0294117647058824;0.470588235294118
Control.SRR15539874;33;32;0.515151515151515;16;17;0.0151515151515151;0.484848484848485
Control.SRR15539874;39;32;0.487179487179487;20;19;0.0128205128205128;0.487179487179487
Control.SRR15539874;34;32;0.411764705882353;20;14;0.0882352941176471;0.411764705882353
Control.SRR15539874;34;32;0.558823529411765;15;19;0.0588235294117647;0.441176470588235
Control.SRR15539874;34;32;0.588235294117647;14;20;0.0882352941176471;0.411764705882353
Control.SRR15539874;37;32;0.378378378378378;23;14;0.121621621621622;0.378378378378378
Control.SRR15539874;39;32;0.461538461538462;21;18;0.0384615384615384;0.461538461538462
Control.SRR15539874;36;32;0.583333333333333;15;21;0.0833333333333334;0.416666666666667
Control.SRR15539874;31;32;0.387096774193548;19;12;0.112903225806452;0.387096774193548
Control.SRR15539874;32;32;0.59375;13;19;0.09375;0.40625
Control.SRR15539874;32;32;0.53125;15;17;0.03125;0.46875
Control.SRR15539874;30;32;0.466666666666667;16;14;0.0333333333333333;0.466666666666667
Control.SRR15539874;29;32;0.517241379310345;14;15;0.0172413793103449;0.482758620689655
Control.SRR15539874;32;32;0.5625;14;18;0.0625;0.4375
Control.SRR15539874;31;32;0.451612903225806;17;14;0.0483870967741936;0.451612903225806
Control.SRR15539874;35;32;0.628571428571429;13;22;0.128571428571429;0.371428571428571
Control.SRR15539874;32;32;0.5;16;16;0;0.5
Control.SRR15539874;32;32;0.5625;14;18;0.0625;0.4375
Control.SRR15539874;34;32;0.294117647058824;24;10;0.205882352941176;0.294117647058824
Control.SRR15539874;38;32;0.394736842105263;23;15;0.105263157894737;0.394736842105263
Control.SRR15539874;30;32;0.466666666666667;16;14;0.0333333333333333;0.466666666666667
Control.SRR15539874;30;32;0.6;12;18;0.1;0.4
Control.SRR15539874;36;32;0.416666666666667;21;15;0.0833333333333333;0.416666666666667
Control.SRR15539874;36;32;0.527777777777778;17;19;0.0277777777777778;0.472222222222222
Control.SRR15539874;32;32;0.28125;23;9;0.21875;0.28125
Control.SRR15539874;33;32;0.606060606060606;13;20;0.106060606060606;0.393939393939394
Control.SRR15539874;31;32;0.516129032258065;15;16;0.0161290322580645;0.483870967741935
Control.SRR15539874;32;32;0.25;24;8;0.25;0.25
Control.SRR15539874;31;32;0.387096774193548;19;12;0.112903225806452;0.387096774193548
Control.SRR15539874;32;32;0.53125;15;17;0.03125;0.46875
Control.SRR15539874;31;32;0.290322580645161;22;9;0.209677419354839;0.290322580645161
Control.SRR15539874;31;32;0.483870967741935;16;15;0.0161290322580645;0.483870967741935
Control.SRR15539874;31;32;0.483870967741935;16;15;0.0161290322580645;0.483870967741935
Control.SRR15539874;33;32;0.454545454545455;18;15;0.0454545454545455;0.454545454545455
Control.SRR15539874;34;32;0.676470588235294;11;23;0.176470588235294;0.323529411764706
Control.SRR15539874;32;32;0.5;16;16;0;0.5
Control.SRR15539874;33;32;0.606060606060606;13;20;0.106060606060606;0.393939393939394
Control.SRR15539874;33;32;0.484848484848485;17;16;0.0151515151515151;0.484848484848485
Control.SRR15539874;31;32;0.354838709677419;20;11;0.145161290322581;0.354838709677419
Control.SRR15539874;29;32;0.379310344827586;18;11;0.120689655172414;0.379310344827586
Control.SRR15539874;37;32;0.648648648648649;13;24;0.148648648648649;0.351351351351351
Control.SRR15539874;37;32;0.432432432432432;21;16;0.0675675675675675;0.432432432432432
Control.SRR15539874;36;32;0.388888888888889;22;14;0.111111111111111;0.388888888888889
Control.SRR15539874;29;32;0.517241379310345;14;15;0.0172413793103449;0.482758620689655
Control.SRR15539874;33;32;0.393939393939394;20;13;0.106060606060606;0.393939393939394
Control.SRR15539874;34;32;0.470588235294118;18;16;0.0294117647058824;0.470588235294118
Control.SRR15539874;37;32;0.486486486486487;19;18;0.0135135135135135;0.486486486486487
Control.SRR15539874;34;32;0.5;17;17;0;0.5
Control.SRR15539874;35;32;0.6;14;21;0.1;0.4
Control.SRR15539874;36;32;0.416666666666667;21;15;0.0833333333333333;0.416666666666667
Control.SRR15539874;32;32;0.5;16;16;0;0.5
Control.SRR15539874;36;32;0.555555555555556;16;20;0.0555555555555556;0.444444444444444
Control.SRR15539874;30;32;0.633333333333333;11;19;0.133333333333333;0.366666666666667
Control.SRR15539874;35;32;0.628571428571429;13;22;0.128571428571429;0.371428571428571
Control.SRR15539874;36;32;0.416666666666667;21;15;0.0833333333333333;0.416666666666667
Control.SRR15539874;36;32;0.444444444444444;20;16;0.0555555555555556;0.444444444444444
Control.SRR15539874;29;32;0.586206896551724;12;17;0.0862068965517241;0.413793103448276
Control.SRR15539874;32;32;0.65625;11;21;0.15625;0.34375
Control.SRR15539874;35;32;0.6;14;21;0.1;0.4
Control.SRR15539874;36;32;0.416666666666667;21;15;0.0833333333333333;0.416666666666667
Control.SRR15539874;33;32;0.545454545454545;15;18;0.0454545454545454;0.454545454545455
Control.SRR15539874;30;32;0.533333333333333;14;16;0.0333333333333333;0.466666666666667
Control.SRR15539874;37;32;0.513513513513513;18;19;0.0135135135135135;0.486486486486487
Control.SRR15539874;32;32;0.46875;17;15;0.03125;0.46875
Control.SRR15539874;34;32;0.588235294117647;14;20;0.0882352941176471;0.411764705882353
Control.SRR15539874;31;32;0.580645161290323;13;18;0.0806451612903226;0.419354838709677
Control.SRR15539874;37;32;0.432432432432432;21;16;0.0675675675675675;0.432432432432432
Control.SRR15539874;29;32;0.448275862068966;16;13;0.0517241379310345;0.448275862068966
Control.SRR15539874;31;32;0.451612903225806;17;14;0.0483870967741936;0.451612903225806
Control.SRR15539874;34;32;0.558823529411765;15;19;0.0588235294117647;0.441176470588235
Control.SRR15539874;33;32;0.393939393939394;20;13;0.106060606060606;0.393939393939394
Control.SRR15539874;31;32;0.645161290322581;11;20;0.145161290322581;0.354838709677419
Control.SRR15539874;34;32;0.588235294117647;14;20;0.0882352941176471;0.411764705882353
Control.SRR15539874;35;32;0.571428571428571;15;20;0.0714285714285714;0.428571428571429
Control.SRR15539874;35;32;0.428571428571429;20;15;0.0714285714285715;0.428571428571429
Control.SRR15539874;35;32;0.371428571428571;22;13;0.128571428571429;0.371428571428571
Control.SRR15539874;33;32;0.545454545454545;15;18;0.0454545454545454;0.454545454545455
Control.SRR15539874;33;32;0.575757575757576;14;19;0.0757575757575758;0.424242424242424
Control.SRR15539874;32;32;0.46875;17;15;0.03125;0.46875
Control.SRR15539874;35;32;0.6;14;21;0.1;0.4
Control.SRR15539874;29;32;0.448275862068966;16;13;0.0517241379310345;0.448275862068966
Control.SRR15539874;36;32;0.361111111111111;23;13;0.138888888888889;0.361111111111111
Control.SRR15539874;36;32;0.638888888888889;13;23;0.138888888888889;0.361111111111111
Control.SRR15539874;30;32;0.6;12;18;0.1;0.4
Control.SRR15539874;29;32;0.724137931034483;8;21;0.224137931034483;0.275862068965517
Control.SRR15539874;34;32;0.352941176470588;22;12;0.147058823529412;0.352941176470588
Control.SRR15539874;35;32;0.542857142857143;16;19;0.0428571428571428;0.457142857142857
Control.SRR15539874;33;32;0.515151515151515;16;17;0.0151515151515151;0.484848484848485
Control.SRR15539874;34;32;0.235294117647059;26;8;0.264705882352941;0.235294117647059
Control.SRR15539874;37;32;0.513513513513513;18;19;0.0135135135135135;0.486486486486487
Control.SRR15539874;35;32;0.485714285714286;18;17;0.0142857142857143;0.485714285714286
Control.SRR15539874;36;32;0.583333333333333;15;21;0.0833333333333334;0.416666666666667
Control.SRR15539874;35;32;0.685714285714286;11;24;0.185714285714286;0.314285714285714
Control.SRR15539874;35;32;0.428571428571429;20;15;0.0714285714285715;0.428571428571429
Control.SRR15539874;31;32;0.483870967741935;16;15;0.0161290322580645;0.483870967741935
Control.SRR15539874;29;32;0.586206896551724;12;17;0.0862068965517241;0.413793103448276
Control.SRR15539874;36;32;0.444444444444444;20;16;0.0555555555555556;0.444444444444444
Control.SRR15539874;33;32;0.636363636363636;12;21;0.136363636363636;0.363636363636364
Control.SRR15539874;35;32;0.485714285714286;18;17;0.0142857142857143;0.485714285714286
Control.SRR15539874;31;32;0.451612903225806;17;14;0.0483870967741936;0.451612903225806
Control.SRR15539874;34;32;0.558823529411765;15;19;0.0588235294117647;0.441176470588235
Control.SRR15539874;37;32;0.513513513513513;18;19;0.0135135135135135;0.486486486486487
Control.SRR15539874;35;32;0.485714285714286;18;17;0.0142857142857143;0.485714285714286
Control.SRR15539874;35;32;0.542857142857143;16;19;0.0428571428571428;0.457142857142857
Control.SRR15539874;37;32;0.297297297297297;26;11;0.202702702702703;0.297297297297297
Control.SRR15539874;34;32;0.676470588235294;11;23;0.176470588235294;0.323529411764706
Control.SRR15539874;35;32;0.542857142857143;16;19;0.0428571428571428;0.457142857142857
Control.SRR15539874;32;32;0.59375;13;19;0.09375;0.40625
Control.SRR15539874;29;32;0.586206896551724;12;17;0.0862068965517241;0.413793103448276
Control.SRR15539874;35;32;0.371428571428571;22;13;0.128571428571429;0.371428571428571
Control.SRR15539874;34;32;0.617647058823529;13;21;0.117647058823529;0.382352941176471
Control.SRR15539874;37;32;0.432432432432432;21;16;0.0675675675675675;0.432432432432432
Control.SRR15539874;33;32;0.484848484848485;17;16;0.0151515151515151;0.484848484848485
Control.SRR15539874;33;32;0.454545454545455;18;15;0.0454545454545455;0.454545454545455
Control.SRR15539874;36;32;0.416666666666667;21;15;0.0833333333333333;0.416666666666667
Control.SRR15539874;34;32;0.470588235294118;18;16;0.0294117647058824;0.470588235294118
Control.SRR15539874;33;32;0.545454545454545;15;18;0.0454545454545454;0.454545454545455
Control.SRR15539874;32;32;0.59375;13;19;0.09375;0.40625
Control.SRR15539874;36;32;0.5;18;18;0;0.5
Control.SRR15539874;33;32;0.545454545454545;15;18;0.0454545454545454;0.454545454545455
Control.SRR15539874;34;32;0.588235294117647;14;20;0.0882352941176471;0.411764705882353
Control.SRR15539874;31;32;0.483870967741935;16;15;0.0161290322580645;0.483870967741935
Control.SRR15539874;30;32;0.533333333333333;14;16;0.0333333333333333;0.466666666666667
Control.SRR15539874;29;32;0.448275862068966;16;13;0.0517241379310345;0.448275862068966
Control.SRR15539874;30;32;0.533333333333333;14;16;0.0333333333333333;0.466666666666667
Control.SRR15539874;34;32;0.617647058823529;13;21;0.117647058823529;0.382352941176471
Control.SRR15539874;35;32;0.685714285714286;11;24;0.185714285714286;0.314285714285714
Control.SRR15539874;31;32;0.612903225806452;12;19;0.112903225806452;0.387096774193548
Control.SRR15539874;32;32;0.53125;15;17;0.03125;0.46875
Control.SRR15539874;32;32;0.46875;17;15;0.03125;0.46875
Control.SRR15539874;30;32;0.433333333333333;17;13;0.0666666666666667;0.433333333333333
Control.SRR15539874;33;32;0.484848484848485;17;16;0.0151515151515151;0.484848484848485
Control.SRR15539874;37;32;0.459459459459459;20;17;0.0405405405405405;0.459459459459459
Control.SRR15539874;35;32;0.6;14;21;0.1;0.4
Control.SRR15539874;31;32;0.516129032258065;15;16;0.0161290322580645;0.483870967741935
Control.SRR15539874;30;32;0.466666666666667;16;14;0.0333333333333333;0.466666666666667
Control.SRR15539874;33;32;0.454545454545455;18;15;0.0454545454545455;0.454545454545455
Control.SRR15539874;37;32;0.648648648648649;13;24;0.148648648648649;0.351351351351351
Control.SRR15539874;37;32;0.378378378378378;23;14;0.121621621621622;0.378378378378378
Control.SRR15539874;34;32;0.558823529411765;15;19;0.0588235294117647;0.441176470588235
Control.SRR15539874;37;32;0.405405405405405;22;15;0.0945945945945946;0.405405405405405
Control.SRR15539874;37;32;0.513513513513513;18;19;0.0135135135135135;0.486486486486487
Control.SRR15539874;29;32;0.586206896551724;12;17;0.0862068965517241;0.413793103448276
Control.SRR15539874;33;32;0.515151515151515;16;17;0.0151515151515151;0.484848484848485
Control.SRR15539874;31;32;0.516129032258065;15;16;0.0161290322580645;0.483870967741935
Control.SRR15539874;33;32;0.515151515151515;16;17;0.0151515151515151;0.484848484848485
Control.SRR15539874;35;32;0.485714285714286;18;17;0.0142857142857143;0.485714285714286
Control.SRR15539874;32;32;0.3125;22;10;0.1875;0.3125
Control.SRR15539874;31;32;0.548387096774194;14;17;0.0483870967741935;0.451612903225806
Control.SRR15539874;37;32;0.621621621621622;14;23;0.121621621621622;0.378378378378378
Control.SRR15539874;34;32;0.264705882352941;25;9;0.235294117647059;0.264705882352941
Control.SRR15539874;34;32;0.676470588235294;11;23;0.176470588235294;0.323529411764706
Control.SRR15539874;30;32;0.4;18;12;0.1;0.4
Control.SRR15539874;34;32;0.5;17;17;0;0.5
Control.SRR15539874;33;32;0.454545454545455;18;15;0.0454545454545455;0.454545454545455
Control.SRR15539874;34;32;0.647058823529412;12;22;0.147058823529412;0.352941176470588
Control.SRR15539874;37;32;0.486486486486487;19;18;0.0135135135135135;0.486486486486487
Control.SRR15539874;37;32;0.567567567567568;16;21;0.0675675675675675;0.432432432432432
Control.SRR15539874;30;32;0.6;12;18;0.1;0.4
Control.SRR15539874;32;32;0.375;20;12;0.125;0.375
Control.SRR15539874;30;32;0.433333333333333;17;13;0.0666666666666667;0.433333333333333
Control.SRR15539874;35;32;0.542857142857143;16;19;0.0428571428571428;0.457142857142857
Control.SRR15539874;29;32;0.482758620689655;15;14;0.0172413793103448;0.482758620689655
Control.SRR15539874;29;32;0.448275862068966;16;13;0.0517241379310345;0.448275862068966
Control.SRR15539874;31;32;0.483870967741935;16;15;0.0161290322580645;0.483870967741935
Control.SRR15539874;31;32;0.645161290322581;11;20;0.145161290322581;0.354838709677419
Control.SRR15539874;32;32;0.5625;14;18;0.0625;0.4375
Control.SRR15539874;31;32;0.387096774193548;19;12;0.112903225806452;0.387096774193548
Control.SRR15539874;36;32;0.472222222222222;19;17;0.0277777777777778;0.472222222222222
Control.SRR15539874;33;32;0.606060606060606;13;20;0.106060606060606;0.393939393939394
Control.SRR15539874;32;32;0.625;12;20;0.125;0.375
Control.SRR15539874;34;32;0.470588235294118;18;16;0.0294117647058824;0.470588235294118
Control.SRR15539874;33;32;0.515151515151515;16;17;0.0151515151515151;0.484848484848485
Control.SRR15539874;34;32;0.264705882352941;25;9;0.235294117647059;0.264705882352941
Control.SRR15539874;30;32;0.366666666666667;19;11;0.133333333333333;0.366666666666667
Control.SRR15539874;36;32;0.555555555555556;16;20;0.0555555555555556;0.444444444444444
Control.SRR15539874;32;32;0.625;12;20;0.125;0.375
Control.SRR15539874;35;32;0.314285714285714;24;11;0.185714285714286;0.314285714285714
Control.SRR15539874;35;32;0.457142857142857;19;16;0.0428571428571429;0.457142857142857
Control.SRR15539874;34;32;0.588235294117647;14;20;0.0882352941176471;0.411764705882353
Control.SRR15539874;35;32;0.514285714285714;17;18;0.0142857142857142;0.485714285714286
Control.SRR15539874;33;32;0.545454545454545;15;18;0.0454545454545454;0.454545454545455
Control.SRR15539874;30;32;0.433333333333333;17;13;0.0666666666666667;0.433333333333333
Control.SRR15539874;36;32;0.527777777777778;17;19;0.0277777777777778;0.472222222222222
Control.SRR15539874;30;32;0.533333333333333;14;16;0.0333333333333333;0.466666666666667
Control.SRR15539874;34;32;0.382352941176471;21;13;0.117647058823529;0.382352941176471
Control.SRR15539874;35;32;0.428571428571429;20;15;0.0714285714285715;0.428571428571429
Control.SRR15539874;36;32;0.472222222222222;19;17;0.0277777777777778;0.472222222222222
Control.SRR15539874;36;32;0.583333333333333;15;21;0.0833333333333334;0.416666666666667
Control.SRR15539874;35;32;0.628571428571429;13;22;0.128571428571429;0.371428571428571
Control.SRR15539874;37;32;0.486486486486487;19;18;0.0135135135135135;0.486486486486487
Control.SRR15539874;33;32;0.515151515151515;16;17;0.0151515151515151;0.484848484848485
Control.SRR15539874;37;32;0.540540540540541;17;20;0.0405405405405406;0.459459459459459
Control.SRR15539874;30;32;0.566666666666667;13;17;0.0666666666666667;0.433333333333333
Control.SRR15539874;33;32;0.545454545454545;15;18;0.0454545454545454;0.454545454545455
Control.SRR15539874;37;32;0.486486486486487;19;18;0.0135135135135135;0.486486486486487
Control.SRR15539874;36;32;0.527777777777778;17;19;0.0277777777777778;0.472222222222222
Control.SRR15539874;36;32;0.416666666666667;21;15;0.0833333333333333;0.416666666666667
Control.SRR15539874;36;32;0.527777777777778;17;19;0.0277777777777778;0.472222222222222
Control.SRR15539874;30;32;0.3;21;9;0.2;0.3
Control.SRR15539874;29;32;0.655172413793103;10;19;0.155172413793103;0.344827586206897
Control.SRR15539874;29;32;0.551724137931034;13;16;0.0517241379310345;0.448275862068966
Control.SRR15539874;35;32;0.542857142857143;16;19;0.0428571428571428;0.457142857142857
Control.SRR15539874;31;32;0.548387096774194;14;17;0.0483870967741935;0.451612903225806
Control.SRR15539874;31;32;0.419354838709677;18;13;0.0806451612903226;0.419354838709677
Control.SRR15539874;37;32;0.459459459459459;20;17;0.0405405405405405;0.459459459459459
Control.SRR15539874;36;32;0.5;18;18;0;0.5
Control.SRR15539874;35;32;0.628571428571429;13;22;0.128571428571429;0.371428571428571
Control.SRR15539874;36;32;0.333333333333333;24;12;0.166666666666667;0.333333333333333
Control.SRR15539874;31;32;0.580645161290323;13;18;0.0806451612903226;0.419354838709677
Control.SRR15539874;30;32;0.633333333333333;11;19;0.133333333333333;0.366666666666667
Control.SRR15539874;32;32;0.5625;14;18;0.0625;0.4375
Control.SRR15539874;33;32;0.666666666666667;11;22;0.166666666666667;0.333333333333333
Control.SRR15539874;34;32;0.617647058823529;13;21;0.117647058823529;0.382352941176471
Control.SRR15539874;33;32;0.333333333333333;22;11;0.166666666666667;0.333333333333333
Control.SRR15539874;29;32;0.413793103448276;17;12;0.0862068965517241;0.413793103448276
Control.SRR15539874;31;32;0.709677419354839;9;22;0.209677419354839;0.290322580645161
Control.SRR15539874;32;32;0.46875;17;15;0.03125;0.46875
Control.SRR15539874;30;32;0.533333333333333;14;16;0.0333333333333333;0.466666666666667
Control.SRR15539874;33;32;0.484848484848485;17;16;0.0151515151515151;0.484848484848485
Control.SRR15539874;35;32;0.342857142857143;23;12;0.157142857142857;0.342857142857143
Control.SRR15539874;35;32;0.571428571428571;15;20;0.0714285714285714;0.428571428571429
Control.SRR15539874;36;32;0.333333333333333;24;12;0.166666666666667;0.333333333333333
Control.SRR15539874;32;32;0.46875;17;15;0.03125;0.46875
Control.SRR15539874;29;32;0.586206896551724;12;17;0.0862068965517241;0.413793103448276
Control.SRR15539874;35;32;0.542857142857143;16;19;0.0428571428571428;0.457142857142857
Control.SRR15539874;33;32;0.545454545454545;15;18;0.0454545454545454;0.454545454545455
Control.SRR15539874;31;32;0.451612903225806;17;14;0.0483870967741936;0.451612903225806
Control.SRR15539874;33;32;0.575757575757576;14;19;0.0757575757575758;0.424242424242424
Control.SRR15539874;31;32;0.580645161290323;13;18;0.0806451612903226;0.419354838709677
Control.SRR15539874;34;32;0.470588235294118;18;16;0.0294117647058824;0.470588235294118
Control.SRR15539874;29;32;0.482758620689655;15;14;0.0172413793103448;0.482758620689655
Control.SRR15539874;33;32;0.515151515151515;16;17;0.0151515151515151;0.484848484848485
Control.SRR15539874;36;32;0.388888888888889;22;14;0.111111111111111;0.388888888888889
Control.SRR15539874;35;32;0.371428571428571;22;13;0.128571428571429;0.371428571428571
Control.SRR15539874;34;32;0.558823529411765;15;19;0.0588235294117647;0.441176470588235
Control.SRR15539874;35;32;0.542857142857143;16;19;0.0428571428571428;0.457142857142857
Control.SRR15539874;33;32;0.424242424242424;19;14;0.0757575757575757;0.424242424242424
Control.SRR15539874;37;32;0.675675675675676;12;25;0.175675675675676;0.324324324324324
Control.SRR15539874;29;32;0.413793103448276;17;12;0.0862068965517241;0.413793103448276
Control.SRR15539874;30;32;0.4;18;12;0.1;0.4
Control.SRR15539874;34;32;0.588235294117647;14;20;0.0882352941176471;0.411764705882353
Control.SRR15539874;36;32;0.611111111111111;14;22;0.111111111111111;0.388888888888889
Control.SRR15539874;30;32;0.533333333333333;14;16;0.0333333333333333;0.466666666666667
Control.SRR15539874;30;32;0.533333333333333;14;16;0.0333333333333333;0.466666666666667
Control.SRR15539874;34;32;0.5;17;17;0;0.5
Control.SRR15539874;31;32;0.451612903225806;17;14;0.0483870967741936;0.451612903225806
Control.SRR15539874;35;32;0.4;21;14;0.1;0.4
Control.SRR15539874;29;32;0.620689655172414;11;18;0.120689655172414;0.379310344827586
Control.SRR15539874;35;32;0.485714285714286;18;17;0.0142857142857143;0.485714285714286
Control.SRR15539874;32;32;0.5;16;16;0;0.5
Control.SRR15539874;37;32;0.594594594594595;15;22;0.0945945945945946;0.405405405405405
Control.SRR15539874;32;32;0.59375;13;19;0.09375;0.40625
Control.SRR15539874;33;32;0.515151515151515;16;17;0.0151515151515151;0.484848484848485
Control.SRR15539874;35;32;0.571428571428571;15;20;0.0714285714285714;0.428571428571429
Control.SRR15539874;36;32;0.5;18;18;0;0.5
Control.SRR15539874;33;32;0.363636363636364;21;12;0.136363636363636;0.363636363636364
Control.SRR15539874;37;32;0.405405405405405;22;15;0.0945945945945946;0.405405405405405
Control.SRR15539874;35;32;0.485714285714286;18;17;0.0142857142857143;0.485714285714286
Control.SRR15539874;36;32;0.416666666666667;21;15;0.0833333333333333;0.416666666666667
Control.SRR15539874;30;32;0.5;15;15;0;0.5
Control.SRR15539874;34;32;0.470588235294118;18;16;0.0294117647058824;0.470588235294118
Control.SRR15539874;35;32;0.571428571428571;15;20;0.0714285714285714;0.428571428571429
Control.SRR15539874;37;32;0.432432432432432;21;16;0.0675675675675675;0.432432432432432
Control.SRR15539874;30;32;0.533333333333333;14;16;0.0333333333333333;0.466666666666667
Control.SRR15539874;35;32;0.485714285714286;18;17;0.0142857142857143;0.485714285714286
Control.SRR15539874;31;32;0.548387096774194;14;17;0.0483870967741935;0.451612903225806
Control.SRR15539874;34;32;0.617647058823529;13;21;0.117647058823529;0.382352941176471
Control.SRR15539874;36;32;0.388888888888889;22;14;0.111111111111111;0.388888888888889
Control.SRR15539874;36;32;0.472222222222222;19;17;0.0277777777777778;0.472222222222222
Control.SRR15539874;34;32;0.558823529411765;15;19;0.0588235294117647;0.441176470588235
Control.SRR15539874;32;32;0.4375;18;14;0.0625;0.4375
Control.SRR15539874;32;32;0.65625;11;21;0.15625;0.34375
Control.SRR15539874;33;32;0.454545454545455;18;15;0.0454545454545455;0.454545454545455
Control.SRR15539874;30;32;0.433333333333333;17;13;0.0666666666666667;0.433333333333333
Control.SRR15539874;30;32;0.533333333333333;14;16;0.0333333333333333;0.466666666666667
Control.SRR15539874;37;32;0.432432432432432;21;16;0.0675675675675675;0.432432432432432
Control.SRR15539874;35;32;0.4;21;14;0.1;0.4
Control.SRR15539874;37;32;0.513513513513513;18;19;0.0135135135135135;0.486486486486487
Control.SRR15539874;30;32;0.566666666666667;13;17;0.0666666666666667;0.433333333333333
Control.SRR15539874;33;32;0.575757575757576;14;19;0.0757575757575758;0.424242424242424
Control.SRR15539874;36;32;0.555555555555556;16;20;0.0555555555555556;0.444444444444444
Control.SRR15539874;36;32;0.472222222222222;19;17;0.0277777777777778;0.472222222222222
Control.SRR15539874;33;32;0.515151515151515;16;17;0.0151515151515151;0.484848484848485
Control.SRR15539874;33;32;0.454545454545455;18;15;0.0454545454545455;0.454545454545455
Control.SRR15539874;31;32;0.580645161290323;13;18;0.0806451612903226;0.419354838709677
Control.SRR15539874;34;32;0.588235294117647;14;20;0.0882352941176471;0.411764705882353
Control.SRR15539874;35;32;0.4;21;14;0.1;0.4
Control.SRR15539874;32;32;0.46875;17;15;0.03125;0.46875
Control.SRR15539874;29;32;0.655172413793103;10;19;0.155172413793103;0.344827586206897
Control.SRR15539874;37;32;0.459459459459459;20;17;0.0405405405405405;0.459459459459459
Control.SRR15539874;33;32;0.424242424242424;19;14;0.0757575757575757;0.424242424242424
Control.SRR15539874;36;32;0.361111111111111;23;13;0.138888888888889;0.361111111111111
Control.SRR15539874;34;32;0.558823529411765;15;19;0.0588235294117647;0.441176470588235
Control.SRR15539874;37;32;0.540540540540541;17;20;0.0405405405405406;0.459459459459459
Control.SRR15539874;33;32;0.515151515151515;16;17;0.0151515151515151;0.484848484848485
Control.SRR15539874;33;32;0.575757575757576;14;19;0.0757575757575758;0.424242424242424
Control.SRR15539874;31;32;0.580645161290323;13;18;0.0806451612903226;0.419354838709677
Control.SRR15539874;30;32;0.566666666666667;13;17;0.0666666666666667;0.433333333333333
Control.SRR15539874;34;32;0.5;17;17;0;0.5
Control.SRR15539874;35;32;0.514285714285714;17;18;0.0142857142857142;0.485714285714286
Control.SRR15539874;32;32;0.40625;19;13;0.09375;0.40625
Control.SRR15539874;32;32;0.34375;21;11;0.15625;0.34375
Control.SRR15539874;30;32;0.466666666666667;16;14;0.0333333333333333;0.466666666666667
Control.SRR15539874;31;32;0.387096774193548;19;12;0.112903225806452;0.387096774193548
Control.SRR15539874;37;32;0.378378378378378;23;14;0.121621621621622;0.378378378378378
Control.SRR15539874;33;32;0.545454545454545;15;18;0.0454545454545454;0.454545454545455
Control.SRR15539874;32;32;0.65625;11;21;0.15625;0.34375
Control.SRR15539874;30;32;0.433333333333333;17;13;0.0666666666666667;0.433333333333333
Control.SRR15539874;32;32;0.625;12;20;0.125;0.375
Control.SRR15539874;31;32;0.32258064516129;21;10;0.17741935483871;0.32258064516129
Control.SRR15539874;33;32;0.545454545454545;15;18;0.0454545454545454;0.454545454545455
Control.SRR15539874;30;32;0.433333333333333;17;13;0.0666666666666667;0.433333333333333
Control.SRR15539874;29;32;0.344827586206897;19;10;0.155172413793103;0.344827586206897
Control.SRR15539874;30;32;0.6;12;18;0.1;0.4
Control.SRR15539874;29;32;0.620689655172414;11;18;0.120689655172414;0.379310344827586
Control.SRR15539874;29;32;0.517241379310345;14;15;0.0172413793103449;0.482758620689655
Control.SRR15539874;36;32;0.472222222222222;19;17;0.0277777777777778;0.472222222222222
Control.SRR15539874;29;32;0.551724137931034;13;16;0.0517241379310345;0.448275862068966
Control.SRR15539874;32;32;0.46875;17;15;0.03125;0.46875
Control.SRR15539874;37;32;0.621621621621622;14;23;0.121621621621622;0.378378378378378
Control.SRR15539874;37;32;0.486486486486487;19;18;0.0135135135135135;0.486486486486487
Control.SRR15539874;30;32;0.433333333333333;17;13;0.0666666666666667;0.433333333333333
Control.SRR15539874;30;32;0.533333333333333;14;16;0.0333333333333333;0.466666666666667
Control.SRR15539874;35;32;0.542857142857143;16;19;0.0428571428571428;0.457142857142857
Control.SRR15539874;34;32;0.5;17;17;0;0.5
Control.SRR15539874;35;32;0.4;21;14;0.1;0.4
Control.SRR15539874;35;32;0.714285714285714;10;25;0.214285714285714;0.285714285714286
Control.SRR15539874;35;32;0.342857142857143;23;12;0.157142857142857;0.342857142857143
Control.SRR15539874;31;32;0.483870967741935;16;15;0.0161290322580645;0.483870967741935
Control.SRR15539874;30;32;0.466666666666667;16;14;0.0333333333333333;0.466666666666667
Control.SRR15539874;31;32;0.387096774193548;19;12;0.112903225806452;0.387096774193548
Control.SRR15539874;36;32;0.5;18;18;0;0.5
Control.SRR15539874;30;32;0.4;18;12;0.1;0.4
Control.SRR15539874;33;32;0.484848484848485;17;16;0.0151515151515151;0.484848484848485
Control.SRR15539874;32;32;0.46875;17;15;0.03125;0.46875
Control.SRR15539874;30;32;0.533333333333333;14;16;0.0333333333333333;0.466666666666667
Control.SRR15539874;34;32;0.323529411764706;23;11;0.176470588235294;0.323529411764706
Control.SRR15539874;35;32;0.514285714285714;17;18;0.0142857142857142;0.485714285714286
Control.SRR15539874;30;32;0.4;18;12;0.1;0.4
Control.SRR15539874;30;32;0.5;15;15;0;0.5
Control.SRR15539874;29;32;0.517241379310345;14;15;0.0172413793103449;0.482758620689655
Control.SRR15539874;30;32;0.566666666666667;13;17;0.0666666666666667;0.433333333333333
Control.SRR15539874;29;32;0.517241379310345;14;15;0.0172413793103449;0.482758620689655
Control.SRR15539874;37;32;0.621621621621622;14;23;0.121621621621622;0.378378378378378
Control.SRR15539874;31;32;0.580645161290323;13;18;0.0806451612903226;0.419354838709677
Control.SRR15539874;34;32;0.588235294117647;14;20;0.0882352941176471;0.411764705882353
Control.SRR15539874;31;32;0.580645161290323;13;18;0.0806451612903226;0.419354838709677
Control.SRR15539874;29;32;0.517241379310345;14;15;0.0172413793103449;0.482758620689655
Control.SRR15539874;34;32;0.382352941176471;21;13;0.117647058823529;0.382352941176471
Control.SRR15539874;36;32;0.361111111111111;23;13;0.138888888888889;0.361111111111111
Control.SRR15539874;36;32;0.416666666666667;21;15;0.0833333333333333;0.416666666666667
Control.SRR15539874;32;32;0.625;12;20;0.125;0.375
Control.SRR15539874;29;32;0.448275862068966;16;13;0.0517241379310345;0.448275862068966
Control.SRR15539874;29;32;0.448275862068966;16;13;0.0517241379310345;0.448275862068966
Control.SRR15539874;32;32;0.59375;13;19;0.09375;0.40625
Control.SRR15539874;35;32;0.628571428571429;13;22;0.128571428571429;0.371428571428571
Control.SRR15539874;34;32;0.588235294117647;14;20;0.0882352941176471;0.411764705882353
Control.SRR15539874;34;32;0.529411764705882;16;18;0.0294117647058824;0.470588235294118
Control.SRR15539874;29;32;0.586206896551724;12;17;0.0862068965517241;0.413793103448276
Control.SRR15539874;34;32;0.529411764705882;16;18;0.0294117647058824;0.470588235294118
Control.SRR15539874;34;32;0.470588235294118;18;16;0.0294117647058824;0.470588235294118
Control.SRR15539874;30;32;0.333333333333333;20;10;0.166666666666667;0.333333333333333
Control.SRR15539874;29;32;0.551724137931034;13;16;0.0517241379310345;0.448275862068966
Control.SRR15539874;37;32;0.378378378378378;23;14;0.121621621621622;0.378378378378378
Control.SRR15539874;29;32;0.379310344827586;18;11;0.120689655172414;0.379310344827586
Control.SRR15539874;33;32;0.575757575757576;14;19;0.0757575757575758;0.424242424242424
Control.SRR15539874;34;32;0.5;17;17;0;0.5
Control.SRR15539874;30;32;0.4;18;12;0.1;0.4
Control.SRR15539874;29;32;0.344827586206897;19;10;0.155172413793103;0.344827586206897
Control.SRR15539874;29;32;0.517241379310345;14;15;0.0172413793103449;0.482758620689655
Control.SRR15539874;32;32;0.40625;19;13;0.09375;0.40625
Control.SRR15539874;29;32;0.517241379310345;14;15;0.0172413793103449;0.482758620689655
Control.SRR15539874;36;32;0.611111111111111;14;22;0.111111111111111;0.388888888888889
Control.SRR15539874;34;32;0.441176470588235;19;15;0.0588235294117647;0.441176470588235
Control.SRR15539874;29;32;0.655172413793103;10;19;0.155172413793103;0.344827586206897
Control.SRR15539874;30;32;0.733333333333333;8;22;0.233333333333333;0.266666666666667
Control.SRR15539874;37;32;0.459459459459459;20;17;0.0405405405405405;0.459459459459459
Control.SRR15539874;33;32;0.424242424242424;19;14;0.0757575757575757;0.424242424242424
Control.SRR15539874;32;32;0.375;20;12;0.125;0.375
Control.SRR15539874;29;32;0.655172413793103;10;19;0.155172413793103;0.344827586206897
Control.SRR15539874;29;32;0.551724137931034;13;16;0.0517241379310345;0.448275862068966
Control.SRR15539874;34;32;0.558823529411765;15;19;0.0588235294117647;0.441176470588235
Control.SRR15539874;30;32;0.3;21;9;0.2;0.3
Control.SRR15539874;30;32;0.566666666666667;13;17;0.0666666666666667;0.433333333333333
Control.SRR15539874;33;32;0.515151515151515;16;17;0.0151515151515151;0.484848484848485
Control.SRR15539874;30;32;0.5;15;15;0;0.5
Control.SRR15539874;35;32;0.571428571428571;15;20;0.0714285714285714;0.428571428571429
Control.SRR15539874;33;32;0.333333333333333;22;11;0.166666666666667;0.333333333333333
Control.SRR15539874;33;32;0.272727272727273;24;9;0.227272727272727;0.272727272727273
Control.SRR15539874;31;32;0.548387096774194;14;17;0.0483870967741935;0.451612903225806
Control.SRR15539874;33;32;0.636363636363636;12;21;0.136363636363636;0.363636363636364
Control.SRR15539874;37;32;0.486486486486487;19;18;0.0135135135135135;0.486486486486487
Control.SRR15539874;29;32;0.482758620689655;15;14;0.0172413793103448;0.482758620689655
Control.SRR15539874;36;32;0.583333333333333;15;21;0.0833333333333334;0.416666666666667
Control.SRR15539874;37;32;0.648648648648649;13;24;0.148648648648649;0.351351351351351
Control.SRR15539874;32;32;0.5;16;16;0;0.5
Control.SRR15539874;31;32;0.290322580645161;22;9;0.209677419354839;0.290322580645161
Control.SRR15539874;33;32;0.484848484848485;17;16;0.0151515151515151;0.484848484848485
Control.SRR15539874;36;32;0.638888888888889;13;23;0.138888888888889;0.361111111111111
Control.SRR15539874;34;32;0.441176470588235;19;15;0.0588235294117647;0.441176470588235
Control.SRR15539874;36;32;0.444444444444444;20;16;0.0555555555555556;0.444444444444444
Control.SRR15539874;37;32;0.567567567567568;16;21;0.0675675675675675;0.432432432432432
Control.SRR15539874;31;32;0.580645161290323;13;18;0.0806451612903226;0.419354838709677
Control.SRR15539874;37;32;0.432432432432432;21;16;0.0675675675675675;0.432432432432432
Control.SRR15539874;30;32;0.3;21;9;0.2;0.3
Control.SRR15539874;34;32;0.470588235294118;18;16;0.0294117647058824;0.470588235294118
Control.SRR15539874;35;32;0.485714285714286;18;17;0.0142857142857143;0.485714285714286
Control.SRR15539874;30;32;0.3;21;9;0.2;0.3
Control.SRR15539874;33;32;0.393939393939394;20;13;0.106060606060606;0.393939393939394
Control.SRR15539874;35;32;0.657142857142857;12;23;0.157142857142857;0.342857142857143
Control.SRR15539874;31;32;0.451612903225806;17;14;0.0483870967741936;0.451612903225806
Control.SRR15539874;31;32;0.548387096774194;14;17;0.0483870967741935;0.451612903225806
Control.SRR15539874;31;32;0.580645161290323;13;18;0.0806451612903226;0.419354838709677
Control.SRR15539874;30;32;0.633333333333333;11;19;0.133333333333333;0.366666666666667
Control.SRR15539874;36;32;0.611111111111111;14;22;0.111111111111111;0.388888888888889
Control.SRR15539874;30;32;0.6;12;18;0.1;0.4
Control.SRR15539874;31;32;0.483870967741935;16;15;0.0161290322580645;0.483870967741935
Control.SRR15539874;34;32;0.5;17;17;0;0.5
Control.SRR15539874;37;32;0.513513513513513;18;19;0.0135135135135135;0.486486486486487
Control.SRR15539874;33;32;0.545454545454545;15;18;0.0454545454545454;0.454545454545455
Control.SRR15539874;30;32;0.6;12;18;0.1;0.4
Control.SRR15539874;36;32;0.472222222222222;19;17;0.0277777777777778;0.472222222222222
Control.SRR15539874;29;32;0.482758620689655;15;14;0.0172413793103448;0.482758620689655
Control.SRR15539874;30;32;0.466666666666667;16;14;0.0333333333333333;0.466666666666667
Control.SRR15539874;37;32;0.594594594594595;15;22;0.0945945945945946;0.405405405405405
Control.SRR15539874;36;32;0.555555555555556;16;20;0.0555555555555556;0.444444444444444
Control.SRR15539874;34;32;0.441176470588235;19;15;0.0588235294117647;0.441176470588235
Control.SRR15539874;36;32;0.583333333333333;15;21;0.0833333333333334;0.416666666666667
Control.SRR15539874;32;32;0.53125;15;17;0.03125;0.46875
Control.SRR15539874;33;32;0.545454545454545;15;18;0.0454545454545454;0.454545454545455
Control.SRR15539874;31;32;0.580645161290323;13;18;0.0806451612903226;0.419354838709677
Control.SRR15539874;35;32;0.6;14;21;0.1;0.4
Control.SRR15539874;35;32;0.428571428571429;20;15;0.0714285714285715;0.428571428571429
Control.SRR15539874;32;32;0.34375;21;11;0.15625;0.34375
Control.SRR15539874;30;32;0.466666666666667;16;14;0.0333333333333333;0.466666666666667
Control.SRR15539874;32;32;0.25;24;8;0.25;0.25
Control.SRR15539874;29;32;0.586206896551724;12;17;0.0862068965517241;0.413793103448276
Control.SRR15539874;31;32;0.387096774193548;19;12;0.112903225806452;0.387096774193548
Control.SRR15539874;36;32;0.583333333333333;15;21;0.0833333333333334;0.416666666666667
Control.SRR15539874;29;32;0.482758620689655;15;14;0.0172413793103448;0.482758620689655
Control.SRR15539874;31;32;0.451612903225806;17;14;0.0483870967741936;0.451612903225806
Control.SRR15539874;29;32;0.517241379310345;14;15;0.0172413793103449;0.482758620689655
Control.SRR15539874;36;32;0.444444444444444;20;16;0.0555555555555556;0.444444444444444
Control.SRR15539874;29;32;0.482758620689655;15;14;0.0172413793103448;0.482758620689655
Control.SRR15539874;30;32;0.533333333333333;14;16;0.0333333333333333;0.466666666666667
Control.SRR15539874;30;32;0.433333333333333;17;13;0.0666666666666667;0.433333333333333
Control.SRR15539874;35;32;0.4;21;14;0.1;0.4
Control.SRR15539874;36;32;0.277777777777778;26;10;0.222222222222222;0.277777777777778
Control.SRR15539874;34;32;0.5;17;17;0;0.5
Control.SRR15539874;31;32;0.354838709677419;20;11;0.145161290322581;0.354838709677419
Control.SRR15539874;34;32;0.382352941176471;21;13;0.117647058823529;0.382352941176471
Control.SRR15539874;31;32;0.548387096774194;14;17;0.0483870967741935;0.451612903225806
Control.SRR15539874;30;32;0.5;15;15;0;0.5
Control.SRR15539874;35;32;0.314285714285714;24;11;0.185714285714286;0.314285714285714
Control.SRR15539874;30;32;0.5;15;15;0;0.5
Control.SRR15539874;35;32;0.571428571428571;15;20;0.0714285714285714;0.428571428571429
Control.SRR15539874;32;32;0.46875;17;15;0.03125;0.46875
Control.SRR15539874;37;32;0.621621621621622;14;23;0.121621621621622;0.378378378378378
Control.SRR15539874;36;32;0.527777777777778;17;19;0.0277777777777778;0.472222222222222
Control.SRR15539874;37;32;0.567567567567568;16;21;0.0675675675675675;0.432432432432432
Control.SRR15539874;31;32;0.67741935483871;10;21;0.17741935483871;0.32258064516129
Control.SRR15539874;30;32;0.533333333333333;14;16;0.0333333333333333;0.466666666666667
Control.SRR15539874;30;32;0.466666666666667;16;14;0.0333333333333333;0.466666666666667
Control.SRR15539874;31;32;0.387096774193548;19;12;0.112903225806452;0.387096774193548
Control.SRR15539874;29;32;0.517241379310345;14;15;0.0172413793103449;0.482758620689655
Control.SRR15539874;33;32;0.666666666666667;11;22;0.166666666666667;0.333333333333333
Control.SRR15539874;34;32;0.588235294117647;14;20;0.0882352941176471;0.411764705882353
Control.SRR15539874;37;32;0.540540540540541;17;20;0.0405405405405406;0.459459459459459
Control.SRR15539874;32;32;0.5625;14;18;0.0625;0.4375
Control.SRR15539874;36;32;0.638888888888889;13;23;0.138888888888889;0.361111111111111
Control.SRR15539874;35;32;0.542857142857143;16;19;0.0428571428571428;0.457142857142857
Control.SRR15539874;34;32;0.529411764705882;16;18;0.0294117647058824;0.470588235294118
Control.SRR15539874;33;32;0.363636363636364;21;12;0.136363636363636;0.363636363636364
Control.SRR15539874;36;32;0.638888888888889;13;23;0.138888888888889;0.361111111111111
Control.SRR15539874;36;32;0.5;18;18;0;0.5
Control.SRR15539874;30;32;0.566666666666667;13;17;0.0666666666666667;0.433333333333333
Control.SRR15539874;29;32;0.413793103448276;17;12;0.0862068965517241;0.413793103448276
Control.SRR15539874;36;32;0.666666666666667;12;24;0.166666666666667;0.333333333333333
Control.SRR15539874;32;32;0.53125;15;17;0.03125;0.46875
Control.SRR15539874;35;32;0.314285714285714;24;11;0.185714285714286;0.314285714285714
Control.SRR15539874;29;32;0.620689655172414;11;18;0.120689655172414;0.379310344827586
Control.SRR15539874;33;32;0.545454545454545;15;18;0.0454545454545454;0.454545454545455
Control.SRR15539874;34;32;0.5;17;17;0;0.5
Control.SRR15539874;37;32;0.486486486486487;19;18;0.0135135135135135;0.486486486486487
Control.SRR15539874;33;32;0.575757575757576;14;19;0.0757575757575758;0.424242424242424
Control.SRR15539874;30;32;0.5;15;15;0;0.5
Control.SRR15539874;35;32;0.457142857142857;19;16;0.0428571428571429;0.457142857142857
Control.SRR15539874;32;32;0.6875;10;22;0.1875;0.3125
Control.SRR15539874;30;32;0.366666666666667;19;11;0.133333333333333;0.366666666666667
Control.SRR15539874;37;32;0.621621621621622;14;23;0.121621621621622;0.378378378378378
Control.SRR15539874;32;32;0.53125;15;17;0.03125;0.46875
Control.SRR15539874;33;32;0.454545454545455;18;15;0.0454545454545455;0.454545454545455
Control.SRR15539874;34;32;0.529411764705882;16;18;0.0294117647058824;0.470588235294118
Control.SRR15539874;34;32;0.411764705882353;20;14;0.0882352941176471;0.411764705882353
Control.SRR15539874;34;32;0.529411764705882;16;18;0.0294117647058824;0.470588235294118
Control.SRR15539874;37;32;0.513513513513513;18;19;0.0135135135135135;0.486486486486487
Control.SRR15539874;31;32;0.387096774193548;19;12;0.112903225806452;0.387096774193548
Control.SRR15539874;34;32;0.558823529411765;15;19;0.0588235294117647;0.441176470588235
Control.SRR15539874;31;32;0.451612903225806;17;14;0.0483870967741936;0.451612903225806
Control.SRR15539874;35;32;0.428571428571429;20;15;0.0714285714285715;0.428571428571429
Control.SRR15539874;32;32;0.625;12;20;0.125;0.375
Control.SRR15539874;30;32;0.566666666666667;13;17;0.0666666666666667;0.433333333333333
Control.SRR15539874;33;32;0.545454545454545;15;18;0.0454545454545454;0.454545454545455
Control.SRR15539874;36;32;0.472222222222222;19;17;0.0277777777777778;0.472222222222222
Control.SRR15539874;35;32;0.514285714285714;17;18;0.0142857142857142;0.485714285714286
Control.SRR15539874;30;32;0.466666666666667;16;14;0.0333333333333333;0.466666666666667
Control.SRR15539874;36;32;0.5;18;18;0;0.5
Control.SRR15539874;31;32;0.516129032258065;15;16;0.0161290322580645;0.483870967741935
Control.SRR15539874;31;32;0.419354838709677;18;13;0.0806451612903226;0.419354838709677
Control.SRR15539874;30;32;0.366666666666667;19;11;0.133333333333333;0.366666666666667
Control.SRR15539874;35;32;0.542857142857143;16;19;0.0428571428571428;0.457142857142857
Control.SRR15539874;34;32;0.382352941176471;21;13;0.117647058823529;0.382352941176471
Control.SRR15539874;35;32;0.514285714285714;17;18;0.0142857142857142;0.485714285714286
Control.SRR15539874;33;32;0.484848484848485;17;16;0.0151515151515151;0.484848484848485
Control.SRR15539874;32;32;0.5;16;16;0;0.5
Control.SRR15539874;33;32;0.393939393939394;20;13;0.106060606060606;0.393939393939394
Control.SRR15539874;33;32;0.575757575757576;14;19;0.0757575757575758;0.424242424242424
Control.SRR15539874;37;32;0.513513513513513;18;19;0.0135135135135135;0.486486486486487
Control.SRR15539874;34;32;0.5;17;17;0;0.5
Control.SRR15539874;29;32;0.448275862068966;16;13;0.0517241379310345;0.448275862068966
Control.SRR15539874;31;32;0.387096774193548;19;12;0.112903225806452;0.387096774193548
Control.SRR15539874;29;32;0.448275862068966;16;13;0.0517241379310345;0.448275862068966
Control.SRR15539874;33;32;0.424242424242424;19;14;0.0757575757575757;0.424242424242424
Control.SRR15539874;33;32;0.363636363636364;21;12;0.136363636363636;0.363636363636364
Control.SRR15539874;37;32;0.486486486486487;19;18;0.0135135135135135;0.486486486486487
Control.SRR15539874;32;32;0.4375;18;14;0.0625;0.4375
Control.SRR15539874;32;32;0.5;16;16;0;0.5
Control.SRR15539874;31;32;0.483870967741935;16;15;0.0161290322580645;0.483870967741935
Control.SRR15539874;37;32;0.378378378378378;23;14;0.121621621621622;0.378378378378378
Control.SRR15539874;36;32;0.416666666666667;21;15;0.0833333333333333;0.416666666666667
Control.SRR15539874;29;32;0.448275862068966;16;13;0.0517241379310345;0.448275862068966
Control.SRR15539874;35;32;0.4;21;14;0.1;0.4
Control.SRR15539874;33;32;0.333333333333333;22;11;0.166666666666667;0.333333333333333
Control.SRR15539874;35;32;0.571428571428571;15;20;0.0714285714285714;0.428571428571429
Control.SRR15539874;30;32;0.5;15;15;0;0.5
Control.SRR15539874;35;32;0.485714285714286;18;17;0.0142857142857143;0.485714285714286
Control.SRR15539874;35;32;0.4;21;14;0.1;0.4
Control.SRR15539874;37;32;0.486486486486487;19;18;0.0135135135135135;0.486486486486487
Control.SRR15539874;37;32;0.351351351351351;24;13;0.148648648648649;0.351351351351351
Control.SRR15539874;32;32;0.46875;17;15;0.03125;0.46875
Control.SRR15539874;35;32;0.542857142857143;16;19;0.0428571428571428;0.457142857142857
Control.SRR15539874;37;32;0.540540540540541;17;20;0.0405405405405406;0.459459459459459
Control.SRR15539874;35;32;0.571428571428571;15;20;0.0714285714285714;0.428571428571429
Control.SRR15539874;31;32;0.451612903225806;17;14;0.0483870967741936;0.451612903225806
Control.SRR15539874;35;32;0.457142857142857;19;16;0.0428571428571429;0.457142857142857
Control.SRR15539874;34;32;0.411764705882353;20;14;0.0882352941176471;0.411764705882353
Control.SRR15539874;33;32;0.606060606060606;13;20;0.106060606060606;0.393939393939394
Control.SRR15539874;35;32;0.4;21;14;0.1;0.4
Control.SRR15539874;34;32;0.411764705882353;20;14;0.0882352941176471;0.411764705882353
Control.SRR15539874;35;32;0.542857142857143;16;19;0.0428571428571428;0.457142857142857
Control.SRR15539874;30;32;0.466666666666667;16;14;0.0333333333333333;0.466666666666667
Control.SRR15539874;33;32;0.454545454545455;18;15;0.0454545454545455;0.454545454545455
Control.SRR15539874;29;32;0.448275862068966;16;13;0.0517241379310345;0.448275862068966
Control.SRR15539874;35;32;0.514285714285714;17;18;0.0142857142857142;0.485714285714286
Control.SRR15539874;34;32;0.323529411764706;23;11;0.176470588235294;0.323529411764706
Control.SRR15539874;35;32;0.485714285714286;18;17;0.0142857142857143;0.485714285714286
Control.SRR15539874;33;32;0.666666666666667;11;22;0.166666666666667;0.333333333333333
Control.SRR15539874;33;32;0.424242424242424;19;14;0.0757575757575757;0.424242424242424
Control.SRR15539874;31;32;0.483870967741935;16;15;0.0161290322580645;0.483870967741935
Control.SRR15539874;30;32;0.533333333333333;14;16;0.0333333333333333;0.466666666666667
Control.SRR15539874;31;32;0.580645161290323;13;18;0.0806451612903226;0.419354838709677
Control.SRR15539874;31;32;0.451612903225806;17;14;0.0483870967741936;0.451612903225806
Control.SRR15539874;33;32;0.575757575757576;14;19;0.0757575757575758;0.424242424242424
Control.SRR15539874;35;32;0.457142857142857;19;16;0.0428571428571429;0.457142857142857
Control.SRR15539874;35;32;0.6;14;21;0.1;0.4
Control.SRR15539874;36;32;0.416666666666667;21;15;0.0833333333333333;0.416666666666667
Control.SRR15539874;37;32;0.459459459459459;20;17;0.0405405405405405;0.459459459459459
Control.SRR15539874;37;32;0.378378378378378;23;14;0.121621621621622;0.378378378378378
Control.SRR15539874;32;32;0.53125;15;17;0.03125;0.46875
Control.SRR15539874;31;32;0.387096774193548;19;12;0.112903225806452;0.387096774193548
Control.SRR15539874;32;32;0.59375;13;19;0.09375;0.40625
Control.SRR15539874;36;32;0.611111111111111;14;22;0.111111111111111;0.388888888888889
Control.SRR15539874;30;32;0.566666666666667;13;17;0.0666666666666667;0.433333333333333
Control.SRR15539874;36;32;0.361111111111111;23;13;0.138888888888889;0.361111111111111
Control.SRR15539874;36;32;0.5;18;18;0;0.5
Control.SRR15539874;32;32;0.4375;18;14;0.0625;0.4375
Control.SRR15539874;35;32;0.657142857142857;12;23;0.157142857142857;0.342857142857143
Control.SRR15539874;31;32;0.32258064516129;21;10;0.17741935483871;0.32258064516129
Control.SRR15539874;32;32;0.53125;15;17;0.03125;0.46875
Control.SRR15539874;30;32;0.4;18;12;0.1;0.4
Control.SRR15539874;31;32;0.354838709677419;20;11;0.145161290322581;0.354838709677419
Control.SRR15539874;36;32;0.361111111111111;23;13;0.138888888888889;0.361111111111111
Control.SRR15539874;30;32;0.4;18;12;0.1;0.4
Control.SRR15539874;34;32;0.441176470588235;19;15;0.0588235294117647;0.441176470588235
Control.SRR15539874;31;32;0.451612903225806;17;14;0.0483870967741936;0.451612903225806
Control.SRR15539874;31;32;0.612903225806452;12;19;0.112903225806452;0.387096774193548
Control.SRR15539874;34;32;0.529411764705882;16;18;0.0294117647058824;0.470588235294118
Control.SRR15539874;32;32;0.5;16;16;0;0.5
Control.SRR15539874;37;32;0.432432432432432;21;16;0.0675675675675675;0.432432432432432
Control.SRR15539874;33;32;0.424242424242424;19;14;0.0757575757575757;0.424242424242424
Control.SRR15539874;35;32;0.571428571428571;15;20;0.0714285714285714;0.428571428571429
Control.SRR15539874;29;32;0.551724137931034;13;16;0.0517241379310345;0.448275862068966
Control.SRR15539874;37;32;0.378378378378378;23;14;0.121621621621622;0.378378378378378
Control.SRR15539874;30;32;0.466666666666667;16;14;0.0333333333333333;0.466666666666667
Control.SRR15539874;31;32;0.67741935483871;10;21;0.17741935483871;0.32258064516129
Control.SRR15539874;32;32;0.625;12;20;0.125;0.375
Control.SRR15539874;34;32;0.470588235294118;18;16;0.0294117647058824;0.470588235294118
Control.SRR15539874;36;32;0.444444444444444;20;16;0.0555555555555556;0.444444444444444
Control.SRR15539874;31;32;0.580645161290323;13;18;0.0806451612903226;0.419354838709677
Control.SRR15539874;33;32;0.636363636363636;12;21;0.136363636363636;0.363636363636364
Control.SRR15539874;37;32;0.486486486486487;19;18;0.0135135135135135;0.486486486486487
Control.SRR15539874;36;32;0.472222222222222;19;17;0.0277777777777778;0.472222222222222
Control.SRR15539874;36;32;0.555555555555556;16;20;0.0555555555555556;0.444444444444444
Control.SRR15539874;31;32;0.483870967741935;16;15;0.0161290322580645;0.483870967741935
Control.SRR15539874;29;32;0.448275862068966;16;13;0.0517241379310345;0.448275862068966
Control.SRR15539874;32;32;0.59375;13;19;0.09375;0.40625
Control.SRR15539874;33;32;0.545454545454545;15;18;0.0454545454545454;0.454545454545455
Control.SRR15539874;33;32;0.484848484848485;17;16;0.0151515151515151;0.484848484848485
Control.SRR15539874;36;32;0.5;18;18;0;0.5
Control.SRR15539874;35;32;0.457142857142857;19;16;0.0428571428571429;0.457142857142857
Control.SRR15539874;35;32;0.6;14;21;0.1;0.4
Control.SRR15539874;32;32;0.59375;13;19;0.09375;0.40625
Control.SRR15539874;32;32;0.4375;18;14;0.0625;0.4375
Control.SRR15539874;34;32;0.558823529411765;15;19;0.0588235294117647;0.441176470588235
Control.SRR15539874;34;32;0.411764705882353;20;14;0.0882352941176471;0.411764705882353
Control.SRR15539874;30;32;0.266666666666667;22;8;0.233333333333333;0.266666666666667
Control.SRR15539874;29;32;0.413793103448276;17;12;0.0862068965517241;0.413793103448276
Control.SRR15539874;30;32;0.333333333333333;20;10;0.166666666666667;0.333333333333333
Control.SRR15539874;37;32;0.540540540540541;17;20;0.0405405405405406;0.459459459459459
Control.SRR15539874;30;32;0.6;12;18;0.1;0.4
Control.SRR15539874;29;32;0.586206896551724;12;17;0.0862068965517241;0.413793103448276
Control.SRR15539874;32;32;0.34375;21;11;0.15625;0.34375
Control.SRR15539874;36;32;0.361111111111111;23;13;0.138888888888889;0.361111111111111
Control.SRR15539874;34;32;0.470588235294118;18;16;0.0294117647058824;0.470588235294118
Control.SRR15539874;34;32;0.5;17;17;0;0.5
Control.SRR15539874;31;32;0.483870967741935;16;15;0.0161290322580645;0.483870967741935
Control.SRR15539874;29;32;0.620689655172414;11;18;0.120689655172414;0.379310344827586
Control.SRR15539874;30;32;0.466666666666667;16;14;0.0333333333333333;0.466666666666667
Control.SRR15539874;36;32;0.527777777777778;17;19;0.0277777777777778;0.472222222222222
Control.SRR15539874;32;32;0.46875;17;15;0.03125;0.46875
Control.SRR15539874;32;32;0.46875;17;15;0.03125;0.46875
Control.SRR15539874;35;32;0.485714285714286;18;17;0.0142857142857143;0.485714285714286
Control.SRR15539874;34;32;0.529411764705882;16;18;0.0294117647058824;0.470588235294118
Control.SRR15539874;35;32;0.428571428571429;20;15;0.0714285714285715;0.428571428571429
Control.SRR15539874;30;32;0.5;15;15;0;0.5
Control.SRR15539874;31;32;0.483870967741935;16;15;0.0161290322580645;0.483870967741935
Control.SRR15539874;35;32;0.371428571428571;22;13;0.128571428571429;0.371428571428571
Control.SRR15539874;35;32;0.485714285714286;18;17;0.0142857142857143;0.485714285714286
Control.SRR15539874;35;32;0.685714285714286;11;24;0.185714285714286;0.314285714285714
Control.SRR15539874;30;32;0.533333333333333;14;16;0.0333333333333333;0.466666666666667
Control.SRR15539874;31;32;0.580645161290323;13;18;0.0806451612903226;0.419354838709677
Control.SRR15539874;36;32;0.416666666666667;21;15;0.0833333333333333;0.416666666666667
Control.SRR15539874;31;32;0.483870967741935;16;15;0.0161290322580645;0.483870967741935
Control.SRR15539874;31;32;0.483870967741935;16;15;0.0161290322580645;0.483870967741935
Control.SRR15539874;31;32;0.419354838709677;18;13;0.0806451612903226;0.419354838709677
Control.SRR15539874;33;32;0.484848484848485;17;16;0.0151515151515151;0.484848484848485
Control.SRR15539874;37;32;0.486486486486487;19;18;0.0135135135135135;0.486486486486487
Control.SRR15539874;34;32;0.676470588235294;11;23;0.176470588235294;0.323529411764706
Control.SRR15539874;37;32;0.594594594594595;15;22;0.0945945945945946;0.405405405405405
Control.SRR15539874;36;32;0.5;18;18;0;0.5
Control.SRR15539874;34;32;0.529411764705882;16;18;0.0294117647058824;0.470588235294118
Control.SRR15539874;37;32;0.567567567567568;16;21;0.0675675675675675;0.432432432432432
Control.SRR15539874;36;32;0.472222222222222;19;17;0.0277777777777778;0.472222222222222
Control.SRR15539874;37;32;0.351351351351351;24;13;0.148648648648649;0.351351351351351
Control.SRR15539874;33;32;0.575757575757576;14;19;0.0757575757575758;0.424242424242424
Control.SRR15539874;29;32;0.586206896551724;12;17;0.0862068965517241;0.413793103448276
Control.SRR15539874;30;32;0.5;15;15;0;0.5
Control.SRR15539874;33;32;0.454545454545455;18;15;0.0454545454545455;0.454545454545455
Control.SRR15539874;30;32;0.566666666666667;13;17;0.0666666666666667;0.433333333333333
Control.SRR15539874;35;32;0.6;14;21;0.1;0.4
Control.SRR15539874;33;32;0.515151515151515;16;17;0.0151515151515151;0.484848484848485
Control.SRR15539874;31;32;0.451612903225806;17;14;0.0483870967741936;0.451612903225806
Control.SRR15539874;30;32;0.6;12;18;0.1;0.4
Control.SRR15539874;29;32;0.379310344827586;18;11;0.120689655172414;0.379310344827586
Control.SRR15539874;32;32;0.5;16;16;0;0.5
Control.SRR15539874;36;32;0.472222222222222;19;17;0.0277777777777778;0.472222222222222
Control.SRR15539874;37;32;0.459459459459459;20;17;0.0405405405405405;0.459459459459459
Control.SRR15539874;33;32;0.575757575757576;14;19;0.0757575757575758;0.424242424242424
Control.SRR15539874;31;32;0.387096774193548;19;12;0.112903225806452;0.387096774193548
Control.SRR15539874;33;32;0.484848484848485;17;16;0.0151515151515151;0.484848484848485
Control.SRR15539874;31;32;0.645161290322581;11;20;0.145161290322581;0.354838709677419
Control.SRR15539874;31;32;0.419354838709677;18;13;0.0806451612903226;0.419354838709677
Control.SRR15539874;30;32;0.5;15;15;0;0.5
Control.SRR15539874;33;32;0.424242424242424;19;14;0.0757575757575757;0.424242424242424
Control.SRR15539874;37;32;0.540540540540541;17;20;0.0405405405405406;0.459459459459459
Control.SRR15539874;34;32;0.470588235294118;18;16;0.0294117647058824;0.470588235294118
Control.SRR15539874;32;32;0.1875;26;6;0.3125;0.1875
Control.SRR15539874;33;32;0.424242424242424;19;14;0.0757575757575757;0.424242424242424
Control.SRR15539874;32;32;0.5;16;16;0;0.5
Control.SRR15539874;30;32;0.433333333333333;17;13;0.0666666666666667;0.433333333333333
Control.SRR15539874;30;32;0.533333333333333;14;16;0.0333333333333333;0.466666666666667
Control.SRR15539874;36;32;0.472222222222222;19;17;0.0277777777777778;0.472222222222222
Control.SRR15539874;31;32;0.612903225806452;12;19;0.112903225806452;0.387096774193548
Control.SRR15539874;35;32;0.371428571428571;22;13;0.128571428571429;0.371428571428571
Control.SRR15539874;33;32;0.484848484848485;17;16;0.0151515151515151;0.484848484848485
Control.SRR15539874;30;32;0.366666666666667;19;11;0.133333333333333;0.366666666666667
Control.SRR15539874;29;32;0.310344827586207;20;9;0.189655172413793;0.310344827586207
Control.SRR15539874;37;32;0.432432432432432;21;16;0.0675675675675675;0.432432432432432
Control.SRR15539874;31;32;0.548387096774194;14;17;0.0483870967741935;0.451612903225806
Control.SRR15539874;31;32;0.419354838709677;18;13;0.0806451612903226;0.419354838709677
Control.SRR15539874;35;32;0.571428571428571;15;20;0.0714285714285714;0.428571428571429
Control.SRR15539874;36;32;0.444444444444444;20;16;0.0555555555555556;0.444444444444444
Control.SRR15539874;37;32;0.567567567567568;16;21;0.0675675675675675;0.432432432432432
Control.SRR15539874;35;32;0.685714285714286;11;24;0.185714285714286;0.314285714285714
Control.SRR15539874;30;32;0.566666666666667;13;17;0.0666666666666667;0.433333333333333
Control.SRR15539874;35;32;0.6;14;21;0.1;0.4
Control.SRR15539874;33;32;0.424242424242424;19;14;0.0757575757575757;0.424242424242424
Control.SRR15539874;35;32;0.428571428571429;20;15;0.0714285714285715;0.428571428571429
Control.SRR15539874;31;32;0.354838709677419;20;11;0.145161290322581;0.354838709677419
Control.SRR15539874;29;32;0.620689655172414;11;18;0.120689655172414;0.379310344827586
Control.SRR15539874;35;32;0.457142857142857;19;16;0.0428571428571429;0.457142857142857
Control.SRR15539874;30;32;0.666666666666667;10;20;0.166666666666667;0.333333333333333
Control.SRR15539874;37;32;0.351351351351351;24;13;0.148648648648649;0.351351351351351
Control.SRR15539874;37;32;0.378378378378378;23;14;0.121621621621622;0.378378378378378
Control.SRR15539874;35;32;0.657142857142857;12;23;0.157142857142857;0.342857142857143
Control.SRR15539874;29;32;0.586206896551724;12;17;0.0862068965517241;0.413793103448276
Control.SRR15539874;32;32;0.34375;21;11;0.15625;0.34375
Control.SRR15539874;31;32;0.387096774193548;19;12;0.112903225806452;0.387096774193548
Control.SRR15539874;33;32;0.393939393939394;20;13;0.106060606060606;0.393939393939394
Control.SRR15539874;32;32;0.46875;17;15;0.03125;0.46875
Control.SRR15539874;36;32;0.444444444444444;20;16;0.0555555555555556;0.444444444444444
Control.SRR15539874;34;32;0.558823529411765;15;19;0.0588235294117647;0.441176470588235
Control.SRR15539874;37;32;0.621621621621622;14;23;0.121621621621622;0.378378378378378
Control.SRR15539874;37;32;0.432432432432432;21;16;0.0675675675675675;0.432432432432432
Control.SRR15539874;32;32;0.5;16;16;0;0.5
Control.SRR15539874;37;32;0.459459459459459;20;17;0.0405405405405405;0.459459459459459
Control.SRR15539874;33;32;0.575757575757576;14;19;0.0757575757575758;0.424242424242424
Control.SRR15539874;29;32;0.413793103448276;17;12;0.0862068965517241;0.413793103448276
Control.SRR15539874;37;32;0.621621621621622;14;23;0.121621621621622;0.378378378378378
Control.SRR15539874;31;32;0.32258064516129;21;10;0.17741935483871;0.32258064516129
Control.SRR15539874;33;32;0.545454545454545;15;18;0.0454545454545454;0.454545454545455
Control.SRR15539874;32;32;0.5625;14;18;0.0625;0.4375
Control.SRR15539874;35;32;0.657142857142857;12;23;0.157142857142857;0.342857142857143
Control.SRR15539874;29;32;0.482758620689655;15;14;0.0172413793103448;0.482758620689655
Control.SRR15539874;34;32;0.5;17;17;0;0.5
Control.SRR15539874;35;32;0.485714285714286;18;17;0.0142857142857143;0.485714285714286
Control.SRR15539874;31;32;0.709677419354839;9;22;0.209677419354839;0.290322580645161
Control.SRR15539874;34;32;0.470588235294118;18;16;0.0294117647058824;0.470588235294118
Control.SRR15539874;33;32;0.454545454545455;18;15;0.0454545454545455;0.454545454545455
Control.SRR15539874;29;32;0.413793103448276;17;12;0.0862068965517241;0.413793103448276
Control.SRR15539874;29;32;0.620689655172414;11;18;0.120689655172414;0.379310344827586
Control.SRR15539874;30;32;0.433333333333333;17;13;0.0666666666666667;0.433333333333333
Control.SRR15539874;36;32;0.611111111111111;14;22;0.111111111111111;0.388888888888889
Control.SRR15539874;29;32;0.413793103448276;17;12;0.0862068965517241;0.413793103448276
Control.SRR15539874;34;32;0.529411764705882;16;18;0.0294117647058824;0.470588235294118
Control.SRR15539874;37;32;0.513513513513513;18;19;0.0135135135135135;0.486486486486487
Control.SRR15539874;31;32;0.548387096774194;14;17;0.0483870967741935;0.451612903225806
Control.SRR15539874;30;32;0.466666666666667;16;14;0.0333333333333333;0.466666666666667
Control.SRR15539874;30;32;0.466666666666667;16;14;0.0333333333333333;0.466666666666667
Control.SRR15539874;29;32;0.482758620689655;15;14;0.0172413793103448;0.482758620689655
Control.SRR15539874;32;32;0.46875;17;15;0.03125;0.46875
Control.SRR15539874;32;32;0.46875;17;15;0.03125;0.46875
Control.SRR15539874;33;32;0.515151515151515;16;17;0.0151515151515151;0.484848484848485
Control.SRR15539874;30;32;0.466666666666667;16;14;0.0333333333333333;0.466666666666667
Control.SRR15539874;32;32;0.4375;18;14;0.0625;0.4375
Control.SRR15539874;34;32;0.411764705882353;20;14;0.0882352941176471;0.411764705882353
Control.SRR15539874;29;32;0.517241379310345;14;15;0.0172413793103449;0.482758620689655
Control.SRR15539874;31;32;0.516129032258065;15;16;0.0161290322580645;0.483870967741935
Control.SRR15539874;30;32;0.466666666666667;16;14;0.0333333333333333;0.466666666666667
Control.SRR15539874;32;32;0.5625;14;18;0.0625;0.4375
Control.SRR15539874;29;32;0.448275862068966;16;13;0.0517241379310345;0.448275862068966
Control.SRR15539874;34;32;0.5;17;17;0;0.5
Control.SRR15539874;29;32;0.620689655172414;11;18;0.120689655172414;0.379310344827586
Control.SRR15539874;33;32;0.393939393939394;20;13;0.106060606060606;0.393939393939394
Control.SRR15539874;32;32;0.5;16;16;0;0.5
Control.SRR15539874;29;32;0.379310344827586;18;11;0.120689655172414;0.379310344827586
Control.SRR15539874;30;32;0.533333333333333;14;16;0.0333333333333333;0.466666666666667
Control.SRR15539874;33;32;0.575757575757576;14;19;0.0757575757575758;0.424242424242424
Control.SRR15539874;30;32;0.433333333333333;17;13;0.0666666666666667;0.433333333333333
Control.SRR15539874;31;32;0.483870967741935;16;15;0.0161290322580645;0.483870967741935
Control.SRR15539874;29;32;0.448275862068966;16;13;0.0517241379310345;0.448275862068966
Control.SRR15539874;29;32;0.482758620689655;15;14;0.0172413793103448;0.482758620689655
Control.SRR15539874;33;32;0.636363636363636;12;21;0.136363636363636;0.363636363636364
Control.SRR15539874;32;32;0.46875;17;15;0.03125;0.46875
Control.SRR15539874;37;32;0.540540540540541;17;20;0.0405405405405406;0.459459459459459
Control.SRR15539874;32;32;0.375;20;12;0.125;0.375
Control.SRR15539874;30;32;0.5;15;15;0;0.5
Control.SRR15539874;33;32;0.515151515151515;16;17;0.0151515151515151;0.484848484848485
Control.SRR15539874;35;32;0.514285714285714;17;18;0.0142857142857142;0.485714285714286
Control.SRR15539874;35;32;0.571428571428571;15;20;0.0714285714285714;0.428571428571429
Control.SRR15539874;36;32;0.5;18;18;0;0.5
Control.SRR15539874;32;32;0.5;16;16;0;0.5
Control.SRR15539874;31;32;0.387096774193548;19;12;0.112903225806452;0.387096774193548
Control.SRR15539874;32;32;0.375;20;12;0.125;0.375
Control.SRR15539874;37;32;0.513513513513513;18;19;0.0135135135135135;0.486486486486487
Control.SRR15539874;35;32;0.571428571428571;15;20;0.0714285714285714;0.428571428571429
Control.SRR15539874;30;32;0.433333333333333;17;13;0.0666666666666667;0.433333333333333
Control.SRR15539874;30;32;0.366666666666667;19;11;0.133333333333333;0.366666666666667
Control.SRR15539874;30;32;0.633333333333333;11;19;0.133333333333333;0.366666666666667
Control.SRR15539874;36;32;0.5;18;18;0;0.5
Control.SRR15539874;30;32;0.533333333333333;14;16;0.0333333333333333;0.466666666666667
Control.SRR15539874;37;32;0.432432432432432;21;16;0.0675675675675675;0.432432432432432
Control.SRR15539874;30;32;0.4;18;12;0.1;0.4
Control.SRR15539874;32;32;0.5625;14;18;0.0625;0.4375
Control.SRR15539874;29;32;0.689655172413793;9;20;0.189655172413793;0.310344827586207
Control.SRR15539874;33;32;0.545454545454545;15;18;0.0454545454545454;0.454545454545455
Control.SRR15539874;31;32;0.387096774193548;19;12;0.112903225806452;0.387096774193548
Control.SRR15539874;31;32;0.483870967741935;16;15;0.0161290322580645;0.483870967741935
Control.SRR15539874;36;32;0.583333333333333;15;21;0.0833333333333334;0.416666666666667
Control.SRR15539874;31;32;0.580645161290323;13;18;0.0806451612903226;0.419354838709677
Control.SRR15539874;30;32;0.5;15;15;0;0.5
Control.SRR15539874;34;32;0.441176470588235;19;15;0.0588235294117647;0.441176470588235
Control.SRR15539874;35;32;0.6;14;21;0.1;0.4
Control.SRR15539874;29;32;0.586206896551724;12;17;0.0862068965517241;0.413793103448276
Control.SRR15539874;30;32;0.6;12;18;0.1;0.4
Control.SRR15539874;29;32;0.379310344827586;18;11;0.120689655172414;0.379310344827586
Control.SRR15539874;29;32;0.275862068965517;21;8;0.224137931034483;0.275862068965517
Control.SRR15539874;32;32;0.4375;18;14;0.0625;0.4375
Control.SRR15539874;31;32;0.516129032258065;15;16;0.0161290322580645;0.483870967741935
Control.SRR15539874;30;32;0.433333333333333;17;13;0.0666666666666667;0.433333333333333
Control.SRR15539874;29;32;0.689655172413793;9;20;0.189655172413793;0.310344827586207
Control.SRR15539874;29;32;0.379310344827586;18;11;0.120689655172414;0.379310344827586
Control.SRR15539874;33;32;0.393939393939394;20;13;0.106060606060606;0.393939393939394
Control.SRR15539874;35;32;0.428571428571429;20;15;0.0714285714285715;0.428571428571429
Control.SRR15539874;36;32;0.5;18;18;0;0.5
Control.SRR15539874;29;32;0.482758620689655;15;14;0.0172413793103448;0.482758620689655
Control.SRR15539874;32;32;0.53125;15;17;0.03125;0.46875
Control.SRR15539874;32;32;0.46875;17;15;0.03125;0.46875
Control.SRR15539874;34;32;0.558823529411765;15;19;0.0588235294117647;0.441176470588235
Control.SRR15539874;29;32;0.344827586206897;19;10;0.155172413793103;0.344827586206897
Control.SRR15539874;37;32;0.540540540540541;17;20;0.0405405405405406;0.459459459459459
Control.SRR15539874;31;32;0.548387096774194;14;17;0.0483870967741935;0.451612903225806
Control.SRR15539874;32;32;0.34375;21;11;0.15625;0.34375
Control.SRR15539874;30;32;0.5;15;15;0;0.5
Control.SRR15539874;31;32;0.580645161290323;13;18;0.0806451612903226;0.419354838709677
Control.SRR15539874;37;32;0.459459459459459;20;17;0.0405405405405405;0.459459459459459
Control.SRR15539874;35;32;0.485714285714286;18;17;0.0142857142857143;0.485714285714286
Control.SRR15539874;31;32;0.483870967741935;16;15;0.0161290322580645;0.483870967741935
Control.SRR15539874;31;32;0.67741935483871;10;21;0.17741935483871;0.32258064516129
Control.SRR15539874;30;32;0.566666666666667;13;17;0.0666666666666667;0.433333333333333
Control.SRR15539874;35;32;0.571428571428571;15;20;0.0714285714285714;0.428571428571429
Control.SRR15539874;34;32;0.5;17;17;0;0.5
Control.SRR15539874;35;32;0.514285714285714;17;18;0.0142857142857142;0.485714285714286
Control.SRR15539874;30;32;0.466666666666667;16;14;0.0333333333333333;0.466666666666667
Control.SRR15539874;31;32;0.354838709677419;20;11;0.145161290322581;0.354838709677419
Control.SRR15539874;32;32;0.59375;13;19;0.09375;0.40625
Control.SRR15539874;35;32;0.6;14;21;0.1;0.4
Control.SRR15539874;33;32;0.272727272727273;24;9;0.227272727272727;0.272727272727273
Control.SRR15539874;30;32;0.5;15;15;0;0.5
Control.SRR15539874;30;32;0.5;15;15;0;0.5
Control.SRR15539874;34;32;0.264705882352941;25;9;0.235294117647059;0.264705882352941
Control.SRR15539874;34;32;0.647058823529412;12;22;0.147058823529412;0.352941176470588
Control.SRR15539874;36;32;0.305555555555556;25;11;0.194444444444444;0.305555555555556
Control.SRR15539874;33;32;0.545454545454545;15;18;0.0454545454545454;0.454545454545455
Control.SRR15539874;29;32;0.482758620689655;15;14;0.0172413793103448;0.482758620689655
Control.SRR15539874;35;32;0.542857142857143;16;19;0.0428571428571428;0.457142857142857
Control.SRR15539874;34;32;0.441176470588235;19;15;0.0588235294117647;0.441176470588235
Control.SRR15539874;33;32;0.424242424242424;19;14;0.0757575757575757;0.424242424242424
Control.SRR15539874;35;32;0.4;21;14;0.1;0.4
Control.SRR15539874;31;32;0.516129032258065;15;16;0.0161290322580645;0.483870967741935
Control.SRR15539874;34;32;0.441176470588235;19;15;0.0588235294117647;0.441176470588235
Control.SRR15539874;27;32;0.666666666666667;9;18;0.166666666666667;0.333333333333333
Control.SRR15539874;28;32;0.464285714285714;15;13;0.0357142857142857;0.464285714285714
Control.SRR15539874;32;32;0.28125;23;9;0.21875;0.28125
Control.SRR15539874;30;32;0.5;15;15;0;0.5
Control.SRR15539874;28;32;0.571428571428571;12;16;0.0714285714285714;0.428571428571429
Control.SRR15539874;29;32;0.448275862068966;16;13;0.0517241379310345;0.448275862068966
Control.SRR15539874;32;32;0.4375;18;14;0.0625;0.4375
Control.SRR15539874;35;32;0.457142857142857;19;16;0.0428571428571429;0.457142857142857
Control.SRR15539874;34;32;0.529411764705882;16;18;0.0294117647058824;0.470588235294118
Control.SRR15539874;28;32;0.535714285714286;13;15;0.0357142857142857;0.464285714285714
Control.SRR15539874;32;32;0.25;24;8;0.25;0.25
Control.SRR15539874;30;32;0.4;18;12;0.1;0.4
Control.SRR15539874;30;32;0.433333333333333;17;13;0.0666666666666667;0.433333333333333
Control.SRR15539874;32;32;0.5625;14;18;0.0625;0.4375
Control.SRR15539874;27;32;0.407407407407407;16;11;0.0925925925925926;0.407407407407407
Control.SRR15539874;27;32;0.518518518518518;13;14;0.0185185185185185;0.481481481481481
Control.SRR15539874;31;32;0.548387096774194;14;17;0.0483870967741935;0.451612903225806
Control.SRR15539874;29;32;0.379310344827586;18;11;0.120689655172414;0.379310344827586
Control.SRR15539874;28;32;0.535714285714286;13;15;0.0357142857142857;0.464285714285714
Control.SRR15539874;33;32;0.545454545454545;15;18;0.0454545454545454;0.454545454545455
Control.SRR15539874;28;32;0.571428571428571;12;16;0.0714285714285714;0.428571428571429
Control.SRR15539874;30;32;0.366666666666667;19;11;0.133333333333333;0.366666666666667
Control.SRR15539874;32;32;0.53125;15;17;0.03125;0.46875
Control.SRR15539874;34;32;0.382352941176471;21;13;0.117647058823529;0.382352941176471
Control.SRR15539874;35;32;0.457142857142857;19;16;0.0428571428571429;0.457142857142857
Control.SRR15539874;35;32;0.457142857142857;19;16;0.0428571428571429;0.457142857142857
Control.SRR15539874;28;32;0.392857142857143;17;11;0.107142857142857;0.392857142857143
Control.SRR15539874;33;32;0.454545454545455;18;15;0.0454545454545455;0.454545454545455
Control.SRR15539874;27;32;0.592592592592593;11;16;0.0925925925925926;0.407407407407407
Control.SRR15539874;29;32;0.482758620689655;15;14;0.0172413793103448;0.482758620689655
Control.SRR15539874;27;32;0.407407407407407;16;11;0.0925925925925926;0.407407407407407
Control.SRR15539874;31;32;0.387096774193548;19;12;0.112903225806452;0.387096774193548
Control.SRR15539874;32;32;0.5625;14;18;0.0625;0.4375
Control.SRR15539874;34;32;0.470588235294118;18;16;0.0294117647058824;0.470588235294118
Control.SRR15539874;35;32;0.485714285714286;18;17;0.0142857142857143;0.485714285714286
Control.SRR15539874;35;32;0.571428571428571;15;20;0.0714285714285714;0.428571428571429
Control.SRR15539874;27;32;0.62962962962963;10;17;0.12962962962963;0.37037037037037
Control.SRR15539874;30;32;0.433333333333333;17;13;0.0666666666666667;0.433333333333333
Control.SRR15539874;34;32;0.529411764705882;16;18;0.0294117647058824;0.470588235294118
Control.SRR15539874;29;32;0.379310344827586;18;11;0.120689655172414;0.379310344827586
Control.SRR15539874;30;32;0.533333333333333;14;16;0.0333333333333333;0.466666666666667
Control.SRR15539874;28;32;0.464285714285714;15;13;0.0357142857142857;0.464285714285714
Control.SRR15539874;30;32;0.4;18;12;0.1;0.4
Control.SRR15539874;32;32;0.5;16;16;0;0.5
Control.SRR15539874;29;32;0.448275862068966;16;13;0.0517241379310345;0.448275862068966
Control.SRR15539874;29;32;0.517241379310345;14;15;0.0172413793103449;0.482758620689655
Control.SRR15539874;33;32;0.484848484848485;17;16;0.0151515151515151;0.484848484848485
Control.SRR15539874;27;32;0.407407407407407;16;11;0.0925925925925926;0.407407407407407
Control.SRR15539874;30;32;0.733333333333333;8;22;0.233333333333333;0.266666666666667
Control.SRR15539874;30;32;0.533333333333333;14;16;0.0333333333333333;0.466666666666667
Control.SRR15539874;29;32;0.482758620689655;15;14;0.0172413793103448;0.482758620689655
Control.SRR15539874;31;32;0.387096774193548;19;12;0.112903225806452;0.387096774193548
Control.SRR15539874;30;32;0.566666666666667;13;17;0.0666666666666667;0.433333333333333
Control.SRR15539874;31;32;0.451612903225806;17;14;0.0483870967741936;0.451612903225806
Control.SRR15539874;29;32;0.448275862068966;16;13;0.0517241379310345;0.448275862068966
Control.SRR15539874;27;32;0.518518518518518;13;14;0.0185185185185185;0.481481481481481
Control.SRR15539874;35;32;0.485714285714286;18;17;0.0142857142857143;0.485714285714286
Control.SRR15539874;31;32;0.483870967741935;16;15;0.0161290322580645;0.483870967741935
Control.SRR15539874;31;32;0.451612903225806;17;14;0.0483870967741936;0.451612903225806
Control.SRR15539874;31;32;0.548387096774194;14;17;0.0483870967741935;0.451612903225806
Control.SRR15539874;32;32;0.5;16;16;0;0.5
Control.SRR15539874;30;32;0.566666666666667;13;17;0.0666666666666667;0.433333333333333
Control.SRR15539874;32;32;0.46875;17;15;0.03125;0.46875
Control.SRR15539874;27;32;0.481481481481481;14;13;0.0185185185185185;0.481481481481481
Control.SRR15539874;27;32;0.555555555555556;12;15;0.0555555555555556;0.444444444444444
Control.SRR15539874;33;32;0.454545454545455;18;15;0.0454545454545455;0.454545454545455
Control.SRR15539874;29;32;0.586206896551724;12;17;0.0862068965517241;0.413793103448276
Control.SRR15539874;27;32;0.518518518518518;13;14;0.0185185185185185;0.481481481481481
Control.SRR15539874;32;32;0.53125;15;17;0.03125;0.46875
Control.SRR15539874;33;32;0.424242424242424;19;14;0.0757575757575757;0.424242424242424
Control.SRR15539874;30;32;0.466666666666667;16;14;0.0333333333333333;0.466666666666667
Control.SRR15539874;32;32;0.4375;18;14;0.0625;0.4375
Control.SRR15539874;32;32;0.46875;17;15;0.03125;0.46875
Control.SRR15539874;32;32;0.59375;13;19;0.09375;0.40625
Control.SRR15539874;32;32;0.5;16;16;0;0.5
Control.SRR15539874;32;32;0.53125;15;17;0.03125;0.46875
Control.SRR15539874;30;32;0.566666666666667;13;17;0.0666666666666667;0.433333333333333
Control.SRR15539874;32;32;0.5625;14;18;0.0625;0.4375
Control.SRR15539874;28;32;0.714285714285714;8;20;0.214285714285714;0.285714285714286
Control.SRR15539874;34;32;0.558823529411765;15;19;0.0588235294117647;0.441176470588235
Control.SRR15539874;33;32;0.484848484848485;17;16;0.0151515151515151;0.484848484848485
Control.SRR15539874;28;32;0.285714285714286;20;8;0.214285714285714;0.285714285714286
Control.SRR15539874;30;32;0.433333333333333;17;13;0.0666666666666667;0.433333333333333
Control.SRR15539874;32;32;0.53125;15;17;0.03125;0.46875
Control.SRR15539874;28;32;0.428571428571429;16;12;0.0714285714285715;0.428571428571429
Control.SRR15539874;32;32;0.59375;13;19;0.09375;0.40625
Control.SRR15539874;32;32;0.65625;11;21;0.15625;0.34375
Control.SRR15539874;29;32;0.517241379310345;14;15;0.0172413793103449;0.482758620689655
Control.SRR15539874;27;32;0.592592592592593;11;16;0.0925925925925926;0.407407407407407
Control.SRR15539874;29;32;0.413793103448276;17;12;0.0862068965517241;0.413793103448276
Control.SRR15539874;33;32;0.545454545454545;15;18;0.0454545454545454;0.454545454545455
Control.SRR15539874;29;32;0.620689655172414;11;18;0.120689655172414;0.379310344827586
Control.SRR15539874;33;32;0.515151515151515;16;17;0.0151515151515151;0.484848484848485
Control.SRR15539874;30;32;0.466666666666667;16;14;0.0333333333333333;0.466666666666667
Control.SRR15539874;27;32;0.518518518518518;13;14;0.0185185185185185;0.481481481481481
Control.SRR15539874;31;32;0.387096774193548;19;12;0.112903225806452;0.387096774193548
Control.SRR15539874;33;32;0.303030303030303;23;10;0.196969696969697;0.303030303030303
Control.SRR15539874;28;32;0.428571428571429;16;12;0.0714285714285715;0.428571428571429
Control.SRR15539874;28;32;0.571428571428571;12;16;0.0714285714285714;0.428571428571429
Control.SRR15539874;27;32;0.481481481481481;14;13;0.0185185185185185;0.481481481481481
Control.SRR15539874;33;32;0.424242424242424;19;14;0.0757575757575757;0.424242424242424
Control.SRR15539874;32;32;0.53125;15;17;0.03125;0.46875
Control.SRR15539874;31;32;0.387096774193548;19;12;0.112903225806452;0.387096774193548
Control.SRR15539874;28;32;0.5;14;14;0;0.5
Control.SRR15539874;32;32;0.4375;18;14;0.0625;0.4375
Control.SRR15539874;35;32;0.371428571428571;22;13;0.128571428571429;0.371428571428571
Control.SRR15539874;31;32;0.741935483870968;8;23;0.241935483870968;0.258064516129032
Control.SRR15539874;33;32;0.515151515151515;16;17;0.0151515151515151;0.484848484848485
Control.SRR15539874;31;32;0.548387096774194;14;17;0.0483870967741935;0.451612903225806
Control.SRR15539874;31;32;0.645161290322581;11;20;0.145161290322581;0.354838709677419
Control.SRR15539874;29;32;0.448275862068966;16;13;0.0517241379310345;0.448275862068966
Control.SRR15539874;31;32;0.580645161290323;13;18;0.0806451612903226;0.419354838709677
Control.SRR15539874;32;32;0.5;16;16;0;0.5
Control.SRR15539874;28;32;0.357142857142857;18;10;0.142857142857143;0.357142857142857
Control.SRR15539874;32;32;0.5625;14;18;0.0625;0.4375
Control.SRR15539874;27;32;0.703703703703704;8;19;0.203703703703704;0.296296296296296
Control.SRR15539874;33;32;0.333333333333333;22;11;0.166666666666667;0.333333333333333
Control.SRR15539874;33;32;0.484848484848485;17;16;0.0151515151515151;0.484848484848485
Control.SRR15539874;31;32;0.580645161290323;13;18;0.0806451612903226;0.419354838709677
Control.SRR15539874;34;32;0.352941176470588;22;12;0.147058823529412;0.352941176470588
Control.SRR15539874;31;32;0.612903225806452;12;19;0.112903225806452;0.387096774193548
Control.SRR15539874;30;32;0.5;15;15;0;0.5
Control.SRR15539874;31;32;0.548387096774194;14;17;0.0483870967741935;0.451612903225806
Control.SRR15539874;30;32;0.5;15;15;0;0.5
Control.SRR15539874;32;32;0.53125;15;17;0.03125;0.46875
Control.SRR15539874;34;32;0.441176470588235;19;15;0.0588235294117647;0.441176470588235
Control.SRR15539874;35;32;0.314285714285714;24;11;0.185714285714286;0.314285714285714
Control.SRR15539874;34;32;0.5;17;17;0;0.5
Control.SRR15539874;33;32;0.575757575757576;14;19;0.0757575757575758;0.424242424242424
Control.SRR15539874;34;32;0.411764705882353;20;14;0.0882352941176471;0.411764705882353
Control.SRR15539874;33;32;0.575757575757576;14;19;0.0757575757575758;0.424242424242424
Control.SRR15539874;35;32;0.6;14;21;0.1;0.4
Control.SRR15539874;31;32;0.419354838709677;18;13;0.0806451612903226;0.419354838709677
Control.SRR15539874;32;32;0.625;12;20;0.125;0.375
Control.SRR15539874;30;32;0.533333333333333;14;16;0.0333333333333333;0.466666666666667
Control.SRR15539874;27;32;0.481481481481481;14;13;0.0185185185185185;0.481481481481481
Control.SRR15539874;28;32;0.464285714285714;15;13;0.0357142857142857;0.464285714285714
Control.SRR15539874;34;32;0.558823529411765;15;19;0.0588235294117647;0.441176470588235
Control.SRR15539874;32;32;0.46875;17;15;0.03125;0.46875
Control.SRR15539874;33;32;0.515151515151515;16;17;0.0151515151515151;0.484848484848485
Control.SRR15539874;28;32;0.535714285714286;13;15;0.0357142857142857;0.464285714285714
Control.SRR15539874;30;32;0.533333333333333;14;16;0.0333333333333333;0.466666666666667
Control.SRR15539874;31;32;0.483870967741935;16;15;0.0161290322580645;0.483870967741935
Control.SRR15539874;32;32;0.5;16;16;0;0.5
Control.SRR15539874;28;32;0.464285714285714;15;13;0.0357142857142857;0.464285714285714
Control.SRR15539874;27;32;0.62962962962963;10;17;0.12962962962963;0.37037037037037
Control.SRR15539874;35;32;0.371428571428571;22;13;0.128571428571429;0.371428571428571
Control.SRR15539874;31;32;0.516129032258065;15;16;0.0161290322580645;0.483870967741935
Control.SRR15539874;34;32;0.470588235294118;18;16;0.0294117647058824;0.470588235294118
Control.SRR15539874;35;32;0.514285714285714;17;18;0.0142857142857142;0.485714285714286
Control.SRR15539874;29;32;0.448275862068966;16;13;0.0517241379310345;0.448275862068966
Control.SRR15539874;35;32;0.514285714285714;17;18;0.0142857142857142;0.485714285714286
Control.SRR15539874;34;32;0.588235294117647;14;20;0.0882352941176471;0.411764705882353
Control.SRR15539874;32;32;0.40625;19;13;0.09375;0.40625
Control.SRR15539874;28;32;0.678571428571429;9;19;0.178571428571429;0.321428571428571
Control.SRR15539874;30;32;0.433333333333333;17;13;0.0666666666666667;0.433333333333333
Control.SRR15539874;32;32;0.40625;19;13;0.09375;0.40625
Control.SRR15539874;27;32;0.555555555555556;12;15;0.0555555555555556;0.444444444444444
Control.SRR15539874;30;32;0.5;15;15;0;0.5
Control.SRR15539874;27;32;0.407407407407407;16;11;0.0925925925925926;0.407407407407407
Control.SRR15539874;33;32;0.393939393939394;20;13;0.106060606060606;0.393939393939394
Control.SRR15539874;27;32;0.555555555555556;12;15;0.0555555555555556;0.444444444444444
Control.SRR15539874;30;32;0.366666666666667;19;11;0.133333333333333;0.366666666666667
Control.SRR15539874;35;32;0.542857142857143;16;19;0.0428571428571428;0.457142857142857
Control.SRR15539874;32;32;0.5625;14;18;0.0625;0.4375
Control.SRR15539874;31;32;0.354838709677419;20;11;0.145161290322581;0.354838709677419
Control.SRR15539874;32;32;0.59375;13;19;0.09375;0.40625
Control.SRR15539874;28;32;0.392857142857143;17;11;0.107142857142857;0.392857142857143
Control.SRR15539874;31;32;0.516129032258065;15;16;0.0161290322580645;0.483870967741935
Control.SRR15539874;35;32;0.314285714285714;24;11;0.185714285714286;0.314285714285714
Control.SRR15539874;32;32;0.375;20;12;0.125;0.375
Control.SRR15539874;27;32;0.259259259259259;20;7;0.240740740740741;0.259259259259259
Control.SRR15539874;30;32;0.466666666666667;16;14;0.0333333333333333;0.466666666666667
Control.SRR15539874;29;32;0.482758620689655;15;14;0.0172413793103448;0.482758620689655
Control.SRR15539874;27;32;0.481481481481481;14;13;0.0185185185185185;0.481481481481481
Control.SRR15539874;30;32;0.466666666666667;16;14;0.0333333333333333;0.466666666666667
Control.SRR15539874;34;32;0.558823529411765;15;19;0.0588235294117647;0.441176470588235
Control.SRR15539874;27;32;0.518518518518518;13;14;0.0185185185185185;0.481481481481481
Control.SRR15539874;31;32;0.645161290322581;11;20;0.145161290322581;0.354838709677419
Control.SRR15539874;33;32;0.515151515151515;16;17;0.0151515151515151;0.484848484848485
Control.SRR15539874;33;32;0.454545454545455;18;15;0.0454545454545455;0.454545454545455
Control.SRR15539874;35;32;0.514285714285714;17;18;0.0142857142857142;0.485714285714286
Control.SRR15539874;34;32;0.647058823529412;12;22;0.147058823529412;0.352941176470588
Control.SRR15539874;28;32;0.428571428571429;16;12;0.0714285714285715;0.428571428571429
Control.SRR15539874;33;32;0.545454545454545;15;18;0.0454545454545454;0.454545454545455
Control.SRR15539874;30;32;0.466666666666667;16;14;0.0333333333333333;0.466666666666667
Control.SRR15539874;33;32;0.575757575757576;14;19;0.0757575757575758;0.424242424242424
Control.SRR15539874;29;32;0.586206896551724;12;17;0.0862068965517241;0.413793103448276
Control.SRR15539874;29;32;0.517241379310345;14;15;0.0172413793103449;0.482758620689655
Control.SRR15539874;34;32;0.470588235294118;18;16;0.0294117647058824;0.470588235294118
Control.SRR15539874;34;32;0.647058823529412;12;22;0.147058823529412;0.352941176470588
Control.SRR15539874;31;32;0.580645161290323;13;18;0.0806451612903226;0.419354838709677
Control.SRR15539874;33;32;0.454545454545455;18;15;0.0454545454545455;0.454545454545455
Control.SRR15539874;29;32;0.413793103448276;17;12;0.0862068965517241;0.413793103448276
Control.SRR15539874;33;32;0.484848484848485;17;16;0.0151515151515151;0.484848484848485
Control.SRR15539874;35;32;0.542857142857143;16;19;0.0428571428571428;0.457142857142857
Control.SRR15539874;30;32;0.6;12;18;0.1;0.4
Control.SRR15539874;30;32;0.566666666666667;13;17;0.0666666666666667;0.433333333333333
Control.SRR15539874;34;32;0.5;17;17;0;0.5
Control.SRR15539874;34;32;0.470588235294118;18;16;0.0294117647058824;0.470588235294118
Control.SRR15539874;27;32;0.481481481481481;14;13;0.0185185185185185;0.481481481481481
Control.SRR15539874;31;32;0.67741935483871;10;21;0.17741935483871;0.32258064516129
Control.SRR15539874;28;32;0.428571428571429;16;12;0.0714285714285715;0.428571428571429
Control.SRR15539874;35;32;0.485714285714286;18;17;0.0142857142857143;0.485714285714286
Control.SRR15539874;28;32;0.5;14;14;0;0.5
Control.SRR15539874;31;32;0.419354838709677;18;13;0.0806451612903226;0.419354838709677
Control.SRR15539874;30;32;0.466666666666667;16;14;0.0333333333333333;0.466666666666667
Control.SRR15539874;35;32;0.371428571428571;22;13;0.128571428571429;0.371428571428571
Control.SRR15539874;34;32;0.441176470588235;19;15;0.0588235294117647;0.441176470588235
Control.SRR15539874;29;32;0.482758620689655;15;14;0.0172413793103448;0.482758620689655
Control.SRR15539874;33;32;0.484848484848485;17;16;0.0151515151515151;0.484848484848485
Control.SRR15539874;33;32;0.333333333333333;22;11;0.166666666666667;0.333333333333333
Control.SRR15539874;32;32;0.5;16;16;0;0.5
Control.SRR15539874;31;32;0.483870967741935;16;15;0.0161290322580645;0.483870967741935
Control.SRR15539874;34;32;0.441176470588235;19;15;0.0588235294117647;0.441176470588235
Control.SRR15539874;33;32;0.545454545454545;15;18;0.0454545454545454;0.454545454545455
Control.SRR15539874;33;32;0.424242424242424;19;14;0.0757575757575757;0.424242424242424
Control.SRR15539874;27;32;0.62962962962963;10;17;0.12962962962963;0.37037037037037
Control.SRR15539874;34;32;0.647058823529412;12;22;0.147058823529412;0.352941176470588
Control.SRR15539874;28;32;0.714285714285714;8;20;0.214285714285714;0.285714285714286
Control.SRR15539874;33;32;0.575757575757576;14;19;0.0757575757575758;0.424242424242424
Control.SRR15539874;30;32;0.466666666666667;16;14;0.0333333333333333;0.466666666666667
Control.SRR15539874;30;32;0.466666666666667;16;14;0.0333333333333333;0.466666666666667
Control.SRR15539874;34;32;0.5;17;17;0;0.5
Control.SRR15539874;35;32;0.571428571428571;15;20;0.0714285714285714;0.428571428571429
Control.SRR15539874;31;32;0.483870967741935;16;15;0.0161290322580645;0.483870967741935
Control.SRR15539874;33;32;0.424242424242424;19;14;0.0757575757575757;0.424242424242424
Control.SRR15539874;28;32;0.357142857142857;18;10;0.142857142857143;0.357142857142857
Control.SRR15539874;31;32;0.419354838709677;18;13;0.0806451612903226;0.419354838709677
Control.SRR15539874;30;32;0.666666666666667;10;20;0.166666666666667;0.333333333333333
Control.SRR15539874;27;32;0.62962962962963;10;17;0.12962962962963;0.37037037037037
Control.SRR15539874;28;32;0.535714285714286;13;15;0.0357142857142857;0.464285714285714
Control.SRR15539874;30;32;0.466666666666667;16;14;0.0333333333333333;0.466666666666667
Control.SRR15539874;27;32;0.481481481481481;14;13;0.0185185185185185;0.481481481481481
Control.SRR15539874;31;32;0.645161290322581;11;20;0.145161290322581;0.354838709677419
Control.SRR15539874;27;32;0.444444444444444;15;12;0.0555555555555556;0.444444444444444
Control.SRR15539874;32;32;0.46875;17;15;0.03125;0.46875
Control.SRR15539874;31;32;0.645161290322581;11;20;0.145161290322581;0.354838709677419
Control.SRR15539874;35;32;0.628571428571429;13;22;0.128571428571429;0.371428571428571
Control.SRR15539874;31;32;0.516129032258065;15;16;0.0161290322580645;0.483870967741935
Control.SRR15539874;34;32;0.529411764705882;16;18;0.0294117647058824;0.470588235294118
Control.SRR15539874;31;32;0.354838709677419;20;11;0.145161290322581;0.354838709677419
Control.SRR15539874;28;32;0.642857142857143;10;18;0.142857142857143;0.357142857142857
Control.SRR15539874;28;32;0.428571428571429;16;12;0.0714285714285715;0.428571428571429
Control.SRR15539874;33;32;0.333333333333333;22;11;0.166666666666667;0.333333333333333
Control.SRR15539874;32;32;0.59375;13;19;0.09375;0.40625
Control.SRR15539874;27;32;0.703703703703704;8;19;0.203703703703704;0.296296296296296
Control.SRR15539874;29;32;0.448275862068966;16;13;0.0517241379310345;0.448275862068966
Control.SRR15539874;34;32;0.5;17;17;0;0.5
Control.SRR15539874;29;32;0.586206896551724;12;17;0.0862068965517241;0.413793103448276
Control.SRR15539874;33;32;0.393939393939394;20;13;0.106060606060606;0.393939393939394
Control.SRR15539874;34;32;0.411764705882353;20;14;0.0882352941176471;0.411764705882353
Control.SRR15539874;35;32;0.657142857142857;12;23;0.157142857142857;0.342857142857143
Control.SRR15539874;32;32;0.59375;13;19;0.09375;0.40625
Control.SRR15539874;31;32;0.387096774193548;19;12;0.112903225806452;0.387096774193548
Control.SRR15539874;35;32;0.4;21;14;0.1;0.4
Control.SRR15539874;34;32;0.588235294117647;14;20;0.0882352941176471;0.411764705882353
Control.SRR15539874;28;32;0.535714285714286;13;15;0.0357142857142857;0.464285714285714
Control.SRR15539874;34;32;0.558823529411765;15;19;0.0588235294117647;0.441176470588235
Control.SRR15539874;33;32;0.484848484848485;17;16;0.0151515151515151;0.484848484848485
Control.SRR15539874;33;32;0.545454545454545;15;18;0.0454545454545454;0.454545454545455
Control.SRR15539874;27;32;0.518518518518518;13;14;0.0185185185185185;0.481481481481481
Control.SRR15539874;29;32;0.379310344827586;18;11;0.120689655172414;0.379310344827586
Control.SRR15539874;32;32;0.625;12;20;0.125;0.375
Control.SRR15539874;33;32;0.545454545454545;15;18;0.0454545454545454;0.454545454545455
Control.SRR15539874;31;32;0.645161290322581;11;20;0.145161290322581;0.354838709677419
Control.SRR15539874;31;32;0.645161290322581;11;20;0.145161290322581;0.354838709677419
Control.SRR15539874;32;32;0.5625;14;18;0.0625;0.4375
Control.SRR15539874;32;32;0.46875;17;15;0.03125;0.46875
Control.SRR15539874;34;32;0.5;17;17;0;0.5
Control.SRR15539874;34;32;0.441176470588235;19;15;0.0588235294117647;0.441176470588235
Control.SRR15539874;33;32;0.606060606060606;13;20;0.106060606060606;0.393939393939394
Control.SRR15539874;34;32;0.558823529411765;15;19;0.0588235294117647;0.441176470588235
Control.SRR15539874;34;32;0.5;17;17;0;0.5
Control.SRR15539874;30;32;0.5;15;15;0;0.5
Control.SRR15539874;34;32;0.382352941176471;21;13;0.117647058823529;0.382352941176471
Control.SRR15539874;34;32;0.411764705882353;20;14;0.0882352941176471;0.411764705882353
Control.SRR15539874;33;32;0.393939393939394;20;13;0.106060606060606;0.393939393939394
Control.SRR15539874;35;32;0.428571428571429;20;15;0.0714285714285715;0.428571428571429
Control.SRR15539874;29;32;0.758620689655172;7;22;0.258620689655172;0.241379310344828
Control.SRR15539874;27;32;0.62962962962963;10;17;0.12962962962963;0.37037037037037
Control.SRR15539874;32;32;0.46875;17;15;0.03125;0.46875
Control.SRR15539874;33;32;0.545454545454545;15;18;0.0454545454545454;0.454545454545455
Control.SRR15539874;35;32;0.4;21;14;0.1;0.4
Control.SRR15539874;35;32;0.485714285714286;18;17;0.0142857142857143;0.485714285714286
Control.SRR15539874;35;32;0.514285714285714;17;18;0.0142857142857142;0.485714285714286
Control.SRR15539874;34;32;0.411764705882353;20;14;0.0882352941176471;0.411764705882353
Control.SRR15539874;30;32;0.5;15;15;0;0.5
Control.SRR15539874;31;32;0.387096774193548;19;12;0.112903225806452;0.387096774193548
Control.SRR15539874;34;32;0.470588235294118;18;16;0.0294117647058824;0.470588235294118
Control.SRR15539874;28;32;0.642857142857143;10;18;0.142857142857143;0.357142857142857
Control.SRR15539874;28;32;0.464285714285714;15;13;0.0357142857142857;0.464285714285714
Control.SRR15539874;34;32;0.382352941176471;21;13;0.117647058823529;0.382352941176471
Control.SRR15539874;35;32;0.657142857142857;12;23;0.157142857142857;0.342857142857143
Control.SRR15539874;33;32;0.393939393939394;20;13;0.106060606060606;0.393939393939394
Control.SRR15539874;29;32;0.517241379310345;14;15;0.0172413793103449;0.482758620689655
Control.SRR15539874;32;32;0.5625;14;18;0.0625;0.4375
Control.SRR15539874;34;32;0.411764705882353;20;14;0.0882352941176471;0.411764705882353
Control.SRR15539874;29;32;0.482758620689655;15;14;0.0172413793103448;0.482758620689655
Control.SRR15539874;28;32;0.464285714285714;15;13;0.0357142857142857;0.464285714285714
Control.SRR15539874;29;32;0.482758620689655;15;14;0.0172413793103448;0.482758620689655
Control.SRR15539874;32;32;0.46875;17;15;0.03125;0.46875
Control.SRR15539874;30;32;0.466666666666667;16;14;0.0333333333333333;0.466666666666667
Control.SRR15539874;32;32;0.34375;21;11;0.15625;0.34375
Control.SRR15539874;29;32;0.482758620689655;15;14;0.0172413793103448;0.482758620689655
Control.SRR15539874;33;32;0.606060606060606;13;20;0.106060606060606;0.393939393939394
Control.SRR15539874;32;32;0.5625;14;18;0.0625;0.4375
Control.SRR15539874;35;32;0.542857142857143;16;19;0.0428571428571428;0.457142857142857
Control.SRR15539874;27;32;0.333333333333333;18;9;0.166666666666667;0.333333333333333
Control.SRR15539874;29;32;0.413793103448276;17;12;0.0862068965517241;0.413793103448276
Control.SRR15539874;33;32;0.606060606060606;13;20;0.106060606060606;0.393939393939394
Control.SRR15539874;28;32;0.571428571428571;12;16;0.0714285714285714;0.428571428571429
Control.SRR15539874;34;32;0.382352941176471;21;13;0.117647058823529;0.382352941176471
Control.SRR15539874;34;32;0.382352941176471;21;13;0.117647058823529;0.382352941176471
Control.SRR15539874;32;32;0.3125;22;10;0.1875;0.3125
Control.SRR15539874;28;32;0.464285714285714;15;13;0.0357142857142857;0.464285714285714
Control.SRR15539874;33;32;0.575757575757576;14;19;0.0757575757575758;0.424242424242424
Control.SRR15539874;27;32;0.296296296296296;19;8;0.203703703703704;0.296296296296296
Control.SRR15539874;28;32;0.571428571428571;12;16;0.0714285714285714;0.428571428571429
Control.SRR15539874;34;32;0.5;17;17;0;0.5
Control.SRR15539874;29;32;0.517241379310345;14;15;0.0172413793103449;0.482758620689655
Control.SRR15539874;35;32;0.571428571428571;15;20;0.0714285714285714;0.428571428571429
Control.SRR15539874;35;32;0.542857142857143;16;19;0.0428571428571428;0.457142857142857
Control.SRR15539874;35;32;0.571428571428571;15;20;0.0714285714285714;0.428571428571429
Control.SRR15539874;31;32;0.483870967741935;16;15;0.0161290322580645;0.483870967741935
Control.SRR15539874;35;32;0.428571428571429;20;15;0.0714285714285715;0.428571428571429
Control.SRR15539874;33;32;0.393939393939394;20;13;0.106060606060606;0.393939393939394
Control.SRR15539874;35;32;0.485714285714286;18;17;0.0142857142857143;0.485714285714286
Control.SRR15539874;34;32;0.529411764705882;16;18;0.0294117647058824;0.470588235294118
Control.SRR15539874;31;32;0.645161290322581;11;20;0.145161290322581;0.354838709677419
Control.SRR15539874;31;32;0.516129032258065;15;16;0.0161290322580645;0.483870967741935
Control.SRR15539874;32;32;0.53125;15;17;0.03125;0.46875
Control.SRR15539874;28;32;0.357142857142857;18;10;0.142857142857143;0.357142857142857
Control.SRR15539874;35;32;0.457142857142857;19;16;0.0428571428571429;0.457142857142857
Control.SRR15539874;32;32;0.5;16;16;0;0.5
Control.SRR15539874;29;32;0.413793103448276;17;12;0.0862068965517241;0.413793103448276
Control.SRR15539874;32;32;0.53125;15;17;0.03125;0.46875
Control.SRR15539874;28;32;0.607142857142857;11;17;0.107142857142857;0.392857142857143
Control.SRR15539874;29;32;0.517241379310345;14;15;0.0172413793103449;0.482758620689655
Control.SRR15539874;29;32;0.275862068965517;21;8;0.224137931034483;0.275862068965517
Control.SRR15539874;28;32;0.535714285714286;13;15;0.0357142857142857;0.464285714285714
Control.SRR15539874;27;32;0.333333333333333;18;9;0.166666666666667;0.333333333333333
Control.SRR15539874;28;32;0.5;14;14;0;0.5
Control.SRR15539874;34;32;0.588235294117647;14;20;0.0882352941176471;0.411764705882353
Control.SRR15539874;30;32;0.466666666666667;16;14;0.0333333333333333;0.466666666666667
Control.SRR15539874;32;32;0.375;20;12;0.125;0.375
Control.SRR15539874;27;32;0.481481481481481;14;13;0.0185185185185185;0.481481481481481
Control.SRR15539874;30;32;0.533333333333333;14;16;0.0333333333333333;0.466666666666667
Control.SRR15539874;33;32;0.454545454545455;18;15;0.0454545454545455;0.454545454545455
Control.SRR15539874;28;32;0.392857142857143;17;11;0.107142857142857;0.392857142857143
Control.SRR15539874;32;32;0.46875;17;15;0.03125;0.46875
Control.SRR15539874;35;32;0.371428571428571;22;13;0.128571428571429;0.371428571428571
Control.SRR15539874;30;32;0.5;15;15;0;0.5
Control.SRR15539874;29;32;0.620689655172414;11;18;0.120689655172414;0.379310344827586
Control.SRR15539874;28;32;0.428571428571429;16;12;0.0714285714285715;0.428571428571429
Control.SRR15539874;27;32;0.518518518518518;13;14;0.0185185185185185;0.481481481481481
Control.SRR15539874;29;32;0.517241379310345;14;15;0.0172413793103449;0.482758620689655
Control.SRR15539874;35;32;0.485714285714286;18;17;0.0142857142857143;0.485714285714286
Control.SRR15539874;33;32;0.606060606060606;13;20;0.106060606060606;0.393939393939394
Control.SRR15539874;33;32;0.545454545454545;15;18;0.0454545454545454;0.454545454545455
Control.SRR15539874;27;32;0.555555555555556;12;15;0.0555555555555556;0.444444444444444
Control.SRR15539874;28;32;0.428571428571429;16;12;0.0714285714285715;0.428571428571429
Control.SRR15539874;27;32;0.555555555555556;12;15;0.0555555555555556;0.444444444444444
Control.SRR15539874;27;32;0.407407407407407;16;11;0.0925925925925926;0.407407407407407
Control.SRR15539874;30;32;0.4;18;12;0.1;0.4
Control.SRR15539874;28;32;0.5;14;14;0;0.5
Control.SRR15539874;30;32;0.566666666666667;13;17;0.0666666666666667;0.433333333333333
Control.SRR15539874;30;32;0.533333333333333;14;16;0.0333333333333333;0.466666666666667
Control.SRR15539874;33;32;0.424242424242424;19;14;0.0757575757575757;0.424242424242424
Control.SRR15539874;34;32;0.529411764705882;16;18;0.0294117647058824;0.470588235294118
Control.SRR15539874;31;32;0.516129032258065;15;16;0.0161290322580645;0.483870967741935
Control.SRR15539874;35;32;0.485714285714286;18;17;0.0142857142857143;0.485714285714286
Control.SRR15539874;34;32;0.676470588235294;11;23;0.176470588235294;0.323529411764706
Control.SRR15539874;28;32;0.642857142857143;10;18;0.142857142857143;0.357142857142857
Control.SRR15539874;32;32;0.53125;15;17;0.03125;0.46875
Control.SRR15539874;30;32;0.333333333333333;20;10;0.166666666666667;0.333333333333333
Control.SRR15539874;33;32;0.545454545454545;15;18;0.0454545454545454;0.454545454545455
Control.SRR15539874;34;32;0.529411764705882;16;18;0.0294117647058824;0.470588235294118
Control.SRR15539874;31;32;0.451612903225806;17;14;0.0483870967741936;0.451612903225806
Control.SRR15539874;31;32;0.32258064516129;21;10;0.17741935483871;0.32258064516129
Control.SRR15539874;34;32;0.441176470588235;19;15;0.0588235294117647;0.441176470588235
Control.SRR15539874;33;32;0.545454545454545;15;18;0.0454545454545454;0.454545454545455
Control.SRR15539874;33;32;0.515151515151515;16;17;0.0151515151515151;0.484848484848485
Control.SRR15539874;34;32;0.411764705882353;20;14;0.0882352941176471;0.411764705882353
Control.SRR15539874;32;32;0.46875;17;15;0.03125;0.46875
Control.SRR15539874;32;32;0.46875;17;15;0.03125;0.46875
Control.SRR15539874;33;32;0.333333333333333;22;11;0.166666666666667;0.333333333333333
Control.SRR15539874;35;32;0.342857142857143;23;12;0.157142857142857;0.342857142857143
Control.SRR15539874;30;32;0.533333333333333;14;16;0.0333333333333333;0.466666666666667
Control.SRR15539874;32;32;0.5625;14;18;0.0625;0.4375
Control.SRR15539874;31;32;0.387096774193548;19;12;0.112903225806452;0.387096774193548
Control.SRR15539874;31;32;0.548387096774194;14;17;0.0483870967741935;0.451612903225806
Control.SRR15539874;31;32;0.483870967741935;16;15;0.0161290322580645;0.483870967741935
Control.SRR15539874;32;32;0.5;16;16;0;0.5
Control.SRR15539874;33;32;0.575757575757576;14;19;0.0757575757575758;0.424242424242424
Control.SRR15539874;33;32;0.575757575757576;14;19;0.0757575757575758;0.424242424242424
Control.SRR15539874;32;32;0.625;12;20;0.125;0.375
Control.SRR15539874;30;32;0.4;18;12;0.1;0.4
Control.SRR15539874;32;32;0.46875;17;15;0.03125;0.46875
Control.SRR15539874;30;32;0.433333333333333;17;13;0.0666666666666667;0.433333333333333
Control.SRR15539874;28;32;0.607142857142857;11;17;0.107142857142857;0.392857142857143
Control.SRR15539874;33;32;0.515151515151515;16;17;0.0151515151515151;0.484848484848485
Control.SRR15539874;35;32;0.485714285714286;18;17;0.0142857142857143;0.485714285714286
Control.SRR15539874;29;32;0.379310344827586;18;11;0.120689655172414;0.379310344827586
Control.SRR15539874;35;32;0.6;14;21;0.1;0.4
Control.SRR15539874;35;32;0.457142857142857;19;16;0.0428571428571429;0.457142857142857
Control.SRR15539874;35;32;0.485714285714286;18;17;0.0142857142857143;0.485714285714286
Control.SRR15539874;33;32;0.424242424242424;19;14;0.0757575757575757;0.424242424242424
Control.SRR15539874;31;32;0.548387096774194;14;17;0.0483870967741935;0.451612903225806
Control.SRR15539874;33;32;0.484848484848485;17;16;0.0151515151515151;0.484848484848485
Control.SRR15539874;34;32;0.5;17;17;0;0.5
Control.SRR15539874;35;32;0.6;14;21;0.1;0.4
Control.SRR15539874;28;32;0.678571428571429;9;19;0.178571428571429;0.321428571428571
Control.SRR15539874;31;32;0.548387096774194;14;17;0.0483870967741935;0.451612903225806
Control.SRR15539874;33;32;0.484848484848485;17;16;0.0151515151515151;0.484848484848485
Control.SRR15539874;29;32;0.448275862068966;16;13;0.0517241379310345;0.448275862068966
Control.SRR15539874;29;32;0.517241379310345;14;15;0.0172413793103449;0.482758620689655
Control.SRR15539874;29;32;0.655172413793103;10;19;0.155172413793103;0.344827586206897
Control.SRR15539874;35;32;0.514285714285714;17;18;0.0142857142857142;0.485714285714286
Control.SRR15539874;27;32;0.592592592592593;11;16;0.0925925925925926;0.407407407407407
Control.SRR15539874;30;32;0.6;12;18;0.1;0.4
Control.SRR15539874;28;32;0.392857142857143;17;11;0.107142857142857;0.392857142857143
Control.SRR15539874;34;32;0.5;17;17;0;0.5
Control.SRR15539874;33;32;0.515151515151515;16;17;0.0151515151515151;0.484848484848485
Control.SRR15539874;34;32;0.558823529411765;15;19;0.0588235294117647;0.441176470588235
Control.SRR15539874;31;32;0.419354838709677;18;13;0.0806451612903226;0.419354838709677
Control.SRR15539874;33;32;0.666666666666667;11;22;0.166666666666667;0.333333333333333
Control.SRR15539874;34;32;0.441176470588235;19;15;0.0588235294117647;0.441176470588235
Control.SRR15539874;34;32;0.470588235294118;18;16;0.0294117647058824;0.470588235294118
Control.SRR15539874;35;32;0.314285714285714;24;11;0.185714285714286;0.314285714285714
Control.SRR15539874;29;32;0.413793103448276;17;12;0.0862068965517241;0.413793103448276
Control.SRR15539874;31;32;0.516129032258065;15;16;0.0161290322580645;0.483870967741935
Control.SRR15539874;27;32;0.592592592592593;11;16;0.0925925925925926;0.407407407407407
Control.SRR15539874;35;32;0.485714285714286;18;17;0.0142857142857143;0.485714285714286
Control.SRR15539874;30;32;0.633333333333333;11;19;0.133333333333333;0.366666666666667
Control.SRR15539874;39;32;0.41025641025641;23;16;0.0897435897435898;0.41025641025641
Control.SRR15539874;35;32;0.371428571428571;22;13;0.128571428571429;0.371428571428571
Control.SRR15539874;39;32;0.512820512820513;19;20;0.0128205128205128;0.487179487179487
Control.SRR15539874;33;32;0.424242424242424;19;14;0.0757575757575757;0.424242424242424
Control.SRR15539874;32;32;0.53125;15;17;0.03125;0.46875
Control.SRR15539874;35;32;0.514285714285714;17;18;0.0142857142857142;0.485714285714286
Control.SRR15539874;36;32;0.416666666666667;21;15;0.0833333333333333;0.416666666666667
Control.SRR15539874;32;32;0.40625;19;13;0.09375;0.40625
Control.SRR15539874;33;32;0.424242424242424;19;14;0.0757575757575757;0.424242424242424
Control.SRR15539874;31;32;0.483870967741935;16;15;0.0161290322580645;0.483870967741935
Control.SRR15539874;40;32;0.425;23;17;0.075;0.425
Control.SRR15539874;39;32;0.487179487179487;20;19;0.0128205128205128;0.487179487179487
Control.SRR15539874;33;32;0.454545454545455;18;15;0.0454545454545455;0.454545454545455
Control.SRR15539874;36;32;0.555555555555556;16;20;0.0555555555555556;0.444444444444444
Control.SRR15539874;38;32;0.473684210526316;20;18;0.0263157894736842;0.473684210526316
Control.SRR15539874;32;32;0.46875;17;15;0.03125;0.46875
Control.SRR15539874;37;32;0.621621621621622;14;23;0.121621621621622;0.378378378378378
Control.SRR15539874;34;32;0.588235294117647;14;20;0.0882352941176471;0.411764705882353
Control.SRR15539874;37;32;0.594594594594595;15;22;0.0945945945945946;0.405405405405405
Control.SRR15539874;37;32;0.648648648648649;13;24;0.148648648648649;0.351351351351351
Control.SRR15539874;39;32;0.512820512820513;19;20;0.0128205128205128;0.487179487179487
Control.SRR15539874;32;32;0.53125;15;17;0.03125;0.46875
Control.SRR15539874;36;32;0.361111111111111;23;13;0.138888888888889;0.361111111111111
Control.SRR15539874;37;32;0.594594594594595;15;22;0.0945945945945946;0.405405405405405
Control.SRR15539874;32;32;0.65625;11;21;0.15625;0.34375
Control.SRR15539874;35;32;0.542857142857143;16;19;0.0428571428571428;0.457142857142857
Control.SRR15539874;34;32;0.5;17;17;0;0.5
Control.SRR15539874;30;32;0.466666666666667;16;14;0.0333333333333333;0.466666666666667
Control.SRR15539874;32;32;0.59375;13;19;0.09375;0.40625
Control.SRR15539874;32;32;0.5625;14;18;0.0625;0.4375
Control.SRR15539874;32;32;0.46875;17;15;0.03125;0.46875
Control.SRR15539874;35;32;0.571428571428571;15;20;0.0714285714285714;0.428571428571429
Control.SRR15539874;35;32;0.514285714285714;17;18;0.0142857142857142;0.485714285714286
Control.SRR15539874;35;32;0.371428571428571;22;13;0.128571428571429;0.371428571428571
Control.SRR15539874;38;32;0.447368421052632;21;17;0.0526315789473684;0.447368421052632
Control.SRR15539874;36;32;0.527777777777778;17;19;0.0277777777777778;0.472222222222222
Control.SRR15539874;31;32;0.451612903225806;17;14;0.0483870967741936;0.451612903225806
Control.SRR15539874;40;32;0.5;20;20;0;0.5
Control.SRR15539874;31;32;0.548387096774194;14;17;0.0483870967741935;0.451612903225806
Control.SRR15539874;33;32;0.393939393939394;20;13;0.106060606060606;0.393939393939394
Control.SRR15539874;34;32;0.411764705882353;20;14;0.0882352941176471;0.411764705882353
Control.SRR15539874;36;32;0.555555555555556;16;20;0.0555555555555556;0.444444444444444
Control.SRR15539874;30;32;0.433333333333333;17;13;0.0666666666666667;0.433333333333333
Control.SRR15539874;37;32;0.405405405405405;22;15;0.0945945945945946;0.405405405405405
Control.SRR15539874;32;32;0.46875;17;15;0.03125;0.46875
Control.SRR15539874;31;32;0.354838709677419;20;11;0.145161290322581;0.354838709677419
Control.SRR15539874;30;32;0.433333333333333;17;13;0.0666666666666667;0.433333333333333
Control.SRR15539874;30;32;0.633333333333333;11;19;0.133333333333333;0.366666666666667
Control.SRR15539874;32;32;0.53125;15;17;0.03125;0.46875
Control.SRR15539874;30;32;0.3;21;9;0.2;0.3
Control.SRR15539874;30;32;0.5;15;15;0;0.5
Control.SRR15539874;35;32;0.342857142857143;23;12;0.157142857142857;0.342857142857143
Control.SRR15539874;35;32;0.514285714285714;17;18;0.0142857142857142;0.485714285714286
Control.SRR15539874;35;32;0.628571428571429;13;22;0.128571428571429;0.371428571428571
Control.SRR15539874;38;32;0.526315789473684;18;20;0.0263157894736842;0.473684210526316
Control.SRR15539874;30;32;0.4;18;12;0.1;0.4
Control.SRR15539874;34;32;0.558823529411765;15;19;0.0588235294117647;0.441176470588235
Control.SRR15539874;32;32;0.375;20;12;0.125;0.375
Control.SRR15539874;31;32;0.419354838709677;18;13;0.0806451612903226;0.419354838709677
Control.SRR15539874;32;32;0.5;16;16;0;0.5
Control.SRR15539874;31;32;0.354838709677419;20;11;0.145161290322581;0.354838709677419
Control.SRR15539874;39;32;0.487179487179487;20;19;0.0128205128205128;0.487179487179487
Control.SRR15539874;36;32;0.638888888888889;13;23;0.138888888888889;0.361111111111111
Control.SRR15539874;33;32;0.393939393939394;20;13;0.106060606060606;0.393939393939394
Control.SRR15539874;36;32;0.416666666666667;21;15;0.0833333333333333;0.416666666666667
Control.SRR15539874;37;32;0.486486486486487;19;18;0.0135135135135135;0.486486486486487
Control.SRR15539874;34;32;0.470588235294118;18;16;0.0294117647058824;0.470588235294118
Control.SRR15539874;40;32;0.35;26;14;0.15;0.35
Control.SRR15539874;33;32;0.575757575757576;14;19;0.0757575757575758;0.424242424242424
Control.SRR15539874;32;32;0.53125;15;17;0.03125;0.46875
Control.SRR15539874;30;32;0.333333333333333;20;10;0.166666666666667;0.333333333333333
Control.SRR15539874;36;32;0.583333333333333;15;21;0.0833333333333334;0.416666666666667
Control.SRR15539874;33;32;0.545454545454545;15;18;0.0454545454545454;0.454545454545455
Control.SRR15539874;31;32;0.354838709677419;20;11;0.145161290322581;0.354838709677419
Control.SRR15539874;34;32;0.5;17;17;0;0.5
Control.SRR15539874;37;32;0.459459459459459;20;17;0.0405405405405405;0.459459459459459
Control.SRR15539874;36;32;0.361111111111111;23;13;0.138888888888889;0.361111111111111
Control.SRR15539874;32;32;0.4375;18;14;0.0625;0.4375
Control.SRR15539874;36;32;0.333333333333333;24;12;0.166666666666667;0.333333333333333
Control.SRR15539874;36;32;0.472222222222222;19;17;0.0277777777777778;0.472222222222222
Control.SRR15539874;37;32;0.486486486486487;19;18;0.0135135135135135;0.486486486486487
Control.SRR15539874;30;32;0.533333333333333;14;16;0.0333333333333333;0.466666666666667
Control.SRR15539874;32;32;0.53125;15;17;0.03125;0.46875
Control.SRR15539874;32;32;0.59375;13;19;0.09375;0.40625
Control.SRR15539874;31;32;0.612903225806452;12;19;0.112903225806452;0.387096774193548
Control.SRR15539874;30;32;0.566666666666667;13;17;0.0666666666666667;0.433333333333333
Control.SRR15539874;33;32;0.272727272727273;24;9;0.227272727272727;0.272727272727273
Control.SRR15539874;30;32;0.533333333333333;14;16;0.0333333333333333;0.466666666666667
Control.SRR15539874;38;32;0.605263157894737;15;23;0.105263157894737;0.394736842105263
Control.SRR15539874;38;32;0.526315789473684;18;20;0.0263157894736842;0.473684210526316
Control.SRR15539874;37;32;0.567567567567568;16;21;0.0675675675675675;0.432432432432432
Control.SRR15539874;34;32;0.558823529411765;15;19;0.0588235294117647;0.441176470588235
Control.SRR15539874;33;32;0.727272727272727;9;24;0.227272727272727;0.272727272727273
Control.SRR15539874;39;32;0.487179487179487;20;19;0.0128205128205128;0.487179487179487
Control.SRR15539874;40;32;0.45;22;18;0.05;0.45
Control.SRR15539874;35;32;0.371428571428571;22;13;0.128571428571429;0.371428571428571
Control.SRR15539874;35;32;0.485714285714286;18;17;0.0142857142857143;0.485714285714286
Control.SRR15539874;32;32;0.5;16;16;0;0.5
Control.SRR15539874;40;32;0.35;26;14;0.15;0.35
Control.SRR15539874;40;32;0.575;17;23;0.075;0.425
Control.SRR15539874;31;32;0.483870967741935;16;15;0.0161290322580645;0.483870967741935
Control.SRR15539874;32;32;0.625;12;20;0.125;0.375
Control.SRR15539874;36;32;0.472222222222222;19;17;0.0277777777777778;0.472222222222222
Control.SRR15539874;33;32;0.606060606060606;13;20;0.106060606060606;0.393939393939394
Control.SRR15539874;30;32;0.633333333333333;11;19;0.133333333333333;0.366666666666667
Control.SRR15539874;32;32;0.5;16;16;0;0.5
Control.SRR15539874;34;32;0.5;17;17;0;0.5
Control.SRR15539874;31;32;0.354838709677419;20;11;0.145161290322581;0.354838709677419
Control.SRR15539874;37;32;0.648648648648649;13;24;0.148648648648649;0.351351351351351
Control.SRR15539874;38;32;0.526315789473684;18;20;0.0263157894736842;0.473684210526316
Control.SRR15539874;36;32;0.444444444444444;20;16;0.0555555555555556;0.444444444444444
Control.SRR15539874;36;32;0.472222222222222;19;17;0.0277777777777778;0.472222222222222
Control.SRR15539874;33;32;0.545454545454545;15;18;0.0454545454545454;0.454545454545455
Control.SRR15539874;37;32;0.513513513513513;18;19;0.0135135135135135;0.486486486486487
Control.SRR15539874;33;32;0.484848484848485;17;16;0.0151515151515151;0.484848484848485
Control.SRR15539874;38;32;0.5;19;19;0;0.5
Control.SRR15539874;39;32;0.307692307692308;27;12;0.192307692307692;0.307692307692308
Control.SRR15539874;35;32;0.485714285714286;18;17;0.0142857142857143;0.485714285714286
Control.SRR15539874;33;32;0.515151515151515;16;17;0.0151515151515151;0.484848484848485
Control.SRR15539874;39;32;0.384615384615385;24;15;0.115384615384615;0.384615384615385
Control.SRR15539874;38;32;0.552631578947368;17;21;0.0526315789473685;0.447368421052632
Control.SRR15539874;40;32;0.45;22;18;0.05;0.45
Control.SRR15539874;30;32;0.566666666666667;13;17;0.0666666666666667;0.433333333333333
Control.SRR15539874;40;32;0.7;12;28;0.2;0.3
Control.SRR15539874;33;32;0.575757575757576;14;19;0.0757575757575758;0.424242424242424
Control.SRR15539874;30;32;0.6;12;18;0.1;0.4
Control.SRR15539874;33;32;0.484848484848485;17;16;0.0151515151515151;0.484848484848485
Control.SRR15539874;34;32;0.529411764705882;16;18;0.0294117647058824;0.470588235294118
Control.SRR15539874;38;32;0.473684210526316;20;18;0.0263157894736842;0.473684210526316
Control.SRR15539874;38;32;0.605263157894737;15;23;0.105263157894737;0.394736842105263
Control.SRR15539874;38;32;0.289473684210526;27;11;0.210526315789474;0.289473684210526
Control.SRR15539874;39;32;0.538461538461538;18;21;0.0384615384615384;0.461538461538462
Control.SRR15539874;34;32;0.588235294117647;14;20;0.0882352941176471;0.411764705882353
Control.SRR15539874;31;32;0.516129032258065;15;16;0.0161290322580645;0.483870967741935
Control.SRR15539874;31;32;0.419354838709677;18;13;0.0806451612903226;0.419354838709677
Control.SRR15539874;31;32;0.580645161290323;13;18;0.0806451612903226;0.419354838709677
Control.SRR15539874;35;32;0.457142857142857;19;16;0.0428571428571429;0.457142857142857
Control.SRR15539874;33;32;0.545454545454545;15;18;0.0454545454545454;0.454545454545455
Control.SRR15539874;38;32;0.710526315789474;11;27;0.210526315789474;0.289473684210526
Control.SRR15539874;36;32;0.527777777777778;17;19;0.0277777777777778;0.472222222222222
Control.SRR15539874;38;32;0.447368421052632;21;17;0.0526315789473684;0.447368421052632
Control.SRR15539874;30;32;0.466666666666667;16;14;0.0333333333333333;0.466666666666667
Control.SRR15539874;37;32;0.378378378378378;23;14;0.121621621621622;0.378378378378378
Control.SRR15539874;33;32;0.454545454545455;18;15;0.0454545454545455;0.454545454545455
Control.SRR15539874;40;32;0.475;21;19;0.025;0.475
Control.SRR15539874;39;32;0.615384615384615;15;24;0.115384615384615;0.384615384615385
Control.SRR15539874;34;32;0.470588235294118;18;16;0.0294117647058824;0.470588235294118
Control.SRR15539874;38;32;0.5;19;19;0;0.5
Control.SRR15539874;40;32;0.375;25;15;0.125;0.375
Control.SRR15539874;33;32;0.393939393939394;20;13;0.106060606060606;0.393939393939394
Control.SRR15539874;39;32;0.435897435897436;22;17;0.0641025641025641;0.435897435897436
Control.SRR15539874;37;32;0.432432432432432;21;16;0.0675675675675675;0.432432432432432
Control.SRR15539874;31;32;0.451612903225806;17;14;0.0483870967741936;0.451612903225806
Control.SRR15539874;34;32;0.5;17;17;0;0.5
Control.SRR15539874;33;32;0.393939393939394;20;13;0.106060606060606;0.393939393939394
Control.SRR15539874;36;32;0.583333333333333;15;21;0.0833333333333334;0.416666666666667
Control.SRR15539874;34;32;0.470588235294118;18;16;0.0294117647058824;0.470588235294118
Control.SRR15539874;35;32;0.514285714285714;17;18;0.0142857142857142;0.485714285714286
Control.SRR15539874;40;32;0.475;21;19;0.025;0.475
Control.SRR15539874;30;32;0.333333333333333;20;10;0.166666666666667;0.333333333333333
Control.SRR15539874;35;32;0.542857142857143;16;19;0.0428571428571428;0.457142857142857
Control.SRR15539874;37;32;0.459459459459459;20;17;0.0405405405405405;0.459459459459459
Control.SRR15539874;31;32;0.548387096774194;14;17;0.0483870967741935;0.451612903225806
Control.SRR15539874;31;32;0.516129032258065;15;16;0.0161290322580645;0.483870967741935
Control.SRR15539874;30;32;0.366666666666667;19;11;0.133333333333333;0.366666666666667
Control.SRR15539874;31;32;0.354838709677419;20;11;0.145161290322581;0.354838709677419
Control.SRR15539874;36;32;0.555555555555556;16;20;0.0555555555555556;0.444444444444444
Control.SRR15539874;31;32;0.516129032258065;15;16;0.0161290322580645;0.483870967741935
Control.SRR15539874;40;32;0.625;15;25;0.125;0.375
Control.SRR15539874;40;32;0.375;25;15;0.125;0.375
Control.SRR15539874;31;32;0.483870967741935;16;15;0.0161290322580645;0.483870967741935
Control.SRR15539874;31;32;0.451612903225806;17;14;0.0483870967741936;0.451612903225806
Control.SRR15539874;37;32;0.459459459459459;20;17;0.0405405405405405;0.459459459459459
Control.SRR15539874;38;32;0.447368421052632;21;17;0.0526315789473684;0.447368421052632
Control.SRR15539874;36;32;0.638888888888889;13;23;0.138888888888889;0.361111111111111
Control.SRR15539874;39;32;0.384615384615385;24;15;0.115384615384615;0.384615384615385
Control.SRR15539874;34;32;0.470588235294118;18;16;0.0294117647058824;0.470588235294118
Control.SRR15539874;40;32;0.475;21;19;0.025;0.475
Control.SRR15539874;32;32;0.40625;19;13;0.09375;0.40625
Control.SRR15539874;32;32;0.59375;13;19;0.09375;0.40625
Control.SRR15539874;38;32;0.394736842105263;23;15;0.105263157894737;0.394736842105263
Control.SRR15539874;38;32;0.605263157894737;15;23;0.105263157894737;0.394736842105263
Control.SRR15539874;39;32;0.435897435897436;22;17;0.0641025641025641;0.435897435897436
Control.SRR15539874;32;32;0.5;16;16;0;0.5
Control.SRR15539874;34;32;0.558823529411765;15;19;0.0588235294117647;0.441176470588235
Control.SRR15539874;32;32;0.59375;13;19;0.09375;0.40625
Control.SRR15539874;30;32;0.6;12;18;0.1;0.4
Control.SRR15539874;33;32;0.454545454545455;18;15;0.0454545454545455;0.454545454545455
Control.SRR15539874;36;32;0.666666666666667;12;24;0.166666666666667;0.333333333333333
Control.SRR15539874;36;32;0.583333333333333;15;21;0.0833333333333334;0.416666666666667
Control.SRR15539874;30;32;0.466666666666667;16;14;0.0333333333333333;0.466666666666667
Control.SRR15539874;40;32;0.575;17;23;0.075;0.425
Control.SRR15539874;38;32;0.368421052631579;24;14;0.131578947368421;0.368421052631579
Control.SRR15539874;35;32;0.4;21;14;0.1;0.4
Control.SRR15539874;31;32;0.483870967741935;16;15;0.0161290322580645;0.483870967741935
Control.SRR15539874;36;32;0.5;18;18;0;0.5
Control.SRR15539874;40;32;0.575;17;23;0.075;0.425
Control.SRR15539874;35;32;0.628571428571429;13;22;0.128571428571429;0.371428571428571
Control.SRR15539874;37;32;0.513513513513513;18;19;0.0135135135135135;0.486486486486487
Control.SRR15539874;32;32;0.59375;13;19;0.09375;0.40625
Control.SRR15539874;36;32;0.5;18;18;0;0.5
Control.SRR15539874;32;32;0.5;16;16;0;0.5
Control.SRR15539874;31;32;0.483870967741935;16;15;0.0161290322580645;0.483870967741935
Control.SRR15539874;31;32;0.516129032258065;15;16;0.0161290322580645;0.483870967741935
Control.SRR15539874;35;32;0.485714285714286;18;17;0.0142857142857143;0.485714285714286
Control.SRR15539874;32;32;0.53125;15;17;0.03125;0.46875
Control.SRR15539874;37;32;0.297297297297297;26;11;0.202702702702703;0.297297297297297
Control.SRR15539874;35;32;0.6;14;21;0.1;0.4
Control.SRR15539874;36;32;0.638888888888889;13;23;0.138888888888889;0.361111111111111
Control.SRR15539874;36;32;0.5;18;18;0;0.5
Control.SRR15539874;32;32;0.5625;14;18;0.0625;0.4375
Control.SRR15539874;32;32;0.625;12;20;0.125;0.375
Control.SRR15539874;32;32;0.5;16;16;0;0.5
Control.SRR15539874;37;32;0.513513513513513;18;19;0.0135135135135135;0.486486486486487
Control.SRR15539874;35;32;0.4;21;14;0.1;0.4
Control.SRR15539874;37;32;0.594594594594595;15;22;0.0945945945945946;0.405405405405405
Control.SRR15539874;34;32;0.352941176470588;22;12;0.147058823529412;0.352941176470588
Control.SRR15539874;33;32;0.545454545454545;15;18;0.0454545454545454;0.454545454545455
Control.SRR15539874;33;32;0.393939393939394;20;13;0.106060606060606;0.393939393939394
Control.SRR15539874;36;32;0.388888888888889;22;14;0.111111111111111;0.388888888888889
Control.SRR15539874;31;32;0.451612903225806;17;14;0.0483870967741936;0.451612903225806
Control.SRR15539874;35;32;0.514285714285714;17;18;0.0142857142857142;0.485714285714286
Control.SRR15539874;36;32;0.472222222222222;19;17;0.0277777777777778;0.472222222222222
Control.SRR15539874;31;32;0.419354838709677;18;13;0.0806451612903226;0.419354838709677
Control.SRR15539874;33;32;0.484848484848485;17;16;0.0151515151515151;0.484848484848485
Control.SRR15539874;30;32;0.633333333333333;11;19;0.133333333333333;0.366666666666667
Control.SRR15539874;31;32;0.548387096774194;14;17;0.0483870967741935;0.451612903225806
Control.SRR15539874;33;32;0.484848484848485;17;16;0.0151515151515151;0.484848484848485
Control.SRR15539874;33;32;0.575757575757576;14;19;0.0757575757575758;0.424242424242424
Control.SRR15539874;36;32;0.555555555555556;16;20;0.0555555555555556;0.444444444444444
Control.SRR15539874;40;32;0.35;26;14;0.15;0.35
Control.SRR15539874;35;32;0.514285714285714;17;18;0.0142857142857142;0.485714285714286
Control.SRR15539874;38;32;0.421052631578947;22;16;0.0789473684210527;0.421052631578947
Control.SRR15539874;32;32;0.46875;17;15;0.03125;0.46875
Control.SRR15539874;36;32;0.5;18;18;0;0.5
Control.SRR15539874;32;32;0.53125;15;17;0.03125;0.46875
Control.SRR15539874;34;32;0.411764705882353;20;14;0.0882352941176471;0.411764705882353
Control.SRR15539874;37;32;0.567567567567568;16;21;0.0675675675675675;0.432432432432432
Control.SRR15539874;33;32;0.424242424242424;19;14;0.0757575757575757;0.424242424242424
Control.SRR15539874;31;32;0.419354838709677;18;13;0.0806451612903226;0.419354838709677
Control.SRR15539874;39;32;0.564102564102564;17;22;0.0641025641025641;0.435897435897436
Control.SRR15539874;40;32;0.375;25;15;0.125;0.375
Control.SRR15539874;31;32;0.451612903225806;17;14;0.0483870967741936;0.451612903225806
Control.SRR15539874;32;32;0.3125;22;10;0.1875;0.3125
Control.SRR15539874;31;32;0.451612903225806;17;14;0.0483870967741936;0.451612903225806
Control.SRR15539874;39;32;0.512820512820513;19;20;0.0128205128205128;0.487179487179487
Control.SRR15539874;32;32;0.4375;18;14;0.0625;0.4375
Control.SRR15539874;35;32;0.457142857142857;19;16;0.0428571428571429;0.457142857142857
Control.SRR15539874;33;32;0.454545454545455;18;15;0.0454545454545455;0.454545454545455
Control.SRR15539874;33;32;0.333333333333333;22;11;0.166666666666667;0.333333333333333
Control.SRR15539874;40;32;0.525;19;21;0.025;0.475
Control.SRR15539874;30;32;0.433333333333333;17;13;0.0666666666666667;0.433333333333333
Control.SRR15539874;35;32;0.314285714285714;24;11;0.185714285714286;0.314285714285714
Control.SRR15539874;37;32;0.486486486486487;19;18;0.0135135135135135;0.486486486486487
Control.SRR15539874;37;32;0.513513513513513;18;19;0.0135135135135135;0.486486486486487
Control.SRR15539874;39;32;0.58974358974359;16;23;0.0897435897435898;0.41025641025641
Control.SRR15539874;38;32;0.526315789473684;18;20;0.0263157894736842;0.473684210526316
Control.SRR15539874;38;32;0.473684210526316;20;18;0.0263157894736842;0.473684210526316
Control.SRR15539874;39;32;0.435897435897436;22;17;0.0641025641025641;0.435897435897436
Control.SRR15539874;37;32;0.513513513513513;18;19;0.0135135135135135;0.486486486486487
Control.SRR15539874;40;32;0.475;21;19;0.025;0.475
Control.SRR15539874;40;32;0.4;24;16;0.1;0.4
Control.SRR15539874;38;32;0.578947368421053;16;22;0.0789473684210527;0.421052631578947
Control.SRR15539874;40;32;0.45;22;18;0.05;0.45
Control.SRR15539874;34;32;0.529411764705882;16;18;0.0294117647058824;0.470588235294118
Control.SRR15539874;37;32;0.459459459459459;20;17;0.0405405405405405;0.459459459459459
Control.SRR15539874;34;32;0.558823529411765;15;19;0.0588235294117647;0.441176470588235
Control.SRR15539874;34;32;0.647058823529412;12;22;0.147058823529412;0.352941176470588
Control.SRR15539874;34;32;0.470588235294118;18;16;0.0294117647058824;0.470588235294118
Control.SRR15539874;30;32;0.566666666666667;13;17;0.0666666666666667;0.433333333333333
Control.SRR15539874;37;32;0.378378378378378;23;14;0.121621621621622;0.378378378378378
Control.SRR15539874;33;32;0.606060606060606;13;20;0.106060606060606;0.393939393939394
Control.SRR15539874;33;32;0.484848484848485;17;16;0.0151515151515151;0.484848484848485
Control.SRR15539874;33;32;0.424242424242424;19;14;0.0757575757575757;0.424242424242424
Control.SRR15539874;37;32;0.486486486486487;19;18;0.0135135135135135;0.486486486486487
Control.SRR15539874;38;32;0.447368421052632;21;17;0.0526315789473684;0.447368421052632
Control.SRR15539874;32;32;0.59375;13;19;0.09375;0.40625
Control.SRR15539874;38;32;0.5;19;19;0;0.5
Control.SRR15539874;35;32;0.428571428571429;20;15;0.0714285714285715;0.428571428571429
Control.SRR15539874;31;32;0.419354838709677;18;13;0.0806451612903226;0.419354838709677
Control.SRR15539874;39;32;0.358974358974359;25;14;0.141025641025641;0.358974358974359
Control.SRR15539874;34;32;0.647058823529412;12;22;0.147058823529412;0.352941176470588
Control.SRR15539874;38;32;0.578947368421053;16;22;0.0789473684210527;0.421052631578947
Control.SRR15539874;38;32;0.447368421052632;21;17;0.0526315789473684;0.447368421052632
Control.SRR15539874;30;32;0.433333333333333;17;13;0.0666666666666667;0.433333333333333
Control.SRR15539874;35;32;0.542857142857143;16;19;0.0428571428571428;0.457142857142857
Control.SRR15539874;37;32;0.405405405405405;22;15;0.0945945945945946;0.405405405405405
Control.SRR15539874;36;32;0.416666666666667;21;15;0.0833333333333333;0.416666666666667
Control.SRR15539874;35;32;0.485714285714286;18;17;0.0142857142857143;0.485714285714286
Control.SRR15539874;37;32;0.405405405405405;22;15;0.0945945945945946;0.405405405405405
Control.SRR15539874;36;32;0.527777777777778;17;19;0.0277777777777778;0.472222222222222
Control.SRR15539874;30;32;0.5;15;15;0;0.5
Control.SRR15539874;34;32;0.411764705882353;20;14;0.0882352941176471;0.411764705882353
Control.SRR15539874;33;32;0.666666666666667;11;22;0.166666666666667;0.333333333333333
Control.SRR15539874;35;32;0.4;21;14;0.1;0.4
Control.SRR15539874;34;32;0.647058823529412;12;22;0.147058823529412;0.352941176470588
Control.SRR15539874;38;32;0.421052631578947;22;16;0.0789473684210527;0.421052631578947
Control.SRR15539874;32;32;0.5;16;16;0;0.5
Control.SRR15539874;36;32;0.472222222222222;19;17;0.0277777777777778;0.472222222222222
Control.SRR15539874;30;32;0.366666666666667;19;11;0.133333333333333;0.366666666666667
Control.SRR15539874;34;32;0.470588235294118;18;16;0.0294117647058824;0.470588235294118
Control.SRR15539874;30;32;0.533333333333333;14;16;0.0333333333333333;0.466666666666667
Control.SRR15539874;34;32;0.558823529411765;15;19;0.0588235294117647;0.441176470588235
Control.SRR15539874;35;32;0.514285714285714;17;18;0.0142857142857142;0.485714285714286
Control.SRR15539874;37;32;0.594594594594595;15;22;0.0945945945945946;0.405405405405405
Control.SRR15539874;35;32;0.514285714285714;17;18;0.0142857142857142;0.485714285714286
Control.SRR15539874;33;32;0.515151515151515;16;17;0.0151515151515151;0.484848484848485
Control.SRR15539874;36;32;0.388888888888889;22;14;0.111111111111111;0.388888888888889
Control.SRR15539874;36;32;0.416666666666667;21;15;0.0833333333333333;0.416666666666667
Control.SRR15539874;38;32;0.394736842105263;23;15;0.105263157894737;0.394736842105263
Control.SRR15539874;38;32;0.447368421052632;21;17;0.0526315789473684;0.447368421052632
Control.SRR15539874;32;32;0.5625;14;18;0.0625;0.4375
Control.SRR15539874;36;32;0.5;18;18;0;0.5
Control.SRR15539874;37;32;0.513513513513513;18;19;0.0135135135135135;0.486486486486487
Control.SRR15539874;39;32;0.538461538461538;18;21;0.0384615384615384;0.461538461538462
Control.SRR15539874;35;32;0.457142857142857;19;16;0.0428571428571429;0.457142857142857
Control.SRR15539874;31;32;0.516129032258065;15;16;0.0161290322580645;0.483870967741935
Control.SRR15539874;31;32;0.516129032258065;15;16;0.0161290322580645;0.483870967741935
Control.SRR15539874;31;32;0.516129032258065;15;16;0.0161290322580645;0.483870967741935
Control.SRR15539874;38;32;0.447368421052632;21;17;0.0526315789473684;0.447368421052632
Control.SRR15539874;34;32;0.352941176470588;22;12;0.147058823529412;0.352941176470588
Control.SRR15539874;31;32;0.548387096774194;14;17;0.0483870967741935;0.451612903225806
Control.SRR15539874;37;32;0.486486486486487;19;18;0.0135135135135135;0.486486486486487
Control.SRR15539874;32;32;0.40625;19;13;0.09375;0.40625
Control.SRR15539874;33;32;0.666666666666667;11;22;0.166666666666667;0.333333333333333
Control.SRR15539874;37;32;0.486486486486487;19;18;0.0135135135135135;0.486486486486487
Control.SRR15539874;40;32;0.6;16;24;0.1;0.4
Control.SRR15539874;35;32;0.628571428571429;13;22;0.128571428571429;0.371428571428571
Control.SRR15539874;37;32;0.540540540540541;17;20;0.0405405405405406;0.459459459459459
Control.SRR15539874;39;32;0.564102564102564;17;22;0.0641025641025641;0.435897435897436
Control.SRR15539874;34;32;0.470588235294118;18;16;0.0294117647058824;0.470588235294118
Control.SRR15539874;37;32;0.621621621621622;14;23;0.121621621621622;0.378378378378378
Control.SRR15539874;32;32;0.5;16;16;0;0.5
Control.SRR15539874;33;32;0.727272727272727;9;24;0.227272727272727;0.272727272727273
Control.SRR15539874;37;32;0.567567567567568;16;21;0.0675675675675675;0.432432432432432
Control.SRR15539874;31;32;0.451612903225806;17;14;0.0483870967741936;0.451612903225806
Control.SRR15539874;30;32;0.6;12;18;0.1;0.4
Control.SRR15539874;29;32;0.517241379310345;14;15;0.0172413793103449;0.482758620689655
Control.SRR15539874;36;32;0.416666666666667;21;15;0.0833333333333333;0.416666666666667
Control.SRR15539874;32;32;0.59375;13;19;0.09375;0.40625
Control.SRR15539874;35;32;0.371428571428571;22;13;0.128571428571429;0.371428571428571
Control.SRR15539874;37;32;0.540540540540541;17;20;0.0405405405405406;0.459459459459459
Control.SRR15539874;34;32;0.411764705882353;20;14;0.0882352941176471;0.411764705882353
Control.SRR15539874;36;32;0.527777777777778;17;19;0.0277777777777778;0.472222222222222
Control.SRR15539874;33;32;0.575757575757576;14;19;0.0757575757575758;0.424242424242424
Control.SRR15539874;31;32;0.419354838709677;18;13;0.0806451612903226;0.419354838709677
Control.SRR15539874;36;32;0.361111111111111;23;13;0.138888888888889;0.361111111111111
Control.SRR15539874;31;32;0.419354838709677;18;13;0.0806451612903226;0.419354838709677
Control.SRR15539874;33;32;0.545454545454545;15;18;0.0454545454545454;0.454545454545455
Control.SRR15539874;30;32;0.5;15;15;0;0.5
Control.SRR15539874;30;32;0.5;15;15;0;0.5
Control.SRR15539874;30;32;0.633333333333333;11;19;0.133333333333333;0.366666666666667
Control.SRR15539874;29;32;0.586206896551724;12;17;0.0862068965517241;0.413793103448276
Control.SRR15539874;31;32;0.580645161290323;13;18;0.0806451612903226;0.419354838709677
Control.SRR15539874;30;32;0.5;15;15;0;0.5
Control.SRR15539874;32;32;0.5;16;16;0;0.5
Control.SRR15539874;30;32;0.533333333333333;14;16;0.0333333333333333;0.466666666666667
Control.SRR15539874;32;32;0.46875;17;15;0.03125;0.46875
Control.SRR15539874;35;32;0.514285714285714;17;18;0.0142857142857142;0.485714285714286
Control.SRR15539874;37;32;0.405405405405405;22;15;0.0945945945945946;0.405405405405405
Control.SRR15539874;34;32;0.676470588235294;11;23;0.176470588235294;0.323529411764706
Control.SRR15539874;29;32;0.586206896551724;12;17;0.0862068965517241;0.413793103448276
Control.SRR15539874;35;32;0.457142857142857;19;16;0.0428571428571429;0.457142857142857
Control.SRR15539874;29;32;0.551724137931034;13;16;0.0517241379310345;0.448275862068966
Control.SRR15539874;32;32;0.4375;18;14;0.0625;0.4375
Control.SRR15539874;34;32;0.411764705882353;20;14;0.0882352941176471;0.411764705882353
Control.SRR15539874;30;32;0.466666666666667;16;14;0.0333333333333333;0.466666666666667
Control.SRR15539874;30;32;0.566666666666667;13;17;0.0666666666666667;0.433333333333333
Control.SRR15539874;33;32;0.545454545454545;15;18;0.0454545454545454;0.454545454545455
Control.SRR15539874;34;32;0.529411764705882;16;18;0.0294117647058824;0.470588235294118
Control.SRR15539874;32;32;0.71875;9;23;0.21875;0.28125
Control.SRR15539874;33;32;0.454545454545455;18;15;0.0454545454545455;0.454545454545455
Control.SRR15539874;32;32;0.5;16;16;0;0.5
Control.SRR15539874;39;32;0.512820512820513;19;20;0.0128205128205128;0.487179487179487
Control.SRR15539874;31;32;0.483870967741935;16;15;0.0161290322580645;0.483870967741935
Control.SRR15539874;32;32;0.59375;13;19;0.09375;0.40625
Control.SRR15539874;35;32;0.657142857142857;12;23;0.157142857142857;0.342857142857143
Control.SRR15539874;35;32;0.314285714285714;24;11;0.185714285714286;0.314285714285714
Control.SRR15539874;29;32;0.551724137931034;13;16;0.0517241379310345;0.448275862068966
Control.SRR15539874;32;32;0.53125;15;17;0.03125;0.46875
Control.SRR15539874;35;32;0.428571428571429;20;15;0.0714285714285715;0.428571428571429
Control.SRR15539874;38;32;0.526315789473684;18;20;0.0263157894736842;0.473684210526316
Control.SRR15539874;38;32;0.5;19;19;0;0.5
Control.SRR15539874;37;32;0.513513513513513;18;19;0.0135135135135135;0.486486486486487
Control.SRR15539874;36;32;0.416666666666667;21;15;0.0833333333333333;0.416666666666667
Control.SRR15539874;39;32;0.461538461538462;21;18;0.0384615384615384;0.461538461538462
Control.SRR15539874;38;32;0.5;19;19;0;0.5
Control.SRR15539874;29;32;0.448275862068966;16;13;0.0517241379310345;0.448275862068966
Control.SRR15539874;32;32;0.5;16;16;0;0.5
Control.SRR15539874;29;32;0.413793103448276;17;12;0.0862068965517241;0.413793103448276
Control.SRR15539874;30;32;0.433333333333333;17;13;0.0666666666666667;0.433333333333333
Control.SRR15539874;39;32;0.41025641025641;23;16;0.0897435897435898;0.41025641025641
Control.SRR15539874;33;32;0.424242424242424;19;14;0.0757575757575757;0.424242424242424
Control.SRR15539874;36;32;0.472222222222222;19;17;0.0277777777777778;0.472222222222222
Control.SRR15539874;29;32;0.517241379310345;14;15;0.0172413793103449;0.482758620689655
Control.SRR15539874;38;32;0.605263157894737;15;23;0.105263157894737;0.394736842105263
Control.SRR15539874;33;32;0.484848484848485;17;16;0.0151515151515151;0.484848484848485
Control.SRR15539874;31;32;0.419354838709677;18;13;0.0806451612903226;0.419354838709677
Control.SRR15539874;32;32;0.53125;15;17;0.03125;0.46875
Control.SRR15539874;29;32;0.448275862068966;16;13;0.0517241379310345;0.448275862068966
Control.SRR15539874;30;32;0.7;9;21;0.2;0.3
Control.SRR15539874;39;32;0.435897435897436;22;17;0.0641025641025641;0.435897435897436
Control.SRR15539874;29;32;0.482758620689655;15;14;0.0172413793103448;0.482758620689655
Control.SRR15539874;30;32;0.433333333333333;17;13;0.0666666666666667;0.433333333333333
Control.SRR15539874;31;32;0.612903225806452;12;19;0.112903225806452;0.387096774193548
Control.SRR15539874;34;32;0.647058823529412;12;22;0.147058823529412;0.352941176470588
Control.SRR15539874;32;32;0.40625;19;13;0.09375;0.40625
Control.SRR15539874;30;32;0.433333333333333;17;13;0.0666666666666667;0.433333333333333
Control.SRR15539874;35;32;0.571428571428571;15;20;0.0714285714285714;0.428571428571429
Control.SRR15539874;38;32;0.473684210526316;20;18;0.0263157894736842;0.473684210526316
Control.SRR15539874;32;32;0.59375;13;19;0.09375;0.40625
Control.SRR15539874;30;32;0.5;15;15;0;0.5
Control.SRR15539874;37;32;0.486486486486487;19;18;0.0135135135135135;0.486486486486487
Control.SRR15539874;35;32;0.371428571428571;22;13;0.128571428571429;0.371428571428571
Control.SRR15539874;31;32;0.516129032258065;15;16;0.0161290322580645;0.483870967741935
Control.SRR15539874;29;32;0.551724137931034;13;16;0.0517241379310345;0.448275862068966
Control.SRR15539874;37;32;0.594594594594595;15;22;0.0945945945945946;0.405405405405405
Control.SRR15539874;34;32;0.529411764705882;16;18;0.0294117647058824;0.470588235294118
Control.SRR15539874;30;32;0.533333333333333;14;16;0.0333333333333333;0.466666666666667
Control.SRR15539874;31;32;0.451612903225806;17;14;0.0483870967741936;0.451612903225806
Control.SRR15539874;37;32;0.540540540540541;17;20;0.0405405405405406;0.459459459459459
Control.SRR15539874;29;32;0.482758620689655;15;14;0.0172413793103448;0.482758620689655
Control.SRR15539874;38;32;0.578947368421053;16;22;0.0789473684210527;0.421052631578947
Control.SRR15539874;35;32;0.542857142857143;16;19;0.0428571428571428;0.457142857142857
Control.SRR15539874;29;32;0.448275862068966;16;13;0.0517241379310345;0.448275862068966
Control.SRR15539874;32;32;0.53125;15;17;0.03125;0.46875
Control.SRR15539874;31;32;0.387096774193548;19;12;0.112903225806452;0.387096774193548
Control.SRR15539874;35;32;0.514285714285714;17;18;0.0142857142857142;0.485714285714286
Control.SRR15539874;34;32;0.588235294117647;14;20;0.0882352941176471;0.411764705882353
Control.SRR15539874;30;32;0.633333333333333;11;19;0.133333333333333;0.366666666666667
Control.SRR15539874;29;32;0.551724137931034;13;16;0.0517241379310345;0.448275862068966
Control.SRR15539874;32;32;0.375;20;12;0.125;0.375
Control.SRR15539874;38;32;0.578947368421053;16;22;0.0789473684210527;0.421052631578947
Control.SRR15539874;33;32;0.606060606060606;13;20;0.106060606060606;0.393939393939394
Control.SRR15539874;35;32;0.514285714285714;17;18;0.0142857142857142;0.485714285714286
Control.SRR15539874;30;32;0.466666666666667;16;14;0.0333333333333333;0.466666666666667
Control.SRR15539874;37;32;0.567567567567568;16;21;0.0675675675675675;0.432432432432432
Control.SRR15539874;36;32;0.5;18;18;0;0.5
Control.SRR15539874;35;32;0.485714285714286;18;17;0.0142857142857143;0.485714285714286
Control.SRR15539874;31;32;0.645161290322581;11;20;0.145161290322581;0.354838709677419
Control.SRR15539874;30;32;0.466666666666667;16;14;0.0333333333333333;0.466666666666667
Control.SRR15539874;34;32;0.441176470588235;19;15;0.0588235294117647;0.441176470588235
Control.SRR15539874;36;32;0.527777777777778;17;19;0.0277777777777778;0.472222222222222
Control.SRR15539874;29;32;0.379310344827586;18;11;0.120689655172414;0.379310344827586
Control.SRR15539874;33;32;0.484848484848485;17;16;0.0151515151515151;0.484848484848485
Control.SRR15539874;38;32;0.421052631578947;22;16;0.0789473684210527;0.421052631578947
Control.SRR15539874;35;32;0.514285714285714;17;18;0.0142857142857142;0.485714285714286
Control.SRR15539874;34;32;0.5;17;17;0;0.5
Control.SRR15539874;39;32;0.564102564102564;17;22;0.0641025641025641;0.435897435897436
Control.SRR15539874;34;32;0.558823529411765;15;19;0.0588235294117647;0.441176470588235
Control.SRR15539874;38;32;0.473684210526316;20;18;0.0263157894736842;0.473684210526316
Control.SRR15539874;29;32;0.482758620689655;15;14;0.0172413793103448;0.482758620689655
Control.SRR15539874;36;32;0.416666666666667;21;15;0.0833333333333333;0.416666666666667
Control.SRR15539874;34;32;0.617647058823529;13;21;0.117647058823529;0.382352941176471
Control.SRR15539874;32;32;0.40625;19;13;0.09375;0.40625
Control.SRR15539874;33;32;0.515151515151515;16;17;0.0151515151515151;0.484848484848485
Control.SRR15539874;39;32;0.41025641025641;23;16;0.0897435897435898;0.41025641025641
Control.SRR15539874;33;32;0.424242424242424;19;14;0.0757575757575757;0.424242424242424
Control.SRR15539874;34;32;0.647058823529412;12;22;0.147058823529412;0.352941176470588
Control.SRR15539874;38;32;0.5;19;19;0;0.5
Control.SRR15539874;29;32;0.482758620689655;15;14;0.0172413793103448;0.482758620689655
Control.SRR15539874;36;32;0.5;18;18;0;0.5
Control.SRR15539874;30;32;0.466666666666667;16;14;0.0333333333333333;0.466666666666667
Control.SRR15539874;36;32;0.5;18;18;0;0.5
Control.SRR15539874;38;32;0.605263157894737;15;23;0.105263157894737;0.394736842105263
Control.SRR15539874;35;32;0.657142857142857;12;23;0.157142857142857;0.342857142857143
Control.SRR15539874;30;32;0.466666666666667;16;14;0.0333333333333333;0.466666666666667
Control.SRR15539874;34;32;0.470588235294118;18;16;0.0294117647058824;0.470588235294118
Control.SRR15539874;38;32;0.394736842105263;23;15;0.105263157894737;0.394736842105263
Control.SRR15539874;38;32;0.578947368421053;16;22;0.0789473684210527;0.421052631578947
Control.SRR15539874;34;32;0.529411764705882;16;18;0.0294117647058824;0.470588235294118
Control.SRR15539874;29;32;0.413793103448276;17;12;0.0862068965517241;0.413793103448276
Control.SRR15539874;37;32;0.486486486486487;19;18;0.0135135135135135;0.486486486486487
Control.SRR15539874;30;32;0.633333333333333;11;19;0.133333333333333;0.366666666666667
Control.SRR15539874;31;32;0.580645161290323;13;18;0.0806451612903226;0.419354838709677
Control.SRR15539874;39;32;0.58974358974359;16;23;0.0897435897435898;0.41025641025641
Control.SRR15539874;37;32;0.405405405405405;22;15;0.0945945945945946;0.405405405405405
Control.SRR15539874;30;32;0.433333333333333;17;13;0.0666666666666667;0.433333333333333
Control.SRR15539874;37;32;0.378378378378378;23;14;0.121621621621622;0.378378378378378
Control.SRR15539874;32;32;0.40625;19;13;0.09375;0.40625
Control.SRR15539874;35;32;0.485714285714286;18;17;0.0142857142857143;0.485714285714286
Control.SRR15539874;39;32;0.461538461538462;21;18;0.0384615384615384;0.461538461538462
Control.SRR15539874;30;32;0.7;9;21;0.2;0.3
Control.SRR15539874;30;32;0.433333333333333;17;13;0.0666666666666667;0.433333333333333
Control.SRR15539874;39;32;0.358974358974359;25;14;0.141025641025641;0.358974358974359
Control.SRR15539874;34;32;0.5;17;17;0;0.5
Control.SRR15539874;38;32;0.684210526315789;12;26;0.184210526315789;0.315789473684211
Control.SRR15539874;32;32;0.625;12;20;0.125;0.375
Control.SRR15539874;31;32;0.516129032258065;15;16;0.0161290322580645;0.483870967741935
Control.SRR15539874;36;32;0.555555555555556;16;20;0.0555555555555556;0.444444444444444
Control.SRR15539874;39;32;0.564102564102564;17;22;0.0641025641025641;0.435897435897436
Control.SRR15539874;30;32;0.6;12;18;0.1;0.4
Control.SRR15539874;37;32;0.621621621621622;14;23;0.121621621621622;0.378378378378378
Control.SRR15539874;33;32;0.545454545454545;15;18;0.0454545454545454;0.454545454545455
Control.SRR15539874;36;32;0.5;18;18;0;0.5
Control.SRR15539874;31;32;0.580645161290323;13;18;0.0806451612903226;0.419354838709677
Control.SRR15539874;30;32;0.4;18;12;0.1;0.4
Control.SRR15539874;36;32;0.444444444444444;20;16;0.0555555555555556;0.444444444444444
Control.SRR15539874;32;32;0.59375;13;19;0.09375;0.40625
Control.SRR15539874;33;32;0.484848484848485;17;16;0.0151515151515151;0.484848484848485
Control.SRR15539874;37;32;0.351351351351351;24;13;0.148648648648649;0.351351351351351
Control.SRR15539874;33;32;0.484848484848485;17;16;0.0151515151515151;0.484848484848485
Control.SRR15539874;32;32;0.46875;17;15;0.03125;0.46875
Control.SRR15539874;29;32;0.551724137931034;13;16;0.0517241379310345;0.448275862068966
Control.SRR15539874;29;32;0.413793103448276;17;12;0.0862068965517241;0.413793103448276
Control.SRR15539874;29;32;0.551724137931034;13;16;0.0517241379310345;0.448275862068966
Control.SRR15539874;30;32;0.433333333333333;17;13;0.0666666666666667;0.433333333333333
Control.SRR15539874;29;32;0.482758620689655;15;14;0.0172413793103448;0.482758620689655
Control.SRR15539874;34;32;0.558823529411765;15;19;0.0588235294117647;0.441176470588235
Control.SRR15539874;35;32;0.457142857142857;19;16;0.0428571428571429;0.457142857142857
Control.SRR15539874;36;32;0.5;18;18;0;0.5
Control.SRR15539874;38;32;0.5;19;19;0;0.5
Control.SRR15539874;39;32;0.512820512820513;19;20;0.0128205128205128;0.487179487179487
Control.SRR15539874;35;32;0.485714285714286;18;17;0.0142857142857143;0.485714285714286
Control.SRR15539874;32;32;0.46875;17;15;0.03125;0.46875
Control.SRR15539874;31;32;0.516129032258065;15;16;0.0161290322580645;0.483870967741935
Control.SRR15539874;30;32;0.433333333333333;17;13;0.0666666666666667;0.433333333333333
Control.SRR15539874;29;32;0.482758620689655;15;14;0.0172413793103448;0.482758620689655
Control.SRR15539874;32;32;0.5625;14;18;0.0625;0.4375
Control.SRR15539874;39;32;0.487179487179487;20;19;0.0128205128205128;0.487179487179487
Control.SRR15539874;30;32;0.566666666666667;13;17;0.0666666666666667;0.433333333333333
Control.SRR15539874;29;32;0.379310344827586;18;11;0.120689655172414;0.379310344827586
Control.SRR15539874;36;32;0.527777777777778;17;19;0.0277777777777778;0.472222222222222
Control.SRR15539874;35;32;0.542857142857143;16;19;0.0428571428571428;0.457142857142857
Control.SRR15539874;39;32;0.461538461538462;21;18;0.0384615384615384;0.461538461538462
Control.SRR15539874;35;32;0.542857142857143;16;19;0.0428571428571428;0.457142857142857
Control.SRR15539874;29;32;0.655172413793103;10;19;0.155172413793103;0.344827586206897
Control.SRR15539874;30;32;0.566666666666667;13;17;0.0666666666666667;0.433333333333333
Control.SRR15539874;37;32;0.594594594594595;15;22;0.0945945945945946;0.405405405405405
Control.SRR15539874;32;32;0.375;20;12;0.125;0.375
Control.SRR15539874;35;32;0.371428571428571;22;13;0.128571428571429;0.371428571428571
Control.SRR15539874;38;32;0.526315789473684;18;20;0.0263157894736842;0.473684210526316
Control.SRR15539874;39;32;0.641025641025641;14;25;0.141025641025641;0.358974358974359
Control.SRR15539874;35;32;0.571428571428571;15;20;0.0714285714285714;0.428571428571429
Control.SRR15539874;38;32;0.605263157894737;15;23;0.105263157894737;0.394736842105263
Control.SRR15539874;35;32;0.571428571428571;15;20;0.0714285714285714;0.428571428571429
Control.SRR15539874;38;32;0.421052631578947;22;16;0.0789473684210527;0.421052631578947
Control.SRR15539874;32;32;0.625;12;20;0.125;0.375
Control.SRR15539874;30;32;0.533333333333333;14;16;0.0333333333333333;0.466666666666667
Control.SRR15539874;31;32;0.516129032258065;15;16;0.0161290322580645;0.483870967741935
Control.SRR15539874;31;32;0.290322580645161;22;9;0.209677419354839;0.290322580645161
Control.SRR15539874;34;32;0.558823529411765;15;19;0.0588235294117647;0.441176470588235
Control.SRR15539874;39;32;0.538461538461538;18;21;0.0384615384615384;0.461538461538462
Control.SRR15539874;37;32;0.594594594594595;15;22;0.0945945945945946;0.405405405405405
Control.SRR15539874;35;32;0.542857142857143;16;19;0.0428571428571428;0.457142857142857
Control.SRR15539874;33;32;0.515151515151515;16;17;0.0151515151515151;0.484848484848485
Control.SRR15539874;38;32;0.552631578947368;17;21;0.0526315789473685;0.447368421052632
Control.SRR15539874;36;32;0.472222222222222;19;17;0.0277777777777778;0.472222222222222
Control.SRR15539874;32;32;0.5625;14;18;0.0625;0.4375
Control.SRR15539874;36;32;0.5;18;18;0;0.5
Control.SRR15539874;39;32;0.538461538461538;18;21;0.0384615384615384;0.461538461538462
Control.SRR15539874;33;32;0.333333333333333;22;11;0.166666666666667;0.333333333333333
Control.SRR15539874;36;32;0.527777777777778;17;19;0.0277777777777778;0.472222222222222
Control.SRR15539874;36;32;0.472222222222222;19;17;0.0277777777777778;0.472222222222222
Control.SRR15539874;30;32;0.466666666666667;16;14;0.0333333333333333;0.466666666666667
Control.SRR15539874;32;32;0.59375;13;19;0.09375;0.40625
Control.SRR15539874;33;32;0.393939393939394;20;13;0.106060606060606;0.393939393939394
Control.SRR15539874;32;32;0.40625;19;13;0.09375;0.40625
Control.SRR15539874;32;32;0.40625;19;13;0.09375;0.40625
Control.SRR15539874;34;32;0.617647058823529;13;21;0.117647058823529;0.382352941176471
Control.SRR15539874;29;32;0.517241379310345;14;15;0.0172413793103449;0.482758620689655
Control.SRR15539874;29;32;0.551724137931034;13;16;0.0517241379310345;0.448275862068966
Control.SRR15539874;35;32;0.657142857142857;12;23;0.157142857142857;0.342857142857143
Control.SRR15539874;32;32;0.625;12;20;0.125;0.375
Control.SRR15539874;29;32;0.586206896551724;12;17;0.0862068965517241;0.413793103448276
Control.SRR15539874;39;32;0.58974358974359;16;23;0.0897435897435898;0.41025641025641
Control.SRR15539874;35;32;0.457142857142857;19;16;0.0428571428571429;0.457142857142857
Control.SRR15539874;30;32;0.533333333333333;14;16;0.0333333333333333;0.466666666666667
Control.SRR15539874;36;32;0.472222222222222;19;17;0.0277777777777778;0.472222222222222
Control.SRR15539874;36;32;0.527777777777778;17;19;0.0277777777777778;0.472222222222222
Control.SRR15539874;38;32;0.526315789473684;18;20;0.0263157894736842;0.473684210526316
Control.SRR15539874;39;32;0.461538461538462;21;18;0.0384615384615384;0.461538461538462
Control.SRR15539874;34;32;0.382352941176471;21;13;0.117647058823529;0.382352941176471
Control.SRR15539874;31;32;0.612903225806452;12;19;0.112903225806452;0.387096774193548
Control.SRR15539874;30;32;0.366666666666667;19;11;0.133333333333333;0.366666666666667
Control.SRR15539874;33;32;0.545454545454545;15;18;0.0454545454545454;0.454545454545455
Control.SRR15539874;33;32;0.545454545454545;15;18;0.0454545454545454;0.454545454545455
Control.SRR15539874;34;32;0.382352941176471;21;13;0.117647058823529;0.382352941176471
Control.SRR15539874;37;32;0.540540540540541;17;20;0.0405405405405406;0.459459459459459
Control.SRR15539874;36;32;0.666666666666667;12;24;0.166666666666667;0.333333333333333
Control.SRR15539874;36;32;0.444444444444444;20;16;0.0555555555555556;0.444444444444444
Control.SRR15539874;36;32;0.416666666666667;21;15;0.0833333333333333;0.416666666666667
Control.SRR15539874;34;32;0.441176470588235;19;15;0.0588235294117647;0.441176470588235
Control.SRR15539874;34;32;0.470588235294118;18;16;0.0294117647058824;0.470588235294118
Control.SRR15539874;30;32;0.5;15;15;0;0.5
Control.SRR15539874;37;32;0.567567567567568;16;21;0.0675675675675675;0.432432432432432
Control.SRR15539874;38;32;0.605263157894737;15;23;0.105263157894737;0.394736842105263
Control.SRR15539874;29;32;0.724137931034483;8;21;0.224137931034483;0.275862068965517
Control.SRR15539874;29;32;0.482758620689655;15;14;0.0172413793103448;0.482758620689655
Control.SRR15539874;34;32;0.558823529411765;15;19;0.0588235294117647;0.441176470588235
Control.SRR15539874;38;32;0.447368421052632;21;17;0.0526315789473684;0.447368421052632
Control.SRR15539874;38;32;0.5;19;19;0;0.5
Control.SRR15539874;39;32;0.512820512820513;19;20;0.0128205128205128;0.487179487179487
Control.SRR15539874;34;32;0.441176470588235;19;15;0.0588235294117647;0.441176470588235
Control.SRR15539874;35;32;0.742857142857143;9;26;0.242857142857143;0.257142857142857
Control.SRR15539874;38;32;0.447368421052632;21;17;0.0526315789473684;0.447368421052632
Control.SRR15539874;30;32;0.433333333333333;17;13;0.0666666666666667;0.433333333333333
Control.SRR15539874;33;32;0.575757575757576;14;19;0.0757575757575758;0.424242424242424
Control.SRR15539874;35;32;0.457142857142857;19;16;0.0428571428571429;0.457142857142857
Control.SRR15539874;35;32;0.4;21;14;0.1;0.4
Control.SRR15539874;34;32;0.470588235294118;18;16;0.0294117647058824;0.470588235294118
Control.SRR15539874;35;32;0.6;14;21;0.1;0.4
Control.SRR15539874;38;32;0.421052631578947;22;16;0.0789473684210527;0.421052631578947
Control.SRR15539874;30;32;0.4;18;12;0.1;0.4
Control.SRR15539874;37;32;0.648648648648649;13;24;0.148648648648649;0.351351351351351
Control.SRR15539874;31;32;0.483870967741935;16;15;0.0161290322580645;0.483870967741935
Control.SRR15539874;39;32;0.461538461538462;21;18;0.0384615384615384;0.461538461538462
Control.SRR15539874;35;32;0.542857142857143;16;19;0.0428571428571428;0.457142857142857
Control.SRR15539874;36;32;0.611111111111111;14;22;0.111111111111111;0.388888888888889
Control.SRR15539874;38;32;0.631578947368421;14;24;0.131578947368421;0.368421052631579
Control.SRR15539874;31;32;0.516129032258065;15;16;0.0161290322580645;0.483870967741935
Control.SRR15539874;33;32;0.363636363636364;21;12;0.136363636363636;0.363636363636364
Control.SRR15539874;33;32;0.545454545454545;15;18;0.0454545454545454;0.454545454545455
Control.SRR15539874;39;32;0.358974358974359;25;14;0.141025641025641;0.358974358974359
Control.SRR15539874;39;32;0.461538461538462;21;18;0.0384615384615384;0.461538461538462
Control.SRR15539874;38;32;0.5;19;19;0;0.5
Control.SRR15539874;32;32;0.5;16;16;0;0.5
Control.SRR15539874;33;32;0.424242424242424;19;14;0.0757575757575757;0.424242424242424
Control.SRR15539874;29;32;0.620689655172414;11;18;0.120689655172414;0.379310344827586
Control.SRR15539874;31;32;0.548387096774194;14;17;0.0483870967741935;0.451612903225806
Control.SRR15539874;33;32;0.575757575757576;14;19;0.0757575757575758;0.424242424242424
Control.SRR15539874;30;32;0.433333333333333;17;13;0.0666666666666667;0.433333333333333
Control.SRR15539874;36;32;0.555555555555556;16;20;0.0555555555555556;0.444444444444444
Control.SRR15539874;38;32;0.368421052631579;24;14;0.131578947368421;0.368421052631579
Control.SRR15539874;30;32;0.6;12;18;0.1;0.4
Control.SRR15539874;31;32;0.387096774193548;19;12;0.112903225806452;0.387096774193548
Control.SRR15539874;32;32;0.4375;18;14;0.0625;0.4375
Control.SRR15539874;34;32;0.5;17;17;0;0.5
Control.SRR15539874;32;32;0.46875;17;15;0.03125;0.46875
Control.SRR15539874;36;32;0.611111111111111;14;22;0.111111111111111;0.388888888888889
Control.SRR15539874;35;32;0.342857142857143;23;12;0.157142857142857;0.342857142857143
Control.SRR15539874;38;32;0.552631578947368;17;21;0.0526315789473685;0.447368421052632
Control.SRR15539874;34;32;0.441176470588235;19;15;0.0588235294117647;0.441176470588235
Control.SRR15539874;33;32;0.424242424242424;19;14;0.0757575757575757;0.424242424242424
Control.SRR15539874;29;32;0.413793103448276;17;12;0.0862068965517241;0.413793103448276
Control.SRR15539874;29;32;0.413793103448276;17;12;0.0862068965517241;0.413793103448276
Control.SRR15539874;36;32;0.444444444444444;20;16;0.0555555555555556;0.444444444444444
Control.SRR15539874;36;32;0.583333333333333;15;21;0.0833333333333334;0.416666666666667
Control.SRR15539874;35;32;0.457142857142857;19;16;0.0428571428571429;0.457142857142857
Control.SRR15539874;32;32;0.40625;19;13;0.09375;0.40625
Control.SRR15539874;37;32;0.459459459459459;20;17;0.0405405405405405;0.459459459459459
Control.SRR15539874;37;32;0.648648648648649;13;24;0.148648648648649;0.351351351351351
Control.SRR15539874;35;32;0.457142857142857;19;16;0.0428571428571429;0.457142857142857
Control.SRR15539874;33;32;0.363636363636364;21;12;0.136363636363636;0.363636363636364
Control.SRR15539874;37;32;0.432432432432432;21;16;0.0675675675675675;0.432432432432432
Control.SRR15539874;34;32;0.5;17;17;0;0.5
Control.SRR15539874;32;32;0.40625;19;13;0.09375;0.40625
Control.SRR15539874;30;32;0.5;15;15;0;0.5
Control.SRR15539874;31;32;0.548387096774194;14;17;0.0483870967741935;0.451612903225806
Control.SRR15539874;31;32;0.516129032258065;15;16;0.0161290322580645;0.483870967741935
Control.SRR15539874;36;32;0.472222222222222;19;17;0.0277777777777778;0.472222222222222
Control.SRR15539874;36;32;0.5;18;18;0;0.5
Control.SRR15539874;38;32;0.5;19;19;0;0.5
Control.SRR15539874;38;32;0.394736842105263;23;15;0.105263157894737;0.394736842105263
Control.SRR15539874;38;32;0.5;19;19;0;0.5
Control.SRR15539874;36;32;0.638888888888889;13;23;0.138888888888889;0.361111111111111
Control.SRR15539874;32;32;0.46875;17;15;0.03125;0.46875
Control.SRR15539874;36;32;0.583333333333333;15;21;0.0833333333333334;0.416666666666667
Control.SRR15539874;31;32;0.419354838709677;18;13;0.0806451612903226;0.419354838709677
Control.SRR15539874;31;32;0.387096774193548;19;12;0.112903225806452;0.387096774193548
Control.SRR15539874;36;32;0.277777777777778;26;10;0.222222222222222;0.277777777777778
Control.SRR15539874;39;32;0.435897435897436;22;17;0.0641025641025641;0.435897435897436
Control.SRR15539874;31;32;0.516129032258065;15;16;0.0161290322580645;0.483870967741935
Control.SRR15539874;34;32;0.529411764705882;16;18;0.0294117647058824;0.470588235294118
Control.SRR15539874;38;32;0.447368421052632;21;17;0.0526315789473684;0.447368421052632
Control.SRR15539874;38;32;0.289473684210526;27;11;0.210526315789474;0.289473684210526
Control.SRR15539874;34;32;0.5;17;17;0;0.5
Control.SRR15539874;33;32;0.393939393939394;20;13;0.106060606060606;0.393939393939394
Control.SRR15539874;38;32;0.657894736842105;13;25;0.157894736842105;0.342105263157895
Control.SRR15539874;37;32;0.513513513513513;18;19;0.0135135135135135;0.486486486486487
Control.SRR15539874;29;32;0.655172413793103;10;19;0.155172413793103;0.344827586206897
Control.SRR15539874;38;32;0.526315789473684;18;20;0.0263157894736842;0.473684210526316
Control.SRR15539874;34;32;0.382352941176471;21;13;0.117647058823529;0.382352941176471
Control.SRR15539874;35;32;0.514285714285714;17;18;0.0142857142857142;0.485714285714286
Control.SRR15539874;32;32;0.6875;10;22;0.1875;0.3125
Control.SRR15539874;33;32;0.424242424242424;19;14;0.0757575757575757;0.424242424242424
Control.SRR15539874;29;32;0.413793103448276;17;12;0.0862068965517241;0.413793103448276
Control.SRR15539874;35;32;0.342857142857143;23;12;0.157142857142857;0.342857142857143
Control.SRR15539874;34;32;0.352941176470588;22;12;0.147058823529412;0.352941176470588
Control.SRR15539874;33;32;0.575757575757576;14;19;0.0757575757575758;0.424242424242424
Control.SRR15539874;34;32;0.470588235294118;18;16;0.0294117647058824;0.470588235294118
Control.SRR15539874;30;32;0.533333333333333;14;16;0.0333333333333333;0.466666666666667
Control.SRR15539874;36;32;0.361111111111111;23;13;0.138888888888889;0.361111111111111
Control.SRR15539874;35;32;0.542857142857143;16;19;0.0428571428571428;0.457142857142857
Control.SRR15539874;36;32;0.5;18;18;0;0.5
Control.SRR15539874;38;32;0.526315789473684;18;20;0.0263157894736842;0.473684210526316
Control.SRR15539874;38;32;0.447368421052632;21;17;0.0526315789473684;0.447368421052632
Control.SRR15539874;32;32;0.53125;15;17;0.03125;0.46875
Control.SRR15539874;30;32;0.533333333333333;14;16;0.0333333333333333;0.466666666666667
Control.SRR15539874;36;32;0.361111111111111;23;13;0.138888888888889;0.361111111111111
Control.SRR15539874;39;32;0.58974358974359;16;23;0.0897435897435898;0.41025641025641
Control.SRR15539874;38;32;0.552631578947368;17;21;0.0526315789473685;0.447368421052632
Control.SRR15539874;30;32;0.4;18;12;0.1;0.4
Control.SRR15539874;37;32;0.513513513513513;18;19;0.0135135135135135;0.486486486486487
Control.SRR15539874;37;32;0.594594594594595;15;22;0.0945945945945946;0.405405405405405
Control.SRR15539874;30;32;0.733333333333333;8;22;0.233333333333333;0.266666666666667
Control.SRR15539874;37;32;0.540540540540541;17;20;0.0405405405405406;0.459459459459459
Control.SRR15539874;31;32;0.612903225806452;12;19;0.112903225806452;0.387096774193548
Control.SRR15539874;31;32;0.548387096774194;14;17;0.0483870967741935;0.451612903225806
Control.SRR15539874;32;32;0.4375;18;14;0.0625;0.4375
Control.SRR15539874;31;32;0.516129032258065;15;16;0.0161290322580645;0.483870967741935
Control.SRR15539874;30;32;0.4;18;12;0.1;0.4
Control.SRR15539874;33;32;0.575757575757576;14;19;0.0757575757575758;0.424242424242424
Control.SRR15539874;32;32;0.4375;18;14;0.0625;0.4375
Control.SRR15539874;39;32;0.487179487179487;20;19;0.0128205128205128;0.487179487179487
Control.SRR15539874;38;32;0.605263157894737;15;23;0.105263157894737;0.394736842105263
Control.SRR15539874;37;32;0.567567567567568;16;21;0.0675675675675675;0.432432432432432
Control.SRR15539874;35;32;0.485714285714286;18;17;0.0142857142857143;0.485714285714286
Control.SRR15539874;37;32;0.594594594594595;15;22;0.0945945945945946;0.405405405405405
Control.SRR15539874;39;32;0.564102564102564;17;22;0.0641025641025641;0.435897435897436
Control.SRR15539874;34;32;0.411764705882353;20;14;0.0882352941176471;0.411764705882353
Control.SRR15539874;32;32;0.5625;14;18;0.0625;0.4375
Control.SRR15539874;38;32;0.578947368421053;16;22;0.0789473684210527;0.421052631578947
Control.SRR15539874;33;32;0.454545454545455;18;15;0.0454545454545455;0.454545454545455
Control.SRR15539874;32;32;0.4375;18;14;0.0625;0.4375
Control.SRR15539874;32;32;0.4375;18;14;0.0625;0.4375
Control.SRR15539874;31;32;0.612903225806452;12;19;0.112903225806452;0.387096774193548
Control.SRR15539874;32;32;0.65625;11;21;0.15625;0.34375
Control.SRR15539874;29;32;0.551724137931034;13;16;0.0517241379310345;0.448275862068966
Control.SRR15539874;38;32;0.526315789473684;18;20;0.0263157894736842;0.473684210526316
Control.SRR15539874;32;32;0.375;20;12;0.125;0.375
Control.SRR15539874;31;32;0.709677419354839;9;22;0.209677419354839;0.290322580645161
Control.SRR15539874;37;32;0.459459459459459;20;17;0.0405405405405405;0.459459459459459
Control.SRR15539874;30;32;0.466666666666667;16;14;0.0333333333333333;0.466666666666667
Control.SRR15539874;32;32;0.34375;21;11;0.15625;0.34375
Control.SRR15539874;33;32;0.636363636363636;12;21;0.136363636363636;0.363636363636364
Control.SRR15539874;31;32;0.516129032258065;15;16;0.0161290322580645;0.483870967741935
Control.SRR15539874;37;32;0.432432432432432;21;16;0.0675675675675675;0.432432432432432
Control.SRR15539874;39;32;0.564102564102564;17;22;0.0641025641025641;0.435897435897436
Control.SRR15539874;32;32;0.5;16;16;0;0.5
Control.SRR15539874;33;32;0.454545454545455;18;15;0.0454545454545455;0.454545454545455
Control.SRR15539874;35;32;0.6;14;21;0.1;0.4
Control.SRR15539874;38;32;0.552631578947368;17;21;0.0526315789473685;0.447368421052632
Control.SRR15539874;38;32;0.421052631578947;22;16;0.0789473684210527;0.421052631578947
Control.SRR15539874;39;32;0.41025641025641;23;16;0.0897435897435898;0.41025641025641
Control.SRR15539874;36;32;0.583333333333333;15;21;0.0833333333333334;0.416666666666667
Control.SRR15539874;36;32;0.388888888888889;22;14;0.111111111111111;0.388888888888889
Control.SRR15539874;36;32;0.472222222222222;19;17;0.0277777777777778;0.472222222222222
Control.SRR15539874;31;32;0.580645161290323;13;18;0.0806451612903226;0.419354838709677
Control.SRR15539874;37;32;0.594594594594595;15;22;0.0945945945945946;0.405405405405405
Control.SRR15539874;36;32;0.638888888888889;13;23;0.138888888888889;0.361111111111111
Control.SRR15539874;35;32;0.514285714285714;17;18;0.0142857142857142;0.485714285714286
Control.SRR15539874;37;32;0.486486486486487;19;18;0.0135135135135135;0.486486486486487
Control.SRR15539874;32;32;0.5;16;16;0;0.5
Control.SRR15539874;36;32;0.5;18;18;0;0.5
Control.SRR15539874;35;32;0.542857142857143;16;19;0.0428571428571428;0.457142857142857
Control.SRR15539874;34;32;0.529411764705882;16;18;0.0294117647058824;0.470588235294118
Control.SRR15539874;31;32;0.451612903225806;17;14;0.0483870967741936;0.451612903225806
Control.SRR15539874;38;32;0.526315789473684;18;20;0.0263157894736842;0.473684210526316
Control.SRR15539874;35;32;0.314285714285714;24;11;0.185714285714286;0.314285714285714
Control.SRR15539874;33;32;0.636363636363636;12;21;0.136363636363636;0.363636363636364
Control.SRR15539874;30;32;0.6;12;18;0.1;0.4
Control.SRR15539874;36;32;0.388888888888889;22;14;0.111111111111111;0.388888888888889
Control.SRR15539874;33;32;0.575757575757576;14;19;0.0757575757575758;0.424242424242424
Control.SRR15539874;38;32;0.631578947368421;14;24;0.131578947368421;0.368421052631579
Control.SRR15539874;36;32;0.527777777777778;17;19;0.0277777777777778;0.472222222222222
Control.SRR15539874;30;32;0.5;15;15;0;0.5
Control.SRR15539874;34;32;0.411764705882353;20;14;0.0882352941176471;0.411764705882353
Control.SRR15539874;35;32;0.4;21;14;0.1;0.4
Control.SRR15539874;36;32;0.555555555555556;16;20;0.0555555555555556;0.444444444444444
Control.SRR15539874;33;32;0.515151515151515;16;17;0.0151515151515151;0.484848484848485
Control.SRR15539874;31;32;0.483870967741935;16;15;0.0161290322580645;0.483870967741935
Control.SRR15539874;35;32;0.514285714285714;17;18;0.0142857142857142;0.485714285714286
Control.SRR15539874;33;32;0.575757575757576;14;19;0.0757575757575758;0.424242424242424
Control.SRR15539874;34;32;0.441176470588235;19;15;0.0588235294117647;0.441176470588235
Control.SRR15539874;36;32;0.583333333333333;15;21;0.0833333333333334;0.416666666666667
Control.SRR15539874;33;32;0.484848484848485;17;16;0.0151515151515151;0.484848484848485
Control.SRR15539874;30;32;0.533333333333333;14;16;0.0333333333333333;0.466666666666667
Control.SRR15539874;39;32;0.512820512820513;19;20;0.0128205128205128;0.487179487179487
Control.SRR15539874;36;32;0.361111111111111;23;13;0.138888888888889;0.361111111111111
Control.SRR15539874;36;32;0.5;18;18;0;0.5
Control.SRR15539874;37;32;0.567567567567568;16;21;0.0675675675675675;0.432432432432432
Control.SRR15539874;34;32;0.470588235294118;18;16;0.0294117647058824;0.470588235294118
Control.SRR15539874;29;32;0.379310344827586;18;11;0.120689655172414;0.379310344827586
Control.SRR15539874;30;32;0.433333333333333;17;13;0.0666666666666667;0.433333333333333
Control.SRR15539874;36;32;0.555555555555556;16;20;0.0555555555555556;0.444444444444444
Control.SRR15539874;38;32;0.394736842105263;23;15;0.105263157894737;0.394736842105263
Control.SRR15539874;31;32;0.354838709677419;20;11;0.145161290322581;0.354838709677419
Control.SRR15539874;38;32;0.578947368421053;16;22;0.0789473684210527;0.421052631578947
Control.SRR15539874;29;32;0.517241379310345;14;15;0.0172413793103449;0.482758620689655
Control.SRR15539874;36;32;0.5;18;18;0;0.5
Control.SRR15539874;37;32;0.405405405405405;22;15;0.0945945945945946;0.405405405405405
Control.SRR15539874;31;32;0.516129032258065;15;16;0.0161290322580645;0.483870967741935
Control.SRR15539874;30;32;0.7;9;21;0.2;0.3
Control.SRR15539874;30;32;0.633333333333333;11;19;0.133333333333333;0.366666666666667
Control.SRR15539874;29;32;0.620689655172414;11;18;0.120689655172414;0.379310344827586
Control.SRR15539874;29;32;0.620689655172414;11;18;0.120689655172414;0.379310344827586
Control.SRR15539874;32;32;0.4375;18;14;0.0625;0.4375
Control.SRR15539874;33;32;0.575757575757576;14;19;0.0757575757575758;0.424242424242424
Control.SRR15539874;39;32;0.461538461538462;21;18;0.0384615384615384;0.461538461538462
Control.SRR15539874;36;32;0.555555555555556;16;20;0.0555555555555556;0.444444444444444
Control.SRR15539874;34;32;0.647058823529412;12;22;0.147058823529412;0.352941176470588
Control.SRR15539874;35;32;0.628571428571429;13;22;0.128571428571429;0.371428571428571
Control.SRR15539874;31;32;0.419354838709677;18;13;0.0806451612903226;0.419354838709677
Control.SRR15539874;34;32;0.5;17;17;0;0.5
Control.SRR15539874;31;32;0.548387096774194;14;17;0.0483870967741935;0.451612903225806
Control.SRR15539874;29;32;0.586206896551724;12;17;0.0862068965517241;0.413793103448276
Control.SRR15539874;30;32;0.5;15;15;0;0.5
Control.SRR15539874;39;32;0.564102564102564;17;22;0.0641025641025641;0.435897435897436
Control.SRR15539874;34;32;0.382352941176471;21;13;0.117647058823529;0.382352941176471
Control.SRR15539874;36;32;0.527777777777778;17;19;0.0277777777777778;0.472222222222222
Control.SRR15539874;35;32;0.542857142857143;16;19;0.0428571428571428;0.457142857142857
Control.SRR15539874;32;32;0.46875;17;15;0.03125;0.46875
Control.SRR15539874;39;32;0.58974358974359;16;23;0.0897435897435898;0.41025641025641
Control.SRR15539874;33;32;0.636363636363636;12;21;0.136363636363636;0.363636363636364
Control.SRR15539874;31;32;0.483870967741935;16;15;0.0161290322580645;0.483870967741935
Control.SRR15539874;32;32;0.5625;14;18;0.0625;0.4375
Control.SRR15539874;33;32;0.363636363636364;21;12;0.136363636363636;0.363636363636364
Control.SRR15539874;36;32;0.555555555555556;16;20;0.0555555555555556;0.444444444444444
Control.SRR15539874;37;32;0.513513513513513;18;19;0.0135135135135135;0.486486486486487
Control.SRR15539874;36;32;0.5;18;18;0;0.5
Control.SRR15539874;38;32;0.526315789473684;18;20;0.0263157894736842;0.473684210526316
Control.SRR15539874;37;32;0.621621621621622;14;23;0.121621621621622;0.378378378378378
Control.SRR15539874;31;32;0.354838709677419;20;11;0.145161290322581;0.354838709677419
Control.SRR15539874;31;32;0.483870967741935;16;15;0.0161290322580645;0.483870967741935
Control.SRR15539874;29;32;0.413793103448276;17;12;0.0862068965517241;0.413793103448276
Control.SRR15539874;35;32;0.457142857142857;19;16;0.0428571428571429;0.457142857142857
Control.SRR15539874;30;32;0.433333333333333;17;13;0.0666666666666667;0.433333333333333
Control.SRR15539874;30;32;0.533333333333333;14;16;0.0333333333333333;0.466666666666667
Control.SRR15539874;32;32;0.71875;9;23;0.21875;0.28125
Control.SRR15539874;34;32;0.558823529411765;15;19;0.0588235294117647;0.441176470588235
Control.SRR15539874;32;32;0.46875;17;15;0.03125;0.46875
Control.SRR15539874;33;32;0.454545454545455;18;15;0.0454545454545455;0.454545454545455
Control.SRR15539874;30;32;0.533333333333333;14;16;0.0333333333333333;0.466666666666667
Control.SRR15539874;35;32;0.514285714285714;17;18;0.0142857142857142;0.485714285714286
Control.SRR15539874;36;32;0.472222222222222;19;17;0.0277777777777778;0.472222222222222
Control.SRR15539874;38;32;0.473684210526316;20;18;0.0263157894736842;0.473684210526316
Control.SRR15539874;39;32;0.564102564102564;17;22;0.0641025641025641;0.435897435897436
Control.SRR15539874;39;32;0.435897435897436;22;17;0.0641025641025641;0.435897435897436
Control.SRR15539874;31;32;0.548387096774194;14;17;0.0483870967741935;0.451612903225806
Control.SRR15539874;34;32;0.441176470588235;19;15;0.0588235294117647;0.441176470588235
Control.SRR15539874;35;32;0.4;21;14;0.1;0.4
Control.SRR15539874;29;32;0.379310344827586;18;11;0.120689655172414;0.379310344827586
Control.SRR15539874;32;32;0.59375;13;19;0.09375;0.40625
Control.SRR15539874;39;32;0.282051282051282;28;11;0.217948717948718;0.282051282051282
Control.SRR15539874;38;32;0.473684210526316;20;18;0.0263157894736842;0.473684210526316
Control.SRR15539874;35;32;0.514285714285714;17;18;0.0142857142857142;0.485714285714286
Control.SRR15539874;38;32;0.578947368421053;16;22;0.0789473684210527;0.421052631578947
Control.SRR15539874;35;32;0.6;14;21;0.1;0.4
Control.SRR15539874;32;32;0.375;20;12;0.125;0.375
Control.SRR15539874;32;32;0.40625;19;13;0.09375;0.40625
Control.SRR15539874;29;32;0.413793103448276;17;12;0.0862068965517241;0.413793103448276
Control.SRR15539874;35;32;0.6;14;21;0.1;0.4
Control.SRR15539874;29;32;0.517241379310345;14;15;0.0172413793103449;0.482758620689655
Control.SRR15539874;38;32;0.394736842105263;23;15;0.105263157894737;0.394736842105263
Control.SRR15539874;31;32;0.548387096774194;14;17;0.0483870967741935;0.451612903225806
Control.SRR15539874;32;32;0.4375;18;14;0.0625;0.4375
Control.SRR15539874;32;32;0.46875;17;15;0.03125;0.46875
Control.SRR15539874;31;32;0.516129032258065;15;16;0.0161290322580645;0.483870967741935
Control.SRR15539874;34;32;0.529411764705882;16;18;0.0294117647058824;0.470588235294118
Control.SRR15539874;30;32;0.333333333333333;20;10;0.166666666666667;0.333333333333333
Control.SRR15539874;33;32;0.363636363636364;21;12;0.136363636363636;0.363636363636364
Control.SRR15539874;39;32;0.41025641025641;23;16;0.0897435897435898;0.41025641025641
Control.SRR15539874;37;32;0.351351351351351;24;13;0.148648648648649;0.351351351351351
Control.SRR15539874;34;32;0.352941176470588;22;12;0.147058823529412;0.352941176470588
Control.SRR15539874;34;32;0.470588235294118;18;16;0.0294117647058824;0.470588235294118
Control.SRR15539874;36;32;0.527777777777778;17;19;0.0277777777777778;0.472222222222222
Control.SRR15539874;36;32;0.583333333333333;15;21;0.0833333333333334;0.416666666666667
Control.SRR15539874;34;32;0.441176470588235;19;15;0.0588235294117647;0.441176470588235
Control.SRR15539874;38;32;0.394736842105263;23;15;0.105263157894737;0.394736842105263
Control.SRR15539874;36;32;0.361111111111111;23;13;0.138888888888889;0.361111111111111
Control.SRR15539874;32;32;0.53125;15;17;0.03125;0.46875
Control.SRR15539874;35;32;0.428571428571429;20;15;0.0714285714285715;0.428571428571429
Control.SRR15539874;37;32;0.405405405405405;22;15;0.0945945945945946;0.405405405405405
Control.SRR15539874;30;32;0.6;12;18;0.1;0.4
Control.SRR15539874;31;32;0.419354838709677;18;13;0.0806451612903226;0.419354838709677
Control.SRR15539874;39;32;0.487179487179487;20;19;0.0128205128205128;0.487179487179487
Control.SRR15539874;38;32;0.394736842105263;23;15;0.105263157894737;0.394736842105263
Control.SRR15539874;38;32;0.526315789473684;18;20;0.0263157894736842;0.473684210526316
Control.SRR15539874;36;32;0.444444444444444;20;16;0.0555555555555556;0.444444444444444
Control.SRR15539874;37;32;0.351351351351351;24;13;0.148648648648649;0.351351351351351
Control.SRR15539874;34;32;0.588235294117647;14;20;0.0882352941176471;0.411764705882353
Control.SRR15539874;36;32;0.583333333333333;15;21;0.0833333333333334;0.416666666666667
Control.SRR15539874;29;32;0.448275862068966;16;13;0.0517241379310345;0.448275862068966
Control.SRR15539874;38;32;0.526315789473684;18;20;0.0263157894736842;0.473684210526316
Control.SRR15539874;31;32;0.419354838709677;18;13;0.0806451612903226;0.419354838709677
Control.SRR15539874;33;32;0.727272727272727;9;24;0.227272727272727;0.272727272727273
Control.SRR15539874;36;32;0.444444444444444;20;16;0.0555555555555556;0.444444444444444
Control.SRR15539874;38;32;0.473684210526316;20;18;0.0263157894736842;0.473684210526316
Control.SRR15539874;29;32;0.379310344827586;18;11;0.120689655172414;0.379310344827586
Control.SRR15539874;33;32;0.454545454545455;18;15;0.0454545454545455;0.454545454545455
Control.SRR15539874;38;32;0.421052631578947;22;16;0.0789473684210527;0.421052631578947
Control.SRR15539874;35;32;0.628571428571429;13;22;0.128571428571429;0.371428571428571
Control.SRR15539874;37;32;0.621621621621622;14;23;0.121621621621622;0.378378378378378
Control.SRR15539874;36;32;0.555555555555556;16;20;0.0555555555555556;0.444444444444444
Control.SRR15539874;34;32;0.5;17;17;0;0.5
Control.SRR15539874;36;32;0.333333333333333;24;12;0.166666666666667;0.333333333333333
Control.SRR15539874;30;32;0.433333333333333;17;13;0.0666666666666667;0.433333333333333
Control.SRR15539874;33;32;0.393939393939394;20;13;0.106060606060606;0.393939393939394
Control.SRR15539874;33;32;0.575757575757576;14;19;0.0757575757575758;0.424242424242424
Control.SRR15539874;39;32;0.461538461538462;21;18;0.0384615384615384;0.461538461538462
Control.SRR15539874;38;32;0.394736842105263;23;15;0.105263157894737;0.394736842105263
Control.SRR15539874;34;32;0.529411764705882;16;18;0.0294117647058824;0.470588235294118
Control.SRR15539874;37;32;0.540540540540541;17;20;0.0405405405405406;0.459459459459459
Control.SRR15539874;36;32;0.5;18;18;0;0.5
Control.SRR15539874;32;32;0.4375;18;14;0.0625;0.4375
Control.SRR15539874;33;32;0.424242424242424;19;14;0.0757575757575757;0.424242424242424
Control.SRR15539874;32;32;0.53125;15;17;0.03125;0.46875
Control.SRR15539874;37;32;0.405405405405405;22;15;0.0945945945945946;0.405405405405405
Control.SRR15539874;31;32;0.451612903225806;17;14;0.0483870967741936;0.451612903225806
Control.SRR15539874;30;32;0.633333333333333;11;19;0.133333333333333;0.366666666666667
Control.SRR15539874;32;32;0.5;16;16;0;0.5
Control.SRR15539874;32;32;0.625;12;20;0.125;0.375
Control.SRR15539874;30;32;0.5;15;15;0;0.5
Control.SRR15539874;31;32;0.580645161290323;13;18;0.0806451612903226;0.419354838709677
Control.SRR15539874;32;32;0.4375;18;14;0.0625;0.4375
Control.SRR15539874;33;32;0.545454545454545;15;18;0.0454545454545454;0.454545454545455
Control.SRR15539874;31;32;0.612903225806452;12;19;0.112903225806452;0.387096774193548
Control.SRR15539874;34;32;0.5;17;17;0;0.5
Control.SRR15539874;30;32;0.633333333333333;11;19;0.133333333333333;0.366666666666667
Control.SRR15539874;33;32;0.545454545454545;15;18;0.0454545454545454;0.454545454545455
Control.SRR15539874;29;32;0.482758620689655;15;14;0.0172413793103448;0.482758620689655
Control.SRR15539874;29;32;0.448275862068966;16;13;0.0517241379310345;0.448275862068966
Control.SRR15539874;33;32;0.454545454545455;18;15;0.0454545454545455;0.454545454545455
Control.SRR15539874;31;32;0.451612903225806;17;14;0.0483870967741936;0.451612903225806
Control.SRR15539874;33;32;0.333333333333333;22;11;0.166666666666667;0.333333333333333
Control.SRR15539874;36;32;0.444444444444444;20;16;0.0555555555555556;0.444444444444444
Control.SRR15539874;30;32;0.566666666666667;13;17;0.0666666666666667;0.433333333333333
Control.SRR15539874;32;32;0.65625;11;21;0.15625;0.34375
Control.SRR15539874;32;32;0.5;16;16;0;0.5
Control.SRR15539874;31;32;0.483870967741935;16;15;0.0161290322580645;0.483870967741935
Control.SRR15539874;36;32;0.416666666666667;21;15;0.0833333333333333;0.416666666666667
Control.SRR15539874;32;32;0.5;16;16;0;0.5
Control.SRR15539874;34;32;0.529411764705882;16;18;0.0294117647058824;0.470588235294118
Control.SRR15539874;35;32;0.457142857142857;19;16;0.0428571428571429;0.457142857142857
Control.SRR15539874;30;32;0.5;15;15;0;0.5
Control.SRR15539874;34;32;0.529411764705882;16;18;0.0294117647058824;0.470588235294118
Control.SRR15539874;33;32;0.606060606060606;13;20;0.106060606060606;0.393939393939394
Control.SRR15539874;37;32;0.513513513513513;18;19;0.0135135135135135;0.486486486486487
Control.SRR15539874;36;32;0.555555555555556;16;20;0.0555555555555556;0.444444444444444
Control.SRR15539874;34;32;0.411764705882353;20;14;0.0882352941176471;0.411764705882353
Control.SRR15539874;32;32;0.53125;15;17;0.03125;0.46875
Control.SRR15539874;29;32;0.413793103448276;17;12;0.0862068965517241;0.413793103448276
Control.SRR15539874;35;32;0.628571428571429;13;22;0.128571428571429;0.371428571428571
Control.SRR15539874;37;32;0.567567567567568;16;21;0.0675675675675675;0.432432432432432
Control.SRR15539874;29;32;0.620689655172414;11;18;0.120689655172414;0.379310344827586
Control.SRR15539874;33;32;0.363636363636364;21;12;0.136363636363636;0.363636363636364
Control.SRR15539874;29;32;0.448275862068966;16;13;0.0517241379310345;0.448275862068966
Control.SRR15539874;32;32;0.5;16;16;0;0.5
Control.SRR15539874;30;32;0.633333333333333;11;19;0.133333333333333;0.366666666666667
Control.SRR15539874;33;32;0.424242424242424;19;14;0.0757575757575757;0.424242424242424
Control.SRR15539874;31;32;0.516129032258065;15;16;0.0161290322580645;0.483870967741935
Control.SRR15539874;33;32;0.515151515151515;16;17;0.0151515151515151;0.484848484848485
Control.SRR15539874;30;32;0.5;15;15;0;0.5
Control.SRR15539874;30;32;0.466666666666667;16;14;0.0333333333333333;0.466666666666667
Control.SRR15539874;29;32;0.517241379310345;14;15;0.0172413793103449;0.482758620689655
Control.SRR15539874;37;32;0.459459459459459;20;17;0.0405405405405405;0.459459459459459
Control.SRR15539874;34;32;0.411764705882353;20;14;0.0882352941176471;0.411764705882353
Control.SRR15539874;35;32;0.514285714285714;17;18;0.0142857142857142;0.485714285714286
Control.SRR15539874;34;32;0.529411764705882;16;18;0.0294117647058824;0.470588235294118
Control.SRR15539874;31;32;0.483870967741935;16;15;0.0161290322580645;0.483870967741935
Control.SRR15539874;32;32;0.46875;17;15;0.03125;0.46875
Control.SRR15539874;35;32;0.457142857142857;19;16;0.0428571428571429;0.457142857142857
Control.SRR15539874;32;32;0.53125;15;17;0.03125;0.46875
Control.SRR15539874;29;32;0.517241379310345;14;15;0.0172413793103449;0.482758620689655
Control.SRR15539874;36;32;0.555555555555556;16;20;0.0555555555555556;0.444444444444444
Control.SRR15539874;34;32;0.411764705882353;20;14;0.0882352941176471;0.411764705882353
Control.SRR15539874;33;32;0.515151515151515;16;17;0.0151515151515151;0.484848484848485
Control.SRR15539874;30;32;0.466666666666667;16;14;0.0333333333333333;0.466666666666667
Control.SRR15539874;34;32;0.411764705882353;20;14;0.0882352941176471;0.411764705882353
Control.SRR15539874;29;32;0.448275862068966;16;13;0.0517241379310345;0.448275862068966
Control.SRR15539874;37;32;0.567567567567568;16;21;0.0675675675675675;0.432432432432432
Control.SRR15539874;31;32;0.516129032258065;15;16;0.0161290322580645;0.483870967741935
Control.SRR15539874;34;32;0.470588235294118;18;16;0.0294117647058824;0.470588235294118
Control.SRR15539874;32;32;0.625;12;20;0.125;0.375
Control.SRR15539874;32;32;0.625;12;20;0.125;0.375
Control.SRR15539874;32;32;0.625;12;20;0.125;0.375
Control.SRR15539874;30;32;0.466666666666667;16;14;0.0333333333333333;0.466666666666667
Control.SRR15539874;30;32;0.666666666666667;10;20;0.166666666666667;0.333333333333333
Control.SRR15539874;36;32;0.583333333333333;15;21;0.0833333333333334;0.416666666666667
Control.SRR15539874;31;32;0.516129032258065;15;16;0.0161290322580645;0.483870967741935
Control.SRR15539874;29;32;0.620689655172414;11;18;0.120689655172414;0.379310344827586
Control.SRR15539874;31;32;0.548387096774194;14;17;0.0483870967741935;0.451612903225806
Control.SRR15539874;34;32;0.441176470588235;19;15;0.0588235294117647;0.441176470588235
Control.SRR15539874;33;32;0.424242424242424;19;14;0.0757575757575757;0.424242424242424
Control.SRR15539874;37;32;0.432432432432432;21;16;0.0675675675675675;0.432432432432432
Control.SRR15539874;32;32;0.34375;21;11;0.15625;0.34375
Control.SRR15539874;29;32;0.551724137931034;13;16;0.0517241379310345;0.448275862068966
Control.SRR15539874;34;32;0.441176470588235;19;15;0.0588235294117647;0.441176470588235
Control.SRR15539874;32;32;0.53125;15;17;0.03125;0.46875
Control.SRR15539874;33;32;0.606060606060606;13;20;0.106060606060606;0.393939393939394
Control.SRR15539874;35;32;0.314285714285714;24;11;0.185714285714286;0.314285714285714
Control.SRR15539874;36;32;0.555555555555556;16;20;0.0555555555555556;0.444444444444444
Control.SRR15539874;32;32;0.4375;18;14;0.0625;0.4375
Control.SRR15539874;32;32;0.5625;14;18;0.0625;0.4375
Control.SRR15539874;35;32;0.457142857142857;19;16;0.0428571428571429;0.457142857142857
Control.SRR15539874;32;32;0.46875;17;15;0.03125;0.46875
Control.SRR15539874;29;32;0.758620689655172;7;22;0.258620689655172;0.241379310344828
Control.SRR15539874;32;32;0.5625;14;18;0.0625;0.4375
Control.SRR15539874;35;32;0.371428571428571;22;13;0.128571428571429;0.371428571428571
Control.SRR15539874;34;32;0.529411764705882;16;18;0.0294117647058824;0.470588235294118
Control.SRR15539874;29;32;0.517241379310345;14;15;0.0172413793103449;0.482758620689655
Control.SRR15539874;33;32;0.393939393939394;20;13;0.106060606060606;0.393939393939394
Control.SRR15539874;34;32;0.529411764705882;16;18;0.0294117647058824;0.470588235294118
Control.SRR15539874;31;32;0.516129032258065;15;16;0.0161290322580645;0.483870967741935
Control.SRR15539874;29;32;0.586206896551724;12;17;0.0862068965517241;0.413793103448276
Control.SRR15539874;36;32;0.611111111111111;14;22;0.111111111111111;0.388888888888889
Control.SRR15539874;30;32;0.466666666666667;16;14;0.0333333333333333;0.466666666666667
Control.SRR15539874;30;32;0.4;18;12;0.1;0.4
Control.SRR15539874;33;32;0.515151515151515;16;17;0.0151515151515151;0.484848484848485
Control.SRR15539874;30;32;0.466666666666667;16;14;0.0333333333333333;0.466666666666667
Control.SRR15539874;33;32;0.545454545454545;15;18;0.0454545454545454;0.454545454545455
Control.SRR15539874;31;32;0.32258064516129;21;10;0.17741935483871;0.32258064516129
Control.SRR15539874;29;32;0.551724137931034;13;16;0.0517241379310345;0.448275862068966
Control.SRR15539874;32;32;0.40625;19;13;0.09375;0.40625
Control.SRR15539874;34;32;0.588235294117647;14;20;0.0882352941176471;0.411764705882353
Control.SRR15539874;37;32;0.432432432432432;21;16;0.0675675675675675;0.432432432432432
Control.SRR15539874;37;32;0.432432432432432;21;16;0.0675675675675675;0.432432432432432
Control.SRR15539874;33;32;0.545454545454545;15;18;0.0454545454545454;0.454545454545455
Control.SRR15539874;33;32;0.424242424242424;19;14;0.0757575757575757;0.424242424242424
Control.SRR15539874;31;32;0.580645161290323;13;18;0.0806451612903226;0.419354838709677
Control.SRR15539874;30;32;0.5;15;15;0;0.5
Control.SRR15539874;35;32;0.485714285714286;18;17;0.0142857142857143;0.485714285714286
Control.SRR15539874;36;32;0.444444444444444;20;16;0.0555555555555556;0.444444444444444
Control.SRR15539874;31;32;0.516129032258065;15;16;0.0161290322580645;0.483870967741935
Control.SRR15539874;32;32;0.40625;19;13;0.09375;0.40625
Control.SRR15539874;29;32;0.344827586206897;19;10;0.155172413793103;0.344827586206897
Control.SRR15539874;31;32;0.612903225806452;12;19;0.112903225806452;0.387096774193548
Control.SRR15539874;32;32;0.40625;19;13;0.09375;0.40625
Control.SRR15539874;29;32;0.586206896551724;12;17;0.0862068965517241;0.413793103448276
Control.SRR15539874;35;32;0.514285714285714;17;18;0.0142857142857142;0.485714285714286
Control.SRR15539874;31;32;0.580645161290323;13;18;0.0806451612903226;0.419354838709677
Control.SRR15539874;33;32;0.454545454545455;18;15;0.0454545454545455;0.454545454545455
Control.SRR15539874;36;32;0.638888888888889;13;23;0.138888888888889;0.361111111111111
Control.SRR15539874;35;32;0.571428571428571;15;20;0.0714285714285714;0.428571428571429
Control.SRR15539874;29;32;0.586206896551724;12;17;0.0862068965517241;0.413793103448276
Control.SRR15539874;31;32;0.483870967741935;16;15;0.0161290322580645;0.483870967741935
Control.SRR15539874;31;32;0.67741935483871;10;21;0.17741935483871;0.32258064516129
Control.SRR15539874;31;32;0.354838709677419;20;11;0.145161290322581;0.354838709677419
Control.SRR15539874;34;32;0.5;17;17;0;0.5
Control.SRR15539874;31;32;0.516129032258065;15;16;0.0161290322580645;0.483870967741935
Control.SRR15539874;31;32;0.580645161290323;13;18;0.0806451612903226;0.419354838709677
Control.SRR15539874;35;32;0.371428571428571;22;13;0.128571428571429;0.371428571428571
Control.SRR15539874;30;32;0.5;15;15;0;0.5
Control.SRR15539874;30;32;0.5;15;15;0;0.5
Control.SRR15539874;32;32;0.5;16;16;0;0.5
Control.SRR15539874;34;32;0.617647058823529;13;21;0.117647058823529;0.382352941176471
Control.SRR15539874;37;32;0.459459459459459;20;17;0.0405405405405405;0.459459459459459
Control.SRR15539874;29;32;0.379310344827586;18;11;0.120689655172414;0.379310344827586
Control.SRR15539874;34;32;0.529411764705882;16;18;0.0294117647058824;0.470588235294118
Control.SRR15539874;31;32;0.483870967741935;16;15;0.0161290322580645;0.483870967741935
Control.SRR15539874;34;32;0.588235294117647;14;20;0.0882352941176471;0.411764705882353
Control.SRR15539874;34;32;0.470588235294118;18;16;0.0294117647058824;0.470588235294118
Control.SRR15539874;34;32;0.588235294117647;14;20;0.0882352941176471;0.411764705882353
Control.SRR15539874;34;32;0.617647058823529;13;21;0.117647058823529;0.382352941176471
Control.SRR15539874;29;32;0.310344827586207;20;9;0.189655172413793;0.310344827586207
Control.SRR15539874;30;32;0.4;18;12;0.1;0.4
Control.SRR15539874;33;32;0.606060606060606;13;20;0.106060606060606;0.393939393939394
Control.SRR15539874;30;32;0.466666666666667;16;14;0.0333333333333333;0.466666666666667
Control.SRR15539874;33;32;0.454545454545455;18;15;0.0454545454545455;0.454545454545455
Control.SRR15539874;36;32;0.472222222222222;19;17;0.0277777777777778;0.472222222222222
Control.SRR15539874;35;32;0.457142857142857;19;16;0.0428571428571429;0.457142857142857
Control.SRR15539874;30;32;0.566666666666667;13;17;0.0666666666666667;0.433333333333333
Control.SRR15539874;29;32;0.551724137931034;13;16;0.0517241379310345;0.448275862068966
Control.SRR15539874;29;32;0.448275862068966;16;13;0.0517241379310345;0.448275862068966
Control.SRR15539874;32;32;0.625;12;20;0.125;0.375
Control.SRR15539874;35;32;0.485714285714286;18;17;0.0142857142857143;0.485714285714286
Control.SRR15539874;36;32;0.611111111111111;14;22;0.111111111111111;0.388888888888889
Control.SRR15539874;37;32;0.675675675675676;12;25;0.175675675675676;0.324324324324324
Control.SRR15539874;34;32;0.5;17;17;0;0.5
Control.SRR15539874;36;32;0.5;18;18;0;0.5
Control.SRR15539874;33;32;0.515151515151515;16;17;0.0151515151515151;0.484848484848485
Control.SRR15539874;37;32;0.432432432432432;21;16;0.0675675675675675;0.432432432432432
Control.SRR15539874;36;32;0.472222222222222;19;17;0.0277777777777778;0.472222222222222
Control.SRR15539874;34;32;0.529411764705882;16;18;0.0294117647058824;0.470588235294118
Control.SRR15539874;37;32;0.513513513513513;18;19;0.0135135135135135;0.486486486486487
Control.SRR15539874;32;32;0.5;16;16;0;0.5
Control.SRR15539874;36;32;0.5;18;18;0;0.5
Control.SRR15539874;37;32;0.594594594594595;15;22;0.0945945945945946;0.405405405405405
Control.SRR15539874;29;32;0.413793103448276;17;12;0.0862068965517241;0.413793103448276
Control.SRR15539874;32;32;0.5625;14;18;0.0625;0.4375
Control.SRR15539874;35;32;0.657142857142857;12;23;0.157142857142857;0.342857142857143
Control.SRR15539874;35;32;0.342857142857143;23;12;0.157142857142857;0.342857142857143
Control.SRR15539874;37;32;0.405405405405405;22;15;0.0945945945945946;0.405405405405405
Control.SRR15539874;36;32;0.361111111111111;23;13;0.138888888888889;0.361111111111111
Control.SRR15539874;34;32;0.617647058823529;13;21;0.117647058823529;0.382352941176471
Control.SRR15539874;29;32;0.448275862068966;16;13;0.0517241379310345;0.448275862068966
Control.SRR15539874;31;32;0.451612903225806;17;14;0.0483870967741936;0.451612903225806
Control.SRR15539874;37;32;0.486486486486487;19;18;0.0135135135135135;0.486486486486487
Control.SRR15539874;31;32;0.419354838709677;18;13;0.0806451612903226;0.419354838709677
Control.SRR15539874;37;32;0.486486486486487;19;18;0.0135135135135135;0.486486486486487
Control.SRR15539874;37;32;0.540540540540541;17;20;0.0405405405405406;0.459459459459459
Control.SRR15539874;37;32;0.594594594594595;15;22;0.0945945945945946;0.405405405405405
Control.SRR15539874;32;32;0.5;16;16;0;0.5
Control.SRR15539874;32;32;0.4375;18;14;0.0625;0.4375
Control.SRR15539874;36;32;0.583333333333333;15;21;0.0833333333333334;0.416666666666667
Control.SRR15539874;29;32;0.482758620689655;15;14;0.0172413793103448;0.482758620689655
Control.SRR15539874;36;32;0.472222222222222;19;17;0.0277777777777778;0.472222222222222
Control.SRR15539874;32;32;0.6875;10;22;0.1875;0.3125
Control.SRR15539874;37;32;0.540540540540541;17;20;0.0405405405405406;0.459459459459459
Control.SRR15539874;33;32;0.515151515151515;16;17;0.0151515151515151;0.484848484848485
Control.SRR15539874;34;32;0.323529411764706;23;11;0.176470588235294;0.323529411764706
Control.SRR15539874;33;32;0.545454545454545;15;18;0.0454545454545454;0.454545454545455
Control.SRR15539874;34;32;0.588235294117647;14;20;0.0882352941176471;0.411764705882353
Control.SRR15539874;37;32;0.567567567567568;16;21;0.0675675675675675;0.432432432432432
Control.SRR15539874;35;32;0.628571428571429;13;22;0.128571428571429;0.371428571428571
Control.SRR15539874;34;32;0.411764705882353;20;14;0.0882352941176471;0.411764705882353
Control.SRR15539874;33;32;0.545454545454545;15;18;0.0454545454545454;0.454545454545455
Control.SRR15539874;30;32;0.666666666666667;10;20;0.166666666666667;0.333333333333333
Control.SRR15539874;33;32;0.606060606060606;13;20;0.106060606060606;0.393939393939394
Control.SRR15539874;32;32;0.53125;15;17;0.03125;0.46875
Control.SRR15539874;34;32;0.441176470588235;19;15;0.0588235294117647;0.441176470588235
Control.SRR15539874;36;32;0.333333333333333;24;12;0.166666666666667;0.333333333333333
Control.SRR15539874;30;32;0.366666666666667;19;11;0.133333333333333;0.366666666666667
Control.SRR15539874;37;32;0.405405405405405;22;15;0.0945945945945946;0.405405405405405
Control.SRR15539874;30;32;0.6;12;18;0.1;0.4
Control.SRR15539874;31;32;0.548387096774194;14;17;0.0483870967741935;0.451612903225806
Control.SRR15539874;35;32;0.428571428571429;20;15;0.0714285714285715;0.428571428571429
Control.SRR15539874;32;32;0.53125;15;17;0.03125;0.46875
Control.SRR15539874;34;32;0.411764705882353;20;14;0.0882352941176471;0.411764705882353
Control.SRR15539874;32;32;0.53125;15;17;0.03125;0.46875
Control.SRR15539874;36;32;0.388888888888889;22;14;0.111111111111111;0.388888888888889
Control.SRR15539874;29;32;0.551724137931034;13;16;0.0517241379310345;0.448275862068966
Control.SRR15539874;32;32;0.5;16;16;0;0.5
Control.SRR15539874;36;32;0.472222222222222;19;17;0.0277777777777778;0.472222222222222
Control.SRR15539874;31;32;0.483870967741935;16;15;0.0161290322580645;0.483870967741935
Control.SRR15539874;36;32;0.555555555555556;16;20;0.0555555555555556;0.444444444444444
Control.SRR15539874;36;32;0.416666666666667;21;15;0.0833333333333333;0.416666666666667
Control.SRR15539874;33;32;0.515151515151515;16;17;0.0151515151515151;0.484848484848485
Control.SRR15539874;34;32;0.5;17;17;0;0.5
Control.SRR15539874;30;32;0.5;15;15;0;0.5
Control.SRR15539874;29;32;0.517241379310345;14;15;0.0172413793103449;0.482758620689655
Control.SRR15539874;33;32;0.515151515151515;16;17;0.0151515151515151;0.484848484848485
Control.SRR15539874;37;32;0.459459459459459;20;17;0.0405405405405405;0.459459459459459
Control.SRR15539874;37;32;0.513513513513513;18;19;0.0135135135135135;0.486486486486487
Control.SRR15539874;35;32;0.428571428571429;20;15;0.0714285714285715;0.428571428571429
Control.SRR15539874;37;32;0.432432432432432;21;16;0.0675675675675675;0.432432432432432
Control.SRR15539874;34;32;0.529411764705882;16;18;0.0294117647058824;0.470588235294118
Control.SRR15539874;35;32;0.485714285714286;18;17;0.0142857142857143;0.485714285714286
Control.SRR15539874;37;32;0.540540540540541;17;20;0.0405405405405406;0.459459459459459
Control.SRR15539874;34;32;0.529411764705882;16;18;0.0294117647058824;0.470588235294118
Control.SRR15539874;35;32;0.485714285714286;18;17;0.0142857142857143;0.485714285714286
Control.SRR15539874;36;32;0.416666666666667;21;15;0.0833333333333333;0.416666666666667
Control.SRR15539874;36;32;0.611111111111111;14;22;0.111111111111111;0.388888888888889
Control.SRR15539874;37;32;0.513513513513513;18;19;0.0135135135135135;0.486486486486487
Control.SRR15539874;34;32;0.558823529411765;15;19;0.0588235294117647;0.441176470588235
Control.SRR15539874;36;32;0.555555555555556;16;20;0.0555555555555556;0.444444444444444
Control.SRR15539874;32;32;0.40625;19;13;0.09375;0.40625
Control.SRR15539874;36;32;0.333333333333333;24;12;0.166666666666667;0.333333333333333
Control.SRR15539874;31;32;0.548387096774194;14;17;0.0483870967741935;0.451612903225806
Control.SRR15539874;36;32;0.333333333333333;24;12;0.166666666666667;0.333333333333333
Control.SRR15539874;32;32;0.28125;23;9;0.21875;0.28125
Control.SRR15539874;37;32;0.486486486486487;19;18;0.0135135135135135;0.486486486486487
Control.SRR15539874;35;32;0.628571428571429;13;22;0.128571428571429;0.371428571428571
Control.SRR15539874;37;32;0.594594594594595;15;22;0.0945945945945946;0.405405405405405
Control.SRR15539874;29;32;0.586206896551724;12;17;0.0862068965517241;0.413793103448276
Control.SRR15539874;32;32;0.5;16;16;0;0.5
Control.SRR15539874;36;32;0.5;18;18;0;0.5
Control.SRR15539874;32;32;0.5625;14;18;0.0625;0.4375
Control.SRR15539874;34;32;0.382352941176471;21;13;0.117647058823529;0.382352941176471
Control.SRR15539874;33;32;0.454545454545455;18;15;0.0454545454545455;0.454545454545455
Control.SRR15539874;33;32;0.454545454545455;18;15;0.0454545454545455;0.454545454545455
Control.SRR15539874;34;32;0.558823529411765;15;19;0.0588235294117647;0.441176470588235
Control.SRR15539874;36;32;0.666666666666667;12;24;0.166666666666667;0.333333333333333
Control.SRR15539874;34;32;0.382352941176471;21;13;0.117647058823529;0.382352941176471
Control.SRR15539874;34;32;0.5;17;17;0;0.5
Control.SRR15539874;33;32;0.636363636363636;12;21;0.136363636363636;0.363636363636364
Control.SRR15539874;36;32;0.583333333333333;15;21;0.0833333333333334;0.416666666666667
Control.SRR15539874;35;32;0.428571428571429;20;15;0.0714285714285715;0.428571428571429
Control.SRR15539874;30;32;0.6;12;18;0.1;0.4
Control.SRR15539874;30;32;0.633333333333333;11;19;0.133333333333333;0.366666666666667
Control.SRR15539874;30;32;0.633333333333333;11;19;0.133333333333333;0.366666666666667
Control.SRR15539874;33;32;0.636363636363636;12;21;0.136363636363636;0.363636363636364
Control.SRR15539874;37;32;0.432432432432432;21;16;0.0675675675675675;0.432432432432432
Control.SRR15539874;33;32;0.515151515151515;16;17;0.0151515151515151;0.484848484848485
Control.SRR15539874;33;32;0.545454545454545;15;18;0.0454545454545454;0.454545454545455
Control.SRR15539874;34;32;0.441176470588235;19;15;0.0588235294117647;0.441176470588235
Control.SRR15539874;30;32;0.6;12;18;0.1;0.4
Control.SRR15539874;32;32;0.53125;15;17;0.03125;0.46875
Control.SRR15539874;35;32;0.4;21;14;0.1;0.4
Control.SRR15539874;37;32;0.432432432432432;21;16;0.0675675675675675;0.432432432432432
Control.SRR15539874;36;32;0.472222222222222;19;17;0.0277777777777778;0.472222222222222
Control.SRR15539874;34;32;0.470588235294118;18;16;0.0294117647058824;0.470588235294118
Control.SRR15539874;36;32;0.472222222222222;19;17;0.0277777777777778;0.472222222222222
Control.SRR15539874;36;32;0.472222222222222;19;17;0.0277777777777778;0.472222222222222
Control.SRR15539874;30;32;0.4;18;12;0.1;0.4
Control.SRR15539874;34;32;0.588235294117647;14;20;0.0882352941176471;0.411764705882353
Control.SRR15539874;31;32;0.516129032258065;15;16;0.0161290322580645;0.483870967741935
Control.SRR15539874;36;32;0.527777777777778;17;19;0.0277777777777778;0.472222222222222
Control.SRR15539874;34;32;0.5;17;17;0;0.5
Control.SRR15539874;31;32;0.483870967741935;16;15;0.0161290322580645;0.483870967741935
Control.SRR15539874;34;32;0.676470588235294;11;23;0.176470588235294;0.323529411764706
Control.SRR15539874;31;32;0.516129032258065;15;16;0.0161290322580645;0.483870967741935
Control.SRR15539874;32;32;0.4375;18;14;0.0625;0.4375
Control.SRR15539874;31;32;0.580645161290323;13;18;0.0806451612903226;0.419354838709677
Control.SRR15539874;37;32;0.486486486486487;19;18;0.0135135135135135;0.486486486486487
Control.SRR15539874;31;32;0.451612903225806;17;14;0.0483870967741936;0.451612903225806
Control.SRR15539874;37;32;0.432432432432432;21;16;0.0675675675675675;0.432432432432432
Control.SRR15539874;34;32;0.441176470588235;19;15;0.0588235294117647;0.441176470588235
Control.SRR15539874;34;32;0.529411764705882;16;18;0.0294117647058824;0.470588235294118
Control.SRR15539874;37;32;0.324324324324324;25;12;0.175675675675676;0.324324324324324
Control.SRR15539874;33;32;0.303030303030303;23;10;0.196969696969697;0.303030303030303
Control.SRR15539874;34;32;0.529411764705882;16;18;0.0294117647058824;0.470588235294118
Control.SRR15539874;34;32;0.529411764705882;16;18;0.0294117647058824;0.470588235294118
Control.SRR15539874;36;32;0.472222222222222;19;17;0.0277777777777778;0.472222222222222
Control.SRR15539874;30;32;0.5;15;15;0;0.5
Control.SRR15539874;37;32;0.513513513513513;18;19;0.0135135135135135;0.486486486486487
Control.SRR15539874;37;32;0.540540540540541;17;20;0.0405405405405406;0.459459459459459
Control.SRR15539874;31;32;0.516129032258065;15;16;0.0161290322580645;0.483870967741935
Control.SRR15539874;35;32;0.314285714285714;24;11;0.185714285714286;0.314285714285714
Control.SRR15539874;30;32;0.633333333333333;11;19;0.133333333333333;0.366666666666667
Control.SRR15539874;31;32;0.516129032258065;15;16;0.0161290322580645;0.483870967741935
Control.SRR15539874;30;32;0.4;18;12;0.1;0.4
Control.SRR15539874;34;32;0.323529411764706;23;11;0.176470588235294;0.323529411764706
Control.SRR15539874;36;32;0.527777777777778;17;19;0.0277777777777778;0.472222222222222
Control.SRR15539874;31;32;0.451612903225806;17;14;0.0483870967741936;0.451612903225806
Control.SRR15539874;34;32;0.5;17;17;0;0.5
Control.SRR15539874;35;32;0.6;14;21;0.1;0.4
Control.SRR15539874;30;32;0.366666666666667;19;11;0.133333333333333;0.366666666666667
Control.SRR15539874;33;32;0.454545454545455;18;15;0.0454545454545455;0.454545454545455
Control.SRR15539874;29;32;0.517241379310345;14;15;0.0172413793103449;0.482758620689655
Control.SRR15539874;36;32;0.472222222222222;19;17;0.0277777777777778;0.472222222222222
Control.SRR15539874;31;32;0.516129032258065;15;16;0.0161290322580645;0.483870967741935
Control.SRR15539874;32;32;0.46875;17;15;0.03125;0.46875
Control.SRR15539874;33;32;0.606060606060606;13;20;0.106060606060606;0.393939393939394
Control.SRR15539874;37;32;0.702702702702703;11;26;0.202702702702703;0.297297297297297
Control.SRR15539874;31;32;0.483870967741935;16;15;0.0161290322580645;0.483870967741935
Control.SRR15539874;36;32;0.638888888888889;13;23;0.138888888888889;0.361111111111111
Control.SRR15539874;36;32;0.472222222222222;19;17;0.0277777777777778;0.472222222222222
Control.SRR15539874;31;32;0.483870967741935;16;15;0.0161290322580645;0.483870967741935
Control.SRR15539874;33;32;0.484848484848485;17;16;0.0151515151515151;0.484848484848485
Control.SRR15539874;36;32;0.388888888888889;22;14;0.111111111111111;0.388888888888889
Control.SRR15539874;32;32;0.46875;17;15;0.03125;0.46875
Control.SRR15539874;34;32;0.588235294117647;14;20;0.0882352941176471;0.411764705882353
Control.SRR15539874;33;32;0.515151515151515;16;17;0.0151515151515151;0.484848484848485
Control.SRR15539874;37;32;0.459459459459459;20;17;0.0405405405405405;0.459459459459459
Control.SRR15539874;34;32;0.470588235294118;18;16;0.0294117647058824;0.470588235294118
Control.SRR15539874;35;32;0.428571428571429;20;15;0.0714285714285715;0.428571428571429
Control.SRR15539874;35;32;0.485714285714286;18;17;0.0142857142857143;0.485714285714286
Control.SRR15539874;37;32;0.621621621621622;14;23;0.121621621621622;0.378378378378378
Control.SRR15539874;32;32;0.40625;19;13;0.09375;0.40625
Control.SRR15539874;32;32;0.40625;19;13;0.09375;0.40625
Control.SRR15539874;29;32;0.517241379310345;14;15;0.0172413793103449;0.482758620689655
Control.SRR15539874;33;32;0.636363636363636;12;21;0.136363636363636;0.363636363636364
Control.SRR15539874;37;32;0.486486486486487;19;18;0.0135135135135135;0.486486486486487
Control.SRR15539874;37;32;0.432432432432432;21;16;0.0675675675675675;0.432432432432432
Control.SRR15539874;32;32;0.53125;15;17;0.03125;0.46875
Control.SRR15539874;30;32;0.466666666666667;16;14;0.0333333333333333;0.466666666666667
Control.SRR15539874;32;32;0.5;16;16;0;0.5
Control.SRR15539874;36;32;0.5;18;18;0;0.5
Control.SRR15539874;31;32;0.612903225806452;12;19;0.112903225806452;0.387096774193548
Control.SRR15539874;29;32;0.517241379310345;14;15;0.0172413793103449;0.482758620689655
Control.SRR15539874;29;32;0.482758620689655;15;14;0.0172413793103448;0.482758620689655
Control.SRR15539874;37;32;0.405405405405405;22;15;0.0945945945945946;0.405405405405405
Control.SRR15539874;32;32;0.4375;18;14;0.0625;0.4375
Control.SRR15539874;37;32;0.432432432432432;21;16;0.0675675675675675;0.432432432432432
Control.SRR15539874;34;32;0.529411764705882;16;18;0.0294117647058824;0.470588235294118
Control.SRR15539874;37;32;0.621621621621622;14;23;0.121621621621622;0.378378378378378
Control.SRR15539874;31;32;0.548387096774194;14;17;0.0483870967741935;0.451612903225806
Control.SRR15539874;31;32;0.451612903225806;17;14;0.0483870967741936;0.451612903225806
Control.SRR15539874;33;32;0.393939393939394;20;13;0.106060606060606;0.393939393939394
Control.SRR15539874;34;32;0.5;17;17;0;0.5
Control.SRR15539874;34;32;0.441176470588235;19;15;0.0588235294117647;0.441176470588235
Control.SRR15539874;35;32;0.514285714285714;17;18;0.0142857142857142;0.485714285714286
Control.SRR15539874;35;32;0.742857142857143;9;26;0.242857142857143;0.257142857142857
Control.SRR15539874;32;32;0.53125;15;17;0.03125;0.46875
Control.SRR15539874;30;32;0.566666666666667;13;17;0.0666666666666667;0.433333333333333
Control.SRR15539874;31;32;0.612903225806452;12;19;0.112903225806452;0.387096774193548
Control.SRR15539874;31;32;0.483870967741935;16;15;0.0161290322580645;0.483870967741935
Control.SRR15539874;29;32;0.551724137931034;13;16;0.0517241379310345;0.448275862068966
Control.SRR15539874;34;32;0.588235294117647;14;20;0.0882352941176471;0.411764705882353
Control.SRR15539874;32;32;0.40625;19;13;0.09375;0.40625
Control.SRR15539874;30;32;0.633333333333333;11;19;0.133333333333333;0.366666666666667
Control.SRR15539874;30;32;0.666666666666667;10;20;0.166666666666667;0.333333333333333
Control.SRR15539874;34;32;0.5;17;17;0;0.5
Control.SRR15539874;34;32;0.411764705882353;20;14;0.0882352941176471;0.411764705882353
Control.SRR15539874;31;32;0.483870967741935;16;15;0.0161290322580645;0.483870967741935
Control.SRR15539874;37;32;0.621621621621622;14;23;0.121621621621622;0.378378378378378
Control.SRR15539874;36;32;0.527777777777778;17;19;0.0277777777777778;0.472222222222222
Control.SRR15539874;31;32;0.612903225806452;12;19;0.112903225806452;0.387096774193548
Control.SRR15539874;32;32;0.65625;11;21;0.15625;0.34375
Control.SRR15539874;29;32;0.448275862068966;16;13;0.0517241379310345;0.448275862068966
Control.SRR15539874;34;32;0.5;17;17;0;0.5
Control.SRR15539874;31;32;0.419354838709677;18;13;0.0806451612903226;0.419354838709677
Control.SRR15539874;34;32;0.352941176470588;22;12;0.147058823529412;0.352941176470588
Control.SRR15539874;31;32;0.580645161290323;13;18;0.0806451612903226;0.419354838709677
Control.SRR15539874;37;32;0.594594594594595;15;22;0.0945945945945946;0.405405405405405
Control.SRR15539874;33;32;0.515151515151515;16;17;0.0151515151515151;0.484848484848485
Control.SRR15539874;34;32;0.529411764705882;16;18;0.0294117647058824;0.470588235294118
Control.SRR15539874;29;32;0.448275862068966;16;13;0.0517241379310345;0.448275862068966
Control.SRR15539874;37;32;0.513513513513513;18;19;0.0135135135135135;0.486486486486487
Control.SRR15539874;31;32;0.580645161290323;13;18;0.0806451612903226;0.419354838709677
Control.SRR15539874;34;32;0.588235294117647;14;20;0.0882352941176471;0.411764705882353
Control.SRR15539874;35;32;0.485714285714286;18;17;0.0142857142857143;0.485714285714286
Control.SRR15539874;35;32;0.371428571428571;22;13;0.128571428571429;0.371428571428571
Control.SRR15539874;37;32;0.540540540540541;17;20;0.0405405405405406;0.459459459459459
Control.SRR15539874;36;32;0.416666666666667;21;15;0.0833333333333333;0.416666666666667
Control.SRR15539874;37;32;0.594594594594595;15;22;0.0945945945945946;0.405405405405405
Control.SRR15539874;35;32;0.6;14;21;0.1;0.4
Control.SRR15539874;35;32;0.514285714285714;17;18;0.0142857142857142;0.485714285714286
Control.SRR15539874;33;32;0.636363636363636;12;21;0.136363636363636;0.363636363636364
Control.SRR15539874;32;32;0.59375;13;19;0.09375;0.40625
Control.SRR15539874;30;32;0.566666666666667;13;17;0.0666666666666667;0.433333333333333
Control.SRR15539874;37;32;0.675675675675676;12;25;0.175675675675676;0.324324324324324
Control.SRR15539874;36;32;0.444444444444444;20;16;0.0555555555555556;0.444444444444444
Control.SRR15539874;33;32;0.454545454545455;18;15;0.0454545454545455;0.454545454545455
Control.SRR15539874;34;32;0.411764705882353;20;14;0.0882352941176471;0.411764705882353
Control.SRR15539874;30;32;0.633333333333333;11;19;0.133333333333333;0.366666666666667
Control.SRR15539874;29;32;0.758620689655172;7;22;0.258620689655172;0.241379310344828
Control.SRR15539874;36;32;0.527777777777778;17;19;0.0277777777777778;0.472222222222222
Control.SRR15539874;34;32;0.470588235294118;18;16;0.0294117647058824;0.470588235294118
Control.SRR15539874;35;32;0.6;14;21;0.1;0.4
Control.SRR15539874;33;32;0.424242424242424;19;14;0.0757575757575757;0.424242424242424
Control.SRR15539874;33;32;0.484848484848485;17;16;0.0151515151515151;0.484848484848485
Control.SRR15539874;34;32;0.617647058823529;13;21;0.117647058823529;0.382352941176471
Control.SRR15539874;29;32;0.344827586206897;19;10;0.155172413793103;0.344827586206897
Control.SRR15539874;35;32;0.457142857142857;19;16;0.0428571428571429;0.457142857142857
Control.SRR15539874;34;32;0.529411764705882;16;18;0.0294117647058824;0.470588235294118
Control.SRR15539874;35;32;0.371428571428571;22;13;0.128571428571429;0.371428571428571
Control.SRR15539874;29;32;0.517241379310345;14;15;0.0172413793103449;0.482758620689655
Control.SRR15539874;36;32;0.527777777777778;17;19;0.0277777777777778;0.472222222222222
Control.SRR15539874;32;32;0.53125;15;17;0.03125;0.46875
Control.SRR15539874;30;32;0.4;18;12;0.1;0.4
Control.SRR15539874;30;32;0.5;15;15;0;0.5
Control.SRR15539874;32;32;0.5;16;16;0;0.5
Control.SRR15539874;32;32;0.5625;14;18;0.0625;0.4375
Control.SRR15539874;32;32;0.59375;13;19;0.09375;0.40625
Control.SRR15539874;31;32;0.451612903225806;17;14;0.0483870967741936;0.451612903225806
Control.SRR15539874;31;32;0.483870967741935;16;15;0.0161290322580645;0.483870967741935
Control.SRR15539874;31;32;0.451612903225806;17;14;0.0483870967741936;0.451612903225806
Control.SRR15539874;31;32;0.612903225806452;12;19;0.112903225806452;0.387096774193548
Control.SRR15539874;36;32;0.416666666666667;21;15;0.0833333333333333;0.416666666666667
Control.SRR15539874;32;32;0.4375;18;14;0.0625;0.4375
Control.SRR15539874;37;32;0.432432432432432;21;16;0.0675675675675675;0.432432432432432
Control.SRR15539874;37;32;0.540540540540541;17;20;0.0405405405405406;0.459459459459459
Control.SRR15539874;33;32;0.424242424242424;19;14;0.0757575757575757;0.424242424242424
Control.SRR15539874;30;32;0.433333333333333;17;13;0.0666666666666667;0.433333333333333
Control.SRR15539874;33;32;0.545454545454545;15;18;0.0454545454545454;0.454545454545455
Control.SRR15539874;31;32;0.451612903225806;17;14;0.0483870967741936;0.451612903225806
Control.SRR15539874;35;32;0.714285714285714;10;25;0.214285714285714;0.285714285714286
Control.SRR15539874;33;32;0.545454545454545;15;18;0.0454545454545454;0.454545454545455
Control.SRR15539874;31;32;0.612903225806452;12;19;0.112903225806452;0.387096774193548
Control.SRR15539874;32;32;0.4375;18;14;0.0625;0.4375
Control.SRR15539874;31;32;0.645161290322581;11;20;0.145161290322581;0.354838709677419
Control.SRR15539874;34;32;0.5;17;17;0;0.5
Control.SRR15539874;35;32;0.514285714285714;17;18;0.0142857142857142;0.485714285714286
Control.SRR15539874;31;32;0.67741935483871;10;21;0.17741935483871;0.32258064516129
Control.SRR15539874;37;32;0.621621621621622;14;23;0.121621621621622;0.378378378378378
Control.SRR15539874;33;32;0.454545454545455;18;15;0.0454545454545455;0.454545454545455
Control.SRR15539874;35;32;0.571428571428571;15;20;0.0714285714285714;0.428571428571429
Control.SRR15539874;33;32;0.636363636363636;12;21;0.136363636363636;0.363636363636364
Control.SRR15539874;37;32;0.513513513513513;18;19;0.0135135135135135;0.486486486486487
Control.SRR15539874;32;32;0.4375;18;14;0.0625;0.4375
Control.SRR15539874;37;32;0.513513513513513;18;19;0.0135135135135135;0.486486486486487
Control.SRR15539874;29;32;0.517241379310345;14;15;0.0172413793103449;0.482758620689655
Control.SRR15539874;35;32;0.4;21;14;0.1;0.4
Control.SRR15539874;34;32;0.470588235294118;18;16;0.0294117647058824;0.470588235294118
Control.SRR15539874;35;32;0.457142857142857;19;16;0.0428571428571429;0.457142857142857
Control.SRR15539874;32;32;0.65625;11;21;0.15625;0.34375
Control.SRR15539874;32;32;0.40625;19;13;0.09375;0.40625
Control.SRR15539874;32;32;0.375;20;12;0.125;0.375
Control.SRR15539874;29;32;0.448275862068966;16;13;0.0517241379310345;0.448275862068966
Control.SRR15539874;30;32;0.433333333333333;17;13;0.0666666666666667;0.433333333333333
Control.SRR15539874;34;32;0.441176470588235;19;15;0.0588235294117647;0.441176470588235
Control.SRR15539874;36;32;0.444444444444444;20;16;0.0555555555555556;0.444444444444444
Control.SRR15539874;33;32;0.242424242424242;25;8;0.257575757575758;0.242424242424242
Control.SRR15539874;30;32;0.433333333333333;17;13;0.0666666666666667;0.433333333333333
Control.SRR15539874;32;32;0.53125;15;17;0.03125;0.46875
Control.SRR15539874;37;32;0.513513513513513;18;19;0.0135135135135135;0.486486486486487
Control.SRR15539874;30;32;0.366666666666667;19;11;0.133333333333333;0.366666666666667
Control.SRR15539874;34;32;0.529411764705882;16;18;0.0294117647058824;0.470588235294118
Control.SRR15539874;34;32;0.382352941176471;21;13;0.117647058823529;0.382352941176471
Control.SRR15539874;32;32;0.53125;15;17;0.03125;0.46875
Control.SRR15539874;30;32;0.7;9;21;0.2;0.3
Control.SRR15539874;29;32;0.517241379310345;14;15;0.0172413793103449;0.482758620689655
Control.SRR15539874;29;32;0.620689655172414;11;18;0.120689655172414;0.379310344827586
Control.SRR15539874;33;32;0.393939393939394;20;13;0.106060606060606;0.393939393939394
Control.SRR15539874;30;32;0.533333333333333;14;16;0.0333333333333333;0.466666666666667
Control.SRR15539874;31;32;0.483870967741935;16;15;0.0161290322580645;0.483870967741935
Control.SRR15539874;36;32;0.472222222222222;19;17;0.0277777777777778;0.472222222222222
Control.SRR15539874;35;32;0.485714285714286;18;17;0.0142857142857143;0.485714285714286
Control.SRR15539874;33;32;0.484848484848485;17;16;0.0151515151515151;0.484848484848485
Control.SRR15539874;33;32;0.575757575757576;14;19;0.0757575757575758;0.424242424242424
Control.SRR15539874;37;32;0.459459459459459;20;17;0.0405405405405405;0.459459459459459
Control.SRR15539874;35;32;0.4;21;14;0.1;0.4
Control.SRR15539874;30;32;0.566666666666667;13;17;0.0666666666666667;0.433333333333333
Control.SRR15539874;34;32;0.411764705882353;20;14;0.0882352941176471;0.411764705882353
Control.SRR15539874;36;32;0.555555555555556;16;20;0.0555555555555556;0.444444444444444
Control.SRR15539874;33;32;0.575757575757576;14;19;0.0757575757575758;0.424242424242424
Control.SRR15539874;36;32;0.638888888888889;13;23;0.138888888888889;0.361111111111111
Control.SRR15539874;34;32;0.411764705882353;20;14;0.0882352941176471;0.411764705882353
Control.SRR15539874;32;32;0.4375;18;14;0.0625;0.4375
Control.SRR15539874;32;32;0.53125;15;17;0.03125;0.46875
Control.SRR15539874;31;32;0.483870967741935;16;15;0.0161290322580645;0.483870967741935
Control.SRR15539874;29;32;0.517241379310345;14;15;0.0172413793103449;0.482758620689655
Control.SRR15539874;35;32;0.542857142857143;16;19;0.0428571428571428;0.457142857142857
Control.SRR15539874;30;32;0.333333333333333;20;10;0.166666666666667;0.333333333333333
Control.SRR15539874;32;32;0.46875;17;15;0.03125;0.46875
Control.SRR15539874;34;32;0.588235294117647;14;20;0.0882352941176471;0.411764705882353
Control.SRR15539874;30;32;0.466666666666667;16;14;0.0333333333333333;0.466666666666667
Control.SRR15539874;32;32;0.5;16;16;0;0.5
Control.SRR15539874;31;32;0.483870967741935;16;15;0.0161290322580645;0.483870967741935
Control.SRR15539874;30;32;0.433333333333333;17;13;0.0666666666666667;0.433333333333333
Control.SRR15539874;29;32;0.551724137931034;13;16;0.0517241379310345;0.448275862068966
Control.SRR15539874;29;32;0.413793103448276;17;12;0.0862068965517241;0.413793103448276
Control.SRR15539874;35;32;0.428571428571429;20;15;0.0714285714285715;0.428571428571429
Control.SRR15539874;37;32;0.486486486486487;19;18;0.0135135135135135;0.486486486486487
Control.SRR15539874;32;32;0.53125;15;17;0.03125;0.46875
Control.SRR15539874;33;32;0.484848484848485;17;16;0.0151515151515151;0.484848484848485
Control.SRR15539874;34;32;0.588235294117647;14;20;0.0882352941176471;0.411764705882353
Control.SRR15539874;30;32;0.466666666666667;16;14;0.0333333333333333;0.466666666666667
Control.SRR15539874;30;32;0.466666666666667;16;14;0.0333333333333333;0.466666666666667
Control.SRR15539874;35;32;0.457142857142857;19;16;0.0428571428571429;0.457142857142857
Control.SRR15539874;34;32;0.470588235294118;18;16;0.0294117647058824;0.470588235294118
Control.SRR15539874;35;32;0.4;21;14;0.1;0.4
Control.SRR15539874;34;32;0.529411764705882;16;18;0.0294117647058824;0.470588235294118
Control.SRR15539874;37;32;0.567567567567568;16;21;0.0675675675675675;0.432432432432432
Control.SRR15539874;35;32;0.571428571428571;15;20;0.0714285714285714;0.428571428571429
Control.SRR15539874;31;32;0.516129032258065;15;16;0.0161290322580645;0.483870967741935
Control.SRR15539874;35;32;0.457142857142857;19;16;0.0428571428571429;0.457142857142857
Control.SRR15539874;36;32;0.611111111111111;14;22;0.111111111111111;0.388888888888889
Control.SRR15539874;32;32;0.625;12;20;0.125;0.375
Control.SRR15539874;32;32;0.53125;15;17;0.03125;0.46875
Control.SRR15539874;31;32;0.32258064516129;21;10;0.17741935483871;0.32258064516129
Control.SRR15539874;32;32;0.5;16;16;0;0.5
Control.SRR15539874;33;32;0.545454545454545;15;18;0.0454545454545454;0.454545454545455
Control.SRR15539874;29;32;0.620689655172414;11;18;0.120689655172414;0.379310344827586
Control.SRR15539874;30;32;0.466666666666667;16;14;0.0333333333333333;0.466666666666667
Control.SRR15539874;36;32;0.361111111111111;23;13;0.138888888888889;0.361111111111111
Control.SRR15539874;34;32;0.5;17;17;0;0.5
Control.SRR15539874;31;32;0.387096774193548;19;12;0.112903225806452;0.387096774193548
Control.SRR15539874;33;32;0.393939393939394;20;13;0.106060606060606;0.393939393939394
Control.SRR15539874;32;32;0.46875;17;15;0.03125;0.46875
Control.SRR15539874;32;32;0.59375;13;19;0.09375;0.40625
Control.SRR15539874;33;32;0.545454545454545;15;18;0.0454545454545454;0.454545454545455
Control.SRR15539874;29;32;0.517241379310345;14;15;0.0172413793103449;0.482758620689655
Control.SRR15539874;31;32;0.516129032258065;15;16;0.0161290322580645;0.483870967741935
Control.SRR15539874;34;32;0.558823529411765;15;19;0.0588235294117647;0.441176470588235
Control.SRR15539874;30;32;0.5;15;15;0;0.5
Control.SRR15539874;34;32;0.441176470588235;19;15;0.0588235294117647;0.441176470588235
Control.SRR15539874;30;32;0.5;15;15;0;0.5
Control.SRR15539874;35;32;0.542857142857143;16;19;0.0428571428571428;0.457142857142857
Control.SRR15539874;29;32;0.655172413793103;10;19;0.155172413793103;0.344827586206897
Control.SRR15539874;30;32;0.533333333333333;14;16;0.0333333333333333;0.466666666666667
Control.SRR15539874;33;32;0.424242424242424;19;14;0.0757575757575757;0.424242424242424
Control.SRR15539874;33;32;0.393939393939394;20;13;0.106060606060606;0.393939393939394
Control.SRR15539874;35;32;0.314285714285714;24;11;0.185714285714286;0.314285714285714
Control.SRR15539874;30;32;0.433333333333333;17;13;0.0666666666666667;0.433333333333333
Control.SRR15539874;35;32;0.485714285714286;18;17;0.0142857142857143;0.485714285714286
Control.SRR15539874;33;32;0.454545454545455;18;15;0.0454545454545455;0.454545454545455
Control.SRR15539874;29;32;0.551724137931034;13;16;0.0517241379310345;0.448275862068966
Control.SRR15539874;29;32;0.413793103448276;17;12;0.0862068965517241;0.413793103448276
Control.SRR15539874;29;32;0.517241379310345;14;15;0.0172413793103449;0.482758620689655
Control.SRR15539874;34;32;0.647058823529412;12;22;0.147058823529412;0.352941176470588
Control.SRR15539874;32;32;0.46875;17;15;0.03125;0.46875
Control.SRR15539874;31;32;0.354838709677419;20;11;0.145161290322581;0.354838709677419
Control.SRR15539874;32;32;0.5625;14;18;0.0625;0.4375
Control.SRR15539874;36;32;0.416666666666667;21;15;0.0833333333333333;0.416666666666667
Control.SRR15539874;36;32;0.472222222222222;19;17;0.0277777777777778;0.472222222222222
Control.SRR15539874;29;32;0.379310344827586;18;11;0.120689655172414;0.379310344827586
Control.SRR15539874;32;32;0.625;12;20;0.125;0.375
Control.SRR15539874;33;32;0.303030303030303;23;10;0.196969696969697;0.303030303030303
Control.SRR15539874;34;32;0.470588235294118;18;16;0.0294117647058824;0.470588235294118
Control.SRR15539874;37;32;0.486486486486487;19;18;0.0135135135135135;0.486486486486487
Control.SRR15539874;36;32;0.444444444444444;20;16;0.0555555555555556;0.444444444444444
Control.SRR15539874;30;32;0.433333333333333;17;13;0.0666666666666667;0.433333333333333
Control.SRR15539874;32;32;0.4375;18;14;0.0625;0.4375
Control.SRR15539874;34;32;0.617647058823529;13;21;0.117647058823529;0.382352941176471
Control.SRR15539874;35;32;0.514285714285714;17;18;0.0142857142857142;0.485714285714286
Control.SRR15539874;37;32;0.297297297297297;26;11;0.202702702702703;0.297297297297297
Control.SRR15539874;31;32;0.387096774193548;19;12;0.112903225806452;0.387096774193548
Control.SRR15539874;31;32;0.419354838709677;18;13;0.0806451612903226;0.419354838709677
Control.SRR15539874;32;32;0.53125;15;17;0.03125;0.46875
Control.SRR15539874;31;32;0.548387096774194;14;17;0.0483870967741935;0.451612903225806
Control.SRR15539874;37;32;0.621621621621622;14;23;0.121621621621622;0.378378378378378
Control.SRR15539874;31;32;0.516129032258065;15;16;0.0161290322580645;0.483870967741935
Control.SRR15539874;33;32;0.575757575757576;14;19;0.0757575757575758;0.424242424242424
Control.SRR15539874;35;32;0.514285714285714;17;18;0.0142857142857142;0.485714285714286
Control.SRR15539874;30;32;0.566666666666667;13;17;0.0666666666666667;0.433333333333333
Control.SRR15539874;35;32;0.571428571428571;15;20;0.0714285714285714;0.428571428571429
Control.SRR15539874;36;32;0.638888888888889;13;23;0.138888888888889;0.361111111111111
Control.SRR15539874;31;32;0.32258064516129;21;10;0.17741935483871;0.32258064516129
Control.SRR15539874;30;32;0.366666666666667;19;11;0.133333333333333;0.366666666666667
Control.SRR15539874;30;32;0.533333333333333;14;16;0.0333333333333333;0.466666666666667
Control.SRR15539874;37;32;0.459459459459459;20;17;0.0405405405405405;0.459459459459459
Control.SRR15539874;34;32;0.529411764705882;16;18;0.0294117647058824;0.470588235294118
Control.SRR15539874;31;32;0.548387096774194;14;17;0.0483870967741935;0.451612903225806
Control.SRR15539874;32;32;0.5;16;16;0;0.5
Control.SRR15539874;35;32;0.6;14;21;0.1;0.4
Control.SRR15539874;30;32;0.4;18;12;0.1;0.4
Control.SRR15539874;29;32;0.413793103448276;17;12;0.0862068965517241;0.413793103448276
Control.SRR15539874;36;32;0.5;18;18;0;0.5
Control.SRR15539874;31;32;0.387096774193548;19;12;0.112903225806452;0.387096774193548
Control.SRR15539874;33;32;0.545454545454545;15;18;0.0454545454545454;0.454545454545455
Control.SRR15539874;35;32;0.457142857142857;19;16;0.0428571428571429;0.457142857142857
Control.SRR15539874;31;32;0.451612903225806;17;14;0.0483870967741936;0.451612903225806
Control.SRR15539874;30;32;0.4;18;12;0.1;0.4
Control.SRR15539874;29;32;0.448275862068966;16;13;0.0517241379310345;0.448275862068966
Control.SRR15539874;33;32;0.545454545454545;15;18;0.0454545454545454;0.454545454545455
Control.SRR15539874;34;32;0.470588235294118;18;16;0.0294117647058824;0.470588235294118
Control.SRR15539874;29;32;0.379310344827586;18;11;0.120689655172414;0.379310344827586
Control.SRR15539874;33;32;0.424242424242424;19;14;0.0757575757575757;0.424242424242424
Control.SRR15539874;33;32;0.424242424242424;19;14;0.0757575757575757;0.424242424242424
Control.SRR15539874;35;32;0.457142857142857;19;16;0.0428571428571429;0.457142857142857
Control.SRR15539874;30;32;0.533333333333333;14;16;0.0333333333333333;0.466666666666667
Control.SRR15539874;36;32;0.444444444444444;20;16;0.0555555555555556;0.444444444444444
Control.SRR15539874;36;32;0.555555555555556;16;20;0.0555555555555556;0.444444444444444
Control.SRR15539874;29;32;0.655172413793103;10;19;0.155172413793103;0.344827586206897
Control.SRR15539874;29;32;0.551724137931034;13;16;0.0517241379310345;0.448275862068966
Control.SRR15539874;36;32;0.333333333333333;24;12;0.166666666666667;0.333333333333333
Control.SRR15539874;35;32;0.6;14;21;0.1;0.4
Control.SRR15539874;37;32;0.648648648648649;13;24;0.148648648648649;0.351351351351351
Control.SRR15539874;34;32;0.5;17;17;0;0.5
Control.SRR15539874;29;32;0.448275862068966;16;13;0.0517241379310345;0.448275862068966
Control.SRR15539874;30;32;0.533333333333333;14;16;0.0333333333333333;0.466666666666667
Control.SRR15539874;35;32;0.571428571428571;15;20;0.0714285714285714;0.428571428571429
Control.SRR15539874;34;32;0.529411764705882;16;18;0.0294117647058824;0.470588235294118
Control.SRR15539874;29;32;0.448275862068966;16;13;0.0517241379310345;0.448275862068966
Control.SRR15539874;32;32;0.625;12;20;0.125;0.375
Control.SRR15539874;29;32;0.448275862068966;16;13;0.0517241379310345;0.448275862068966
Control.SRR15539874;30;32;0.466666666666667;16;14;0.0333333333333333;0.466666666666667
Control.SRR15539874;30;32;0.433333333333333;17;13;0.0666666666666667;0.433333333333333
Control.SRR15539874;31;32;0.483870967741935;16;15;0.0161290322580645;0.483870967741935
Control.SRR15539874;34;32;0.441176470588235;19;15;0.0588235294117647;0.441176470588235
Control.SRR15539874;32;32;0.5625;14;18;0.0625;0.4375
Control.SRR15539874;37;32;0.324324324324324;25;12;0.175675675675676;0.324324324324324
Control.SRR15539874;29;32;0.551724137931034;13;16;0.0517241379310345;0.448275862068966
Control.SRR15539874;32;32;0.625;12;20;0.125;0.375
Control.SRR15539874;34;32;0.529411764705882;16;18;0.0294117647058824;0.470588235294118
Control.SRR15539874;31;32;0.548387096774194;14;17;0.0483870967741935;0.451612903225806
Control.SRR15539874;36;32;0.638888888888889;13;23;0.138888888888889;0.361111111111111
Control.SRR15539874;34;32;0.558823529411765;15;19;0.0588235294117647;0.441176470588235
Control.SRR15539874;37;32;0.324324324324324;25;12;0.175675675675676;0.324324324324324
Control.SRR15539874;37;32;0.486486486486487;19;18;0.0135135135135135;0.486486486486487
Control.SRR15539874;37;32;0.513513513513513;18;19;0.0135135135135135;0.486486486486487
Control.SRR15539874;37;32;0.540540540540541;17;20;0.0405405405405406;0.459459459459459
Control.SRR15539874;31;32;0.516129032258065;15;16;0.0161290322580645;0.483870967741935
Control.SRR15539874;35;32;0.6;14;21;0.1;0.4
Control.SRR15539874;34;32;0.647058823529412;12;22;0.147058823529412;0.352941176470588
Control.SRR15539874;29;32;0.344827586206897;19;10;0.155172413793103;0.344827586206897
Control.SRR15539874;32;32;0.53125;15;17;0.03125;0.46875
Control.SRR15539874;30;32;0.466666666666667;16;14;0.0333333333333333;0.466666666666667
Control.SRR15539874;31;32;0.419354838709677;18;13;0.0806451612903226;0.419354838709677
Control.SRR15539874;31;32;0.580645161290323;13;18;0.0806451612903226;0.419354838709677
Control.SRR15539874;33;32;0.515151515151515;16;17;0.0151515151515151;0.484848484848485
Control.SRR15539874;36;32;0.416666666666667;21;15;0.0833333333333333;0.416666666666667
Control.SRR15539874;32;32;0.40625;19;13;0.09375;0.40625
Control.SRR15539874;31;32;0.516129032258065;15;16;0.0161290322580645;0.483870967741935
Control.SRR15539874;33;32;0.515151515151515;16;17;0.0151515151515151;0.484848484848485
Control.SRR15539874;31;32;0.516129032258065;15;16;0.0161290322580645;0.483870967741935
Control.SRR15539874;30;32;0.433333333333333;17;13;0.0666666666666667;0.433333333333333
Control.SRR15539874;29;32;0.517241379310345;14;15;0.0172413793103449;0.482758620689655
Control.SRR15539874;36;32;0.305555555555556;25;11;0.194444444444444;0.305555555555556
Control.SRR15539874;36;32;0.333333333333333;24;12;0.166666666666667;0.333333333333333
Control.SRR15539874;37;32;0.648648648648649;13;24;0.148648648648649;0.351351351351351
Control.SRR15539874;33;32;0.424242424242424;19;14;0.0757575757575757;0.424242424242424
Control.SRR15539874;34;32;0.470588235294118;18;16;0.0294117647058824;0.470588235294118
Control.SRR15539874;31;32;0.741935483870968;8;23;0.241935483870968;0.258064516129032
Control.SRR15539874;32;32;0.625;12;20;0.125;0.375
Control.SRR15539874;30;32;0.566666666666667;13;17;0.0666666666666667;0.433333333333333
Control.SRR15539874;35;32;0.428571428571429;20;15;0.0714285714285715;0.428571428571429
Control.SRR15539874;32;32;0.5;16;16;0;0.5
Control.SRR15539874;31;32;0.516129032258065;15;16;0.0161290322580645;0.483870967741935
Control.SRR15539874;29;32;0.586206896551724;12;17;0.0862068965517241;0.413793103448276
Control.SRR15539874;30;32;0.6;12;18;0.1;0.4
Control.SRR15539874;29;32;0.482758620689655;15;14;0.0172413793103448;0.482758620689655
Control.SRR15539874;34;32;0.558823529411765;15;19;0.0588235294117647;0.441176470588235
Control.SRR15539874;32;32;0.53125;15;17;0.03125;0.46875
Control.SRR15539874;36;32;0.444444444444444;20;16;0.0555555555555556;0.444444444444444
Control.SRR15539874;32;32;0.375;20;12;0.125;0.375
Control.SRR15539874;29;32;0.551724137931034;13;16;0.0517241379310345;0.448275862068966
Control.SRR15539874;32;32;0.4375;18;14;0.0625;0.4375
Control.SRR15539874;35;32;0.514285714285714;17;18;0.0142857142857142;0.485714285714286
Control.SRR15539874;30;32;0.333333333333333;20;10;0.166666666666667;0.333333333333333
Control.SRR15539874;31;32;0.483870967741935;16;15;0.0161290322580645;0.483870967741935
Control.SRR15539874;34;32;0.441176470588235;19;15;0.0588235294117647;0.441176470588235
Control.SRR15539874;33;32;0.393939393939394;20;13;0.106060606060606;0.393939393939394
Control.SRR15539874;30;32;0.466666666666667;16;14;0.0333333333333333;0.466666666666667
Control.SRR15539874;29;32;0.482758620689655;15;14;0.0172413793103448;0.482758620689655
Control.SRR15539874;35;32;0.428571428571429;20;15;0.0714285714285715;0.428571428571429
Control.SRR15539874;32;32;0.46875;17;15;0.03125;0.46875
Control.SRR15539874;31;32;0.451612903225806;17;14;0.0483870967741936;0.451612903225806
Control.SRR15539874;33;32;0.636363636363636;12;21;0.136363636363636;0.363636363636364
Control.SRR15539874;33;32;0.575757575757576;14;19;0.0757575757575758;0.424242424242424
Control.SRR15539874;32;32;0.5625;14;18;0.0625;0.4375
Control.SRR15539874;36;32;0.416666666666667;21;15;0.0833333333333333;0.416666666666667
Control.SRR15539874;34;32;0.5;17;17;0;0.5
Control.SRR15539874;37;32;0.540540540540541;17;20;0.0405405405405406;0.459459459459459
Control.SRR15539874;32;32;0.65625;11;21;0.15625;0.34375
Control.SRR15539874;34;32;0.441176470588235;19;15;0.0588235294117647;0.441176470588235
Control.SRR15539874;33;32;0.484848484848485;17;16;0.0151515151515151;0.484848484848485
Control.SRR15539874;36;32;0.611111111111111;14;22;0.111111111111111;0.388888888888889
Control.SRR15539874;32;32;0.4375;18;14;0.0625;0.4375
Control.SRR15539874;32;32;0.4375;18;14;0.0625;0.4375
Control.SRR15539874;33;32;0.575757575757576;14;19;0.0757575757575758;0.424242424242424
Control.SRR15539874;29;32;0.551724137931034;13;16;0.0517241379310345;0.448275862068966
Control.SRR15539874;33;32;0.333333333333333;22;11;0.166666666666667;0.333333333333333
Control.SRR15539874;30;32;0.6;12;18;0.1;0.4
Control.SRR15539874;31;32;0.419354838709677;18;13;0.0806451612903226;0.419354838709677
Control.SRR15539874;33;32;0.333333333333333;22;11;0.166666666666667;0.333333333333333
Control.SRR15539874;32;32;0.46875;17;15;0.03125;0.46875
Control.SRR15539874;35;32;0.6;14;21;0.1;0.4
Control.SRR15539874;33;32;0.424242424242424;19;14;0.0757575757575757;0.424242424242424
Control.SRR15539874;31;32;0.32258064516129;21;10;0.17741935483871;0.32258064516129
Control.SRR15539874;35;32;0.485714285714286;18;17;0.0142857142857143;0.485714285714286
Control.SRR15539874;32;32;0.5;16;16;0;0.5
Control.SRR15539874;30;32;0.4;18;12;0.1;0.4
Control.SRR15539874;33;32;0.424242424242424;19;14;0.0757575757575757;0.424242424242424
Control.SRR15539874;35;32;0.457142857142857;19;16;0.0428571428571429;0.457142857142857
Control.SRR15539874;35;32;0.628571428571429;13;22;0.128571428571429;0.371428571428571
Control.SRR15539874;37;32;0.459459459459459;20;17;0.0405405405405405;0.459459459459459
Control.SRR15539874;34;32;0.617647058823529;13;21;0.117647058823529;0.382352941176471
Control.SRR15539874;29;32;0.655172413793103;10;19;0.155172413793103;0.344827586206897
Control.SRR15539874;37;32;0.567567567567568;16;21;0.0675675675675675;0.432432432432432
Control.SRR15539874;35;32;0.628571428571429;13;22;0.128571428571429;0.371428571428571
Control.SRR15539874;37;32;0.459459459459459;20;17;0.0405405405405405;0.459459459459459
Control.SRR15539874;34;32;0.647058823529412;12;22;0.147058823529412;0.352941176470588
Control.SRR15539874;33;32;0.454545454545455;18;15;0.0454545454545455;0.454545454545455
Control.SRR15539874;34;32;0.5;17;17;0;0.5
Control.SRR15539874;29;32;0.482758620689655;15;14;0.0172413793103448;0.482758620689655
Control.SRR15539874;33;32;0.545454545454545;15;18;0.0454545454545454;0.454545454545455
Control.SRR15539874;30;32;0.466666666666667;16;14;0.0333333333333333;0.466666666666667
Control.SRR15539874;32;32;0.4375;18;14;0.0625;0.4375
Control.SRR15539874;32;32;0.5625;14;18;0.0625;0.4375
Control.SRR15539874;37;32;0.621621621621622;14;23;0.121621621621622;0.378378378378378
Control.SRR15539874;31;32;0.548387096774194;14;17;0.0483870967741935;0.451612903225806
Control.SRR15539874;35;32;0.457142857142857;19;16;0.0428571428571429;0.457142857142857
Control.SRR15539874;36;32;0.472222222222222;19;17;0.0277777777777778;0.472222222222222
Control.SRR15539874;36;32;0.472222222222222;19;17;0.0277777777777778;0.472222222222222
Control.SRR15539874;36;32;0.638888888888889;13;23;0.138888888888889;0.361111111111111
Control.SRR15539874;29;32;0.448275862068966;16;13;0.0517241379310345;0.448275862068966
Control.SRR15539874;33;32;0.424242424242424;19;14;0.0757575757575757;0.424242424242424
Control.SRR15539874;32;32;0.34375;21;11;0.15625;0.34375
Control.SRR15539874;29;32;0.379310344827586;18;11;0.120689655172414;0.379310344827586
Control.SRR15539874;32;32;0.6875;10;22;0.1875;0.3125
Control.SRR15539874;34;32;0.588235294117647;14;20;0.0882352941176471;0.411764705882353
Control.SRR15539874;37;32;0.432432432432432;21;16;0.0675675675675675;0.432432432432432
Control.SRR15539874;31;32;0.516129032258065;15;16;0.0161290322580645;0.483870967741935
Control.SRR15539874;35;32;0.4;21;14;0.1;0.4
Control.SRR15539874;36;32;0.555555555555556;16;20;0.0555555555555556;0.444444444444444
Control.SRR15539874;30;32;0.466666666666667;16;14;0.0333333333333333;0.466666666666667
Control.SRR15539874;36;32;0.444444444444444;20;16;0.0555555555555556;0.444444444444444
Control.SRR15539874;33;32;0.484848484848485;17;16;0.0151515151515151;0.484848484848485
Control.SRR15539874;30;32;0.533333333333333;14;16;0.0333333333333333;0.466666666666667
Control.SRR15539874;34;32;0.352941176470588;22;12;0.147058823529412;0.352941176470588
Control.SRR15539874;36;32;0.583333333333333;15;21;0.0833333333333334;0.416666666666667
Control.SRR15539874;32;32;0.46875;17;15;0.03125;0.46875
Control.SRR15539874;31;32;0.387096774193548;19;12;0.112903225806452;0.387096774193548
Control.SRR15539874;34;32;0.5;17;17;0;0.5
Control.SRR15539874;29;32;0.344827586206897;19;10;0.155172413793103;0.344827586206897
Control.SRR15539874;31;32;0.548387096774194;14;17;0.0483870967741935;0.451612903225806
Control.SRR15539874;32;32;0.5625;14;18;0.0625;0.4375
Control.SRR15539874;34;32;0.558823529411765;15;19;0.0588235294117647;0.441176470588235
Control.SRR15539874;32;32;0.5625;14;18;0.0625;0.4375
Control.SRR15539874;37;32;0.621621621621622;14;23;0.121621621621622;0.378378378378378
Control.SRR15539874;29;32;0.448275862068966;16;13;0.0517241379310345;0.448275862068966
Control.SRR15539874;35;32;0.514285714285714;17;18;0.0142857142857142;0.485714285714286
Control.SRR15539874;33;32;0.545454545454545;15;18;0.0454545454545454;0.454545454545455
Control.SRR15539874;33;32;0.454545454545455;18;15;0.0454545454545455;0.454545454545455
Control.SRR15539874;33;32;0.424242424242424;19;14;0.0757575757575757;0.424242424242424
Control.SRR15539874;33;32;0.575757575757576;14;19;0.0757575757575758;0.424242424242424
Control.SRR15539874;36;32;0.555555555555556;16;20;0.0555555555555556;0.444444444444444
Control.SRR15539874;34;32;0.5;17;17;0;0.5
Control.SRR15539874;35;32;0.428571428571429;20;15;0.0714285714285715;0.428571428571429
Control.SRR15539874;29;32;0.517241379310345;14;15;0.0172413793103449;0.482758620689655
Control.SRR15539874;30;32;0.466666666666667;16;14;0.0333333333333333;0.466666666666667
Control.SRR15539874;30;32;0.433333333333333;17;13;0.0666666666666667;0.433333333333333
Control.SRR15539874;31;32;0.548387096774194;14;17;0.0483870967741935;0.451612903225806
Control.SRR15539874;31;32;0.516129032258065;15;16;0.0161290322580645;0.483870967741935
Control.SRR15539874;30;32;0.4;18;12;0.1;0.4
Control.SRR15539874;34;32;0.470588235294118;18;16;0.0294117647058824;0.470588235294118
Control.SRR15539874;34;32;0.529411764705882;16;18;0.0294117647058824;0.470588235294118
Control.SRR15539874;34;32;0.470588235294118;18;16;0.0294117647058824;0.470588235294118
Control.SRR15539874;35;32;0.4;21;14;0.1;0.4
Control.SRR15539874;31;32;0.387096774193548;19;12;0.112903225806452;0.387096774193548
Control.SRR15539874;30;32;0.666666666666667;10;20;0.166666666666667;0.333333333333333
Control.SRR15539874;31;32;0.612903225806452;12;19;0.112903225806452;0.387096774193548
Control.SRR15539874;32;32;0.53125;15;17;0.03125;0.46875
Control.SRR15539874;34;32;0.558823529411765;15;19;0.0588235294117647;0.441176470588235
Control.SRR15539874;31;32;0.645161290322581;11;20;0.145161290322581;0.354838709677419
Control.SRR15539874;37;32;0.486486486486487;19;18;0.0135135135135135;0.486486486486487
Control.SRR15539874;36;32;0.583333333333333;15;21;0.0833333333333334;0.416666666666667
Control.SRR15539874;35;32;0.457142857142857;19;16;0.0428571428571429;0.457142857142857
Control.SRR15539874;37;32;0.513513513513513;18;19;0.0135135135135135;0.486486486486487
Control.SRR15539874;30;32;0.3;21;9;0.2;0.3
Control.SRR15539874;32;32;0.46875;17;15;0.03125;0.46875
Control.SRR15539874;33;32;0.575757575757576;14;19;0.0757575757575758;0.424242424242424
Control.SRR15539874;32;32;0.46875;17;15;0.03125;0.46875
Control.SRR15539874;35;32;0.4;21;14;0.1;0.4
Control.SRR15539874;37;32;0.405405405405405;22;15;0.0945945945945946;0.405405405405405
Control.SRR15539874;34;32;0.529411764705882;16;18;0.0294117647058824;0.470588235294118
Control.SRR15539874;29;32;0.482758620689655;15;14;0.0172413793103448;0.482758620689655
Control.SRR15539874;35;32;0.657142857142857;12;23;0.157142857142857;0.342857142857143
Control.SRR15539874;29;32;0.413793103448276;17;12;0.0862068965517241;0.413793103448276
Control.SRR15539874;33;32;0.484848484848485;17;16;0.0151515151515151;0.484848484848485
Control.SRR15539874;37;32;0.621621621621622;14;23;0.121621621621622;0.378378378378378
Control.SRR15539874;32;32;0.4375;18;14;0.0625;0.4375
Control.SRR15539874;33;32;0.575757575757576;14;19;0.0757575757575758;0.424242424242424
Control.SRR15539874;36;32;0.527777777777778;17;19;0.0277777777777778;0.472222222222222
Control.SRR15539874;35;32;0.428571428571429;20;15;0.0714285714285715;0.428571428571429
Control.SRR15539874;29;32;0.517241379310345;14;15;0.0172413793103449;0.482758620689655
Control.SRR15539874;33;32;0.333333333333333;22;11;0.166666666666667;0.333333333333333
Control.SRR15539874;29;32;0.379310344827586;18;11;0.120689655172414;0.379310344827586
Control.SRR15539874;35;32;0.714285714285714;10;25;0.214285714285714;0.285714285714286
Control.SRR15539874;29;32;0.448275862068966;16;13;0.0517241379310345;0.448275862068966
Control.SRR15539874;30;32;0.533333333333333;14;16;0.0333333333333333;0.466666666666667
Control.SRR15539874;29;32;0.586206896551724;12;17;0.0862068965517241;0.413793103448276
Control.SRR15539874;33;32;0.393939393939394;20;13;0.106060606060606;0.393939393939394
Control.SRR15539874;36;32;0.638888888888889;13;23;0.138888888888889;0.361111111111111
Control.SRR15539874;31;32;0.451612903225806;17;14;0.0483870967741936;0.451612903225806
Control.SRR15539874;32;32;0.59375;13;19;0.09375;0.40625
Control.SRR15539874;31;32;0.483870967741935;16;15;0.0161290322580645;0.483870967741935
Control.SRR15539874;35;32;0.514285714285714;17;18;0.0142857142857142;0.485714285714286
Control.SRR15539874;33;32;0.484848484848485;17;16;0.0151515151515151;0.484848484848485
Control.SRR15539874;35;32;0.514285714285714;17;18;0.0142857142857142;0.485714285714286
Control.SRR15539874;37;32;0.486486486486487;19;18;0.0135135135135135;0.486486486486487
Control.SRR15539874;30;32;0.533333333333333;14;16;0.0333333333333333;0.466666666666667
Control.SRR15539874;32;32;0.34375;21;11;0.15625;0.34375
Control.SRR15539874;34;32;0.558823529411765;15;19;0.0588235294117647;0.441176470588235
Control.SRR15539874;29;32;0.586206896551724;12;17;0.0862068965517241;0.413793103448276
Control.SRR15539874;30;32;0.5;15;15;0;0.5
Control.SRR15539874;32;32;0.6875;10;22;0.1875;0.3125
Control.SRR15539874;29;32;0.517241379310345;14;15;0.0172413793103449;0.482758620689655
Control.SRR15539874;31;32;0.548387096774194;14;17;0.0483870967741935;0.451612903225806
Control.SRR15539874;34;32;0.382352941176471;21;13;0.117647058823529;0.382352941176471
Control.SRR15539874;31;32;0.548387096774194;14;17;0.0483870967741935;0.451612903225806
Control.SRR15539874;35;32;0.485714285714286;18;17;0.0142857142857143;0.485714285714286
Control.SRR15539874;32;32;0.46875;17;15;0.03125;0.46875
Control.SRR15539874;35;32;0.485714285714286;18;17;0.0142857142857143;0.485714285714286
Control.SRR15539874;37;32;0.648648648648649;13;24;0.148648648648649;0.351351351351351
Control.SRR15539874;34;32;0.588235294117647;14;20;0.0882352941176471;0.411764705882353
Control.SRR15539874;30;32;0.5;15;15;0;0.5
Control.SRR15539874;29;32;0.379310344827586;18;11;0.120689655172414;0.379310344827586
Control.SRR15539874;37;32;0.324324324324324;25;12;0.175675675675676;0.324324324324324
Control.SRR15539874;34;32;0.470588235294118;18;16;0.0294117647058824;0.470588235294118
Control.SRR15539874;36;32;0.416666666666667;21;15;0.0833333333333333;0.416666666666667
Control.SRR15539874;32;32;0.5;16;16;0;0.5
Control.SRR15539874;37;32;0.486486486486487;19;18;0.0135135135135135;0.486486486486487
Control.SRR15539874;34;32;0.382352941176471;21;13;0.117647058823529;0.382352941176471
Control.SRR15539874;37;32;0.621621621621622;14;23;0.121621621621622;0.378378378378378
Control.SRR15539874;33;32;0.363636363636364;21;12;0.136363636363636;0.363636363636364
Control.SRR15539874;34;32;0.441176470588235;19;15;0.0588235294117647;0.441176470588235
Control.SRR15539874;34;32;0.470588235294118;18;16;0.0294117647058824;0.470588235294118
Control.SRR15539874;36;32;0.472222222222222;19;17;0.0277777777777778;0.472222222222222
Control.SRR15539874;35;32;0.485714285714286;18;17;0.0142857142857143;0.485714285714286
Control.SRR15539874;29;32;0.448275862068966;16;13;0.0517241379310345;0.448275862068966
Control.SRR15539874;30;32;0.566666666666667;13;17;0.0666666666666667;0.433333333333333
Control.SRR15539874;29;32;0.517241379310345;14;15;0.0172413793103449;0.482758620689655
Control.SRR15539874;36;32;0.694444444444444;11;25;0.194444444444444;0.305555555555556
Control.SRR15539874;36;32;0.416666666666667;21;15;0.0833333333333333;0.416666666666667
Control.SRR15539874;35;32;0.428571428571429;20;15;0.0714285714285715;0.428571428571429
Control.SRR15539874;34;32;0.441176470588235;19;15;0.0588235294117647;0.441176470588235
Control.SRR15539874;30;32;0.566666666666667;13;17;0.0666666666666667;0.433333333333333
Control.SRR15539874;35;32;0.514285714285714;17;18;0.0142857142857142;0.485714285714286
Control.SRR15539874;37;32;0.567567567567568;16;21;0.0675675675675675;0.432432432432432
Control.SRR15539874;29;32;0.482758620689655;15;14;0.0172413793103448;0.482758620689655
Control.SRR15539874;33;32;0.393939393939394;20;13;0.106060606060606;0.393939393939394
Control.SRR15539874;30;32;0.666666666666667;10;20;0.166666666666667;0.333333333333333
Control.SRR15539874;29;32;0.586206896551724;12;17;0.0862068965517241;0.413793103448276
Control.SRR15539874;36;32;0.527777777777778;17;19;0.0277777777777778;0.472222222222222
Control.SRR15539874;30;32;0.433333333333333;17;13;0.0666666666666667;0.433333333333333
Control.SRR15539874;34;32;0.588235294117647;14;20;0.0882352941176471;0.411764705882353
Control.SRR15539874;33;32;0.454545454545455;18;15;0.0454545454545455;0.454545454545455
Control.SRR15539874;35;32;0.428571428571429;20;15;0.0714285714285715;0.428571428571429
Control.SRR15539874;29;32;0.551724137931034;13;16;0.0517241379310345;0.448275862068966
Control.SRR15539874;37;32;0.621621621621622;14;23;0.121621621621622;0.378378378378378
Control.SRR15539874;35;32;0.457142857142857;19;16;0.0428571428571429;0.457142857142857
Control.SRR15539874;29;32;0.413793103448276;17;12;0.0862068965517241;0.413793103448276
Control.SRR15539874;31;32;0.516129032258065;15;16;0.0161290322580645;0.483870967741935
Control.SRR15539874;30;32;0.6;12;18;0.1;0.4
Control.SRR15539874;36;32;0.527777777777778;17;19;0.0277777777777778;0.472222222222222
Control.SRR15539874;34;32;0.558823529411765;15;19;0.0588235294117647;0.441176470588235
Control.SRR15539874;33;32;0.515151515151515;16;17;0.0151515151515151;0.484848484848485
Control.SRR15539874;31;32;0.580645161290323;13;18;0.0806451612903226;0.419354838709677
Control.SRR15539874;34;32;0.441176470588235;19;15;0.0588235294117647;0.441176470588235
Control.SRR15539874;32;32;0.28125;23;9;0.21875;0.28125
Control.SRR15539874;32;32;0.53125;15;17;0.03125;0.46875
Control.SRR15539874;34;32;0.441176470588235;19;15;0.0588235294117647;0.441176470588235
Control.SRR15539874;36;32;0.583333333333333;15;21;0.0833333333333334;0.416666666666667
Control.SRR15539874;37;32;0.567567567567568;16;21;0.0675675675675675;0.432432432432432
Control.SRR15539874;29;32;0.517241379310345;14;15;0.0172413793103449;0.482758620689655
Control.SRR15539874;32;32;0.4375;18;14;0.0625;0.4375
Control.SRR15539874;29;32;0.413793103448276;17;12;0.0862068965517241;0.413793103448276
Control.SRR15539874;36;32;0.444444444444444;20;16;0.0555555555555556;0.444444444444444
Control.SRR15539874;36;32;0.472222222222222;19;17;0.0277777777777778;0.472222222222222
Control.SRR15539874;32;32;0.34375;21;11;0.15625;0.34375
Control.SRR15539874;35;32;0.542857142857143;16;19;0.0428571428571428;0.457142857142857
Control.SRR15539874;37;32;0.486486486486487;19;18;0.0135135135135135;0.486486486486487
Control.SRR15539874;34;32;0.5;17;17;0;0.5
Control.SRR15539874;34;32;0.558823529411765;15;19;0.0588235294117647;0.441176470588235
Control.SRR15539874;33;32;0.424242424242424;19;14;0.0757575757575757;0.424242424242424
Control.SRR15539874;33;32;0.393939393939394;20;13;0.106060606060606;0.393939393939394
Control.SRR15539874;35;32;0.428571428571429;20;15;0.0714285714285715;0.428571428571429
Control.SRR15539874;35;32;0.571428571428571;15;20;0.0714285714285714;0.428571428571429
Control.SRR15539874;35;32;0.542857142857143;16;19;0.0428571428571428;0.457142857142857
Control.SRR15539874;36;32;0.694444444444444;11;25;0.194444444444444;0.305555555555556
Control.SRR15539874;35;32;0.485714285714286;18;17;0.0142857142857143;0.485714285714286
Control.SRR15539874;33;32;0.575757575757576;14;19;0.0757575757575758;0.424242424242424
Control.SRR15539874;36;32;0.583333333333333;15;21;0.0833333333333334;0.416666666666667
Control.SRR15539874;32;32;0.46875;17;15;0.03125;0.46875
Control.SRR15539874;37;32;0.405405405405405;22;15;0.0945945945945946;0.405405405405405
Control.SRR15539874;29;32;0.655172413793103;10;19;0.155172413793103;0.344827586206897
Control.SRR15539874;37;32;0.486486486486487;19;18;0.0135135135135135;0.486486486486487
Control.SRR15539874;34;32;0.470588235294118;18;16;0.0294117647058824;0.470588235294118
Control.SRR15539874;33;32;0.606060606060606;13;20;0.106060606060606;0.393939393939394
Control.SRR15539874;32;32;0.46875;17;15;0.03125;0.46875
Control.SRR15539874;31;32;0.645161290322581;11;20;0.145161290322581;0.354838709677419
Control.SRR15539874;35;32;0.571428571428571;15;20;0.0714285714285714;0.428571428571429
Control.SRR15539874;35;32;0.6;14;21;0.1;0.4
Control.SRR15539874;33;32;0.484848484848485;17;16;0.0151515151515151;0.484848484848485
Control.SRR15539874;29;32;0.586206896551724;12;17;0.0862068965517241;0.413793103448276
Control.SRR15539874;33;32;0.484848484848485;17;16;0.0151515151515151;0.484848484848485
Control.SRR15539874;36;32;0.472222222222222;19;17;0.0277777777777778;0.472222222222222
Control.SRR15539874;33;32;0.636363636363636;12;21;0.136363636363636;0.363636363636364
Control.SRR15539874;36;32;0.5;18;18;0;0.5
Control.SRR15539874;33;32;0.484848484848485;17;16;0.0151515151515151;0.484848484848485
Control.SRR15539874;29;32;0.448275862068966;16;13;0.0517241379310345;0.448275862068966
Control.SRR15539874;34;32;0.529411764705882;16;18;0.0294117647058824;0.470588235294118
Control.SRR15539874;34;32;0.558823529411765;15;19;0.0588235294117647;0.441176470588235
Control.SRR15539874;31;32;0.548387096774194;14;17;0.0483870967741935;0.451612903225806
Control.SRR15539874;35;32;0.542857142857143;16;19;0.0428571428571428;0.457142857142857
Control.SRR15539874;29;32;0.448275862068966;16;13;0.0517241379310345;0.448275862068966
Control.SRR15539874;33;32;0.515151515151515;16;17;0.0151515151515151;0.484848484848485
Control.SRR15539874;34;32;0.529411764705882;16;18;0.0294117647058824;0.470588235294118
Control.SRR15539874;35;32;0.571428571428571;15;20;0.0714285714285714;0.428571428571429
Control.SRR15539874;33;32;0.454545454545455;18;15;0.0454545454545455;0.454545454545455
Control.SRR15539874;35;32;0.428571428571429;20;15;0.0714285714285715;0.428571428571429
Control.SRR15539874;33;32;0.545454545454545;15;18;0.0454545454545454;0.454545454545455
Control.SRR15539874;33;32;0.333333333333333;22;11;0.166666666666667;0.333333333333333
Control.SRR15539874;37;32;0.648648648648649;13;24;0.148648648648649;0.351351351351351
Control.SRR15539874;32;32;0.5625;14;18;0.0625;0.4375
Control.SRR15539874;34;32;0.558823529411765;15;19;0.0588235294117647;0.441176470588235
Control.SRR15539874;31;32;0.483870967741935;16;15;0.0161290322580645;0.483870967741935
Control.SRR15539874;33;32;0.484848484848485;17;16;0.0151515151515151;0.484848484848485
Control.SRR15539874;34;32;0.529411764705882;16;18;0.0294117647058824;0.470588235294118
Control.SRR15539874;30;32;0.533333333333333;14;16;0.0333333333333333;0.466666666666667
Control.SRR15539874;33;32;0.575757575757576;14;19;0.0757575757575758;0.424242424242424
Control.SRR15539874;32;32;0.59375;13;19;0.09375;0.40625
Control.SRR15539874;36;32;0.361111111111111;23;13;0.138888888888889;0.361111111111111
Control.SRR15539874;33;32;0.727272727272727;9;24;0.227272727272727;0.272727272727273
Control.SRR15539874;33;32;0.393939393939394;20;13;0.106060606060606;0.393939393939394
Control.SRR15539874;34;32;0.558823529411765;15;19;0.0588235294117647;0.441176470588235
Control.SRR15539874;34;32;0.352941176470588;22;12;0.147058823529412;0.352941176470588
Control.SRR15539874;36;32;0.388888888888889;22;14;0.111111111111111;0.388888888888889
Control.SRR15539874;31;32;0.419354838709677;18;13;0.0806451612903226;0.419354838709677
Control.SRR15539874;32;32;0.5625;14;18;0.0625;0.4375
Control.SRR15539874;31;32;0.451612903225806;17;14;0.0483870967741936;0.451612903225806
Control.SRR15539874;36;32;0.472222222222222;19;17;0.0277777777777778;0.472222222222222
Control.SRR15539874;35;32;0.514285714285714;17;18;0.0142857142857142;0.485714285714286
Control.SRR15539874;36;32;0.694444444444444;11;25;0.194444444444444;0.305555555555556
Control.SRR15539874;32;32;0.625;12;20;0.125;0.375
Control.SRR15539874;29;32;0.620689655172414;11;18;0.120689655172414;0.379310344827586
Control.SRR15539874;36;32;0.416666666666667;21;15;0.0833333333333333;0.416666666666667
Control.SRR15539874;32;32;0.40625;19;13;0.09375;0.40625
Control.SRR15539874;33;32;0.515151515151515;16;17;0.0151515151515151;0.484848484848485
Control.SRR15539874;33;32;0.515151515151515;16;17;0.0151515151515151;0.484848484848485
Control.SRR15539874;29;32;0.413793103448276;17;12;0.0862068965517241;0.413793103448276
Control.SRR15539874;35;32;0.457142857142857;19;16;0.0428571428571429;0.457142857142857
Control.SRR15539874;32;32;0.53125;15;17;0.03125;0.46875
Control.SRR15539874;34;32;0.558823529411765;15;19;0.0588235294117647;0.441176470588235
Control.SRR15539874;36;32;0.472222222222222;19;17;0.0277777777777778;0.472222222222222
Control.SRR15539874;37;32;0.621621621621622;14;23;0.121621621621622;0.378378378378378
Control.SRR15539874;36;32;0.472222222222222;19;17;0.0277777777777778;0.472222222222222
Control.SRR15539874;36;32;0.527777777777778;17;19;0.0277777777777778;0.472222222222222
Control.SRR15539874;32;32;0.53125;15;17;0.03125;0.46875
Control.SRR15539874;37;32;0.486486486486487;19;18;0.0135135135135135;0.486486486486487
Control.SRR15539874;35;32;0.542857142857143;16;19;0.0428571428571428;0.457142857142857
Control.SRR15539874;31;32;0.483870967741935;16;15;0.0161290322580645;0.483870967741935
Control.SRR15539874;34;32;0.529411764705882;16;18;0.0294117647058824;0.470588235294118
Control.SRR15539874;35;32;0.428571428571429;20;15;0.0714285714285715;0.428571428571429
Control.SRR15539874;33;32;0.515151515151515;16;17;0.0151515151515151;0.484848484848485
Control.SRR15539874;31;32;0.516129032258065;15;16;0.0161290322580645;0.483870967741935
Control.SRR15539874;32;32;0.5;16;16;0;0.5
Control.SRR15539874;33;32;0.393939393939394;20;13;0.106060606060606;0.393939393939394
Control.SRR15539874;33;32;0.575757575757576;14;19;0.0757575757575758;0.424242424242424
Control.SRR15539874;35;32;0.314285714285714;24;11;0.185714285714286;0.314285714285714
Control.SRR15539874;31;32;0.516129032258065;15;16;0.0161290322580645;0.483870967741935
Control.SRR15539874;31;32;0.612903225806452;12;19;0.112903225806452;0.387096774193548
Control.SRR15539874;34;32;0.411764705882353;20;14;0.0882352941176471;0.411764705882353
Control.SRR15539874;31;32;0.548387096774194;14;17;0.0483870967741935;0.451612903225806
Control.SRR15539874;36;32;0.472222222222222;19;17;0.0277777777777778;0.472222222222222
Control.SRR15539874;36;32;0.527777777777778;17;19;0.0277777777777778;0.472222222222222
Control.SRR15539874;35;32;0.6;14;21;0.1;0.4
Control.SRR15539874;36;32;0.416666666666667;21;15;0.0833333333333333;0.416666666666667
Control.SRR15539874;37;32;0.702702702702703;11;26;0.202702702702703;0.297297297297297
Control.SRR15539874;37;32;0.486486486486487;19;18;0.0135135135135135;0.486486486486487
Control.SRR15539874;35;32;0.514285714285714;17;18;0.0142857142857142;0.485714285714286
Control.SRR15539874;35;32;0.428571428571429;20;15;0.0714285714285715;0.428571428571429
Control.SRR15539874;37;32;0.540540540540541;17;20;0.0405405405405406;0.459459459459459
Control.SRR15539874;37;32;0.432432432432432;21;16;0.0675675675675675;0.432432432432432
Control.SRR15539874;36;32;0.5;18;18;0;0.5
Control.SRR15539874;32;32;0.40625;19;13;0.09375;0.40625
Control.SRR15539874;32;32;0.40625;19;13;0.09375;0.40625
Control.SRR15539874;35;32;0.4;21;14;0.1;0.4
Control.SRR15539874;34;32;0.5;17;17;0;0.5
Control.SRR15539874;37;32;0.351351351351351;24;13;0.148648648648649;0.351351351351351
Control.SRR15539874;29;32;0.241379310344828;22;7;0.258620689655172;0.241379310344828
Control.SRR15539874;32;32;0.28125;23;9;0.21875;0.28125
Control.SRR15539874;37;32;0.486486486486487;19;18;0.0135135135135135;0.486486486486487
Control.SRR15539874;35;32;0.485714285714286;18;17;0.0142857142857143;0.485714285714286
Control.SRR15539874;33;32;0.393939393939394;20;13;0.106060606060606;0.393939393939394
Control.SRR15539874;31;32;0.451612903225806;17;14;0.0483870967741936;0.451612903225806
Control.SRR15539874;33;32;0.515151515151515;16;17;0.0151515151515151;0.484848484848485
Control.SRR15539874;29;32;0.551724137931034;13;16;0.0517241379310345;0.448275862068966
Control.SRR15539874;36;32;0.638888888888889;13;23;0.138888888888889;0.361111111111111
Control.SRR15539874;31;32;0.451612903225806;17;14;0.0483870967741936;0.451612903225806
Control.SRR15539874;31;32;0.516129032258065;15;16;0.0161290322580645;0.483870967741935
Control.SRR15539874;34;32;0.558823529411765;15;19;0.0588235294117647;0.441176470588235
Control.SRR15539874;33;32;0.454545454545455;18;15;0.0454545454545455;0.454545454545455
Control.SRR15539874;31;32;0.419354838709677;18;13;0.0806451612903226;0.419354838709677
Control.SRR15539874;30;32;0.566666666666667;13;17;0.0666666666666667;0.433333333333333
Control.SRR15539874;31;32;0.483870967741935;16;15;0.0161290322580645;0.483870967741935
Control.SRR15539874;29;32;0.551724137931034;13;16;0.0517241379310345;0.448275862068966
Control.SRR15539874;33;32;0.606060606060606;13;20;0.106060606060606;0.393939393939394
Control.SRR15539874;31;32;0.32258064516129;21;10;0.17741935483871;0.32258064516129
Control.SRR15539874;33;32;0.484848484848485;17;16;0.0151515151515151;0.484848484848485
Control.SRR15539874;30;32;0.3;21;9;0.2;0.3
Control.SRR15539874;36;32;0.5;18;18;0;0.5
Control.SRR15539874;32;32;0.4375;18;14;0.0625;0.4375
Control.SRR15539874;36;32;0.611111111111111;14;22;0.111111111111111;0.388888888888889
Control.SRR15539874;34;32;0.470588235294118;18;16;0.0294117647058824;0.470588235294118
Control.SRR15539874;34;32;0.470588235294118;18;16;0.0294117647058824;0.470588235294118
Control.SRR15539874;30;32;0.433333333333333;17;13;0.0666666666666667;0.433333333333333
Control.SRR15539874;31;32;0.612903225806452;12;19;0.112903225806452;0.387096774193548
Control.SRR15539874;30;32;0.466666666666667;16;14;0.0333333333333333;0.466666666666667
Control.SRR15539874;35;32;0.4;21;14;0.1;0.4
Control.SRR15539874;35;32;0.6;14;21;0.1;0.4
Control.SRR15539874;37;32;0.378378378378378;23;14;0.121621621621622;0.378378378378378
Control.SRR15539874;36;32;0.472222222222222;19;17;0.0277777777777778;0.472222222222222
Control.SRR15539874;33;32;0.545454545454545;15;18;0.0454545454545454;0.454545454545455
Control.SRR15539874;37;32;0.513513513513513;18;19;0.0135135135135135;0.486486486486487
Control.SRR15539874;36;32;0.527777777777778;17;19;0.0277777777777778;0.472222222222222
Control.SRR15539874;30;32;0.566666666666667;13;17;0.0666666666666667;0.433333333333333
Control.SRR15539874;34;32;0.441176470588235;19;15;0.0588235294117647;0.441176470588235
Control.SRR15539874;34;32;0.382352941176471;21;13;0.117647058823529;0.382352941176471
Control.SRR15539874;30;32;0.7;9;21;0.2;0.3
Control.SRR15539874;34;32;0.470588235294118;18;16;0.0294117647058824;0.470588235294118
Control.SRR15539874;32;32;0.40625;19;13;0.09375;0.40625
Control.SRR15539874;31;32;0.354838709677419;20;11;0.145161290322581;0.354838709677419
Control.SRR15539874;31;32;0.483870967741935;16;15;0.0161290322580645;0.483870967741935
Control.SRR15539874;36;32;0.472222222222222;19;17;0.0277777777777778;0.472222222222222
Control.SRR15539874;33;32;0.393939393939394;20;13;0.106060606060606;0.393939393939394
Control.SRR15539874;33;32;0.454545454545455;18;15;0.0454545454545455;0.454545454545455
Control.SRR15539874;34;32;0.470588235294118;18;16;0.0294117647058824;0.470588235294118
Control.SRR15539874;37;32;0.351351351351351;24;13;0.148648648648649;0.351351351351351
Control.SRR15539874;35;32;0.514285714285714;17;18;0.0142857142857142;0.485714285714286
Control.SRR15539874;37;32;0.648648648648649;13;24;0.148648648648649;0.351351351351351
Control.SRR15539874;29;32;0.586206896551724;12;17;0.0862068965517241;0.413793103448276
Control.SRR15539874;30;32;0.633333333333333;11;19;0.133333333333333;0.366666666666667
Control.SRR15539874;31;32;0.516129032258065;15;16;0.0161290322580645;0.483870967741935
Control.SRR15539874;37;32;0.567567567567568;16;21;0.0675675675675675;0.432432432432432
Control.SRR15539874;32;32;0.625;12;20;0.125;0.375
Control.SRR15539874;36;32;0.416666666666667;21;15;0.0833333333333333;0.416666666666667
Control.SRR15539874;37;32;0.459459459459459;20;17;0.0405405405405405;0.459459459459459
Control.SRR15539874;30;32;0.433333333333333;17;13;0.0666666666666667;0.433333333333333
Control.SRR15539874;31;32;0.516129032258065;15;16;0.0161290322580645;0.483870967741935
Control.SRR15539874;36;32;0.611111111111111;14;22;0.111111111111111;0.388888888888889
Control.SRR15539874;34;32;0.529411764705882;16;18;0.0294117647058824;0.470588235294118
Control.SRR15539874;31;32;0.516129032258065;15;16;0.0161290322580645;0.483870967741935
Control.SRR15539874;32;32;0.625;12;20;0.125;0.375
Control.SRR15539874;33;32;0.545454545454545;15;18;0.0454545454545454;0.454545454545455
Control.SRR15539874;33;32;0.575757575757576;14;19;0.0757575757575758;0.424242424242424
Control.SRR15539874;35;32;0.485714285714286;18;17;0.0142857142857143;0.485714285714286
Control.SRR15539874;29;32;0.482758620689655;15;14;0.0172413793103448;0.482758620689655
Control.SRR15539874;37;32;0.459459459459459;20;17;0.0405405405405405;0.459459459459459
Control.SRR15539874;35;32;0.6;14;21;0.1;0.4
Control.SRR15539874;32;32;0.46875;17;15;0.03125;0.46875
Control.SRR15539874;30;32;0.433333333333333;17;13;0.0666666666666667;0.433333333333333
Control.SRR15539874;32;32;0.1875;26;6;0.3125;0.1875
Control.SRR15539874;30;32;0.7;9;21;0.2;0.3
Control.SRR15539874;31;32;0.419354838709677;18;13;0.0806451612903226;0.419354838709677
Control.SRR15539874;36;32;0.583333333333333;15;21;0.0833333333333334;0.416666666666667
Control.SRR15539874;33;32;0.393939393939394;20;13;0.106060606060606;0.393939393939394
Control.SRR15539874;36;32;0.361111111111111;23;13;0.138888888888889;0.361111111111111
Control.SRR15539874;31;32;0.548387096774194;14;17;0.0483870967741935;0.451612903225806
Control.SRR15539874;37;32;0.540540540540541;17;20;0.0405405405405406;0.459459459459459
Control.SRR15539874;32;32;0.40625;19;13;0.09375;0.40625
Control.SRR15539874;34;32;0.470588235294118;18;16;0.0294117647058824;0.470588235294118
Control.SRR15539874;35;32;0.485714285714286;18;17;0.0142857142857143;0.485714285714286
Control.SRR15539874;35;32;0.4;21;14;0.1;0.4
Control.SRR15539874;31;32;0.516129032258065;15;16;0.0161290322580645;0.483870967741935
Control.SRR15539874;34;32;0.588235294117647;14;20;0.0882352941176471;0.411764705882353
Control.SRR15539874;29;32;0.586206896551724;12;17;0.0862068965517241;0.413793103448276
Control.SRR15539874;35;32;0.457142857142857;19;16;0.0428571428571429;0.457142857142857
Control.SRR15539874;33;32;0.515151515151515;16;17;0.0151515151515151;0.484848484848485
Control.SRR15539874;34;32;0.382352941176471;21;13;0.117647058823529;0.382352941176471
Control.SRR15539874;34;32;0.588235294117647;14;20;0.0882352941176471;0.411764705882353
Control.SRR15539874;30;32;0.7;9;21;0.2;0.3
Control.SRR15539874;31;32;0.419354838709677;18;13;0.0806451612903226;0.419354838709677
Control.SRR15539874;32;32;0.46875;17;15;0.03125;0.46875
Control.SRR15539874;30;32;0.4;18;12;0.1;0.4
Control.SRR15539874;30;32;0.5;15;15;0;0.5
Control.SRR15539874;31;32;0.451612903225806;17;14;0.0483870967741936;0.451612903225806
Control.SRR15539874;32;32;0.53125;15;17;0.03125;0.46875
Control.SRR15539874;30;32;0.5;15;15;0;0.5
Control.SRR15539874;31;32;0.451612903225806;17;14;0.0483870967741936;0.451612903225806
Control.SRR15539874;32;32;0.3125;22;10;0.1875;0.3125
Control.SRR15539874;36;32;0.305555555555556;25;11;0.194444444444444;0.305555555555556
Control.SRR15539874;35;32;0.742857142857143;9;26;0.242857142857143;0.257142857142857
Control.SRR15539874;29;32;0.310344827586207;20;9;0.189655172413793;0.310344827586207
Control.SRR15539874;35;32;0.685714285714286;11;24;0.185714285714286;0.314285714285714
Control.SRR15539874;33;32;0.484848484848485;17;16;0.0151515151515151;0.484848484848485
Control.SRR15539874;30;32;0.533333333333333;14;16;0.0333333333333333;0.466666666666667
Control.SRR15539874;34;32;0.411764705882353;20;14;0.0882352941176471;0.411764705882353
Control.SRR15539874;36;32;0.416666666666667;21;15;0.0833333333333333;0.416666666666667
Control.SRR15539874;35;32;0.4;21;14;0.1;0.4
Control.SRR15539874;36;32;0.361111111111111;23;13;0.138888888888889;0.361111111111111
Control.SRR15539874;34;32;0.588235294117647;14;20;0.0882352941176471;0.411764705882353
Control.SRR15539874;35;32;0.542857142857143;16;19;0.0428571428571428;0.457142857142857
Control.SRR15539874;37;32;0.594594594594595;15;22;0.0945945945945946;0.405405405405405
Control.SRR15539874;35;32;0.514285714285714;17;18;0.0142857142857142;0.485714285714286
Control.SRR15539874;30;32;0.4;18;12;0.1;0.4
Control.SRR15539874;30;32;0.433333333333333;17;13;0.0666666666666667;0.433333333333333
Control.SRR15539874;32;32;0.46875;17;15;0.03125;0.46875
Control.SRR15539874;30;32;0.466666666666667;16;14;0.0333333333333333;0.466666666666667
Control.SRR15539874;31;32;0.354838709677419;20;11;0.145161290322581;0.354838709677419
Control.SRR15539874;33;32;0.484848484848485;17;16;0.0151515151515151;0.484848484848485
Control.SRR15539874;37;32;0.567567567567568;16;21;0.0675675675675675;0.432432432432432
Control.SRR15539874;35;32;0.6;14;21;0.1;0.4
Control.SRR15539874;36;32;0.5;18;18;0;0.5
Control.SRR15539874;32;32;0.5625;14;18;0.0625;0.4375
Control.SRR15539874;31;32;0.387096774193548;19;12;0.112903225806452;0.387096774193548
Control.SRR15539874;37;32;0.486486486486487;19;18;0.0135135135135135;0.486486486486487
Control.SRR15539874;36;32;0.583333333333333;15;21;0.0833333333333334;0.416666666666667
Control.SRR15539874;33;32;0.575757575757576;14;19;0.0757575757575758;0.424242424242424
Control.SRR15539874;30;32;0.666666666666667;10;20;0.166666666666667;0.333333333333333
Control.SRR15539874;29;32;0.517241379310345;14;15;0.0172413793103449;0.482758620689655
Control.SRR15539874;36;32;0.361111111111111;23;13;0.138888888888889;0.361111111111111
Control.SRR15539874;36;32;0.388888888888889;22;14;0.111111111111111;0.388888888888889
Control.SRR15539874;30;32;0.566666666666667;13;17;0.0666666666666667;0.433333333333333
Control.SRR15539874;36;32;0.5;18;18;0;0.5
Control.SRR15539874;34;32;0.676470588235294;11;23;0.176470588235294;0.323529411764706
Control.SRR15539874;35;32;0.4;21;14;0.1;0.4
Control.SRR15539874;37;32;0.540540540540541;17;20;0.0405405405405406;0.459459459459459
Control.SRR15539874;32;32;0.46875;17;15;0.03125;0.46875
Control.SRR15539874;34;32;0.470588235294118;18;16;0.0294117647058824;0.470588235294118
Control.SRR15539874;29;32;0.517241379310345;14;15;0.0172413793103449;0.482758620689655
Control.SRR15539874;34;32;0.529411764705882;16;18;0.0294117647058824;0.470588235294118
Control.SRR15539874;31;32;0.548387096774194;14;17;0.0483870967741935;0.451612903225806
Control.SRR15539874;35;32;0.485714285714286;18;17;0.0142857142857143;0.485714285714286
Control.SRR15539874;32;32;0.375;20;12;0.125;0.375
Control.SRR15539874;36;32;0.583333333333333;15;21;0.0833333333333334;0.416666666666667
Control.SRR15539874;30;32;0.466666666666667;16;14;0.0333333333333333;0.466666666666667
Control.SRR15539874;34;32;0.529411764705882;16;18;0.0294117647058824;0.470588235294118
Control.SRR15539874;37;32;0.567567567567568;16;21;0.0675675675675675;0.432432432432432
Control.SRR15539874;33;32;0.515151515151515;16;17;0.0151515151515151;0.484848484848485
Control.SRR15539874;31;32;0.483870967741935;16;15;0.0161290322580645;0.483870967741935
Control.SRR15539874;32;32;0.46875;17;15;0.03125;0.46875
Control.SRR15539874;37;32;0.594594594594595;15;22;0.0945945945945946;0.405405405405405
Control.SRR15539874;31;32;0.612903225806452;12;19;0.112903225806452;0.387096774193548
Control.SRR15539874;37;32;0.486486486486487;19;18;0.0135135135135135;0.486486486486487
Control.SRR15539874;32;32;0.40625;19;13;0.09375;0.40625
Control.SRR15539874;29;32;0.655172413793103;10;19;0.155172413793103;0.344827586206897
Control.SRR15539874;30;32;0.466666666666667;16;14;0.0333333333333333;0.466666666666667
Control.SRR15539874;35;32;0.514285714285714;17;18;0.0142857142857142;0.485714285714286
Control.SRR15539874;36;32;0.583333333333333;15;21;0.0833333333333334;0.416666666666667
Control.SRR15539874;29;32;0.413793103448276;17;12;0.0862068965517241;0.413793103448276
Control.SRR15539874;30;32;0.4;18;12;0.1;0.4
Control.SRR15539874;33;32;0.515151515151515;16;17;0.0151515151515151;0.484848484848485
Control.SRR15539874;32;32;0.34375;21;11;0.15625;0.34375
Control.SRR15539874;29;32;0.551724137931034;13;16;0.0517241379310345;0.448275862068966
Control.SRR15539874;36;32;0.638888888888889;13;23;0.138888888888889;0.361111111111111
Control.SRR15539874;31;32;0.645161290322581;11;20;0.145161290322581;0.354838709677419
Control.SRR15539874;33;32;0.484848484848485;17;16;0.0151515151515151;0.484848484848485
Control.SRR15539874;30;32;0.433333333333333;17;13;0.0666666666666667;0.433333333333333
Control.SRR15539874;30;32;0.533333333333333;14;16;0.0333333333333333;0.466666666666667
Control.SRR15539874;32;32;0.59375;13;19;0.09375;0.40625
Control.SRR15539874;37;32;0.405405405405405;22;15;0.0945945945945946;0.405405405405405
Control.SRR15539874;34;32;0.558823529411765;15;19;0.0588235294117647;0.441176470588235
Control.SRR15539874;33;32;0.424242424242424;19;14;0.0757575757575757;0.424242424242424
Control.SRR15539874;30;32;0.533333333333333;14;16;0.0333333333333333;0.466666666666667
Control.SRR15539874;36;32;0.472222222222222;19;17;0.0277777777777778;0.472222222222222
Control.SRR15539874;36;32;0.611111111111111;14;22;0.111111111111111;0.388888888888889
Control.SRR15539874;33;32;0.575757575757576;14;19;0.0757575757575758;0.424242424242424
Control.SRR15539874;35;32;0.457142857142857;19;16;0.0428571428571429;0.457142857142857
Control.SRR15539874;33;32;0.393939393939394;20;13;0.106060606060606;0.393939393939394
Control.SRR15539874;36;32;0.583333333333333;15;21;0.0833333333333334;0.416666666666667
Control.SRR15539874;34;32;0.529411764705882;16;18;0.0294117647058824;0.470588235294118
Control.SRR15539874;30;32;0.466666666666667;16;14;0.0333333333333333;0.466666666666667
Control.SRR15539874;31;32;0.645161290322581;11;20;0.145161290322581;0.354838709677419
Control.SRR15539874;33;32;0.424242424242424;19;14;0.0757575757575757;0.424242424242424
Control.SRR15539874;37;32;0.513513513513513;18;19;0.0135135135135135;0.486486486486487
Control.SRR15539874;31;32;0.516129032258065;15;16;0.0161290322580645;0.483870967741935
Control.SRR15539874;37;32;0.513513513513513;18;19;0.0135135135135135;0.486486486486487
Control.SRR15539874;31;32;0.548387096774194;14;17;0.0483870967741935;0.451612903225806
Control.SRR15539874;32;32;0.4375;18;14;0.0625;0.4375
Control.SRR15539874;35;32;0.485714285714286;18;17;0.0142857142857143;0.485714285714286
Control.SRR15539874;31;32;0.580645161290323;13;18;0.0806451612903226;0.419354838709677
Control.SRR15539874;37;32;0.540540540540541;17;20;0.0405405405405406;0.459459459459459
Control.SRR15539874;37;32;0.324324324324324;25;12;0.175675675675676;0.324324324324324
Control.SRR15539874;35;32;0.514285714285714;17;18;0.0142857142857142;0.485714285714286
Control.SRR15539874;34;32;0.529411764705882;16;18;0.0294117647058824;0.470588235294118
Control.SRR15539874;33;32;0.545454545454545;15;18;0.0454545454545454;0.454545454545455
Control.SRR15539874;36;32;0.444444444444444;20;16;0.0555555555555556;0.444444444444444
Control.SRR15539874;32;32;0.34375;21;11;0.15625;0.34375
Control.SRR15539874;35;32;0.542857142857143;16;19;0.0428571428571428;0.457142857142857
Control.SRR15539874;33;32;0.575757575757576;14;19;0.0757575757575758;0.424242424242424
Control.SRR15539874;35;32;0.371428571428571;22;13;0.128571428571429;0.371428571428571
Control.SRR15539874;36;32;0.416666666666667;21;15;0.0833333333333333;0.416666666666667
Control.SRR15539874;36;32;0.416666666666667;21;15;0.0833333333333333;0.416666666666667
Control.SRR15539874;32;32;0.59375;13;19;0.09375;0.40625
Control.SRR15539874;34;32;0.470588235294118;18;16;0.0294117647058824;0.470588235294118
Control.SRR15539874;29;32;0.379310344827586;18;11;0.120689655172414;0.379310344827586
Control.SRR15539874;33;32;0.454545454545455;18;15;0.0454545454545455;0.454545454545455
Control.SRR15539874;29;32;0.482758620689655;15;14;0.0172413793103448;0.482758620689655
Control.SRR15539874;32;32;0.40625;19;13;0.09375;0.40625
Control.SRR15539874;35;32;0.628571428571429;13;22;0.128571428571429;0.371428571428571
Control.SRR15539874;31;32;0.67741935483871;10;21;0.17741935483871;0.32258064516129
Control.SRR15539874;32;32;0.40625;19;13;0.09375;0.40625
Control.SRR15539874;33;32;0.393939393939394;20;13;0.106060606060606;0.393939393939394
Control.SRR15539874;30;32;0.566666666666667;13;17;0.0666666666666667;0.433333333333333
Control.SRR15539874;29;32;0.413793103448276;17;12;0.0862068965517241;0.413793103448276
Control.SRR15539874;31;32;0.548387096774194;14;17;0.0483870967741935;0.451612903225806
Control.SRR15539874;31;32;0.548387096774194;14;17;0.0483870967741935;0.451612903225806
Control.SRR15539874;35;32;0.6;14;21;0.1;0.4
Control.SRR15539874;35;32;0.657142857142857;12;23;0.157142857142857;0.342857142857143
Control.SRR15539874;31;32;0.354838709677419;20;11;0.145161290322581;0.354838709677419
Control.SRR15539874;29;32;0.344827586206897;19;10;0.155172413793103;0.344827586206897
Control.SRR15539874;33;32;0.393939393939394;20;13;0.106060606060606;0.393939393939394
Control.SRR15539874;33;32;0.424242424242424;19;14;0.0757575757575757;0.424242424242424
Control.SRR15539874;31;32;0.516129032258065;15;16;0.0161290322580645;0.483870967741935
Control.SRR15539874;36;32;0.472222222222222;19;17;0.0277777777777778;0.472222222222222
Control.SRR15539874;29;32;0.551724137931034;13;16;0.0517241379310345;0.448275862068966
Control.SRR15539874;35;32;0.685714285714286;11;24;0.185714285714286;0.314285714285714
Control.SRR15539874;31;32;0.354838709677419;20;11;0.145161290322581;0.354838709677419
Control.SRR15539874;35;32;0.657142857142857;12;23;0.157142857142857;0.342857142857143
Control.SRR15539874;30;32;0.466666666666667;16;14;0.0333333333333333;0.466666666666667
Control.SRR15539874;31;32;0.419354838709677;18;13;0.0806451612903226;0.419354838709677
Control.SRR15539874;34;32;0.441176470588235;19;15;0.0588235294117647;0.441176470588235
Control.SRR15539874;32;32;0.5;16;16;0;0.5
Control.SRR15539874;35;32;0.542857142857143;16;19;0.0428571428571428;0.457142857142857
Control.SRR15539874;29;32;0.586206896551724;12;17;0.0862068965517241;0.413793103448276
Control.SRR15539874;35;32;0.4;21;14;0.1;0.4
Control.SRR15539874;32;32;0.46875;17;15;0.03125;0.46875
Control.SRR15539874;31;32;0.483870967741935;16;15;0.0161290322580645;0.483870967741935
Control.SRR15539874;31;32;0.419354838709677;18;13;0.0806451612903226;0.419354838709677
Control.SRR15539874;35;32;0.514285714285714;17;18;0.0142857142857142;0.485714285714286
Control.SRR15539874;32;32;0.5;16;16;0;0.5
Control.SRR15539874;31;32;0.354838709677419;20;11;0.145161290322581;0.354838709677419
Control.SRR15539874;31;32;0.548387096774194;14;17;0.0483870967741935;0.451612903225806
Control.SRR15539874;34;32;0.529411764705882;16;18;0.0294117647058824;0.470588235294118
Control.SRR15539874;34;32;0.352941176470588;22;12;0.147058823529412;0.352941176470588
Control.SRR15539874;32;32;0.4375;18;14;0.0625;0.4375
Control.SRR15539874;29;32;0.689655172413793;9;20;0.189655172413793;0.310344827586207
Control.SRR15539874;30;32;0.666666666666667;10;20;0.166666666666667;0.333333333333333
Control.SRR15539874;31;32;0.548387096774194;14;17;0.0483870967741935;0.451612903225806
Control.SRR15539874;32;32;0.4375;18;14;0.0625;0.4375
Control.SRR15539874;33;32;0.606060606060606;13;20;0.106060606060606;0.393939393939394
Control.SRR15539874;33;32;0.393939393939394;20;13;0.106060606060606;0.393939393939394
Control.SRR15539874;35;32;0.485714285714286;18;17;0.0142857142857143;0.485714285714286
Control.SRR15539874;37;32;0.513513513513513;18;19;0.0135135135135135;0.486486486486487
Control.SRR15539874;29;32;0.517241379310345;14;15;0.0172413793103449;0.482758620689655
Control.SRR15539874;34;32;0.5;17;17;0;0.5
Control.SRR15539874;32;32;0.5;16;16;0;0.5
Control.SRR15539874;31;32;0.419354838709677;18;13;0.0806451612903226;0.419354838709677
Control.SRR15539874;36;32;0.583333333333333;15;21;0.0833333333333334;0.416666666666667
Control.SRR15539874;32;32;0.40625;19;13;0.09375;0.40625
Control.SRR15539874;31;32;0.419354838709677;18;13;0.0806451612903226;0.419354838709677
Control.SRR15539874;31;32;0.419354838709677;18;13;0.0806451612903226;0.419354838709677
Control.SRR15539874;36;32;0.611111111111111;14;22;0.111111111111111;0.388888888888889
Control.SRR15539874;34;32;0.529411764705882;16;18;0.0294117647058824;0.470588235294118
Control.SRR15539874;35;32;0.542857142857143;16;19;0.0428571428571428;0.457142857142857
Control.SRR15539874;37;32;0.324324324324324;25;12;0.175675675675676;0.324324324324324
Control.SRR15539874;36;32;0.527777777777778;17;19;0.0277777777777778;0.472222222222222
Control.SRR15539874;37;32;0.486486486486487;19;18;0.0135135135135135;0.486486486486487
Control.SRR15539874;30;32;0.466666666666667;16;14;0.0333333333333333;0.466666666666667
Control.SRR15539874;36;32;0.527777777777778;17;19;0.0277777777777778;0.472222222222222
Control.SRR15539874;35;32;0.485714285714286;18;17;0.0142857142857143;0.485714285714286
Control.SRR15539874;38;32;0.552631578947368;17;21;0.0526315789473685;0.447368421052632
Control.SRR15539874;36;32;0.583333333333333;15;21;0.0833333333333334;0.416666666666667
Control.SRR15539874;38;32;0.657894736842105;13;25;0.157894736842105;0.342105263157895
Control.SRR15539874;34;32;0.264705882352941;25;9;0.235294117647059;0.264705882352941
Control.SRR15539874;32;32;0.6875;10;22;0.1875;0.3125
Control.SRR15539874;32;32;0.40625;19;13;0.09375;0.40625
Control.SRR15539874;36;32;0.638888888888889;13;23;0.138888888888889;0.361111111111111
Control.SRR15539874;38;32;0.5;19;19;0;0.5
Control.SRR15539874;31;32;0.548387096774194;14;17;0.0483870967741935;0.451612903225806
Control.SRR15539874;37;32;0.459459459459459;20;17;0.0405405405405405;0.459459459459459
Control.SRR15539874;36;32;0.444444444444444;20;16;0.0555555555555556;0.444444444444444
Control.SRR15539874;34;32;0.441176470588235;19;15;0.0588235294117647;0.441176470588235
Control.SRR15539874;33;32;0.424242424242424;19;14;0.0757575757575757;0.424242424242424
Control.SRR15539874;35;32;0.542857142857143;16;19;0.0428571428571428;0.457142857142857
Control.SRR15539874;32;32;0.4375;18;14;0.0625;0.4375
Control.SRR15539874;29;32;0.482758620689655;15;14;0.0172413793103448;0.482758620689655
Control.SRR15539874;34;32;0.588235294117647;14;20;0.0882352941176471;0.411764705882353
Control.SRR15539874;33;32;0.545454545454545;15;18;0.0454545454545454;0.454545454545455
Control.SRR15539874;30;32;0.533333333333333;14;16;0.0333333333333333;0.466666666666667
Control.SRR15539874;35;32;0.6;14;21;0.1;0.4
Control.SRR15539874;33;32;0.515151515151515;16;17;0.0151515151515151;0.484848484848485
Control.SRR15539874;36;32;0.444444444444444;20;16;0.0555555555555556;0.444444444444444
Control.SRR15539874;38;32;0.526315789473684;18;20;0.0263157894736842;0.473684210526316
Control.SRR15539874;32;32;0.40625;19;13;0.09375;0.40625
Control.SRR15539874;33;32;0.606060606060606;13;20;0.106060606060606;0.393939393939394
Control.SRR15539874;30;32;0.6;12;18;0.1;0.4
Control.SRR15539874;34;32;0.529411764705882;16;18;0.0294117647058824;0.470588235294118
Control.SRR15539874;39;32;0.538461538461538;18;21;0.0384615384615384;0.461538461538462
Control.SRR15539874;38;32;0.473684210526316;20;18;0.0263157894736842;0.473684210526316
Control.SRR15539874;30;32;0.433333333333333;17;13;0.0666666666666667;0.433333333333333
Control.SRR15539874;35;32;0.428571428571429;20;15;0.0714285714285715;0.428571428571429
Control.SRR15539874;35;32;0.428571428571429;20;15;0.0714285714285715;0.428571428571429
Control.SRR15539874;30;32;0.6;12;18;0.1;0.4
Control.SRR15539874;33;32;0.484848484848485;17;16;0.0151515151515151;0.484848484848485
Control.SRR15539874;35;32;0.6;14;21;0.1;0.4
Control.SRR15539874;33;32;0.454545454545455;18;15;0.0454545454545455;0.454545454545455
Control.SRR15539874;35;32;0.285714285714286;25;10;0.214285714285714;0.285714285714286
Control.SRR15539874;33;32;0.393939393939394;20;13;0.106060606060606;0.393939393939394
Control.SRR15539874;33;32;0.393939393939394;20;13;0.106060606060606;0.393939393939394
Control.SRR15539874;33;32;0.393939393939394;20;13;0.106060606060606;0.393939393939394
Control.SRR15539874;39;32;0.41025641025641;23;16;0.0897435897435898;0.41025641025641
Control.SRR15539874;36;32;0.444444444444444;20;16;0.0555555555555556;0.444444444444444
Control.SRR15539874;35;32;0.571428571428571;15;20;0.0714285714285714;0.428571428571429
Control.SRR15539874;36;32;0.444444444444444;20;16;0.0555555555555556;0.444444444444444
Control.SRR15539874;35;32;0.571428571428571;15;20;0.0714285714285714;0.428571428571429
Control.SRR15539874;32;32;0.53125;15;17;0.03125;0.46875
Control.SRR15539874;34;32;0.558823529411765;15;19;0.0588235294117647;0.441176470588235
Control.SRR15539874;34;32;0.588235294117647;14;20;0.0882352941176471;0.411764705882353
Control.SRR15539874;32;32;0.5;16;16;0;0.5
Control.SRR15539874;34;32;0.352941176470588;22;12;0.147058823529412;0.352941176470588
Control.SRR15539874;38;32;0.552631578947368;17;21;0.0526315789473685;0.447368421052632
Control.SRR15539874;38;32;0.578947368421053;16;22;0.0789473684210527;0.421052631578947
Control.SRR15539874;34;32;0.558823529411765;15;19;0.0588235294117647;0.441176470588235
Control.SRR15539874;38;32;0.552631578947368;17;21;0.0526315789473685;0.447368421052632
Control.SRR15539874;30;32;0.4;18;12;0.1;0.4
Control.SRR15539874;33;32;0.545454545454545;15;18;0.0454545454545454;0.454545454545455
Control.SRR15539874;37;32;0.567567567567568;16;21;0.0675675675675675;0.432432432432432
Control.SRR15539874;35;32;0.485714285714286;18;17;0.0142857142857143;0.485714285714286
Control.SRR15539874;34;32;0.558823529411765;15;19;0.0588235294117647;0.441176470588235
Control.SRR15539874;30;32;0.5;15;15;0;0.5
Control.SRR15539874;31;32;0.32258064516129;21;10;0.17741935483871;0.32258064516129
Control.SRR15539874;39;32;0.538461538461538;18;21;0.0384615384615384;0.461538461538462
Control.SRR15539874;36;32;0.5;18;18;0;0.5
Control.SRR15539874;34;32;0.558823529411765;15;19;0.0588235294117647;0.441176470588235
Control.SRR15539874;37;32;0.567567567567568;16;21;0.0675675675675675;0.432432432432432
Control.SRR15539874;35;32;0.571428571428571;15;20;0.0714285714285714;0.428571428571429
Control.SRR15539874;33;32;0.575757575757576;14;19;0.0757575757575758;0.424242424242424
Control.SRR15539874;32;32;0.5;16;16;0;0.5
Control.SRR15539874;31;32;0.451612903225806;17;14;0.0483870967741936;0.451612903225806
Control.SRR15539874;30;32;0.433333333333333;17;13;0.0666666666666667;0.433333333333333
Control.SRR15539874;30;32;0.533333333333333;14;16;0.0333333333333333;0.466666666666667
Control.SRR15539874;38;32;0.473684210526316;20;18;0.0263157894736842;0.473684210526316
Control.SRR15539874;39;32;0.538461538461538;18;21;0.0384615384615384;0.461538461538462
Control.SRR15539874;32;32;0.5;16;16;0;0.5
Control.SRR15539874;30;32;0.6;12;18;0.1;0.4
Control.SRR15539874;30;32;0.533333333333333;14;16;0.0333333333333333;0.466666666666667
Control.SRR15539874;32;32;0.53125;15;17;0.03125;0.46875
Control.SRR15539874;34;32;0.441176470588235;19;15;0.0588235294117647;0.441176470588235
Control.SRR15539874;33;32;0.545454545454545;15;18;0.0454545454545454;0.454545454545455
Control.SRR15539874;31;32;0.612903225806452;12;19;0.112903225806452;0.387096774193548
Control.SRR15539874;35;32;0.6;14;21;0.1;0.4
Control.SRR15539874;32;32;0.53125;15;17;0.03125;0.46875
Control.SRR15539874;35;32;0.285714285714286;25;10;0.214285714285714;0.285714285714286
Control.SRR15539874;37;32;0.72972972972973;10;27;0.22972972972973;0.27027027027027
Control.SRR15539874;30;32;0.5;15;15;0;0.5
Control.SRR15539874;30;32;0.533333333333333;14;16;0.0333333333333333;0.466666666666667
Control.SRR15539874;37;32;0.540540540540541;17;20;0.0405405405405406;0.459459459459459
Control.SRR15539874;38;32;0.552631578947368;17;21;0.0526315789473685;0.447368421052632
Control.SRR15539874;36;32;0.333333333333333;24;12;0.166666666666667;0.333333333333333
Control.SRR15539874;30;32;0.5;15;15;0;0.5
Control.SRR15539874;35;32;0.514285714285714;17;18;0.0142857142857142;0.485714285714286
Control.SRR15539874;32;32;0.28125;23;9;0.21875;0.28125
Control.SRR15539874;33;32;0.575757575757576;14;19;0.0757575757575758;0.424242424242424
Control.SRR15539874;35;32;0.485714285714286;18;17;0.0142857142857143;0.485714285714286
Control.SRR15539874;33;32;0.424242424242424;19;14;0.0757575757575757;0.424242424242424
Control.SRR15539874;33;32;0.454545454545455;18;15;0.0454545454545455;0.454545454545455
Control.SRR15539874;37;32;0.459459459459459;20;17;0.0405405405405405;0.459459459459459
Control.SRR15539874;33;32;0.515151515151515;16;17;0.0151515151515151;0.484848484848485
Control.SRR15539874;35;32;0.514285714285714;17;18;0.0142857142857142;0.485714285714286
Control.SRR15539874;33;32;0.424242424242424;19;14;0.0757575757575757;0.424242424242424
Control.SRR15539874;34;32;0.617647058823529;13;21;0.117647058823529;0.382352941176471
Control.SRR15539874;36;32;0.472222222222222;19;17;0.0277777777777778;0.472222222222222
Control.SRR15539874;38;32;0.421052631578947;22;16;0.0789473684210527;0.421052631578947
Control.SRR15539874;38;32;0.447368421052632;21;17;0.0526315789473684;0.447368421052632
Control.SRR15539874;37;32;0.621621621621622;14;23;0.121621621621622;0.378378378378378
Control.SRR15539874;39;32;0.41025641025641;23;16;0.0897435897435898;0.41025641025641
Control.SRR15539874;36;32;0.527777777777778;17;19;0.0277777777777778;0.472222222222222
Control.SRR15539874;34;32;0.529411764705882;16;18;0.0294117647058824;0.470588235294118
Control.SRR15539874;32;32;0.46875;17;15;0.03125;0.46875
Control.SRR15539874;29;32;0.551724137931034;13;16;0.0517241379310345;0.448275862068966
Control.SRR15539874;37;32;0.486486486486487;19;18;0.0135135135135135;0.486486486486487
Control.SRR15539874;29;32;0.620689655172414;11;18;0.120689655172414;0.379310344827586
Control.SRR15539874;29;32;0.482758620689655;15;14;0.0172413793103448;0.482758620689655
Control.SRR15539874;37;32;0.513513513513513;18;19;0.0135135135135135;0.486486486486487
Control.SRR15539874;32;32;0.59375;13;19;0.09375;0.40625
Control.SRR15539874;36;32;0.5;18;18;0;0.5
Control.SRR15539874;33;32;0.636363636363636;12;21;0.136363636363636;0.363636363636364
Control.SRR15539874;32;32;0.40625;19;13;0.09375;0.40625
Control.SRR15539874;34;32;0.529411764705882;16;18;0.0294117647058824;0.470588235294118
Control.SRR15539874;32;32;0.46875;17;15;0.03125;0.46875
Control.SRR15539874;31;32;0.354838709677419;20;11;0.145161290322581;0.354838709677419
Control.SRR15539874;35;32;0.371428571428571;22;13;0.128571428571429;0.371428571428571
Control.SRR15539874;31;32;0.451612903225806;17;14;0.0483870967741936;0.451612903225806
Control.SRR15539874;30;32;0.633333333333333;11;19;0.133333333333333;0.366666666666667
Control.SRR15539874;31;32;0.419354838709677;18;13;0.0806451612903226;0.419354838709677
Control.SRR15539874;36;32;0.444444444444444;20;16;0.0555555555555556;0.444444444444444
Control.SRR15539874;38;32;0.578947368421053;16;22;0.0789473684210527;0.421052631578947
Control.SRR15539874;30;32;0.4;18;12;0.1;0.4
Control.SRR15539874;36;32;0.472222222222222;19;17;0.0277777777777778;0.472222222222222
Control.SRR15539874;32;32;0.53125;15;17;0.03125;0.46875
Control.SRR15539874;39;32;0.384615384615385;24;15;0.115384615384615;0.384615384615385
Control.SRR15539874;36;32;0.444444444444444;20;16;0.0555555555555556;0.444444444444444
Control.SRR15539874;35;32;0.514285714285714;17;18;0.0142857142857142;0.485714285714286
Control.SRR15539874;34;32;0.588235294117647;14;20;0.0882352941176471;0.411764705882353
Control.SRR15539874;33;32;0.515151515151515;16;17;0.0151515151515151;0.484848484848485
Control.SRR15539874;34;32;0.441176470588235;19;15;0.0588235294117647;0.441176470588235
Control.SRR15539874;31;32;0.451612903225806;17;14;0.0483870967741936;0.451612903225806
Control.SRR15539874;37;32;0.378378378378378;23;14;0.121621621621622;0.378378378378378
Control.SRR15539874;38;32;0.526315789473684;18;20;0.0263157894736842;0.473684210526316
Control.SRR15539874;38;32;0.421052631578947;22;16;0.0789473684210527;0.421052631578947
Control.SRR15539874;39;32;0.512820512820513;19;20;0.0128205128205128;0.487179487179487
Control.SRR15539874;36;32;0.277777777777778;26;10;0.222222222222222;0.277777777777778
Control.SRR15539874;36;32;0.583333333333333;15;21;0.0833333333333334;0.416666666666667
Control.SRR15539874;39;32;0.358974358974359;25;14;0.141025641025641;0.358974358974359
Control.SRR15539874;37;32;0.459459459459459;20;17;0.0405405405405405;0.459459459459459
Control.SRR15539874;39;32;0.461538461538462;21;18;0.0384615384615384;0.461538461538462
Control.SRR15539874;30;32;0.333333333333333;20;10;0.166666666666667;0.333333333333333
Control.SRR15539874;33;32;0.606060606060606;13;20;0.106060606060606;0.393939393939394
Control.SRR15539874;39;32;0.538461538461538;18;21;0.0384615384615384;0.461538461538462
Control.SRR15539874;35;32;0.628571428571429;13;22;0.128571428571429;0.371428571428571
Control.SRR15539874;37;32;0.486486486486487;19;18;0.0135135135135135;0.486486486486487
Control.SRR15539874;37;32;0.540540540540541;17;20;0.0405405405405406;0.459459459459459
Control.SRR15539874;37;32;0.459459459459459;20;17;0.0405405405405405;0.459459459459459
Control.SRR15539874;39;32;0.435897435897436;22;17;0.0641025641025641;0.435897435897436
Control.SRR15539874;33;32;0.545454545454545;15;18;0.0454545454545454;0.454545454545455
Control.SRR15539874;38;32;0.657894736842105;13;25;0.157894736842105;0.342105263157895
Control.SRR15539874;36;32;0.444444444444444;20;16;0.0555555555555556;0.444444444444444
Control.SRR15539874;36;32;0.444444444444444;20;16;0.0555555555555556;0.444444444444444
Control.SRR15539874;37;32;0.405405405405405;22;15;0.0945945945945946;0.405405405405405
Control.SRR15539874;30;32;0.533333333333333;14;16;0.0333333333333333;0.466666666666667
Control.SRR15539874;29;32;0.413793103448276;17;12;0.0862068965517241;0.413793103448276
Control.SRR15539874;32;32;0.5625;14;18;0.0625;0.4375
Control.SRR15539874;29;32;0.620689655172414;11;18;0.120689655172414;0.379310344827586
Control.SRR15539874;39;32;0.487179487179487;20;19;0.0128205128205128;0.487179487179487
Control.SRR15539874;31;32;0.32258064516129;21;10;0.17741935483871;0.32258064516129
Control.SRR15539874;29;32;0.448275862068966;16;13;0.0517241379310345;0.448275862068966
Control.SRR15539874;36;32;0.555555555555556;16;20;0.0555555555555556;0.444444444444444
Control.SRR15539874;38;32;0.5;19;19;0;0.5
Control.SRR15539874;38;32;0.473684210526316;20;18;0.0263157894736842;0.473684210526316
Control.SRR15539874;34;32;0.352941176470588;22;12;0.147058823529412;0.352941176470588
Control.SRR15539874;30;32;0.366666666666667;19;11;0.133333333333333;0.366666666666667
Control.SRR15539874;39;32;0.435897435897436;22;17;0.0641025641025641;0.435897435897436
Control.SRR15539874;35;32;0.485714285714286;18;17;0.0142857142857143;0.485714285714286
Control.SRR15539874;36;32;0.583333333333333;15;21;0.0833333333333334;0.416666666666667
Control.SRR15539874;29;32;0.482758620689655;15;14;0.0172413793103448;0.482758620689655
Control.SRR15539874;32;32;0.46875;17;15;0.03125;0.46875
Control.SRR15539874;35;32;0.4;21;14;0.1;0.4
Control.SRR15539874;33;32;0.575757575757576;14;19;0.0757575757575758;0.424242424242424
Control.SRR15539874;31;32;0.354838709677419;20;11;0.145161290322581;0.354838709677419
Control.SRR15539874;34;32;0.558823529411765;15;19;0.0588235294117647;0.441176470588235
Control.SRR15539874;31;32;0.483870967741935;16;15;0.0161290322580645;0.483870967741935
Control.SRR15539874;35;32;0.571428571428571;15;20;0.0714285714285714;0.428571428571429
Control.SRR15539874;35;32;0.542857142857143;16;19;0.0428571428571428;0.457142857142857
Control.SRR15539874;31;32;0.548387096774194;14;17;0.0483870967741935;0.451612903225806
Control.SRR15539874;38;32;0.526315789473684;18;20;0.0263157894736842;0.473684210526316
Control.SRR15539874;31;32;0.419354838709677;18;13;0.0806451612903226;0.419354838709677
Control.SRR15539874;36;32;0.5;18;18;0;0.5
Control.SRR15539874;33;32;0.454545454545455;18;15;0.0454545454545455;0.454545454545455
Control.SRR15539874;29;32;0.344827586206897;19;10;0.155172413793103;0.344827586206897
Control.SRR15539874;31;32;0.516129032258065;15;16;0.0161290322580645;0.483870967741935
Control.SRR15539874;33;32;0.454545454545455;18;15;0.0454545454545455;0.454545454545455
Control.SRR15539874;35;32;0.542857142857143;16;19;0.0428571428571428;0.457142857142857
Control.SRR15539874;32;32;0.75;8;24;0.25;0.25
Control.SRR15539874;36;32;0.5;18;18;0;0.5
Control.SRR15539874;38;32;0.578947368421053;16;22;0.0789473684210527;0.421052631578947
Control.SRR15539874;37;32;0.459459459459459;20;17;0.0405405405405405;0.459459459459459
Control.SRR15539874;29;32;0.517241379310345;14;15;0.0172413793103449;0.482758620689655
Control.SRR15539874;36;32;0.527777777777778;17;19;0.0277777777777778;0.472222222222222
Control.SRR15539874;32;32;0.375;20;12;0.125;0.375
Control.SRR15539874;34;32;0.558823529411765;15;19;0.0588235294117647;0.441176470588235
Control.SRR15539874;38;32;0.421052631578947;22;16;0.0789473684210527;0.421052631578947
Control.SRR15539874;37;32;0.567567567567568;16;21;0.0675675675675675;0.432432432432432
Control.SRR15539874;36;32;0.527777777777778;17;19;0.0277777777777778;0.472222222222222
Control.SRR15539874;33;32;0.515151515151515;16;17;0.0151515151515151;0.484848484848485
Control.SRR15539874;37;32;0.648648648648649;13;24;0.148648648648649;0.351351351351351
Control.SRR15539874;38;32;0.473684210526316;20;18;0.0263157894736842;0.473684210526316
Control.SRR15539874;33;32;0.424242424242424;19;14;0.0757575757575757;0.424242424242424
Control.SRR15539874;32;32;0.34375;21;11;0.15625;0.34375
Control.SRR15539874;34;32;0.588235294117647;14;20;0.0882352941176471;0.411764705882353
Control.SRR15539874;38;32;0.5;19;19;0;0.5
Control.SRR15539874;29;32;0.413793103448276;17;12;0.0862068965517241;0.413793103448276
Control.SRR15539874;31;32;0.483870967741935;16;15;0.0161290322580645;0.483870967741935
Control.SRR15539874;33;32;0.484848484848485;17;16;0.0151515151515151;0.484848484848485
Control.SRR15539874;34;32;0.588235294117647;14;20;0.0882352941176471;0.411764705882353
Control.SRR15539874;38;32;0.552631578947368;17;21;0.0526315789473685;0.447368421052632
Control.SRR15539874;31;32;0.419354838709677;18;13;0.0806451612903226;0.419354838709677
Control.SRR15539874;39;32;0.435897435897436;22;17;0.0641025641025641;0.435897435897436
Control.SRR15539874;32;32;0.625;12;20;0.125;0.375
Control.SRR15539874;30;32;0.633333333333333;11;19;0.133333333333333;0.366666666666667
Control.SRR15539874;29;32;0.620689655172414;11;18;0.120689655172414;0.379310344827586
Control.SRR15539874;29;32;0.551724137931034;13;16;0.0517241379310345;0.448275862068966
Control.SRR15539874;30;32;0.433333333333333;17;13;0.0666666666666667;0.433333333333333
Control.SRR15539874;31;32;0.580645161290323;13;18;0.0806451612903226;0.419354838709677
Control.SRR15539874;31;32;0.548387096774194;14;17;0.0483870967741935;0.451612903225806
Control.SRR15539874;30;32;0.533333333333333;14;16;0.0333333333333333;0.466666666666667
Control.SRR15539874;37;32;0.621621621621622;14;23;0.121621621621622;0.378378378378378
Control.SRR15539874;34;32;0.558823529411765;15;19;0.0588235294117647;0.441176470588235
Control.SRR15539874;36;32;0.416666666666667;21;15;0.0833333333333333;0.416666666666667
Control.SRR15539874;34;32;0.529411764705882;16;18;0.0294117647058824;0.470588235294118
Control.SRR15539874;37;32;0.513513513513513;18;19;0.0135135135135135;0.486486486486487
Control.SRR15539874;32;32;0.53125;15;17;0.03125;0.46875
Control.SRR15539874;37;32;0.567567567567568;16;21;0.0675675675675675;0.432432432432432
Control.SRR15539874;34;32;0.382352941176471;21;13;0.117647058823529;0.382352941176471
Control.SRR15539874;32;32;0.5;16;16;0;0.5
Control.SRR15539874;36;32;0.666666666666667;12;24;0.166666666666667;0.333333333333333
Control.SRR15539874;38;32;0.578947368421053;16;22;0.0789473684210527;0.421052631578947
Control.SRR15539874;30;32;0.566666666666667;13;17;0.0666666666666667;0.433333333333333
Control.SRR15539874;37;32;0.486486486486487;19;18;0.0135135135135135;0.486486486486487
Control.SRR15539874;36;32;0.388888888888889;22;14;0.111111111111111;0.388888888888889
Control.SRR15539874;30;32;0.7;9;21;0.2;0.3
Control.SRR15539874;34;32;0.441176470588235;19;15;0.0588235294117647;0.441176470588235
Control.SRR15539874;36;32;0.5;18;18;0;0.5
Control.SRR15539874;33;32;0.484848484848485;17;16;0.0151515151515151;0.484848484848485
Control.SRR15539874;33;32;0.424242424242424;19;14;0.0757575757575757;0.424242424242424
Control.SRR15539874;33;32;0.484848484848485;17;16;0.0151515151515151;0.484848484848485
Control.SRR15539874;34;32;0.382352941176471;21;13;0.117647058823529;0.382352941176471
Control.SRR15539874;36;32;0.611111111111111;14;22;0.111111111111111;0.388888888888889
Control.SRR15539874;39;32;0.538461538461538;18;21;0.0384615384615384;0.461538461538462
Control.SRR15539874;37;32;0.540540540540541;17;20;0.0405405405405406;0.459459459459459
Control.SRR15539874;38;32;0.315789473684211;26;12;0.184210526315789;0.315789473684211
Control.SRR15539874;29;32;0.482758620689655;15;14;0.0172413793103448;0.482758620689655
Control.SRR15539874;37;32;0.567567567567568;16;21;0.0675675675675675;0.432432432432432
Control.SRR15539874;31;32;0.483870967741935;16;15;0.0161290322580645;0.483870967741935
Control.SRR15539874;38;32;0.5;19;19;0;0.5
Control.SRR15539874;31;32;0.451612903225806;17;14;0.0483870967741936;0.451612903225806
Control.SRR15539874;36;32;0.444444444444444;20;16;0.0555555555555556;0.444444444444444
Control.SRR15539874;33;32;0.606060606060606;13;20;0.106060606060606;0.393939393939394
Control.SRR15539874;33;32;0.424242424242424;19;14;0.0757575757575757;0.424242424242424
Control.SRR15539874;33;32;0.454545454545455;18;15;0.0454545454545455;0.454545454545455
Control.SRR15539874;34;32;0.529411764705882;16;18;0.0294117647058824;0.470588235294118
Control.SRR15539874;38;32;0.552631578947368;17;21;0.0526315789473685;0.447368421052632
Control.SRR15539874;31;32;0.387096774193548;19;12;0.112903225806452;0.387096774193548
Control.SRR15539874;29;32;0.517241379310345;14;15;0.0172413793103449;0.482758620689655
Control.SRR15539874;31;32;0.483870967741935;16;15;0.0161290322580645;0.483870967741935
Control.SRR15539874;33;32;0.333333333333333;22;11;0.166666666666667;0.333333333333333
Control.SRR15539874;34;32;0.617647058823529;13;21;0.117647058823529;0.382352941176471
Control.SRR15539874;30;32;0.6;12;18;0.1;0.4
Control.SRR15539874;31;32;0.483870967741935;16;15;0.0161290322580645;0.483870967741935
Control.SRR15539874;35;32;0.514285714285714;17;18;0.0142857142857142;0.485714285714286
Control.SRR15539874;38;32;0.5;19;19;0;0.5
Control.SRR15539874;35;32;0.542857142857143;16;19;0.0428571428571428;0.457142857142857
Control.SRR15539874;35;32;0.542857142857143;16;19;0.0428571428571428;0.457142857142857
Control.SRR15539874;29;32;0.551724137931034;13;16;0.0517241379310345;0.448275862068966
Control.SRR15539874;31;32;0.419354838709677;18;13;0.0806451612903226;0.419354838709677
Control.SRR15539874;29;32;0.379310344827586;18;11;0.120689655172414;0.379310344827586
Control.SRR15539874;35;32;0.542857142857143;16;19;0.0428571428571428;0.457142857142857
Control.SRR15539874;33;32;0.454545454545455;18;15;0.0454545454545455;0.454545454545455
Control.SRR15539874;32;32;0.625;12;20;0.125;0.375
Control.SRR15539874;39;32;0.435897435897436;22;17;0.0641025641025641;0.435897435897436
Control.SRR15539874;33;32;0.484848484848485;17;16;0.0151515151515151;0.484848484848485
Control.SRR15539874;34;32;0.558823529411765;15;19;0.0588235294117647;0.441176470588235
Control.SRR15539874;32;32;0.4375;18;14;0.0625;0.4375
Control.SRR15539874;36;32;0.5;18;18;0;0.5
Control.SRR15539874;38;32;0.394736842105263;23;15;0.105263157894737;0.394736842105263
Control.SRR15539874;33;32;0.393939393939394;20;13;0.106060606060606;0.393939393939394
Control.SRR15539874;35;32;0.571428571428571;15;20;0.0714285714285714;0.428571428571429
Control.SRR15539874;33;32;0.545454545454545;15;18;0.0454545454545454;0.454545454545455
Control.SRR15539874;33;32;0.515151515151515;16;17;0.0151515151515151;0.484848484848485
Control.SRR15539874;34;32;0.529411764705882;16;18;0.0294117647058824;0.470588235294118
Control.SRR15539874;33;32;0.545454545454545;15;18;0.0454545454545454;0.454545454545455
Control.SRR15539874;38;32;0.421052631578947;22;16;0.0789473684210527;0.421052631578947
Control.SRR15539874;35;32;0.485714285714286;18;17;0.0142857142857143;0.485714285714286
Control.SRR15539874;38;32;0.447368421052632;21;17;0.0526315789473684;0.447368421052632
Control.SRR15539874;37;32;0.486486486486487;19;18;0.0135135135135135;0.486486486486487
Control.SRR15539874;34;32;0.558823529411765;15;19;0.0588235294117647;0.441176470588235
Control.SRR15539874;35;32;0.714285714285714;10;25;0.214285714285714;0.285714285714286
Control.SRR15539874;37;32;0.513513513513513;18;19;0.0135135135135135;0.486486486486487
Control.SRR15539874;37;32;0.486486486486487;19;18;0.0135135135135135;0.486486486486487
Control.SRR15539874;35;32;0.457142857142857;19;16;0.0428571428571429;0.457142857142857
Control.SRR15539874;38;32;0.526315789473684;18;20;0.0263157894736842;0.473684210526316
Control.SRR15539874;30;32;0.666666666666667;10;20;0.166666666666667;0.333333333333333
Control.SRR15539874;36;32;0.555555555555556;16;20;0.0555555555555556;0.444444444444444
Control.SRR15539874;36;32;0.444444444444444;20;16;0.0555555555555556;0.444444444444444
Control.SRR15539874;31;32;0.451612903225806;17;14;0.0483870967741936;0.451612903225806
Control.SRR15539874;31;32;0.548387096774194;14;17;0.0483870967741935;0.451612903225806
Control.SRR15539874;32;32;0.46875;17;15;0.03125;0.46875
Control.SRR15539874;30;32;0.466666666666667;16;14;0.0333333333333333;0.466666666666667
Control.SRR15539874;37;32;0.459459459459459;20;17;0.0405405405405405;0.459459459459459
Control.SRR15539874;33;32;0.454545454545455;18;15;0.0454545454545455;0.454545454545455
Control.SRR15539874;36;32;0.472222222222222;19;17;0.0277777777777778;0.472222222222222
Control.SRR15539874;29;32;0.448275862068966;16;13;0.0517241379310345;0.448275862068966
Control.SRR15539874;36;32;0.416666666666667;21;15;0.0833333333333333;0.416666666666667
Control.SRR15539874;32;32;0.46875;17;15;0.03125;0.46875
Control.SRR15539874;35;32;0.742857142857143;9;26;0.242857142857143;0.257142857142857
Control.SRR15539874;30;32;0.633333333333333;11;19;0.133333333333333;0.366666666666667
Control.SRR15539874;37;32;0.567567567567568;16;21;0.0675675675675675;0.432432432432432
Control.SRR15539874;36;32;0.638888888888889;13;23;0.138888888888889;0.361111111111111
Control.SRR15539874;34;32;0.588235294117647;14;20;0.0882352941176471;0.411764705882353
Control.SRR15539874;34;32;0.470588235294118;18;16;0.0294117647058824;0.470588235294118
Control.SRR15539874;34;32;0.588235294117647;14;20;0.0882352941176471;0.411764705882353
Control.SRR15539874;39;32;0.487179487179487;20;19;0.0128205128205128;0.487179487179487
Control.SRR15539874;34;32;0.529411764705882;16;18;0.0294117647058824;0.470588235294118
Control.SRR15539874;36;32;0.277777777777778;26;10;0.222222222222222;0.277777777777778
Control.SRR15539874;29;32;0.620689655172414;11;18;0.120689655172414;0.379310344827586
Control.SRR15539874;29;32;0.448275862068966;16;13;0.0517241379310345;0.448275862068966
Control.SRR15539874;34;32;0.647058823529412;12;22;0.147058823529412;0.352941176470588
Control.SRR15539874;31;32;0.548387096774194;14;17;0.0483870967741935;0.451612903225806
Control.SRR15539874;30;32;0.4;18;12;0.1;0.4
Control.SRR15539874;30;32;0.566666666666667;13;17;0.0666666666666667;0.433333333333333
Control.SRR15539874;39;32;0.564102564102564;17;22;0.0641025641025641;0.435897435897436
Control.SRR15539874;36;32;0.583333333333333;15;21;0.0833333333333334;0.416666666666667
Control.SRR15539874;36;32;0.388888888888889;22;14;0.111111111111111;0.388888888888889
Control.SRR15539874;38;32;0.552631578947368;17;21;0.0526315789473685;0.447368421052632
Control.SRR15539874;33;32;0.363636363636364;21;12;0.136363636363636;0.363636363636364
Control.SRR15539874;34;32;0.558823529411765;15;19;0.0588235294117647;0.441176470588235
Control.SRR15539874;30;32;0.4;18;12;0.1;0.4
Control.SRR15539874;36;32;0.361111111111111;23;13;0.138888888888889;0.361111111111111
Control.SRR15539874;34;32;0.529411764705882;16;18;0.0294117647058824;0.470588235294118
Control.SRR15539874;32;32;0.53125;15;17;0.03125;0.46875
Control.SRR15539874;38;32;0.447368421052632;21;17;0.0526315789473684;0.447368421052632
Control.SRR15539874;32;32;0.5625;14;18;0.0625;0.4375
Control.SRR15539874;34;32;0.529411764705882;16;18;0.0294117647058824;0.470588235294118
Control.SRR15539874;37;32;0.594594594594595;15;22;0.0945945945945946;0.405405405405405
Control.SRR15539874;31;32;0.580645161290323;13;18;0.0806451612903226;0.419354838709677
Control.SRR15539874;34;32;0.647058823529412;12;22;0.147058823529412;0.352941176470588
Control.SRR15539874;38;32;0.473684210526316;20;18;0.0263157894736842;0.473684210526316
Control.SRR15539874;35;32;0.6;14;21;0.1;0.4
Control.SRR15539874;30;32;0.5;15;15;0;0.5
Control.SRR15539874;30;32;0.466666666666667;16;14;0.0333333333333333;0.466666666666667
Control.SRR15539874;32;32;0.40625;19;13;0.09375;0.40625
Control.SRR15539874;33;32;0.545454545454545;15;18;0.0454545454545454;0.454545454545455
Control.SRR15539874;37;32;0.567567567567568;16;21;0.0675675675675675;0.432432432432432
Control.SRR15539874;32;32;0.5;16;16;0;0.5
Control.SRR15539874;35;32;0.485714285714286;18;17;0.0142857142857143;0.485714285714286
Control.SRR15539874;36;32;0.444444444444444;20;16;0.0555555555555556;0.444444444444444
Control.SRR15539874;37;32;0.567567567567568;16;21;0.0675675675675675;0.432432432432432
Control.SRR15539874;38;32;0.421052631578947;22;16;0.0789473684210527;0.421052631578947
Control.SRR15539874;31;32;0.451612903225806;17;14;0.0483870967741936;0.451612903225806
Control.SRR15539874;31;32;0.67741935483871;10;21;0.17741935483871;0.32258064516129
Control.SRR15539874;31;32;0.580645161290323;13;18;0.0806451612903226;0.419354838709677
Control.SRR15539874;36;32;0.666666666666667;12;24;0.166666666666667;0.333333333333333
Control.SRR15539874;34;32;0.470588235294118;18;16;0.0294117647058824;0.470588235294118
Control.SRR15539874;37;32;0.459459459459459;20;17;0.0405405405405405;0.459459459459459
Control.SRR15539874;34;32;0.529411764705882;16;18;0.0294117647058824;0.470588235294118
Control.SRR15539874;32;32;0.5;16;16;0;0.5
Control.SRR15539874;31;32;0.290322580645161;22;9;0.209677419354839;0.290322580645161
Control.SRR15539874;36;32;0.555555555555556;16;20;0.0555555555555556;0.444444444444444
Control.SRR15539874;34;32;0.5;17;17;0;0.5
Control.SRR15539874;33;32;0.424242424242424;19;14;0.0757575757575757;0.424242424242424
Control.SRR15539874;33;32;0.242424242424242;25;8;0.257575757575758;0.242424242424242
Control.SRR15539874;36;32;0.5;18;18;0;0.5
Control.SRR15539874;38;32;0.578947368421053;16;22;0.0789473684210527;0.421052631578947
Control.SRR15539874;38;32;0.552631578947368;17;21;0.0526315789473685;0.447368421052632
Control.SRR15539874;34;32;0.411764705882353;20;14;0.0882352941176471;0.411764705882353
Control.SRR15539874;33;32;0.515151515151515;16;17;0.0151515151515151;0.484848484848485
Control.SRR15539874;32;32;0.5625;14;18;0.0625;0.4375
Control.SRR15539874;33;32;0.484848484848485;17;16;0.0151515151515151;0.484848484848485
Control.SRR15539874;33;32;0.424242424242424;19;14;0.0757575757575757;0.424242424242424
Control.SRR15539874;38;32;0.5;19;19;0;0.5
Control.SRR15539874;34;32;0.411764705882353;20;14;0.0882352941176471;0.411764705882353
Control.SRR15539874;31;32;0.483870967741935;16;15;0.0161290322580645;0.483870967741935
Control.SRR15539874;31;32;0.580645161290323;13;18;0.0806451612903226;0.419354838709677
Control.SRR15539874;36;32;0.472222222222222;19;17;0.0277777777777778;0.472222222222222
Control.SRR15539874;34;32;0.470588235294118;18;16;0.0294117647058824;0.470588235294118
Control.SRR15539874;29;32;0.448275862068966;16;13;0.0517241379310345;0.448275862068966
Control.SRR15539874;33;32;0.575757575757576;14;19;0.0757575757575758;0.424242424242424
Control.SRR15539874;35;32;0.285714285714286;25;10;0.214285714285714;0.285714285714286
Control.SRR15539874;37;32;0.459459459459459;20;17;0.0405405405405405;0.459459459459459
Control.SRR15539874;39;32;0.58974358974359;16;23;0.0897435897435898;0.41025641025641
Control.SRR15539874;33;32;0.333333333333333;22;11;0.166666666666667;0.333333333333333
Control.SRR15539874;36;32;0.555555555555556;16;20;0.0555555555555556;0.444444444444444
Control.SRR15539874;33;32;0.636363636363636;12;21;0.136363636363636;0.363636363636364
Control.SRR15539874;30;32;0.5;15;15;0;0.5
Control.SRR15539874;35;32;0.6;14;21;0.1;0.4
Control.SRR15539874;39;32;0.435897435897436;22;17;0.0641025641025641;0.435897435897436
Control.SRR15539874;31;32;0.451612903225806;17;14;0.0483870967741936;0.451612903225806
Control.SRR15539874;35;32;0.542857142857143;16;19;0.0428571428571428;0.457142857142857
Control.SRR15539874;39;32;0.487179487179487;20;19;0.0128205128205128;0.487179487179487
Control.SRR15539874;35;32;0.628571428571429;13;22;0.128571428571429;0.371428571428571
Control.SRR15539874;34;32;0.470588235294118;18;16;0.0294117647058824;0.470588235294118
Control.SRR15539874;39;32;0.461538461538462;21;18;0.0384615384615384;0.461538461538462
Control.SRR15539874;37;32;0.567567567567568;16;21;0.0675675675675675;0.432432432432432
Control.SRR15539874;39;32;0.58974358974359;16;23;0.0897435897435898;0.41025641025641
Control.SRR15539874;35;32;0.571428571428571;15;20;0.0714285714285714;0.428571428571429
Control.SRR15539874;33;32;0.454545454545455;18;15;0.0454545454545455;0.454545454545455
Control.SRR15539874;33;32;0.636363636363636;12;21;0.136363636363636;0.363636363636364
Control.SRR15539874;30;32;0.633333333333333;11;19;0.133333333333333;0.366666666666667
Control.SRR15539874;32;32;0.5625;14;18;0.0625;0.4375
Control.SRR15539874;32;32;0.53125;15;17;0.03125;0.46875
Control.SRR15539874;34;32;0.588235294117647;14;20;0.0882352941176471;0.411764705882353
Control.SRR15539874;32;32;0.34375;21;11;0.15625;0.34375
Control.SRR15539874;35;32;0.685714285714286;11;24;0.185714285714286;0.314285714285714
Control.SRR15539874;31;32;0.516129032258065;15;16;0.0161290322580645;0.483870967741935
Control.SRR15539874;35;32;0.514285714285714;17;18;0.0142857142857142;0.485714285714286
Control.SRR15539874;33;32;0.757575757575758;8;25;0.257575757575758;0.242424242424242
Control.SRR15539874;33;32;0.545454545454545;15;18;0.0454545454545454;0.454545454545455
Control.SRR15539874;32;32;0.4375;18;14;0.0625;0.4375
Control.SRR15539874;37;32;0.432432432432432;21;16;0.0675675675675675;0.432432432432432
Control.SRR15539874;31;32;0.354838709677419;20;11;0.145161290322581;0.354838709677419
Control.SRR15539874;31;32;0.451612903225806;17;14;0.0483870967741936;0.451612903225806
Control.SRR15539874;34;32;0.411764705882353;20;14;0.0882352941176471;0.411764705882353
Control.SRR15539874;32;32;0.375;20;12;0.125;0.375
Control.SRR15539874;33;32;0.484848484848485;17;16;0.0151515151515151;0.484848484848485
Control.SRR15539874;31;32;0.580645161290323;13;18;0.0806451612903226;0.419354838709677
Control.SRR15539874;30;32;0.566666666666667;13;17;0.0666666666666667;0.433333333333333
Control.SRR15539874;31;32;0.419354838709677;18;13;0.0806451612903226;0.419354838709677
Control.SRR15539874;34;32;0.470588235294118;18;16;0.0294117647058824;0.470588235294118
Control.SRR15539874;34;32;0.441176470588235;19;15;0.0588235294117647;0.441176470588235
Control.SRR15539874;30;32;0.5;15;15;0;0.5
Control.SRR15539874;34;32;0.529411764705882;16;18;0.0294117647058824;0.470588235294118
Control.SRR15539874;38;32;0.578947368421053;16;22;0.0789473684210527;0.421052631578947
Control.SRR15539874;39;32;0.384615384615385;24;15;0.115384615384615;0.384615384615385
Control.SRR15539874;30;32;0.533333333333333;14;16;0.0333333333333333;0.466666666666667
Control.SRR15539874;30;32;0.533333333333333;14;16;0.0333333333333333;0.466666666666667
Control.SRR15539874;31;32;0.612903225806452;12;19;0.112903225806452;0.387096774193548
Control.SRR15539874;35;32;0.571428571428571;15;20;0.0714285714285714;0.428571428571429
Control.SRR15539874;35;32;0.571428571428571;15;20;0.0714285714285714;0.428571428571429
Control.SRR15539874;39;32;0.41025641025641;23;16;0.0897435897435898;0.41025641025641
Control.SRR15539874;37;32;0.432432432432432;21;16;0.0675675675675675;0.432432432432432
Control.SRR15539874;35;32;0.428571428571429;20;15;0.0714285714285715;0.428571428571429
Control.SRR15539874;34;32;0.470588235294118;18;16;0.0294117647058824;0.470588235294118
Control.SRR15539874;37;32;0.351351351351351;24;13;0.148648648648649;0.351351351351351
Control.SRR15539874;38;32;0.526315789473684;18;20;0.0263157894736842;0.473684210526316
Control.SRR15539874;36;32;0.555555555555556;16;20;0.0555555555555556;0.444444444444444
Control.SRR15539874;34;32;0.382352941176471;21;13;0.117647058823529;0.382352941176471
Control.SRR15539874;30;32;0.6;12;18;0.1;0.4
Control.SRR15539874;32;32;0.5;16;16;0;0.5
Control.SRR15539874;34;32;0.441176470588235;19;15;0.0588235294117647;0.441176470588235
Control.SRR15539874;37;32;0.648648648648649;13;24;0.148648648648649;0.351351351351351
Control.SRR15539874;34;32;0.411764705882353;20;14;0.0882352941176471;0.411764705882353
Control.SRR15539874;30;32;0.433333333333333;17;13;0.0666666666666667;0.433333333333333
Control.SRR15539874;35;32;0.428571428571429;20;15;0.0714285714285715;0.428571428571429
Control.SRR15539874;31;32;0.709677419354839;9;22;0.209677419354839;0.290322580645161
Control.SRR15539874;32;32;0.59375;13;19;0.09375;0.40625
Control.SRR15539874;33;32;0.666666666666667;11;22;0.166666666666667;0.333333333333333
Control.SRR15539874;39;32;0.512820512820513;19;20;0.0128205128205128;0.487179487179487
Control.SRR15539874;33;32;0.424242424242424;19;14;0.0757575757575757;0.424242424242424
Control.SRR15539874;30;32;0.5;15;15;0;0.5
Control.SRR15539874;35;32;0.485714285714286;18;17;0.0142857142857143;0.485714285714286
Control.SRR15539874;35;32;0.457142857142857;19;16;0.0428571428571429;0.457142857142857
Control.SRR15539874;36;32;0.527777777777778;17;19;0.0277777777777778;0.472222222222222
Control.SRR15539874;32;32;0.5;16;16;0;0.5
Control.SRR15539874;34;32;0.411764705882353;20;14;0.0882352941176471;0.411764705882353
Control.SRR15539874;32;32;0.40625;19;13;0.09375;0.40625
Control.SRR15539874;37;32;0.486486486486487;19;18;0.0135135135135135;0.486486486486487
Control.SRR15539874;33;32;0.515151515151515;16;17;0.0151515151515151;0.484848484848485
Control.SRR15539874;37;32;0.486486486486487;19;18;0.0135135135135135;0.486486486486487
Control.SRR15539874;35;32;0.457142857142857;19;16;0.0428571428571429;0.457142857142857
Control.SRR15539874;36;32;0.5;18;18;0;0.5
Control.SRR15539874;32;32;0.40625;19;13;0.09375;0.40625
Control.SRR15539874;34;32;0.558823529411765;15;19;0.0588235294117647;0.441176470588235
Control.SRR15539874;34;32;0.470588235294118;18;16;0.0294117647058824;0.470588235294118
Control.SRR15539874;30;32;0.533333333333333;14;16;0.0333333333333333;0.466666666666667
Control.SRR15539874;36;32;0.416666666666667;21;15;0.0833333333333333;0.416666666666667
Control.SRR15539874;30;32;0.5;15;15;0;0.5
Control.SRR15539874;34;32;0.441176470588235;19;15;0.0588235294117647;0.441176470588235
Control.SRR15539874;39;32;0.435897435897436;22;17;0.0641025641025641;0.435897435897436
Control.SRR15539874;29;32;0.448275862068966;16;13;0.0517241379310345;0.448275862068966
Control.SRR15539874;34;32;0.470588235294118;18;16;0.0294117647058824;0.470588235294118
Control.SRR15539874;35;32;0.514285714285714;17;18;0.0142857142857142;0.485714285714286
Control.SRR15539874;38;32;0.289473684210526;27;11;0.210526315789474;0.289473684210526
Control.SRR15539874;37;32;0.486486486486487;19;18;0.0135135135135135;0.486486486486487
Control.SRR15539874;29;32;0.517241379310345;14;15;0.0172413793103449;0.482758620689655
Control.SRR15539874;33;32;0.606060606060606;13;20;0.106060606060606;0.393939393939394
Control.SRR15539874;31;32;0.354838709677419;20;11;0.145161290322581;0.354838709677419
Control.SRR15539874;39;32;0.641025641025641;14;25;0.141025641025641;0.358974358974359
Control.SRR15539874;38;32;0.5;19;19;0;0.5
Control.SRR15539874;29;32;0.551724137931034;13;16;0.0517241379310345;0.448275862068966
Control.SRR15539874;31;32;0.612903225806452;12;19;0.112903225806452;0.387096774193548
Control.SRR15539874;30;32;0.466666666666667;16;14;0.0333333333333333;0.466666666666667
Control.SRR15539874;36;32;0.5;18;18;0;0.5
Control.SRR15539874;38;32;0.631578947368421;14;24;0.131578947368421;0.368421052631579
Control.SRR15539874;35;32;0.485714285714286;18;17;0.0142857142857143;0.485714285714286
Control.SRR15539874;34;32;0.441176470588235;19;15;0.0588235294117647;0.441176470588235
Control.SRR15539874;38;32;0.552631578947368;17;21;0.0526315789473685;0.447368421052632
Control.SRR15539874;36;32;0.527777777777778;17;19;0.0277777777777778;0.472222222222222
Control.SRR15539874;39;32;0.41025641025641;23;16;0.0897435897435898;0.41025641025641
Control.SRR15539874;32;32;0.5;16;16;0;0.5
Control.SRR15539874;39;32;0.58974358974359;16;23;0.0897435897435898;0.41025641025641
Control.SRR15539874;31;32;0.548387096774194;14;17;0.0483870967741935;0.451612903225806
Control.SRR15539874;32;32;0.65625;11;21;0.15625;0.34375
Control.SRR15539874;36;32;0.611111111111111;14;22;0.111111111111111;0.388888888888889
Control.SRR15539874;33;32;0.515151515151515;16;17;0.0151515151515151;0.484848484848485
Control.SRR15539874;38;32;0.368421052631579;24;14;0.131578947368421;0.368421052631579
Control.SRR15539874;32;32;0.5;16;16;0;0.5
Control.SRR15539874;30;32;0.6;12;18;0.1;0.4
Control.SRR15539874;30;32;0.533333333333333;14;16;0.0333333333333333;0.466666666666667
Control.SRR15539874;29;32;0.551724137931034;13;16;0.0517241379310345;0.448275862068966
Control.SRR15539874;29;32;0.689655172413793;9;20;0.189655172413793;0.310344827586207
Control.SRR15539874;32;32;0.625;12;20;0.125;0.375
Control.SRR15539874;31;32;0.419354838709677;18;13;0.0806451612903226;0.419354838709677
Control.SRR15539874;39;32;0.461538461538462;21;18;0.0384615384615384;0.461538461538462
Control.SRR15539874;33;32;0.606060606060606;13;20;0.106060606060606;0.393939393939394
Control.SRR15539874;33;32;0.575757575757576;14;19;0.0757575757575758;0.424242424242424
Control.SRR15539874;37;32;0.594594594594595;15;22;0.0945945945945946;0.405405405405405
Control.SRR15539874;37;32;0.486486486486487;19;18;0.0135135135135135;0.486486486486487
Control.SRR15539874;29;32;0.448275862068966;16;13;0.0517241379310345;0.448275862068966
Control.SRR15539874;37;32;0.432432432432432;21;16;0.0675675675675675;0.432432432432432
Control.SRR15539874;32;32;0.40625;19;13;0.09375;0.40625
Control.SRR15539874;35;32;0.428571428571429;20;15;0.0714285714285715;0.428571428571429
Control.SRR15539874;34;32;0.470588235294118;18;16;0.0294117647058824;0.470588235294118
Control.SRR15539874;37;32;0.513513513513513;18;19;0.0135135135135135;0.486486486486487
Control.SRR15539874;37;32;0.378378378378378;23;14;0.121621621621622;0.378378378378378
Control.SRR15539874;31;32;0.387096774193548;19;12;0.112903225806452;0.387096774193548
Control.SRR15539874;30;32;0.433333333333333;17;13;0.0666666666666667;0.433333333333333
Control.SRR15539874;30;32;0.333333333333333;20;10;0.166666666666667;0.333333333333333
Control.SRR15539874;39;32;0.564102564102564;17;22;0.0641025641025641;0.435897435897436
Control.SRR15539874;29;32;0.482758620689655;15;14;0.0172413793103448;0.482758620689655
Control.SRR15539874;29;32;0.413793103448276;17;12;0.0862068965517241;0.413793103448276
Control.SRR15539874;36;32;0.611111111111111;14;22;0.111111111111111;0.388888888888889
Control.SRR15539874;33;32;0.454545454545455;18;15;0.0454545454545455;0.454545454545455
Control.SRR15539874;32;32;0.46875;17;15;0.03125;0.46875
Control.SRR15539874;35;32;0.514285714285714;17;18;0.0142857142857142;0.485714285714286
Control.SRR15539874;35;32;0.428571428571429;20;15;0.0714285714285715;0.428571428571429
Control.SRR15539874;33;32;0.636363636363636;12;21;0.136363636363636;0.363636363636364
Control.SRR15539874;36;32;0.416666666666667;21;15;0.0833333333333333;0.416666666666667
Control.SRR15539874;30;32;0.466666666666667;16;14;0.0333333333333333;0.466666666666667
Control.SRR15539874;30;32;0.5;15;15;0;0.5
Control.SRR15539874;29;32;0.448275862068966;16;13;0.0517241379310345;0.448275862068966
Control.SRR15539874;30;32;0.566666666666667;13;17;0.0666666666666667;0.433333333333333
Control.SRR15539874;34;32;0.411764705882353;20;14;0.0882352941176471;0.411764705882353
Control.SRR15539874;32;32;0.53125;15;17;0.03125;0.46875
Control.SRR15539874;31;32;0.645161290322581;11;20;0.145161290322581;0.354838709677419
Control.SRR15539874;34;32;0.441176470588235;19;15;0.0588235294117647;0.441176470588235
Control.SRR15539874;29;32;0.551724137931034;13;16;0.0517241379310345;0.448275862068966
Control.SRR15539874;39;32;0.435897435897436;22;17;0.0641025641025641;0.435897435897436
Control.SRR15539874;30;32;0.4;18;12;0.1;0.4
Control.SRR15539874;35;32;0.6;14;21;0.1;0.4
Control.SRR15539874;29;32;0.448275862068966;16;13;0.0517241379310345;0.448275862068966
Control.SRR15539874;38;32;0.394736842105263;23;15;0.105263157894737;0.394736842105263
Control.SRR15539874;34;32;0.382352941176471;21;13;0.117647058823529;0.382352941176471
Control.SRR15539874;32;32;0.4375;18;14;0.0625;0.4375
Control.SRR15539874;37;32;0.459459459459459;20;17;0.0405405405405405;0.459459459459459
Control.SRR15539874;38;32;0.5;19;19;0;0.5
Control.SRR15539874;36;32;0.444444444444444;20;16;0.0555555555555556;0.444444444444444
Control.SRR15539874;35;32;0.514285714285714;17;18;0.0142857142857142;0.485714285714286
Control.SRR15539874;32;32;0.46875;17;15;0.03125;0.46875
Control.SRR15539874;34;32;0.470588235294118;18;16;0.0294117647058824;0.470588235294118
Control.SRR15539874;30;32;0.533333333333333;14;16;0.0333333333333333;0.466666666666667
Control.SRR15539874;37;32;0.567567567567568;16;21;0.0675675675675675;0.432432432432432
Control.SRR15539874;39;32;0.487179487179487;20;19;0.0128205128205128;0.487179487179487
Control.SRR15539874;35;32;0.342857142857143;23;12;0.157142857142857;0.342857142857143
Control.SRR15539874;34;32;0.411764705882353;20;14;0.0882352941176471;0.411764705882353
Control.SRR15539874;30;32;0.466666666666667;16;14;0.0333333333333333;0.466666666666667
Control.SRR15539874;29;32;0.551724137931034;13;16;0.0517241379310345;0.448275862068966
Control.SRR15539874;31;32;0.451612903225806;17;14;0.0483870967741936;0.451612903225806
Control.SRR15539874;34;32;0.441176470588235;19;15;0.0588235294117647;0.441176470588235
Control.SRR15539874;33;32;0.757575757575758;8;25;0.257575757575758;0.242424242424242
Control.SRR15539874;31;32;0.354838709677419;20;11;0.145161290322581;0.354838709677419
Control.SRR15539874;31;32;0.580645161290323;13;18;0.0806451612903226;0.419354838709677
Control.SRR15539874;29;32;0.310344827586207;20;9;0.189655172413793;0.310344827586207
Control.SRR15539874;30;32;0.5;15;15;0;0.5
Control.SRR15539874;32;32;0.5625;14;18;0.0625;0.4375
Control.SRR15539874;35;32;0.485714285714286;18;17;0.0142857142857143;0.485714285714286
Control.SRR15539874;29;32;0.448275862068966;16;13;0.0517241379310345;0.448275862068966
Control.SRR15539874;29;32;0.517241379310345;14;15;0.0172413793103449;0.482758620689655
Control.SRR15539874;29;32;0.551724137931034;13;16;0.0517241379310345;0.448275862068966
Control.SRR15539874;33;32;0.545454545454545;15;18;0.0454545454545454;0.454545454545455
Control.SRR15539874;32;32;0.53125;15;17;0.03125;0.46875
Control.SRR15539874;32;32;0.53125;15;17;0.03125;0.46875
Control.SRR15539874;29;32;0.448275862068966;16;13;0.0517241379310345;0.448275862068966
Control.SRR15539874;29;32;0.482758620689655;15;14;0.0172413793103448;0.482758620689655
Control.SRR15539874;29;32;0.517241379310345;14;15;0.0172413793103449;0.482758620689655
Control.SRR15539874;32;32;0.5625;14;18;0.0625;0.4375
Control.SRR15539874;33;32;0.454545454545455;18;15;0.0454545454545455;0.454545454545455
Control.SRR15539874;29;32;0.413793103448276;17;12;0.0862068965517241;0.413793103448276
Control.SRR15539874;31;32;0.451612903225806;17;14;0.0483870967741936;0.451612903225806
Control.SRR15539874;36;32;0.444444444444444;20;16;0.0555555555555556;0.444444444444444
Control.SRR15539874;31;32;0.645161290322581;11;20;0.145161290322581;0.354838709677419
Control.SRR15539874;30;32;0.6;12;18;0.1;0.4
Control.SRR15539874;37;32;0.432432432432432;21;16;0.0675675675675675;0.432432432432432
Control.SRR15539874;30;32;0.4;18;12;0.1;0.4
Control.SRR15539874;33;32;0.515151515151515;16;17;0.0151515151515151;0.484848484848485
Control.SRR15539874;30;32;0.533333333333333;14;16;0.0333333333333333;0.466666666666667
Control.SRR15539874;34;32;0.441176470588235;19;15;0.0588235294117647;0.441176470588235
Control.SRR15539874;29;32;0.655172413793103;10;19;0.155172413793103;0.344827586206897
Control.SRR15539874;36;32;0.666666666666667;12;24;0.166666666666667;0.333333333333333
Control.SRR15539874;32;32;0.53125;15;17;0.03125;0.46875
Control.SRR15539874;37;32;0.621621621621622;14;23;0.121621621621622;0.378378378378378
Control.SRR15539874;34;32;0.470588235294118;18;16;0.0294117647058824;0.470588235294118
Control.SRR15539874;31;32;0.483870967741935;16;15;0.0161290322580645;0.483870967741935
Control.SRR15539874;31;32;0.67741935483871;10;21;0.17741935483871;0.32258064516129
Control.SRR15539874;33;32;0.454545454545455;18;15;0.0454545454545455;0.454545454545455
Control.SRR15539874;30;32;0.366666666666667;19;11;0.133333333333333;0.366666666666667
Control.SRR15539874;32;32;0.59375;13;19;0.09375;0.40625
Control.SRR15539874;29;32;0.586206896551724;12;17;0.0862068965517241;0.413793103448276
Control.SRR15539874;30;32;0.666666666666667;10;20;0.166666666666667;0.333333333333333
Control.SRR15539874;36;32;0.583333333333333;15;21;0.0833333333333334;0.416666666666667
Control.SRR15539874;29;32;0.413793103448276;17;12;0.0862068965517241;0.413793103448276
Control.SRR15539874;30;32;0.533333333333333;14;16;0.0333333333333333;0.466666666666667
Control.SRR15539874;32;32;0.59375;13;19;0.09375;0.40625
Control.SRR15539874;30;32;0.6;12;18;0.1;0.4
Control.SRR15539874;30;32;0.4;18;12;0.1;0.4
Control.SRR15539874;29;32;0.413793103448276;17;12;0.0862068965517241;0.413793103448276
Control.SRR15539874;33;32;0.545454545454545;15;18;0.0454545454545454;0.454545454545455
Control.SRR15539874;35;32;0.342857142857143;23;12;0.157142857142857;0.342857142857143
Control.SRR15539874;32;32;0.4375;18;14;0.0625;0.4375
Control.SRR15539874;34;32;0.441176470588235;19;15;0.0588235294117647;0.441176470588235
Control.SRR15539874;36;32;0.583333333333333;15;21;0.0833333333333334;0.416666666666667
Control.SRR15539874;29;32;0.517241379310345;14;15;0.0172413793103449;0.482758620689655
Control.SRR15539874;30;32;0.4;18;12;0.1;0.4
Control.SRR15539874;36;32;0.5;18;18;0;0.5
Control.SRR15539874;36;32;0.555555555555556;16;20;0.0555555555555556;0.444444444444444
Control.SRR15539874;31;32;0.483870967741935;16;15;0.0161290322580645;0.483870967741935
Control.SRR15539874;32;32;0.5;16;16;0;0.5
Control.SRR15539874;31;32;0.419354838709677;18;13;0.0806451612903226;0.419354838709677
Control.SRR15539874;29;32;0.448275862068966;16;13;0.0517241379310345;0.448275862068966
Control.SRR15539874;31;32;0.548387096774194;14;17;0.0483870967741935;0.451612903225806
Control.SRR15539874;33;32;0.636363636363636;12;21;0.136363636363636;0.363636363636364
Control.SRR15539874;33;32;0.424242424242424;19;14;0.0757575757575757;0.424242424242424
Control.SRR15539874;36;32;0.444444444444444;20;16;0.0555555555555556;0.444444444444444
Control.SRR15539874;31;32;0.483870967741935;16;15;0.0161290322580645;0.483870967741935
Control.SRR15539874;37;32;0.486486486486487;19;18;0.0135135135135135;0.486486486486487
Control.SRR15539874;30;32;0.466666666666667;16;14;0.0333333333333333;0.466666666666667
Control.SRR15539874;34;32;0.529411764705882;16;18;0.0294117647058824;0.470588235294118
Control.SRR15539874;37;32;0.540540540540541;17;20;0.0405405405405406;0.459459459459459
Control.SRR15539874;32;32;0.53125;15;17;0.03125;0.46875
Control.SRR15539874;35;32;0.457142857142857;19;16;0.0428571428571429;0.457142857142857
Control.SRR15539874;34;32;0.352941176470588;22;12;0.147058823529412;0.352941176470588
Control.SRR15539874;33;32;0.484848484848485;17;16;0.0151515151515151;0.484848484848485
Control.SRR15539874;35;32;0.514285714285714;17;18;0.0142857142857142;0.485714285714286
Control.SRR15539874;31;32;0.612903225806452;12;19;0.112903225806452;0.387096774193548
Control.SRR15539874;31;32;0.516129032258065;15;16;0.0161290322580645;0.483870967741935
Control.SRR15539874;30;32;0.566666666666667;13;17;0.0666666666666667;0.433333333333333
Control.SRR15539874;33;32;0.454545454545455;18;15;0.0454545454545455;0.454545454545455
Control.SRR15539874;30;32;0.566666666666667;13;17;0.0666666666666667;0.433333333333333
Control.SRR15539874;31;32;0.483870967741935;16;15;0.0161290322580645;0.483870967741935
Control.SRR15539874;33;32;0.454545454545455;18;15;0.0454545454545455;0.454545454545455
Control.SRR15539874;36;32;0.416666666666667;21;15;0.0833333333333333;0.416666666666667
Control.SRR15539874;31;32;0.451612903225806;17;14;0.0483870967741936;0.451612903225806
Control.SRR15539874;33;32;0.484848484848485;17;16;0.0151515151515151;0.484848484848485
Control.SRR15539874;34;32;0.529411764705882;16;18;0.0294117647058824;0.470588235294118
Control.SRR15539874;30;32;0.633333333333333;11;19;0.133333333333333;0.366666666666667
Control.SRR15539874;30;32;0.6;12;18;0.1;0.4
Control.SRR15539874;34;32;0.382352941176471;21;13;0.117647058823529;0.382352941176471
Control.SRR15539874;34;32;0.5;17;17;0;0.5
Control.SRR15539874;31;32;0.387096774193548;19;12;0.112903225806452;0.387096774193548
Control.SRR15539874;35;32;0.542857142857143;16;19;0.0428571428571428;0.457142857142857
Control.SRR15539874;34;32;0.529411764705882;16;18;0.0294117647058824;0.470588235294118
Control.SRR15539874;34;32;0.558823529411765;15;19;0.0588235294117647;0.441176470588235
Control.SRR15539874;33;32;0.606060606060606;13;20;0.106060606060606;0.393939393939394
Control.SRR15539874;36;32;0.416666666666667;21;15;0.0833333333333333;0.416666666666667
Control.SRR15539874;34;32;0.588235294117647;14;20;0.0882352941176471;0.411764705882353
Control.SRR15539874;30;32;0.333333333333333;20;10;0.166666666666667;0.333333333333333
Control.SRR15539874;37;32;0.540540540540541;17;20;0.0405405405405406;0.459459459459459
Control.SRR15539874;33;32;0.515151515151515;16;17;0.0151515151515151;0.484848484848485
Control.SRR15539874;37;32;0.594594594594595;15;22;0.0945945945945946;0.405405405405405
Control.SRR15539874;36;32;0.527777777777778;17;19;0.0277777777777778;0.472222222222222
Control.SRR15539874;36;32;0.333333333333333;24;12;0.166666666666667;0.333333333333333
Control.SRR15539874;34;32;0.352941176470588;22;12;0.147058823529412;0.352941176470588
Control.SRR15539874;36;32;0.611111111111111;14;22;0.111111111111111;0.388888888888889
Control.SRR15539874;32;32;0.46875;17;15;0.03125;0.46875
Control.SRR15539874;36;32;0.5;18;18;0;0.5
Control.SRR15539874;32;32;0.5;16;16;0;0.5
Control.SRR15539874;36;32;0.611111111111111;14;22;0.111111111111111;0.388888888888889
Control.SRR15539874;37;32;0.459459459459459;20;17;0.0405405405405405;0.459459459459459
Control.SRR15539874;33;32;0.393939393939394;20;13;0.106060606060606;0.393939393939394
Control.SRR15539874;36;32;0.5;18;18;0;0.5
Control.SRR15539874;36;32;0.472222222222222;19;17;0.0277777777777778;0.472222222222222
Control.SRR15539874;34;32;0.529411764705882;16;18;0.0294117647058824;0.470588235294118
Control.SRR15539874;31;32;0.419354838709677;18;13;0.0806451612903226;0.419354838709677
Control.SRR15539874;30;32;0.466666666666667;16;14;0.0333333333333333;0.466666666666667
Control.SRR15539874;30;32;0.4;18;12;0.1;0.4
Control.SRR15539874;33;32;0.545454545454545;15;18;0.0454545454545454;0.454545454545455
Control.SRR15539874;33;32;0.515151515151515;16;17;0.0151515151515151;0.484848484848485
Control.SRR15539874;32;32;0.4375;18;14;0.0625;0.4375
Control.SRR15539874;30;32;0.4;18;12;0.1;0.4
Control.SRR15539874;31;32;0.516129032258065;15;16;0.0161290322580645;0.483870967741935
Control.SRR15539874;30;32;0.4;18;12;0.1;0.4
Control.SRR15539874;31;32;0.516129032258065;15;16;0.0161290322580645;0.483870967741935
Control.SRR15539874;37;32;0.459459459459459;20;17;0.0405405405405405;0.459459459459459
Control.SRR15539874;34;32;0.617647058823529;13;21;0.117647058823529;0.382352941176471
Control.SRR15539874;30;32;0.466666666666667;16;14;0.0333333333333333;0.466666666666667
Control.SRR15539874;32;32;0.46875;17;15;0.03125;0.46875
Control.SRR15539874;37;32;0.594594594594595;15;22;0.0945945945945946;0.405405405405405
Control.SRR15539874;34;32;0.588235294117647;14;20;0.0882352941176471;0.411764705882353
Control.SRR15539874;34;32;0.558823529411765;15;19;0.0588235294117647;0.441176470588235
Control.SRR15539874;31;32;0.645161290322581;11;20;0.145161290322581;0.354838709677419
Control.SRR15539874;36;32;0.444444444444444;20;16;0.0555555555555556;0.444444444444444
Control.SRR15539874;34;32;0.558823529411765;15;19;0.0588235294117647;0.441176470588235
Control.SRR15539874;30;32;0.5;15;15;0;0.5
Control.SRR15539874;33;32;0.727272727272727;9;24;0.227272727272727;0.272727272727273
Control.SRR15539874;32;32;0.4375;18;14;0.0625;0.4375
Control.SRR15539874;33;32;0.424242424242424;19;14;0.0757575757575757;0.424242424242424
Control.SRR15539874;37;32;0.459459459459459;20;17;0.0405405405405405;0.459459459459459
Control.SRR15539874;32;32;0.59375;13;19;0.09375;0.40625
Control.SRR15539874;33;32;0.545454545454545;15;18;0.0454545454545454;0.454545454545455
Control.SRR15539874;31;32;0.645161290322581;11;20;0.145161290322581;0.354838709677419
Control.SRR15539874;36;32;0.416666666666667;21;15;0.0833333333333333;0.416666666666667
Control.SRR15539874;30;32;0.633333333333333;11;19;0.133333333333333;0.366666666666667
Control.SRR15539874;32;32;0.59375;13;19;0.09375;0.40625
Control.SRR15539874;31;32;0.516129032258065;15;16;0.0161290322580645;0.483870967741935
Control.SRR15539874;37;32;0.648648648648649;13;24;0.148648648648649;0.351351351351351
Control.SRR15539874;35;32;0.6;14;21;0.1;0.4
Control.SRR15539874;33;32;0.545454545454545;15;18;0.0454545454545454;0.454545454545455
Control.SRR15539874;35;32;0.628571428571429;13;22;0.128571428571429;0.371428571428571
Control.SRR15539874;35;32;0.571428571428571;15;20;0.0714285714285714;0.428571428571429
Control.SRR15539874;32;32;0.40625;19;13;0.09375;0.40625
Control.SRR15539874;35;32;0.514285714285714;17;18;0.0142857142857142;0.485714285714286
Control.SRR15539874;30;32;0.566666666666667;13;17;0.0666666666666667;0.433333333333333
Control.SRR15539874;32;32;0.53125;15;17;0.03125;0.46875
Control.SRR15539874;31;32;0.483870967741935;16;15;0.0161290322580645;0.483870967741935
Control.SRR15539874;34;32;0.470588235294118;18;16;0.0294117647058824;0.470588235294118
Control.SRR15539874;31;32;0.32258064516129;21;10;0.17741935483871;0.32258064516129
Control.SRR15539874;35;32;0.514285714285714;17;18;0.0142857142857142;0.485714285714286
Control.SRR15539874;34;32;0.647058823529412;12;22;0.147058823529412;0.352941176470588
Control.SRR15539874;37;32;0.513513513513513;18;19;0.0135135135135135;0.486486486486487
Control.SRR15539874;30;32;0.6;12;18;0.1;0.4
Control.SRR15539874;30;32;0.433333333333333;17;13;0.0666666666666667;0.433333333333333
Control.SRR15539874;30;32;0.433333333333333;17;13;0.0666666666666667;0.433333333333333
Control.SRR15539874;31;32;0.645161290322581;11;20;0.145161290322581;0.354838709677419
Control.SRR15539874;30;32;0.6;12;18;0.1;0.4
Control.SRR15539874;31;32;0.580645161290323;13;18;0.0806451612903226;0.419354838709677
Control.SRR15539874;32;32;0.5625;14;18;0.0625;0.4375
Control.SRR15539874;29;32;0.482758620689655;15;14;0.0172413793103448;0.482758620689655
Control.SRR15539874;33;32;0.515151515151515;16;17;0.0151515151515151;0.484848484848485
Control.SRR15539874;33;32;0.545454545454545;15;18;0.0454545454545454;0.454545454545455
Control.SRR15539874;35;32;0.514285714285714;17;18;0.0142857142857142;0.485714285714286
Control.SRR15539874;33;32;0.424242424242424;19;14;0.0757575757575757;0.424242424242424
Control.SRR15539874;32;32;0.59375;13;19;0.09375;0.40625
Control.SRR15539874;37;32;0.351351351351351;24;13;0.148648648648649;0.351351351351351
Control.SRR15539874;29;32;0.551724137931034;13;16;0.0517241379310345;0.448275862068966
Control.SRR15539874;29;32;0.517241379310345;14;15;0.0172413793103449;0.482758620689655
Control.SRR15539874;30;32;0.533333333333333;14;16;0.0333333333333333;0.466666666666667
Control.SRR15539874;37;32;0.513513513513513;18;19;0.0135135135135135;0.486486486486487
Control.SRR15539874;31;32;0.612903225806452;12;19;0.112903225806452;0.387096774193548
Control.SRR15539874;36;32;0.388888888888889;22;14;0.111111111111111;0.388888888888889
Control.SRR15539874;32;32;0.40625;19;13;0.09375;0.40625
Control.SRR15539874;37;32;0.513513513513513;18;19;0.0135135135135135;0.486486486486487
Control.SRR15539874;30;32;0.533333333333333;14;16;0.0333333333333333;0.466666666666667
Control.SRR15539874;30;32;0.5;15;15;0;0.5
Control.SRR15539874;36;32;0.5;18;18;0;0.5
Control.SRR15539874;30;32;0.5;15;15;0;0.5
Control.SRR15539874;34;32;0.411764705882353;20;14;0.0882352941176471;0.411764705882353
Control.SRR15539874;33;32;0.454545454545455;18;15;0.0454545454545455;0.454545454545455
Control.SRR15539874;34;32;0.529411764705882;16;18;0.0294117647058824;0.470588235294118
Control.SRR15539874;33;32;0.454545454545455;18;15;0.0454545454545455;0.454545454545455
Control.SRR15539874;34;32;0.558823529411765;15;19;0.0588235294117647;0.441176470588235
Control.SRR15539874;35;32;0.571428571428571;15;20;0.0714285714285714;0.428571428571429
Control.SRR15539874;35;32;0.542857142857143;16;19;0.0428571428571428;0.457142857142857
Control.SRR15539874;37;32;0.486486486486487;19;18;0.0135135135135135;0.486486486486487
Control.SRR15539874;31;32;0.451612903225806;17;14;0.0483870967741936;0.451612903225806
Control.SRR15539874;36;32;0.5;18;18;0;0.5
Control.SRR15539874;36;32;0.472222222222222;19;17;0.0277777777777778;0.472222222222222
Control.SRR15539874;30;32;0.533333333333333;14;16;0.0333333333333333;0.466666666666667
Control.SRR15539874;34;32;0.5;17;17;0;0.5
Control.SRR15539874;36;32;0.5;18;18;0;0.5
Control.SRR15539874;37;32;0.594594594594595;15;22;0.0945945945945946;0.405405405405405
Control.SRR15539874;33;32;0.575757575757576;14;19;0.0757575757575758;0.424242424242424
Control.SRR15539874;31;32;0.290322580645161;22;9;0.209677419354839;0.290322580645161
Control.SRR15539874;30;32;0.5;15;15;0;0.5
Control.SRR15539874;35;32;0.485714285714286;18;17;0.0142857142857143;0.485714285714286
Control.SRR15539874;35;32;0.542857142857143;16;19;0.0428571428571428;0.457142857142857
Control.SRR15539874;36;32;0.5;18;18;0;0.5
Control.SRR15539874;35;32;0.542857142857143;16;19;0.0428571428571428;0.457142857142857
Control.SRR15539874;32;32;0.53125;15;17;0.03125;0.46875
Control.SRR15539874;32;32;0.46875;17;15;0.03125;0.46875
Control.SRR15539874;36;32;0.5;18;18;0;0.5
Control.SRR15539874;31;32;0.580645161290323;13;18;0.0806451612903226;0.419354838709677
Control.SRR15539874;36;32;0.5;18;18;0;0.5
Control.SRR15539874;35;32;0.628571428571429;13;22;0.128571428571429;0.371428571428571
Control.SRR15539874;35;32;0.514285714285714;17;18;0.0142857142857142;0.485714285714286
Control.SRR15539874;33;32;0.484848484848485;17;16;0.0151515151515151;0.484848484848485
Control.SRR15539874;32;32;0.5;16;16;0;0.5
Control.SRR15539874;29;32;0.448275862068966;16;13;0.0517241379310345;0.448275862068966
Control.SRR15539874;31;32;0.612903225806452;12;19;0.112903225806452;0.387096774193548
Control.SRR15539874;34;32;0.470588235294118;18;16;0.0294117647058824;0.470588235294118
Control.SRR15539874;31;32;0.387096774193548;19;12;0.112903225806452;0.387096774193548
Control.SRR15539874;29;32;0.620689655172414;11;18;0.120689655172414;0.379310344827586
Control.SRR15539874;30;32;0.433333333333333;17;13;0.0666666666666667;0.433333333333333
Control.SRR15539874;32;32;0.4375;18;14;0.0625;0.4375
Control.SRR15539874;30;32;0.566666666666667;13;17;0.0666666666666667;0.433333333333333
Control.SRR15539874;36;32;0.416666666666667;21;15;0.0833333333333333;0.416666666666667
Control.SRR15539874;36;32;0.583333333333333;15;21;0.0833333333333334;0.416666666666667
Control.SRR15539874;34;32;0.441176470588235;19;15;0.0588235294117647;0.441176470588235
Control.SRR15539874;30;32;0.5;15;15;0;0.5
Control.SRR15539874;30;32;0.466666666666667;16;14;0.0333333333333333;0.466666666666667
Control.SRR15539874;32;32;0.34375;21;11;0.15625;0.34375
Control.SRR15539874;33;32;0.636363636363636;12;21;0.136363636363636;0.363636363636364
Control.SRR15539874;34;32;0.441176470588235;19;15;0.0588235294117647;0.441176470588235
Control.SRR15539874;34;32;0.588235294117647;14;20;0.0882352941176471;0.411764705882353
Control.SRR15539874;29;32;0.517241379310345;14;15;0.0172413793103449;0.482758620689655
Control.SRR15539874;33;32;0.575757575757576;14;19;0.0757575757575758;0.424242424242424
Control.SRR15539874;32;32;0.5;16;16;0;0.5
Control.SRR15539874;36;32;0.361111111111111;23;13;0.138888888888889;0.361111111111111
Control.SRR15539874;32;32;0.375;20;12;0.125;0.375
Control.SRR15539874;32;32;0.53125;15;17;0.03125;0.46875
Control.SRR15539874;32;32;0.46875;17;15;0.03125;0.46875
Control.SRR15539874;30;32;0.566666666666667;13;17;0.0666666666666667;0.433333333333333
Control.SRR15539874;32;32;0.65625;11;21;0.15625;0.34375
Control.SRR15539874;33;32;0.515151515151515;16;17;0.0151515151515151;0.484848484848485
Control.SRR15539874;30;32;0.666666666666667;10;20;0.166666666666667;0.333333333333333
Control.SRR15539874;35;32;0.457142857142857;19;16;0.0428571428571429;0.457142857142857
Control.SRR15539874;34;32;0.411764705882353;20;14;0.0882352941176471;0.411764705882353
Control.SRR15539874;34;32;0.5;17;17;0;0.5
Control.SRR15539874;35;32;0.485714285714286;18;17;0.0142857142857143;0.485714285714286
Control.SRR15539874;34;32;0.5;17;17;0;0.5
Control.SRR15539874;35;32;0.542857142857143;16;19;0.0428571428571428;0.457142857142857
Control.SRR15539874;37;32;0.459459459459459;20;17;0.0405405405405405;0.459459459459459
Control.SRR15539874;32;32;0.375;20;12;0.125;0.375
Control.SRR15539874;37;32;0.513513513513513;18;19;0.0135135135135135;0.486486486486487
Control.SRR15539874;35;32;0.485714285714286;18;17;0.0142857142857143;0.485714285714286
Control.SRR15539874;33;32;0.545454545454545;15;18;0.0454545454545454;0.454545454545455
Control.SRR15539874;33;32;0.545454545454545;15;18;0.0454545454545454;0.454545454545455
Control.SRR15539874;29;32;0.551724137931034;13;16;0.0517241379310345;0.448275862068966
Control.SRR15539874;36;32;0.388888888888889;22;14;0.111111111111111;0.388888888888889
Control.SRR15539874;34;32;0.529411764705882;16;18;0.0294117647058824;0.470588235294118
Control.SRR15539874;32;32;0.4375;18;14;0.0625;0.4375
Control.SRR15539874;31;32;0.451612903225806;17;14;0.0483870967741936;0.451612903225806
Control.SRR15539874;32;32;0.59375;13;19;0.09375;0.40625
Control.SRR15539874;31;32;0.612903225806452;12;19;0.112903225806452;0.387096774193548
Control.SRR15539874;37;32;0.486486486486487;19;18;0.0135135135135135;0.486486486486487
Control.SRR15539874;30;32;0.566666666666667;13;17;0.0666666666666667;0.433333333333333
Control.SRR15539874;36;32;0.638888888888889;13;23;0.138888888888889;0.361111111111111
Control.SRR15539874;36;32;0.444444444444444;20;16;0.0555555555555556;0.444444444444444
Control.SRR15539874;36;32;0.333333333333333;24;12;0.166666666666667;0.333333333333333
Control.SRR15539874;36;32;0.444444444444444;20;16;0.0555555555555556;0.444444444444444
Control.SRR15539874;37;32;0.594594594594595;15;22;0.0945945945945946;0.405405405405405
Control.SRR15539874;30;32;0.5;15;15;0;0.5
Control.SRR15539874;34;32;0.676470588235294;11;23;0.176470588235294;0.323529411764706
Control.SRR15539874;32;32;0.40625;19;13;0.09375;0.40625
Control.SRR15539874;32;32;0.59375;13;19;0.09375;0.40625
Control.SRR15539874;33;32;0.424242424242424;19;14;0.0757575757575757;0.424242424242424
Control.SRR15539874;31;32;0.451612903225806;17;14;0.0483870967741936;0.451612903225806
Control.SRR15539874;37;32;0.459459459459459;20;17;0.0405405405405405;0.459459459459459
Control.SRR15539874;32;32;0.5;16;16;0;0.5
Control.SRR15539874;29;32;0.379310344827586;18;11;0.120689655172414;0.379310344827586
Control.SRR15539874;32;32;0.59375;13;19;0.09375;0.40625
Control.SRR15539874;36;32;0.527777777777778;17;19;0.0277777777777778;0.472222222222222
Control.SRR15539874;34;32;0.529411764705882;16;18;0.0294117647058824;0.470588235294118
Control.SRR15539874;29;32;0.551724137931034;13;16;0.0517241379310345;0.448275862068966
Control.SRR15539874;34;32;0.588235294117647;14;20;0.0882352941176471;0.411764705882353
Control.SRR15539874;32;32;0.46875;17;15;0.03125;0.46875
Control.SRR15539874;34;32;0.411764705882353;20;14;0.0882352941176471;0.411764705882353
Control.SRR15539874;33;32;0.606060606060606;13;20;0.106060606060606;0.393939393939394
Control.SRR15539874;31;32;0.419354838709677;18;13;0.0806451612903226;0.419354838709677
Control.SRR15539874;36;32;0.611111111111111;14;22;0.111111111111111;0.388888888888889
Control.SRR15539874;35;32;0.514285714285714;17;18;0.0142857142857142;0.485714285714286
Control.SRR15539874;30;32;0.533333333333333;14;16;0.0333333333333333;0.466666666666667
Control.SRR15539874;34;32;0.5;17;17;0;0.5
Control.SRR15539874;36;32;0.583333333333333;15;21;0.0833333333333334;0.416666666666667
Control.SRR15539874;29;32;0.655172413793103;10;19;0.155172413793103;0.344827586206897
Control.SRR15539874;37;32;0.378378378378378;23;14;0.121621621621622;0.378378378378378
Control.SRR15539874;35;32;0.485714285714286;18;17;0.0142857142857143;0.485714285714286
Control.SRR15539874;33;32;0.575757575757576;14;19;0.0757575757575758;0.424242424242424
Control.SRR15539874;31;32;0.451612903225806;17;14;0.0483870967741936;0.451612903225806
Control.SRR15539874;29;32;0.620689655172414;11;18;0.120689655172414;0.379310344827586
Control.SRR15539874;30;32;0.466666666666667;16;14;0.0333333333333333;0.466666666666667
Control.SRR15539874;37;32;0.513513513513513;18;19;0.0135135135135135;0.486486486486487
Control.SRR15539874;31;32;0.483870967741935;16;15;0.0161290322580645;0.483870967741935
Control.SRR15539874;31;32;0.451612903225806;17;14;0.0483870967741936;0.451612903225806
Control.SRR15539874;32;32;0.4375;18;14;0.0625;0.4375
Control.SRR15539874;35;32;0.514285714285714;17;18;0.0142857142857142;0.485714285714286
Control.SRR15539874;37;32;0.513513513513513;18;19;0.0135135135135135;0.486486486486487
Control.SRR15539874;30;32;0.633333333333333;11;19;0.133333333333333;0.366666666666667
Control.SRR15539874;35;32;0.371428571428571;22;13;0.128571428571429;0.371428571428571
Control.SRR15539874;30;32;0.6;12;18;0.1;0.4
Control.SRR15539874;33;32;0.393939393939394;20;13;0.106060606060606;0.393939393939394
Control.SRR15539874;32;32;0.625;12;20;0.125;0.375
Control.SRR15539874;36;32;0.5;18;18;0;0.5
Control.SRR15539874;29;32;0.275862068965517;21;8;0.224137931034483;0.275862068965517
Control.SRR15539874;34;32;0.647058823529412;12;22;0.147058823529412;0.352941176470588
Control.SRR15539874;37;32;0.351351351351351;24;13;0.148648648648649;0.351351351351351
Control.SRR15539874;36;32;0.305555555555556;25;11;0.194444444444444;0.305555555555556
Control.SRR15539874;35;32;0.485714285714286;18;17;0.0142857142857143;0.485714285714286
Control.SRR15539874;33;32;0.575757575757576;14;19;0.0757575757575758;0.424242424242424
Control.SRR15539874;32;32;0.40625;19;13;0.09375;0.40625
Control.SRR15539874;29;32;0.379310344827586;18;11;0.120689655172414;0.379310344827586
Control.SRR15539874;29;32;0.586206896551724;12;17;0.0862068965517241;0.413793103448276
Control.SRR15539874;35;32;0.542857142857143;16;19;0.0428571428571428;0.457142857142857
Control.SRR15539874;30;32;0.566666666666667;13;17;0.0666666666666667;0.433333333333333
Control.SRR15539874;37;32;0.378378378378378;23;14;0.121621621621622;0.378378378378378
Control.SRR15539874;31;32;0.451612903225806;17;14;0.0483870967741936;0.451612903225806
Control.SRR15539874;34;32;0.441176470588235;19;15;0.0588235294117647;0.441176470588235
Control.SRR15539874;33;32;0.575757575757576;14;19;0.0757575757575758;0.424242424242424
Control.SRR15539874;37;32;0.567567567567568;16;21;0.0675675675675675;0.432432432432432
Control.SRR15539874;29;32;0.448275862068966;16;13;0.0517241379310345;0.448275862068966
Control.SRR15539874;37;32;0.540540540540541;17;20;0.0405405405405406;0.459459459459459
Control.SRR15539874;35;32;0.428571428571429;20;15;0.0714285714285715;0.428571428571429
Control.SRR15539874;36;32;0.666666666666667;12;24;0.166666666666667;0.333333333333333
Control.SRR15539874;33;32;0.424242424242424;19;14;0.0757575757575757;0.424242424242424
Control.SRR15539874;32;32;0.46875;17;15;0.03125;0.46875
Control.SRR15539874;32;32;0.5625;14;18;0.0625;0.4375
Control.SRR15539874;30;32;0.3;21;9;0.2;0.3
Control.SRR15539874;29;32;0.655172413793103;10;19;0.155172413793103;0.344827586206897
Control.SRR15539874;33;32;0.606060606060606;13;20;0.106060606060606;0.393939393939394
Control.SRR15539874;36;32;0.416666666666667;21;15;0.0833333333333333;0.416666666666667
Control.SRR15539874;32;32;0.65625;11;21;0.15625;0.34375
Control.SRR15539874;33;32;0.515151515151515;16;17;0.0151515151515151;0.484848484848485
Control.SRR15539874;32;32;0.40625;19;13;0.09375;0.40625
Control.SRR15539874;34;32;0.529411764705882;16;18;0.0294117647058824;0.470588235294118
Control.SRR15539874;35;32;0.571428571428571;15;20;0.0714285714285714;0.428571428571429
Control.SRR15539874;35;32;0.4;21;14;0.1;0.4
Control.SRR15539874;29;32;0.413793103448276;17;12;0.0862068965517241;0.413793103448276
Control.SRR15539874;33;32;0.545454545454545;15;18;0.0454545454545454;0.454545454545455
Control.SRR15539874;32;32;0.5625;14;18;0.0625;0.4375
Control.SRR15539874;34;32;0.441176470588235;19;15;0.0588235294117647;0.441176470588235
Control.SRR15539874;32;32;0.53125;15;17;0.03125;0.46875
Control.SRR15539874;37;32;0.594594594594595;15;22;0.0945945945945946;0.405405405405405
Control.SRR15539874;37;32;0.621621621621622;14;23;0.121621621621622;0.378378378378378
Control.SRR15539874;31;32;0.516129032258065;15;16;0.0161290322580645;0.483870967741935
Control.SRR15539874;29;32;0.482758620689655;15;14;0.0172413793103448;0.482758620689655
Control.SRR15539874;30;32;0.7;9;21;0.2;0.3
Control.SRR15539874;30;32;0.466666666666667;16;14;0.0333333333333333;0.466666666666667
Control.SRR15539874;32;32;0.375;20;12;0.125;0.375
Control.SRR15539874;33;32;0.606060606060606;13;20;0.106060606060606;0.393939393939394
Control.SRR15539874;33;32;0.333333333333333;22;11;0.166666666666667;0.333333333333333
Control.SRR15539874;36;32;0.472222222222222;19;17;0.0277777777777778;0.472222222222222
Control.SRR15539874;30;32;0.566666666666667;13;17;0.0666666666666667;0.433333333333333
Control.SRR15539874;29;32;0.689655172413793;9;20;0.189655172413793;0.310344827586207
Control.SRR15539874;32;32;0.4375;18;14;0.0625;0.4375
Control.SRR15539874;36;32;0.5;18;18;0;0.5
Control.SRR15539874;29;32;0.448275862068966;16;13;0.0517241379310345;0.448275862068966
Control.SRR15539874;33;32;0.454545454545455;18;15;0.0454545454545455;0.454545454545455
Control.SRR15539874;33;32;0.484848484848485;17;16;0.0151515151515151;0.484848484848485
Control.SRR15539874;30;32;0.6;12;18;0.1;0.4
Control.SRR15539874;37;32;0.621621621621622;14;23;0.121621621621622;0.378378378378378
Control.SRR15539874;35;32;0.542857142857143;16;19;0.0428571428571428;0.457142857142857
Control.SRR15539874;36;32;0.416666666666667;21;15;0.0833333333333333;0.416666666666667
Control.SRR15539874;37;32;0.567567567567568;16;21;0.0675675675675675;0.432432432432432
Control.SRR15539874;30;32;0.566666666666667;13;17;0.0666666666666667;0.433333333333333
Control.SRR15539874;29;32;0.379310344827586;18;11;0.120689655172414;0.379310344827586
Control.SRR15539874;35;32;0.571428571428571;15;20;0.0714285714285714;0.428571428571429
Control.SRR15539874;37;32;0.594594594594595;15;22;0.0945945945945946;0.405405405405405
Control.SRR15539874;35;32;0.457142857142857;19;16;0.0428571428571429;0.457142857142857
Control.SRR15539874;31;32;0.580645161290323;13;18;0.0806451612903226;0.419354838709677
Control.SRR15539874;29;32;0.482758620689655;15;14;0.0172413793103448;0.482758620689655
Control.SRR15539874;33;32;0.545454545454545;15;18;0.0454545454545454;0.454545454545455
Control.SRR15539874;31;32;0.548387096774194;14;17;0.0483870967741935;0.451612903225806
Control.SRR15539874;36;32;0.416666666666667;21;15;0.0833333333333333;0.416666666666667
Control.SRR15539874;31;32;0.483870967741935;16;15;0.0161290322580645;0.483870967741935
Control.SRR15539874;33;32;0.454545454545455;18;15;0.0454545454545455;0.454545454545455
Control.SRR15539874;36;32;0.416666666666667;21;15;0.0833333333333333;0.416666666666667
Control.SRR15539874;34;32;0.382352941176471;21;13;0.117647058823529;0.382352941176471
Control.SRR15539874;32;32;0.65625;11;21;0.15625;0.34375
Control.SRR15539874;30;32;0.533333333333333;14;16;0.0333333333333333;0.466666666666667
Control.SRR15539874;34;32;0.529411764705882;16;18;0.0294117647058824;0.470588235294118
Control.SRR15539874;29;32;0.344827586206897;19;10;0.155172413793103;0.344827586206897
Control.SRR15539874;37;32;0.621621621621622;14;23;0.121621621621622;0.378378378378378
Control.SRR15539874;29;32;0.448275862068966;16;13;0.0517241379310345;0.448275862068966
Control.SRR15539874;31;32;0.387096774193548;19;12;0.112903225806452;0.387096774193548
Control.SRR15539874;33;32;0.454545454545455;18;15;0.0454545454545455;0.454545454545455
Control.SRR15539874;29;32;0.551724137931034;13;16;0.0517241379310345;0.448275862068966
Control.SRR15539874;33;32;0.484848484848485;17;16;0.0151515151515151;0.484848484848485
Control.SRR15539874;29;32;0.482758620689655;15;14;0.0172413793103448;0.482758620689655
Control.SRR15539874;37;32;0.459459459459459;20;17;0.0405405405405405;0.459459459459459
Control.SRR15539874;35;32;0.514285714285714;17;18;0.0142857142857142;0.485714285714286
Control.SRR15539874;33;32;0.454545454545455;18;15;0.0454545454545455;0.454545454545455
Control.SRR15539874;33;32;0.424242424242424;19;14;0.0757575757575757;0.424242424242424
Control.SRR15539874;31;32;0.516129032258065;15;16;0.0161290322580645;0.483870967741935
Control.SRR15539874;30;32;0.466666666666667;16;14;0.0333333333333333;0.466666666666667
Control.SRR15539874;32;32;0.4375;18;14;0.0625;0.4375
Control.SRR15539874;29;32;0.482758620689655;15;14;0.0172413793103448;0.482758620689655
Control.SRR15539874;36;32;0.444444444444444;20;16;0.0555555555555556;0.444444444444444
Control.SRR15539874;30;32;0.5;15;15;0;0.5
Control.SRR15539874;31;32;0.580645161290323;13;18;0.0806451612903226;0.419354838709677
Control.SRR15539874;36;32;0.5;18;18;0;0.5
Control.SRR15539874;34;32;0.558823529411765;15;19;0.0588235294117647;0.441176470588235
Control.SRR15539874;34;32;0.529411764705882;16;18;0.0294117647058824;0.470588235294118
Control.SRR15539874;37;32;0.486486486486487;19;18;0.0135135135135135;0.486486486486487
Control.SRR15539874;29;32;0.551724137931034;13;16;0.0517241379310345;0.448275862068966
Control.SRR15539874;37;32;0.432432432432432;21;16;0.0675675675675675;0.432432432432432
Control.SRR15539874;33;32;0.575757575757576;14;19;0.0757575757575758;0.424242424242424
Control.SRR15539874;31;32;0.451612903225806;17;14;0.0483870967741936;0.451612903225806
Control.SRR15539874;36;32;0.527777777777778;17;19;0.0277777777777778;0.472222222222222
Control.SRR15539874;35;32;0.4;21;14;0.1;0.4
Control.SRR15539874;32;32;0.625;12;20;0.125;0.375
Control.SRR15539874;31;32;0.483870967741935;16;15;0.0161290322580645;0.483870967741935
Control.SRR15539874;34;32;0.588235294117647;14;20;0.0882352941176471;0.411764705882353
Control.SRR15539874;36;32;0.416666666666667;21;15;0.0833333333333333;0.416666666666667
Control.SRR15539874;36;32;0.472222222222222;19;17;0.0277777777777778;0.472222222222222
Control.SRR15539874;28;32;0.535714285714286;13;15;0.0357142857142857;0.464285714285714
Control.SRR15539874;35;32;0.571428571428571;15;20;0.0714285714285714;0.428571428571429
Control.SRR15539874;34;32;0.411764705882353;20;14;0.0882352941176471;0.411764705882353
Control.SRR15539874;28;32;0.392857142857143;17;11;0.107142857142857;0.392857142857143
Control.SRR15539874;35;32;0.457142857142857;19;16;0.0428571428571429;0.457142857142857
Control.SRR15539874;35;32;0.485714285714286;18;17;0.0142857142857143;0.485714285714286
Control.SRR15539874;33;32;0.484848484848485;17;16;0.0151515151515151;0.484848484848485
Control.SRR15539874;34;32;0.441176470588235;19;15;0.0588235294117647;0.441176470588235
Control.SRR15539874;31;32;0.580645161290323;13;18;0.0806451612903226;0.419354838709677
Control.SRR15539874;28;32;0.714285714285714;8;20;0.214285714285714;0.285714285714286
Control.SRR15539874;30;32;0.466666666666667;16;14;0.0333333333333333;0.466666666666667
Control.SRR15539874;35;32;0.457142857142857;19;16;0.0428571428571429;0.457142857142857
Control.SRR15539874;35;32;0.542857142857143;16;19;0.0428571428571428;0.457142857142857
Control.SRR15539874;30;32;0.6;12;18;0.1;0.4
Control.SRR15539874;29;32;0.586206896551724;12;17;0.0862068965517241;0.413793103448276
Control.SRR15539874;34;32;0.470588235294118;18;16;0.0294117647058824;0.470588235294118
Control.SRR15539874;33;32;0.484848484848485;17;16;0.0151515151515151;0.484848484848485
Control.SRR15539874;35;32;0.571428571428571;15;20;0.0714285714285714;0.428571428571429
Control.SRR15539874;33;32;0.393939393939394;20;13;0.106060606060606;0.393939393939394
Control.SRR15539874;33;32;0.424242424242424;19;14;0.0757575757575757;0.424242424242424
Control.SRR15539874;33;32;0.515151515151515;16;17;0.0151515151515151;0.484848484848485
Control.SRR15539874;31;32;0.32258064516129;21;10;0.17741935483871;0.32258064516129
Control.SRR15539874;30;32;0.566666666666667;13;17;0.0666666666666667;0.433333333333333
Control.SRR15539874;35;32;0.457142857142857;19;16;0.0428571428571429;0.457142857142857
Control.SRR15539874;29;32;0.586206896551724;12;17;0.0862068965517241;0.413793103448276
Control.SRR15539874;29;32;0.413793103448276;17;12;0.0862068965517241;0.413793103448276
Control.SRR15539874;28;32;0.571428571428571;12;16;0.0714285714285714;0.428571428571429
Control.SRR15539874;33;32;0.484848484848485;17;16;0.0151515151515151;0.484848484848485
Control.SRR15539874;28;32;0.464285714285714;15;13;0.0357142857142857;0.464285714285714
Control.SRR15539874;31;32;0.419354838709677;18;13;0.0806451612903226;0.419354838709677
Control.SRR15539874;30;32;0.466666666666667;16;14;0.0333333333333333;0.466666666666667
Control.SRR15539874;29;32;0.482758620689655;15;14;0.0172413793103448;0.482758620689655
Control.SRR15539874;31;32;0.419354838709677;18;13;0.0806451612903226;0.419354838709677
Control.SRR15539874;33;32;0.515151515151515;16;17;0.0151515151515151;0.484848484848485
Control.SRR15539874;30;32;0.6;12;18;0.1;0.4
Control.SRR15539874;27;32;0.407407407407407;16;11;0.0925925925925926;0.407407407407407
Control.SRR15539874;29;32;0.517241379310345;14;15;0.0172413793103449;0.482758620689655
Control.SRR15539874;33;32;0.484848484848485;17;16;0.0151515151515151;0.484848484848485
Control.SRR15539874;34;32;0.470588235294118;18;16;0.0294117647058824;0.470588235294118
Control.SRR15539874;33;32;0.424242424242424;19;14;0.0757575757575757;0.424242424242424
Control.SRR15539874;33;32;0.606060606060606;13;20;0.106060606060606;0.393939393939394
Control.SRR15539874;32;32;0.53125;15;17;0.03125;0.46875
Control.SRR15539874;27;32;0.444444444444444;15;12;0.0555555555555556;0.444444444444444
Control.SRR15539874;35;32;0.571428571428571;15;20;0.0714285714285714;0.428571428571429
Control.SRR15539874;31;32;0.516129032258065;15;16;0.0161290322580645;0.483870967741935
Control.SRR15539874;35;32;0.571428571428571;15;20;0.0714285714285714;0.428571428571429
Control.SRR15539874;32;32;0.5;16;16;0;0.5
Control.SRR15539874;29;32;0.517241379310345;14;15;0.0172413793103449;0.482758620689655
Control.SRR15539874;27;32;0.592592592592593;11;16;0.0925925925925926;0.407407407407407
Control.SRR15539874;30;32;0.566666666666667;13;17;0.0666666666666667;0.433333333333333
Control.SRR15539874;34;32;0.617647058823529;13;21;0.117647058823529;0.382352941176471
Control.SRR15539874;33;32;0.363636363636364;21;12;0.136363636363636;0.363636363636364
Control.SRR15539874;28;32;0.535714285714286;13;15;0.0357142857142857;0.464285714285714
Control.SRR15539874;34;32;0.558823529411765;15;19;0.0588235294117647;0.441176470588235
Control.SRR15539874;28;32;0.464285714285714;15;13;0.0357142857142857;0.464285714285714
Control.SRR15539874;35;32;0.485714285714286;18;17;0.0142857142857143;0.485714285714286
Control.SRR15539874;27;32;0.481481481481481;14;13;0.0185185185185185;0.481481481481481
Control.SRR15539874;29;32;0.517241379310345;14;15;0.0172413793103449;0.482758620689655
Control.SRR15539874;34;32;0.529411764705882;16;18;0.0294117647058824;0.470588235294118
Control.SRR15539874;34;32;0.382352941176471;21;13;0.117647058823529;0.382352941176471
Control.SRR15539874;35;32;0.514285714285714;17;18;0.0142857142857142;0.485714285714286
Control.SRR15539874;31;32;0.548387096774194;14;17;0.0483870967741935;0.451612903225806
Control.SRR15539874;35;32;0.6;14;21;0.1;0.4
Control.SRR15539874;30;32;0.666666666666667;10;20;0.166666666666667;0.333333333333333
Control.SRR15539874;28;32;0.5;14;14;0;0.5
Control.SRR15539874;28;32;0.285714285714286;20;8;0.214285714285714;0.285714285714286
Control.SRR15539874;32;32;0.5625;14;18;0.0625;0.4375
Control.SRR15539874;31;32;0.548387096774194;14;17;0.0483870967741935;0.451612903225806
Control.SRR15539874;30;32;0.5;15;15;0;0.5
Control.SRR15539874;28;32;0.464285714285714;15;13;0.0357142857142857;0.464285714285714
Control.SRR15539874;30;32;0.566666666666667;13;17;0.0666666666666667;0.433333333333333
Control.SRR15539874;29;32;0.551724137931034;13;16;0.0517241379310345;0.448275862068966
Control.SRR15539874;35;32;0.514285714285714;17;18;0.0142857142857142;0.485714285714286
Control.SRR15539874;32;32;0.46875;17;15;0.03125;0.46875
Control.SRR15539874;33;32;0.454545454545455;18;15;0.0454545454545455;0.454545454545455
Control.SRR15539874;34;32;0.5;17;17;0;0.5
Control.SRR15539874;31;32;0.483870967741935;16;15;0.0161290322580645;0.483870967741935
Control.SRR15539874;32;32;0.6875;10;22;0.1875;0.3125
Control.SRR15539874;33;32;0.575757575757576;14;19;0.0757575757575758;0.424242424242424
Control.SRR15539874;29;32;0.310344827586207;20;9;0.189655172413793;0.310344827586207
Control.SRR15539874;31;32;0.516129032258065;15;16;0.0161290322580645;0.483870967741935
Control.SRR15539874;30;32;0.433333333333333;17;13;0.0666666666666667;0.433333333333333
Control.SRR15539874;30;32;0.6;12;18;0.1;0.4
Control.SRR15539874;29;32;0.482758620689655;15;14;0.0172413793103448;0.482758620689655
Control.SRR15539874;31;32;0.516129032258065;15;16;0.0161290322580645;0.483870967741935
Control.SRR15539874;30;32;0.5;15;15;0;0.5
Control.SRR15539874;30;32;0.566666666666667;13;17;0.0666666666666667;0.433333333333333
Control.SRR15539874;29;32;0.551724137931034;13;16;0.0517241379310345;0.448275862068966
Control.SRR15539874;34;32;0.411764705882353;20;14;0.0882352941176471;0.411764705882353
Control.SRR15539874;33;32;0.424242424242424;19;14;0.0757575757575757;0.424242424242424
Control.SRR15539874;31;32;0.451612903225806;17;14;0.0483870967741936;0.451612903225806
Control.SRR15539874;35;32;0.457142857142857;19;16;0.0428571428571429;0.457142857142857
Control.SRR15539874;35;32;0.457142857142857;19;16;0.0428571428571429;0.457142857142857
Control.SRR15539874;30;32;0.2;24;6;0.3;0.2
Control.SRR15539874;35;32;0.457142857142857;19;16;0.0428571428571429;0.457142857142857
Control.SRR15539874;29;32;0.517241379310345;14;15;0.0172413793103449;0.482758620689655
Control.SRR15539874;32;32;0.40625;19;13;0.09375;0.40625
Control.SRR15539874;30;32;0.266666666666667;22;8;0.233333333333333;0.266666666666667
Control.SRR15539874;29;32;0.551724137931034;13;16;0.0517241379310345;0.448275862068966
Control.SRR15539874;28;32;0.535714285714286;13;15;0.0357142857142857;0.464285714285714
Control.SRR15539874;34;32;0.647058823529412;12;22;0.147058823529412;0.352941176470588
Control.SRR15539874;29;32;0.448275862068966;16;13;0.0517241379310345;0.448275862068966
Control.SRR15539874;32;32;0.5;16;16;0;0.5
Control.SRR15539874;29;32;0.448275862068966;16;13;0.0517241379310345;0.448275862068966
Control.SRR15539874;29;32;0.482758620689655;15;14;0.0172413793103448;0.482758620689655
Control.SRR15539874;30;32;0.633333333333333;11;19;0.133333333333333;0.366666666666667
Control.SRR15539874;32;32;0.5;16;16;0;0.5
Control.SRR15539874;33;32;0.545454545454545;15;18;0.0454545454545454;0.454545454545455
Control.SRR15539874;29;32;0.517241379310345;14;15;0.0172413793103449;0.482758620689655
Control.SRR15539874;29;32;0.448275862068966;16;13;0.0517241379310345;0.448275862068966
Control.SRR15539874;31;32;0.354838709677419;20;11;0.145161290322581;0.354838709677419
Control.SRR15539874;32;32;0.5625;14;18;0.0625;0.4375
Control.SRR15539874;28;32;0.714285714285714;8;20;0.214285714285714;0.285714285714286
Control.SRR15539874;28;32;0.642857142857143;10;18;0.142857142857143;0.357142857142857
Control.SRR15539874;34;32;0.617647058823529;13;21;0.117647058823529;0.382352941176471
Control.SRR15539874;34;32;0.470588235294118;18;16;0.0294117647058824;0.470588235294118
Control.SRR15539874;31;32;0.645161290322581;11;20;0.145161290322581;0.354838709677419
Control.SRR15539874;31;32;0.483870967741935;16;15;0.0161290322580645;0.483870967741935
Control.SRR15539874;29;32;0.413793103448276;17;12;0.0862068965517241;0.413793103448276
Control.SRR15539874;27;32;0.222222222222222;21;6;0.277777777777778;0.222222222222222
Control.SRR15539874;31;32;0.774193548387097;7;24;0.274193548387097;0.225806451612903
Control.SRR15539874;32;32;0.4375;18;14;0.0625;0.4375
Control.SRR15539874;35;32;0.571428571428571;15;20;0.0714285714285714;0.428571428571429
Control.SRR15539874;27;32;0.62962962962963;10;17;0.12962962962963;0.37037037037037
Control.SRR15539874;33;32;0.454545454545455;18;15;0.0454545454545455;0.454545454545455
Control.SRR15539874;33;32;0.545454545454545;15;18;0.0454545454545454;0.454545454545455
Control.SRR15539874;32;32;0.46875;17;15;0.03125;0.46875
Control.SRR15539874;33;32;0.575757575757576;14;19;0.0757575757575758;0.424242424242424
Control.SRR15539874;32;32;0.34375;21;11;0.15625;0.34375
Control.SRR15539874;32;32;0.5625;14;18;0.0625;0.4375
Control.SRR15539874;34;32;0.441176470588235;19;15;0.0588235294117647;0.441176470588235
Control.SRR15539874;34;32;0.411764705882353;20;14;0.0882352941176471;0.411764705882353
Control.SRR15539874;29;32;0.655172413793103;10;19;0.155172413793103;0.344827586206897
Control.SRR15539874;28;32;0.642857142857143;10;18;0.142857142857143;0.357142857142857
Control.SRR15539874;33;32;0.545454545454545;15;18;0.0454545454545454;0.454545454545455
Control.SRR15539874;31;32;0.483870967741935;16;15;0.0161290322580645;0.483870967741935
Control.SRR15539874;29;32;0.413793103448276;17;12;0.0862068965517241;0.413793103448276
Control.SRR15539874;28;32;0.5;14;14;0;0.5
Control.SRR15539874;27;32;0.518518518518518;13;14;0.0185185185185185;0.481481481481481
Control.SRR15539874;29;32;0.448275862068966;16;13;0.0517241379310345;0.448275862068966
Control.SRR15539874;30;32;0.6;12;18;0.1;0.4
Control.SRR15539874;29;32;0.448275862068966;16;13;0.0517241379310345;0.448275862068966
Control.SRR15539874;30;32;0.566666666666667;13;17;0.0666666666666667;0.433333333333333
Control.SRR15539874;34;32;0.470588235294118;18;16;0.0294117647058824;0.470588235294118
Control.SRR15539874;31;32;0.451612903225806;17;14;0.0483870967741936;0.451612903225806
Control.SRR15539874;31;32;0.516129032258065;15;16;0.0161290322580645;0.483870967741935
Control.SRR15539874;29;32;0.689655172413793;9;20;0.189655172413793;0.310344827586207
Control.SRR15539874;34;32;0.529411764705882;16;18;0.0294117647058824;0.470588235294118
Control.SRR15539874;32;32;0.4375;18;14;0.0625;0.4375
Control.SRR15539874;35;32;0.514285714285714;17;18;0.0142857142857142;0.485714285714286
Control.SRR15539874;34;32;0.558823529411765;15;19;0.0588235294117647;0.441176470588235
Control.SRR15539874;28;32;0.714285714285714;8;20;0.214285714285714;0.285714285714286
Control.SRR15539874;32;32;0.34375;21;11;0.15625;0.34375
Control.SRR15539874;30;32;0.6;12;18;0.1;0.4
Control.SRR15539874;32;32;0.59375;13;19;0.09375;0.40625
Control.SRR15539874;27;32;0.407407407407407;16;11;0.0925925925925926;0.407407407407407
Control.SRR15539874;28;32;0.607142857142857;11;17;0.107142857142857;0.392857142857143
Control.SRR15539874;33;32;0.606060606060606;13;20;0.106060606060606;0.393939393939394
Control.SRR15539874;31;32;0.548387096774194;14;17;0.0483870967741935;0.451612903225806
Control.SRR15539874;31;32;0.645161290322581;11;20;0.145161290322581;0.354838709677419
Control.SRR15539874;33;32;0.515151515151515;16;17;0.0151515151515151;0.484848484848485
Control.SRR15539874;34;32;0.411764705882353;20;14;0.0882352941176471;0.411764705882353
Control.SRR15539874;33;32;0.515151515151515;16;17;0.0151515151515151;0.484848484848485
Control.SRR15539874;28;32;0.642857142857143;10;18;0.142857142857143;0.357142857142857
Control.SRR15539874;34;32;0.5;17;17;0;0.5
Control.SRR15539874;27;32;0.518518518518518;13;14;0.0185185185185185;0.481481481481481
Control.SRR15539874;31;32;0.548387096774194;14;17;0.0483870967741935;0.451612903225806
Control.SRR15539874;32;32;0.4375;18;14;0.0625;0.4375
Control.SRR15539874;35;32;0.428571428571429;20;15;0.0714285714285715;0.428571428571429
Control.SRR15539874;30;32;0.533333333333333;14;16;0.0333333333333333;0.466666666666667
Control.SRR15539874;28;32;0.607142857142857;11;17;0.107142857142857;0.392857142857143
Control.SRR15539874;35;32;0.514285714285714;17;18;0.0142857142857142;0.485714285714286
Control.SRR15539874;31;32;0.548387096774194;14;17;0.0483870967741935;0.451612903225806
Control.SRR15539874;35;32;0.457142857142857;19;16;0.0428571428571429;0.457142857142857
Control.SRR15539874;31;32;0.419354838709677;18;13;0.0806451612903226;0.419354838709677
Control.SRR15539874;32;32;0.4375;18;14;0.0625;0.4375
Control.SRR15539874;33;32;0.424242424242424;19;14;0.0757575757575757;0.424242424242424
Control.SRR15539874;33;32;0.515151515151515;16;17;0.0151515151515151;0.484848484848485
Control.SRR15539874;33;32;0.545454545454545;15;18;0.0454545454545454;0.454545454545455
Control.SRR15539874;35;32;0.457142857142857;19;16;0.0428571428571429;0.457142857142857
Control.SRR15539874;27;32;0.518518518518518;13;14;0.0185185185185185;0.481481481481481
Control.SRR15539874;34;32;0.588235294117647;14;20;0.0882352941176471;0.411764705882353
Control.SRR15539874;34;32;0.529411764705882;16;18;0.0294117647058824;0.470588235294118
Control.SRR15539874;29;32;0.448275862068966;16;13;0.0517241379310345;0.448275862068966
Control.SRR15539874;28;32;0.392857142857143;17;11;0.107142857142857;0.392857142857143
Control.SRR15539874;35;32;0.571428571428571;15;20;0.0714285714285714;0.428571428571429
Control.SRR15539874;33;32;0.636363636363636;12;21;0.136363636363636;0.363636363636364
Control.SRR15539874;32;32;0.625;12;20;0.125;0.375
Control.SRR15539874;28;32;0.357142857142857;18;10;0.142857142857143;0.357142857142857
Control.SRR15539874;32;32;0.4375;18;14;0.0625;0.4375
Control.SRR15539874;33;32;0.454545454545455;18;15;0.0454545454545455;0.454545454545455
Control.SRR15539874;33;32;0.515151515151515;16;17;0.0151515151515151;0.484848484848485
Control.SRR15539874;29;32;0.551724137931034;13;16;0.0517241379310345;0.448275862068966
Control.SRR15539874;27;32;0.592592592592593;11;16;0.0925925925925926;0.407407407407407
Control.SRR15539874;33;32;0.454545454545455;18;15;0.0454545454545455;0.454545454545455
Control.SRR15539874;34;32;0.5;17;17;0;0.5
Control.SRR15539874;29;32;0.379310344827586;18;11;0.120689655172414;0.379310344827586
Control.SRR15539874;28;32;0.464285714285714;15;13;0.0357142857142857;0.464285714285714
Control.SRR15539874;33;32;0.575757575757576;14;19;0.0757575757575758;0.424242424242424
Control.SRR15539874;29;32;0.448275862068966;16;13;0.0517241379310345;0.448275862068966
Control.SRR15539874;28;32;0.428571428571429;16;12;0.0714285714285715;0.428571428571429
Control.SRR15539874;29;32;0.448275862068966;16;13;0.0517241379310345;0.448275862068966
Control.SRR15539874;33;32;0.515151515151515;16;17;0.0151515151515151;0.484848484848485
Control.SRR15539874;29;32;0.620689655172414;11;18;0.120689655172414;0.379310344827586
Control.SRR15539874;27;32;0.407407407407407;16;11;0.0925925925925926;0.407407407407407
Control.SRR15539874;29;32;0.586206896551724;12;17;0.0862068965517241;0.413793103448276
Control.SRR15539874;27;32;0.62962962962963;10;17;0.12962962962963;0.37037037037037
Control.SRR15539874;29;32;0.586206896551724;12;17;0.0862068965517241;0.413793103448276
Control.SRR15539874;32;32;0.5;16;16;0;0.5
Control.SRR15539874;31;32;0.516129032258065;15;16;0.0161290322580645;0.483870967741935
Control.SRR15539874;31;32;0.580645161290323;13;18;0.0806451612903226;0.419354838709677
Control.SRR15539874;35;32;0.485714285714286;18;17;0.0142857142857143;0.485714285714286
Control.SRR15539874;34;32;0.411764705882353;20;14;0.0882352941176471;0.411764705882353
Control.SRR15539874;31;32;0.67741935483871;10;21;0.17741935483871;0.32258064516129
Control.SRR15539874;35;32;0.571428571428571;15;20;0.0714285714285714;0.428571428571429
Control.SRR15539874;33;32;0.484848484848485;17;16;0.0151515151515151;0.484848484848485
Control.SRR15539874;31;32;0.709677419354839;9;22;0.209677419354839;0.290322580645161
Control.SRR15539874;30;32;0.6;12;18;0.1;0.4
Control.SRR15539874;29;32;0.413793103448276;17;12;0.0862068965517241;0.413793103448276
Control.SRR15539874;30;32;0.566666666666667;13;17;0.0666666666666667;0.433333333333333
Control.SRR15539874;30;32;0.533333333333333;14;16;0.0333333333333333;0.466666666666667
Control.SRR15539874;35;32;0.514285714285714;17;18;0.0142857142857142;0.485714285714286
Control.SRR15539874;28;32;0.535714285714286;13;15;0.0357142857142857;0.464285714285714
Control.SRR15539874;27;32;0.444444444444444;15;12;0.0555555555555556;0.444444444444444
Control.SRR15539874;28;32;0.535714285714286;13;15;0.0357142857142857;0.464285714285714
Control.SRR15539874;28;32;0.535714285714286;13;15;0.0357142857142857;0.464285714285714
Control.SRR15539874;30;32;0.433333333333333;17;13;0.0666666666666667;0.433333333333333
Control.SRR15539874;35;32;0.371428571428571;22;13;0.128571428571429;0.371428571428571
Control.SRR15539874;32;32;0.59375;13;19;0.09375;0.40625
Control.SRR15539874;34;32;0.382352941176471;21;13;0.117647058823529;0.382352941176471
Control.SRR15539874;29;32;0.586206896551724;12;17;0.0862068965517241;0.413793103448276
Control.SRR15539874;34;32;0.441176470588235;19;15;0.0588235294117647;0.441176470588235
Control.SRR15539874;29;32;0.517241379310345;14;15;0.0172413793103449;0.482758620689655
Control.SRR15539874;27;32;0.518518518518518;13;14;0.0185185185185185;0.481481481481481
Control.SRR15539874;27;32;0.62962962962963;10;17;0.12962962962963;0.37037037037037
Control.SRR15539874;35;32;0.485714285714286;18;17;0.0142857142857143;0.485714285714286
Control.SRR15539874;31;32;0.419354838709677;18;13;0.0806451612903226;0.419354838709677
Control.SRR15539874;32;32;0.46875;17;15;0.03125;0.46875
Control.SRR15539874;32;32;0.46875;17;15;0.03125;0.46875
Control.SRR15539874;30;32;0.533333333333333;14;16;0.0333333333333333;0.466666666666667
Control.SRR15539874;33;32;0.575757575757576;14;19;0.0757575757575758;0.424242424242424
Control.SRR15539874;35;32;0.457142857142857;19;16;0.0428571428571429;0.457142857142857
Control.SRR15539874;32;32;0.5625;14;18;0.0625;0.4375
Control.SRR15539874;30;32;0.633333333333333;11;19;0.133333333333333;0.366666666666667
Control.SRR15539874;30;32;0.466666666666667;16;14;0.0333333333333333;0.466666666666667
Control.SRR15539874;32;32;0.59375;13;19;0.09375;0.40625
Control.SRR15539874;30;32;0.466666666666667;16;14;0.0333333333333333;0.466666666666667
Control.SRR15539874;29;32;0.586206896551724;12;17;0.0862068965517241;0.413793103448276
Control.SRR15539874;34;32;0.441176470588235;19;15;0.0588235294117647;0.441176470588235
Control.SRR15539874;28;32;0.535714285714286;13;15;0.0357142857142857;0.464285714285714
Control.SRR15539874;32;32;0.625;12;20;0.125;0.375
Control.SRR15539874;34;32;0.470588235294118;18;16;0.0294117647058824;0.470588235294118
Control.SRR15539874;31;32;0.645161290322581;11;20;0.145161290322581;0.354838709677419
Control.SRR15539874;34;32;0.5;17;17;0;0.5
Control.SRR15539874;31;32;0.451612903225806;17;14;0.0483870967741936;0.451612903225806
Control.SRR15539874;28;32;0.428571428571429;16;12;0.0714285714285715;0.428571428571429
Control.SRR15539874;32;32;0.5;16;16;0;0.5
Control.SRR15539874;33;32;0.515151515151515;16;17;0.0151515151515151;0.484848484848485
Control.SRR15539874;34;32;0.529411764705882;16;18;0.0294117647058824;0.470588235294118
Control.SRR15539874;32;32;0.5;16;16;0;0.5
Control.SRR15539874;29;32;0.344827586206897;19;10;0.155172413793103;0.344827586206897
Control.SRR15539874;27;32;0.666666666666667;9;18;0.166666666666667;0.333333333333333
Control.SRR15539874;29;32;0.448275862068966;16;13;0.0517241379310345;0.448275862068966
Control.SRR15539874;30;32;0.633333333333333;11;19;0.133333333333333;0.366666666666667
Control.SRR15539874;32;32;0.5625;14;18;0.0625;0.4375
Control.SRR15539874;35;32;0.6;14;21;0.1;0.4
Control.SRR15539874;31;32;0.516129032258065;15;16;0.0161290322580645;0.483870967741935
Control.SRR15539874;27;32;0.592592592592593;11;16;0.0925925925925926;0.407407407407407
Control.SRR15539874;33;32;0.666666666666667;11;22;0.166666666666667;0.333333333333333
Control.SRR15539874;27;32;0.407407407407407;16;11;0.0925925925925926;0.407407407407407
Control.SRR15539874;28;32;0.464285714285714;15;13;0.0357142857142857;0.464285714285714
Control.SRR15539874;29;32;0.551724137931034;13;16;0.0517241379310345;0.448275862068966
Control.SRR15539874;28;32;0.678571428571429;9;19;0.178571428571429;0.321428571428571
Control.SRR15539874;29;32;0.448275862068966;16;13;0.0517241379310345;0.448275862068966
Control.SRR15539874;32;32;0.5;16;16;0;0.5
Control.SRR15539874;33;32;0.393939393939394;20;13;0.106060606060606;0.393939393939394
Control.SRR15539874;27;32;0.518518518518518;13;14;0.0185185185185185;0.481481481481481
Control.SRR15539874;32;32;0.34375;21;11;0.15625;0.34375
Control.SRR15539874;34;32;0.529411764705882;16;18;0.0294117647058824;0.470588235294118
Control.SRR15539874;29;32;0.448275862068966;16;13;0.0517241379310345;0.448275862068966
Control.SRR15539874;30;32;0.333333333333333;20;10;0.166666666666667;0.333333333333333
Control.SRR15539874;32;32;0.5;16;16;0;0.5
Control.SRR15539874;35;32;0.428571428571429;20;15;0.0714285714285715;0.428571428571429
Control.SRR15539874;33;32;0.575757575757576;14;19;0.0757575757575758;0.424242424242424
Control.SRR15539874;31;32;0.451612903225806;17;14;0.0483870967741936;0.451612903225806
Control.SRR15539874;35;32;0.485714285714286;18;17;0.0142857142857143;0.485714285714286
Control.SRR15539874;32;32;0.5;16;16;0;0.5
Control.SRR15539874;27;32;0.481481481481481;14;13;0.0185185185185185;0.481481481481481
Control.SRR15539874;35;32;0.542857142857143;16;19;0.0428571428571428;0.457142857142857
Control.SRR15539874;27;32;0.592592592592593;11;16;0.0925925925925926;0.407407407407407
Control.SRR15539874;33;32;0.484848484848485;17;16;0.0151515151515151;0.484848484848485
Control.SRR15539874;35;32;0.457142857142857;19;16;0.0428571428571429;0.457142857142857
Control.SRR15539874;35;32;0.571428571428571;15;20;0.0714285714285714;0.428571428571429
Control.SRR15539874;29;32;0.482758620689655;15;14;0.0172413793103448;0.482758620689655
Control.SRR15539874;35;32;0.428571428571429;20;15;0.0714285714285715;0.428571428571429
Control.SRR15539874;31;32;0.483870967741935;16;15;0.0161290322580645;0.483870967741935
Control.SRR15539874;34;32;0.411764705882353;20;14;0.0882352941176471;0.411764705882353
Control.SRR15539874;31;32;0.612903225806452;12;19;0.112903225806452;0.387096774193548
Control.SRR15539874;33;32;0.454545454545455;18;15;0.0454545454545455;0.454545454545455
Control.SRR15539874;28;32;0.571428571428571;12;16;0.0714285714285714;0.428571428571429
Control.SRR15539874;32;32;0.53125;15;17;0.03125;0.46875
Control.SRR15539874;29;32;0.448275862068966;16;13;0.0517241379310345;0.448275862068966
Control.SRR15539874;33;32;0.484848484848485;17;16;0.0151515151515151;0.484848484848485
Control.SRR15539874;32;32;0.5;16;16;0;0.5
Control.SRR15539874;28;32;0.571428571428571;12;16;0.0714285714285714;0.428571428571429
Control.SRR15539874;31;32;0.387096774193548;19;12;0.112903225806452;0.387096774193548
Control.SRR15539874;30;32;0.466666666666667;16;14;0.0333333333333333;0.466666666666667
Control.SRR15539874;31;32;0.645161290322581;11;20;0.145161290322581;0.354838709677419
Control.SRR15539874;33;32;0.515151515151515;16;17;0.0151515151515151;0.484848484848485
Control.SRR15539874;31;32;0.516129032258065;15;16;0.0161290322580645;0.483870967741935
Control.SRR15539874;31;32;0.451612903225806;17;14;0.0483870967741936;0.451612903225806
Control.SRR15539874;27;32;0.518518518518518;13;14;0.0185185185185185;0.481481481481481
Control.SRR15539874;31;32;0.483870967741935;16;15;0.0161290322580645;0.483870967741935
Control.SRR15539874;34;32;0.441176470588235;19;15;0.0588235294117647;0.441176470588235
Control.SRR15539874;33;32;0.484848484848485;17;16;0.0151515151515151;0.484848484848485
Control.SRR15539874;27;32;0.62962962962963;10;17;0.12962962962963;0.37037037037037
Control.SRR15539874;27;32;0.37037037037037;17;10;0.12962962962963;0.37037037037037
Control.SRR15539874;27;32;0.518518518518518;13;14;0.0185185185185185;0.481481481481481
Control.SRR15539874;28;32;0.428571428571429;16;12;0.0714285714285715;0.428571428571429
Control.SRR15539874;27;32;0.444444444444444;15;12;0.0555555555555556;0.444444444444444
Control.SRR15539874;33;32;0.454545454545455;18;15;0.0454545454545455;0.454545454545455
Control.SRR15539874;33;32;0.575757575757576;14;19;0.0757575757575758;0.424242424242424
Control.SRR15539874;34;32;0.382352941176471;21;13;0.117647058823529;0.382352941176471
Control.SRR15539874;29;32;0.689655172413793;9;20;0.189655172413793;0.310344827586207
Control.SRR15539874;28;32;0.571428571428571;12;16;0.0714285714285714;0.428571428571429
Control.SRR15539874;31;32;0.645161290322581;11;20;0.145161290322581;0.354838709677419
Control.SRR15539874;34;32;0.411764705882353;20;14;0.0882352941176471;0.411764705882353
Control.SRR15539874;35;32;0.457142857142857;19;16;0.0428571428571429;0.457142857142857
Control.SRR15539874;31;32;0.548387096774194;14;17;0.0483870967741935;0.451612903225806
Control.SRR15539874;34;32;0.529411764705882;16;18;0.0294117647058824;0.470588235294118
Control.SRR15539874;33;32;0.515151515151515;16;17;0.0151515151515151;0.484848484848485
Control.SRR15539874;30;32;0.466666666666667;16;14;0.0333333333333333;0.466666666666667
Control.SRR15539874;32;32;0.625;12;20;0.125;0.375
Control.SRR15539874;31;32;0.483870967741935;16;15;0.0161290322580645;0.483870967741935
Control.SRR15539874;31;32;0.483870967741935;16;15;0.0161290322580645;0.483870967741935
Control.SRR15539874;31;32;0.612903225806452;12;19;0.112903225806452;0.387096774193548
Control.SRR15539874;33;32;0.393939393939394;20;13;0.106060606060606;0.393939393939394
Control.SRR15539874;28;32;0.678571428571429;9;19;0.178571428571429;0.321428571428571
Control.SRR15539874;31;32;0.483870967741935;16;15;0.0161290322580645;0.483870967741935
Control.SRR15539874;31;32;0.516129032258065;15;16;0.0161290322580645;0.483870967741935
Control.SRR15539874;33;32;0.424242424242424;19;14;0.0757575757575757;0.424242424242424
Control.SRR15539874;29;32;0.448275862068966;16;13;0.0517241379310345;0.448275862068966
Control.SRR15539874;34;32;0.676470588235294;11;23;0.176470588235294;0.323529411764706
Control.SRR15539874;30;32;0.466666666666667;16;14;0.0333333333333333;0.466666666666667
Control.SRR15539874;30;32;0.533333333333333;14;16;0.0333333333333333;0.466666666666667
Control.SRR15539874;34;32;0.441176470588235;19;15;0.0588235294117647;0.441176470588235
Control.SRR15539874;34;32;0.558823529411765;15;19;0.0588235294117647;0.441176470588235
Control.SRR15539874;27;32;0.555555555555556;12;15;0.0555555555555556;0.444444444444444
Control.SRR15539874;28;32;0.571428571428571;12;16;0.0714285714285714;0.428571428571429
Control.SRR15539874;27;32;0.518518518518518;13;14;0.0185185185185185;0.481481481481481
Control.SRR15539874;34;32;0.529411764705882;16;18;0.0294117647058824;0.470588235294118
Control.SRR15539874;35;32;0.457142857142857;19;16;0.0428571428571429;0.457142857142857
Control.SRR15539874;32;32;0.59375;13;19;0.09375;0.40625
Control.SRR15539874;27;32;0.444444444444444;15;12;0.0555555555555556;0.444444444444444
Control.SRR15539874;27;32;0.518518518518518;13;14;0.0185185185185185;0.481481481481481
Control.SRR15539874;29;32;0.482758620689655;15;14;0.0172413793103448;0.482758620689655
Control.SRR15539874;31;32;0.419354838709677;18;13;0.0806451612903226;0.419354838709677
Control.SRR15539874;32;32;0.4375;18;14;0.0625;0.4375
Control.SRR15539874;30;32;0.666666666666667;10;20;0.166666666666667;0.333333333333333
Control.SRR15539874;28;32;0.392857142857143;17;11;0.107142857142857;0.392857142857143
Control.SRR15539874;35;32;0.6;14;21;0.1;0.4
Control.SRR15539874;31;32;0.419354838709677;18;13;0.0806451612903226;0.419354838709677
Control.SRR15539874;28;32;0.642857142857143;10;18;0.142857142857143;0.357142857142857
Control.SRR15539874;27;32;0.444444444444444;15;12;0.0555555555555556;0.444444444444444
Control.SRR15539874;33;32;0.606060606060606;13;20;0.106060606060606;0.393939393939394
Control.SRR15539874;33;32;0.454545454545455;18;15;0.0454545454545455;0.454545454545455
Control.SRR15539874;31;32;0.516129032258065;15;16;0.0161290322580645;0.483870967741935
Control.SRR15539874;29;32;0.551724137931034;13;16;0.0517241379310345;0.448275862068966
Control.SRR15539874;29;32;0.482758620689655;15;14;0.0172413793103448;0.482758620689655
Control.SRR15539874;33;32;0.454545454545455;18;15;0.0454545454545455;0.454545454545455
Control.SRR15539874;32;32;0.59375;13;19;0.09375;0.40625
Control.SRR15539874;32;32;0.5625;14;18;0.0625;0.4375
Control.SRR15539874;35;32;0.428571428571429;20;15;0.0714285714285715;0.428571428571429
Control.SRR15539874;28;32;0.428571428571429;16;12;0.0714285714285715;0.428571428571429
Control.SRR15539874;28;32;0.428571428571429;16;12;0.0714285714285715;0.428571428571429
Control.SRR15539874;34;32;0.441176470588235;19;15;0.0588235294117647;0.441176470588235
Control.SRR15539874;31;32;0.516129032258065;15;16;0.0161290322580645;0.483870967741935
Control.SRR15539874;34;32;0.558823529411765;15;19;0.0588235294117647;0.441176470588235
Control.SRR15539874;32;32;0.34375;21;11;0.15625;0.34375
Control.SRR15539874;31;32;0.612903225806452;12;19;0.112903225806452;0.387096774193548
Control.SRR15539874;32;32;0.4375;18;14;0.0625;0.4375
Control.SRR15539874;34;32;0.5;17;17;0;0.5
Control.SRR15539874;32;32;0.625;12;20;0.125;0.375
Control.SRR15539874;34;32;0.529411764705882;16;18;0.0294117647058824;0.470588235294118
Control.SRR15539874;28;32;0.464285714285714;15;13;0.0357142857142857;0.464285714285714
Control.SRR15539874;33;32;0.454545454545455;18;15;0.0454545454545455;0.454545454545455
Control.SRR15539874;27;32;0.481481481481481;14;13;0.0185185185185185;0.481481481481481
Control.SRR15539874;30;32;0.533333333333333;14;16;0.0333333333333333;0.466666666666667
Control.SRR15539874;31;32;0.387096774193548;19;12;0.112903225806452;0.387096774193548
Control.SRR15539874;35;32;0.571428571428571;15;20;0.0714285714285714;0.428571428571429
Control.SRR15539874;31;32;0.516129032258065;15;16;0.0161290322580645;0.483870967741935
Control.SRR15539874;27;32;0.555555555555556;12;15;0.0555555555555556;0.444444444444444
Control.SRR15539874;28;32;0.392857142857143;17;11;0.107142857142857;0.392857142857143
Control.SRR15539874;29;32;0.517241379310345;14;15;0.0172413793103449;0.482758620689655
Control.SRR15539874;33;32;0.515151515151515;16;17;0.0151515151515151;0.484848484848485
Control.SRR15539874;34;32;0.470588235294118;18;16;0.0294117647058824;0.470588235294118
Control.SRR15539874;34;32;0.5;17;17;0;0.5
Control.SRR15539874;30;32;0.566666666666667;13;17;0.0666666666666667;0.433333333333333
Control.SRR15539874;31;32;0.483870967741935;16;15;0.0161290322580645;0.483870967741935
Control.SRR15539874;30;32;0.433333333333333;17;13;0.0666666666666667;0.433333333333333
Control.SRR15539874;29;32;0.586206896551724;12;17;0.0862068965517241;0.413793103448276
Control.SRR15539874;29;32;0.620689655172414;11;18;0.120689655172414;0.379310344827586
Control.SRR15539874;29;32;0.482758620689655;15;14;0.0172413793103448;0.482758620689655
Control.SRR15539874;33;32;0.545454545454545;15;18;0.0454545454545454;0.454545454545455
Control.SRR15539874;30;32;0.566666666666667;13;17;0.0666666666666667;0.433333333333333
Control.SRR15539874;29;32;0.379310344827586;18;11;0.120689655172414;0.379310344827586
Control.SRR15539874;35;32;0.571428571428571;15;20;0.0714285714285714;0.428571428571429
Control.SRR15539874;28;32;0.357142857142857;18;10;0.142857142857143;0.357142857142857
Control.SRR15539874;27;32;0.555555555555556;12;15;0.0555555555555556;0.444444444444444
Control.SRR15539874;27;32;0.444444444444444;15;12;0.0555555555555556;0.444444444444444
Control.SRR15539874;29;32;0.310344827586207;20;9;0.189655172413793;0.310344827586207
Control.SRR15539874;29;32;0.448275862068966;16;13;0.0517241379310345;0.448275862068966
Control.SRR15539874;30;32;0.6;12;18;0.1;0.4
Control.SRR15539874;28;32;0.464285714285714;15;13;0.0357142857142857;0.464285714285714
Control.SRR15539874;34;32;0.558823529411765;15;19;0.0588235294117647;0.441176470588235
Control.SRR15539874;32;32;0.4375;18;14;0.0625;0.4375
Control.SRR15539874;27;32;0.555555555555556;12;15;0.0555555555555556;0.444444444444444
Control.SRR15539874;28;32;0.607142857142857;11;17;0.107142857142857;0.392857142857143
Control.SRR15539874;28;32;0.357142857142857;18;10;0.142857142857143;0.357142857142857
Control.SRR15539874;31;32;0.419354838709677;18;13;0.0806451612903226;0.419354838709677
Control.SRR15539874;30;32;0.4;18;12;0.1;0.4
Control.SRR15539874;31;32;0.580645161290323;13;18;0.0806451612903226;0.419354838709677
Control.SRR15539874;30;32;0.433333333333333;17;13;0.0666666666666667;0.433333333333333
Control.SRR15539874;29;32;0.586206896551724;12;17;0.0862068965517241;0.413793103448276
Control.SRR15539874;33;32;0.545454545454545;15;18;0.0454545454545454;0.454545454545455
Control.SRR15539874;32;32;0.5;16;16;0;0.5
Control.SRR15539874;32;32;0.53125;15;17;0.03125;0.46875
Control.SRR15539874;33;32;0.424242424242424;19;14;0.0757575757575757;0.424242424242424
Control.SRR15539874;29;32;0.413793103448276;17;12;0.0862068965517241;0.413793103448276
Control.SRR15539874;32;32;0.46875;17;15;0.03125;0.46875
Control.SRR15539874;35;32;0.457142857142857;19;16;0.0428571428571429;0.457142857142857
Control.SRR15539874;34;32;0.5;17;17;0;0.5
Control.SRR15539874;28;32;0.535714285714286;13;15;0.0357142857142857;0.464285714285714
Control.SRR15539874;33;32;0.454545454545455;18;15;0.0454545454545455;0.454545454545455
Control.SRR15539874;28;32;0.392857142857143;17;11;0.107142857142857;0.392857142857143
Control.SRR15539874;35;32;0.514285714285714;17;18;0.0142857142857142;0.485714285714286
Control.SRR15539874;27;32;0.592592592592593;11;16;0.0925925925925926;0.407407407407407
Control.SRR15539874;35;32;0.571428571428571;15;20;0.0714285714285714;0.428571428571429
Control.SRR15539874;27;32;0.481481481481481;14;13;0.0185185185185185;0.481481481481481
Control.SRR15539874;31;32;0.612903225806452;12;19;0.112903225806452;0.387096774193548
Control.SRR15539874;33;32;0.484848484848485;17;16;0.0151515151515151;0.484848484848485
Control.SRR15539874;34;32;0.441176470588235;19;15;0.0588235294117647;0.441176470588235
Control.SRR15539874;29;32;0.517241379310345;14;15;0.0172413793103449;0.482758620689655
Control.SRR15539874;29;32;0.551724137931034;13;16;0.0517241379310345;0.448275862068966
Control.SRR15539874;31;32;0.516129032258065;15;16;0.0161290322580645;0.483870967741935
Control.SRR15539874;33;32;0.545454545454545;15;18;0.0454545454545454;0.454545454545455
Control.SRR15539874;27;32;0.333333333333333;18;9;0.166666666666667;0.333333333333333
Control.SRR15539874;35;32;0.485714285714286;18;17;0.0142857142857143;0.485714285714286
Control.SRR15539874;32;32;0.5625;14;18;0.0625;0.4375
Control.SRR15539874;31;32;0.516129032258065;15;16;0.0161290322580645;0.483870967741935
Control.SRR15539874;35;32;0.514285714285714;17;18;0.0142857142857142;0.485714285714286
Control.SRR15539874;29;32;0.379310344827586;18;11;0.120689655172414;0.379310344827586
Control.SRR15539874;32;32;0.4375;18;14;0.0625;0.4375
Control.SRR15539874;34;32;0.5;17;17;0;0.5
Control.SRR15539874;32;32;0.5625;14;18;0.0625;0.4375
Control.SRR15539874;32;32;0.46875;17;15;0.03125;0.46875
Control.SRR15539874;33;32;0.515151515151515;16;17;0.0151515151515151;0.484848484848485
Control.SRR15539874;29;32;0.379310344827586;18;11;0.120689655172414;0.379310344827586
Control.SRR15539874;29;32;0.413793103448276;17;12;0.0862068965517241;0.413793103448276
Control.SRR15539874;33;32;0.636363636363636;12;21;0.136363636363636;0.363636363636364
Control.SRR15539874;29;32;0.517241379310345;14;15;0.0172413793103449;0.482758620689655
Control.SRR15539874;32;32;0.5625;14;18;0.0625;0.4375
Control.SRR15539874;33;32;0.515151515151515;16;17;0.0151515151515151;0.484848484848485
Control.SRR15539874;32;32;0.375;20;12;0.125;0.375
Control.SRR15539874;34;32;0.529411764705882;16;18;0.0294117647058824;0.470588235294118
Control.SRR15539874;35;32;0.571428571428571;15;20;0.0714285714285714;0.428571428571429
Control.SRR15539874;32;32;0.34375;21;11;0.15625;0.34375
Control.SRR15539874;32;32;0.46875;17;15;0.03125;0.46875
Control.SRR15539874;30;32;0.333333333333333;20;10;0.166666666666667;0.333333333333333
Control.SRR15539874;34;32;0.411764705882353;20;14;0.0882352941176471;0.411764705882353
Control.SRR15539874;32;32;0.65625;11;21;0.15625;0.34375
Control.SRR15539874;28;32;0.357142857142857;18;10;0.142857142857143;0.357142857142857
Control.SRR15539874;33;32;0.393939393939394;20;13;0.106060606060606;0.393939393939394
Control.SRR15539874;33;32;0.303030303030303;23;10;0.196969696969697;0.303030303030303
Control.SRR15539874;35;32;0.457142857142857;19;16;0.0428571428571429;0.457142857142857
Control.SRR15539874;27;32;0.481481481481481;14;13;0.0185185185185185;0.481481481481481
Control.SRR15539874;32;32;0.46875;17;15;0.03125;0.46875
Control.SRR15539874;30;32;0.6;12;18;0.1;0.4
Control.SRR15539874;34;32;0.5;17;17;0;0.5
Control.SRR15539874;27;32;0.481481481481481;14;13;0.0185185185185185;0.481481481481481
Control.SRR15539874;32;32;0.5;16;16;0;0.5
Control.SRR15539874;35;32;0.514285714285714;17;18;0.0142857142857142;0.485714285714286
Control.SRR15539874;29;32;0.517241379310345;14;15;0.0172413793103449;0.482758620689655
Control.SRR15539874;27;32;0.518518518518518;13;14;0.0185185185185185;0.481481481481481
Control.SRR15539874;33;32;0.393939393939394;20;13;0.106060606060606;0.393939393939394
Control.SRR15539874;29;32;0.517241379310345;14;15;0.0172413793103449;0.482758620689655
Control.SRR15539874;28;32;0.5;14;14;0;0.5
Control.SRR15539874;35;32;0.542857142857143;16;19;0.0428571428571428;0.457142857142857
Control.SRR15539874;35;32;0.571428571428571;15;20;0.0714285714285714;0.428571428571429
Control.SRR15539874;31;32;0.387096774193548;19;12;0.112903225806452;0.387096774193548
Control.SRR15539874;28;32;0.535714285714286;13;15;0.0357142857142857;0.464285714285714
Control.SRR15539874;28;32;0.535714285714286;13;15;0.0357142857142857;0.464285714285714
Control.SRR15539874;29;32;0.482758620689655;15;14;0.0172413793103448;0.482758620689655
Control.SRR15539874;33;32;0.515151515151515;16;17;0.0151515151515151;0.484848484848485
Control.SRR15539874;30;32;0.7;9;21;0.2;0.3
Control.SRR15539874;27;32;0.481481481481481;14;13;0.0185185185185185;0.481481481481481
Control.SRR15539874;35;32;0.628571428571429;13;22;0.128571428571429;0.371428571428571
Control.SRR15539874;29;32;0.517241379310345;14;15;0.0172413793103449;0.482758620689655
Control.SRR15539874;33;32;0.363636363636364;21;12;0.136363636363636;0.363636363636364
Control.SRR15539874;32;32;0.4375;18;14;0.0625;0.4375
Control.SRR15539874;27;32;0.518518518518518;13;14;0.0185185185185185;0.481481481481481
Control.SRR15539874;30;32;0.433333333333333;17;13;0.0666666666666667;0.433333333333333
Control.SRR15539874;32;32;0.5625;14;18;0.0625;0.4375
Control.SRR15539874;32;32;0.53125;15;17;0.03125;0.46875
Control.SRR15539874;28;32;0.714285714285714;8;20;0.214285714285714;0.285714285714286
Control.SRR15539874;33;32;0.575757575757576;14;19;0.0757575757575758;0.424242424242424
Control.SRR15539874;31;32;0.483870967741935;16;15;0.0161290322580645;0.483870967741935
Control.SRR15539874;28;32;0.392857142857143;17;11;0.107142857142857;0.392857142857143
Control.SRR15539874;30;32;0.433333333333333;17;13;0.0666666666666667;0.433333333333333
Control.SRR15539874;30;32;0.433333333333333;17;13;0.0666666666666667;0.433333333333333
Control.SRR15539874;34;32;0.617647058823529;13;21;0.117647058823529;0.382352941176471
Control.SRR15539874;28;32;0.5;14;14;0;0.5
Control.SRR15539874;32;32;0.4375;18;14;0.0625;0.4375
Control.SRR15539874;27;32;0.518518518518518;13;14;0.0185185185185185;0.481481481481481
Control.SRR15539874;29;32;0.482758620689655;15;14;0.0172413793103448;0.482758620689655
Control.SRR15539874;30;32;0.5;15;15;0;0.5
Control.SRR15539874;30;32;0.533333333333333;14;16;0.0333333333333333;0.466666666666667
Control.SRR15539874;29;32;0.517241379310345;14;15;0.0172413793103449;0.482758620689655
Control.SRR15539874;32;32;0.59375;13;19;0.09375;0.40625
Control.SRR15539874;30;32;0.466666666666667;16;14;0.0333333333333333;0.466666666666667
Control.SRR15539874;34;32;0.617647058823529;13;21;0.117647058823529;0.382352941176471
Control.SRR15539874;30;32;0.466666666666667;16;14;0.0333333333333333;0.466666666666667
Control.SRR15539874;32;32;0.53125;15;17;0.03125;0.46875
Control.SRR15539874;34;32;0.588235294117647;14;20;0.0882352941176471;0.411764705882353
Control.SRR15539874;33;32;0.424242424242424;19;14;0.0757575757575757;0.424242424242424
Control.SRR15539874;31;32;0.612903225806452;12;19;0.112903225806452;0.387096774193548
Control.SRR15539874;33;32;0.303030303030303;23;10;0.196969696969697;0.303030303030303
Control.SRR15539874;31;32;0.548387096774194;14;17;0.0483870967741935;0.451612903225806
Control.SRR15539874;32;32;0.5;16;16;0;0.5
Control.SRR15539874;29;32;0.482758620689655;15;14;0.0172413793103448;0.482758620689655
Control.SRR15539874;32;32;0.5625;14;18;0.0625;0.4375
Control.SRR15539874;30;32;0.533333333333333;14;16;0.0333333333333333;0.466666666666667
Control.SRR15539874;33;32;0.454545454545455;18;15;0.0454545454545455;0.454545454545455
Control.SRR15539874;27;32;0.333333333333333;18;9;0.166666666666667;0.333333333333333
Control.SRR15539874;29;32;0.310344827586207;20;9;0.189655172413793;0.310344827586207
Control.SRR15539874;28;32;0.607142857142857;11;17;0.107142857142857;0.392857142857143
Control.SRR15539874;27;32;0.37037037037037;17;10;0.12962962962963;0.37037037037037
Control.SRR15539874;28;32;0.428571428571429;16;12;0.0714285714285715;0.428571428571429
Control.SRR15539874;35;32;0.457142857142857;19;16;0.0428571428571429;0.457142857142857
Control.SRR15539874;35;32;0.514285714285714;17;18;0.0142857142857142;0.485714285714286
Control.SRR15539874;30;32;0.6;12;18;0.1;0.4
Control.SRR15539874;27;32;0.703703703703704;8;19;0.203703703703704;0.296296296296296
Control.SRR15539874;29;32;0.620689655172414;11;18;0.120689655172414;0.379310344827586
Control.SRR15539874;35;32;0.457142857142857;19;16;0.0428571428571429;0.457142857142857
Control.SRR15539874;34;32;0.441176470588235;19;15;0.0588235294117647;0.441176470588235
Control.SRR15539874;27;32;0.703703703703704;8;19;0.203703703703704;0.296296296296296
Control.SRR15539874;35;32;0.371428571428571;22;13;0.128571428571429;0.371428571428571
Control.SRR15539874;33;32;0.545454545454545;15;18;0.0454545454545454;0.454545454545455
Control.SRR15539874;32;32;0.53125;15;17;0.03125;0.46875
Control.SRR15539874;29;32;0.517241379310345;14;15;0.0172413793103449;0.482758620689655
Control.SRR15539874;35;32;0.428571428571429;20;15;0.0714285714285715;0.428571428571429
Control.SRR15539874;34;32;0.617647058823529;13;21;0.117647058823529;0.382352941176471
Control.SRR15539874;34;32;0.588235294117647;14;20;0.0882352941176471;0.411764705882353
Control.SRR15539874;28;32;0.428571428571429;16;12;0.0714285714285715;0.428571428571429
Control.SRR15539874;30;32;0.533333333333333;14;16;0.0333333333333333;0.466666666666667
Control.SRR15539874;28;32;0.5;14;14;0;0.5
Control.SRR15539874;27;32;0.407407407407407;16;11;0.0925925925925926;0.407407407407407
Control.SRR15539874;34;32;0.617647058823529;13;21;0.117647058823529;0.382352941176471
Control.SRR15539874;32;32;0.4375;18;14;0.0625;0.4375
Control.SRR15539874;33;32;0.636363636363636;12;21;0.136363636363636;0.363636363636364
Control.SRR15539874;27;32;0.518518518518518;13;14;0.0185185185185185;0.481481481481481
Control.SRR15539874;35;32;0.628571428571429;13;22;0.128571428571429;0.371428571428571
Control.SRR15539874;34;32;0.382352941176471;21;13;0.117647058823529;0.382352941176471
Control.SRR15539874;35;32;0.628571428571429;13;22;0.128571428571429;0.371428571428571
Control.SRR15539874;27;32;0.592592592592593;11;16;0.0925925925925926;0.407407407407407
Control.SRR15539874;27;32;0.518518518518518;13;14;0.0185185185185185;0.481481481481481
Control.SRR15539874;31;32;0.483870967741935;16;15;0.0161290322580645;0.483870967741935
Control.SRR15539874;28;32;0.642857142857143;10;18;0.142857142857143;0.357142857142857
Control.SRR15539874;29;32;0.655172413793103;10;19;0.155172413793103;0.344827586206897
Control.SRR15539874;33;32;0.484848484848485;17;16;0.0151515151515151;0.484848484848485
Control.SRR15539874;29;32;0.551724137931034;13;16;0.0517241379310345;0.448275862068966
Control.SRR15539874;27;32;0.296296296296296;19;8;0.203703703703704;0.296296296296296
Control.SRR15539874;28;32;0.464285714285714;15;13;0.0357142857142857;0.464285714285714
Control.SRR15539874;29;32;0.586206896551724;12;17;0.0862068965517241;0.413793103448276
Control.SRR15539874;32;32;0.4375;18;14;0.0625;0.4375
Control.SRR15539874;30;32;0.466666666666667;16;14;0.0333333333333333;0.466666666666667
Control.SRR15539874;27;32;0.444444444444444;15;12;0.0555555555555556;0.444444444444444
Control.SRR15539874;35;32;0.4;21;14;0.1;0.4
Control.SRR15539874;29;32;0.448275862068966;16;13;0.0517241379310345;0.448275862068966
Control.SRR15539874;32;32;0.5;16;16;0;0.5
Control.SRR15539874;34;32;0.558823529411765;15;19;0.0588235294117647;0.441176470588235
Control.SRR15539874;30;32;0.433333333333333;17;13;0.0666666666666667;0.433333333333333
Control.SRR15539874;30;32;0.433333333333333;17;13;0.0666666666666667;0.433333333333333
Control.SRR15539874;34;32;0.352941176470588;22;12;0.147058823529412;0.352941176470588
Control.SRR15539874;30;32;0.5;15;15;0;0.5
Control.SRR15539874;29;32;0.413793103448276;17;12;0.0862068965517241;0.413793103448276
Control.SRR15539874;27;32;0.481481481481481;14;13;0.0185185185185185;0.481481481481481
Control.SRR15539874;34;32;0.411764705882353;20;14;0.0882352941176471;0.411764705882353
Control.SRR15539874;31;32;0.516129032258065;15;16;0.0161290322580645;0.483870967741935
Control.SRR15539874;32;32;0.53125;15;17;0.03125;0.46875
Control.SRR15539874;34;32;0.558823529411765;15;19;0.0588235294117647;0.441176470588235
Control.SRR15539874;29;32;0.793103448275862;6;23;0.293103448275862;0.206896551724138
Control.SRR15539874;30;32;0.7;9;21;0.2;0.3
Control.SRR15539874;32;32;0.375;20;12;0.125;0.375
Control.SRR15539874;34;32;0.558823529411765;15;19;0.0588235294117647;0.441176470588235
Control.SRR15539874;34;32;0.647058823529412;12;22;0.147058823529412;0.352941176470588
Control.SRR15539874;31;32;0.516129032258065;15;16;0.0161290322580645;0.483870967741935
Control.SRR15539874;32;32;0.59375;13;19;0.09375;0.40625
Control.SRR15539874;30;32;0.3;21;9;0.2;0.3
Control.SRR15539874;32;32;0.34375;21;11;0.15625;0.34375
Control.SRR15539874;28;32;0.535714285714286;13;15;0.0357142857142857;0.464285714285714
Control.SRR15539874;30;32;0.566666666666667;13;17;0.0666666666666667;0.433333333333333
Control.SRR15539874;28;32;0.464285714285714;15;13;0.0357142857142857;0.464285714285714
Control.SRR15539874;32;32;0.5625;14;18;0.0625;0.4375
Control.SRR15539874;34;32;0.588235294117647;14;20;0.0882352941176471;0.411764705882353
Control.SRR15539874;35;32;0.4;21;14;0.1;0.4
Control.SRR15539874;30;32;0.366666666666667;19;11;0.133333333333333;0.366666666666667
Control.SRR15539874;29;32;0.517241379310345;14;15;0.0172413793103449;0.482758620689655
Control.SRR15539874;32;32;0.625;12;20;0.125;0.375
Control.SRR15539874;33;32;0.484848484848485;17;16;0.0151515151515151;0.484848484848485
Control.SRR15539874;34;32;0.5;17;17;0;0.5
Control.SRR15539874;34;32;0.5;17;17;0;0.5
Control.SRR15539874;34;32;0.441176470588235;19;15;0.0588235294117647;0.441176470588235
Control.SRR15539874;28;32;0.607142857142857;11;17;0.107142857142857;0.392857142857143
Control.SRR15539874;28;32;0.571428571428571;12;16;0.0714285714285714;0.428571428571429
Control.SRR15539874;31;32;0.354838709677419;20;11;0.145161290322581;0.354838709677419
Control.SRR15539874;31;32;0.451612903225806;17;14;0.0483870967741936;0.451612903225806
Control.SRR15539874;31;32;0.483870967741935;16;15;0.0161290322580645;0.483870967741935
Control.SRR15539874;31;32;0.612903225806452;12;19;0.112903225806452;0.387096774193548
Control.SRR15539874;34;32;0.558823529411765;15;19;0.0588235294117647;0.441176470588235
Control.SRR15539874;28;32;0.642857142857143;10;18;0.142857142857143;0.357142857142857
Control.SRR15539874;31;32;0.483870967741935;16;15;0.0161290322580645;0.483870967741935
Control.SRR15539874;34;32;0.529411764705882;16;18;0.0294117647058824;0.470588235294118
Control.SRR15539874;27;32;0.518518518518518;13;14;0.0185185185185185;0.481481481481481
Control.SRR15539874;28;32;0.392857142857143;17;11;0.107142857142857;0.392857142857143
Control.SRR15539874;35;32;0.6;14;21;0.1;0.4
Control.SRR15539874;31;32;0.451612903225806;17;14;0.0483870967741936;0.451612903225806
Control.SRR15539874;35;32;0.485714285714286;18;17;0.0142857142857143;0.485714285714286
Control.SRR15539874;34;32;0.470588235294118;18;16;0.0294117647058824;0.470588235294118
Control.SRR15539874;30;32;0.633333333333333;11;19;0.133333333333333;0.366666666666667
Control.SRR15539874;35;32;0.542857142857143;16;19;0.0428571428571428;0.457142857142857
Control.SRR15539874;32;32;0.46875;17;15;0.03125;0.46875
Control.SRR15539874;32;32;0.5625;14;18;0.0625;0.4375
Control.SRR15539874;28;32;0.535714285714286;13;15;0.0357142857142857;0.464285714285714
Control.SRR15539874;33;32;0.454545454545455;18;15;0.0454545454545455;0.454545454545455
Control.SRR15539874;35;32;0.371428571428571;22;13;0.128571428571429;0.371428571428571
Control.SRR15539874;29;32;0.586206896551724;12;17;0.0862068965517241;0.413793103448276
Control.SRR15539874;29;32;0.379310344827586;18;11;0.120689655172414;0.379310344827586
Control.SRR15539874;35;32;0.571428571428571;15;20;0.0714285714285714;0.428571428571429
Control.SRR15539874;34;32;0.5;17;17;0;0.5
Control.SRR15539874;28;32;0.5;14;14;0;0.5
Control.SRR15539874;32;32;0.375;20;12;0.125;0.375
Control.SRR15539874;32;32;0.46875;17;15;0.03125;0.46875
Control.SRR15539874;34;32;0.5;17;17;0;0.5
Control.SRR15539874;30;32;0.433333333333333;17;13;0.0666666666666667;0.433333333333333
Control.SRR15539874;27;32;0.444444444444444;15;12;0.0555555555555556;0.444444444444444
Control.SRR15539874;28;32;0.428571428571429;16;12;0.0714285714285715;0.428571428571429
Control.SRR15539874;29;32;0.448275862068966;16;13;0.0517241379310345;0.448275862068966
Control.SRR15539874;29;32;0.586206896551724;12;17;0.0862068965517241;0.413793103448276
Control.SRR15539874;35;32;0.428571428571429;20;15;0.0714285714285715;0.428571428571429
Control.SRR15539874;28;32;0.714285714285714;8;20;0.214285714285714;0.285714285714286
Control.SRR15539874;35;32;0.685714285714286;11;24;0.185714285714286;0.314285714285714
Control.SRR15539874;33;32;0.515151515151515;16;17;0.0151515151515151;0.484848484848485
Control.SRR15539874;31;32;0.612903225806452;12;19;0.112903225806452;0.387096774193548
Control.SRR15539874;27;32;0.555555555555556;12;15;0.0555555555555556;0.444444444444444
Control.SRR15539874;33;32;0.575757575757576;14;19;0.0757575757575758;0.424242424242424
Control.SRR15539874;32;32;0.40625;19;13;0.09375;0.40625
Control.SRR15539874;29;32;0.413793103448276;17;12;0.0862068965517241;0.413793103448276
Control.SRR15539874;35;32;0.342857142857143;23;12;0.157142857142857;0.342857142857143
Control.SRR15539874;28;32;0.535714285714286;13;15;0.0357142857142857;0.464285714285714
Control.SRR15539874;29;32;0.448275862068966;16;13;0.0517241379310345;0.448275862068966
Control.SRR15539874;28;32;0.321428571428571;19;9;0.178571428571429;0.321428571428571
Control.SRR15539874;31;32;0.516129032258065;15;16;0.0161290322580645;0.483870967741935
Control.SRR15539874;34;32;0.5;17;17;0;0.5
Control.SRR15539874;34;32;0.323529411764706;23;11;0.176470588235294;0.323529411764706
Control.SRR15539874;30;32;0.466666666666667;16;14;0.0333333333333333;0.466666666666667
Control.SRR15539874;27;32;0.444444444444444;15;12;0.0555555555555556;0.444444444444444
Control.SRR15539874;31;32;0.516129032258065;15;16;0.0161290322580645;0.483870967741935
Control.SRR15539874;32;32;0.59375;13;19;0.09375;0.40625
Control.SRR15539874;34;32;0.5;17;17;0;0.5
Control.SRR15539874;35;32;0.485714285714286;18;17;0.0142857142857143;0.485714285714286
Control.SRR15539874;29;32;0.482758620689655;15;14;0.0172413793103448;0.482758620689655
Control.SRR15539874;33;32;0.515151515151515;16;17;0.0151515151515151;0.484848484848485
Control.SRR15539874;27;32;0.555555555555556;12;15;0.0555555555555556;0.444444444444444
Control.SRR15539874;35;32;0.685714285714286;11;24;0.185714285714286;0.314285714285714
Control.SRR15539874;32;32;0.5625;14;18;0.0625;0.4375
Control.SRR15539874;34;32;0.617647058823529;13;21;0.117647058823529;0.382352941176471
Control.SRR15539874;29;32;0.379310344827586;18;11;0.120689655172414;0.379310344827586
Control.SRR15539874;35;32;0.514285714285714;17;18;0.0142857142857142;0.485714285714286
Control.SRR15539874;32;32;0.53125;15;17;0.03125;0.46875
Control.SRR15539874;35;32;0.457142857142857;19;16;0.0428571428571429;0.457142857142857
Control.SRR15539874;35;32;0.542857142857143;16;19;0.0428571428571428;0.457142857142857
Control.SRR15539874;35;32;0.485714285714286;18;17;0.0142857142857143;0.485714285714286
Control.SRR15539874;35;32;0.314285714285714;24;11;0.185714285714286;0.314285714285714
Control.SRR15539874;30;32;0.433333333333333;17;13;0.0666666666666667;0.433333333333333
Control.SRR15539874;30;32;0.533333333333333;14;16;0.0333333333333333;0.466666666666667
Control.SRR15539874;33;32;0.515151515151515;16;17;0.0151515151515151;0.484848484848485
Control.SRR15539874;33;32;0.636363636363636;12;21;0.136363636363636;0.363636363636364
Control.SRR15539874;30;32;0.566666666666667;13;17;0.0666666666666667;0.433333333333333
Control.SRR15539874;31;32;0.580645161290323;13;18;0.0806451612903226;0.419354838709677
Control.SRR15539874;28;32;0.571428571428571;12;16;0.0714285714285714;0.428571428571429
Control.SRR15539874;32;32;0.46875;17;15;0.03125;0.46875
Control.SRR15539874;28;32;0.535714285714286;13;15;0.0357142857142857;0.464285714285714
Control.SRR15539874;28;32;0.464285714285714;15;13;0.0357142857142857;0.464285714285714
Control.SRR15539874;32;32;0.53125;15;17;0.03125;0.46875
Control.SRR15539874;32;32;0.59375;13;19;0.09375;0.40625
Control.SRR15539874;29;32;0.448275862068966;16;13;0.0517241379310345;0.448275862068966
Control.SRR15539874;28;32;0.607142857142857;11;17;0.107142857142857;0.392857142857143
Control.SRR15539874;30;32;0.633333333333333;11;19;0.133333333333333;0.366666666666667
Control.SRR15539874;34;32;0.5;17;17;0;0.5
Control.SRR15539874;34;32;0.647058823529412;12;22;0.147058823529412;0.352941176470588
Control.SRR15539874;29;32;0.551724137931034;13;16;0.0517241379310345;0.448275862068966
Control.SRR15539874;34;32;0.470588235294118;18;16;0.0294117647058824;0.470588235294118
Control.SRR15539874;33;32;0.393939393939394;20;13;0.106060606060606;0.393939393939394
Control.SRR15539874;34;32;0.411764705882353;20;14;0.0882352941176471;0.411764705882353
Control.SRR15539874;35;32;0.6;14;21;0.1;0.4
Control.SRR15539874;30;32;0.5;15;15;0;0.5
Control.SRR15539874;33;32;0.272727272727273;24;9;0.227272727272727;0.272727272727273
Control.SRR15539874;31;32;0.516129032258065;15;16;0.0161290322580645;0.483870967741935
Control.SRR15539874;30;32;0.566666666666667;13;17;0.0666666666666667;0.433333333333333
Control.SRR15539874;31;32;0.548387096774194;14;17;0.0483870967741935;0.451612903225806
Control.SRR15539874;32;32;0.5;16;16;0;0.5
Control.SRR15539874;28;32;0.428571428571429;16;12;0.0714285714285715;0.428571428571429
Control.SRR15539874;32;32;0.5;16;16;0;0.5
Control.SRR15539874;30;32;0.466666666666667;16;14;0.0333333333333333;0.466666666666667
Control.SRR15539874;35;32;0.6;14;21;0.1;0.4
Control.SRR15539874;32;32;0.34375;21;11;0.15625;0.34375
Control.SRR15539874;35;32;0.457142857142857;19;16;0.0428571428571429;0.457142857142857
Control.SRR15539874;35;32;0.8;7;28;0.3;0.2
Control.SRR15539874;31;32;0.419354838709677;18;13;0.0806451612903226;0.419354838709677
Control.SRR15539874;29;32;0.551724137931034;13;16;0.0517241379310345;0.448275862068966
Control.SRR15539874;31;32;0.612903225806452;12;19;0.112903225806452;0.387096774193548
Control.SRR15539874;35;32;0.657142857142857;12;23;0.157142857142857;0.342857142857143
Control.SRR15539874;34;32;0.323529411764706;23;11;0.176470588235294;0.323529411764706
Control.SRR15539874;34;32;0.470588235294118;18;16;0.0294117647058824;0.470588235294118
Control.SRR15539874;31;32;0.645161290322581;11;20;0.145161290322581;0.354838709677419
Control.SRR15539874;31;32;0.354838709677419;20;11;0.145161290322581;0.354838709677419
Control.SRR15539874;29;32;0.482758620689655;15;14;0.0172413793103448;0.482758620689655
Control.SRR15539874;31;32;0.483870967741935;16;15;0.0161290322580645;0.483870967741935
Control.SRR15539874;30;32;0.433333333333333;17;13;0.0666666666666667;0.433333333333333
Control.SRR15539874;35;32;0.457142857142857;19;16;0.0428571428571429;0.457142857142857
Control.SRR15539874;30;32;0.5;15;15;0;0.5
Control.SRR15539874;31;32;0.419354838709677;18;13;0.0806451612903226;0.419354838709677
Control.SRR15539874;33;32;0.606060606060606;13;20;0.106060606060606;0.393939393939394
Control.SRR15539874;33;32;0.393939393939394;20;13;0.106060606060606;0.393939393939394
Control.SRR15539874;30;32;0.366666666666667;19;11;0.133333333333333;0.366666666666667
Control.SRR15539874;30;32;0.6;12;18;0.1;0.4
Control.SRR15539874;29;32;0.310344827586207;20;9;0.189655172413793;0.310344827586207
Control.SRR15539874;33;32;0.393939393939394;20;13;0.106060606060606;0.393939393939394
Control.SRR15539874;33;32;0.545454545454545;15;18;0.0454545454545454;0.454545454545455
Control.SRR15539874;30;32;0.633333333333333;11;19;0.133333333333333;0.366666666666667
Control.SRR15539874;35;32;0.457142857142857;19;16;0.0428571428571429;0.457142857142857
Control.SRR15539874;33;32;0.454545454545455;18;15;0.0454545454545455;0.454545454545455
Control.SRR15539874;29;32;0.551724137931034;13;16;0.0517241379310345;0.448275862068966
Control.SRR15539874;30;32;0.433333333333333;17;13;0.0666666666666667;0.433333333333333
Control.SRR15539874;30;32;0.7;9;21;0.2;0.3
Control.SRR15539874;34;32;0.382352941176471;21;13;0.117647058823529;0.382352941176471
Control.SRR15539874;33;32;0.575757575757576;14;19;0.0757575757575758;0.424242424242424
Control.SRR15539874;34;32;0.323529411764706;23;11;0.176470588235294;0.323529411764706
Control.SRR15539874;34;32;0.588235294117647;14;20;0.0882352941176471;0.411764705882353
Control.SRR15539874;35;32;0.485714285714286;18;17;0.0142857142857143;0.485714285714286
Control.SRR15539874;32;32;0.5625;14;18;0.0625;0.4375
Control.SRR15539874;32;32;0.625;12;20;0.125;0.375
Control.SRR15539874;31;32;0.451612903225806;17;14;0.0483870967741936;0.451612903225806
Control.SRR15539874;28;32;0.535714285714286;13;15;0.0357142857142857;0.464285714285714
Control.SRR15539874;28;32;0.607142857142857;11;17;0.107142857142857;0.392857142857143
Control.SRR15539874;34;32;0.470588235294118;18;16;0.0294117647058824;0.470588235294118
Control.SRR15539874;27;32;0.296296296296296;19;8;0.203703703703704;0.296296296296296
Control.SRR15539874;32;32;0.65625;11;21;0.15625;0.34375
Control.SRR15539874;35;32;0.657142857142857;12;23;0.157142857142857;0.342857142857143
Control.SRR15539874;35;32;0.514285714285714;17;18;0.0142857142857142;0.485714285714286
Control.SRR15539874;32;32;0.6875;10;22;0.1875;0.3125
Control.SRR15539874;35;32;0.342857142857143;23;12;0.157142857142857;0.342857142857143
Control.SRR15539874;34;32;0.441176470588235;19;15;0.0588235294117647;0.441176470588235
Control.SRR15539874;33;32;0.454545454545455;18;15;0.0454545454545455;0.454545454545455
Control.SRR15539874;28;32;0.428571428571429;16;12;0.0714285714285715;0.428571428571429
Control.SRR15539874;32;32;0.5;16;16;0;0.5
Control.SRR15539874;31;32;0.451612903225806;17;14;0.0483870967741936;0.451612903225806
Control.SRR15539874;29;32;0.517241379310345;14;15;0.0172413793103449;0.482758620689655
Control.SRR15539874;28;32;0.285714285714286;20;8;0.214285714285714;0.285714285714286
Control.SRR15539874;28;32;0.464285714285714;15;13;0.0357142857142857;0.464285714285714
Control.SRR15539874;30;32;0.566666666666667;13;17;0.0666666666666667;0.433333333333333
Control.SRR15539874;34;32;0.558823529411765;15;19;0.0588235294117647;0.441176470588235
Control.SRR15539874;31;32;0.548387096774194;14;17;0.0483870967741935;0.451612903225806
Control.SRR15539874;29;32;0.448275862068966;16;13;0.0517241379310345;0.448275862068966
Control.SRR15539874;29;32;0.517241379310345;14;15;0.0172413793103449;0.482758620689655
Control.SRR15539874;27;32;0.259259259259259;20;7;0.240740740740741;0.259259259259259
Control.SRR15539874;32;32;0.46875;17;15;0.03125;0.46875
Control.SRR15539874;29;32;0.517241379310345;14;15;0.0172413793103449;0.482758620689655
Control.SRR15539874;32;32;0.40625;19;13;0.09375;0.40625
Control.SRR15539874;32;32;0.625;12;20;0.125;0.375
Control.SRR15539874;33;32;0.575757575757576;14;19;0.0757575757575758;0.424242424242424
Control.SRR15539874;32;32;0.53125;15;17;0.03125;0.46875
Control.SRR15539874;27;32;0.481481481481481;14;13;0.0185185185185185;0.481481481481481
Control.SRR15539874;31;32;0.548387096774194;14;17;0.0483870967741935;0.451612903225806
Control.SRR15539874;30;32;0.533333333333333;14;16;0.0333333333333333;0.466666666666667
Control.SRR15539874;29;32;0.517241379310345;14;15;0.0172413793103449;0.482758620689655
Control.SRR15539874;30;32;0.533333333333333;14;16;0.0333333333333333;0.466666666666667
Control.SRR15539874;34;32;0.470588235294118;18;16;0.0294117647058824;0.470588235294118
Control.SRR15539874;33;32;0.515151515151515;16;17;0.0151515151515151;0.484848484848485
Control.SRR15539874;33;32;0.575757575757576;14;19;0.0757575757575758;0.424242424242424
Control.SRR15539874;27;32;0.518518518518518;13;14;0.0185185185185185;0.481481481481481
Control.SRR15539874;28;32;0.678571428571429;9;19;0.178571428571429;0.321428571428571
Control.SRR15539874;30;32;0.566666666666667;13;17;0.0666666666666667;0.433333333333333
Control.SRR15539874;31;32;0.387096774193548;19;12;0.112903225806452;0.387096774193548
Control.SRR15539874;32;32;0.5;16;16;0;0.5
Control.SRR15539874;29;32;0.517241379310345;14;15;0.0172413793103449;0.482758620689655
Control.SRR15539874;30;32;0.633333333333333;11;19;0.133333333333333;0.366666666666667
Control.SRR15539874;33;32;0.424242424242424;19;14;0.0757575757575757;0.424242424242424
Control.SRR15539874;30;32;0.5;15;15;0;0.5
Control.SRR15539874;34;32;0.470588235294118;18;16;0.0294117647058824;0.470588235294118
Control.SRR15539874;30;32;0.333333333333333;20;10;0.166666666666667;0.333333333333333
Control.SRR15539874;34;32;0.441176470588235;19;15;0.0588235294117647;0.441176470588235
Control.SRR15539874;35;32;0.542857142857143;16;19;0.0428571428571428;0.457142857142857
Control.SRR15539874;28;32;0.428571428571429;16;12;0.0714285714285715;0.428571428571429
Control.SRR15539874;27;32;0.481481481481481;14;13;0.0185185185185185;0.481481481481481
Control.SRR15539874;35;32;0.514285714285714;17;18;0.0142857142857142;0.485714285714286
Control.SRR15539874;32;32;0.40625;19;13;0.09375;0.40625
Control.SRR15539874;34;32;0.529411764705882;16;18;0.0294117647058824;0.470588235294118
Control.SRR15539874;34;32;0.529411764705882;16;18;0.0294117647058824;0.470588235294118
Control.SRR15539874;33;32;0.545454545454545;15;18;0.0454545454545454;0.454545454545455
Control.SRR15539874;27;32;0.37037037037037;17;10;0.12962962962963;0.37037037037037
Control.SRR15539874;27;32;0.407407407407407;16;11;0.0925925925925926;0.407407407407407
Control.SRR15539874;29;32;0.517241379310345;14;15;0.0172413793103449;0.482758620689655
Control.SRR15539874;32;32;0.59375;13;19;0.09375;0.40625
Control.SRR15539874;30;32;0.5;15;15;0;0.5
Control.SRR15539874;27;32;0.481481481481481;14;13;0.0185185185185185;0.481481481481481
Control.SRR15539874;27;32;0.444444444444444;15;12;0.0555555555555556;0.444444444444444
Control.SRR15539874;33;32;0.575757575757576;14;19;0.0757575757575758;0.424242424242424
Control.SRR15539874;33;32;0.484848484848485;17;16;0.0151515151515151;0.484848484848485
Control.SRR15539874;28;32;0.428571428571429;16;12;0.0714285714285715;0.428571428571429
Control.SRR15539874;34;32;0.441176470588235;19;15;0.0588235294117647;0.441176470588235
Control.SRR15539874;33;32;0.575757575757576;14;19;0.0757575757575758;0.424242424242424
Control.SRR15539874;32;32;0.46875;17;15;0.03125;0.46875
Control.SRR15539874;32;32;0.59375;13;19;0.09375;0.40625
Control.SRR15539874;32;32;0.59375;13;19;0.09375;0.40625
Control.SRR15539874;27;32;0.481481481481481;14;13;0.0185185185185185;0.481481481481481
Control.SRR15539874;31;32;0.516129032258065;15;16;0.0161290322580645;0.483870967741935
Control.SRR15539874;33;32;0.424242424242424;19;14;0.0757575757575757;0.424242424242424
Control.SRR15539874;31;32;0.451612903225806;17;14;0.0483870967741936;0.451612903225806
Control.SRR15539874;30;32;0.533333333333333;14;16;0.0333333333333333;0.466666666666667
Control.SRR15539874;33;32;0.424242424242424;19;14;0.0757575757575757;0.424242424242424
Control.SRR15539874;28;32;0.428571428571429;16;12;0.0714285714285715;0.428571428571429
Control.SRR15539874;29;32;0.482758620689655;15;14;0.0172413793103448;0.482758620689655
Control.SRR15539874;35;32;0.342857142857143;23;12;0.157142857142857;0.342857142857143
Control.SRR15539874;30;32;0.3;21;9;0.2;0.3
Control.SRR15539874;35;32;0.428571428571429;20;15;0.0714285714285715;0.428571428571429
Control.SRR15539874;29;32;0.517241379310345;14;15;0.0172413793103449;0.482758620689655
Control.SRR15539874;35;32;0.4;21;14;0.1;0.4
Control.SRR15539874;32;32;0.5;16;16;0;0.5
Control.SRR15539874;30;32;0.466666666666667;16;14;0.0333333333333333;0.466666666666667
Control.SRR15539874;33;32;0.575757575757576;14;19;0.0757575757575758;0.424242424242424
Control.SRR15539874;31;32;0.483870967741935;16;15;0.0161290322580645;0.483870967741935
Control.SRR15539874;32;32;0.5625;14;18;0.0625;0.4375
Control.SRR15539874;33;32;0.606060606060606;13;20;0.106060606060606;0.393939393939394
Control.SRR15539874;35;32;0.457142857142857;19;16;0.0428571428571429;0.457142857142857
Control.SRR15539874;34;32;0.529411764705882;16;18;0.0294117647058824;0.470588235294118
Control.SRR15539874;34;32;0.647058823529412;12;22;0.147058823529412;0.352941176470588
Control.SRR15539874;29;32;0.413793103448276;17;12;0.0862068965517241;0.413793103448276
Control.SRR15539874;28;32;0.535714285714286;13;15;0.0357142857142857;0.464285714285714
Control.SRR15539874;35;32;0.6;14;21;0.1;0.4
Control.SRR15539874;31;32;0.419354838709677;18;13;0.0806451612903226;0.419354838709677
Control.SRR15539874;29;32;0.482758620689655;15;14;0.0172413793103448;0.482758620689655
Control.SRR15539874;28;32;0.25;21;7;0.25;0.25
Control.SRR15539874;29;32;0.482758620689655;15;14;0.0172413793103448;0.482758620689655
Control.SRR15539874;33;32;0.424242424242424;19;14;0.0757575757575757;0.424242424242424
Control.SRR15539874;31;32;0.483870967741935;16;15;0.0161290322580645;0.483870967741935
Control.SRR15539874;32;32;0.40625;19;13;0.09375;0.40625
Control.SRR15539874;28;32;0.285714285714286;20;8;0.214285714285714;0.285714285714286
Control.SRR15539874;35;32;0.542857142857143;16;19;0.0428571428571428;0.457142857142857
Control.SRR15539874;30;32;0.466666666666667;16;14;0.0333333333333333;0.466666666666667
Control.SRR15539874;33;32;0.484848484848485;17;16;0.0151515151515151;0.484848484848485
Control.SRR15539874;32;32;0.65625;11;21;0.15625;0.34375
Control.SRR15539874;35;32;0.428571428571429;20;15;0.0714285714285715;0.428571428571429
Control.SRR15539874;29;32;0.517241379310345;14;15;0.0172413793103449;0.482758620689655
Control.SRR15539874;28;32;0.392857142857143;17;11;0.107142857142857;0.392857142857143
Control.SRR15539874;32;32;0.5625;14;18;0.0625;0.4375
Control.SRR15539874;34;32;0.470588235294118;18;16;0.0294117647058824;0.470588235294118
Control.SRR15539874;30;32;0.466666666666667;16;14;0.0333333333333333;0.466666666666667
Control.SRR15539874;31;32;0.548387096774194;14;17;0.0483870967741935;0.451612903225806
Control.SRR15539874;30;32;0.433333333333333;17;13;0.0666666666666667;0.433333333333333
Control.SRR15539874;32;32;0.375;20;12;0.125;0.375
Control.SRR15539874;29;32;0.344827586206897;19;10;0.155172413793103;0.344827586206897
Control.SRR15539874;28;32;0.285714285714286;20;8;0.214285714285714;0.285714285714286
Control.SRR15539874;30;32;0.666666666666667;10;20;0.166666666666667;0.333333333333333
Control.SRR15539874;31;32;0.548387096774194;14;17;0.0483870967741935;0.451612903225806
Control.SRR15539874;34;32;0.411764705882353;20;14;0.0882352941176471;0.411764705882353
Control.SRR15539874;28;32;0.607142857142857;11;17;0.107142857142857;0.392857142857143
Control.SRR15539874;27;32;0.555555555555556;12;15;0.0555555555555556;0.444444444444444
Control.SRR15539874;31;32;0.645161290322581;11;20;0.145161290322581;0.354838709677419
Control.SRR15539874;32;32;0.46875;17;15;0.03125;0.46875
Control.SRR15539874;34;32;0.411764705882353;20;14;0.0882352941176471;0.411764705882353
Control.SRR15539874;33;32;0.272727272727273;24;9;0.227272727272727;0.272727272727273
Control.SRR15539874;30;32;0.466666666666667;16;14;0.0333333333333333;0.466666666666667
Control.SRR15539874;31;32;0.548387096774194;14;17;0.0483870967741935;0.451612903225806
Control.SRR15539874;35;32;0.514285714285714;17;18;0.0142857142857142;0.485714285714286
Control.SRR15539874;32;32;0.5;16;16;0;0.5
Control.SRR15539874;28;32;0.571428571428571;12;16;0.0714285714285714;0.428571428571429
Control.SRR15539874;32;32;0.65625;11;21;0.15625;0.34375
Control.SRR15539874;32;32;0.4375;18;14;0.0625;0.4375
Control.SRR15539874;30;32;0.533333333333333;14;16;0.0333333333333333;0.466666666666667
Control.SRR15539874;28;32;0.214285714285714;22;6;0.285714285714286;0.214285714285714
Control.SRR15539874;29;32;0.724137931034483;8;21;0.224137931034483;0.275862068965517
Control.SRR15539874;30;32;0.5;15;15;0;0.5
Control.SRR15539874;33;32;0.393939393939394;20;13;0.106060606060606;0.393939393939394
Control.SRR15539874;29;32;0.620689655172414;11;18;0.120689655172414;0.379310344827586
Control.SRR15539874;33;32;0.484848484848485;17;16;0.0151515151515151;0.484848484848485
Control.SRR15539874;29;32;0.448275862068966;16;13;0.0517241379310345;0.448275862068966
Control.SRR15539874;32;32;0.46875;17;15;0.03125;0.46875
Control.SRR15539874;28;32;0.571428571428571;12;16;0.0714285714285714;0.428571428571429
Control.SRR15539874;35;32;0.371428571428571;22;13;0.128571428571429;0.371428571428571
Control.SRR15539874;29;32;0.344827586206897;19;10;0.155172413793103;0.344827586206897
Control.SRR15539874;32;32;0.53125;15;17;0.03125;0.46875
Control.SRR15539874;30;32;0.433333333333333;17;13;0.0666666666666667;0.433333333333333
Control.SRR15539874;30;32;0.566666666666667;13;17;0.0666666666666667;0.433333333333333
Control.SRR15539874;35;32;0.514285714285714;17;18;0.0142857142857142;0.485714285714286
Control.SRR15539874;33;32;0.454545454545455;18;15;0.0454545454545455;0.454545454545455
Control.SRR15539874;33;32;0.454545454545455;18;15;0.0454545454545455;0.454545454545455
Control.SRR15539874;29;32;0.586206896551724;12;17;0.0862068965517241;0.413793103448276
Control.SRR15539874;29;32;0.448275862068966;16;13;0.0517241379310345;0.448275862068966
Control.SRR15539874;27;32;0.296296296296296;19;8;0.203703703703704;0.296296296296296
Control.SRR15539874;31;32;0.516129032258065;15;16;0.0161290322580645;0.483870967741935
Control.SRR15539874;35;32;0.485714285714286;18;17;0.0142857142857143;0.485714285714286
Control.SRR15539874;31;32;0.548387096774194;14;17;0.0483870967741935;0.451612903225806
Control.SRR15539874;29;32;0.655172413793103;10;19;0.155172413793103;0.344827586206897
Control.SRR15539874;31;32;0.516129032258065;15;16;0.0161290322580645;0.483870967741935
Control.SRR15539874;27;32;0.555555555555556;12;15;0.0555555555555556;0.444444444444444
Control.SRR15539874;32;32;0.65625;11;21;0.15625;0.34375
Control.SRR15539874;33;32;0.424242424242424;19;14;0.0757575757575757;0.424242424242424
Control.SRR15539874;30;32;0.666666666666667;10;20;0.166666666666667;0.333333333333333
Control.SRR15539874;34;32;0.5;17;17;0;0.5
Control.SRR15539874;31;32;0.483870967741935;16;15;0.0161290322580645;0.483870967741935
Control.SRR15539874;31;32;0.419354838709677;18;13;0.0806451612903226;0.419354838709677
Control.SRR15539874;32;32;0.5;16;16;0;0.5
Control.SRR15539874;32;32;0.75;8;24;0.25;0.25
Control.SRR15539874;31;32;0.516129032258065;15;16;0.0161290322580645;0.483870967741935
Control.SRR15539874;29;32;0.517241379310345;14;15;0.0172413793103449;0.482758620689655
Control.SRR15539874;33;32;0.363636363636364;21;12;0.136363636363636;0.363636363636364
Control.SRR15539874;33;32;0.545454545454545;15;18;0.0454545454545454;0.454545454545455
Control.SRR15539874;32;32;0.5625;14;18;0.0625;0.4375
Control.SRR15539874;27;32;0.555555555555556;12;15;0.0555555555555556;0.444444444444444
Control.SRR15539874;31;32;0.548387096774194;14;17;0.0483870967741935;0.451612903225806
Control.SRR15539874;27;32;0.555555555555556;12;15;0.0555555555555556;0.444444444444444
Control.SRR15539874;31;32;0.354838709677419;20;11;0.145161290322581;0.354838709677419
Control.SRR15539874;28;32;0.428571428571429;16;12;0.0714285714285715;0.428571428571429
Control.SRR15539874;30;32;0.5;15;15;0;0.5
Control.SRR15539874;30;32;0.466666666666667;16;14;0.0333333333333333;0.466666666666667
Control.SRR15539874;29;32;0.448275862068966;16;13;0.0517241379310345;0.448275862068966
Control.SRR15539874;32;32;0.34375;21;11;0.15625;0.34375
Control.SRR15539874;32;32;0.40625;19;13;0.09375;0.40625
Control.SRR15539874;28;32;0.607142857142857;11;17;0.107142857142857;0.392857142857143
Control.SRR15539874;34;32;0.5;17;17;0;0.5
Control.SRR15539874;31;32;0.548387096774194;14;17;0.0483870967741935;0.451612903225806
Control.SRR15539874;33;32;0.484848484848485;17;16;0.0151515151515151;0.484848484848485
Control.SRR15539874;35;32;0.457142857142857;19;16;0.0428571428571429;0.457142857142857
Control.SRR15539874;32;32;0.46875;17;15;0.03125;0.46875
Control.SRR15539874;33;32;0.333333333333333;22;11;0.166666666666667;0.333333333333333
Control.SRR15539874;33;32;0.666666666666667;11;22;0.166666666666667;0.333333333333333
Control.SRR15539874;29;32;0.448275862068966;16;13;0.0517241379310345;0.448275862068966
Control.SRR15539874;32;32;0.5;16;16;0;0.5
Control.SRR15539874;34;32;0.470588235294118;18;16;0.0294117647058824;0.470588235294118
Control.SRR15539874;31;32;0.612903225806452;12;19;0.112903225806452;0.387096774193548
Control.SRR15539874;27;32;0.555555555555556;12;15;0.0555555555555556;0.444444444444444
Control.SRR15539874;29;32;0.241379310344828;22;7;0.258620689655172;0.241379310344828
Control.SRR15539874;34;32;0.411764705882353;20;14;0.0882352941176471;0.411764705882353
Control.SRR15539874;28;32;0.5;14;14;0;0.5
Control.SRR15539874;30;32;0.566666666666667;13;17;0.0666666666666667;0.433333333333333
Control.SRR15539874;30;32;0.5;15;15;0;0.5
Control.SRR15539874;28;32;0.642857142857143;10;18;0.142857142857143;0.357142857142857
Control.SRR15539874;29;32;0.586206896551724;12;17;0.0862068965517241;0.413793103448276
Control.SRR15539874;30;32;0.433333333333333;17;13;0.0666666666666667;0.433333333333333
Control.SRR15539874;32;32;0.28125;23;9;0.21875;0.28125
Control.SRR15539874;31;32;0.645161290322581;11;20;0.145161290322581;0.354838709677419
Control.SRR15539874;29;32;0.655172413793103;10;19;0.155172413793103;0.344827586206897
Control.SRR15539874;28;32;0.607142857142857;11;17;0.107142857142857;0.392857142857143
Control.SRR15539874;29;32;0.448275862068966;16;13;0.0517241379310345;0.448275862068966
Control.SRR15539874;34;32;0.441176470588235;19;15;0.0588235294117647;0.441176470588235
Control.SRR15539874;29;32;0.482758620689655;15;14;0.0172413793103448;0.482758620689655
Control.SRR15539874;34;32;0.5;17;17;0;0.5
Control.SRR15539874;32;32;0.625;12;20;0.125;0.375
Control.SRR15539874;35;32;0.6;14;21;0.1;0.4
Control.SRR15539874;35;32;0.428571428571429;20;15;0.0714285714285715;0.428571428571429
Control.SRR15539874;34;32;0.558823529411765;15;19;0.0588235294117647;0.441176470588235
Control.SRR15539874;31;32;0.483870967741935;16;15;0.0161290322580645;0.483870967741935
Control.SRR15539874;34;32;0.294117647058824;24;10;0.205882352941176;0.294117647058824
Control.SRR15539874;33;32;0.393939393939394;20;13;0.106060606060606;0.393939393939394
Control.SRR15539874;31;32;0.548387096774194;14;17;0.0483870967741935;0.451612903225806
Control.SRR15539874;31;32;0.354838709677419;20;11;0.145161290322581;0.354838709677419
Control.SRR15539874;34;32;0.529411764705882;16;18;0.0294117647058824;0.470588235294118
Control.SRR15539874;32;32;0.53125;15;17;0.03125;0.46875
Control.SRR15539874;35;32;0.457142857142857;19;16;0.0428571428571429;0.457142857142857
Control.SRR15539874;27;32;0.518518518518518;13;14;0.0185185185185185;0.481481481481481
Control.SRR15539874;30;32;0.5;15;15;0;0.5
Control.SRR15539874;35;32;0.4;21;14;0.1;0.4
Control.SRR15539874;33;32;0.575757575757576;14;19;0.0757575757575758;0.424242424242424
Control.SRR15539874;32;32;0.4375;18;14;0.0625;0.4375
Control.SRR15539874;28;32;0.714285714285714;8;20;0.214285714285714;0.285714285714286
Control.SRR15539874;30;32;0.533333333333333;14;16;0.0333333333333333;0.466666666666667
Control.SRR15539874;31;32;0.354838709677419;20;11;0.145161290322581;0.354838709677419
Control.SRR15539874;31;32;0.258064516129032;23;8;0.241935483870968;0.258064516129032
Control.SRR15539874;28;32;0.5;14;14;0;0.5
Control.SRR15539874;34;32;0.529411764705882;16;18;0.0294117647058824;0.470588235294118
Control.SRR15539874;35;32;0.571428571428571;15;20;0.0714285714285714;0.428571428571429
Control.SRR15539874;28;32;0.642857142857143;10;18;0.142857142857143;0.357142857142857
Control.SRR15539874;30;32;0.5;15;15;0;0.5
Control.SRR15539874;29;32;0.448275862068966;16;13;0.0517241379310345;0.448275862068966
Control.SRR15539874;34;32;0.470588235294118;18;16;0.0294117647058824;0.470588235294118
Control.SRR15539874;33;32;0.606060606060606;13;20;0.106060606060606;0.393939393939394
Control.SRR15539874;32;32;0.59375;13;19;0.09375;0.40625
Control.SRR15539874;35;32;0.428571428571429;20;15;0.0714285714285715;0.428571428571429
Control.SRR15539874;33;32;0.545454545454545;15;18;0.0454545454545454;0.454545454545455
Control.SRR15539874;31;32;0.548387096774194;14;17;0.0483870967741935;0.451612903225806
Control.SRR15539874;28;32;0.5;14;14;0;0.5
Control.SRR15539874;34;32;0.5;17;17;0;0.5
Control.SRR15539874;32;32;0.46875;17;15;0.03125;0.46875
Control.SRR15539874;35;32;0.628571428571429;13;22;0.128571428571429;0.371428571428571
Control.SRR15539874;28;32;0.428571428571429;16;12;0.0714285714285715;0.428571428571429
Control.SRR15539874;34;32;0.441176470588235;19;15;0.0588235294117647;0.441176470588235
Control.SRR15539874;28;32;0.428571428571429;16;12;0.0714285714285715;0.428571428571429
Control.SRR15539874;29;32;0.620689655172414;11;18;0.120689655172414;0.379310344827586
Control.SRR15539874;30;32;0.566666666666667;13;17;0.0666666666666667;0.433333333333333
Control.SRR15539874;28;32;0.571428571428571;12;16;0.0714285714285714;0.428571428571429
Control.SRR15539874;27;32;0.259259259259259;20;7;0.240740740740741;0.259259259259259
Control.SRR15539874;29;32;0.551724137931034;13;16;0.0517241379310345;0.448275862068966
Control.SRR15539874;30;32;0.366666666666667;19;11;0.133333333333333;0.366666666666667
Control.SRR15539874;29;32;0.620689655172414;11;18;0.120689655172414;0.379310344827586
Control.SRR15539874;28;32;0.357142857142857;18;10;0.142857142857143;0.357142857142857
Control.SRR15539874;32;32;0.53125;15;17;0.03125;0.46875
Control.SRR15539874;28;32;0.357142857142857;18;10;0.142857142857143;0.357142857142857
Control.SRR15539874;29;32;0.482758620689655;15;14;0.0172413793103448;0.482758620689655
Control.SRR15539874;32;32;0.46875;17;15;0.03125;0.46875
Control.SRR15539874;34;32;0.441176470588235;19;15;0.0588235294117647;0.441176470588235
Control.SRR15539874;33;32;0.454545454545455;18;15;0.0454545454545455;0.454545454545455
Control.SRR15539874;33;32;0.484848484848485;17;16;0.0151515151515151;0.484848484848485
Control.SRR15539874;28;32;0.392857142857143;17;11;0.107142857142857;0.392857142857143
Control.SRR15539874;33;32;0.575757575757576;14;19;0.0757575757575758;0.424242424242424
Control.SRR15539874;32;32;0.3125;22;10;0.1875;0.3125
Control.SRR15539874;32;32;0.4375;18;14;0.0625;0.4375
Control.SRR15539874;30;32;0.466666666666667;16;14;0.0333333333333333;0.466666666666667
Control.SRR15539874;32;32;0.53125;15;17;0.03125;0.46875
Control.SRR15539874;32;32;0.46875;17;15;0.03125;0.46875
Control.SRR15539874;30;32;0.466666666666667;16;14;0.0333333333333333;0.466666666666667
Control.SRR15539874;32;32;0.59375;13;19;0.09375;0.40625
Control.SRR15539874;33;32;0.515151515151515;16;17;0.0151515151515151;0.484848484848485
Control.SRR15539874;27;32;0.37037037037037;17;10;0.12962962962963;0.37037037037037
Control.SRR15539874;32;32;0.4375;18;14;0.0625;0.4375
Control.SRR15539874;27;32;0.444444444444444;15;12;0.0555555555555556;0.444444444444444
Control.SRR15539874;27;32;0.407407407407407;16;11;0.0925925925925926;0.407407407407407
Control.SRR15539874;27;32;0.666666666666667;9;18;0.166666666666667;0.333333333333333
Control.SRR15539874;29;32;0.448275862068966;16;13;0.0517241379310345;0.448275862068966
Control.SRR15539874;34;32;0.411764705882353;20;14;0.0882352941176471;0.411764705882353
Control.SRR15539874;30;32;0.433333333333333;17;13;0.0666666666666667;0.433333333333333
Control.SRR15539874;31;32;0.483870967741935;16;15;0.0161290322580645;0.483870967741935
Control.SRR15539874;31;32;0.483870967741935;16;15;0.0161290322580645;0.483870967741935
Control.SRR15539874;34;32;0.411764705882353;20;14;0.0882352941176471;0.411764705882353
Control.SRR15539874;33;32;0.545454545454545;15;18;0.0454545454545454;0.454545454545455
Control.SRR15539874;33;32;0.606060606060606;13;20;0.106060606060606;0.393939393939394
Control.SRR15539874;30;32;0.333333333333333;20;10;0.166666666666667;0.333333333333333
Control.SRR15539874;31;32;0.580645161290323;13;18;0.0806451612903226;0.419354838709677
Control.SRR15539874;28;32;0.464285714285714;15;13;0.0357142857142857;0.464285714285714
Control.SRR15539874;27;32;0.592592592592593;11;16;0.0925925925925926;0.407407407407407
Control.SRR15539874;27;32;0.518518518518518;13;14;0.0185185185185185;0.481481481481481
Control.SRR15539874;27;32;0.703703703703704;8;19;0.203703703703704;0.296296296296296
Control.SRR15539874;27;32;0.481481481481481;14;13;0.0185185185185185;0.481481481481481
Control.SRR15539874;31;32;0.67741935483871;10;21;0.17741935483871;0.32258064516129
Control.SRR15539874;27;32;0.481481481481481;14;13;0.0185185185185185;0.481481481481481
Control.SRR15539874;31;32;0.483870967741935;16;15;0.0161290322580645;0.483870967741935
Control.SRR15539874;34;32;0.441176470588235;19;15;0.0588235294117647;0.441176470588235
Control.SRR15539874;31;32;0.548387096774194;14;17;0.0483870967741935;0.451612903225806
Control.SRR15539874;30;32;0.4;18;12;0.1;0.4
Control.SRR15539874;32;32;0.5625;14;18;0.0625;0.4375
Control.SRR15539874;28;32;0.392857142857143;17;11;0.107142857142857;0.392857142857143
Control.SRR15539874;27;32;0.518518518518518;13;14;0.0185185185185185;0.481481481481481
Control.SRR15539874;28;32;0.642857142857143;10;18;0.142857142857143;0.357142857142857
Control.SRR15539874;28;32;0.571428571428571;12;16;0.0714285714285714;0.428571428571429
Control.SRR15539874;35;32;0.514285714285714;17;18;0.0142857142857142;0.485714285714286
Control.SRR15539874;29;32;0.448275862068966;16;13;0.0517241379310345;0.448275862068966
Control.SRR15539874;28;32;0.5;14;14;0;0.5
Control.SRR15539874;29;32;0.344827586206897;19;10;0.155172413793103;0.344827586206897
Control.SRR15539874;29;32;0.379310344827586;18;11;0.120689655172414;0.379310344827586
Control.SRR15539874;28;32;0.428571428571429;16;12;0.0714285714285715;0.428571428571429
Control.SRR15539874;34;32;0.529411764705882;16;18;0.0294117647058824;0.470588235294118
Control.SRR15539874;33;32;0.606060606060606;13;20;0.106060606060606;0.393939393939394
Control.SRR15539874;33;32;0.515151515151515;16;17;0.0151515151515151;0.484848484848485
Control.SRR15539874;30;32;0.466666666666667;16;14;0.0333333333333333;0.466666666666667
Control.SRR15539874;33;32;0.515151515151515;16;17;0.0151515151515151;0.484848484848485
Control.SRR15539874;35;32;0.6;14;21;0.1;0.4
Control.SRR15539874;31;32;0.645161290322581;11;20;0.145161290322581;0.354838709677419
Control.SRR15539874;28;32;0.464285714285714;15;13;0.0357142857142857;0.464285714285714
Control.SRR15539874;30;32;0.5;15;15;0;0.5
Control.SRR15539874;35;32;0.485714285714286;18;17;0.0142857142857143;0.485714285714286
Control.SRR15539874;31;32;0.451612903225806;17;14;0.0483870967741936;0.451612903225806
Control.SRR15539874;32;32;0.46875;17;15;0.03125;0.46875
Control.SRR15539874;34;32;0.470588235294118;18;16;0.0294117647058824;0.470588235294118
Control.SRR15539874;33;32;0.484848484848485;17;16;0.0151515151515151;0.484848484848485
Control.SRR15539874;32;32;0.40625;19;13;0.09375;0.40625
Control.SRR15539874;29;32;0.310344827586207;20;9;0.189655172413793;0.310344827586207
Control.SRR15539874;27;32;0.333333333333333;18;9;0.166666666666667;0.333333333333333
Control.SRR15539874;31;32;0.419354838709677;18;13;0.0806451612903226;0.419354838709677
Control.SRR15539874;27;32;0.37037037037037;17;10;0.12962962962963;0.37037037037037
Control.SRR15539874;35;32;0.657142857142857;12;23;0.157142857142857;0.342857142857143
Control.SRR15539874;31;32;0.516129032258065;15;16;0.0161290322580645;0.483870967741935
Control.SRR15539874;33;32;0.575757575757576;14;19;0.0757575757575758;0.424242424242424
Control.SRR15539874;31;32;0.483870967741935;16;15;0.0161290322580645;0.483870967741935
Control.SRR15539874;32;32;0.5;16;16;0;0.5
Control.SRR15539874;30;32;0.433333333333333;17;13;0.0666666666666667;0.433333333333333
Control.SRR15539874;33;32;0.515151515151515;16;17;0.0151515151515151;0.484848484848485
Control.SRR15539874;30;32;0.4;18;12;0.1;0.4
Control.SRR15539874;31;32;0.645161290322581;11;20;0.145161290322581;0.354838709677419
Control.SRR15539874;27;32;0.555555555555556;12;15;0.0555555555555556;0.444444444444444
Control.SRR15539874;34;32;0.382352941176471;21;13;0.117647058823529;0.382352941176471
Control.SRR15539874;33;32;0.454545454545455;18;15;0.0454545454545455;0.454545454545455
Control.SRR15539874;31;32;0.419354838709677;18;13;0.0806451612903226;0.419354838709677
Control.SRR15539874;33;32;0.636363636363636;12;21;0.136363636363636;0.363636363636364
Control.SRR15539874;33;32;0.545454545454545;15;18;0.0454545454545454;0.454545454545455
Control.SRR15539874;28;32;0.535714285714286;13;15;0.0357142857142857;0.464285714285714
Control.SRR15539874;28;32;0.5;14;14;0;0.5
Control.SRR15539874;28;32;0.428571428571429;16;12;0.0714285714285715;0.428571428571429
Control.SRR15539874;33;32;0.484848484848485;17;16;0.0151515151515151;0.484848484848485
Control.SRR15539874;32;32;0.5625;14;18;0.0625;0.4375
Control.SRR15539874;32;32;0.5;16;16;0;0.5
Control.SRR15539874;28;32;0.392857142857143;17;11;0.107142857142857;0.392857142857143
Control.SRR15539874;28;32;0.571428571428571;12;16;0.0714285714285714;0.428571428571429
Control.SRR15539874;33;32;0.454545454545455;18;15;0.0454545454545455;0.454545454545455
Control.SRR15539874;29;32;0.482758620689655;15;14;0.0172413793103448;0.482758620689655
Control.SRR15539874;34;32;0.5;17;17;0;0.5
Control.SRR15539874;31;32;0.548387096774194;14;17;0.0483870967741935;0.451612903225806
Control.SRR15539874;28;32;0.5;14;14;0;0.5
Control.SRR15539874;31;32;0.516129032258065;15;16;0.0161290322580645;0.483870967741935
Control.SRR15539874;31;32;0.580645161290323;13;18;0.0806451612903226;0.419354838709677
Control.SRR15539874;27;32;0.518518518518518;13;14;0.0185185185185185;0.481481481481481
Control.SRR15539874;34;32;0.588235294117647;14;20;0.0882352941176471;0.411764705882353
Control.SRR15539874;30;32;0.466666666666667;16;14;0.0333333333333333;0.466666666666667
Control.SRR15539874;34;32;0.470588235294118;18;16;0.0294117647058824;0.470588235294118
Control.SRR15539874;33;32;0.484848484848485;17;16;0.0151515151515151;0.484848484848485
Control.SRR15539874;31;32;0.32258064516129;21;10;0.17741935483871;0.32258064516129
Control.SRR15539874;31;32;0.548387096774194;14;17;0.0483870967741935;0.451612903225806
Control.SRR15539874;28;32;0.535714285714286;13;15;0.0357142857142857;0.464285714285714
Control.SRR15539874;27;32;0.555555555555556;12;15;0.0555555555555556;0.444444444444444
Control.SRR15539874;31;32;0.548387096774194;14;17;0.0483870967741935;0.451612903225806
Control.SRR15539874;29;32;0.482758620689655;15;14;0.0172413793103448;0.482758620689655
Control.SRR15539874;33;32;0.303030303030303;23;10;0.196969696969697;0.303030303030303
Control.SRR15539874;31;32;0.580645161290323;13;18;0.0806451612903226;0.419354838709677
Control.SRR15539874;33;32;0.454545454545455;18;15;0.0454545454545455;0.454545454545455
Control.SRR15539874;27;32;0.481481481481481;14;13;0.0185185185185185;0.481481481481481
Control.SRR15539874;34;32;0.470588235294118;18;16;0.0294117647058824;0.470588235294118
Control.SRR15539874;31;32;0.516129032258065;15;16;0.0161290322580645;0.483870967741935
Control.SRR15539874;34;32;0.441176470588235;19;15;0.0588235294117647;0.441176470588235
Control.SRR15539874;30;32;0.566666666666667;13;17;0.0666666666666667;0.433333333333333
Control.SRR15539874;34;32;0.5;17;17;0;0.5
Control.SRR15539874;29;32;0.448275862068966;16;13;0.0517241379310345;0.448275862068966
Control.SRR15539874;32;32;0.40625;19;13;0.09375;0.40625
Control.SRR15539874;33;32;0.484848484848485;17;16;0.0151515151515151;0.484848484848485
Control.SRR15539874;32;32;0.53125;15;17;0.03125;0.46875
Control.SRR15539874;35;32;0.428571428571429;20;15;0.0714285714285715;0.428571428571429
Control.SRR15539874;28;32;0.464285714285714;15;13;0.0357142857142857;0.464285714285714
Control.SRR15539874;35;32;0.428571428571429;20;15;0.0714285714285715;0.428571428571429
Control.SRR15539874;32;32;0.375;20;12;0.125;0.375
Control.SRR15539874;34;32;0.470588235294118;18;16;0.0294117647058824;0.470588235294118
Control.SRR15539874;32;32;0.5;16;16;0;0.5
Control.SRR15539874;30;32;0.433333333333333;17;13;0.0666666666666667;0.433333333333333
Control.SRR15539874;30;32;0.5;15;15;0;0.5
Control.SRR15539874;32;32;0.5;16;16;0;0.5
Control.SRR15539874;27;32;0.518518518518518;13;14;0.0185185185185185;0.481481481481481
Control.SRR15539874;31;32;0.516129032258065;15;16;0.0161290322580645;0.483870967741935
Control.SRR15539874;30;32;0.433333333333333;17;13;0.0666666666666667;0.433333333333333
Control.SRR15539874;35;32;0.457142857142857;19;16;0.0428571428571429;0.457142857142857
Control.SRR15539874;29;32;0.655172413793103;10;19;0.155172413793103;0.344827586206897
Control.SRR15539874;30;32;0.566666666666667;13;17;0.0666666666666667;0.433333333333333
Control.SRR15539874;35;32;0.342857142857143;23;12;0.157142857142857;0.342857142857143
Control.SRR15539874;29;32;0.482758620689655;15;14;0.0172413793103448;0.482758620689655
Control.SRR15539874;33;32;0.454545454545455;18;15;0.0454545454545455;0.454545454545455
Control.SRR15539874;29;32;0.413793103448276;17;12;0.0862068965517241;0.413793103448276
Control.SRR15539874;27;32;0.555555555555556;12;15;0.0555555555555556;0.444444444444444
Control.SRR15539874;28;32;0.571428571428571;12;16;0.0714285714285714;0.428571428571429
Control.SRR15539874;27;32;0.518518518518518;13;14;0.0185185185185185;0.481481481481481
Control.SRR15539874;33;32;0.575757575757576;14;19;0.0757575757575758;0.424242424242424
Control.SRR15539874;30;32;0.5;15;15;0;0.5
Control.SRR15539874;32;32;0.5625;14;18;0.0625;0.4375
Control.SRR15539874;30;32;0.533333333333333;14;16;0.0333333333333333;0.466666666666667
Control.SRR15539874;28;32;0.428571428571429;16;12;0.0714285714285715;0.428571428571429
Control.SRR15539874;31;32;0.419354838709677;18;13;0.0806451612903226;0.419354838709677
Control.SRR15539874;32;32;0.5625;14;18;0.0625;0.4375
Control.SRR15539874;30;32;0.466666666666667;16;14;0.0333333333333333;0.466666666666667
Control.SRR15539874;31;32;0.483870967741935;16;15;0.0161290322580645;0.483870967741935
Control.SRR15539874;30;32;0.633333333333333;11;19;0.133333333333333;0.366666666666667
Control.SRR15539874;31;32;0.419354838709677;18;13;0.0806451612903226;0.419354838709677
Control.SRR15539874;34;32;0.470588235294118;18;16;0.0294117647058824;0.470588235294118
Control.SRR15539874;34;32;0.470588235294118;18;16;0.0294117647058824;0.470588235294118
Control.SRR15539874;27;32;0.555555555555556;12;15;0.0555555555555556;0.444444444444444
Control.SRR15539874;27;32;0.555555555555556;12;15;0.0555555555555556;0.444444444444444
Control.SRR15539874;27;32;0.481481481481481;14;13;0.0185185185185185;0.481481481481481
Control.SRR15539874;30;32;0.433333333333333;17;13;0.0666666666666667;0.433333333333333
Control.SRR15539874;35;32;0.571428571428571;15;20;0.0714285714285714;0.428571428571429
Control.SRR15539874;29;32;0.482758620689655;15;14;0.0172413793103448;0.482758620689655
Control.SRR15539874;32;32;0.46875;17;15;0.03125;0.46875
Control.SRR15539874;29;32;0.517241379310345;14;15;0.0172413793103449;0.482758620689655
Control.SRR15539874;35;32;0.371428571428571;22;13;0.128571428571429;0.371428571428571
Control.SRR15539874;28;32;0.428571428571429;16;12;0.0714285714285715;0.428571428571429
Control.SRR15539874;27;32;0.518518518518518;13;14;0.0185185185185185;0.481481481481481
Control.SRR15539874;29;32;0.482758620689655;15;14;0.0172413793103448;0.482758620689655
Control.SRR15539874;27;32;0.37037037037037;17;10;0.12962962962963;0.37037037037037
Control.SRR15539874;31;32;0.387096774193548;19;12;0.112903225806452;0.387096774193548
Control.SRR15539874;34;32;0.411764705882353;20;14;0.0882352941176471;0.411764705882353
Control.SRR15539874;33;32;0.333333333333333;22;11;0.166666666666667;0.333333333333333
Control.SRR15539874;34;32;0.617647058823529;13;21;0.117647058823529;0.382352941176471
Control.SRR15539874;35;32;0.428571428571429;20;15;0.0714285714285715;0.428571428571429
Control.SRR15539874;29;32;0.517241379310345;14;15;0.0172413793103449;0.482758620689655
Control.SRR15539874;28;32;0.535714285714286;13;15;0.0357142857142857;0.464285714285714
Control.SRR15539874;27;32;0.592592592592593;11;16;0.0925925925925926;0.407407407407407
Control.SRR15539874;33;32;0.424242424242424;19;14;0.0757575757575757;0.424242424242424
Control.SRR15539874;27;32;0.37037037037037;17;10;0.12962962962963;0.37037037037037
Control.SRR15539874;34;32;0.5;17;17;0;0.5
Control.SRR15539874;32;32;0.59375;13;19;0.09375;0.40625
Control.SRR15539874;32;32;0.65625;11;21;0.15625;0.34375
Control.SRR15539874;33;32;0.515151515151515;16;17;0.0151515151515151;0.484848484848485
Control.SRR15539874;27;32;0.518518518518518;13;14;0.0185185185185185;0.481481481481481
Control.SRR15539874;30;32;0.566666666666667;13;17;0.0666666666666667;0.433333333333333
Control.SRR15539874;31;32;0.451612903225806;17;14;0.0483870967741936;0.451612903225806
Control.SRR15539874;33;32;0.515151515151515;16;17;0.0151515151515151;0.484848484848485
Control.SRR15539874;34;32;0.382352941176471;21;13;0.117647058823529;0.382352941176471
Control.SRR15539874;31;32;0.483870967741935;16;15;0.0161290322580645;0.483870967741935
Control.SRR15539874;32;32;0.5;16;16;0;0.5
Control.SRR15539874;34;32;0.411764705882353;20;14;0.0882352941176471;0.411764705882353
Control.SRR15539874;28;32;0.535714285714286;13;15;0.0357142857142857;0.464285714285714
Control.SRR15539874;29;32;0.517241379310345;14;15;0.0172413793103449;0.482758620689655
Control.SRR15539874;30;32;0.566666666666667;13;17;0.0666666666666667;0.433333333333333
Control.SRR15539874;30;32;0.566666666666667;13;17;0.0666666666666667;0.433333333333333
Control.SRR15539874;33;32;0.454545454545455;18;15;0.0454545454545455;0.454545454545455
Control.SRR15539874;32;32;0.65625;11;21;0.15625;0.34375
Control.SRR15539874;28;32;0.5;14;14;0;0.5
Control.SRR15539874;27;32;0.37037037037037;17;10;0.12962962962963;0.37037037037037
Control.SRR15539874;34;32;0.470588235294118;18;16;0.0294117647058824;0.470588235294118
Control.SRR15539874;35;32;0.485714285714286;18;17;0.0142857142857143;0.485714285714286
Control.SRR15539874;33;32;0.606060606060606;13;20;0.106060606060606;0.393939393939394
Control.SRR15539874;28;32;0.5;14;14;0;0.5
Control.SRR15539874;27;32;0.444444444444444;15;12;0.0555555555555556;0.444444444444444
Control.SRR15539874;31;32;0.483870967741935;16;15;0.0161290322580645;0.483870967741935
Control.SRR15539874;31;32;0.419354838709677;18;13;0.0806451612903226;0.419354838709677
Control.SRR15539874;29;32;0.482758620689655;15;14;0.0172413793103448;0.482758620689655
Control.SRR15539874;33;32;0.454545454545455;18;15;0.0454545454545455;0.454545454545455
Control.SRR15539874;29;32;0.482758620689655;15;14;0.0172413793103448;0.482758620689655
Control.SRR15539874;29;32;0.586206896551724;12;17;0.0862068965517241;0.413793103448276
Control.SRR15539874;31;32;0.451612903225806;17;14;0.0483870967741936;0.451612903225806
Control.SRR15539874;27;32;0.444444444444444;15;12;0.0555555555555556;0.444444444444444
Control.SRR15539874;29;32;0.448275862068966;16;13;0.0517241379310345;0.448275862068966
Control.SRR15539874;29;32;0.482758620689655;15;14;0.0172413793103448;0.482758620689655
Control.SRR15539874;29;32;0.482758620689655;15;14;0.0172413793103448;0.482758620689655
Control.SRR15539874;28;32;0.392857142857143;17;11;0.107142857142857;0.392857142857143
Control.SRR15539874;27;32;0.62962962962963;10;17;0.12962962962963;0.37037037037037
Control.SRR15539874;34;32;0.470588235294118;18;16;0.0294117647058824;0.470588235294118
Control.SRR15539874;32;32;0.59375;13;19;0.09375;0.40625
Control.SRR15539874;34;32;0.411764705882353;20;14;0.0882352941176471;0.411764705882353
Control.SRR15539874;29;32;0.448275862068966;16;13;0.0517241379310345;0.448275862068966
Control.SRR15539874;34;32;0.558823529411765;15;19;0.0588235294117647;0.441176470588235
Control.SRR15539874;33;32;0.515151515151515;16;17;0.0151515151515151;0.484848484848485
Control.SRR15539874;31;32;0.451612903225806;17;14;0.0483870967741936;0.451612903225806
Control.SRR15539874;30;32;0.433333333333333;17;13;0.0666666666666667;0.433333333333333
Control.SRR15539874;30;32;0.566666666666667;13;17;0.0666666666666667;0.433333333333333
Control.SRR15539874;28;32;0.5;14;14;0;0.5
Control.SRR15539874;27;32;0.296296296296296;19;8;0.203703703703704;0.296296296296296
Control.SRR15539874;28;32;0.607142857142857;11;17;0.107142857142857;0.392857142857143
Control.SRR15539874;28;32;0.428571428571429;16;12;0.0714285714285715;0.428571428571429
Control.SRR15539874;33;32;0.606060606060606;13;20;0.106060606060606;0.393939393939394
Control.SRR15539874;29;32;0.517241379310345;14;15;0.0172413793103449;0.482758620689655
Control.SRR15539874;33;32;0.545454545454545;15;18;0.0454545454545454;0.454545454545455
Control.SRR15539874;32;32;0.34375;21;11;0.15625;0.34375
Control.SRR15539874;33;32;0.424242424242424;19;14;0.0757575757575757;0.424242424242424
Control.SRR15539874;35;32;0.542857142857143;16;19;0.0428571428571428;0.457142857142857
Control.SRR15539874;28;32;0.5;14;14;0;0.5
Control.SRR15539874;33;32;0.424242424242424;19;14;0.0757575757575757;0.424242424242424
Control.SRR15539874;30;32;0.566666666666667;13;17;0.0666666666666667;0.433333333333333
Control.SRR15539874;28;32;0.357142857142857;18;10;0.142857142857143;0.357142857142857
Control.SRR15539874;28;32;0.535714285714286;13;15;0.0357142857142857;0.464285714285714
Control.SRR15539874;28;32;0.392857142857143;17;11;0.107142857142857;0.392857142857143
Control.SRR15539874;35;32;0.485714285714286;18;17;0.0142857142857143;0.485714285714286
Control.SRR15539874;31;32;0.580645161290323;13;18;0.0806451612903226;0.419354838709677
Control.SRR15539874;31;32;0.258064516129032;23;8;0.241935483870968;0.258064516129032
Control.SRR15539874;34;32;0.558823529411765;15;19;0.0588235294117647;0.441176470588235
Control.SRR15539874;29;32;0.551724137931034;13;16;0.0517241379310345;0.448275862068966
Control.SRR15539874;29;32;0.482758620689655;15;14;0.0172413793103448;0.482758620689655
Control.SRR15539874;29;32;0.379310344827586;18;11;0.120689655172414;0.379310344827586
Control.SRR15539874;28;32;0.428571428571429;16;12;0.0714285714285715;0.428571428571429
Control.SRR15539874;32;32;0.5625;14;18;0.0625;0.4375
Control.SRR15539874;30;32;0.433333333333333;17;13;0.0666666666666667;0.433333333333333
Control.SRR15539874;30;32;0.433333333333333;17;13;0.0666666666666667;0.433333333333333
Control.SRR15539874;29;32;0.482758620689655;15;14;0.0172413793103448;0.482758620689655
Control.SRR15539874;28;32;0.571428571428571;12;16;0.0714285714285714;0.428571428571429
Control.SRR15539874;29;32;0.482758620689655;15;14;0.0172413793103448;0.482758620689655
Control.SRR15539874;34;32;0.411764705882353;20;14;0.0882352941176471;0.411764705882353
Control.SRR15539874;28;32;0.5;14;14;0;0.5
Control.SRR15539874;29;32;0.482758620689655;15;14;0.0172413793103448;0.482758620689655
Control.SRR15539874;29;32;0.517241379310345;14;15;0.0172413793103449;0.482758620689655
Control.SRR15539874;31;32;0.612903225806452;12;19;0.112903225806452;0.387096774193548
Control.SRR15539874;33;32;0.454545454545455;18;15;0.0454545454545455;0.454545454545455
Control.SRR15539874;31;32;0.580645161290323;13;18;0.0806451612903226;0.419354838709677
Control.SRR15539874;29;32;0.517241379310345;14;15;0.0172413793103449;0.482758620689655
Control.SRR15539874;30;32;0.5;15;15;0;0.5
Control.SRR15539874;32;32;0.53125;15;17;0.03125;0.46875
Control.SRR15539874;27;32;0.259259259259259;20;7;0.240740740740741;0.259259259259259
Control.SRR15539874;32;32;0.5625;14;18;0.0625;0.4375
Control.SRR15539874;32;32;0.5;16;16;0;0.5
Control.SRR15539874;32;32;0.65625;11;21;0.15625;0.34375
Control.SRR15539874;27;32;0.555555555555556;12;15;0.0555555555555556;0.444444444444444
Control.SRR15539874;35;32;0.514285714285714;17;18;0.0142857142857142;0.485714285714286
Control.SRR15539874;31;32;0.516129032258065;15;16;0.0161290322580645;0.483870967741935
Control.SRR15539874;31;32;0.516129032258065;15;16;0.0161290322580645;0.483870967741935
Control.SRR15539874;35;32;0.485714285714286;18;17;0.0142857142857143;0.485714285714286
Control.SRR15539874;29;32;0.448275862068966;16;13;0.0517241379310345;0.448275862068966
Control.SRR15539874;30;32;0.333333333333333;20;10;0.166666666666667;0.333333333333333
Control.SRR15539874;34;32;0.441176470588235;19;15;0.0588235294117647;0.441176470588235
Control.SRR15539874;29;32;0.482758620689655;15;14;0.0172413793103448;0.482758620689655
Control.SRR15539874;28;32;0.535714285714286;13;15;0.0357142857142857;0.464285714285714
Control.SRR15539874;27;32;0.62962962962963;10;17;0.12962962962963;0.37037037037037
Control.SRR15539874;30;32;0.4;18;12;0.1;0.4
Control.SRR15539874;29;32;0.448275862068966;16;13;0.0517241379310345;0.448275862068966
Control.SRR15539874;28;32;0.285714285714286;20;8;0.214285714285714;0.285714285714286
Control.SRR15539874;35;32;0.514285714285714;17;18;0.0142857142857142;0.485714285714286
Control.SRR15539874;33;32;0.606060606060606;13;20;0.106060606060606;0.393939393939394
Control.SRR15539874;35;32;0.485714285714286;18;17;0.0142857142857143;0.485714285714286
Control.SRR15539874;29;32;0.551724137931034;13;16;0.0517241379310345;0.448275862068966
Control.SRR15539874;33;32;0.606060606060606;13;20;0.106060606060606;0.393939393939394
Control.SRR15539874;30;32;0.566666666666667;13;17;0.0666666666666667;0.433333333333333
Control.SRR15539874;34;32;0.558823529411765;15;19;0.0588235294117647;0.441176470588235
Control.SRR15539874;29;32;0.655172413793103;10;19;0.155172413793103;0.344827586206897
Control.SRR15539874;32;32;0.4375;18;14;0.0625;0.4375
Control.SRR15539874;28;32;0.714285714285714;8;20;0.214285714285714;0.285714285714286
Control.SRR15539874;31;32;0.548387096774194;14;17;0.0483870967741935;0.451612903225806
Control.SRR15539874;29;32;0.482758620689655;15;14;0.0172413793103448;0.482758620689655
Control.SRR15539874;29;32;0.655172413793103;10;19;0.155172413793103;0.344827586206897
Control.SRR15539874;28;32;0.392857142857143;17;11;0.107142857142857;0.392857142857143
Control.SRR15539874;35;32;0.514285714285714;17;18;0.0142857142857142;0.485714285714286
Control.SRR15539874;29;32;0.310344827586207;20;9;0.189655172413793;0.310344827586207
Control.SRR15539874;30;32;0.533333333333333;14;16;0.0333333333333333;0.466666666666667
Control.SRR15539874;27;32;0.333333333333333;18;9;0.166666666666667;0.333333333333333
Control.SRR15539874;31;32;0.516129032258065;15;16;0.0161290322580645;0.483870967741935
Control.SRR15539874;29;32;0.551724137931034;13;16;0.0517241379310345;0.448275862068966
Control.SRR15539874;35;32;0.485714285714286;18;17;0.0142857142857143;0.485714285714286
Control.SRR15539874;28;32;0.571428571428571;12;16;0.0714285714285714;0.428571428571429
Control.SRR15539874;30;32;0.566666666666667;13;17;0.0666666666666667;0.433333333333333
Control.SRR15539874;32;32;0.59375;13;19;0.09375;0.40625
Control.SRR15539874;30;32;0.333333333333333;20;10;0.166666666666667;0.333333333333333
Control.SRR15539874;29;32;0.448275862068966;16;13;0.0517241379310345;0.448275862068966
Control.SRR15539874;32;32;0.5625;14;18;0.0625;0.4375
Control.SRR15539874;33;32;0.515151515151515;16;17;0.0151515151515151;0.484848484848485
Control.SRR15539874;31;32;0.419354838709677;18;13;0.0806451612903226;0.419354838709677
Control.SRR15539874;32;32;0.4375;18;14;0.0625;0.4375
Control.SRR15539874;29;32;0.413793103448276;17;12;0.0862068965517241;0.413793103448276
Control.SRR15539874;32;32;0.375;20;12;0.125;0.375
Control.SRR15539874;31;32;0.548387096774194;14;17;0.0483870967741935;0.451612903225806
Control.SRR15539874;31;32;0.516129032258065;15;16;0.0161290322580645;0.483870967741935
Control.SRR15539874;34;32;0.764705882352941;8;26;0.264705882352941;0.235294117647059
Control.SRR15539874;29;32;0.517241379310345;14;15;0.0172413793103449;0.482758620689655
Control.SRR15539874;31;32;0.516129032258065;15;16;0.0161290322580645;0.483870967741935
Control.SRR15539874;34;32;0.5;17;17;0;0.5
Control.SRR15539874;34;32;0.647058823529412;12;22;0.147058823529412;0.352941176470588
Control.SRR15539874;31;32;0.419354838709677;18;13;0.0806451612903226;0.419354838709677
Control.SRR15539874;27;32;0.37037037037037;17;10;0.12962962962963;0.37037037037037
Control.SRR15539874;34;32;0.382352941176471;21;13;0.117647058823529;0.382352941176471
Control.SRR15539874;34;32;0.5;17;17;0;0.5
Control.SRR15539874;34;32;0.470588235294118;18;16;0.0294117647058824;0.470588235294118
Control.SRR15539874;30;32;0.466666666666667;16;14;0.0333333333333333;0.466666666666667
Control.SRR15539874;31;32;0.483870967741935;16;15;0.0161290322580645;0.483870967741935
Control.SRR15539874;27;32;0.407407407407407;16;11;0.0925925925925926;0.407407407407407
Control.SRR15539874;27;32;0.444444444444444;15;12;0.0555555555555556;0.444444444444444
Control.SRR15539874;35;32;0.371428571428571;22;13;0.128571428571429;0.371428571428571
Control.SRR15539874;29;32;0.413793103448276;17;12;0.0862068965517241;0.413793103448276
Control.SRR15539874;34;32;0.441176470588235;19;15;0.0588235294117647;0.441176470588235
Control.SRR15539874;29;32;0.655172413793103;10;19;0.155172413793103;0.344827586206897
Control.SRR15539874;29;32;0.379310344827586;18;11;0.120689655172414;0.379310344827586
Control.SRR15539874;31;32;0.516129032258065;15;16;0.0161290322580645;0.483870967741935
Control.SRR15539874;34;32;0.529411764705882;16;18;0.0294117647058824;0.470588235294118
Control.SRR15539874;31;32;0.483870967741935;16;15;0.0161290322580645;0.483870967741935
Control.SRR15539874;34;32;0.411764705882353;20;14;0.0882352941176471;0.411764705882353
Control.SRR15539874;29;32;0.517241379310345;14;15;0.0172413793103449;0.482758620689655
Control.SRR15539874;28;32;0.571428571428571;12;16;0.0714285714285714;0.428571428571429
Control.SRR15539874;34;32;0.470588235294118;18;16;0.0294117647058824;0.470588235294118
Control.SRR15539874;34;32;0.352941176470588;22;12;0.147058823529412;0.352941176470588
Control.SRR15539874;29;32;0.448275862068966;16;13;0.0517241379310345;0.448275862068966
Control.SRR15539874;31;32;0.548387096774194;14;17;0.0483870967741935;0.451612903225806
Control.SRR15539874;32;32;0.59375;13;19;0.09375;0.40625
Control.SRR15539874;32;32;0.53125;15;17;0.03125;0.46875
Control.SRR15539874;35;32;0.457142857142857;19;16;0.0428571428571429;0.457142857142857
Control.SRR15539874;35;32;0.571428571428571;15;20;0.0714285714285714;0.428571428571429
Control.SRR15539874;32;32;0.5;16;16;0;0.5
Control.SRR15539874;29;32;0.482758620689655;15;14;0.0172413793103448;0.482758620689655
Control.SRR15539874;27;32;0.407407407407407;16;11;0.0925925925925926;0.407407407407407
Control.SRR15539874;28;32;0.428571428571429;16;12;0.0714285714285715;0.428571428571429
Control.SRR15539874;33;32;0.515151515151515;16;17;0.0151515151515151;0.484848484848485
Control.SRR15539874;28;32;0.5;14;14;0;0.5
Control.SRR15539874;29;32;0.482758620689655;15;14;0.0172413793103448;0.482758620689655
Control.SRR15539874;33;32;0.666666666666667;11;22;0.166666666666667;0.333333333333333
Control.SRR15539874;29;32;0.448275862068966;16;13;0.0517241379310345;0.448275862068966
Control.SRR15539874;32;32;0.53125;15;17;0.03125;0.46875
Control.SRR15539874;29;32;0.413793103448276;17;12;0.0862068965517241;0.413793103448276
Control.SRR15539874;30;32;0.466666666666667;16;14;0.0333333333333333;0.466666666666667
Control.SRR15539874;30;32;0.466666666666667;16;14;0.0333333333333333;0.466666666666667
Control.SRR15539874;35;32;0.428571428571429;20;15;0.0714285714285715;0.428571428571429
Control.SRR15539874;33;32;0.363636363636364;21;12;0.136363636363636;0.363636363636364
Control.SRR15539874;31;32;0.419354838709677;18;13;0.0806451612903226;0.419354838709677
Control.SRR15539874;31;32;0.451612903225806;17;14;0.0483870967741936;0.451612903225806
Control.SRR15539874;31;32;0.580645161290323;13;18;0.0806451612903226;0.419354838709677
Control.SRR15539874;35;32;0.514285714285714;17;18;0.0142857142857142;0.485714285714286
Control.SRR15539874;35;32;0.457142857142857;19;16;0.0428571428571429;0.457142857142857
Control.SRR15539874;35;32;0.4;21;14;0.1;0.4
Control.SRR15539874;29;32;0.586206896551724;12;17;0.0862068965517241;0.413793103448276
Control.SRR15539874;28;32;0.535714285714286;13;15;0.0357142857142857;0.464285714285714
Control.SRR15539874;28;32;0.535714285714286;13;15;0.0357142857142857;0.464285714285714
Control.SRR15539874;32;32;0.53125;15;17;0.03125;0.46875
Control.SRR15539874;35;32;0.457142857142857;19;16;0.0428571428571429;0.457142857142857
Control.SRR15539874;30;32;0.566666666666667;13;17;0.0666666666666667;0.433333333333333
Control.SRR15539874;34;32;0.5;17;17;0;0.5
Control.SRR15539874;31;32;0.387096774193548;19;12;0.112903225806452;0.387096774193548
Control.SRR15539874;31;32;0.387096774193548;19;12;0.112903225806452;0.387096774193548
Control.SRR15539874;31;32;0.548387096774194;14;17;0.0483870967741935;0.451612903225806
Control.SRR15539874;30;32;0.633333333333333;11;19;0.133333333333333;0.366666666666667
Control.SRR15539874;31;32;0.580645161290323;13;18;0.0806451612903226;0.419354838709677
Control.SRR15539874;27;32;0.740740740740741;7;20;0.240740740740741;0.259259259259259
Control.SRR15539874;28;32;0.535714285714286;13;15;0.0357142857142857;0.464285714285714
Control.SRR15539874;33;32;0.545454545454545;15;18;0.0454545454545454;0.454545454545455
Control.SRR15539874;31;32;0.548387096774194;14;17;0.0483870967741935;0.451612903225806
Control.SRR15539874;30;32;0.466666666666667;16;14;0.0333333333333333;0.466666666666667
Control.SRR15539874;30;32;0.433333333333333;17;13;0.0666666666666667;0.433333333333333
Control.SRR15539874;30;32;0.333333333333333;20;10;0.166666666666667;0.333333333333333
Control.SRR15539874;34;32;0.647058823529412;12;22;0.147058823529412;0.352941176470588
Control.SRR15539874;28;32;0.464285714285714;15;13;0.0357142857142857;0.464285714285714
Control.SRR15539874;27;32;0.555555555555556;12;15;0.0555555555555556;0.444444444444444
Control.SRR15539874;28;32;0.5;14;14;0;0.5
Control.SRR15539874;27;32;0.518518518518518;13;14;0.0185185185185185;0.481481481481481
Control.SRR15539874;29;32;0.551724137931034;13;16;0.0517241379310345;0.448275862068966
Control.SRR15539874;28;32;0.678571428571429;9;19;0.178571428571429;0.321428571428571
Control.SRR15539874;33;32;0.484848484848485;17;16;0.0151515151515151;0.484848484848485
Control.SRR15539874;35;32;0.4;21;14;0.1;0.4
Control.SRR15539874;33;32;0.454545454545455;18;15;0.0454545454545455;0.454545454545455
Control.SRR15539874;30;32;0.466666666666667;16;14;0.0333333333333333;0.466666666666667
Control.SRR15539874;30;32;0.566666666666667;13;17;0.0666666666666667;0.433333333333333
Control.SRR15539874;27;32;0.481481481481481;14;13;0.0185185185185185;0.481481481481481
Control.SRR15539874;30;32;0.366666666666667;19;11;0.133333333333333;0.366666666666667
Control.SRR15539874;33;32;0.333333333333333;22;11;0.166666666666667;0.333333333333333
Control.SRR15539874;28;32;0.428571428571429;16;12;0.0714285714285715;0.428571428571429
Control.SRR15539874;32;32;0.46875;17;15;0.03125;0.46875
Control.SRR15539874;29;32;0.448275862068966;16;13;0.0517241379310345;0.448275862068966
Control.SRR15539874;33;32;0.575757575757576;14;19;0.0757575757575758;0.424242424242424
Control.SRR15539874;35;32;0.485714285714286;18;17;0.0142857142857143;0.485714285714286
Control.SRR15539874;35;32;0.685714285714286;11;24;0.185714285714286;0.314285714285714
Control.SRR15539874;35;32;0.457142857142857;19;16;0.0428571428571429;0.457142857142857
Control.SRR15539874;33;32;0.545454545454545;15;18;0.0454545454545454;0.454545454545455
Control.SRR15539874;35;32;0.514285714285714;17;18;0.0142857142857142;0.485714285714286
Control.SRR15539874;30;32;0.666666666666667;10;20;0.166666666666667;0.333333333333333
Control.SRR15539874;30;32;0.466666666666667;16;14;0.0333333333333333;0.466666666666667
Control.SRR15539874;33;32;0.545454545454545;15;18;0.0454545454545454;0.454545454545455
Control.SRR15539874;32;32;0.625;12;20;0.125;0.375
Control.SRR15539874;30;32;0.633333333333333;11;19;0.133333333333333;0.366666666666667
Control.SRR15539874;33;32;0.424242424242424;19;14;0.0757575757575757;0.424242424242424
Control.SRR15539874;28;32;0.607142857142857;11;17;0.107142857142857;0.392857142857143
Control.SRR15539874;29;32;0.482758620689655;15;14;0.0172413793103448;0.482758620689655
Control.SRR15539874;33;32;0.545454545454545;15;18;0.0454545454545454;0.454545454545455
Control.SRR15539874;33;32;0.545454545454545;15;18;0.0454545454545454;0.454545454545455
Control.SRR15539874;33;32;0.545454545454545;15;18;0.0454545454545454;0.454545454545455
Control.SRR15539874;34;32;0.588235294117647;14;20;0.0882352941176471;0.411764705882353
Control.SRR15539874;35;32;0.571428571428571;15;20;0.0714285714285714;0.428571428571429
Control.SRR15539874;33;32;0.484848484848485;17;16;0.0151515151515151;0.484848484848485
Control.SRR15539874;34;32;0.5;17;17;0;0.5
Control.SRR15539874;28;32;0.571428571428571;12;16;0.0714285714285714;0.428571428571429
Control.SRR15539874;34;32;0.558823529411765;15;19;0.0588235294117647;0.441176470588235
Control.SRR15539874;31;32;0.451612903225806;17;14;0.0483870967741936;0.451612903225806
Control.SRR15539874;33;32;0.606060606060606;13;20;0.106060606060606;0.393939393939394
Control.SRR15539874;27;32;0.481481481481481;14;13;0.0185185185185185;0.481481481481481
Control.SRR15539874;29;32;0.275862068965517;21;8;0.224137931034483;0.275862068965517
Control.SRR15539874;30;32;0.533333333333333;14;16;0.0333333333333333;0.466666666666667
Control.SRR15539874;27;32;0.481481481481481;14;13;0.0185185185185185;0.481481481481481
Control.SRR15539874;32;32;0.5625;14;18;0.0625;0.4375
Control.SRR15539874;33;32;0.515151515151515;16;17;0.0151515151515151;0.484848484848485
Control.SRR15539874;31;32;0.516129032258065;15;16;0.0161290322580645;0.483870967741935
Control.SRR15539874;31;32;0.548387096774194;14;17;0.0483870967741935;0.451612903225806
Control.SRR15539874;34;32;0.558823529411765;15;19;0.0588235294117647;0.441176470588235
Control.SRR15539874;32;32;0.46875;17;15;0.03125;0.46875
Control.SRR15539874;28;32;0.678571428571429;9;19;0.178571428571429;0.321428571428571
Control.SRR15539874;31;32;0.483870967741935;16;15;0.0161290322580645;0.483870967741935
Control.SRR15539874;29;32;0.344827586206897;19;10;0.155172413793103;0.344827586206897
Control.SRR15539874;32;32;0.3125;22;10;0.1875;0.3125
Control.SRR15539874;34;32;0.441176470588235;19;15;0.0588235294117647;0.441176470588235
Control.SRR15539874;31;32;0.419354838709677;18;13;0.0806451612903226;0.419354838709677
Control.SRR15539874;35;32;0.485714285714286;18;17;0.0142857142857143;0.485714285714286
Control.SRR15539874;33;32;0.606060606060606;13;20;0.106060606060606;0.393939393939394
Control.SRR15539874;30;32;0.5;15;15;0;0.5
Control.SRR15539874;30;32;0.433333333333333;17;13;0.0666666666666667;0.433333333333333
Control.SRR15539874;30;32;0.466666666666667;16;14;0.0333333333333333;0.466666666666667
Control.SRR15539874;29;32;0.586206896551724;12;17;0.0862068965517241;0.413793103448276
Control.SRR15539874;32;32;0.46875;17;15;0.03125;0.46875
Control.SRR15539874;30;32;0.433333333333333;17;13;0.0666666666666667;0.433333333333333
Control.SRR15539874;30;32;0.5;15;15;0;0.5
Control.SRR15539874;34;32;0.5;17;17;0;0.5
Control.SRR15539874;30;32;0.5;15;15;0;0.5
Control.SRR15539874;35;32;0.514285714285714;17;18;0.0142857142857142;0.485714285714286
Control.SRR15539874;35;32;0.571428571428571;15;20;0.0714285714285714;0.428571428571429
Control.SRR15539874;31;32;0.290322580645161;22;9;0.209677419354839;0.290322580645161
Control.SRR15539874;33;32;0.515151515151515;16;17;0.0151515151515151;0.484848484848485
Control.SRR15539874;30;32;0.566666666666667;13;17;0.0666666666666667;0.433333333333333
Control.SRR15539874;28;32;0.535714285714286;13;15;0.0357142857142857;0.464285714285714
Control.SRR15539874;33;32;0.757575757575758;8;25;0.257575757575758;0.242424242424242
Control.SRR15539874;28;32;0.392857142857143;17;11;0.107142857142857;0.392857142857143
Control.SRR15539874;35;32;0.4;21;14;0.1;0.4
Control.SRR15539874;29;32;0.517241379310345;14;15;0.0172413793103449;0.482758620689655
Control.SRR15539874;34;32;0.529411764705882;16;18;0.0294117647058824;0.470588235294118
Control.SRR15539874;34;32;0.470588235294118;18;16;0.0294117647058824;0.470588235294118
Control.SRR15539874;31;32;0.451612903225806;17;14;0.0483870967741936;0.451612903225806
Control.SRR15539874;30;32;0.533333333333333;14;16;0.0333333333333333;0.466666666666667
Control.SRR15539874;33;32;0.393939393939394;20;13;0.106060606060606;0.393939393939394
Control.SRR15539874;35;32;0.485714285714286;18;17;0.0142857142857143;0.485714285714286
Control.SRR15539874;34;32;0.411764705882353;20;14;0.0882352941176471;0.411764705882353
Control.SRR15539874;35;32;0.457142857142857;19;16;0.0428571428571429;0.457142857142857
Control.SRR15539874;32;32;0.59375;13;19;0.09375;0.40625
Control.SRR15539874;34;32;0.558823529411765;15;19;0.0588235294117647;0.441176470588235
Control.SRR15539874;33;32;0.515151515151515;16;17;0.0151515151515151;0.484848484848485
Control.SRR15539874;32;32;0.5625;14;18;0.0625;0.4375
Control.SRR15539874;30;32;0.566666666666667;13;17;0.0666666666666667;0.433333333333333
Control.SRR15539874;28;32;0.464285714285714;15;13;0.0357142857142857;0.464285714285714
Control.SRR15539874;27;32;0.444444444444444;15;12;0.0555555555555556;0.444444444444444
Control.SRR15539874;27;32;0.555555555555556;12;15;0.0555555555555556;0.444444444444444
Control.SRR15539874;27;32;0.444444444444444;15;12;0.0555555555555556;0.444444444444444
Control.SRR15539874;33;32;0.484848484848485;17;16;0.0151515151515151;0.484848484848485
Control.SRR15539874;35;32;0.457142857142857;19;16;0.0428571428571429;0.457142857142857
Control.SRR15539874;35;32;0.4;21;14;0.1;0.4
Control.SRR15539874;31;32;0.709677419354839;9;22;0.209677419354839;0.290322580645161
Control.SRR15539874;33;32;0.454545454545455;18;15;0.0454545454545455;0.454545454545455
Control.SRR15539874;35;32;0.485714285714286;18;17;0.0142857142857143;0.485714285714286
Control.SRR15539874;29;32;0.517241379310345;14;15;0.0172413793103449;0.482758620689655
Control.SRR15539874;34;32;0.382352941176471;21;13;0.117647058823529;0.382352941176471
Control.SRR15539874;32;32;0.59375;13;19;0.09375;0.40625
Control.SRR15539874;28;32;0.428571428571429;16;12;0.0714285714285715;0.428571428571429
Control.SRR15539874;27;32;0.592592592592593;11;16;0.0925925925925926;0.407407407407407
Control.SRR15539874;30;32;0.533333333333333;14;16;0.0333333333333333;0.466666666666667
Control.SRR15539874;34;32;0.352941176470588;22;12;0.147058823529412;0.352941176470588
Control.SRR15539874;35;32;0.342857142857143;23;12;0.157142857142857;0.342857142857143
Control.SRR15539874;33;32;0.545454545454545;15;18;0.0454545454545454;0.454545454545455
Control.SRR15539874;33;32;0.636363636363636;12;21;0.136363636363636;0.363636363636364
Control.SRR15539874;34;32;0.558823529411765;15;19;0.0588235294117647;0.441176470588235
Control.SRR15539874;31;32;0.516129032258065;15;16;0.0161290322580645;0.483870967741935
Control.SRR15539874;34;32;0.470588235294118;18;16;0.0294117647058824;0.470588235294118
Control.SRR15539874;34;32;0.411764705882353;20;14;0.0882352941176471;0.411764705882353
Control.SRR15539874;35;32;0.428571428571429;20;15;0.0714285714285715;0.428571428571429
Control.SRR15539874;32;32;0.4375;18;14;0.0625;0.4375
Control.SRR15539874;31;32;0.451612903225806;17;14;0.0483870967741936;0.451612903225806
Control.SRR15539874;27;32;0.555555555555556;12;15;0.0555555555555556;0.444444444444444
Control.SRR15539874;27;32;0.518518518518518;13;14;0.0185185185185185;0.481481481481481
Control.SRR15539874;35;32;0.485714285714286;18;17;0.0142857142857143;0.485714285714286
Control.SRR15539874;35;32;0.571428571428571;15;20;0.0714285714285714;0.428571428571429
Control.SRR15539874;35;32;0.542857142857143;16;19;0.0428571428571428;0.457142857142857
Control.SRR15539874;29;32;0.517241379310345;14;15;0.0172413793103449;0.482758620689655
Control.SRR15539874;32;32;0.4375;18;14;0.0625;0.4375
Control.SRR15539874;32;32;0.5625;14;18;0.0625;0.4375
Control.SRR15539874;32;32;0.34375;21;11;0.15625;0.34375
Control.SRR15539874;28;32;0.428571428571429;16;12;0.0714285714285715;0.428571428571429
Control.SRR15539874;32;32;0.5;16;16;0;0.5
Control.SRR15539874;27;32;0.592592592592593;11;16;0.0925925925925926;0.407407407407407
Control.SRR15539874;33;32;0.393939393939394;20;13;0.106060606060606;0.393939393939394
Control.SRR15539874;35;32;0.571428571428571;15;20;0.0714285714285714;0.428571428571429
Control.SRR15539874;34;32;0.470588235294118;18;16;0.0294117647058824;0.470588235294118
Control.SRR15539874;33;32;0.575757575757576;14;19;0.0757575757575758;0.424242424242424
Control.SRR15539874;32;32;0.34375;21;11;0.15625;0.34375
Control.SRR15539874;30;32;0.3;21;9;0.2;0.3
Control.SRR15539874;30;32;0.533333333333333;14;16;0.0333333333333333;0.466666666666667
Control.SRR15539874;34;32;0.382352941176471;21;13;0.117647058823529;0.382352941176471
Control.SRR15539874;34;32;0.705882352941177;10;24;0.205882352941177;0.294117647058824
Control.SRR15539874;34;32;0.441176470588235;19;15;0.0588235294117647;0.441176470588235
Control.SRR15539874;35;32;0.628571428571429;13;22;0.128571428571429;0.371428571428571
Control.SRR15539874;31;32;0.612903225806452;12;19;0.112903225806452;0.387096774193548
Control.SRR15539874;31;32;0.483870967741935;16;15;0.0161290322580645;0.483870967741935
Control.SRR15539874;29;32;0.413793103448276;17;12;0.0862068965517241;0.413793103448276
Control.SRR15539874;33;32;0.515151515151515;16;17;0.0151515151515151;0.484848484848485
Control.SRR15539874;32;32;0.5625;14;18;0.0625;0.4375
Control.SRR15539874;35;32;0.485714285714286;18;17;0.0142857142857143;0.485714285714286
Control.SRR15539874;31;32;0.548387096774194;14;17;0.0483870967741935;0.451612903225806
Control.SRR15539874;27;32;0.333333333333333;18;9;0.166666666666667;0.333333333333333
Control.SRR15539874;32;32;0.53125;15;17;0.03125;0.46875
Control.SRR15539874;30;32;0.366666666666667;19;11;0.133333333333333;0.366666666666667
Control.SRR15539874;28;32;0.464285714285714;15;13;0.0357142857142857;0.464285714285714
Control.SRR15539874;33;32;0.333333333333333;22;11;0.166666666666667;0.333333333333333
Control.SRR15539874;34;32;0.441176470588235;19;15;0.0588235294117647;0.441176470588235
Control.SRR15539874;33;32;0.575757575757576;14;19;0.0757575757575758;0.424242424242424
Control.SRR15539874;32;32;0.46875;17;15;0.03125;0.46875
Control.SRR15539874;28;32;0.607142857142857;11;17;0.107142857142857;0.392857142857143
Control.SRR15539874;32;32;0.59375;13;19;0.09375;0.40625
Control.SRR15539874;30;32;0.5;15;15;0;0.5
Control.SRR15539874;30;32;0.433333333333333;17;13;0.0666666666666667;0.433333333333333
Control.SRR15539874;32;32;0.4375;18;14;0.0625;0.4375
Control.SRR15539874;32;32;0.625;12;20;0.125;0.375
Control.SRR15539874;29;32;0.482758620689655;15;14;0.0172413793103448;0.482758620689655
Control.SRR15539874;34;32;0.441176470588235;19;15;0.0588235294117647;0.441176470588235
Control.SRR15539874;30;32;0.566666666666667;13;17;0.0666666666666667;0.433333333333333
Control.SRR15539874;29;32;0.448275862068966;16;13;0.0517241379310345;0.448275862068966
Control.SRR15539874;28;32;0.464285714285714;15;13;0.0357142857142857;0.464285714285714
Control.SRR15539874;27;32;0.555555555555556;12;15;0.0555555555555556;0.444444444444444
Control.SRR15539874;35;32;0.428571428571429;20;15;0.0714285714285715;0.428571428571429
Control.SRR15539874;34;32;0.411764705882353;20;14;0.0882352941176471;0.411764705882353
Control.SRR15539874;28;32;0.464285714285714;15;13;0.0357142857142857;0.464285714285714
Control.SRR15539874;28;32;0.357142857142857;18;10;0.142857142857143;0.357142857142857
Control.SRR15539874;33;32;0.393939393939394;20;13;0.106060606060606;0.393939393939394
Control.SRR15539874;28;32;0.678571428571429;9;19;0.178571428571429;0.321428571428571
Control.SRR15539874;29;32;0.689655172413793;9;20;0.189655172413793;0.310344827586207
Control.SRR15539874;30;32;0.633333333333333;11;19;0.133333333333333;0.366666666666667
Control.SRR15539874;27;32;0.444444444444444;15;12;0.0555555555555556;0.444444444444444
Control.SRR15539874;29;32;0.482758620689655;15;14;0.0172413793103448;0.482758620689655
Control.SRR15539874;27;32;0.666666666666667;9;18;0.166666666666667;0.333333333333333
Control.SRR15539874;27;32;0.481481481481481;14;13;0.0185185185185185;0.481481481481481
Control.SRR15539874;28;32;0.607142857142857;11;17;0.107142857142857;0.392857142857143
Control.SRR15539874;29;32;0.379310344827586;18;11;0.120689655172414;0.379310344827586
Control.SRR15539874;31;32;0.419354838709677;18;13;0.0806451612903226;0.419354838709677
Control.SRR15539874;35;32;0.428571428571429;20;15;0.0714285714285715;0.428571428571429
Control.SRR15539874;34;32;0.617647058823529;13;21;0.117647058823529;0.382352941176471
Control.SRR15539874;34;32;0.5;17;17;0;0.5
Control.SRR15539874;29;32;0.448275862068966;16;13;0.0517241379310345;0.448275862068966
Control.SRR15539874;28;32;0.571428571428571;12;16;0.0714285714285714;0.428571428571429
Control.SRR15539874;30;32;0.633333333333333;11;19;0.133333333333333;0.366666666666667
Control.SRR15539874;35;32;0.428571428571429;20;15;0.0714285714285715;0.428571428571429
Control.SRR15539874;30;32;0.4;18;12;0.1;0.4
Control.SRR15539874;30;32;0.566666666666667;13;17;0.0666666666666667;0.433333333333333
Control.SRR15539874;32;32;0.5;16;16;0;0.5
Control.SRR15539874;33;32;0.363636363636364;21;12;0.136363636363636;0.363636363636364
Control.SRR15539874;31;32;0.451612903225806;17;14;0.0483870967741936;0.451612903225806
Control.SRR15539874;30;32;0.233333333333333;23;7;0.266666666666667;0.233333333333333
Control.SRR15539874;29;32;0.517241379310345;14;15;0.0172413793103449;0.482758620689655
Control.SRR15539874;30;32;0.533333333333333;14;16;0.0333333333333333;0.466666666666667
Control.SRR15539874;33;32;0.606060606060606;13;20;0.106060606060606;0.393939393939394
Control.SRR15539874;34;32;0.470588235294118;18;16;0.0294117647058824;0.470588235294118
Control.SRR15539874;35;32;0.514285714285714;17;18;0.0142857142857142;0.485714285714286
Control.SRR15539874;31;32;0.612903225806452;12;19;0.112903225806452;0.387096774193548
Control.SRR15539874;30;32;0.566666666666667;13;17;0.0666666666666667;0.433333333333333
Control.SRR15539874;29;32;0.413793103448276;17;12;0.0862068965517241;0.413793103448276
Control.SRR15539874;27;32;0.407407407407407;16;11;0.0925925925925926;0.407407407407407
Control.SRR15539874;35;32;0.6;14;21;0.1;0.4
Control.SRR15539874;32;32;0.65625;11;21;0.15625;0.34375
Control.SRR15539874;28;32;0.464285714285714;15;13;0.0357142857142857;0.464285714285714
Control.SRR15539874;28;32;0.5;14;14;0;0.5
Control.SRR15539874;28;32;0.607142857142857;11;17;0.107142857142857;0.392857142857143
Control.SRR15539874;28;32;0.5;14;14;0;0.5
Control.SRR15539874;30;32;0.4;18;12;0.1;0.4
Control.SRR15539874;32;32;0.46875;17;15;0.03125;0.46875
Control.SRR15539874;30;32;0.3;21;9;0.2;0.3
Control.SRR15539874;34;32;0.323529411764706;23;11;0.176470588235294;0.323529411764706
Control.SRR15539874;30;32;0.4;18;12;0.1;0.4
Control.SRR15539874;34;32;0.411764705882353;20;14;0.0882352941176471;0.411764705882353
Control.SRR15539874;33;32;0.424242424242424;19;14;0.0757575757575757;0.424242424242424
Control.SRR15539874;33;32;0.303030303030303;23;10;0.196969696969697;0.303030303030303
Control.SRR15539874;33;32;0.303030303030303;23;10;0.196969696969697;0.303030303030303
Control.SRR15539874;29;32;0.586206896551724;12;17;0.0862068965517241;0.413793103448276
Control.SRR15539874;30;32;0.466666666666667;16;14;0.0333333333333333;0.466666666666667
Control.SRR15539874;33;32;0.363636363636364;21;12;0.136363636363636;0.363636363636364
Control.SRR15539874;35;32;0.342857142857143;23;12;0.157142857142857;0.342857142857143
Control.SRR15539874;30;32;0.5;15;15;0;0.5
Control.SRR15539874;34;32;0.382352941176471;21;13;0.117647058823529;0.382352941176471
Control.SRR15539874;28;32;0.428571428571429;16;12;0.0714285714285715;0.428571428571429
Control.SRR15539874;35;32;0.542857142857143;16;19;0.0428571428571428;0.457142857142857
Control.SRR15539874;29;32;0.344827586206897;19;10;0.155172413793103;0.344827586206897
Control.SRR15539874;27;32;0.518518518518518;13;14;0.0185185185185185;0.481481481481481
Control.SRR15539874;34;32;0.617647058823529;13;21;0.117647058823529;0.382352941176471
Control.SRR15539874;30;32;0.433333333333333;17;13;0.0666666666666667;0.433333333333333
Control.SRR15539874;27;32;0.37037037037037;17;10;0.12962962962963;0.37037037037037
Control.SRR15539874;30;32;0.5;15;15;0;0.5
Control.SRR15539874;33;32;0.454545454545455;18;15;0.0454545454545455;0.454545454545455
Control.SRR15539874;32;32;0.40625;19;13;0.09375;0.40625
Control.SRR15539874;30;32;0.566666666666667;13;17;0.0666666666666667;0.433333333333333
Control.SRR15539874;35;32;0.485714285714286;18;17;0.0142857142857143;0.485714285714286
Control.SRR15539874;34;32;0.411764705882353;20;14;0.0882352941176471;0.411764705882353
Control.SRR15539874;32;32;0.46875;17;15;0.03125;0.46875
Control.SRR15539874;31;32;0.483870967741935;16;15;0.0161290322580645;0.483870967741935
Control.SRR15539874;32;32;0.46875;17;15;0.03125;0.46875
Control.SRR15539874;31;32;0.612903225806452;12;19;0.112903225806452;0.387096774193548
Control.SRR15539874;28;32;0.642857142857143;10;18;0.142857142857143;0.357142857142857
Control.SRR15539874;32;32;0.40625;19;13;0.09375;0.40625
Control.SRR15539874;32;32;0.5;16;16;0;0.5
Control.SRR15539874;30;32;0.566666666666667;13;17;0.0666666666666667;0.433333333333333
Control.SRR15539874;34;32;0.470588235294118;18;16;0.0294117647058824;0.470588235294118
Control.SRR15539874;30;32;0.466666666666667;16;14;0.0333333333333333;0.466666666666667
Control.SRR15539874;33;32;0.757575757575758;8;25;0.257575757575758;0.242424242424242
Control.SRR15539874;32;32;0.53125;15;17;0.03125;0.46875
Control.SRR15539874;32;32;0.375;20;12;0.125;0.375
Control.SRR15539874;33;32;0.484848484848485;17;16;0.0151515151515151;0.484848484848485
Control.SRR15539874;27;32;0.296296296296296;19;8;0.203703703703704;0.296296296296296
Control.SRR15539874;27;32;0.518518518518518;13;14;0.0185185185185185;0.481481481481481
Control.SRR15539874;35;32;0.428571428571429;20;15;0.0714285714285715;0.428571428571429
Control.SRR15539874;34;32;0.411764705882353;20;14;0.0882352941176471;0.411764705882353
Control.SRR15539874;31;32;0.516129032258065;15;16;0.0161290322580645;0.483870967741935
Control.SRR15539874;29;32;0.482758620689655;15;14;0.0172413793103448;0.482758620689655
Control.SRR15539874;33;32;0.515151515151515;16;17;0.0151515151515151;0.484848484848485
Control.SRR15539874;33;32;0.484848484848485;17;16;0.0151515151515151;0.484848484848485
Control.SRR15539874;32;32;0.4375;18;14;0.0625;0.4375
Control.SRR15539874;30;32;0.566666666666667;13;17;0.0666666666666667;0.433333333333333
Control.SRR15539874;34;32;0.441176470588235;19;15;0.0588235294117647;0.441176470588235
Control.SRR15539874;35;32;0.457142857142857;19;16;0.0428571428571429;0.457142857142857
Control.SRR15539874;35;32;0.628571428571429;13;22;0.128571428571429;0.371428571428571
Control.SRR15539874;35;32;0.457142857142857;19;16;0.0428571428571429;0.457142857142857
Control.SRR15539874;33;32;0.545454545454545;15;18;0.0454545454545454;0.454545454545455
Control.SRR15539874;32;32;0.4375;18;14;0.0625;0.4375
Control.SRR15539874;34;32;0.470588235294118;18;16;0.0294117647058824;0.470588235294118
Control.SRR15539874;32;32;0.53125;15;17;0.03125;0.46875
Control.SRR15539874;34;32;0.470588235294118;18;16;0.0294117647058824;0.470588235294118
Control.SRR15539874;32;32;0.5;16;16;0;0.5
Control.SRR15539874;28;32;0.464285714285714;15;13;0.0357142857142857;0.464285714285714
Control.SRR15539874;33;32;0.454545454545455;18;15;0.0454545454545455;0.454545454545455
Control.SRR15539874;33;32;0.545454545454545;15;18;0.0454545454545454;0.454545454545455
Control.SRR15539874;30;32;0.433333333333333;17;13;0.0666666666666667;0.433333333333333
Control.SRR15539874;33;32;0.606060606060606;13;20;0.106060606060606;0.393939393939394
Control.SRR15539874;28;32;0.571428571428571;12;16;0.0714285714285714;0.428571428571429
Control.SRR15539874;30;32;0.5;15;15;0;0.5
Control.SRR15539874;28;32;0.357142857142857;18;10;0.142857142857143;0.357142857142857
Control.SRR15539874;34;32;0.5;17;17;0;0.5
Control.SRR15539874;34;32;0.705882352941177;10;24;0.205882352941177;0.294117647058824
Control.SRR15539874;34;32;0.529411764705882;16;18;0.0294117647058824;0.470588235294118
Control.SRR15539874;35;32;0.485714285714286;18;17;0.0142857142857143;0.485714285714286
Control.SRR15539874;30;32;0.666666666666667;10;20;0.166666666666667;0.333333333333333
Control.SRR15539874;29;32;0.586206896551724;12;17;0.0862068965517241;0.413793103448276
Control.SRR15539874;30;32;0.466666666666667;16;14;0.0333333333333333;0.466666666666667
Control.SRR15539874;28;32;0.428571428571429;16;12;0.0714285714285715;0.428571428571429
Control.SRR15539874;31;32;0.516129032258065;15;16;0.0161290322580645;0.483870967741935
Control.SRR15539874;33;32;0.484848484848485;17;16;0.0151515151515151;0.484848484848485
Control.SRR15539874;33;32;0.545454545454545;15;18;0.0454545454545454;0.454545454545455
Control.SRR15539874;34;32;0.558823529411765;15;19;0.0588235294117647;0.441176470588235
Control.SRR15539874;32;32;0.5625;14;18;0.0625;0.4375
Control.SRR15539874;32;32;0.375;20;12;0.125;0.375
Control.SRR15539874;31;32;0.516129032258065;15;16;0.0161290322580645;0.483870967741935
Control.SRR15539874;33;32;0.424242424242424;19;14;0.0757575757575757;0.424242424242424
Control.SRR15539874;29;32;0.310344827586207;20;9;0.189655172413793;0.310344827586207
Control.SRR15539874;33;32;0.363636363636364;21;12;0.136363636363636;0.363636363636364
Control.SRR15539874;33;32;0.363636363636364;21;12;0.136363636363636;0.363636363636364
Control.SRR15539874;30;32;0.4;18;12;0.1;0.4
Control.SRR15539874;27;32;0.518518518518518;13;14;0.0185185185185185;0.481481481481481
Control.SRR15539874;29;32;0.310344827586207;20;9;0.189655172413793;0.310344827586207
Control.SRR15539874;30;32;0.4;18;12;0.1;0.4
Control.SRR15539874;29;32;0.448275862068966;16;13;0.0517241379310345;0.448275862068966
Control.SRR15539874;31;32;0.516129032258065;15;16;0.0161290322580645;0.483870967741935
Control.SRR15539874;35;32;0.371428571428571;22;13;0.128571428571429;0.371428571428571
Control.SRR15539874;33;32;0.757575757575758;8;25;0.257575757575758;0.242424242424242
Control.SRR15539874;32;32;0.4375;18;14;0.0625;0.4375
Control.SRR15539874;27;32;0.296296296296296;19;8;0.203703703703704;0.296296296296296
Control.SRR15539874;34;32;0.676470588235294;11;23;0.176470588235294;0.323529411764706
Control.SRR15539874;28;32;0.25;21;7;0.25;0.25
Control.SRR15539874;34;32;0.588235294117647;14;20;0.0882352941176471;0.411764705882353
Control.SRR15539874;31;32;0.67741935483871;10;21;0.17741935483871;0.32258064516129
Control.SRR15539874;31;32;0.612903225806452;12;19;0.112903225806452;0.387096774193548
Control.SRR15539874;32;32;0.5;16;16;0;0.5
Control.SRR15539874;35;32;0.485714285714286;18;17;0.0142857142857143;0.485714285714286
Control.SRR15539874;33;32;0.545454545454545;15;18;0.0454545454545454;0.454545454545455
Control.SRR15539874;34;32;0.676470588235294;11;23;0.176470588235294;0.323529411764706
Control.SRR15539874;27;32;0.481481481481481;14;13;0.0185185185185185;0.481481481481481
Control.SRR15539874;27;32;0.592592592592593;11;16;0.0925925925925926;0.407407407407407
Control.SRR15539874;28;32;0.5;14;14;0;0.5
Control.SRR15539874;34;32;0.411764705882353;20;14;0.0882352941176471;0.411764705882353
Control.SRR15539874;34;32;0.676470588235294;11;23;0.176470588235294;0.323529411764706
Control.SRR15539874;28;32;0.464285714285714;15;13;0.0357142857142857;0.464285714285714
Control.SRR15539874;32;32;0.5625;14;18;0.0625;0.4375
Control.SRR15539874;31;32;0.290322580645161;22;9;0.209677419354839;0.290322580645161
Control.SRR15539874;32;32;0.46875;17;15;0.03125;0.46875
Control.SRR15539874;30;32;0.433333333333333;17;13;0.0666666666666667;0.433333333333333
Control.SRR15539874;31;32;0.419354838709677;18;13;0.0806451612903226;0.419354838709677
Control.SRR15539874;28;32;0.607142857142857;11;17;0.107142857142857;0.392857142857143
Control.SRR15539874;33;32;0.393939393939394;20;13;0.106060606060606;0.393939393939394
Control.SRR15539874;34;32;0.529411764705882;16;18;0.0294117647058824;0.470588235294118
Control.SRR15539874;35;32;0.371428571428571;22;13;0.128571428571429;0.371428571428571
Control.SRR15539874;35;32;0.485714285714286;18;17;0.0142857142857143;0.485714285714286
Control.SRR15539874;35;32;0.457142857142857;19;16;0.0428571428571429;0.457142857142857
Control.SRR15539874;33;32;0.545454545454545;15;18;0.0454545454545454;0.454545454545455
Control.SRR15539874;31;32;0.451612903225806;17;14;0.0483870967741936;0.451612903225806
Control.SRR15539874;31;32;0.580645161290323;13;18;0.0806451612903226;0.419354838709677
Control.SRR15539874;30;32;0.5;15;15;0;0.5
Control.SRR15539874;35;32;0.628571428571429;13;22;0.128571428571429;0.371428571428571
Control.SRR15539874;29;32;0.379310344827586;18;11;0.120689655172414;0.379310344827586
Control.SRR15539874;30;32;0.566666666666667;13;17;0.0666666666666667;0.433333333333333
Control.SRR15539874;32;32;0.5;16;16;0;0.5
Control.SRR15539874;32;32;0.46875;17;15;0.03125;0.46875
Control.SRR15539874;28;32;0.571428571428571;12;16;0.0714285714285714;0.428571428571429
Control.SRR15539874;32;32;0.4375;18;14;0.0625;0.4375
Control.SRR15539874;30;32;0.366666666666667;19;11;0.133333333333333;0.366666666666667
Control.SRR15539874;35;32;0.542857142857143;16;19;0.0428571428571428;0.457142857142857
Control.SRR15539874;35;32;0.571428571428571;15;20;0.0714285714285714;0.428571428571429
Control.SRR15539874;30;32;0.333333333333333;20;10;0.166666666666667;0.333333333333333
Control.SRR15539874;29;32;0.482758620689655;15;14;0.0172413793103448;0.482758620689655
Control.SRR15539874;31;32;0.419354838709677;18;13;0.0806451612903226;0.419354838709677
Control.SRR15539874;35;32;0.485714285714286;18;17;0.0142857142857143;0.485714285714286
Control.SRR15539874;28;32;0.464285714285714;15;13;0.0357142857142857;0.464285714285714
Control.SRR15539874;30;32;0.566666666666667;13;17;0.0666666666666667;0.433333333333333
Control.SRR15539874;30;32;0.566666666666667;13;17;0.0666666666666667;0.433333333333333
Control.SRR15539874;28;32;0.428571428571429;16;12;0.0714285714285715;0.428571428571429
Control.SRR15539874;34;32;0.588235294117647;14;20;0.0882352941176471;0.411764705882353
Control.SRR15539874;30;32;0.366666666666667;19;11;0.133333333333333;0.366666666666667
Control.SRR15539874;27;32;0.444444444444444;15;12;0.0555555555555556;0.444444444444444
Control.SRR15539874;31;32;0.483870967741935;16;15;0.0161290322580645;0.483870967741935
Control.SRR15539874;34;32;0.470588235294118;18;16;0.0294117647058824;0.470588235294118
Control.SRR15539874;28;32;0.535714285714286;13;15;0.0357142857142857;0.464285714285714
Control.SRR15539874;28;32;0.428571428571429;16;12;0.0714285714285715;0.428571428571429
Control.SRR15539874;30;32;0.533333333333333;14;16;0.0333333333333333;0.466666666666667
Control.SRR15539874;27;32;0.407407407407407;16;11;0.0925925925925926;0.407407407407407
Control.SRR15539874;34;32;0.529411764705882;16;18;0.0294117647058824;0.470588235294118
Control.SRR15539874;34;32;0.352941176470588;22;12;0.147058823529412;0.352941176470588
Control.SRR15539874;29;32;0.379310344827586;18;11;0.120689655172414;0.379310344827586
Control.SRR15539874;29;32;0.689655172413793;9;20;0.189655172413793;0.310344827586207
Control.SRR15539874;28;32;0.357142857142857;18;10;0.142857142857143;0.357142857142857
Control.SRR15539874;30;32;0.633333333333333;11;19;0.133333333333333;0.366666666666667
Control.SRR15539874;28;32;0.571428571428571;12;16;0.0714285714285714;0.428571428571429
Control.SRR15539874;27;32;0.703703703703704;8;19;0.203703703703704;0.296296296296296
Control.SRR15539874;33;32;0.575757575757576;14;19;0.0757575757575758;0.424242424242424
Control.SRR15539874;29;32;0.551724137931034;13;16;0.0517241379310345;0.448275862068966
Control.SRR15539874;27;32;0.518518518518518;13;14;0.0185185185185185;0.481481481481481
Control.SRR15539874;33;32;0.424242424242424;19;14;0.0757575757575757;0.424242424242424
Control.SRR15539874;30;32;0.366666666666667;19;11;0.133333333333333;0.366666666666667
Control.SRR15539874;34;32;0.470588235294118;18;16;0.0294117647058824;0.470588235294118
Control.SRR15539874;30;32;0.333333333333333;20;10;0.166666666666667;0.333333333333333
Control.SRR15539874;27;32;0.592592592592593;11;16;0.0925925925925926;0.407407407407407
Control.SRR15539874;35;32;0.657142857142857;12;23;0.157142857142857;0.342857142857143
Control.SRR15539874;34;32;0.352941176470588;22;12;0.147058823529412;0.352941176470588
Control.SRR15539874;35;32;0.485714285714286;18;17;0.0142857142857143;0.485714285714286
Control.SRR15539874;33;32;0.545454545454545;15;18;0.0454545454545454;0.454545454545455
Control.SRR15539874;34;32;0.441176470588235;19;15;0.0588235294117647;0.441176470588235
Control.SRR15539874;29;32;0.482758620689655;15;14;0.0172413793103448;0.482758620689655
Control.SRR15539874;27;32;0.703703703703704;8;19;0.203703703703704;0.296296296296296
Control.SRR15539874;31;32;0.516129032258065;15;16;0.0161290322580645;0.483870967741935
Control.SRR15539874;30;32;0.633333333333333;11;19;0.133333333333333;0.366666666666667
Control.SRR15539874;35;32;0.428571428571429;20;15;0.0714285714285715;0.428571428571429
Control.SRR15539874;36;32;0.5;18;18;0;0.5
Control.SRR15539874;36;32;0.416666666666667;21;15;0.0833333333333333;0.416666666666667
Control.SRR15539874;32;32;0.53125;15;17;0.03125;0.46875
Control.SRR15539874;35;32;0.314285714285714;24;11;0.185714285714286;0.314285714285714
Control.SRR15539874;35;32;0.314285714285714;24;11;0.185714285714286;0.314285714285714
Control.SRR15539874;35;32;0.4;21;14;0.1;0.4
Control.SRR15539874;37;32;0.486486486486487;19;18;0.0135135135135135;0.486486486486487
Control.SRR15539874;32;32;0.53125;15;17;0.03125;0.46875
Control.SRR15539874;33;32;0.333333333333333;22;11;0.166666666666667;0.333333333333333
Control.SRR15539874;37;32;0.486486486486487;19;18;0.0135135135135135;0.486486486486487
Control.SRR15539874;37;32;0.567567567567568;16;21;0.0675675675675675;0.432432432432432
Control.SRR15539874;35;32;0.457142857142857;19;16;0.0428571428571429;0.457142857142857
Control.SRR15539874;34;32;0.647058823529412;12;22;0.147058823529412;0.352941176470588
Control.SRR15539874;35;32;0.314285714285714;24;11;0.185714285714286;0.314285714285714
Control.SRR15539874;35;32;0.628571428571429;13;22;0.128571428571429;0.371428571428571
Control.SRR15539874;34;32;0.558823529411765;15;19;0.0588235294117647;0.441176470588235
Control.SRR15539874;37;32;0.432432432432432;21;16;0.0675675675675675;0.432432432432432
Control.SRR15539874;32;32;0.53125;15;17;0.03125;0.46875
Control.SRR15539874;31;32;0.483870967741935;16;15;0.0161290322580645;0.483870967741935
Control.SRR15539874;35;32;0.571428571428571;15;20;0.0714285714285714;0.428571428571429
Control.SRR15539874;30;32;0.6;12;18;0.1;0.4
Control.SRR15539874;35;32;0.628571428571429;13;22;0.128571428571429;0.371428571428571
Control.SRR15539874;30;32;0.5;15;15;0;0.5
Control.SRR15539874;36;32;0.583333333333333;15;21;0.0833333333333334;0.416666666666667
Control.SRR15539874;34;32;0.5;17;17;0;0.5
Control.SRR15539874;36;32;0.472222222222222;19;17;0.0277777777777778;0.472222222222222
Control.SRR15539874;34;32;0.411764705882353;20;14;0.0882352941176471;0.411764705882353
Control.SRR15539874;32;32;0.46875;17;15;0.03125;0.46875
Control.SRR15539874;36;32;0.472222222222222;19;17;0.0277777777777778;0.472222222222222
Control.SRR15539874;34;32;0.352941176470588;22;12;0.147058823529412;0.352941176470588
Control.SRR15539874;35;32;0.485714285714286;18;17;0.0142857142857143;0.485714285714286
Control.SRR15539874;33;32;0.575757575757576;14;19;0.0757575757575758;0.424242424242424
Control.SRR15539874;29;32;0.620689655172414;11;18;0.120689655172414;0.379310344827586
Control.SRR15539874;36;32;0.583333333333333;15;21;0.0833333333333334;0.416666666666667
Control.SRR15539874;33;32;0.393939393939394;20;13;0.106060606060606;0.393939393939394
Control.SRR15539874;36;32;0.333333333333333;24;12;0.166666666666667;0.333333333333333
Control.SRR15539874;35;32;0.485714285714286;18;17;0.0142857142857143;0.485714285714286
Control.SRR15539874;32;32;0.59375;13;19;0.09375;0.40625
Control.SRR15539874;33;32;0.484848484848485;17;16;0.0151515151515151;0.484848484848485
Control.SRR15539874;36;32;0.472222222222222;19;17;0.0277777777777778;0.472222222222222
Control.SRR15539874;37;32;0.378378378378378;23;14;0.121621621621622;0.378378378378378
Control.SRR15539874;30;32;0.5;15;15;0;0.5
Control.SRR15539874;32;32;0.46875;17;15;0.03125;0.46875
Control.SRR15539874;35;32;0.457142857142857;19;16;0.0428571428571429;0.457142857142857
Control.SRR15539874;36;32;0.666666666666667;12;24;0.166666666666667;0.333333333333333
Control.SRR15539874;30;32;0.533333333333333;14;16;0.0333333333333333;0.466666666666667
Control.SRR15539874;29;32;0.379310344827586;18;11;0.120689655172414;0.379310344827586
Control.SRR15539874;32;32;0.5;16;16;0;0.5
Control.SRR15539874;33;32;0.393939393939394;20;13;0.106060606060606;0.393939393939394
Control.SRR15539874;31;32;0.580645161290323;13;18;0.0806451612903226;0.419354838709677
Control.SRR15539874;31;32;0.516129032258065;15;16;0.0161290322580645;0.483870967741935
Control.SRR15539874;31;32;0.387096774193548;19;12;0.112903225806452;0.387096774193548
Control.SRR15539874;29;32;0.448275862068966;16;13;0.0517241379310345;0.448275862068966
Control.SRR15539874;35;32;0.457142857142857;19;16;0.0428571428571429;0.457142857142857
Control.SRR15539874;33;32;0.424242424242424;19;14;0.0757575757575757;0.424242424242424
Control.SRR15539874;31;32;0.645161290322581;11;20;0.145161290322581;0.354838709677419
Control.SRR15539874;33;32;0.333333333333333;22;11;0.166666666666667;0.333333333333333
Control.SRR15539874;32;32;0.5;16;16;0;0.5
Control.SRR15539874;34;32;0.470588235294118;18;16;0.0294117647058824;0.470588235294118
Control.SRR15539874;32;32;0.46875;17;15;0.03125;0.46875
Control.SRR15539874;31;32;0.741935483870968;8;23;0.241935483870968;0.258064516129032
Control.SRR15539874;35;32;0.485714285714286;18;17;0.0142857142857143;0.485714285714286
Control.SRR15539874;34;32;0.5;17;17;0;0.5
Control.SRR15539874;33;32;0.393939393939394;20;13;0.106060606060606;0.393939393939394
Control.SRR15539874;29;32;0.448275862068966;16;13;0.0517241379310345;0.448275862068966
Control.SRR15539874;32;32;0.40625;19;13;0.09375;0.40625
Control.SRR15539874;36;32;0.416666666666667;21;15;0.0833333333333333;0.416666666666667
Control.SRR15539874;35;32;0.485714285714286;18;17;0.0142857142857143;0.485714285714286
Control.SRR15539874;36;32;0.444444444444444;20;16;0.0555555555555556;0.444444444444444
Control.SRR15539874;30;32;0.5;15;15;0;0.5
Control.SRR15539874;32;32;0.34375;21;11;0.15625;0.34375
Control.SRR15539874;33;32;0.454545454545455;18;15;0.0454545454545455;0.454545454545455
Control.SRR15539874;32;32;0.40625;19;13;0.09375;0.40625
Control.SRR15539874;35;32;0.542857142857143;16;19;0.0428571428571428;0.457142857142857
Control.SRR15539874;37;32;0.567567567567568;16;21;0.0675675675675675;0.432432432432432
Control.SRR15539874;33;32;0.454545454545455;18;15;0.0454545454545455;0.454545454545455
Control.SRR15539874;36;32;0.694444444444444;11;25;0.194444444444444;0.305555555555556
Control.SRR15539874;37;32;0.378378378378378;23;14;0.121621621621622;0.378378378378378
Control.SRR15539874;33;32;0.575757575757576;14;19;0.0757575757575758;0.424242424242424
Control.SRR15539874;30;32;0.566666666666667;13;17;0.0666666666666667;0.433333333333333
Control.SRR15539874;32;32;0.40625;19;13;0.09375;0.40625
Control.SRR15539874;31;32;0.741935483870968;8;23;0.241935483870968;0.258064516129032
Control.SRR15539874;33;32;0.363636363636364;21;12;0.136363636363636;0.363636363636364
Control.SRR15539874;33;32;0.484848484848485;17;16;0.0151515151515151;0.484848484848485
Control.SRR15539874;30;32;0.566666666666667;13;17;0.0666666666666667;0.433333333333333
Control.SRR15539874;32;32;0.4375;18;14;0.0625;0.4375
Control.SRR15539874;32;32;0.5625;14;18;0.0625;0.4375
Control.SRR15539874;31;32;0.580645161290323;13;18;0.0806451612903226;0.419354838709677
Control.SRR15539874;36;32;0.527777777777778;17;19;0.0277777777777778;0.472222222222222
Control.SRR15539874;32;32;0.5625;14;18;0.0625;0.4375
Control.SRR15539874;35;32;0.514285714285714;17;18;0.0142857142857142;0.485714285714286
Control.SRR15539874;30;32;0.5;15;15;0;0.5
Control.SRR15539874;31;32;0.612903225806452;12;19;0.112903225806452;0.387096774193548
Control.SRR15539874;36;32;0.444444444444444;20;16;0.0555555555555556;0.444444444444444
Control.SRR15539874;32;32;0.4375;18;14;0.0625;0.4375
Control.SRR15539874;36;32;0.583333333333333;15;21;0.0833333333333334;0.416666666666667
Control.SRR15539874;37;32;0.513513513513513;18;19;0.0135135135135135;0.486486486486487
Control.SRR15539874;36;32;0.444444444444444;20;16;0.0555555555555556;0.444444444444444
Control.SRR15539874;37;32;0.540540540540541;17;20;0.0405405405405406;0.459459459459459
Control.SRR15539874;29;32;0.413793103448276;17;12;0.0862068965517241;0.413793103448276
Control.SRR15539874;37;32;0.513513513513513;18;19;0.0135135135135135;0.486486486486487
Control.SRR15539874;36;32;0.5;18;18;0;0.5
Control.SRR15539874;33;32;0.515151515151515;16;17;0.0151515151515151;0.484848484848485
Control.SRR15539874;29;32;0.551724137931034;13;16;0.0517241379310345;0.448275862068966
Control.SRR15539874;36;32;0.527777777777778;17;19;0.0277777777777778;0.472222222222222
Control.SRR15539874;36;32;0.666666666666667;12;24;0.166666666666667;0.333333333333333
Control.SRR15539874;35;32;0.542857142857143;16;19;0.0428571428571428;0.457142857142857
Control.SRR15539874;36;32;0.5;18;18;0;0.5
Control.SRR15539874;31;32;0.483870967741935;16;15;0.0161290322580645;0.483870967741935
Control.SRR15539874;31;32;0.580645161290323;13;18;0.0806451612903226;0.419354838709677
Control.SRR15539874;35;32;0.571428571428571;15;20;0.0714285714285714;0.428571428571429
Control.SRR15539874;33;32;0.545454545454545;15;18;0.0454545454545454;0.454545454545455
Control.SRR15539874;30;32;0.533333333333333;14;16;0.0333333333333333;0.466666666666667
Control.SRR15539874;31;32;0.548387096774194;14;17;0.0483870967741935;0.451612903225806
Control.SRR15539874;31;32;0.483870967741935;16;15;0.0161290322580645;0.483870967741935
Control.SRR15539874;31;32;0.516129032258065;15;16;0.0161290322580645;0.483870967741935
Control.SRR15539874;36;32;0.555555555555556;16;20;0.0555555555555556;0.444444444444444
Control.SRR15539874;33;32;0.393939393939394;20;13;0.106060606060606;0.393939393939394
Control.SRR15539874;34;32;0.588235294117647;14;20;0.0882352941176471;0.411764705882353
Control.SRR15539874;34;32;0.470588235294118;18;16;0.0294117647058824;0.470588235294118
Control.SRR15539874;34;32;0.441176470588235;19;15;0.0588235294117647;0.441176470588235
Control.SRR15539874;37;32;0.540540540540541;17;20;0.0405405405405406;0.459459459459459
Control.SRR15539874;37;32;0.378378378378378;23;14;0.121621621621622;0.378378378378378
Control.SRR15539874;29;32;0.379310344827586;18;11;0.120689655172414;0.379310344827586
Control.SRR15539874;36;32;0.416666666666667;21;15;0.0833333333333333;0.416666666666667
Control.SRR15539874;37;32;0.459459459459459;20;17;0.0405405405405405;0.459459459459459
Control.SRR15539874;35;32;0.571428571428571;15;20;0.0714285714285714;0.428571428571429
Control.SRR15539874;31;32;0.451612903225806;17;14;0.0483870967741936;0.451612903225806
Control.SRR15539874;33;32;0.515151515151515;16;17;0.0151515151515151;0.484848484848485
Control.SRR15539874;35;32;0.628571428571429;13;22;0.128571428571429;0.371428571428571
Control.SRR15539874;34;32;0.647058823529412;12;22;0.147058823529412;0.352941176470588
Control.SRR15539874;30;32;0.5;15;15;0;0.5
Control.SRR15539874;33;32;0.424242424242424;19;14;0.0757575757575757;0.424242424242424
Control.SRR15539874;36;32;0.583333333333333;15;21;0.0833333333333334;0.416666666666667
Control.SRR15539874;30;32;0.4;18;12;0.1;0.4
Control.SRR15539874;30;32;0.5;15;15;0;0.5
Control.SRR15539874;32;32;0.6875;10;22;0.1875;0.3125
Control.SRR15539874;36;32;0.416666666666667;21;15;0.0833333333333333;0.416666666666667
Control.SRR15539874;31;32;0.548387096774194;14;17;0.0483870967741935;0.451612903225806
Control.SRR15539874;36;32;0.416666666666667;21;15;0.0833333333333333;0.416666666666667
Control.SRR15539874;33;32;0.575757575757576;14;19;0.0757575757575758;0.424242424242424
Control.SRR15539874;29;32;0.482758620689655;15;14;0.0172413793103448;0.482758620689655
Control.SRR15539874;30;32;0.566666666666667;13;17;0.0666666666666667;0.433333333333333
Control.SRR15539874;30;32;0.5;15;15;0;0.5
Control.SRR15539874;34;32;0.441176470588235;19;15;0.0588235294117647;0.441176470588235
Control.SRR15539874;34;32;0.470588235294118;18;16;0.0294117647058824;0.470588235294118
Control.SRR15539874;37;32;0.540540540540541;17;20;0.0405405405405406;0.459459459459459
Control.SRR15539874;31;32;0.387096774193548;19;12;0.112903225806452;0.387096774193548
Control.SRR15539874;35;32;0.542857142857143;16;19;0.0428571428571428;0.457142857142857
Control.SRR15539874;35;32;0.371428571428571;22;13;0.128571428571429;0.371428571428571
Control.SRR15539874;37;32;0.594594594594595;15;22;0.0945945945945946;0.405405405405405
Control.SRR15539874;29;32;0.448275862068966;16;13;0.0517241379310345;0.448275862068966
Control.SRR15539874;32;32;0.5625;14;18;0.0625;0.4375
Control.SRR15539874;36;32;0.638888888888889;13;23;0.138888888888889;0.361111111111111
Control.SRR15539874;35;32;0.6;14;21;0.1;0.4
Control.SRR15539874;35;32;0.457142857142857;19;16;0.0428571428571429;0.457142857142857
Control.SRR15539874;37;32;0.432432432432432;21;16;0.0675675675675675;0.432432432432432
Control.SRR15539874;32;32;0.6875;10;22;0.1875;0.3125
Control.SRR15539874;32;32;0.46875;17;15;0.03125;0.46875
Control.SRR15539874;36;32;0.5;18;18;0;0.5
Control.SRR15539874;31;32;0.645161290322581;11;20;0.145161290322581;0.354838709677419
Control.SRR15539874;30;32;0.6;12;18;0.1;0.4
Control.SRR15539874;31;32;0.580645161290323;13;18;0.0806451612903226;0.419354838709677
Control.SRR15539874;33;32;0.454545454545455;18;15;0.0454545454545455;0.454545454545455
Control.SRR15539874;34;32;0.382352941176471;21;13;0.117647058823529;0.382352941176471
Control.SRR15539874;37;32;0.594594594594595;15;22;0.0945945945945946;0.405405405405405
Control.SRR15539874;30;32;0.566666666666667;13;17;0.0666666666666667;0.433333333333333
Control.SRR15539874;31;32;0.516129032258065;15;16;0.0161290322580645;0.483870967741935
Control.SRR15539874;37;32;0.324324324324324;25;12;0.175675675675676;0.324324324324324
Control.SRR15539874;37;32;0.432432432432432;21;16;0.0675675675675675;0.432432432432432
Control.SRR15539874;31;32;0.387096774193548;19;12;0.112903225806452;0.387096774193548
Control.SRR15539874;29;32;0.655172413793103;10;19;0.155172413793103;0.344827586206897
Control.SRR15539874;32;32;0.375;20;12;0.125;0.375
Control.SRR15539874;30;32;0.533333333333333;14;16;0.0333333333333333;0.466666666666667
Control.SRR15539874;31;32;0.451612903225806;17;14;0.0483870967741936;0.451612903225806
Control.SRR15539874;33;32;0.575757575757576;14;19;0.0757575757575758;0.424242424242424
Control.SRR15539874;29;32;0.655172413793103;10;19;0.155172413793103;0.344827586206897
Control.SRR15539874;30;32;0.466666666666667;16;14;0.0333333333333333;0.466666666666667
Control.SRR15539874;32;32;0.46875;17;15;0.03125;0.46875
Control.SRR15539874;34;32;0.588235294117647;14;20;0.0882352941176471;0.411764705882353
Control.SRR15539874;30;32;0.4;18;12;0.1;0.4
Control.SRR15539874;34;32;0.5;17;17;0;0.5
Control.SRR15539874;36;32;0.527777777777778;17;19;0.0277777777777778;0.472222222222222
Control.SRR15539874;36;32;0.583333333333333;15;21;0.0833333333333334;0.416666666666667
Control.SRR15539874;31;32;0.258064516129032;23;8;0.241935483870968;0.258064516129032
Control.SRR15539874;37;32;0.405405405405405;22;15;0.0945945945945946;0.405405405405405
Control.SRR15539874;31;32;0.580645161290323;13;18;0.0806451612903226;0.419354838709677
Control.SRR15539874;34;32;0.529411764705882;16;18;0.0294117647058824;0.470588235294118
Control.SRR15539874;32;32;0.375;20;12;0.125;0.375
Control.SRR15539874;32;32;0.5625;14;18;0.0625;0.4375
Control.SRR15539874;37;32;0.378378378378378;23;14;0.121621621621622;0.378378378378378
Control.SRR15539874;30;32;0.5;15;15;0;0.5
Control.SRR15539874;31;32;0.645161290322581;11;20;0.145161290322581;0.354838709677419
Control.SRR15539874;36;32;0.416666666666667;21;15;0.0833333333333333;0.416666666666667
Control.SRR15539874;36;32;0.583333333333333;15;21;0.0833333333333334;0.416666666666667
Control.SRR15539874;33;32;0.454545454545455;18;15;0.0454545454545455;0.454545454545455
Control.SRR15539874;35;32;0.6;14;21;0.1;0.4
Control.SRR15539874;29;32;0.448275862068966;16;13;0.0517241379310345;0.448275862068966
Control.SRR15539874;36;32;0.388888888888889;22;14;0.111111111111111;0.388888888888889
Control.SRR15539874;34;32;0.588235294117647;14;20;0.0882352941176471;0.411764705882353
Control.SRR15539874;31;32;0.419354838709677;18;13;0.0806451612903226;0.419354838709677
Control.SRR15539874;33;32;0.606060606060606;13;20;0.106060606060606;0.393939393939394
Control.SRR15539874;36;32;0.472222222222222;19;17;0.0277777777777778;0.472222222222222
Control.SRR15539874;36;32;0.583333333333333;15;21;0.0833333333333334;0.416666666666667
Control.SRR15539874;30;32;0.633333333333333;11;19;0.133333333333333;0.366666666666667
Control.SRR15539874;33;32;0.515151515151515;16;17;0.0151515151515151;0.484848484848485
Control.SRR15539874;37;32;0.567567567567568;16;21;0.0675675675675675;0.432432432432432
Control.SRR15539874;29;32;0.413793103448276;17;12;0.0862068965517241;0.413793103448276
Control.SRR15539874;36;32;0.666666666666667;12;24;0.166666666666667;0.333333333333333
Control.SRR15539874;36;32;0.583333333333333;15;21;0.0833333333333334;0.416666666666667
Control.SRR15539874;33;32;0.424242424242424;19;14;0.0757575757575757;0.424242424242424
Control.SRR15539874;34;32;0.529411764705882;16;18;0.0294117647058824;0.470588235294118
Control.SRR15539874;37;32;0.621621621621622;14;23;0.121621621621622;0.378378378378378
Control.SRR15539874;36;32;0.388888888888889;22;14;0.111111111111111;0.388888888888889
Control.SRR15539874;36;32;0.472222222222222;19;17;0.0277777777777778;0.472222222222222
Control.SRR15539874;33;32;0.545454545454545;15;18;0.0454545454545454;0.454545454545455
Control.SRR15539874;35;32;0.514285714285714;17;18;0.0142857142857142;0.485714285714286
Control.SRR15539874;30;32;0.533333333333333;14;16;0.0333333333333333;0.466666666666667
Control.SRR15539874;34;32;0.529411764705882;16;18;0.0294117647058824;0.470588235294118
Control.SRR15539874;37;32;0.513513513513513;18;19;0.0135135135135135;0.486486486486487
Control.SRR15539874;29;32;0.551724137931034;13;16;0.0517241379310345;0.448275862068966
Control.SRR15539874;29;32;0.551724137931034;13;16;0.0517241379310345;0.448275862068966
Control.SRR15539874;35;32;0.342857142857143;23;12;0.157142857142857;0.342857142857143
Control.SRR15539874;37;32;0.513513513513513;18;19;0.0135135135135135;0.486486486486487
Control.SRR15539874;31;32;0.419354838709677;18;13;0.0806451612903226;0.419354838709677
Control.SRR15539874;33;32;0.454545454545455;18;15;0.0454545454545455;0.454545454545455
Control.SRR15539874;35;32;0.457142857142857;19;16;0.0428571428571429;0.457142857142857
Control.SRR15539874;32;32;0.5;16;16;0;0.5
Control.SRR15539874;37;32;0.459459459459459;20;17;0.0405405405405405;0.459459459459459
Control.SRR15539874;30;32;0.4;18;12;0.1;0.4
Control.SRR15539874;35;32;0.428571428571429;20;15;0.0714285714285715;0.428571428571429
Control.SRR15539874;37;32;0.513513513513513;18;19;0.0135135135135135;0.486486486486487
Control.SRR15539874;33;32;0.484848484848485;17;16;0.0151515151515151;0.484848484848485
Control.SRR15539874;37;32;0.594594594594595;15;22;0.0945945945945946;0.405405405405405
Control.SRR15539874;34;32;0.588235294117647;14;20;0.0882352941176471;0.411764705882353
Control.SRR15539874;35;32;0.542857142857143;16;19;0.0428571428571428;0.457142857142857
Control.SRR15539874;35;32;0.4;21;14;0.1;0.4
Control.SRR15539874;32;32;0.5625;14;18;0.0625;0.4375
Control.SRR15539874;34;32;0.441176470588235;19;15;0.0588235294117647;0.441176470588235
Control.SRR15539874;30;32;0.6;12;18;0.1;0.4
Control.SRR15539874;31;32;0.548387096774194;14;17;0.0483870967741935;0.451612903225806
Control.SRR15539874;33;32;0.515151515151515;16;17;0.0151515151515151;0.484848484848485
Control.SRR15539874;34;32;0.647058823529412;12;22;0.147058823529412;0.352941176470588
Control.SRR15539874;33;32;0.363636363636364;21;12;0.136363636363636;0.363636363636364
Control.SRR15539874;31;32;0.548387096774194;14;17;0.0483870967741935;0.451612903225806
Control.SRR15539874;30;32;0.466666666666667;16;14;0.0333333333333333;0.466666666666667
Control.SRR15539874;37;32;0.702702702702703;11;26;0.202702702702703;0.297297297297297
Control.SRR15539874;29;32;0.689655172413793;9;20;0.189655172413793;0.310344827586207
Control.SRR15539874;36;32;0.333333333333333;24;12;0.166666666666667;0.333333333333333
Control.SRR15539874;36;32;0.527777777777778;17;19;0.0277777777777778;0.472222222222222
Control.SRR15539874;31;32;0.580645161290323;13;18;0.0806451612903226;0.419354838709677
Control.SRR15539874;30;32;0.6;12;18;0.1;0.4
Control.SRR15539874;37;32;0.513513513513513;18;19;0.0135135135135135;0.486486486486487
Control.SRR15539874;32;32;0.4375;18;14;0.0625;0.4375
Control.SRR15539874;31;32;0.419354838709677;18;13;0.0806451612903226;0.419354838709677
Control.SRR15539874;32;32;0.59375;13;19;0.09375;0.40625
Control.SRR15539874;33;32;0.515151515151515;16;17;0.0151515151515151;0.484848484848485
Control.SRR15539874;35;32;0.6;14;21;0.1;0.4
Control.SRR15539874;30;32;0.666666666666667;10;20;0.166666666666667;0.333333333333333
Control.SRR15539874;33;32;0.545454545454545;15;18;0.0454545454545454;0.454545454545455
Control.SRR15539874;30;32;0.633333333333333;11;19;0.133333333333333;0.366666666666667
Control.SRR15539874;35;32;0.457142857142857;19;16;0.0428571428571429;0.457142857142857
Control.SRR15539874;31;32;0.516129032258065;15;16;0.0161290322580645;0.483870967741935
Control.SRR15539874;31;32;0.516129032258065;15;16;0.0161290322580645;0.483870967741935
Control.SRR15539874;32;32;0.6875;10;22;0.1875;0.3125
Control.SRR15539874;30;32;0.566666666666667;13;17;0.0666666666666667;0.433333333333333
Control.SRR15539874;34;32;0.411764705882353;20;14;0.0882352941176471;0.411764705882353
Control.SRR15539874;32;32;0.40625;19;13;0.09375;0.40625
Control.SRR15539874;34;32;0.5;17;17;0;0.5
Control.SRR15539874;32;32;0.4375;18;14;0.0625;0.4375
Control.SRR15539874;34;32;0.588235294117647;14;20;0.0882352941176471;0.411764705882353
Control.SRR15539874;37;32;0.459459459459459;20;17;0.0405405405405405;0.459459459459459
Control.SRR15539874;37;32;0.567567567567568;16;21;0.0675675675675675;0.432432432432432
Control.SRR15539874;34;32;0.470588235294118;18;16;0.0294117647058824;0.470588235294118
Control.SRR15539874;33;32;0.515151515151515;16;17;0.0151515151515151;0.484848484848485
Control.SRR15539874;37;32;0.324324324324324;25;12;0.175675675675676;0.324324324324324
Control.SRR15539874;30;32;0.566666666666667;13;17;0.0666666666666667;0.433333333333333
Control.SRR15539874;35;32;0.485714285714286;18;17;0.0142857142857143;0.485714285714286
Control.SRR15539874;35;32;0.628571428571429;13;22;0.128571428571429;0.371428571428571
Control.SRR15539874;34;32;0.441176470588235;19;15;0.0588235294117647;0.441176470588235
Control.SRR15539874;35;32;0.514285714285714;17;18;0.0142857142857142;0.485714285714286
Control.SRR15539874;34;32;0.676470588235294;11;23;0.176470588235294;0.323529411764706
Control.SRR15539874;30;32;0.5;15;15;0;0.5
Control.SRR15539874;34;32;0.529411764705882;16;18;0.0294117647058824;0.470588235294118
Control.SRR15539874;34;32;0.5;17;17;0;0.5
Control.SRR15539874;34;32;0.470588235294118;18;16;0.0294117647058824;0.470588235294118
Control.SRR15539874;30;32;0.433333333333333;17;13;0.0666666666666667;0.433333333333333
Control.SRR15539874;29;32;0.586206896551724;12;17;0.0862068965517241;0.413793103448276
Control.SRR15539874;36;32;0.583333333333333;15;21;0.0833333333333334;0.416666666666667
Control.SRR15539874;37;32;0.378378378378378;23;14;0.121621621621622;0.378378378378378
Control.SRR15539874;29;32;0.448275862068966;16;13;0.0517241379310345;0.448275862068966
Control.SRR15539874;36;32;0.583333333333333;15;21;0.0833333333333334;0.416666666666667
Control.SRR15539874;29;32;0.655172413793103;10;19;0.155172413793103;0.344827586206897
Control.SRR15539874;32;32;0.53125;15;17;0.03125;0.46875
Control.SRR15539874;35;32;0.428571428571429;20;15;0.0714285714285715;0.428571428571429
Control.SRR15539874;35;32;0.542857142857143;16;19;0.0428571428571428;0.457142857142857
Control.SRR15539874;35;32;0.571428571428571;15;20;0.0714285714285714;0.428571428571429
Control.SRR15539874;33;32;0.454545454545455;18;15;0.0454545454545455;0.454545454545455
Control.SRR15539874;30;32;0.533333333333333;14;16;0.0333333333333333;0.466666666666667
Control.SRR15539874;31;32;0.612903225806452;12;19;0.112903225806452;0.387096774193548
Control.SRR15539874;29;32;0.448275862068966;16;13;0.0517241379310345;0.448275862068966
Control.SRR15539874;31;32;0.548387096774194;14;17;0.0483870967741935;0.451612903225806
Control.SRR15539874;36;32;0.555555555555556;16;20;0.0555555555555556;0.444444444444444
Control.SRR15539874;34;32;0.5;17;17;0;0.5
Control.SRR15539874;33;32;0.575757575757576;14;19;0.0757575757575758;0.424242424242424
Control.SRR15539874;29;32;0.517241379310345;14;15;0.0172413793103449;0.482758620689655
Control.SRR15539874;34;32;0.470588235294118;18;16;0.0294117647058824;0.470588235294118
Control.SRR15539874;33;32;0.454545454545455;18;15;0.0454545454545455;0.454545454545455
Control.SRR15539874;33;32;0.545454545454545;15;18;0.0454545454545454;0.454545454545455
Control.SRR15539874;33;32;0.484848484848485;17;16;0.0151515151515151;0.484848484848485
Control.SRR15539874;36;32;0.416666666666667;21;15;0.0833333333333333;0.416666666666667
Control.SRR15539874;32;32;0.53125;15;17;0.03125;0.46875
Control.SRR15539874;37;32;0.432432432432432;21;16;0.0675675675675675;0.432432432432432
Control.SRR15539874;34;32;0.382352941176471;21;13;0.117647058823529;0.382352941176471
Control.SRR15539874;36;32;0.444444444444444;20;16;0.0555555555555556;0.444444444444444
Control.SRR15539874;31;32;0.354838709677419;20;11;0.145161290322581;0.354838709677419
Control.SRR15539874;36;32;0.472222222222222;19;17;0.0277777777777778;0.472222222222222
Control.SRR15539874;32;32;0.375;20;12;0.125;0.375
Control.SRR15539874;36;32;0.472222222222222;19;17;0.0277777777777778;0.472222222222222
Control.SRR15539874;32;32;0.40625;19;13;0.09375;0.40625
Control.SRR15539874;34;32;0.470588235294118;18;16;0.0294117647058824;0.470588235294118
Control.SRR15539874;33;32;0.424242424242424;19;14;0.0757575757575757;0.424242424242424
Control.SRR15539874;36;32;0.638888888888889;13;23;0.138888888888889;0.361111111111111
Control.SRR15539874;33;32;0.545454545454545;15;18;0.0454545454545454;0.454545454545455
Control.SRR15539874;34;32;0.617647058823529;13;21;0.117647058823529;0.382352941176471
Control.SRR15539874;31;32;0.645161290322581;11;20;0.145161290322581;0.354838709677419
Control.SRR15539874;31;32;0.419354838709677;18;13;0.0806451612903226;0.419354838709677
Control.SRR15539874;30;32;0.466666666666667;16;14;0.0333333333333333;0.466666666666667
Control.SRR15539874;35;32;0.542857142857143;16;19;0.0428571428571428;0.457142857142857
Control.SRR15539874;29;32;0.344827586206897;19;10;0.155172413793103;0.344827586206897
Control.SRR15539874;29;32;0.413793103448276;17;12;0.0862068965517241;0.413793103448276
Control.SRR15539874;29;32;0.413793103448276;17;12;0.0862068965517241;0.413793103448276
Control.SRR15539874;33;32;0.424242424242424;19;14;0.0757575757575757;0.424242424242424
Control.SRR15539874;37;32;0.432432432432432;21;16;0.0675675675675675;0.432432432432432
Control.SRR15539874;36;32;0.555555555555556;16;20;0.0555555555555556;0.444444444444444
Control.SRR15539874;33;32;0.515151515151515;16;17;0.0151515151515151;0.484848484848485
Control.SRR15539874;32;32;0.5;16;16;0;0.5
Control.SRR15539874;35;32;0.457142857142857;19;16;0.0428571428571429;0.457142857142857
Control.SRR15539874;37;32;0.621621621621622;14;23;0.121621621621622;0.378378378378378
Control.SRR15539874;31;32;0.516129032258065;15;16;0.0161290322580645;0.483870967741935
Control.SRR15539874;32;32;0.5625;14;18;0.0625;0.4375
Control.SRR15539874;34;32;0.588235294117647;14;20;0.0882352941176471;0.411764705882353
Control.SRR15539874;30;32;0.5;15;15;0;0.5
Control.SRR15539874;30;32;0.433333333333333;17;13;0.0666666666666667;0.433333333333333
Control.SRR15539874;29;32;0.448275862068966;16;13;0.0517241379310345;0.448275862068966
Control.SRR15539874;35;32;0.6;14;21;0.1;0.4
Control.SRR15539874;29;32;0.413793103448276;17;12;0.0862068965517241;0.413793103448276
Control.SRR15539874;29;32;0.551724137931034;13;16;0.0517241379310345;0.448275862068966
Control.SRR15539874;35;32;0.485714285714286;18;17;0.0142857142857143;0.485714285714286
Control.SRR15539874;32;32;0.4375;18;14;0.0625;0.4375
Control.SRR15539874;33;32;0.606060606060606;13;20;0.106060606060606;0.393939393939394
Control.SRR15539874;36;32;0.527777777777778;17;19;0.0277777777777778;0.472222222222222
Control.SRR15539874;37;32;0.513513513513513;18;19;0.0135135135135135;0.486486486486487
Control.SRR15539874;34;32;0.470588235294118;18;16;0.0294117647058824;0.470588235294118
Control.SRR15539874;35;32;0.485714285714286;18;17;0.0142857142857143;0.485714285714286
Control.SRR15539874;34;32;0.588235294117647;14;20;0.0882352941176471;0.411764705882353
Control.SRR15539874;30;32;0.666666666666667;10;20;0.166666666666667;0.333333333333333
Control.SRR15539874;37;32;0.405405405405405;22;15;0.0945945945945946;0.405405405405405
Control.SRR15539874;37;32;0.405405405405405;22;15;0.0945945945945946;0.405405405405405
Control.SRR15539874;34;32;0.617647058823529;13;21;0.117647058823529;0.382352941176471
Control.SRR15539874;35;32;0.685714285714286;11;24;0.185714285714286;0.314285714285714
Control.SRR15539874;31;32;0.580645161290323;13;18;0.0806451612903226;0.419354838709677
Control.SRR15539874;34;32;0.294117647058824;24;10;0.205882352941176;0.294117647058824
Control.SRR15539874;36;32;0.638888888888889;13;23;0.138888888888889;0.361111111111111
Control.SRR15539874;30;32;0.233333333333333;23;7;0.266666666666667;0.233333333333333
Control.SRR15539874;31;32;0.612903225806452;12;19;0.112903225806452;0.387096774193548
Control.SRR15539874;33;32;0.515151515151515;16;17;0.0151515151515151;0.484848484848485
Control.SRR15539874;34;32;0.617647058823529;13;21;0.117647058823529;0.382352941176471
Control.SRR15539874;33;32;0.545454545454545;15;18;0.0454545454545454;0.454545454545455
Control.SRR15539874;31;32;0.67741935483871;10;21;0.17741935483871;0.32258064516129
Control.SRR15539874;35;32;0.342857142857143;23;12;0.157142857142857;0.342857142857143
Control.SRR15539874;36;32;0.527777777777778;17;19;0.0277777777777778;0.472222222222222
Control.SRR15539874;30;32;0.566666666666667;13;17;0.0666666666666667;0.433333333333333
Control.SRR15539874;36;32;0.555555555555556;16;20;0.0555555555555556;0.444444444444444
Control.SRR15539874;35;32;0.485714285714286;18;17;0.0142857142857143;0.485714285714286
Control.SRR15539874;37;32;0.594594594594595;15;22;0.0945945945945946;0.405405405405405
Control.SRR15539874;35;32;0.285714285714286;25;10;0.214285714285714;0.285714285714286
Control.SRR15539874;29;32;0.517241379310345;14;15;0.0172413793103449;0.482758620689655
Control.SRR15539874;36;32;0.527777777777778;17;19;0.0277777777777778;0.472222222222222
Control.SRR15539874;32;32;0.46875;17;15;0.03125;0.46875
Control.SRR15539874;34;32;0.647058823529412;12;22;0.147058823529412;0.352941176470588
Control.SRR15539874;29;32;0.517241379310345;14;15;0.0172413793103449;0.482758620689655
Control.SRR15539874;29;32;0.482758620689655;15;14;0.0172413793103448;0.482758620689655
Control.SRR15539874;30;32;0.533333333333333;14;16;0.0333333333333333;0.466666666666667
Control.SRR15539874;37;32;0.486486486486487;19;18;0.0135135135135135;0.486486486486487
Control.SRR15539874;36;32;0.5;18;18;0;0.5
Control.SRR15539874;34;32;0.411764705882353;20;14;0.0882352941176471;0.411764705882353
Control.SRR15539874;36;32;0.388888888888889;22;14;0.111111111111111;0.388888888888889
Control.SRR15539874;37;32;0.513513513513513;18;19;0.0135135135135135;0.486486486486487
Control.SRR15539874;33;32;0.515151515151515;16;17;0.0151515151515151;0.484848484848485
Control.SRR15539874;37;32;0.432432432432432;21;16;0.0675675675675675;0.432432432432432
Control.SRR15539874;33;32;0.454545454545455;18;15;0.0454545454545455;0.454545454545455
Control.SRR15539874;30;32;0.633333333333333;11;19;0.133333333333333;0.366666666666667
Control.SRR15539874;29;32;0.655172413793103;10;19;0.155172413793103;0.344827586206897
Control.SRR15539874;34;32;0.588235294117647;14;20;0.0882352941176471;0.411764705882353
Control.SRR15539874;36;32;0.611111111111111;14;22;0.111111111111111;0.388888888888889
Control.SRR15539874;36;32;0.527777777777778;17;19;0.0277777777777778;0.472222222222222
Control.SRR15539874;37;32;0.621621621621622;14;23;0.121621621621622;0.378378378378378
Control.SRR15539874;37;32;0.567567567567568;16;21;0.0675675675675675;0.432432432432432
Control.SRR15539874;36;32;0.638888888888889;13;23;0.138888888888889;0.361111111111111
Control.SRR15539874;35;32;0.428571428571429;20;15;0.0714285714285715;0.428571428571429
Control.SRR15539874;30;32;0.4;18;12;0.1;0.4
Control.SRR15539874;29;32;0.586206896551724;12;17;0.0862068965517241;0.413793103448276
Control.SRR15539874;31;32;0.483870967741935;16;15;0.0161290322580645;0.483870967741935
Control.SRR15539874;37;32;0.486486486486487;19;18;0.0135135135135135;0.486486486486487
Control.SRR15539874;31;32;0.387096774193548;19;12;0.112903225806452;0.387096774193548
Control.SRR15539874;29;32;0.413793103448276;17;12;0.0862068965517241;0.413793103448276
Control.SRR15539874;37;32;0.486486486486487;19;18;0.0135135135135135;0.486486486486487
Control.SRR15539874;33;32;0.515151515151515;16;17;0.0151515151515151;0.484848484848485
Control.SRR15539874;33;32;0.333333333333333;22;11;0.166666666666667;0.333333333333333
Control.SRR15539874;30;32;0.433333333333333;17;13;0.0666666666666667;0.433333333333333
Control.SRR15539874;35;32;0.571428571428571;15;20;0.0714285714285714;0.428571428571429
Control.SRR15539874;35;32;0.4;21;14;0.1;0.4
Control.SRR15539874;29;32;0.482758620689655;15;14;0.0172413793103448;0.482758620689655
Control.SRR15539874;31;32;0.483870967741935;16;15;0.0161290322580645;0.483870967741935
Control.SRR15539874;33;32;0.393939393939394;20;13;0.106060606060606;0.393939393939394
Control.SRR15539874;37;32;0.513513513513513;18;19;0.0135135135135135;0.486486486486487
Control.SRR15539874;34;32;0.588235294117647;14;20;0.0882352941176471;0.411764705882353
Control.SRR15539874;30;32;0.566666666666667;13;17;0.0666666666666667;0.433333333333333
Control.SRR15539874;30;32;0.366666666666667;19;11;0.133333333333333;0.366666666666667
Control.SRR15539874;29;32;0.551724137931034;13;16;0.0517241379310345;0.448275862068966
Control.SRR15539874;31;32;0.645161290322581;11;20;0.145161290322581;0.354838709677419
Control.SRR15539874;31;32;0.483870967741935;16;15;0.0161290322580645;0.483870967741935
Control.SRR15539874;33;32;0.424242424242424;19;14;0.0757575757575757;0.424242424242424
Control.SRR15539874;34;32;0.352941176470588;22;12;0.147058823529412;0.352941176470588
Control.SRR15539874;29;32;0.551724137931034;13;16;0.0517241379310345;0.448275862068966
Control.SRR15539874;29;32;0.448275862068966;16;13;0.0517241379310345;0.448275862068966
Control.SRR15539874;30;32;0.566666666666667;13;17;0.0666666666666667;0.433333333333333
Control.SRR15539874;31;32;0.516129032258065;15;16;0.0161290322580645;0.483870967741935
Control.SRR15539874;33;32;0.515151515151515;16;17;0.0151515151515151;0.484848484848485
Control.SRR15539874;31;32;0.516129032258065;15;16;0.0161290322580645;0.483870967741935
Control.SRR15539874;36;32;0.583333333333333;15;21;0.0833333333333334;0.416666666666667
Control.SRR15539874;35;32;0.342857142857143;23;12;0.157142857142857;0.342857142857143
Control.SRR15539874;34;32;0.529411764705882;16;18;0.0294117647058824;0.470588235294118
Control.SRR15539874;34;32;0.470588235294118;18;16;0.0294117647058824;0.470588235294118
Control.SRR15539874;29;32;0.448275862068966;16;13;0.0517241379310345;0.448275862068966
Control.SRR15539874;33;32;0.484848484848485;17;16;0.0151515151515151;0.484848484848485
Control.SRR15539874;32;32;0.53125;15;17;0.03125;0.46875
Control.SRR15539874;34;32;0.470588235294118;18;16;0.0294117647058824;0.470588235294118
Control.SRR15539874;34;32;0.647058823529412;12;22;0.147058823529412;0.352941176470588
Control.SRR15539874;29;32;0.655172413793103;10;19;0.155172413793103;0.344827586206897
Control.SRR15539874;29;32;0.448275862068966;16;13;0.0517241379310345;0.448275862068966
Control.SRR15539874;32;32;0.28125;23;9;0.21875;0.28125
Control.SRR15539874;30;32;0.366666666666667;19;11;0.133333333333333;0.366666666666667
Control.SRR15539874;37;32;0.459459459459459;20;17;0.0405405405405405;0.459459459459459
Control.SRR15539874;34;32;0.529411764705882;16;18;0.0294117647058824;0.470588235294118
Control.SRR15539874;33;32;0.575757575757576;14;19;0.0757575757575758;0.424242424242424
Control.SRR15539874;37;32;0.459459459459459;20;17;0.0405405405405405;0.459459459459459
Control.SRR15539874;30;32;0.6;12;18;0.1;0.4
Control.SRR15539874;31;32;0.645161290322581;11;20;0.145161290322581;0.354838709677419
Control.SRR15539874;30;32;0.533333333333333;14;16;0.0333333333333333;0.466666666666667
Control.SRR15539874;31;32;0.387096774193548;19;12;0.112903225806452;0.387096774193548
Control.SRR15539874;31;32;0.419354838709677;18;13;0.0806451612903226;0.419354838709677
Control.SRR15539874;36;32;0.583333333333333;15;21;0.0833333333333334;0.416666666666667
Control.SRR15539874;31;32;0.451612903225806;17;14;0.0483870967741936;0.451612903225806
Control.SRR15539874;29;32;0.517241379310345;14;15;0.0172413793103449;0.482758620689655
Control.SRR15539874;30;32;0.366666666666667;19;11;0.133333333333333;0.366666666666667
Control.SRR15539874;30;32;0.533333333333333;14;16;0.0333333333333333;0.466666666666667
Control.SRR15539874;33;32;0.424242424242424;19;14;0.0757575757575757;0.424242424242424
Control.SRR15539874;30;32;0.433333333333333;17;13;0.0666666666666667;0.433333333333333
Control.SRR15539874;30;32;0.5;15;15;0;0.5
Control.SRR15539874;33;32;0.424242424242424;19;14;0.0757575757575757;0.424242424242424
Control.SRR15539874;36;32;0.444444444444444;20;16;0.0555555555555556;0.444444444444444
Control.SRR15539874;34;32;0.617647058823529;13;21;0.117647058823529;0.382352941176471
Control.SRR15539874;31;32;0.548387096774194;14;17;0.0483870967741935;0.451612903225806
Control.SRR15539874;31;32;0.483870967741935;16;15;0.0161290322580645;0.483870967741935
Control.SRR15539874;30;32;0.5;15;15;0;0.5
Control.SRR15539874;31;32;0.387096774193548;19;12;0.112903225806452;0.387096774193548
Control.SRR15539874;32;32;0.625;12;20;0.125;0.375
Control.SRR15539874;29;32;0.551724137931034;13;16;0.0517241379310345;0.448275862068966
Control.SRR15539874;35;32;0.428571428571429;20;15;0.0714285714285715;0.428571428571429
Control.SRR15539874;32;32;0.53125;15;17;0.03125;0.46875
Control.SRR15539874;37;32;0.459459459459459;20;17;0.0405405405405405;0.459459459459459
Control.SRR15539874;30;32;0.433333333333333;17;13;0.0666666666666667;0.433333333333333
Control.SRR15539874;29;32;0.413793103448276;17;12;0.0862068965517241;0.413793103448276
Control.SRR15539874;32;32;0.46875;17;15;0.03125;0.46875
Control.SRR15539874;30;32;0.4;18;12;0.1;0.4
Control.SRR15539874;31;32;0.516129032258065;15;16;0.0161290322580645;0.483870967741935
Control.SRR15539874;31;32;0.387096774193548;19;12;0.112903225806452;0.387096774193548
Control.SRR15539874;31;32;0.516129032258065;15;16;0.0161290322580645;0.483870967741935
Control.SRR15539874;33;32;0.454545454545455;18;15;0.0454545454545455;0.454545454545455
Control.SRR15539874;29;32;0.517241379310345;14;15;0.0172413793103449;0.482758620689655
Control.SRR15539874;34;32;0.470588235294118;18;16;0.0294117647058824;0.470588235294118
Control.SRR15539874;32;32;0.59375;13;19;0.09375;0.40625
Control.SRR15539874;29;32;0.620689655172414;11;18;0.120689655172414;0.379310344827586
Control.SRR15539874;31;32;0.483870967741935;16;15;0.0161290322580645;0.483870967741935
Control.SRR15539874;36;32;0.583333333333333;15;21;0.0833333333333334;0.416666666666667
Control.SRR15539874;37;32;0.594594594594595;15;22;0.0945945945945946;0.405405405405405
Control.SRR15539874;31;32;0.419354838709677;18;13;0.0806451612903226;0.419354838709677
Control.SRR15539874;31;32;0.516129032258065;15;16;0.0161290322580645;0.483870967741935
Control.SRR15539874;36;32;0.5;18;18;0;0.5
Control.SRR15539874;35;32;0.428571428571429;20;15;0.0714285714285715;0.428571428571429
Control.SRR15539874;37;32;0.432432432432432;21;16;0.0675675675675675;0.432432432432432
Control.SRR15539874;32;32;0.46875;17;15;0.03125;0.46875
Control.SRR15539874;35;32;0.514285714285714;17;18;0.0142857142857142;0.485714285714286
Control.SRR15539874;34;32;0.588235294117647;14;20;0.0882352941176471;0.411764705882353
Control.SRR15539874;29;32;0.379310344827586;18;11;0.120689655172414;0.379310344827586
Control.SRR15539874;32;32;0.4375;18;14;0.0625;0.4375
Control.SRR15539874;30;32;0.433333333333333;17;13;0.0666666666666667;0.433333333333333
Control.SRR15539874;37;32;0.459459459459459;20;17;0.0405405405405405;0.459459459459459
Control.SRR15539874;35;32;0.485714285714286;18;17;0.0142857142857143;0.485714285714286
Control.SRR15539874;37;32;0.486486486486487;19;18;0.0135135135135135;0.486486486486487
Control.SRR15539874;37;32;0.432432432432432;21;16;0.0675675675675675;0.432432432432432
Control.SRR15539874;37;32;0.459459459459459;20;17;0.0405405405405405;0.459459459459459
Control.SRR15539874;36;32;0.694444444444444;11;25;0.194444444444444;0.305555555555556
Control.SRR15539874;33;32;0.636363636363636;12;21;0.136363636363636;0.363636363636364
Control.SRR15539874;32;32;0.59375;13;19;0.09375;0.40625
Control.SRR15539874;34;32;0.470588235294118;18;16;0.0294117647058824;0.470588235294118
Control.SRR15539874;32;32;0.5;16;16;0;0.5
Control.SRR15539874;34;32;0.470588235294118;18;16;0.0294117647058824;0.470588235294118
Control.SRR15539874;33;32;0.393939393939394;20;13;0.106060606060606;0.393939393939394
Control.SRR15539874;35;32;0.371428571428571;22;13;0.128571428571429;0.371428571428571
Control.SRR15539874;37;32;0.486486486486487;19;18;0.0135135135135135;0.486486486486487
Control.SRR15539874;32;32;0.53125;15;17;0.03125;0.46875
Control.SRR15539874;35;32;0.457142857142857;19;16;0.0428571428571429;0.457142857142857
Control.SRR15539874;33;32;0.424242424242424;19;14;0.0757575757575757;0.424242424242424
Control.SRR15539874;32;32;0.59375;13;19;0.09375;0.40625
Control.SRR15539874;32;32;0.46875;17;15;0.03125;0.46875
Control.SRR15539874;36;32;0.555555555555556;16;20;0.0555555555555556;0.444444444444444
Control.SRR15539874;31;32;0.483870967741935;16;15;0.0161290322580645;0.483870967741935
Control.SRR15539874;34;32;0.5;17;17;0;0.5
Control.SRR15539874;33;32;0.575757575757576;14;19;0.0757575757575758;0.424242424242424
Control.SRR15539874;32;32;0.3125;22;10;0.1875;0.3125
Control.SRR15539874;29;32;0.448275862068966;16;13;0.0517241379310345;0.448275862068966
Control.SRR15539874;33;32;0.363636363636364;21;12;0.136363636363636;0.363636363636364
Control.SRR15539874;36;32;0.555555555555556;16;20;0.0555555555555556;0.444444444444444
Control.SRR15539874;30;32;0.6;12;18;0.1;0.4
Control.SRR15539874;29;32;0.586206896551724;12;17;0.0862068965517241;0.413793103448276
Control.SRR15539874;29;32;0.551724137931034;13;16;0.0517241379310345;0.448275862068966
Control.SRR15539874;35;32;0.628571428571429;13;22;0.128571428571429;0.371428571428571
Control.SRR15539874;33;32;0.484848484848485;17;16;0.0151515151515151;0.484848484848485
Control.SRR15539874;29;32;0.551724137931034;13;16;0.0517241379310345;0.448275862068966
Control.SRR15539874;28;32;0.428571428571429;16;12;0.0714285714285715;0.428571428571429
Control.SRR15539874;30;32;0.433333333333333;17;13;0.0666666666666667;0.433333333333333
Control.SRR15539874;28;32;0.678571428571429;9;19;0.178571428571429;0.321428571428571
Control.SRR15539874;36;32;0.5;18;18;0;0.5
Control.SRR15539874;28;32;0.392857142857143;17;11;0.107142857142857;0.392857142857143
Control.SRR15539874;35;32;0.657142857142857;12;23;0.157142857142857;0.342857142857143
Control.SRR15539874;30;32;0.433333333333333;17;13;0.0666666666666667;0.433333333333333
Control.SRR15539874;31;32;0.612903225806452;12;19;0.112903225806452;0.387096774193548
Control.SRR15539874;32;32;0.46875;17;15;0.03125;0.46875
Control.SRR15539874;35;32;0.657142857142857;12;23;0.157142857142857;0.342857142857143
Control.SRR15539874;36;32;0.583333333333333;15;21;0.0833333333333334;0.416666666666667
Control.SRR15539874;32;32;0.4375;18;14;0.0625;0.4375
Control.SRR15539874;28;32;0.357142857142857;18;10;0.142857142857143;0.357142857142857
Control.SRR15539874;31;32;0.516129032258065;15;16;0.0161290322580645;0.483870967741935
Control.SRR15539874;35;32;0.514285714285714;17;18;0.0142857142857142;0.485714285714286
Control.SRR15539874;30;32;0.466666666666667;16;14;0.0333333333333333;0.466666666666667
Control.SRR15539874;29;32;0.517241379310345;14;15;0.0172413793103449;0.482758620689655
Control.SRR15539874;28;32;0.5;14;14;0;0.5
Control.SRR15539874;36;32;0.388888888888889;22;14;0.111111111111111;0.388888888888889
Control.SRR15539874;32;32;0.53125;15;17;0.03125;0.46875
Control.SRR15539874;34;32;0.617647058823529;13;21;0.117647058823529;0.382352941176471
Control.SRR15539874;34;32;0.470588235294118;18;16;0.0294117647058824;0.470588235294118
Control.SRR15539874;30;32;0.4;18;12;0.1;0.4
Control.SRR15539874;30;32;0.566666666666667;13;17;0.0666666666666667;0.433333333333333
Control.SRR15539874;32;32;0.40625;19;13;0.09375;0.40625
Control.SRR15539874;30;32;0.633333333333333;11;19;0.133333333333333;0.366666666666667
Control.SRR15539874;33;32;0.484848484848485;17;16;0.0151515151515151;0.484848484848485
Control.SRR15539874;32;32;0.53125;15;17;0.03125;0.46875
Control.SRR15539874;34;32;0.352941176470588;22;12;0.147058823529412;0.352941176470588
Control.SRR15539874;36;32;0.611111111111111;14;22;0.111111111111111;0.388888888888889
Control.SRR15539874;28;32;0.571428571428571;12;16;0.0714285714285714;0.428571428571429
Control.SRR15539874;35;32;0.428571428571429;20;15;0.0714285714285715;0.428571428571429
Control.SRR15539874;36;32;0.527777777777778;17;19;0.0277777777777778;0.472222222222222
Control.SRR15539874;36;32;0.611111111111111;14;22;0.111111111111111;0.388888888888889
Control.SRR15539874;35;32;0.457142857142857;19;16;0.0428571428571429;0.457142857142857
Control.SRR15539874;35;32;0.4;21;14;0.1;0.4
Control.SRR15539874;31;32;0.580645161290323;13;18;0.0806451612903226;0.419354838709677
Control.SRR15539874;32;32;0.625;12;20;0.125;0.375
Control.SRR15539874;30;32;0.466666666666667;16;14;0.0333333333333333;0.466666666666667
Control.SRR15539874;29;32;0.551724137931034;13;16;0.0517241379310345;0.448275862068966
Control.SRR15539874;29;32;0.482758620689655;15;14;0.0172413793103448;0.482758620689655
Control.SRR15539874;36;32;0.527777777777778;17;19;0.0277777777777778;0.472222222222222
Control.SRR15539874;33;32;0.606060606060606;13;20;0.106060606060606;0.393939393939394
Control.SRR15539874;31;32;0.290322580645161;22;9;0.209677419354839;0.290322580645161
Control.SRR15539874;28;32;0.607142857142857;11;17;0.107142857142857;0.392857142857143
Control.SRR15539874;33;32;0.393939393939394;20;13;0.106060606060606;0.393939393939394
Control.SRR15539874;35;32;0.457142857142857;19;16;0.0428571428571429;0.457142857142857
Control.SRR15539874;34;32;0.558823529411765;15;19;0.0588235294117647;0.441176470588235
Control.SRR15539874;28;32;0.464285714285714;15;13;0.0357142857142857;0.464285714285714
Control.SRR15539874;31;32;0.580645161290323;13;18;0.0806451612903226;0.419354838709677
Control.SRR15539874;31;32;0.451612903225806;17;14;0.0483870967741936;0.451612903225806
Control.SRR15539874;32;32;0.59375;13;19;0.09375;0.40625
Control.SRR15539874;34;32;0.5;17;17;0;0.5
Control.SRR15539874;32;32;0.3125;22;10;0.1875;0.3125
Control.SRR15539874;36;32;0.555555555555556;16;20;0.0555555555555556;0.444444444444444
Control.SRR15539874;28;32;0.428571428571429;16;12;0.0714285714285715;0.428571428571429
Control.SRR15539874;32;32;0.46875;17;15;0.03125;0.46875
Control.SRR15539874;36;32;0.444444444444444;20;16;0.0555555555555556;0.444444444444444
Control.SRR15539874;34;32;0.588235294117647;14;20;0.0882352941176471;0.411764705882353
Control.SRR15539874;31;32;0.483870967741935;16;15;0.0161290322580645;0.483870967741935
Control.SRR15539874;36;32;0.472222222222222;19;17;0.0277777777777778;0.472222222222222
Control.SRR15539874;34;32;0.470588235294118;18;16;0.0294117647058824;0.470588235294118
Control.SRR15539874;33;32;0.424242424242424;19;14;0.0757575757575757;0.424242424242424
Control.SRR15539874;29;32;0.448275862068966;16;13;0.0517241379310345;0.448275862068966
Control.SRR15539874;31;32;0.580645161290323;13;18;0.0806451612903226;0.419354838709677
Control.SRR15539874;29;32;0.517241379310345;14;15;0.0172413793103449;0.482758620689655
Control.SRR15539874;31;32;0.580645161290323;13;18;0.0806451612903226;0.419354838709677
Control.SRR15539874;30;32;0.6;12;18;0.1;0.4
Control.SRR15539874;28;32;0.464285714285714;15;13;0.0357142857142857;0.464285714285714
Control.SRR15539874;29;32;0.586206896551724;12;17;0.0862068965517241;0.413793103448276
Control.SRR15539874;29;32;0.448275862068966;16;13;0.0517241379310345;0.448275862068966
Control.SRR15539874;31;32;0.483870967741935;16;15;0.0161290322580645;0.483870967741935
Control.SRR15539874;32;32;0.5;16;16;0;0.5
Control.SRR15539874;30;32;0.566666666666667;13;17;0.0666666666666667;0.433333333333333
Control.SRR15539874;30;32;0.533333333333333;14;16;0.0333333333333333;0.466666666666667
Control.SRR15539874;28;32;0.464285714285714;15;13;0.0357142857142857;0.464285714285714
Control.SRR15539874;32;32;0.5;16;16;0;0.5
Control.SRR15539874;31;32;0.419354838709677;18;13;0.0806451612903226;0.419354838709677
Control.SRR15539874;36;32;0.583333333333333;15;21;0.0833333333333334;0.416666666666667
Control.SRR15539874;28;32;0.571428571428571;12;16;0.0714285714285714;0.428571428571429
Control.SRR15539874;33;32;0.424242424242424;19;14;0.0757575757575757;0.424242424242424
Control.SRR15539874;29;32;0.655172413793103;10;19;0.155172413793103;0.344827586206897
Control.SRR15539874;32;32;0.5;16;16;0;0.5
Control.SRR15539874;30;32;0.4;18;12;0.1;0.4
Control.SRR15539874;28;32;0.571428571428571;12;16;0.0714285714285714;0.428571428571429
Control.SRR15539874;36;32;0.611111111111111;14;22;0.111111111111111;0.388888888888889
Control.SRR15539874;33;32;0.606060606060606;13;20;0.106060606060606;0.393939393939394
Control.SRR15539874;31;32;0.548387096774194;14;17;0.0483870967741935;0.451612903225806
Control.SRR15539874;30;32;0.466666666666667;16;14;0.0333333333333333;0.466666666666667
Control.SRR15539874;31;32;0.612903225806452;12;19;0.112903225806452;0.387096774193548
Control.SRR15539874;36;32;0.555555555555556;16;20;0.0555555555555556;0.444444444444444
Control.SRR15539874;34;32;0.441176470588235;19;15;0.0588235294117647;0.441176470588235
Control.SRR15539874;33;32;0.484848484848485;17;16;0.0151515151515151;0.484848484848485
Control.SRR15539874;33;32;0.363636363636364;21;12;0.136363636363636;0.363636363636364
Control.SRR15539874;30;32;0.433333333333333;17;13;0.0666666666666667;0.433333333333333
Control.SRR15539874;28;32;0.464285714285714;15;13;0.0357142857142857;0.464285714285714
Control.SRR15539874;28;32;0.607142857142857;11;17;0.107142857142857;0.392857142857143
Control.SRR15539874;33;32;0.515151515151515;16;17;0.0151515151515151;0.484848484848485
Control.SRR15539874;34;32;0.588235294117647;14;20;0.0882352941176471;0.411764705882353
Control.SRR15539874;36;32;0.555555555555556;16;20;0.0555555555555556;0.444444444444444
Control.SRR15539874;28;32;0.678571428571429;9;19;0.178571428571429;0.321428571428571
Control.SRR15539874;33;32;0.666666666666667;11;22;0.166666666666667;0.333333333333333
Control.SRR15539874;36;32;0.416666666666667;21;15;0.0833333333333333;0.416666666666667
Control.SRR15539874;34;32;0.529411764705882;16;18;0.0294117647058824;0.470588235294118
Control.SRR15539874;33;32;0.454545454545455;18;15;0.0454545454545455;0.454545454545455
Control.SRR15539874;29;32;0.448275862068966;16;13;0.0517241379310345;0.448275862068966
Control.SRR15539874;31;32;0.483870967741935;16;15;0.0161290322580645;0.483870967741935
Control.SRR15539874;31;32;0.548387096774194;14;17;0.0483870967741935;0.451612903225806
Control.SRR15539874;28;32;0.607142857142857;11;17;0.107142857142857;0.392857142857143
Control.SRR15539874;30;32;0.433333333333333;17;13;0.0666666666666667;0.433333333333333
Control.SRR15539874;33;32;0.515151515151515;16;17;0.0151515151515151;0.484848484848485
Control.SRR15539874;30;32;0.466666666666667;16;14;0.0333333333333333;0.466666666666667
Control.SRR15539874;28;32;0.428571428571429;16;12;0.0714285714285715;0.428571428571429
Control.SRR15539874;29;32;0.413793103448276;17;12;0.0862068965517241;0.413793103448276
Control.SRR15539874;36;32;0.333333333333333;24;12;0.166666666666667;0.333333333333333
Control.SRR15539874;29;32;0.517241379310345;14;15;0.0172413793103449;0.482758620689655
Control.SRR15539874;33;32;0.424242424242424;19;14;0.0757575757575757;0.424242424242424
Control.SRR15539874;30;32;0.533333333333333;14;16;0.0333333333333333;0.466666666666667
Control.SRR15539874;30;32;0.566666666666667;13;17;0.0666666666666667;0.433333333333333
Control.SRR15539874;30;32;0.5;15;15;0;0.5
Control.SRR15539874;31;32;0.67741935483871;10;21;0.17741935483871;0.32258064516129
Control.SRR15539874;31;32;0.419354838709677;18;13;0.0806451612903226;0.419354838709677
Control.SRR15539874;34;32;0.735294117647059;9;25;0.235294117647059;0.264705882352941
Control.SRR15539874;32;32;0.5625;14;18;0.0625;0.4375
Control.SRR15539874;29;32;0.551724137931034;13;16;0.0517241379310345;0.448275862068966
Control.SRR15539874;28;32;0.571428571428571;12;16;0.0714285714285714;0.428571428571429
Control.SRR15539874;33;32;0.363636363636364;21;12;0.136363636363636;0.363636363636364
Control.SRR15539874;28;32;0.5;14;14;0;0.5
Control.SRR15539874;30;32;0.566666666666667;13;17;0.0666666666666667;0.433333333333333
Control.SRR15539874;32;32;0.625;12;20;0.125;0.375
Control.SRR15539874;28;32;0.285714285714286;20;8;0.214285714285714;0.285714285714286
Control.SRR15539874;32;32;0.5625;14;18;0.0625;0.4375
Control.SRR15539874;33;32;0.515151515151515;16;17;0.0151515151515151;0.484848484848485
Control.SRR15539874;32;32;0.3125;22;10;0.1875;0.3125
Control.SRR15539874;29;32;0.517241379310345;14;15;0.0172413793103449;0.482758620689655
Control.SRR15539874;30;32;0.633333333333333;11;19;0.133333333333333;0.366666666666667
Control.SRR15539874;35;32;0.457142857142857;19;16;0.0428571428571429;0.457142857142857
Control.SRR15539874;30;32;0.466666666666667;16;14;0.0333333333333333;0.466666666666667
Control.SRR15539874;29;32;0.620689655172414;11;18;0.120689655172414;0.379310344827586
Control.SRR15539874;28;32;0.5;14;14;0;0.5
Control.SRR15539874;30;32;0.566666666666667;13;17;0.0666666666666667;0.433333333333333
Control.SRR15539874;32;32;0.46875;17;15;0.03125;0.46875
Control.SRR15539874;29;32;0.379310344827586;18;11;0.120689655172414;0.379310344827586
Control.SRR15539874;34;32;0.558823529411765;15;19;0.0588235294117647;0.441176470588235
Control.SRR15539874;32;32;0.6875;10;22;0.1875;0.3125
Control.SRR15539874;31;32;0.419354838709677;18;13;0.0806451612903226;0.419354838709677
Control.SRR15539874;32;32;0.625;12;20;0.125;0.375
Control.SRR15539874;34;32;0.411764705882353;20;14;0.0882352941176471;0.411764705882353
Control.SRR15539874;29;32;0.448275862068966;16;13;0.0517241379310345;0.448275862068966
Control.SRR15539874;36;32;0.444444444444444;20;16;0.0555555555555556;0.444444444444444
Control.SRR15539874;32;32;0.53125;15;17;0.03125;0.46875
Control.SRR15539874;32;32;0.3125;22;10;0.1875;0.3125
Control.SRR15539874;28;32;0.464285714285714;15;13;0.0357142857142857;0.464285714285714
Control.SRR15539874;35;32;0.428571428571429;20;15;0.0714285714285715;0.428571428571429
Control.SRR15539874;30;32;0.533333333333333;14;16;0.0333333333333333;0.466666666666667
Control.SRR15539874;28;32;0.571428571428571;12;16;0.0714285714285714;0.428571428571429
Control.SRR15539874;33;32;0.515151515151515;16;17;0.0151515151515151;0.484848484848485
Control.SRR15539874;29;32;0.551724137931034;13;16;0.0517241379310345;0.448275862068966
Control.SRR15539874;28;32;0.5;14;14;0;0.5
Control.SRR15539874;32;32;0.46875;17;15;0.03125;0.46875
Control.SRR15539874;33;32;0.606060606060606;13;20;0.106060606060606;0.393939393939394
Control.SRR15539874;28;32;0.5;14;14;0;0.5
Control.SRR15539874;35;32;0.628571428571429;13;22;0.128571428571429;0.371428571428571
Control.SRR15539874;31;32;0.419354838709677;18;13;0.0806451612903226;0.419354838709677
Control.SRR15539874;29;32;0.482758620689655;15;14;0.0172413793103448;0.482758620689655
Control.SRR15539874;34;32;0.617647058823529;13;21;0.117647058823529;0.382352941176471
Control.SRR15539874;31;32;0.645161290322581;11;20;0.145161290322581;0.354838709677419
Control.SRR15539874;34;32;0.529411764705882;16;18;0.0294117647058824;0.470588235294118
Control.SRR15539874;33;32;0.606060606060606;13;20;0.106060606060606;0.393939393939394
Control.SRR15539874;32;32;0.46875;17;15;0.03125;0.46875
Control.SRR15539874;28;32;0.285714285714286;20;8;0.214285714285714;0.285714285714286
Control.SRR15539874;34;32;0.411764705882353;20;14;0.0882352941176471;0.411764705882353
Control.SRR15539874;29;32;0.620689655172414;11;18;0.120689655172414;0.379310344827586
Control.SRR15539874;29;32;0.551724137931034;13;16;0.0517241379310345;0.448275862068966
Control.SRR15539874;34;32;0.470588235294118;18;16;0.0294117647058824;0.470588235294118
Control.SRR15539874;36;32;0.527777777777778;17;19;0.0277777777777778;0.472222222222222
Control.SRR15539874;31;32;0.483870967741935;16;15;0.0161290322580645;0.483870967741935
Control.SRR15539874;34;32;0.647058823529412;12;22;0.147058823529412;0.352941176470588
Control.SRR15539874;32;32;0.4375;18;14;0.0625;0.4375
Control.SRR15539874;35;32;0.6;14;21;0.1;0.4
Control.SRR15539874;35;32;0.457142857142857;19;16;0.0428571428571429;0.457142857142857
Control.SRR15539874;33;32;0.484848484848485;17;16;0.0151515151515151;0.484848484848485
Control.SRR15539874;36;32;0.472222222222222;19;17;0.0277777777777778;0.472222222222222
Control.SRR15539874;28;32;0.5;14;14;0;0.5
Control.SRR15539874;34;32;0.470588235294118;18;16;0.0294117647058824;0.470588235294118
Control.SRR15539874;30;32;0.5;15;15;0;0.5
Control.SRR15539874;28;32;0.535714285714286;13;15;0.0357142857142857;0.464285714285714
Control.SRR15539874;29;32;0.413793103448276;17;12;0.0862068965517241;0.413793103448276
Control.SRR15539874;30;32;0.466666666666667;16;14;0.0333333333333333;0.466666666666667
Control.SRR15539874;32;32;0.40625;19;13;0.09375;0.40625
Control.SRR15539874;31;32;0.580645161290323;13;18;0.0806451612903226;0.419354838709677
Control.SRR15539874;29;32;0.448275862068966;16;13;0.0517241379310345;0.448275862068966
Control.SRR15539874;35;32;0.485714285714286;18;17;0.0142857142857143;0.485714285714286
Control.SRR15539874;30;32;0.4;18;12;0.1;0.4
Control.SRR15539874;35;32;0.657142857142857;12;23;0.157142857142857;0.342857142857143
Control.SRR15539874;32;32;0.5625;14;18;0.0625;0.4375
Control.SRR15539874;36;32;0.583333333333333;15;21;0.0833333333333334;0.416666666666667
Control.SRR15539874;34;32;0.588235294117647;14;20;0.0882352941176471;0.411764705882353
Control.SRR15539874;33;32;0.515151515151515;16;17;0.0151515151515151;0.484848484848485
Control.SRR15539874;36;32;0.416666666666667;21;15;0.0833333333333333;0.416666666666667
Control.SRR15539874;35;32;0.428571428571429;20;15;0.0714285714285715;0.428571428571429
Control.SRR15539874;34;32;0.647058823529412;12;22;0.147058823529412;0.352941176470588
Control.SRR15539874;31;32;0.451612903225806;17;14;0.0483870967741936;0.451612903225806
Control.SRR15539874;36;32;0.611111111111111;14;22;0.111111111111111;0.388888888888889
Control.SRR15539874;33;32;0.545454545454545;15;18;0.0454545454545454;0.454545454545455
Control.SRR15539874;31;32;0.451612903225806;17;14;0.0483870967741936;0.451612903225806
Control.SRR15539874;33;32;0.515151515151515;16;17;0.0151515151515151;0.484848484848485
Control.SRR15539874;29;32;0.413793103448276;17;12;0.0862068965517241;0.413793103448276
Control.SRR15539874;30;32;0.433333333333333;17;13;0.0666666666666667;0.433333333333333
Control.SRR15539874;30;32;0.533333333333333;14;16;0.0333333333333333;0.466666666666667
Control.SRR15539874;30;32;0.533333333333333;14;16;0.0333333333333333;0.466666666666667
Control.SRR15539874;34;32;0.529411764705882;16;18;0.0294117647058824;0.470588235294118
Control.SRR15539874;33;32;0.515151515151515;16;17;0.0151515151515151;0.484848484848485
Control.SRR15539874;33;32;0.515151515151515;16;17;0.0151515151515151;0.484848484848485
Control.SRR15539874;36;32;0.555555555555556;16;20;0.0555555555555556;0.444444444444444
Control.SRR15539874;31;32;0.548387096774194;14;17;0.0483870967741935;0.451612903225806
Control.SRR15539874;33;32;0.575757575757576;14;19;0.0757575757575758;0.424242424242424
Control.SRR15539874;30;32;0.4;18;12;0.1;0.4
Control.SRR15539874;34;32;0.470588235294118;18;16;0.0294117647058824;0.470588235294118
Control.SRR15539874;36;32;0.472222222222222;19;17;0.0277777777777778;0.472222222222222
Control.SRR15539874;34;32;0.676470588235294;11;23;0.176470588235294;0.323529411764706
Control.SRR15539874;29;32;0.551724137931034;13;16;0.0517241379310345;0.448275862068966
Control.SRR15539874;29;32;0.551724137931034;13;16;0.0517241379310345;0.448275862068966
Control.SRR15539874;33;32;0.363636363636364;21;12;0.136363636363636;0.363636363636364
Control.SRR15539874;30;32;0.533333333333333;14;16;0.0333333333333333;0.466666666666667
Control.SRR15539874;31;32;0.548387096774194;14;17;0.0483870967741935;0.451612903225806
Control.SRR15539874;35;32;0.342857142857143;23;12;0.157142857142857;0.342857142857143
Control.SRR15539874;33;32;0.515151515151515;16;17;0.0151515151515151;0.484848484848485
Control.SRR15539874;35;32;0.428571428571429;20;15;0.0714285714285715;0.428571428571429
Control.SRR15539874;33;32;0.424242424242424;19;14;0.0757575757575757;0.424242424242424
Control.SRR15539874;30;32;0.466666666666667;16;14;0.0333333333333333;0.466666666666667
Control.SRR15539874;35;32;0.314285714285714;24;11;0.185714285714286;0.314285714285714
Control.SRR15539874;36;32;0.472222222222222;19;17;0.0277777777777778;0.472222222222222
Control.SRR15539874;34;32;0.529411764705882;16;18;0.0294117647058824;0.470588235294118
Control.SRR15539874;34;32;0.529411764705882;16;18;0.0294117647058824;0.470588235294118
Control.SRR15539874;36;32;0.472222222222222;19;17;0.0277777777777778;0.472222222222222
Control.SRR15539874;29;32;0.517241379310345;14;15;0.0172413793103449;0.482758620689655
Control.SRR15539874;33;32;0.484848484848485;17;16;0.0151515151515151;0.484848484848485
Control.SRR15539874;36;32;0.472222222222222;19;17;0.0277777777777778;0.472222222222222
Control.SRR15539874;30;32;0.533333333333333;14;16;0.0333333333333333;0.466666666666667
Control.SRR15539874;36;32;0.555555555555556;16;20;0.0555555555555556;0.444444444444444
Control.SRR15539874;30;32;0.5;15;15;0;0.5
Control.SRR15539874;32;32;0.625;12;20;0.125;0.375
Control.SRR15539874;36;32;0.388888888888889;22;14;0.111111111111111;0.388888888888889
Control.SRR15539874;28;32;0.535714285714286;13;15;0.0357142857142857;0.464285714285714
Control.SRR15539874;33;32;0.515151515151515;16;17;0.0151515151515151;0.484848484848485
Control.SRR15539874;36;32;0.611111111111111;14;22;0.111111111111111;0.388888888888889
Control.SRR15539874;36;32;0.5;18;18;0;0.5
Control.SRR15539874;33;32;0.363636363636364;21;12;0.136363636363636;0.363636363636364
Control.SRR15539874;34;32;0.411764705882353;20;14;0.0882352941176471;0.411764705882353
Control.SRR15539874;33;32;0.393939393939394;20;13;0.106060606060606;0.393939393939394
Control.SRR15539874;30;32;0.4;18;12;0.1;0.4
Control.SRR15539874;28;32;0.464285714285714;15;13;0.0357142857142857;0.464285714285714
Control.SRR15539874;30;32;0.466666666666667;16;14;0.0333333333333333;0.466666666666667
Control.SRR15539874;36;32;0.583333333333333;15;21;0.0833333333333334;0.416666666666667
Control.SRR15539874;33;32;0.333333333333333;22;11;0.166666666666667;0.333333333333333
Control.SRR15539874;32;32;0.46875;17;15;0.03125;0.46875
Control.SRR15539874;30;32;0.533333333333333;14;16;0.0333333333333333;0.466666666666667
Control.SRR15539874;34;32;0.5;17;17;0;0.5
Control.SRR15539874;30;32;0.5;15;15;0;0.5
Control.SRR15539874;29;32;0.448275862068966;16;13;0.0517241379310345;0.448275862068966
Control.SRR15539874;29;32;0.551724137931034;13;16;0.0517241379310345;0.448275862068966
Control.SRR15539874;31;32;0.451612903225806;17;14;0.0483870967741936;0.451612903225806
Control.SRR15539874;28;32;0.535714285714286;13;15;0.0357142857142857;0.464285714285714
Control.SRR15539874;28;32;0.571428571428571;12;16;0.0714285714285714;0.428571428571429
Control.SRR15539874;34;32;0.5;17;17;0;0.5
Control.SRR15539874;32;32;0.59375;13;19;0.09375;0.40625
Control.SRR15539874;28;32;0.25;21;7;0.25;0.25
Control.SRR15539874;28;32;0.464285714285714;15;13;0.0357142857142857;0.464285714285714
Control.SRR15539874;29;32;0.586206896551724;12;17;0.0862068965517241;0.413793103448276
Control.SRR15539874;36;32;0.388888888888889;22;14;0.111111111111111;0.388888888888889
Control.SRR15539874;36;32;0.555555555555556;16;20;0.0555555555555556;0.444444444444444
Control.SRR15539874;35;32;0.514285714285714;17;18;0.0142857142857142;0.485714285714286
Control.SRR15539874;33;32;0.484848484848485;17;16;0.0151515151515151;0.484848484848485
Control.SRR15539874;36;32;0.555555555555556;16;20;0.0555555555555556;0.444444444444444
Control.SRR15539874;33;32;0.363636363636364;21;12;0.136363636363636;0.363636363636364
Control.SRR15539874;36;32;0.444444444444444;20;16;0.0555555555555556;0.444444444444444
Control.SRR15539874;34;32;0.5;17;17;0;0.5
Control.SRR15539874;31;32;0.612903225806452;12;19;0.112903225806452;0.387096774193548
Control.SRR15539874;29;32;0.586206896551724;12;17;0.0862068965517241;0.413793103448276
Control.SRR15539874;30;32;0.7;9;21;0.2;0.3
Control.SRR15539874;36;32;0.416666666666667;21;15;0.0833333333333333;0.416666666666667
Control.SRR15539874;30;32;0.566666666666667;13;17;0.0666666666666667;0.433333333333333
Control.SRR15539874;35;32;0.571428571428571;15;20;0.0714285714285714;0.428571428571429
Control.SRR15539874;34;32;0.588235294117647;14;20;0.0882352941176471;0.411764705882353
Control.SRR15539874;33;32;0.484848484848485;17;16;0.0151515151515151;0.484848484848485
Control.SRR15539874;35;32;0.371428571428571;22;13;0.128571428571429;0.371428571428571
Control.SRR15539874;29;32;0.448275862068966;16;13;0.0517241379310345;0.448275862068966
Control.SRR15539874;30;32;0.5;15;15;0;0.5
Control.SRR15539874;28;32;0.428571428571429;16;12;0.0714285714285715;0.428571428571429
Control.SRR15539874;32;32;0.59375;13;19;0.09375;0.40625
Control.SRR15539874;30;32;0.333333333333333;20;10;0.166666666666667;0.333333333333333
Control.SRR15539874;33;32;0.636363636363636;12;21;0.136363636363636;0.363636363636364
Control.SRR15539874;36;32;0.5;18;18;0;0.5
Control.SRR15539874;30;32;0.5;15;15;0;0.5
Control.SRR15539874;32;32;0.53125;15;17;0.03125;0.46875
Control.SRR15539874;36;32;0.527777777777778;17;19;0.0277777777777778;0.472222222222222
Control.SRR15539874;34;32;0.382352941176471;21;13;0.117647058823529;0.382352941176471
Control.SRR15539874;31;32;0.483870967741935;16;15;0.0161290322580645;0.483870967741935
Control.SRR15539874;36;32;0.5;18;18;0;0.5
Control.SRR15539874;36;32;0.583333333333333;15;21;0.0833333333333334;0.416666666666667
Control.SRR15539874;36;32;0.583333333333333;15;21;0.0833333333333334;0.416666666666667
Control.SRR15539874;35;32;0.6;14;21;0.1;0.4
Control.SRR15539874;35;32;0.371428571428571;22;13;0.128571428571429;0.371428571428571
Control.SRR15539874;36;32;0.388888888888889;22;14;0.111111111111111;0.388888888888889
Control.SRR15539874;31;32;0.516129032258065;15;16;0.0161290322580645;0.483870967741935
Control.SRR15539874;32;32;0.5625;14;18;0.0625;0.4375
Control.SRR15539874;32;32;0.59375;13;19;0.09375;0.40625
Control.SRR15539874;31;32;0.580645161290323;13;18;0.0806451612903226;0.419354838709677
Control.SRR15539874;34;32;0.5;17;17;0;0.5
Control.SRR15539874;35;32;0.514285714285714;17;18;0.0142857142857142;0.485714285714286
Control.SRR15539874;32;32;0.46875;17;15;0.03125;0.46875
Control.SRR15539874;31;32;0.67741935483871;10;21;0.17741935483871;0.32258064516129
Control.SRR15539874;33;32;0.545454545454545;15;18;0.0454545454545454;0.454545454545455
Control.SRR15539874;34;32;0.647058823529412;12;22;0.147058823529412;0.352941176470588
Control.SRR15539874;31;32;0.419354838709677;18;13;0.0806451612903226;0.419354838709677
Control.SRR15539874;31;32;0.612903225806452;12;19;0.112903225806452;0.387096774193548
Control.SRR15539874;35;32;0.6;14;21;0.1;0.4
Control.SRR15539874;32;32;0.5625;14;18;0.0625;0.4375
Control.SRR15539874;35;32;0.314285714285714;24;11;0.185714285714286;0.314285714285714
Control.SRR15539874;34;32;0.411764705882353;20;14;0.0882352941176471;0.411764705882353
Control.SRR15539874;35;32;0.514285714285714;17;18;0.0142857142857142;0.485714285714286
Control.SRR15539874;32;32;0.4375;18;14;0.0625;0.4375
Control.SRR15539874;33;32;0.303030303030303;23;10;0.196969696969697;0.303030303030303
Control.SRR15539874;36;32;0.472222222222222;19;17;0.0277777777777778;0.472222222222222
Control.SRR15539874;34;32;0.441176470588235;19;15;0.0588235294117647;0.441176470588235
Control.SRR15539874;36;32;0.611111111111111;14;22;0.111111111111111;0.388888888888889
Control.SRR15539874;35;32;0.4;21;14;0.1;0.4
Control.SRR15539874;28;32;0.464285714285714;15;13;0.0357142857142857;0.464285714285714
Control.SRR15539874;31;32;0.516129032258065;15;16;0.0161290322580645;0.483870967741935
Control.SRR15539874;29;32;0.517241379310345;14;15;0.0172413793103449;0.482758620689655
Control.SRR15539874;31;32;0.451612903225806;17;14;0.0483870967741936;0.451612903225806
Control.SRR15539874;31;32;0.67741935483871;10;21;0.17741935483871;0.32258064516129
Control.SRR15539874;32;32;0.5625;14;18;0.0625;0.4375
Control.SRR15539874;31;32;0.451612903225806;17;14;0.0483870967741936;0.451612903225806
Control.SRR15539874;31;32;0.580645161290323;13;18;0.0806451612903226;0.419354838709677
Control.SRR15539874;28;32;0.321428571428571;19;9;0.178571428571429;0.321428571428571
Control.SRR15539874;33;32;0.575757575757576;14;19;0.0757575757575758;0.424242424242424
Control.SRR15539874;35;32;0.571428571428571;15;20;0.0714285714285714;0.428571428571429
Control.SRR15539874;31;32;0.548387096774194;14;17;0.0483870967741935;0.451612903225806
Control.SRR15539874;29;32;0.344827586206897;19;10;0.155172413793103;0.344827586206897
Control.SRR15539874;31;32;0.645161290322581;11;20;0.145161290322581;0.354838709677419
Control.SRR15539874;35;32;0.571428571428571;15;20;0.0714285714285714;0.428571428571429
Control.SRR15539874;29;32;0.517241379310345;14;15;0.0172413793103449;0.482758620689655
Control.SRR15539874;35;32;0.6;14;21;0.1;0.4
Control.SRR15539874;33;32;0.484848484848485;17;16;0.0151515151515151;0.484848484848485
Control.SRR15539874;33;32;0.515151515151515;16;17;0.0151515151515151;0.484848484848485
Control.SRR15539874;36;32;0.388888888888889;22;14;0.111111111111111;0.388888888888889
Control.SRR15539874;35;32;0.4;21;14;0.1;0.4
Control.SRR15539874;31;32;0.419354838709677;18;13;0.0806451612903226;0.419354838709677
Control.SRR15539874;30;32;0.333333333333333;20;10;0.166666666666667;0.333333333333333
Control.SRR15539874;32;32;0.65625;11;21;0.15625;0.34375
Control.SRR15539874;35;32;0.457142857142857;19;16;0.0428571428571429;0.457142857142857
Control.SRR15539874;34;32;0.558823529411765;15;19;0.0588235294117647;0.441176470588235
Control.SRR15539874;35;32;0.571428571428571;15;20;0.0714285714285714;0.428571428571429
Control.SRR15539874;36;32;0.611111111111111;14;22;0.111111111111111;0.388888888888889
Control.SRR15539874;31;32;0.645161290322581;11;20;0.145161290322581;0.354838709677419
Control.SRR15539874;31;32;0.516129032258065;15;16;0.0161290322580645;0.483870967741935
Control.SRR15539874;32;32;0.625;12;20;0.125;0.375
Control.SRR15539874;34;32;0.558823529411765;15;19;0.0588235294117647;0.441176470588235
Control.SRR15539874;28;32;0.428571428571429;16;12;0.0714285714285715;0.428571428571429
Control.SRR15539874;28;32;0.392857142857143;17;11;0.107142857142857;0.392857142857143
Control.SRR15539874;35;32;0.485714285714286;18;17;0.0142857142857143;0.485714285714286
Control.SRR15539874;35;32;0.685714285714286;11;24;0.185714285714286;0.314285714285714
Control.SRR15539874;28;32;0.678571428571429;9;19;0.178571428571429;0.321428571428571
Control.SRR15539874;34;32;0.647058823529412;12;22;0.147058823529412;0.352941176470588
Control.SRR15539874;28;32;0.428571428571429;16;12;0.0714285714285715;0.428571428571429
Control.SRR15539874;35;32;0.514285714285714;17;18;0.0142857142857142;0.485714285714286
Control.SRR15539874;32;32;0.40625;19;13;0.09375;0.40625
Control.SRR15539874;31;32;0.548387096774194;14;17;0.0483870967741935;0.451612903225806
Control.SRR15539874;34;32;0.411764705882353;20;14;0.0882352941176471;0.411764705882353
Control.SRR15539874;34;32;0.470588235294118;18;16;0.0294117647058824;0.470588235294118
Control.SRR15539874;33;32;0.424242424242424;19;14;0.0757575757575757;0.424242424242424
Control.SRR15539874;32;32;0.46875;17;15;0.03125;0.46875
Control.SRR15539874;32;32;0.40625;19;13;0.09375;0.40625
Control.SRR15539874;34;32;0.352941176470588;22;12;0.147058823529412;0.352941176470588
Control.SRR15539874;33;32;0.696969696969697;10;23;0.196969696969697;0.303030303030303
Control.SRR15539874;32;32;0.53125;15;17;0.03125;0.46875
Control.SRR15539874;28;32;0.464285714285714;15;13;0.0357142857142857;0.464285714285714
Control.SRR15539874;32;32;0.59375;13;19;0.09375;0.40625
Control.SRR15539874;33;32;0.484848484848485;17;16;0.0151515151515151;0.484848484848485
Control.SRR15539874;30;32;0.566666666666667;13;17;0.0666666666666667;0.433333333333333
Control.SRR15539874;31;32;0.451612903225806;17;14;0.0483870967741936;0.451612903225806
Control.SRR15539874;30;32;0.466666666666667;16;14;0.0333333333333333;0.466666666666667
Control.SRR15539874;30;32;0.533333333333333;14;16;0.0333333333333333;0.466666666666667
Control.SRR15539874;34;32;0.5;17;17;0;0.5
Control.SRR15539874;35;32;0.485714285714286;18;17;0.0142857142857143;0.485714285714286
Control.SRR15539874;28;32;0.5;14;14;0;0.5
Control.SRR15539874;28;32;0.5;14;14;0;0.5
Control.SRR15539874;35;32;0.6;14;21;0.1;0.4
Control.SRR15539874;30;32;0.533333333333333;14;16;0.0333333333333333;0.466666666666667
Control.SRR15539874;31;32;0.645161290322581;11;20;0.145161290322581;0.354838709677419
Control.SRR15539874;34;32;0.5;17;17;0;0.5
Control.SRR15539874;34;32;0.676470588235294;11;23;0.176470588235294;0.323529411764706
Control.SRR15539874;35;32;0.485714285714286;18;17;0.0142857142857143;0.485714285714286
Control.SRR15539874;39;32;0.487179487179487;20;19;0.0128205128205128;0.487179487179487
Control.SRR15539874;32;32;0.5;16;16;0;0.5
Control.SRR15539874;35;32;0.457142857142857;19;16;0.0428571428571429;0.457142857142857
Control.SRR15539874;33;32;0.606060606060606;13;20;0.106060606060606;0.393939393939394
Control.SRR15539874;33;32;0.484848484848485;17;16;0.0151515151515151;0.484848484848485
Control.SRR15539874;37;32;0.648648648648649;13;24;0.148648648648649;0.351351351351351
Control.SRR15539874;32;32;0.53125;15;17;0.03125;0.46875
Control.SRR15539874;30;32;0.5;15;15;0;0.5
Control.SRR15539874;39;32;0.512820512820513;19;20;0.0128205128205128;0.487179487179487
Control.SRR15539874;36;32;0.388888888888889;22;14;0.111111111111111;0.388888888888889
Control.SRR15539874;29;32;0.413793103448276;17;12;0.0862068965517241;0.413793103448276
Control.SRR15539874;36;32;0.472222222222222;19;17;0.0277777777777778;0.472222222222222
Control.SRR15539874;32;32;0.5625;14;18;0.0625;0.4375
Control.SRR15539874;33;32;0.424242424242424;19;14;0.0757575757575757;0.424242424242424
Control.SRR15539874;32;32;0.46875;17;15;0.03125;0.46875
Control.SRR15539874;35;32;0.542857142857143;16;19;0.0428571428571428;0.457142857142857
Control.SRR15539874;34;32;0.5;17;17;0;0.5
Control.SRR15539874;30;32;0.533333333333333;14;16;0.0333333333333333;0.466666666666667
Control.SRR15539874;32;32;0.5625;14;18;0.0625;0.4375
Control.SRR15539874;30;32;0.633333333333333;11;19;0.133333333333333;0.366666666666667
Control.SRR15539874;33;32;0.454545454545455;18;15;0.0454545454545455;0.454545454545455
Control.SRR15539874;32;32;0.53125;15;17;0.03125;0.46875
Control.SRR15539874;31;32;0.451612903225806;17;14;0.0483870967741936;0.451612903225806
Control.SRR15539874;35;32;0.428571428571429;20;15;0.0714285714285715;0.428571428571429
Control.SRR15539874;32;32;0.59375;13;19;0.09375;0.40625
Control.SRR15539874;36;32;0.388888888888889;22;14;0.111111111111111;0.388888888888889
Control.SRR15539874;29;32;0.482758620689655;15;14;0.0172413793103448;0.482758620689655
Control.SRR15539874;33;32;0.363636363636364;21;12;0.136363636363636;0.363636363636364
Control.SRR15539874;33;32;0.575757575757576;14;19;0.0757575757575758;0.424242424242424
Control.SRR15539874;31;32;0.419354838709677;18;13;0.0806451612903226;0.419354838709677
Control.SRR15539874;34;32;0.529411764705882;16;18;0.0294117647058824;0.470588235294118
Control.SRR15539874;39;32;0.487179487179487;20;19;0.0128205128205128;0.487179487179487
Control.SRR15539874;39;32;0.435897435897436;22;17;0.0641025641025641;0.435897435897436
Control.SRR15539874;33;32;0.666666666666667;11;22;0.166666666666667;0.333333333333333
Control.SRR15539874;33;32;0.606060606060606;13;20;0.106060606060606;0.393939393939394
Control.SRR15539874;30;32;0.566666666666667;13;17;0.0666666666666667;0.433333333333333
Control.SRR15539874;35;32;0.485714285714286;18;17;0.0142857142857143;0.485714285714286
Control.SRR15539874;30;32;0.333333333333333;20;10;0.166666666666667;0.333333333333333
Control.SRR15539874;35;32;0.457142857142857;19;16;0.0428571428571429;0.457142857142857
Control.SRR15539874;34;32;0.5;17;17;0;0.5
Control.SRR15539874;38;32;0.421052631578947;22;16;0.0789473684210527;0.421052631578947
Control.SRR15539874;32;32;0.53125;15;17;0.03125;0.46875
Control.SRR15539874;30;32;0.466666666666667;16;14;0.0333333333333333;0.466666666666667
Control.SRR15539874;34;32;0.411764705882353;20;14;0.0882352941176471;0.411764705882353
Control.SRR15539874;32;32;0.59375;13;19;0.09375;0.40625
Control.SRR15539874;35;32;0.571428571428571;15;20;0.0714285714285714;0.428571428571429
Control.SRR15539874;34;32;0.529411764705882;16;18;0.0294117647058824;0.470588235294118
Control.SRR15539874;31;32;0.451612903225806;17;14;0.0483870967741936;0.451612903225806
Control.SRR15539874;38;32;0.473684210526316;20;18;0.0263157894736842;0.473684210526316
Control.SRR15539874;34;32;0.411764705882353;20;14;0.0882352941176471;0.411764705882353
Control.SRR15539874;39;32;0.461538461538462;21;18;0.0384615384615384;0.461538461538462
Control.SRR15539874;39;32;0.435897435897436;22;17;0.0641025641025641;0.435897435897436
Control.SRR15539874;36;32;0.583333333333333;15;21;0.0833333333333334;0.416666666666667
Control.SRR15539874;32;32;0.4375;18;14;0.0625;0.4375
Control.SRR15539874;33;32;0.484848484848485;17;16;0.0151515151515151;0.484848484848485
Control.SRR15539874;32;32;0.5;16;16;0;0.5
Control.SRR15539874;35;32;0.6;14;21;0.1;0.4
Control.SRR15539874;36;32;0.555555555555556;16;20;0.0555555555555556;0.444444444444444
Control.SRR15539874;31;32;0.612903225806452;12;19;0.112903225806452;0.387096774193548
Control.SRR15539874;35;32;0.485714285714286;18;17;0.0142857142857143;0.485714285714286
Control.SRR15539874;36;32;0.527777777777778;17;19;0.0277777777777778;0.472222222222222
Control.SRR15539874;30;32;0.366666666666667;19;11;0.133333333333333;0.366666666666667
Control.SRR15539874;32;32;0.625;12;20;0.125;0.375
Control.SRR15539874;38;32;0.552631578947368;17;21;0.0526315789473685;0.447368421052632
Control.SRR15539874;35;32;0.428571428571429;20;15;0.0714285714285715;0.428571428571429
Control.SRR15539874;35;32;0.514285714285714;17;18;0.0142857142857142;0.485714285714286
Control.SRR15539874;33;32;0.363636363636364;21;12;0.136363636363636;0.363636363636364
Control.SRR15539874;29;32;0.379310344827586;18;11;0.120689655172414;0.379310344827586
Control.SRR15539874;31;32;0.483870967741935;16;15;0.0161290322580645;0.483870967741935
Control.SRR15539874;38;32;0.421052631578947;22;16;0.0789473684210527;0.421052631578947
Control.SRR15539874;33;32;0.484848484848485;17;16;0.0151515151515151;0.484848484848485
Control.SRR15539874;32;32;0.5;16;16;0;0.5
Control.SRR15539874;30;32;0.333333333333333;20;10;0.166666666666667;0.333333333333333
Control.SRR15539874;37;32;0.459459459459459;20;17;0.0405405405405405;0.459459459459459
Control.SRR15539874;30;32;0.433333333333333;17;13;0.0666666666666667;0.433333333333333
Control.SRR15539874;39;32;0.435897435897436;22;17;0.0641025641025641;0.435897435897436
Control.SRR15539874;38;32;0.421052631578947;22;16;0.0789473684210527;0.421052631578947
Control.SRR15539874;30;32;0.4;18;12;0.1;0.4
Control.SRR15539874;37;32;0.540540540540541;17;20;0.0405405405405406;0.459459459459459
Control.SRR15539874;30;32;0.5;15;15;0;0.5
Control.SRR15539874;32;32;0.59375;13;19;0.09375;0.40625
Control.SRR15539874;32;32;0.46875;17;15;0.03125;0.46875
Control.SRR15539874;32;32;0.5;16;16;0;0.5
Control.SRR15539874;36;32;0.527777777777778;17;19;0.0277777777777778;0.472222222222222
Control.SRR15539874;29;32;0.344827586206897;19;10;0.155172413793103;0.344827586206897
Control.SRR15539874;39;32;0.512820512820513;19;20;0.0128205128205128;0.487179487179487
Control.SRR15539874;35;32;0.542857142857143;16;19;0.0428571428571428;0.457142857142857
Control.SRR15539874;33;32;0.545454545454545;15;18;0.0454545454545454;0.454545454545455
Control.SRR15539874;37;32;0.405405405405405;22;15;0.0945945945945946;0.405405405405405
Control.SRR15539874;36;32;0.472222222222222;19;17;0.0277777777777778;0.472222222222222
Control.SRR15539874;34;32;0.411764705882353;20;14;0.0882352941176471;0.411764705882353
Control.SRR15539874;30;32;0.633333333333333;11;19;0.133333333333333;0.366666666666667
Control.SRR15539874;39;32;0.358974358974359;25;14;0.141025641025641;0.358974358974359
Control.SRR15539874;33;32;0.515151515151515;16;17;0.0151515151515151;0.484848484848485
Control.SRR15539874;29;32;0.413793103448276;17;12;0.0862068965517241;0.413793103448276
Control.SRR15539874;37;32;0.459459459459459;20;17;0.0405405405405405;0.459459459459459
Control.SRR15539874;29;32;0.517241379310345;14;15;0.0172413793103449;0.482758620689655
Control.SRR15539874;34;32;0.5;17;17;0;0.5
Control.SRR15539874;36;32;0.5;18;18;0;0.5
Control.SRR15539874;30;32;0.633333333333333;11;19;0.133333333333333;0.366666666666667
Control.SRR15539874;33;32;0.484848484848485;17;16;0.0151515151515151;0.484848484848485
Control.SRR15539874;37;32;0.486486486486487;19;18;0.0135135135135135;0.486486486486487
Control.SRR15539874;31;32;0.548387096774194;14;17;0.0483870967741935;0.451612903225806
Control.SRR15539874;32;32;0.5625;14;18;0.0625;0.4375
Control.SRR15539874;31;32;0.548387096774194;14;17;0.0483870967741935;0.451612903225806
Control.SRR15539874;38;32;0.5;19;19;0;0.5
Control.SRR15539874;38;32;0.631578947368421;14;24;0.131578947368421;0.368421052631579
Control.SRR15539874;39;32;0.487179487179487;20;19;0.0128205128205128;0.487179487179487
Control.SRR15539874;31;32;0.387096774193548;19;12;0.112903225806452;0.387096774193548
Control.SRR15539874;29;32;0.586206896551724;12;17;0.0862068965517241;0.413793103448276
Control.SRR15539874;34;32;0.529411764705882;16;18;0.0294117647058824;0.470588235294118
Control.SRR15539874;34;32;0.411764705882353;20;14;0.0882352941176471;0.411764705882353
Control.SRR15539874;29;32;0.482758620689655;15;14;0.0172413793103448;0.482758620689655
Control.SRR15539874;30;32;0.566666666666667;13;17;0.0666666666666667;0.433333333333333
Control.SRR15539874;32;32;0.4375;18;14;0.0625;0.4375
Control.SRR15539874;36;32;0.444444444444444;20;16;0.0555555555555556;0.444444444444444
Control.SRR15539874;37;32;0.594594594594595;15;22;0.0945945945945946;0.405405405405405
Control.SRR15539874;29;32;0.586206896551724;12;17;0.0862068965517241;0.413793103448276
Control.SRR15539874;31;32;0.483870967741935;16;15;0.0161290322580645;0.483870967741935
Control.SRR15539874;32;32;0.59375;13;19;0.09375;0.40625
Control.SRR15539874;35;32;0.485714285714286;18;17;0.0142857142857143;0.485714285714286
Control.SRR15539874;31;32;0.483870967741935;16;15;0.0161290322580645;0.483870967741935
Control.SRR15539874;30;32;0.533333333333333;14;16;0.0333333333333333;0.466666666666667
Control.SRR15539874;30;32;0.5;15;15;0;0.5
Control.SRR15539874;30;32;0.5;15;15;0;0.5
Control.SRR15539874;38;32;0.315789473684211;26;12;0.184210526315789;0.315789473684211
Control.SRR15539874;36;32;0.5;18;18;0;0.5
Control.SRR15539874;32;32;0.28125;23;9;0.21875;0.28125
Control.SRR15539874;33;32;0.515151515151515;16;17;0.0151515151515151;0.484848484848485
Control.SRR15539874;30;32;0.5;15;15;0;0.5
Control.SRR15539874;34;32;0.441176470588235;19;15;0.0588235294117647;0.441176470588235
Control.SRR15539874;29;32;0.620689655172414;11;18;0.120689655172414;0.379310344827586
Control.SRR15539874;36;32;0.555555555555556;16;20;0.0555555555555556;0.444444444444444
Control.SRR15539874;35;32;0.428571428571429;20;15;0.0714285714285715;0.428571428571429
Control.SRR15539874;34;32;0.5;17;17;0;0.5
Control.SRR15539874;39;32;0.41025641025641;23;16;0.0897435897435898;0.41025641025641
Control.SRR15539874;36;32;0.583333333333333;15;21;0.0833333333333334;0.416666666666667
Control.SRR15539874;32;32;0.34375;21;11;0.15625;0.34375
Control.SRR15539874;32;32;0.46875;17;15;0.03125;0.46875
Control.SRR15539874;34;32;0.558823529411765;15;19;0.0588235294117647;0.441176470588235
Control.SRR15539874;37;32;0.459459459459459;20;17;0.0405405405405405;0.459459459459459
Control.SRR15539874;37;32;0.459459459459459;20;17;0.0405405405405405;0.459459459459459
Control.SRR15539874;31;32;0.612903225806452;12;19;0.112903225806452;0.387096774193548
Control.SRR15539874;33;32;0.636363636363636;12;21;0.136363636363636;0.363636363636364
Control.SRR15539874;32;32;0.46875;17;15;0.03125;0.46875
Control.SRR15539874;39;32;0.435897435897436;22;17;0.0641025641025641;0.435897435897436
Control.SRR15539874;35;32;0.514285714285714;17;18;0.0142857142857142;0.485714285714286
Control.SRR15539874;34;32;0.588235294117647;14;20;0.0882352941176471;0.411764705882353
Control.SRR15539874;32;32;0.5625;14;18;0.0625;0.4375
Control.SRR15539874;31;32;0.612903225806452;12;19;0.112903225806452;0.387096774193548
Control.SRR15539874;32;32;0.5625;14;18;0.0625;0.4375
Control.SRR15539874;31;32;0.290322580645161;22;9;0.209677419354839;0.290322580645161
Control.SRR15539874;33;32;0.363636363636364;21;12;0.136363636363636;0.363636363636364
Control.SRR15539874;35;32;0.571428571428571;15;20;0.0714285714285714;0.428571428571429
Control.SRR15539874;36;32;0.527777777777778;17;19;0.0277777777777778;0.472222222222222
Control.SRR15539874;31;32;0.67741935483871;10;21;0.17741935483871;0.32258064516129
Control.SRR15539874;39;32;0.461538461538462;21;18;0.0384615384615384;0.461538461538462
Control.SRR15539874;32;32;0.625;12;20;0.125;0.375
Control.SRR15539874;32;32;0.46875;17;15;0.03125;0.46875
Control.SRR15539874;33;32;0.636363636363636;12;21;0.136363636363636;0.363636363636364
Control.SRR15539874;38;32;0.657894736842105;13;25;0.157894736842105;0.342105263157895
Control.SRR15539874;29;32;0.448275862068966;16;13;0.0517241379310345;0.448275862068966
Control.SRR15539874;38;32;0.473684210526316;20;18;0.0263157894736842;0.473684210526316
Control.SRR15539874;38;32;0.631578947368421;14;24;0.131578947368421;0.368421052631579
Control.SRR15539874;33;32;0.363636363636364;21;12;0.136363636363636;0.363636363636364
Control.SRR15539874;31;32;0.612903225806452;12;19;0.112903225806452;0.387096774193548
Control.SRR15539874;39;32;0.307692307692308;27;12;0.192307692307692;0.307692307692308
Control.SRR15539874;37;32;0.405405405405405;22;15;0.0945945945945946;0.405405405405405
Control.SRR15539874;30;32;0.4;18;12;0.1;0.4
Control.SRR15539874;33;32;0.454545454545455;18;15;0.0454545454545455;0.454545454545455
Control.SRR15539874;38;32;0.5;19;19;0;0.5
Control.SRR15539874;30;32;0.433333333333333;17;13;0.0666666666666667;0.433333333333333
Control.SRR15539874;30;32;0.4;18;12;0.1;0.4
Control.SRR15539874;33;32;0.424242424242424;19;14;0.0757575757575757;0.424242424242424
Control.SRR15539874;30;32;0.466666666666667;16;14;0.0333333333333333;0.466666666666667
Control.SRR15539874;31;32;0.419354838709677;18;13;0.0806451612903226;0.419354838709677
Control.SRR15539874;34;32;0.441176470588235;19;15;0.0588235294117647;0.441176470588235
Control.SRR15539874;36;32;0.472222222222222;19;17;0.0277777777777778;0.472222222222222
Control.SRR15539874;35;32;0.6;14;21;0.1;0.4
Control.SRR15539874;32;32;0.4375;18;14;0.0625;0.4375
Control.SRR15539874;34;32;0.441176470588235;19;15;0.0588235294117647;0.441176470588235
Control.SRR15539874;30;32;0.533333333333333;14;16;0.0333333333333333;0.466666666666667
Control.SRR15539874;39;32;0.666666666666667;13;26;0.166666666666667;0.333333333333333
Control.SRR15539874;36;32;0.611111111111111;14;22;0.111111111111111;0.388888888888889
Control.SRR15539874;30;32;0.566666666666667;13;17;0.0666666666666667;0.433333333333333
Control.SRR15539874;30;32;0.633333333333333;11;19;0.133333333333333;0.366666666666667
Control.SRR15539874;31;32;0.451612903225806;17;14;0.0483870967741936;0.451612903225806
Control.SRR15539874;32;32;0.59375;13;19;0.09375;0.40625
Control.SRR15539874;31;32;0.580645161290323;13;18;0.0806451612903226;0.419354838709677
Control.SRR15539874;34;32;0.411764705882353;20;14;0.0882352941176471;0.411764705882353
Control.SRR15539874;37;32;0.405405405405405;22;15;0.0945945945945946;0.405405405405405
Control.SRR15539874;31;32;0.387096774193548;19;12;0.112903225806452;0.387096774193548
Control.SRR15539874;30;32;0.4;18;12;0.1;0.4
Control.SRR15539874;35;32;0.4;21;14;0.1;0.4
Control.SRR15539874;39;32;0.461538461538462;21;18;0.0384615384615384;0.461538461538462
Control.SRR15539874;34;32;0.470588235294118;18;16;0.0294117647058824;0.470588235294118
Control.SRR15539874;37;32;0.513513513513513;18;19;0.0135135135135135;0.486486486486487
Control.SRR15539874;37;32;0.405405405405405;22;15;0.0945945945945946;0.405405405405405
Control.SRR15539874;35;32;0.514285714285714;17;18;0.0142857142857142;0.485714285714286
Control.SRR15539874;37;32;0.405405405405405;22;15;0.0945945945945946;0.405405405405405
Control.SRR15539874;35;32;0.457142857142857;19;16;0.0428571428571429;0.457142857142857
Control.SRR15539874;38;32;0.394736842105263;23;15;0.105263157894737;0.394736842105263
Control.SRR15539874;36;32;0.638888888888889;13;23;0.138888888888889;0.361111111111111
Control.SRR15539874;35;32;0.371428571428571;22;13;0.128571428571429;0.371428571428571
Control.SRR15539874;36;32;0.472222222222222;19;17;0.0277777777777778;0.472222222222222
Control.SRR15539874;38;32;0.394736842105263;23;15;0.105263157894737;0.394736842105263
Control.SRR15539874;33;32;0.484848484848485;17;16;0.0151515151515151;0.484848484848485
Control.SRR15539874;35;32;0.542857142857143;16;19;0.0428571428571428;0.457142857142857
Control.SRR15539874;36;32;0.333333333333333;24;12;0.166666666666667;0.333333333333333
Control.SRR15539874;38;32;0.5;19;19;0;0.5
Control.SRR15539874;38;32;0.447368421052632;21;17;0.0526315789473684;0.447368421052632
Control.SRR15539874;30;32;0.633333333333333;11;19;0.133333333333333;0.366666666666667
Control.SRR15539874;33;32;0.575757575757576;14;19;0.0757575757575758;0.424242424242424
Control.SRR15539874;32;32;0.59375;13;19;0.09375;0.40625
Control.SRR15539874;31;32;0.612903225806452;12;19;0.112903225806452;0.387096774193548
Control.SRR15539874;30;32;0.433333333333333;17;13;0.0666666666666667;0.433333333333333
Control.SRR15539874;30;32;0.566666666666667;13;17;0.0666666666666667;0.433333333333333
Control.SRR15539874;35;32;0.428571428571429;20;15;0.0714285714285715;0.428571428571429
Control.SRR15539874;31;32;0.580645161290323;13;18;0.0806451612903226;0.419354838709677
Control.SRR15539874;30;32;0.533333333333333;14;16;0.0333333333333333;0.466666666666667
Control.SRR15539874;34;32;0.5;17;17;0;0.5
Control.SRR15539874;33;32;0.575757575757576;14;19;0.0757575757575758;0.424242424242424
Control.SRR15539874;34;32;0.588235294117647;14;20;0.0882352941176471;0.411764705882353
Control.SRR15539874;34;32;0.5;17;17;0;0.5
Control.SRR15539874;35;32;0.628571428571429;13;22;0.128571428571429;0.371428571428571
Control.SRR15539874;37;32;0.432432432432432;21;16;0.0675675675675675;0.432432432432432
Control.SRR15539874;31;32;0.483870967741935;16;15;0.0161290322580645;0.483870967741935
Control.SRR15539874;30;32;0.433333333333333;17;13;0.0666666666666667;0.433333333333333
Control.SRR15539874;35;32;0.485714285714286;18;17;0.0142857142857143;0.485714285714286
Control.SRR15539874;29;32;0.586206896551724;12;17;0.0862068965517241;0.413793103448276
Control.SRR15539874;32;32;0.6875;10;22;0.1875;0.3125
Control.SRR15539874;34;32;0.411764705882353;20;14;0.0882352941176471;0.411764705882353
Control.SRR15539874;37;32;0.459459459459459;20;17;0.0405405405405405;0.459459459459459
Control.SRR15539874;29;32;0.448275862068966;16;13;0.0517241379310345;0.448275862068966
Control.SRR15539874;30;32;0.566666666666667;13;17;0.0666666666666667;0.433333333333333
Control.SRR15539874;30;32;0.533333333333333;14;16;0.0333333333333333;0.466666666666667
Control.SRR15539874;32;32;0.46875;17;15;0.03125;0.46875
Control.SRR15539874;39;32;0.461538461538462;21;18;0.0384615384615384;0.461538461538462
Control.SRR15539874;30;32;0.633333333333333;11;19;0.133333333333333;0.366666666666667
Control.SRR15539874;35;32;0.571428571428571;15;20;0.0714285714285714;0.428571428571429
Control.SRR15539874;39;32;0.333333333333333;26;13;0.166666666666667;0.333333333333333
Control.SRR15539874;35;32;0.457142857142857;19;16;0.0428571428571429;0.457142857142857
Control.SRR15539874;37;32;0.459459459459459;20;17;0.0405405405405405;0.459459459459459
Control.SRR15539874;36;32;0.583333333333333;15;21;0.0833333333333334;0.416666666666667
Control.SRR15539874;39;32;0.512820512820513;19;20;0.0128205128205128;0.487179487179487
Control.SRR15539874;39;32;0.461538461538462;21;18;0.0384615384615384;0.461538461538462
Control.SRR15539874;37;32;0.513513513513513;18;19;0.0135135135135135;0.486486486486487
Control.SRR15539874;39;32;0.461538461538462;21;18;0.0384615384615384;0.461538461538462
Control.SRR15539874;31;32;0.451612903225806;17;14;0.0483870967741936;0.451612903225806
Control.SRR15539874;37;32;0.567567567567568;16;21;0.0675675675675675;0.432432432432432
Control.SRR15539874;38;32;0.552631578947368;17;21;0.0526315789473685;0.447368421052632
Control.SRR15539874;30;32;0.6;12;18;0.1;0.4
Control.SRR15539874;37;32;0.405405405405405;22;15;0.0945945945945946;0.405405405405405
Control.SRR15539874;38;32;0.552631578947368;17;21;0.0526315789473685;0.447368421052632
Control.SRR15539874;29;32;0.586206896551724;12;17;0.0862068965517241;0.413793103448276
Control.SRR15539874;35;32;0.628571428571429;13;22;0.128571428571429;0.371428571428571
Control.SRR15539874;32;32;0.46875;17;15;0.03125;0.46875
Control.SRR15539874;29;32;0.379310344827586;18;11;0.120689655172414;0.379310344827586
Control.SRR15539874;38;32;0.394736842105263;23;15;0.105263157894737;0.394736842105263
Control.SRR15539874;33;32;0.363636363636364;21;12;0.136363636363636;0.363636363636364
Control.SRR15539874;34;32;0.5;17;17;0;0.5
Control.SRR15539874;34;32;0.5;17;17;0;0.5
Control.SRR15539874;32;32;0.46875;17;15;0.03125;0.46875
Control.SRR15539874;31;32;0.483870967741935;16;15;0.0161290322580645;0.483870967741935
Control.SRR15539874;30;32;0.6;12;18;0.1;0.4
Control.SRR15539874;34;32;0.617647058823529;13;21;0.117647058823529;0.382352941176471
Control.SRR15539874;39;32;0.512820512820513;19;20;0.0128205128205128;0.487179487179487
Control.SRR15539874;36;32;0.638888888888889;13;23;0.138888888888889;0.361111111111111
Control.SRR15539874;36;32;0.472222222222222;19;17;0.0277777777777778;0.472222222222222
Control.SRR15539874;35;32;0.657142857142857;12;23;0.157142857142857;0.342857142857143
Control.SRR15539874;39;32;0.41025641025641;23;16;0.0897435897435898;0.41025641025641
Control.SRR15539874;36;32;0.416666666666667;21;15;0.0833333333333333;0.416666666666667
Control.SRR15539874;29;32;0.344827586206897;19;10;0.155172413793103;0.344827586206897
Control.SRR15539874;32;32;0.5;16;16;0;0.5
Control.SRR15539874;38;32;0.657894736842105;13;25;0.157894736842105;0.342105263157895
Control.SRR15539874;37;32;0.513513513513513;18;19;0.0135135135135135;0.486486486486487
Control.SRR15539874;39;32;0.435897435897436;22;17;0.0641025641025641;0.435897435897436
Control.SRR15539874;34;32;0.441176470588235;19;15;0.0588235294117647;0.441176470588235
Control.SRR15539874;36;32;0.694444444444444;11;25;0.194444444444444;0.305555555555556
Control.SRR15539874;39;32;0.512820512820513;19;20;0.0128205128205128;0.487179487179487
Control.SRR15539874;38;32;0.5;19;19;0;0.5
Control.SRR15539874;39;32;0.461538461538462;21;18;0.0384615384615384;0.461538461538462
Control.SRR15539874;37;32;0.540540540540541;17;20;0.0405405405405406;0.459459459459459
Control.SRR15539874;31;32;0.516129032258065;15;16;0.0161290322580645;0.483870967741935
Control.SRR15539874;38;32;0.473684210526316;20;18;0.0263157894736842;0.473684210526316
Control.SRR15539874;32;32;0.40625;19;13;0.09375;0.40625
Control.SRR15539874;34;32;0.411764705882353;20;14;0.0882352941176471;0.411764705882353
Control.SRR15539874;30;32;0.466666666666667;16;14;0.0333333333333333;0.466666666666667
Control.SRR15539874;36;32;0.722222222222222;10;26;0.222222222222222;0.277777777777778
Control.SRR15539874;38;32;0.578947368421053;16;22;0.0789473684210527;0.421052631578947
Control.SRR15539874;37;32;0.486486486486487;19;18;0.0135135135135135;0.486486486486487
Control.SRR15539874;32;32;0.46875;17;15;0.03125;0.46875
Control.SRR15539874;33;32;0.515151515151515;16;17;0.0151515151515151;0.484848484848485
Control.SRR15539874;38;32;0.552631578947368;17;21;0.0526315789473685;0.447368421052632
Control.SRR15539874;31;32;0.645161290322581;11;20;0.145161290322581;0.354838709677419
Control.SRR15539874;32;32;0.3125;22;10;0.1875;0.3125
Control.SRR15539874;32;32;0.59375;13;19;0.09375;0.40625
Control.SRR15539874;37;32;0.567567567567568;16;21;0.0675675675675675;0.432432432432432
Control.SRR15539874;36;32;0.444444444444444;20;16;0.0555555555555556;0.444444444444444
Control.SRR15539874;34;32;0.5;17;17;0;0.5
Control.SRR15539874;38;32;0.342105263157895;25;13;0.157894736842105;0.342105263157895
Control.SRR15539874;33;32;0.696969696969697;10;23;0.196969696969697;0.303030303030303
Control.SRR15539874;39;32;0.564102564102564;17;22;0.0641025641025641;0.435897435897436
Control.SRR15539874;37;32;0.648648648648649;13;24;0.148648648648649;0.351351351351351
Control.SRR15539874;35;32;0.514285714285714;17;18;0.0142857142857142;0.485714285714286
Control.SRR15539874;30;32;0.666666666666667;10;20;0.166666666666667;0.333333333333333
Control.SRR15539874;37;32;0.459459459459459;20;17;0.0405405405405405;0.459459459459459
Control.SRR15539874;30;32;0.5;15;15;0;0.5
Control.SRR15539874;36;32;0.416666666666667;21;15;0.0833333333333333;0.416666666666667
Control.SRR15539874;37;32;0.432432432432432;21;16;0.0675675675675675;0.432432432432432
Control.SRR15539874;36;32;0.333333333333333;24;12;0.166666666666667;0.333333333333333
Control.SRR15539874;31;32;0.419354838709677;18;13;0.0806451612903226;0.419354838709677
Control.SRR15539874;29;32;0.586206896551724;12;17;0.0862068965517241;0.413793103448276
Control.SRR15539874;35;32;0.371428571428571;22;13;0.128571428571429;0.371428571428571
Control.SRR15539874;38;32;0.578947368421053;16;22;0.0789473684210527;0.421052631578947
Control.SRR15539874;34;32;0.588235294117647;14;20;0.0882352941176471;0.411764705882353
Control.SRR15539874;35;32;0.571428571428571;15;20;0.0714285714285714;0.428571428571429
Control.SRR15539874;38;32;0.5;19;19;0;0.5
Control.SRR15539874;36;32;0.583333333333333;15;21;0.0833333333333334;0.416666666666667
Control.SRR15539874;33;32;0.484848484848485;17;16;0.0151515151515151;0.484848484848485
Control.SRR15539874;37;32;0.621621621621622;14;23;0.121621621621622;0.378378378378378
Control.SRR15539874;33;32;0.484848484848485;17;16;0.0151515151515151;0.484848484848485
Control.SRR15539874;34;32;0.470588235294118;18;16;0.0294117647058824;0.470588235294118
Control.SRR15539874;34;32;0.411764705882353;20;14;0.0882352941176471;0.411764705882353
Control.SRR15539874;37;32;0.432432432432432;21;16;0.0675675675675675;0.432432432432432
Control.SRR15539874;29;32;0.517241379310345;14;15;0.0172413793103449;0.482758620689655
Control.SRR15539874;31;32;0.483870967741935;16;15;0.0161290322580645;0.483870967741935
Control.SRR15539874;33;32;0.606060606060606;13;20;0.106060606060606;0.393939393939394
Control.SRR15539874;34;32;0.529411764705882;16;18;0.0294117647058824;0.470588235294118
Control.SRR15539874;38;32;0.578947368421053;16;22;0.0789473684210527;0.421052631578947
Control.SRR15539874;32;32;0.5;16;16;0;0.5
Control.SRR15539874;37;32;0.405405405405405;22;15;0.0945945945945946;0.405405405405405
Control.SRR15539874;39;32;0.666666666666667;13;26;0.166666666666667;0.333333333333333
Control.SRR15539874;32;32;0.5;16;16;0;0.5
Control.SRR15539874;33;32;0.242424242424242;25;8;0.257575757575758;0.242424242424242
Control.SRR15539874;36;32;0.555555555555556;16;20;0.0555555555555556;0.444444444444444
Control.SRR15539874;31;32;0.419354838709677;18;13;0.0806451612903226;0.419354838709677
Control.SRR15539874;36;32;0.416666666666667;21;15;0.0833333333333333;0.416666666666667
Control.SRR15539874;29;32;0.344827586206897;19;10;0.155172413793103;0.344827586206897
Control.SRR15539874;34;32;0.676470588235294;11;23;0.176470588235294;0.323529411764706
Control.SRR15539874;30;32;0.466666666666667;16;14;0.0333333333333333;0.466666666666667
Control.SRR15539874;32;32;0.5625;14;18;0.0625;0.4375
Control.SRR15539874;31;32;0.612903225806452;12;19;0.112903225806452;0.387096774193548
Control.SRR15539874;34;32;0.411764705882353;20;14;0.0882352941176471;0.411764705882353
Control.SRR15539874;33;32;0.515151515151515;16;17;0.0151515151515151;0.484848484848485
Control.SRR15539874;38;32;0.5;19;19;0;0.5
Control.SRR15539874;32;32;0.34375;21;11;0.15625;0.34375
Control.SRR15539874;37;32;0.459459459459459;20;17;0.0405405405405405;0.459459459459459
Control.SRR15539874;33;32;0.333333333333333;22;11;0.166666666666667;0.333333333333333
Control.SRR15539874;37;32;0.540540540540541;17;20;0.0405405405405406;0.459459459459459
Control.SRR15539874;29;32;0.379310344827586;18;11;0.120689655172414;0.379310344827586
Control.SRR15539874;29;32;0.413793103448276;17;12;0.0862068965517241;0.413793103448276
Control.SRR15539874;37;32;0.351351351351351;24;13;0.148648648648649;0.351351351351351
Control.SRR15539874;29;32;0.379310344827586;18;11;0.120689655172414;0.379310344827586
Control.SRR15539874;36;32;0.361111111111111;23;13;0.138888888888889;0.361111111111111
Control.SRR15539874;34;32;0.323529411764706;23;11;0.176470588235294;0.323529411764706
Control.SRR15539874;36;32;0.5;18;18;0;0.5
Control.SRR15539874;31;32;0.354838709677419;20;11;0.145161290322581;0.354838709677419
Control.SRR15539874;36;32;0.388888888888889;22;14;0.111111111111111;0.388888888888889
Control.SRR15539874;39;32;0.666666666666667;13;26;0.166666666666667;0.333333333333333
Control.SRR15539874;33;32;0.515151515151515;16;17;0.0151515151515151;0.484848484848485
Control.SRR15539874;34;32;0.470588235294118;18;16;0.0294117647058824;0.470588235294118
Control.SRR15539874;34;32;0.558823529411765;15;19;0.0588235294117647;0.441176470588235
Control.SRR15539874;36;32;0.416666666666667;21;15;0.0833333333333333;0.416666666666667
Control.SRR15539874;37;32;0.432432432432432;21;16;0.0675675675675675;0.432432432432432
Control.SRR15539874;38;32;0.5;19;19;0;0.5
Control.SRR15539874;36;32;0.472222222222222;19;17;0.0277777777777778;0.472222222222222
Control.SRR15539874;39;32;0.512820512820513;19;20;0.0128205128205128;0.487179487179487
Control.SRR15539874;33;32;0.515151515151515;16;17;0.0151515151515151;0.484848484848485
Control.SRR15539874;31;32;0.516129032258065;15;16;0.0161290322580645;0.483870967741935
Control.SRR15539874;33;32;0.545454545454545;15;18;0.0454545454545454;0.454545454545455
Control.SRR15539874;33;32;0.575757575757576;14;19;0.0757575757575758;0.424242424242424
Control.SRR15539874;33;32;0.424242424242424;19;14;0.0757575757575757;0.424242424242424
Control.SRR15539874;30;32;0.433333333333333;17;13;0.0666666666666667;0.433333333333333
Control.SRR15539874;31;32;0.483870967741935;16;15;0.0161290322580645;0.483870967741935
Control.SRR15539874;31;32;0.580645161290323;13;18;0.0806451612903226;0.419354838709677
Control.SRR15539874;38;32;0.526315789473684;18;20;0.0263157894736842;0.473684210526316
Control.SRR15539874;29;32;0.448275862068966;16;13;0.0517241379310345;0.448275862068966
Control.SRR15539874;37;32;0.486486486486487;19;18;0.0135135135135135;0.486486486486487
Control.SRR15539874;37;32;0.432432432432432;21;16;0.0675675675675675;0.432432432432432
Control.SRR15539874;35;32;0.6;14;21;0.1;0.4
Control.SRR15539874;39;32;0.461538461538462;21;18;0.0384615384615384;0.461538461538462
Control.SRR15539874;37;32;0.594594594594595;15;22;0.0945945945945946;0.405405405405405
Control.SRR15539874;38;32;0.552631578947368;17;21;0.0526315789473685;0.447368421052632
Control.SRR15539874;32;32;0.46875;17;15;0.03125;0.46875
Control.SRR15539874;31;32;0.387096774193548;19;12;0.112903225806452;0.387096774193548
Control.SRR15539874;35;32;0.485714285714286;18;17;0.0142857142857143;0.485714285714286
Control.SRR15539874;38;32;0.421052631578947;22;16;0.0789473684210527;0.421052631578947
Control.SRR15539874;32;32;0.4375;18;14;0.0625;0.4375
Control.SRR15539874;34;32;0.382352941176471;21;13;0.117647058823529;0.382352941176471
Control.SRR15539874;38;32;0.447368421052632;21;17;0.0526315789473684;0.447368421052632
Control.SRR15539874;32;32;0.375;20;12;0.125;0.375
Control.SRR15539874;33;32;0.545454545454545;15;18;0.0454545454545454;0.454545454545455
Control.SRR15539874;30;32;0.433333333333333;17;13;0.0666666666666667;0.433333333333333
Control.SRR15539874;34;32;0.382352941176471;21;13;0.117647058823529;0.382352941176471
Control.SRR15539874;32;32;0.5;16;16;0;0.5
Control.SRR15539874;36;32;0.527777777777778;17;19;0.0277777777777778;0.472222222222222
Control.SRR15539874;39;32;0.512820512820513;19;20;0.0128205128205128;0.487179487179487
Control.SRR15539874;33;32;0.666666666666667;11;22;0.166666666666667;0.333333333333333
Control.SRR15539874;31;32;0.483870967741935;16;15;0.0161290322580645;0.483870967741935
Control.SRR15539874;38;32;0.473684210526316;20;18;0.0263157894736842;0.473684210526316
Control.SRR15539874;31;32;0.516129032258065;15;16;0.0161290322580645;0.483870967741935
Control.SRR15539874;29;32;0.482758620689655;15;14;0.0172413793103448;0.482758620689655
Control.SRR15539874;32;32;0.6875;10;22;0.1875;0.3125
Control.SRR15539874;33;32;0.575757575757576;14;19;0.0757575757575758;0.424242424242424
Control.SRR15539874;38;32;0.526315789473684;18;20;0.0263157894736842;0.473684210526316
Control.SRR15539874;33;32;0.393939393939394;20;13;0.106060606060606;0.393939393939394
Control.SRR15539874;29;32;0.482758620689655;15;14;0.0172413793103448;0.482758620689655
Control.SRR15539874;38;32;0.552631578947368;17;21;0.0526315789473685;0.447368421052632
Control.SRR15539874;31;32;0.516129032258065;15;16;0.0161290322580645;0.483870967741935
Control.SRR15539874;39;32;0.435897435897436;22;17;0.0641025641025641;0.435897435897436
Control.SRR15539874;30;32;0.5;15;15;0;0.5
Control.SRR15539874;29;32;0.551724137931034;13;16;0.0517241379310345;0.448275862068966
Control.SRR15539874;32;32;0.625;12;20;0.125;0.375
Control.SRR15539874;33;32;0.575757575757576;14;19;0.0757575757575758;0.424242424242424
Control.SRR15539874;38;32;0.473684210526316;20;18;0.0263157894736842;0.473684210526316
Control.SRR15539874;36;32;0.5;18;18;0;0.5
Control.SRR15539874;34;32;0.529411764705882;16;18;0.0294117647058824;0.470588235294118
Control.SRR15539874;39;32;0.41025641025641;23;16;0.0897435897435898;0.41025641025641
Control.SRR15539874;35;32;0.457142857142857;19;16;0.0428571428571429;0.457142857142857
Control.SRR15539874;39;32;0.435897435897436;22;17;0.0641025641025641;0.435897435897436
Control.SRR15539874;37;32;0.486486486486487;19;18;0.0135135135135135;0.486486486486487
Control.SRR15539874;31;32;0.516129032258065;15;16;0.0161290322580645;0.483870967741935
Control.SRR15539874;35;32;0.428571428571429;20;15;0.0714285714285715;0.428571428571429
Control.SRR15539874;30;32;0.466666666666667;16;14;0.0333333333333333;0.466666666666667
Control.SRR15539874;35;32;0.485714285714286;18;17;0.0142857142857143;0.485714285714286
Control.SRR15539874;39;32;0.512820512820513;19;20;0.0128205128205128;0.487179487179487
Control.SRR15539874;38;32;0.657894736842105;13;25;0.157894736842105;0.342105263157895
Control.SRR15539874;36;32;0.5;18;18;0;0.5
Control.SRR15539874;39;32;0.435897435897436;22;17;0.0641025641025641;0.435897435897436
Control.SRR15539874;33;32;0.393939393939394;20;13;0.106060606060606;0.393939393939394
Control.SRR15539874;34;32;0.676470588235294;11;23;0.176470588235294;0.323529411764706
Control.SRR15539874;31;32;0.741935483870968;8;23;0.241935483870968;0.258064516129032
Control.SRR15539874;39;32;0.487179487179487;20;19;0.0128205128205128;0.487179487179487
Control.SRR15539874;39;32;0.615384615384615;15;24;0.115384615384615;0.384615384615385
Control.SRR15539874;33;32;0.363636363636364;21;12;0.136363636363636;0.363636363636364
Control.SRR15539874;33;32;0.484848484848485;17;16;0.0151515151515151;0.484848484848485
Control.SRR15539874;36;32;0.388888888888889;22;14;0.111111111111111;0.388888888888889
Control.SRR15539874;34;32;0.558823529411765;15;19;0.0588235294117647;0.441176470588235
Control.SRR15539874;37;32;0.486486486486487;19;18;0.0135135135135135;0.486486486486487
Control.SRR15539874;35;32;0.457142857142857;19;16;0.0428571428571429;0.457142857142857
Control.SRR15539874;35;32;0.4;21;14;0.1;0.4
Control.SRR15539874;32;32;0.53125;15;17;0.03125;0.46875
Control.SRR15539874;30;32;0.5;15;15;0;0.5
Control.SRR15539874;30;32;0.5;15;15;0;0.5
Control.SRR15539874;30;32;0.633333333333333;11;19;0.133333333333333;0.366666666666667
Control.SRR15539874;37;32;0.540540540540541;17;20;0.0405405405405406;0.459459459459459
Control.SRR15539874;31;32;0.612903225806452;12;19;0.112903225806452;0.387096774193548
Control.SRR15539874;32;32;0.4375;18;14;0.0625;0.4375
Control.SRR15539874;38;32;0.526315789473684;18;20;0.0263157894736842;0.473684210526316
Control.SRR15539874;33;32;0.454545454545455;18;15;0.0454545454545455;0.454545454545455
Control.SRR15539874;30;32;0.566666666666667;13;17;0.0666666666666667;0.433333333333333
Control.SRR15539874;37;32;0.675675675675676;12;25;0.175675675675676;0.324324324324324
Control.SRR15539874;31;32;0.709677419354839;9;22;0.209677419354839;0.290322580645161
Control.SRR15539874;36;32;0.416666666666667;21;15;0.0833333333333333;0.416666666666667
Control.SRR15539874;34;32;0.558823529411765;15;19;0.0588235294117647;0.441176470588235
Control.SRR15539874;34;32;0.470588235294118;18;16;0.0294117647058824;0.470588235294118
Control.SRR15539874;31;32;0.451612903225806;17;14;0.0483870967741936;0.451612903225806
Control.SRR15539874;37;32;0.378378378378378;23;14;0.121621621621622;0.378378378378378
Control.SRR15539874;33;32;0.515151515151515;16;17;0.0151515151515151;0.484848484848485
Control.SRR15539874;37;32;0.540540540540541;17;20;0.0405405405405406;0.459459459459459
Control.SRR15539874;36;32;0.444444444444444;20;16;0.0555555555555556;0.444444444444444
Control.SRR15539874;34;32;0.529411764705882;16;18;0.0294117647058824;0.470588235294118
Control.SRR15539874;38;32;0.421052631578947;22;16;0.0789473684210527;0.421052631578947
Control.SRR15539874;29;32;0.689655172413793;9;20;0.189655172413793;0.310344827586207
Control.SRR15539874;33;32;0.575757575757576;14;19;0.0757575757575758;0.424242424242424
Control.SRR15539874;35;32;0.514285714285714;17;18;0.0142857142857142;0.485714285714286
Control.SRR15539874;32;32;0.65625;11;21;0.15625;0.34375
Control.SRR15539874;37;32;0.513513513513513;18;19;0.0135135135135135;0.486486486486487
Control.SRR15539874;29;32;0.758620689655172;7;22;0.258620689655172;0.241379310344828
Control.SRR15539874;32;32;0.375;20;12;0.125;0.375
Control.SRR15539874;30;32;0.366666666666667;19;11;0.133333333333333;0.366666666666667
Control.SRR15539874;31;32;0.483870967741935;16;15;0.0161290322580645;0.483870967741935
Control.SRR15539874;38;32;0.631578947368421;14;24;0.131578947368421;0.368421052631579
Control.SRR15539874;31;32;0.419354838709677;18;13;0.0806451612903226;0.419354838709677
Control.SRR15539874;32;32;0.46875;17;15;0.03125;0.46875
Control.SRR15539874;34;32;0.529411764705882;16;18;0.0294117647058824;0.470588235294118
Control.SRR15539874;37;32;0.540540540540541;17;20;0.0405405405405406;0.459459459459459
Control.SRR15539874;30;32;0.4;18;12;0.1;0.4
Control.SRR15539874;32;32;0.40625;19;13;0.09375;0.40625
Control.SRR15539874;33;32;0.545454545454545;15;18;0.0454545454545454;0.454545454545455
Control.SRR15539874;29;32;0.448275862068966;16;13;0.0517241379310345;0.448275862068966
Control.SRR15539874;38;32;0.5;19;19;0;0.5
Control.SRR15539874;35;32;0.4;21;14;0.1;0.4
Control.SRR15539874;30;32;0.5;15;15;0;0.5
Control.SRR15539874;31;32;0.483870967741935;16;15;0.0161290322580645;0.483870967741935
Control.SRR15539874;38;32;0.394736842105263;23;15;0.105263157894737;0.394736842105263
Control.SRR15539874;33;32;0.454545454545455;18;15;0.0454545454545455;0.454545454545455
Control.SRR15539874;35;32;0.6;14;21;0.1;0.4
Control.SRR15539874;38;32;0.315789473684211;26;12;0.184210526315789;0.315789473684211
Control.SRR15539874;32;32;0.5;16;16;0;0.5
Control.SRR15539874;34;32;0.529411764705882;16;18;0.0294117647058824;0.470588235294118
Control.SRR15539874;33;32;0.363636363636364;21;12;0.136363636363636;0.363636363636364
Control.SRR15539874;34;32;0.588235294117647;14;20;0.0882352941176471;0.411764705882353
Control.SRR15539874;38;32;0.657894736842105;13;25;0.157894736842105;0.342105263157895
Control.SRR15539874;31;32;0.387096774193548;19;12;0.112903225806452;0.387096774193548
Control.SRR15539874;38;32;0.631578947368421;14;24;0.131578947368421;0.368421052631579
Control.SRR15539874;37;32;0.432432432432432;21;16;0.0675675675675675;0.432432432432432
Control.SRR15539874;35;32;0.514285714285714;17;18;0.0142857142857142;0.485714285714286
Control.SRR15539874;34;32;0.588235294117647;14;20;0.0882352941176471;0.411764705882353
Control.SRR15539874;39;32;0.461538461538462;21;18;0.0384615384615384;0.461538461538462
Control.SRR15539874;33;32;0.454545454545455;18;15;0.0454545454545455;0.454545454545455
Control.SRR15539874;37;32;0.351351351351351;24;13;0.148648648648649;0.351351351351351
Control.SRR15539874;38;32;0.578947368421053;16;22;0.0789473684210527;0.421052631578947
Control.SRR15539874;36;32;0.527777777777778;17;19;0.0277777777777778;0.472222222222222
Control.SRR15539874;30;32;0.666666666666667;10;20;0.166666666666667;0.333333333333333
Control.SRR15539874;34;32;0.5;17;17;0;0.5
Control.SRR15539874;29;32;0.482758620689655;15;14;0.0172413793103448;0.482758620689655
Control.SRR15539874;29;32;0.448275862068966;16;13;0.0517241379310345;0.448275862068966
Control.SRR15539874;35;32;0.485714285714286;18;17;0.0142857142857143;0.485714285714286
Control.SRR15539874;33;32;0.484848484848485;17;16;0.0151515151515151;0.484848484848485
Control.SRR15539874;30;32;0.566666666666667;13;17;0.0666666666666667;0.433333333333333
Control.SRR15539874;35;32;0.485714285714286;18;17;0.0142857142857143;0.485714285714286
Control.SRR15539874;32;32;0.46875;17;15;0.03125;0.46875
Control.SRR15539874;33;32;0.575757575757576;14;19;0.0757575757575758;0.424242424242424
Control.SRR15539874;36;32;0.666666666666667;12;24;0.166666666666667;0.333333333333333
Control.SRR15539874;37;32;0.378378378378378;23;14;0.121621621621622;0.378378378378378
Control.SRR15539874;36;32;0.555555555555556;16;20;0.0555555555555556;0.444444444444444
Control.SRR15539874;39;32;0.461538461538462;21;18;0.0384615384615384;0.461538461538462
Control.SRR15539874;34;32;0.529411764705882;16;18;0.0294117647058824;0.470588235294118
Control.SRR15539874;31;32;0.580645161290323;13;18;0.0806451612903226;0.419354838709677
Control.SRR15539874;32;32;0.5;16;16;0;0.5
Control.SRR15539874;29;32;0.551724137931034;13;16;0.0517241379310345;0.448275862068966
Control.SRR15539874;36;32;0.444444444444444;20;16;0.0555555555555556;0.444444444444444
Control.SRR15539874;35;32;0.314285714285714;24;11;0.185714285714286;0.314285714285714
Control.SRR15539874;36;32;0.416666666666667;21;15;0.0833333333333333;0.416666666666667
Control.SRR15539874;36;32;0.555555555555556;16;20;0.0555555555555556;0.444444444444444
Control.SRR15539874;36;32;0.5;18;18;0;0.5
Control.SRR15539874;33;32;0.545454545454545;15;18;0.0454545454545454;0.454545454545455
Control.SRR15539874;35;32;0.457142857142857;19;16;0.0428571428571429;0.457142857142857
Control.SRR15539874;37;32;0.594594594594595;15;22;0.0945945945945946;0.405405405405405
Control.SRR15539874;31;32;0.451612903225806;17;14;0.0483870967741936;0.451612903225806
Control.SRR15539874;34;32;0.5;17;17;0;0.5
Control.SRR15539874;29;32;0.586206896551724;12;17;0.0862068965517241;0.413793103448276
Control.SRR15539874;31;32;0.451612903225806;17;14;0.0483870967741936;0.451612903225806
Control.SRR15539874;34;32;0.441176470588235;19;15;0.0588235294117647;0.441176470588235
Control.SRR15539874;35;32;0.714285714285714;10;25;0.214285714285714;0.285714285714286
Control.SRR15539874;34;32;0.411764705882353;20;14;0.0882352941176471;0.411764705882353
Control.SRR15539874;31;32;0.483870967741935;16;15;0.0161290322580645;0.483870967741935
Control.SRR15539874;35;32;0.457142857142857;19;16;0.0428571428571429;0.457142857142857
Control.SRR15539874;37;32;0.540540540540541;17;20;0.0405405405405406;0.459459459459459
Control.SRR15539874;37;32;0.486486486486487;19;18;0.0135135135135135;0.486486486486487
Control.SRR15539874;33;32;0.545454545454545;15;18;0.0454545454545454;0.454545454545455
Control.SRR15539874;34;32;0.529411764705882;16;18;0.0294117647058824;0.470588235294118
Control.SRR15539874;30;32;0.566666666666667;13;17;0.0666666666666667;0.433333333333333
Control.SRR15539874;31;32;0.483870967741935;16;15;0.0161290322580645;0.483870967741935
Control.SRR15539874;32;32;0.59375;13;19;0.09375;0.40625
Control.SRR15539874;32;32;0.40625;19;13;0.09375;0.40625
Control.SRR15539874;31;32;0.645161290322581;11;20;0.145161290322581;0.354838709677419
Control.SRR15539874;29;32;0.379310344827586;18;11;0.120689655172414;0.379310344827586
Control.SRR15539874;36;32;0.444444444444444;20;16;0.0555555555555556;0.444444444444444
Control.SRR15539874;34;32;0.264705882352941;25;9;0.235294117647059;0.264705882352941
Control.SRR15539874;36;32;0.527777777777778;17;19;0.0277777777777778;0.472222222222222
Control.SRR15539874;36;32;0.444444444444444;20;16;0.0555555555555556;0.444444444444444
Control.SRR15539874;33;32;0.545454545454545;15;18;0.0454545454545454;0.454545454545455
Control.SRR15539874;29;32;0.482758620689655;15;14;0.0172413793103448;0.482758620689655
Control.SRR15539874;36;32;0.5;18;18;0;0.5
Control.SRR15539874;31;32;0.451612903225806;17;14;0.0483870967741936;0.451612903225806
Control.SRR15539874;33;32;0.424242424242424;19;14;0.0757575757575757;0.424242424242424
Control.SRR15539874;29;32;0.482758620689655;15;14;0.0172413793103448;0.482758620689655
Control.SRR15539874;30;32;0.533333333333333;14;16;0.0333333333333333;0.466666666666667
Control.SRR15539874;37;32;0.594594594594595;15;22;0.0945945945945946;0.405405405405405
Control.SRR15539874;34;32;0.647058823529412;12;22;0.147058823529412;0.352941176470588
Control.SRR15539874;30;32;0.4;18;12;0.1;0.4
Control.SRR15539874;31;32;0.419354838709677;18;13;0.0806451612903226;0.419354838709677
Control.SRR15539874;36;32;0.555555555555556;16;20;0.0555555555555556;0.444444444444444
Control.SRR15539874;30;32;0.633333333333333;11;19;0.133333333333333;0.366666666666667
Control.SRR15539874;29;32;0.413793103448276;17;12;0.0862068965517241;0.413793103448276
Control.SRR15539874;30;32;0.466666666666667;16;14;0.0333333333333333;0.466666666666667
Control.SRR15539874;30;32;0.566666666666667;13;17;0.0666666666666667;0.433333333333333
Control.SRR15539874;30;32;0.733333333333333;8;22;0.233333333333333;0.266666666666667
Control.SRR15539874;33;32;0.515151515151515;16;17;0.0151515151515151;0.484848484848485
Control.SRR15539874;37;32;0.486486486486487;19;18;0.0135135135135135;0.486486486486487
Control.SRR15539874;33;32;0.454545454545455;18;15;0.0454545454545455;0.454545454545455
Control.SRR15539874;36;32;0.416666666666667;21;15;0.0833333333333333;0.416666666666667
Control.SRR15539874;37;32;0.567567567567568;16;21;0.0675675675675675;0.432432432432432
Control.SRR15539874;37;32;0.513513513513513;18;19;0.0135135135135135;0.486486486486487
Control.SRR15539874;29;32;0.517241379310345;14;15;0.0172413793103449;0.482758620689655
Control.SRR15539874;29;32;0.482758620689655;15;14;0.0172413793103448;0.482758620689655
Control.SRR15539874;33;32;0.424242424242424;19;14;0.0757575757575757;0.424242424242424
Control.SRR15539874;35;32;0.542857142857143;16;19;0.0428571428571428;0.457142857142857
Control.SRR15539874;33;32;0.545454545454545;15;18;0.0454545454545454;0.454545454545455
Control.SRR15539874;36;32;0.611111111111111;14;22;0.111111111111111;0.388888888888889
Control.SRR15539874;37;32;0.594594594594595;15;22;0.0945945945945946;0.405405405405405
Control.SRR15539874;32;32;0.53125;15;17;0.03125;0.46875
Control.SRR15539874;33;32;0.484848484848485;17;16;0.0151515151515151;0.484848484848485
Control.SRR15539874;35;32;0.514285714285714;17;18;0.0142857142857142;0.485714285714286
Control.SRR15539874;30;32;0.533333333333333;14;16;0.0333333333333333;0.466666666666667
Control.SRR15539874;36;32;0.388888888888889;22;14;0.111111111111111;0.388888888888889
Control.SRR15539874;30;32;0.633333333333333;11;19;0.133333333333333;0.366666666666667
Control.SRR15539874;33;32;0.515151515151515;16;17;0.0151515151515151;0.484848484848485
Control.SRR15539874;30;32;0.5;15;15;0;0.5
Control.SRR15539874;32;32;0.65625;11;21;0.15625;0.34375
Control.SRR15539874;34;32;0.382352941176471;21;13;0.117647058823529;0.382352941176471
Control.SRR15539874;37;32;0.540540540540541;17;20;0.0405405405405406;0.459459459459459
Control.SRR15539874;31;32;0.354838709677419;20;11;0.145161290322581;0.354838709677419
Control.SRR15539874;31;32;0.483870967741935;16;15;0.0161290322580645;0.483870967741935
Control.SRR15539874;32;32;0.5625;14;18;0.0625;0.4375
Control.SRR15539874;32;32;0.5;16;16;0;0.5
Control.SRR15539874;36;32;0.5;18;18;0;0.5
Control.SRR15539874;37;32;0.324324324324324;25;12;0.175675675675676;0.324324324324324
Control.SRR15539874;29;32;0.379310344827586;18;11;0.120689655172414;0.379310344827586
Control.SRR15539874;37;32;0.486486486486487;19;18;0.0135135135135135;0.486486486486487
Control.SRR15539874;35;32;0.457142857142857;19;16;0.0428571428571429;0.457142857142857
Control.SRR15539874;35;32;0.4;21;14;0.1;0.4
Control.SRR15539874;36;32;0.583333333333333;15;21;0.0833333333333334;0.416666666666667
Control.SRR15539874;37;32;0.621621621621622;14;23;0.121621621621622;0.378378378378378
Control.SRR15539874;36;32;0.361111111111111;23;13;0.138888888888889;0.361111111111111
Control.SRR15539874;33;32;0.424242424242424;19;14;0.0757575757575757;0.424242424242424
Control.SRR15539874;29;32;0.655172413793103;10;19;0.155172413793103;0.344827586206897
Control.SRR15539874;34;32;0.617647058823529;13;21;0.117647058823529;0.382352941176471
Control.SRR15539874;33;32;0.515151515151515;16;17;0.0151515151515151;0.484848484848485
Control.SRR15539874;36;32;0.583333333333333;15;21;0.0833333333333334;0.416666666666667
Control.SRR15539874;29;32;0.620689655172414;11;18;0.120689655172414;0.379310344827586
Control.SRR15539874;29;32;0.620689655172414;11;18;0.120689655172414;0.379310344827586
Control.SRR15539874;33;32;0.515151515151515;16;17;0.0151515151515151;0.484848484848485
Control.SRR15539874;35;32;0.514285714285714;17;18;0.0142857142857142;0.485714285714286
Control.SRR15539874;33;32;0.515151515151515;16;17;0.0151515151515151;0.484848484848485
Control.SRR15539874;36;32;0.416666666666667;21;15;0.0833333333333333;0.416666666666667
Control.SRR15539874;29;32;0.551724137931034;13;16;0.0517241379310345;0.448275862068966
Control.SRR15539874;31;32;0.516129032258065;15;16;0.0161290322580645;0.483870967741935
Control.SRR15539874;32;32;0.625;12;20;0.125;0.375
Control.SRR15539874;29;32;0.517241379310345;14;15;0.0172413793103449;0.482758620689655
Control.SRR15539874;30;32;0.5;15;15;0;0.5
Control.SRR15539874;34;32;0.558823529411765;15;19;0.0588235294117647;0.441176470588235
Control.SRR15539874;35;32;0.6;14;21;0.1;0.4
Control.SRR15539874;31;32;0.548387096774194;14;17;0.0483870967741935;0.451612903225806
Control.SRR15539874;29;32;0.586206896551724;12;17;0.0862068965517241;0.413793103448276
Control.SRR15539874;33;32;0.363636363636364;21;12;0.136363636363636;0.363636363636364
Control.SRR15539874;33;32;0.666666666666667;11;22;0.166666666666667;0.333333333333333
Control.SRR15539874;33;32;0.575757575757576;14;19;0.0757575757575758;0.424242424242424
Control.SRR15539874;32;32;0.5;16;16;0;0.5
Control.SRR15539874;35;32;0.542857142857143;16;19;0.0428571428571428;0.457142857142857
Control.SRR15539874;30;32;0.566666666666667;13;17;0.0666666666666667;0.433333333333333
Control.SRR15539874;37;32;0.648648648648649;13;24;0.148648648648649;0.351351351351351
Control.SRR15539874;32;32;0.65625;11;21;0.15625;0.34375
Control.SRR15539874;31;32;0.548387096774194;14;17;0.0483870967741935;0.451612903225806
Control.SRR15539874;35;32;0.485714285714286;18;17;0.0142857142857143;0.485714285714286
Control.SRR15539874;31;32;0.419354838709677;18;13;0.0806451612903226;0.419354838709677
Control.SRR15539874;30;32;0.433333333333333;17;13;0.0666666666666667;0.433333333333333
Control.SRR15539874;32;32;0.5625;14;18;0.0625;0.4375
Control.SRR15539874;35;32;0.457142857142857;19;16;0.0428571428571429;0.457142857142857
Control.SRR15539874;30;32;0.6;12;18;0.1;0.4
Control.SRR15539874;34;32;0.382352941176471;21;13;0.117647058823529;0.382352941176471
Control.SRR15539874;34;32;0.5;17;17;0;0.5
Control.SRR15539874;35;32;0.6;14;21;0.1;0.4
Control.SRR15539874;34;32;0.382352941176471;21;13;0.117647058823529;0.382352941176471
Control.SRR15539874;34;32;0.558823529411765;15;19;0.0588235294117647;0.441176470588235
Control.SRR15539874;34;32;0.382352941176471;21;13;0.117647058823529;0.382352941176471
Control.SRR15539874;37;32;0.540540540540541;17;20;0.0405405405405406;0.459459459459459
Control.SRR15539874;29;32;0.413793103448276;17;12;0.0862068965517241;0.413793103448276
Control.SRR15539874;34;32;0.588235294117647;14;20;0.0882352941176471;0.411764705882353
Control.SRR15539874;33;32;0.333333333333333;22;11;0.166666666666667;0.333333333333333
Control.SRR15539874;37;32;0.621621621621622;14;23;0.121621621621622;0.378378378378378
Control.SRR15539874;37;32;0.513513513513513;18;19;0.0135135135135135;0.486486486486487
Control.SRR15539874;30;32;0.4;18;12;0.1;0.4
Control.SRR15539874;31;32;0.419354838709677;18;13;0.0806451612903226;0.419354838709677
Control.SRR15539874;30;32;0.566666666666667;13;17;0.0666666666666667;0.433333333333333
Control.SRR15539874;29;32;0.586206896551724;12;17;0.0862068965517241;0.413793103448276
Control.SRR15539874;34;32;0.676470588235294;11;23;0.176470588235294;0.323529411764706
Control.SRR15539874;30;32;0.433333333333333;17;13;0.0666666666666667;0.433333333333333
Control.SRR15539874;30;32;0.566666666666667;13;17;0.0666666666666667;0.433333333333333
Control.SRR15539874;32;32;0.5;16;16;0;0.5
Control.SRR15539874;34;32;0.588235294117647;14;20;0.0882352941176471;0.411764705882353
Control.SRR15539874;34;32;0.558823529411765;15;19;0.0588235294117647;0.441176470588235
Control.SRR15539874;35;32;0.428571428571429;20;15;0.0714285714285715;0.428571428571429
Control.SRR15539874;31;32;0.354838709677419;20;11;0.145161290322581;0.354838709677419
Control.SRR15539874;33;32;0.515151515151515;16;17;0.0151515151515151;0.484848484848485
Control.SRR15539874;36;32;0.611111111111111;14;22;0.111111111111111;0.388888888888889
Control.SRR15539874;29;32;0.482758620689655;15;14;0.0172413793103448;0.482758620689655
Control.SRR15539874;37;32;0.540540540540541;17;20;0.0405405405405406;0.459459459459459
Control.SRR15539874;32;32;0.5;16;16;0;0.5
Control.SRR15539874;32;32;0.625;12;20;0.125;0.375
Control.SRR15539874;31;32;0.548387096774194;14;17;0.0483870967741935;0.451612903225806
Control.SRR15539874;30;32;0.5;15;15;0;0.5
Control.SRR15539874;31;32;0.419354838709677;18;13;0.0806451612903226;0.419354838709677
Control.SRR15539874;30;32;0.6;12;18;0.1;0.4
Control.SRR15539874;37;32;0.567567567567568;16;21;0.0675675675675675;0.432432432432432
Control.SRR15539874;31;32;0.548387096774194;14;17;0.0483870967741935;0.451612903225806
Control.SRR15539874;31;32;0.645161290322581;11;20;0.145161290322581;0.354838709677419
Control.SRR15539874;37;32;0.621621621621622;14;23;0.121621621621622;0.378378378378378
Control.SRR15539874;32;32;0.5;16;16;0;0.5
Control.SRR15539874;33;32;0.636363636363636;12;21;0.136363636363636;0.363636363636364
Control.SRR15539874;31;32;0.451612903225806;17;14;0.0483870967741936;0.451612903225806
Control.SRR15539874;30;32;0.533333333333333;14;16;0.0333333333333333;0.466666666666667
Control.SRR15539874;32;32;0.375;20;12;0.125;0.375
Control.SRR15539874;32;32;0.53125;15;17;0.03125;0.46875
Control.SRR15539874;32;32;0.46875;17;15;0.03125;0.46875
Control.SRR15539874;35;32;0.457142857142857;19;16;0.0428571428571429;0.457142857142857
Control.SRR15539874;32;32;0.53125;15;17;0.03125;0.46875
Control.SRR15539874;33;32;0.424242424242424;19;14;0.0757575757575757;0.424242424242424
Control.SRR15539874;32;32;0.40625;19;13;0.09375;0.40625
Control.SRR15539874;30;32;0.533333333333333;14;16;0.0333333333333333;0.466666666666667
Control.SRR15539874;36;32;0.527777777777778;17;19;0.0277777777777778;0.472222222222222
Control.SRR15539874;35;32;0.571428571428571;15;20;0.0714285714285714;0.428571428571429
Control.SRR15539874;36;32;0.388888888888889;22;14;0.111111111111111;0.388888888888889
Control.SRR15539874;37;32;0.513513513513513;18;19;0.0135135135135135;0.486486486486487
Control.SRR15539874;35;32;0.514285714285714;17;18;0.0142857142857142;0.485714285714286
Control.SRR15539874;35;32;0.485714285714286;18;17;0.0142857142857143;0.485714285714286
Control.SRR15539874;33;32;0.606060606060606;13;20;0.106060606060606;0.393939393939394
Control.SRR15539874;32;32;0.59375;13;19;0.09375;0.40625
Control.SRR15539874;32;32;0.53125;15;17;0.03125;0.46875
Control.SRR15539874;34;32;0.617647058823529;13;21;0.117647058823529;0.382352941176471
Control.SRR15539874;33;32;0.636363636363636;12;21;0.136363636363636;0.363636363636364
Control.SRR15539874;31;32;0.451612903225806;17;14;0.0483870967741936;0.451612903225806
Control.SRR15539874;29;32;0.620689655172414;11;18;0.120689655172414;0.379310344827586
Control.SRR15539874;32;32;0.375;20;12;0.125;0.375
Control.SRR15539874;34;32;0.558823529411765;15;19;0.0588235294117647;0.441176470588235
Control.SRR15539874;37;32;0.432432432432432;21;16;0.0675675675675675;0.432432432432432
Control.SRR15539874;34;32;0.470588235294118;18;16;0.0294117647058824;0.470588235294118
Control.SRR15539874;34;32;0.529411764705882;16;18;0.0294117647058824;0.470588235294118
Control.SRR15539874;35;32;0.428571428571429;20;15;0.0714285714285715;0.428571428571429
Control.SRR15539874;31;32;0.483870967741935;16;15;0.0161290322580645;0.483870967741935
Control.SRR15539874;30;32;0.366666666666667;19;11;0.133333333333333;0.366666666666667
Control.SRR15539874;29;32;0.620689655172414;11;18;0.120689655172414;0.379310344827586
Control.SRR15539874;30;32;0.433333333333333;17;13;0.0666666666666667;0.433333333333333
Control.SRR15539874;33;32;0.393939393939394;20;13;0.106060606060606;0.393939393939394
Control.SRR15539874;31;32;0.451612903225806;17;14;0.0483870967741936;0.451612903225806
Control.SRR15539874;31;32;0.516129032258065;15;16;0.0161290322580645;0.483870967741935
Control.SRR15539874;29;32;0.517241379310345;14;15;0.0172413793103449;0.482758620689655
Control.SRR15539874;31;32;0.709677419354839;9;22;0.209677419354839;0.290322580645161
Control.SRR15539874;31;32;0.451612903225806;17;14;0.0483870967741936;0.451612903225806
Control.SRR15539874;30;32;0.533333333333333;14;16;0.0333333333333333;0.466666666666667
Control.SRR15539874;33;32;0.424242424242424;19;14;0.0757575757575757;0.424242424242424
Control.SRR15539874;31;32;0.419354838709677;18;13;0.0806451612903226;0.419354838709677
Control.SRR15539874;36;32;0.5;18;18;0;0.5
Control.SRR15539874;36;32;0.444444444444444;20;16;0.0555555555555556;0.444444444444444
Control.SRR15539874;36;32;0.5;18;18;0;0.5
Control.SRR15539874;35;32;0.457142857142857;19;16;0.0428571428571429;0.457142857142857
Control.SRR15539874;36;32;0.444444444444444;20;16;0.0555555555555556;0.444444444444444
Control.SRR15539874;30;32;0.4;18;12;0.1;0.4
Control.SRR15539874;30;32;0.466666666666667;16;14;0.0333333333333333;0.466666666666667
Control.SRR15539874;36;32;0.527777777777778;17;19;0.0277777777777778;0.472222222222222
Control.SRR15539874;29;32;0.586206896551724;12;17;0.0862068965517241;0.413793103448276
Control.SRR15539874;33;32;0.575757575757576;14;19;0.0757575757575758;0.424242424242424
Control.SRR15539874;31;32;0.483870967741935;16;15;0.0161290322580645;0.483870967741935
Control.SRR15539874;35;32;0.457142857142857;19;16;0.0428571428571429;0.457142857142857
Control.SRR15539874;36;32;0.722222222222222;10;26;0.222222222222222;0.277777777777778
Control.SRR15539874;37;32;0.540540540540541;17;20;0.0405405405405406;0.459459459459459
Control.SRR15539874;35;32;0.571428571428571;15;20;0.0714285714285714;0.428571428571429
Control.SRR15539874;37;32;0.297297297297297;26;11;0.202702702702703;0.297297297297297
Control.SRR15539874;35;32;0.371428571428571;22;13;0.128571428571429;0.371428571428571
Control.SRR15539874;37;32;0.486486486486487;19;18;0.0135135135135135;0.486486486486487
Control.SRR15539874;36;32;0.472222222222222;19;17;0.0277777777777778;0.472222222222222
Control.SRR15539874;30;32;0.466666666666667;16;14;0.0333333333333333;0.466666666666667
Control.SRR15539874;34;32;0.411764705882353;20;14;0.0882352941176471;0.411764705882353
Control.SRR15539874;34;32;0.411764705882353;20;14;0.0882352941176471;0.411764705882353
Control.SRR15539874;31;32;0.580645161290323;13;18;0.0806451612903226;0.419354838709677
Control.SRR15539874;29;32;0.448275862068966;16;13;0.0517241379310345;0.448275862068966
Control.SRR15539874;35;32;0.428571428571429;20;15;0.0714285714285715;0.428571428571429
Control.SRR15539874;37;32;0.486486486486487;19;18;0.0135135135135135;0.486486486486487
Control.SRR15539874;29;32;0.413793103448276;17;12;0.0862068965517241;0.413793103448276
Control.SRR15539874;34;32;0.411764705882353;20;14;0.0882352941176471;0.411764705882353
Control.SRR15539874;30;32;0.5;15;15;0;0.5
Control.SRR15539874;33;32;0.303030303030303;23;10;0.196969696969697;0.303030303030303
Control.SRR15539874;33;32;0.424242424242424;19;14;0.0757575757575757;0.424242424242424
Control.SRR15539874;29;32;0.724137931034483;8;21;0.224137931034483;0.275862068965517
Control.SRR15539874;32;32;0.59375;13;19;0.09375;0.40625
Control.SRR15539874;34;32;0.558823529411765;15;19;0.0588235294117647;0.441176470588235
Control.SRR15539874;31;32;0.483870967741935;16;15;0.0161290322580645;0.483870967741935
Control.SRR15539874;33;32;0.363636363636364;21;12;0.136363636363636;0.363636363636364
Control.SRR15539874;30;32;0.5;15;15;0;0.5
Control.SRR15539874;32;32;0.46875;17;15;0.03125;0.46875
Control.SRR15539874;31;32;0.483870967741935;16;15;0.0161290322580645;0.483870967741935
Control.SRR15539874;32;32;0.46875;17;15;0.03125;0.46875
Control.SRR15539874;36;32;0.583333333333333;15;21;0.0833333333333334;0.416666666666667
Control.SRR15539874;32;32;0.40625;19;13;0.09375;0.40625
Control.SRR15539874;30;32;0.5;15;15;0;0.5
Control.SRR15539874;34;32;0.441176470588235;19;15;0.0588235294117647;0.441176470588235
Control.SRR15539874;37;32;0.459459459459459;20;17;0.0405405405405405;0.459459459459459
Control.SRR15539874;31;32;0.483870967741935;16;15;0.0161290322580645;0.483870967741935
Control.SRR15539874;31;32;0.419354838709677;18;13;0.0806451612903226;0.419354838709677
Control.SRR15539874;36;32;0.527777777777778;17;19;0.0277777777777778;0.472222222222222
Control.SRR15539874;29;32;0.517241379310345;14;15;0.0172413793103449;0.482758620689655
Control.SRR15539874;35;32;0.571428571428571;15;20;0.0714285714285714;0.428571428571429
Control.SRR15539874;31;32;0.483870967741935;16;15;0.0161290322580645;0.483870967741935
Control.SRR15539874;35;32;0.542857142857143;16;19;0.0428571428571428;0.457142857142857
Control.SRR15539874;31;32;0.483870967741935;16;15;0.0161290322580645;0.483870967741935
Control.SRR15539874;32;32;0.4375;18;14;0.0625;0.4375
Control.SRR15539874;32;32;0.59375;13;19;0.09375;0.40625
Control.SRR15539874;35;32;0.457142857142857;19;16;0.0428571428571429;0.457142857142857
Control.SRR15539874;34;32;0.294117647058824;24;10;0.205882352941176;0.294117647058824
Control.SRR15539874;31;32;0.387096774193548;19;12;0.112903225806452;0.387096774193548
Control.SRR15539874;31;32;0.516129032258065;15;16;0.0161290322580645;0.483870967741935
Control.SRR15539874;33;32;0.454545454545455;18;15;0.0454545454545455;0.454545454545455
Control.SRR15539874;30;32;0.633333333333333;11;19;0.133333333333333;0.366666666666667
Control.SRR15539874;31;32;0.516129032258065;15;16;0.0161290322580645;0.483870967741935
Control.SRR15539874;32;32;0.6875;10;22;0.1875;0.3125
Control.SRR15539874;32;32;0.375;20;12;0.125;0.375
Control.SRR15539874;31;32;0.483870967741935;16;15;0.0161290322580645;0.483870967741935
Control.SRR15539874;36;32;0.527777777777778;17;19;0.0277777777777778;0.472222222222222
Control.SRR15539874;32;32;0.5;16;16;0;0.5
Control.SRR15539874;34;32;0.441176470588235;19;15;0.0588235294117647;0.441176470588235
Control.SRR15539874;34;32;0.588235294117647;14;20;0.0882352941176471;0.411764705882353
Control.SRR15539874;35;32;0.542857142857143;16;19;0.0428571428571428;0.457142857142857
Control.SRR15539874;31;32;0.483870967741935;16;15;0.0161290322580645;0.483870967741935
Control.SRR15539874;35;32;0.514285714285714;17;18;0.0142857142857142;0.485714285714286
Control.SRR15539874;32;32;0.46875;17;15;0.03125;0.46875
Control.SRR15539874;35;32;0.542857142857143;16;19;0.0428571428571428;0.457142857142857
Control.SRR15539874;37;32;0.432432432432432;21;16;0.0675675675675675;0.432432432432432
Control.SRR15539874;36;32;0.527777777777778;17;19;0.0277777777777778;0.472222222222222
Control.SRR15539874;33;32;0.393939393939394;20;13;0.106060606060606;0.393939393939394
Control.SRR15539874;34;32;0.441176470588235;19;15;0.0588235294117647;0.441176470588235
Control.SRR15539874;32;32;0.53125;15;17;0.03125;0.46875
Control.SRR15539874;36;32;0.416666666666667;21;15;0.0833333333333333;0.416666666666667
Control.SRR15539874;35;32;0.485714285714286;18;17;0.0142857142857143;0.485714285714286
Control.SRR15539874;35;32;0.342857142857143;23;12;0.157142857142857;0.342857142857143
Control.SRR15539874;30;32;0.533333333333333;14;16;0.0333333333333333;0.466666666666667
Control.SRR15539874;35;32;0.514285714285714;17;18;0.0142857142857142;0.485714285714286
Control.SRR15539874;35;32;0.514285714285714;17;18;0.0142857142857142;0.485714285714286
Control.SRR15539874;36;32;0.444444444444444;20;16;0.0555555555555556;0.444444444444444
Control.SRR15539874;33;32;0.545454545454545;15;18;0.0454545454545454;0.454545454545455
Control.SRR15539874;34;32;0.588235294117647;14;20;0.0882352941176471;0.411764705882353
Control.SRR15539874;33;32;0.454545454545455;18;15;0.0454545454545455;0.454545454545455
Control.SRR15539874;34;32;0.411764705882353;20;14;0.0882352941176471;0.411764705882353
Control.SRR15539874;33;32;0.545454545454545;15;18;0.0454545454545454;0.454545454545455
Control.SRR15539874;31;32;0.451612903225806;17;14;0.0483870967741936;0.451612903225806
Control.SRR15539874;35;32;0.371428571428571;22;13;0.128571428571429;0.371428571428571
Control.SRR15539874;29;32;0.344827586206897;19;10;0.155172413793103;0.344827586206897
Control.SRR15539874;35;32;0.371428571428571;22;13;0.128571428571429;0.371428571428571
Control.SRR15539874;32;32;0.40625;19;13;0.09375;0.40625
Control.SRR15539874;34;32;0.558823529411765;15;19;0.0588235294117647;0.441176470588235
Control.SRR15539874;33;32;0.515151515151515;16;17;0.0151515151515151;0.484848484848485
Control.SRR15539874;32;32;0.5;16;16;0;0.5
Control.SRR15539874;33;32;0.484848484848485;17;16;0.0151515151515151;0.484848484848485
Control.SRR15539874;29;32;0.586206896551724;12;17;0.0862068965517241;0.413793103448276
Control.SRR15539874;37;32;0.459459459459459;20;17;0.0405405405405405;0.459459459459459
Control.SRR15539874;29;32;0.413793103448276;17;12;0.0862068965517241;0.413793103448276
Control.SRR15539874;29;32;0.586206896551724;12;17;0.0862068965517241;0.413793103448276
Control.SRR15539874;33;32;0.333333333333333;22;11;0.166666666666667;0.333333333333333
Control.SRR15539874;30;32;0.433333333333333;17;13;0.0666666666666667;0.433333333333333
Control.SRR15539874;29;32;0.344827586206897;19;10;0.155172413793103;0.344827586206897
Control.SRR15539874;37;32;0.513513513513513;18;19;0.0135135135135135;0.486486486486487
Control.SRR15539874;30;32;0.533333333333333;14;16;0.0333333333333333;0.466666666666667
Control.SRR15539874;33;32;0.393939393939394;20;13;0.106060606060606;0.393939393939394
Control.SRR15539874;32;32;0.46875;17;15;0.03125;0.46875
Control.SRR15539874;31;32;0.580645161290323;13;18;0.0806451612903226;0.419354838709677
Control.SRR15539874;35;32;0.428571428571429;20;15;0.0714285714285715;0.428571428571429
Control.SRR15539874;37;32;0.513513513513513;18;19;0.0135135135135135;0.486486486486487
Control.SRR15539874;35;32;0.571428571428571;15;20;0.0714285714285714;0.428571428571429
Control.SRR15539874;34;32;0.441176470588235;19;15;0.0588235294117647;0.441176470588235
Control.SRR15539874;37;32;0.378378378378378;23;14;0.121621621621622;0.378378378378378
Control.SRR15539874;34;32;0.647058823529412;12;22;0.147058823529412;0.352941176470588
Control.SRR15539874;37;32;0.540540540540541;17;20;0.0405405405405406;0.459459459459459
Control.SRR15539874;30;32;0.633333333333333;11;19;0.133333333333333;0.366666666666667
Control.SRR15539874;33;32;0.454545454545455;18;15;0.0454545454545455;0.454545454545455
Control.SRR15539874;34;32;0.558823529411765;15;19;0.0588235294117647;0.441176470588235
Control.SRR15539874;33;32;0.575757575757576;14;19;0.0757575757575758;0.424242424242424
Control.SRR15539874;34;32;0.411764705882353;20;14;0.0882352941176471;0.411764705882353
Control.SRR15539874;32;32;0.5;16;16;0;0.5
Control.SRR15539874;35;32;0.542857142857143;16;19;0.0428571428571428;0.457142857142857
Control.SRR15539874;35;32;0.542857142857143;16;19;0.0428571428571428;0.457142857142857
Control.SRR15539874;29;32;0.413793103448276;17;12;0.0862068965517241;0.413793103448276
Control.SRR15539874;36;32;0.361111111111111;23;13;0.138888888888889;0.361111111111111
Control.SRR15539874;36;32;0.416666666666667;21;15;0.0833333333333333;0.416666666666667
Control.SRR15539874;36;32;0.5;18;18;0;0.5
Control.SRR15539874;36;32;0.5;18;18;0;0.5
Control.SRR15539874;36;32;0.611111111111111;14;22;0.111111111111111;0.388888888888889
Control.SRR15539874;37;32;0.540540540540541;17;20;0.0405405405405406;0.459459459459459
Control.SRR15539874;37;32;0.567567567567568;16;21;0.0675675675675675;0.432432432432432
Control.SRR15539874;29;32;0.413793103448276;17;12;0.0862068965517241;0.413793103448276
Control.SRR15539874;33;32;0.575757575757576;14;19;0.0757575757575758;0.424242424242424
Control.SRR15539874;33;32;0.575757575757576;14;19;0.0757575757575758;0.424242424242424
Control.SRR15539874;34;32;0.647058823529412;12;22;0.147058823529412;0.352941176470588
Control.SRR15539874;34;32;0.588235294117647;14;20;0.0882352941176471;0.411764705882353
Control.SRR15539874;33;32;0.363636363636364;21;12;0.136363636363636;0.363636363636364
Control.SRR15539874;30;32;0.366666666666667;19;11;0.133333333333333;0.366666666666667
Control.SRR15539874;35;32;0.514285714285714;17;18;0.0142857142857142;0.485714285714286
Control.SRR15539874;30;32;0.5;15;15;0;0.5
Control.SRR15539874;36;32;0.527777777777778;17;19;0.0277777777777778;0.472222222222222
Control.SRR15539874;35;32;0.542857142857143;16;19;0.0428571428571428;0.457142857142857
Control.SRR15539874;35;32;0.457142857142857;19;16;0.0428571428571429;0.457142857142857
Control.SRR15539874;37;32;0.459459459459459;20;17;0.0405405405405405;0.459459459459459
Control.SRR15539874;35;32;0.514285714285714;17;18;0.0142857142857142;0.485714285714286
Control.SRR15539874;30;32;0.433333333333333;17;13;0.0666666666666667;0.433333333333333
Control.SRR15539874;31;32;0.32258064516129;21;10;0.17741935483871;0.32258064516129
Control.SRR15539874;35;32;0.457142857142857;19;16;0.0428571428571429;0.457142857142857
Control.SRR15539874;33;32;0.363636363636364;21;12;0.136363636363636;0.363636363636364
Control.SRR15539874;37;32;0.621621621621622;14;23;0.121621621621622;0.378378378378378
Control.SRR15539874;34;32;0.588235294117647;14;20;0.0882352941176471;0.411764705882353
Control.SRR15539874;36;32;0.611111111111111;14;22;0.111111111111111;0.388888888888889
Control.SRR15539874;32;32;0.59375;13;19;0.09375;0.40625
Control.SRR15539874;32;32;0.5625;14;18;0.0625;0.4375
Control.SRR15539874;37;32;0.486486486486487;19;18;0.0135135135135135;0.486486486486487
Control.SRR15539874;34;32;0.529411764705882;16;18;0.0294117647058824;0.470588235294118
Control.SRR15539874;29;32;0.620689655172414;11;18;0.120689655172414;0.379310344827586
Control.SRR15539874;34;32;0.441176470588235;19;15;0.0588235294117647;0.441176470588235
Control.SRR15539874;29;32;0.172413793103448;24;5;0.327586206896552;0.172413793103448
Control.SRR15539874;36;32;0.5;18;18;0;0.5
Control.SRR15539874;34;32;0.382352941176471;21;13;0.117647058823529;0.382352941176471
Control.SRR15539874;37;32;0.486486486486487;19;18;0.0135135135135135;0.486486486486487
Control.SRR15539874;37;32;0.675675675675676;12;25;0.175675675675676;0.324324324324324
Control.SRR15539874;35;32;0.6;14;21;0.1;0.4
Control.SRR15539874;36;32;0.555555555555556;16;20;0.0555555555555556;0.444444444444444
Control.SRR15539874;29;32;0.413793103448276;17;12;0.0862068965517241;0.413793103448276
Control.SRR15539874;36;32;0.472222222222222;19;17;0.0277777777777778;0.472222222222222
Control.SRR15539874;35;32;0.628571428571429;13;22;0.128571428571429;0.371428571428571
Control.SRR15539874;35;32;0.457142857142857;19;16;0.0428571428571429;0.457142857142857
Control.SRR15539874;32;32;0.4375;18;14;0.0625;0.4375
Control.SRR15539874;31;32;0.548387096774194;14;17;0.0483870967741935;0.451612903225806
Control.SRR15539874;31;32;0.483870967741935;16;15;0.0161290322580645;0.483870967741935
Control.SRR15539874;36;32;0.527777777777778;17;19;0.0277777777777778;0.472222222222222
Control.SRR15539874;35;32;0.571428571428571;15;20;0.0714285714285714;0.428571428571429
Control.SRR15539874;30;32;0.633333333333333;11;19;0.133333333333333;0.366666666666667
Control.SRR15539874;35;32;0.428571428571429;20;15;0.0714285714285715;0.428571428571429
Control.SRR15539874;32;32;0.59375;13;19;0.09375;0.40625
Control.SRR15539874;35;32;0.4;21;14;0.1;0.4
Control.SRR15539874;36;32;0.472222222222222;19;17;0.0277777777777778;0.472222222222222
Control.SRR15539874;30;32;0.5;15;15;0;0.5
Control.SRR15539874;32;32;0.375;20;12;0.125;0.375
Control.SRR15539874;35;32;0.457142857142857;19;16;0.0428571428571429;0.457142857142857
Control.SRR15539874;34;32;0.529411764705882;16;18;0.0294117647058824;0.470588235294118
Control.SRR15539874;36;32;0.583333333333333;15;21;0.0833333333333334;0.416666666666667
Control.SRR15539874;34;32;0.617647058823529;13;21;0.117647058823529;0.382352941176471
Control.SRR15539874;35;32;0.6;14;21;0.1;0.4
Control.SRR15539874;34;32;0.5;17;17;0;0.5
Control.SRR15539874;33;32;0.545454545454545;15;18;0.0454545454545454;0.454545454545455
Control.SRR15539874;29;32;0.413793103448276;17;12;0.0862068965517241;0.413793103448276
Control.SRR15539874;29;32;0.586206896551724;12;17;0.0862068965517241;0.413793103448276
Control.SRR15539874;34;32;0.588235294117647;14;20;0.0882352941176471;0.411764705882353
Control.SRR15539874;31;32;0.516129032258065;15;16;0.0161290322580645;0.483870967741935
Control.SRR15539874;29;32;0.482758620689655;15;14;0.0172413793103448;0.482758620689655
Control.SRR15539874;36;32;0.638888888888889;13;23;0.138888888888889;0.361111111111111
Control.SRR15539874;36;32;0.527777777777778;17;19;0.0277777777777778;0.472222222222222
Control.SRR15539874;37;32;0.513513513513513;18;19;0.0135135135135135;0.486486486486487
Control.SRR15539874;34;32;0.558823529411765;15;19;0.0588235294117647;0.441176470588235
Control.SRR15539874;33;32;0.484848484848485;17;16;0.0151515151515151;0.484848484848485
Control.SRR15539874;36;32;0.611111111111111;14;22;0.111111111111111;0.388888888888889
Control.SRR15539874;30;32;0.4;18;12;0.1;0.4
Control.SRR15539874;31;32;0.645161290322581;11;20;0.145161290322581;0.354838709677419
Control.SRR15539874;37;32;0.513513513513513;18;19;0.0135135135135135;0.486486486486487
Control.SRR15539874;29;32;0.413793103448276;17;12;0.0862068965517241;0.413793103448276
Control.SRR15539874;36;32;0.555555555555556;16;20;0.0555555555555556;0.444444444444444
Control.SRR15539874;35;32;0.371428571428571;22;13;0.128571428571429;0.371428571428571
Control.SRR15539874;35;32;0.542857142857143;16;19;0.0428571428571428;0.457142857142857
Control.SRR15539874;34;32;0.470588235294118;18;16;0.0294117647058824;0.470588235294118
Control.SRR15539874;32;32;0.59375;13;19;0.09375;0.40625
Control.SRR15539874;35;32;0.428571428571429;20;15;0.0714285714285715;0.428571428571429
Control.SRR15539874;36;32;0.611111111111111;14;22;0.111111111111111;0.388888888888889
Control.SRR15539874;30;32;0.366666666666667;19;11;0.133333333333333;0.366666666666667
Control.SRR15539874;37;32;0.405405405405405;22;15;0.0945945945945946;0.405405405405405
Control.SRR15539874;36;32;0.416666666666667;21;15;0.0833333333333333;0.416666666666667
Control.SRR15539874;31;32;0.451612903225806;17;14;0.0483870967741936;0.451612903225806
Control.SRR15539874;33;32;0.363636363636364;21;12;0.136363636363636;0.363636363636364
Control.SRR15539874;29;32;0.620689655172414;11;18;0.120689655172414;0.379310344827586
Control.SRR15539874;37;32;0.405405405405405;22;15;0.0945945945945946;0.405405405405405
Control.SRR15539874;37;32;0.594594594594595;15;22;0.0945945945945946;0.405405405405405
Control.SRR15539874;34;32;0.617647058823529;13;21;0.117647058823529;0.382352941176471
Control.SRR15539874;31;32;0.483870967741935;16;15;0.0161290322580645;0.483870967741935
Control.SRR15539874;37;32;0.486486486486487;19;18;0.0135135135135135;0.486486486486487
Control.SRR15539874;31;32;0.516129032258065;15;16;0.0161290322580645;0.483870967741935
Control.SRR15539874;36;32;0.611111111111111;14;22;0.111111111111111;0.388888888888889
Control.SRR15539874;36;32;0.611111111111111;14;22;0.111111111111111;0.388888888888889
Control.SRR15539874;36;32;0.416666666666667;21;15;0.0833333333333333;0.416666666666667
Control.SRR15539874;37;32;0.540540540540541;17;20;0.0405405405405406;0.459459459459459
Control.SRR15539874;31;32;0.548387096774194;14;17;0.0483870967741935;0.451612903225806
Control.SRR15539874;36;32;0.472222222222222;19;17;0.0277777777777778;0.472222222222222
Control.SRR15539874;34;32;0.441176470588235;19;15;0.0588235294117647;0.441176470588235
Control.SRR15539874;29;32;0.482758620689655;15;14;0.0172413793103448;0.482758620689655
Control.SRR15539874;30;32;0.466666666666667;16;14;0.0333333333333333;0.466666666666667
Control.SRR15539874;36;32;0.388888888888889;22;14;0.111111111111111;0.388888888888889
Control.SRR15539874;34;32;0.558823529411765;15;19;0.0588235294117647;0.441176470588235
Control.SRR15539874;29;32;0.482758620689655;15;14;0.0172413793103448;0.482758620689655
Control.SRR15539874;34;32;0.5;17;17;0;0.5
Control.SRR15539874;33;32;0.575757575757576;14;19;0.0757575757575758;0.424242424242424
Control.SRR15539874;33;32;0.757575757575758;8;25;0.257575757575758;0.242424242424242
Control.SRR15539874;33;32;0.575757575757576;14;19;0.0757575757575758;0.424242424242424
Control.SRR15539874;33;32;0.484848484848485;17;16;0.0151515151515151;0.484848484848485
Control.SRR15539874;35;32;0.542857142857143;16;19;0.0428571428571428;0.457142857142857
Control.SRR15539874;34;32;0.529411764705882;16;18;0.0294117647058824;0.470588235294118
Control.SRR15539874;29;32;0.379310344827586;18;11;0.120689655172414;0.379310344827586
Control.SRR15539874;32;32;0.5;16;16;0;0.5
Control.SRR15539874;34;32;0.5;17;17;0;0.5
Control.SRR15539874;34;32;0.558823529411765;15;19;0.0588235294117647;0.441176470588235
Control.SRR15539874;29;32;0.517241379310345;14;15;0.0172413793103449;0.482758620689655
Control.SRR15539874;37;32;0.540540540540541;17;20;0.0405405405405406;0.459459459459459
Control.SRR15539874;35;32;0.571428571428571;15;20;0.0714285714285714;0.428571428571429
Control.SRR15539874;29;32;0.517241379310345;14;15;0.0172413793103449;0.482758620689655
Control.SRR15539874;30;32;0.466666666666667;16;14;0.0333333333333333;0.466666666666667
Control.SRR15539874;34;32;0.5;17;17;0;0.5
Control.SRR15539874;32;32;0.5;16;16;0;0.5
Control.SRR15539874;33;32;0.393939393939394;20;13;0.106060606060606;0.393939393939394
Control.SRR15539874;29;32;0.310344827586207;20;9;0.189655172413793;0.310344827586207
Control.SRR15539874;30;32;0.5;15;15;0;0.5
Control.SRR15539874;33;32;0.545454545454545;15;18;0.0454545454545454;0.454545454545455
Control.SRR15539874;37;32;0.567567567567568;16;21;0.0675675675675675;0.432432432432432
Control.SRR15539874;33;32;0.636363636363636;12;21;0.136363636363636;0.363636363636364
Control.SRR15539874;33;32;0.333333333333333;22;11;0.166666666666667;0.333333333333333
Control.SRR15539874;35;32;0.428571428571429;20;15;0.0714285714285715;0.428571428571429
Control.SRR15539874;34;32;0.588235294117647;14;20;0.0882352941176471;0.411764705882353
Control.SRR15539874;32;32;0.5;16;16;0;0.5
Control.SRR15539874;35;32;0.485714285714286;18;17;0.0142857142857143;0.485714285714286
Control.SRR15539874;34;32;0.470588235294118;18;16;0.0294117647058824;0.470588235294118
Control.SRR15539874;31;32;0.354838709677419;20;11;0.145161290322581;0.354838709677419
Control.SRR15539874;36;32;0.388888888888889;22;14;0.111111111111111;0.388888888888889
Control.SRR15539874;34;32;0.617647058823529;13;21;0.117647058823529;0.382352941176471
Control.SRR15539874;32;32;0.5;16;16;0;0.5
Control.SRR15539874;31;32;0.580645161290323;13;18;0.0806451612903226;0.419354838709677
Control.SRR15539874;36;32;0.444444444444444;20;16;0.0555555555555556;0.444444444444444
Control.SRR15539874;32;32;0.53125;15;17;0.03125;0.46875
Control.SRR15539874;34;32;0.382352941176471;21;13;0.117647058823529;0.382352941176471
Control.SRR15539874;34;32;0.705882352941177;10;24;0.205882352941177;0.294117647058824
Control.SRR15539874;35;32;0.514285714285714;17;18;0.0142857142857142;0.485714285714286
Control.SRR15539874;36;32;0.611111111111111;14;22;0.111111111111111;0.388888888888889
Control.SRR15539874;37;32;0.594594594594595;15;22;0.0945945945945946;0.405405405405405
Control.SRR15539874;31;32;0.580645161290323;13;18;0.0806451612903226;0.419354838709677
Control.SRR15539874;37;32;0.675675675675676;12;25;0.175675675675676;0.324324324324324
Control.SRR15539874;33;32;0.515151515151515;16;17;0.0151515151515151;0.484848484848485
Control.SRR15539874;35;32;0.771428571428571;8;27;0.271428571428571;0.228571428571429
Control.SRR15539874;29;32;0.482758620689655;15;14;0.0172413793103448;0.482758620689655
Control.SRR15539874;31;32;0.419354838709677;18;13;0.0806451612903226;0.419354838709677
Control.SRR15539874;31;32;0.387096774193548;19;12;0.112903225806452;0.387096774193548
Control.SRR15539874;30;32;0.633333333333333;11;19;0.133333333333333;0.366666666666667
Control.SRR15539874;33;32;0.696969696969697;10;23;0.196969696969697;0.303030303030303
Control.SRR15539874;31;32;0.548387096774194;14;17;0.0483870967741935;0.451612903225806
Control.SRR15539874;36;32;0.416666666666667;21;15;0.0833333333333333;0.416666666666667
Control.SRR15539874;34;32;0.352941176470588;22;12;0.147058823529412;0.352941176470588
Control.SRR15539874;29;32;0.517241379310345;14;15;0.0172413793103449;0.482758620689655
Control.SRR15539874;37;32;0.459459459459459;20;17;0.0405405405405405;0.459459459459459
Control.SRR15539874;33;32;0.545454545454545;15;18;0.0454545454545454;0.454545454545455
Control.SRR15539874;29;32;0.689655172413793;9;20;0.189655172413793;0.310344827586207
Control.SRR15539874;34;32;0.558823529411765;15;19;0.0588235294117647;0.441176470588235
Control.SRR15539874;33;32;0.424242424242424;19;14;0.0757575757575757;0.424242424242424
Control.SRR15539874;30;32;0.533333333333333;14;16;0.0333333333333333;0.466666666666667
Control.SRR15539874;37;32;0.594594594594595;15;22;0.0945945945945946;0.405405405405405
Control.SRR15539874;37;32;0.567567567567568;16;21;0.0675675675675675;0.432432432432432
Control.SRR15539874;36;32;0.527777777777778;17;19;0.0277777777777778;0.472222222222222
Control.SRR15539874;31;32;0.580645161290323;13;18;0.0806451612903226;0.419354838709677
Control.SRR15539874;34;32;0.529411764705882;16;18;0.0294117647058824;0.470588235294118
Control.SRR15539874;35;32;0.342857142857143;23;12;0.157142857142857;0.342857142857143
Control.SRR15539874;35;32;0.485714285714286;18;17;0.0142857142857143;0.485714285714286
Control.SRR15539874;30;32;0.4;18;12;0.1;0.4
Control.SRR15539874;37;32;0.594594594594595;15;22;0.0945945945945946;0.405405405405405
Control.SRR15539874;36;32;0.5;18;18;0;0.5
Control.SRR15539874;33;32;0.606060606060606;13;20;0.106060606060606;0.393939393939394
Control.SRR15539874;29;32;0.517241379310345;14;15;0.0172413793103449;0.482758620689655
Control.SRR15539874;37;32;0.567567567567568;16;21;0.0675675675675675;0.432432432432432
Control.SRR15539874;37;32;0.486486486486487;19;18;0.0135135135135135;0.486486486486487
Control.SRR15539874;37;32;0.432432432432432;21;16;0.0675675675675675;0.432432432432432
Control.SRR15539874;36;32;0.472222222222222;19;17;0.0277777777777778;0.472222222222222
Control.SRR15539874;33;32;0.333333333333333;22;11;0.166666666666667;0.333333333333333
Control.SRR15539874;33;32;0.484848484848485;17;16;0.0151515151515151;0.484848484848485
Control.SRR15539874;34;32;0.470588235294118;18;16;0.0294117647058824;0.470588235294118
Control.SRR15539874;34;32;0.647058823529412;12;22;0.147058823529412;0.352941176470588
Control.SRR15539874;35;32;0.628571428571429;13;22;0.128571428571429;0.371428571428571
Control.SRR15539874;36;32;0.388888888888889;22;14;0.111111111111111;0.388888888888889
Control.SRR15539874;29;32;0.586206896551724;12;17;0.0862068965517241;0.413793103448276
Control.SRR15539874;30;32;0.5;15;15;0;0.5
Control.SRR15539874;34;32;0.411764705882353;20;14;0.0882352941176471;0.411764705882353
Control.SRR15539874;29;32;0.413793103448276;17;12;0.0862068965517241;0.413793103448276
Control.SRR15539874;30;32;0.5;15;15;0;0.5
Control.SRR15539874;30;32;0.433333333333333;17;13;0.0666666666666667;0.433333333333333
Control.SRR15539874;31;32;0.354838709677419;20;11;0.145161290322581;0.354838709677419
Control.SRR15539874;33;32;0.606060606060606;13;20;0.106060606060606;0.393939393939394
Control.SRR15539874;35;32;0.4;21;14;0.1;0.4
Control.SRR15539874;37;32;0.567567567567568;16;21;0.0675675675675675;0.432432432432432
Control.SRR15539874;31;32;0.387096774193548;19;12;0.112903225806452;0.387096774193548
Control.SRR15539874;37;32;0.567567567567568;16;21;0.0675675675675675;0.432432432432432
Control.SRR15539874;33;32;0.454545454545455;18;15;0.0454545454545455;0.454545454545455
Control.SRR15539874;35;32;0.428571428571429;20;15;0.0714285714285715;0.428571428571429
Control.SRR15539874;35;32;0.485714285714286;18;17;0.0142857142857143;0.485714285714286
Control.SRR15539874;29;32;0.586206896551724;12;17;0.0862068965517241;0.413793103448276
Control.SRR15539874;34;32;0.5;17;17;0;0.5
Control.SRR15539874;37;32;0.621621621621622;14;23;0.121621621621622;0.378378378378378
Control.SRR15539874;33;32;0.454545454545455;18;15;0.0454545454545455;0.454545454545455
Control.SRR15539874;33;32;0.636363636363636;12;21;0.136363636363636;0.363636363636364
Control.SRR15539874;31;32;0.612903225806452;12;19;0.112903225806452;0.387096774193548
Control.SRR15539874;29;32;0.482758620689655;15;14;0.0172413793103448;0.482758620689655
Control.SRR15539874;29;32;0.413793103448276;17;12;0.0862068965517241;0.413793103448276
Control.SRR15539874;33;32;0.545454545454545;15;18;0.0454545454545454;0.454545454545455
Control.SRR15539874;35;32;0.457142857142857;19;16;0.0428571428571429;0.457142857142857
Control.SRR15539874;34;32;0.529411764705882;16;18;0.0294117647058824;0.470588235294118
Control.SRR15539874;31;32;0.580645161290323;13;18;0.0806451612903226;0.419354838709677
Control.SRR15539874;30;32;0.633333333333333;11;19;0.133333333333333;0.366666666666667
Control.SRR15539874;30;32;0.566666666666667;13;17;0.0666666666666667;0.433333333333333
Control.SRR15539874;35;32;0.428571428571429;20;15;0.0714285714285715;0.428571428571429
Control.SRR15539874;30;32;0.333333333333333;20;10;0.166666666666667;0.333333333333333
Control.SRR15539874;29;32;0.586206896551724;12;17;0.0862068965517241;0.413793103448276
Control.SRR15539874;35;32;0.285714285714286;25;10;0.214285714285714;0.285714285714286
Control.SRR15539874;36;32;0.583333333333333;15;21;0.0833333333333334;0.416666666666667
Control.SRR15539874;37;32;0.459459459459459;20;17;0.0405405405405405;0.459459459459459
Control.SRR15539874;32;32;0.46875;17;15;0.03125;0.46875
Control.SRR15539874;34;32;0.352941176470588;22;12;0.147058823529412;0.352941176470588
Control.SRR15539874;32;32;0.4375;18;14;0.0625;0.4375
Control.SRR15539874;34;32;0.5;17;17;0;0.5
Control.SRR15539874;37;32;0.459459459459459;20;17;0.0405405405405405;0.459459459459459
Control.SRR15539874;36;32;0.472222222222222;19;17;0.0277777777777778;0.472222222222222
Control.SRR15539874;36;32;0.5;18;18;0;0.5
Control.SRR15539874;31;32;0.580645161290323;13;18;0.0806451612903226;0.419354838709677
Control.SRR15539874;29;32;0.517241379310345;14;15;0.0172413793103449;0.482758620689655
Control.SRR15539874;31;32;0.645161290322581;11;20;0.145161290322581;0.354838709677419
Control.SRR15539874;34;32;0.617647058823529;13;21;0.117647058823529;0.382352941176471
Control.SRR15539874;33;32;0.515151515151515;16;17;0.0151515151515151;0.484848484848485
Control.SRR15539874;30;32;0.433333333333333;17;13;0.0666666666666667;0.433333333333333
Control.SRR15539874;34;32;0.647058823529412;12;22;0.147058823529412;0.352941176470588
Control.SRR15539874;31;32;0.483870967741935;16;15;0.0161290322580645;0.483870967741935
Control.SRR15539874;37;32;0.486486486486487;19;18;0.0135135135135135;0.486486486486487
Control.SRR15539874;36;32;0.361111111111111;23;13;0.138888888888889;0.361111111111111
Control.SRR15539874;29;32;0.517241379310345;14;15;0.0172413793103449;0.482758620689655
Control.SRR15539874;32;32;0.40625;19;13;0.09375;0.40625
Control.SRR15539874;34;32;0.382352941176471;21;13;0.117647058823529;0.382352941176471
Control.SRR15539874;35;32;0.457142857142857;19;16;0.0428571428571429;0.457142857142857
Control.SRR15539874;36;32;0.388888888888889;22;14;0.111111111111111;0.388888888888889
Control.SRR15539874;34;32;0.5;17;17;0;0.5
Control.SRR15539874;32;32;0.5625;14;18;0.0625;0.4375
Control.SRR15539874;29;32;0.310344827586207;20;9;0.189655172413793;0.310344827586207
Control.SRR15539874;31;32;0.419354838709677;18;13;0.0806451612903226;0.419354838709677
Control.SRR15539874;37;32;0.378378378378378;23;14;0.121621621621622;0.378378378378378
Control.SRR15539874;36;32;0.5;18;18;0;0.5
Control.SRR15539874;37;32;0.540540540540541;17;20;0.0405405405405406;0.459459459459459
Control.SRR15539874;34;32;0.323529411764706;23;11;0.176470588235294;0.323529411764706
Control.SRR15539874;33;32;0.545454545454545;15;18;0.0454545454545454;0.454545454545455
Control.SRR15539874;36;32;0.611111111111111;14;22;0.111111111111111;0.388888888888889
Control.SRR15539874;32;32;0.46875;17;15;0.03125;0.46875
Control.SRR15539874;33;32;0.545454545454545;15;18;0.0454545454545454;0.454545454545455
Control.SRR15539874;34;32;0.676470588235294;11;23;0.176470588235294;0.323529411764706
Control.SRR15539874;30;32;0.533333333333333;14;16;0.0333333333333333;0.466666666666667
Control.SRR15539874;34;32;0.411764705882353;20;14;0.0882352941176471;0.411764705882353
Control.SRR15539874;31;32;0.516129032258065;15;16;0.0161290322580645;0.483870967741935
Control.SRR15539874;37;32;0.486486486486487;19;18;0.0135135135135135;0.486486486486487
Control.SRR15539874;36;32;0.444444444444444;20;16;0.0555555555555556;0.444444444444444
Control.SRR15539874;34;32;0.676470588235294;11;23;0.176470588235294;0.323529411764706
Control.SRR15539874;37;32;0.378378378378378;23;14;0.121621621621622;0.378378378378378
Control.SRR15539874;34;32;0.5;17;17;0;0.5
Control.SRR15539874;33;32;0.515151515151515;16;17;0.0151515151515151;0.484848484848485
Control.SRR15539874;37;32;0.594594594594595;15;22;0.0945945945945946;0.405405405405405
Control.SRR15539874;34;32;0.5;17;17;0;0.5
Control.SRR15539874;33;32;0.393939393939394;20;13;0.106060606060606;0.393939393939394
Control.SRR15539874;31;32;0.580645161290323;13;18;0.0806451612903226;0.419354838709677
Control.SRR15539874;36;32;0.555555555555556;16;20;0.0555555555555556;0.444444444444444
Control.SRR15539874;37;32;0.513513513513513;18;19;0.0135135135135135;0.486486486486487
Control.SRR15539874;37;32;0.378378378378378;23;14;0.121621621621622;0.378378378378378
Control.SRR15539874;34;32;0.5;17;17;0;0.5
Control.SRR15539874;29;32;0.551724137931034;13;16;0.0517241379310345;0.448275862068966
Control.SRR15539874;36;32;0.472222222222222;19;17;0.0277777777777778;0.472222222222222
Control.SRR15539874;36;32;0.583333333333333;15;21;0.0833333333333334;0.416666666666667
Control.SRR15539874;34;32;0.617647058823529;13;21;0.117647058823529;0.382352941176471
Control.SRR15539874;34;32;0.5;17;17;0;0.5
Control.SRR15539874;32;32;0.375;20;12;0.125;0.375
Control.SRR15539874;30;32;0.5;15;15;0;0.5
Control.SRR15539874;35;32;0.514285714285714;17;18;0.0142857142857142;0.485714285714286
Control.SRR15539874;31;32;0.612903225806452;12;19;0.112903225806452;0.387096774193548
Control.SRR15539874;33;32;0.454545454545455;18;15;0.0454545454545455;0.454545454545455
Control.SRR15539874;37;32;0.486486486486487;19;18;0.0135135135135135;0.486486486486487
Control.SRR15539874;36;32;0.416666666666667;21;15;0.0833333333333333;0.416666666666667
Control.SRR15539874;36;32;0.555555555555556;16;20;0.0555555555555556;0.444444444444444
Control.SRR15539874;32;32;0.5625;14;18;0.0625;0.4375
Control.SRR15539874;32;32;0.375;20;12;0.125;0.375
Control.SRR15539874;33;32;0.424242424242424;19;14;0.0757575757575757;0.424242424242424
Control.SRR15539874;33;32;0.454545454545455;18;15;0.0454545454545455;0.454545454545455
Control.SRR15539874;29;32;0.517241379310345;14;15;0.0172413793103449;0.482758620689655
Control.SRR15539874;30;32;0.533333333333333;14;16;0.0333333333333333;0.466666666666667
Control.SRR15539874;31;32;0.354838709677419;20;11;0.145161290322581;0.354838709677419
Control.SRR15539874;34;32;0.470588235294118;18;16;0.0294117647058824;0.470588235294118
Control.SRR15539874;34;32;0.441176470588235;19;15;0.0588235294117647;0.441176470588235
Control.SRR15539874;36;32;0.583333333333333;15;21;0.0833333333333334;0.416666666666667
Control.SRR15539874;35;32;0.6;14;21;0.1;0.4
Control.SRR15539874;30;32;0.466666666666667;16;14;0.0333333333333333;0.466666666666667
Control.SRR15539874;30;32;0.5;15;15;0;0.5
Control.SRR15539874;37;32;0.567567567567568;16;21;0.0675675675675675;0.432432432432432
Control.SRR15539874;36;32;0.583333333333333;15;21;0.0833333333333334;0.416666666666667
Control.SRR15539874;36;32;0.305555555555556;25;11;0.194444444444444;0.305555555555556
Control.SRR15539874;30;32;0.533333333333333;14;16;0.0333333333333333;0.466666666666667
Control.SRR15539874;37;32;0.486486486486487;19;18;0.0135135135135135;0.486486486486487
Control.SRR15539874;37;32;0.567567567567568;16;21;0.0675675675675675;0.432432432432432
Control.SRR15539874;35;32;0.685714285714286;11;24;0.185714285714286;0.314285714285714
Control.SRR15539874;29;32;0.413793103448276;17;12;0.0862068965517241;0.413793103448276
Control.SRR15539874;29;32;0.517241379310345;14;15;0.0172413793103449;0.482758620689655
Control.SRR15539874;32;32;0.40625;19;13;0.09375;0.40625
Control.SRR15539874;30;32;0.566666666666667;13;17;0.0666666666666667;0.433333333333333
Control.SRR15539874;30;32;0.433333333333333;17;13;0.0666666666666667;0.433333333333333
Control.SRR15539874;30;32;0.6;12;18;0.1;0.4
Control.SRR15539874;30;32;0.533333333333333;14;16;0.0333333333333333;0.466666666666667
Control.SRR15539874;35;32;0.457142857142857;19;16;0.0428571428571429;0.457142857142857
Control.SRR15539874;31;32;0.580645161290323;13;18;0.0806451612903226;0.419354838709677
Control.SRR15539874;37;32;0.405405405405405;22;15;0.0945945945945946;0.405405405405405
Control.SRR15539874;29;32;0.655172413793103;10;19;0.155172413793103;0.344827586206897
Control.SRR15539874;36;32;0.555555555555556;16;20;0.0555555555555556;0.444444444444444
Control.SRR15539874;33;32;0.666666666666667;11;22;0.166666666666667;0.333333333333333
Control.SRR15539874;32;32;0.65625;11;21;0.15625;0.34375
Control.SRR15539874;37;32;0.459459459459459;20;17;0.0405405405405405;0.459459459459459
Control.SRR15539874;35;32;0.514285714285714;17;18;0.0142857142857142;0.485714285714286
Control.SRR15539874;36;32;0.583333333333333;15;21;0.0833333333333334;0.416666666666667
Control.SRR15539874;32;32;0.46875;17;15;0.03125;0.46875
Control.SRR15539874;30;32;0.6;12;18;0.1;0.4
Control.SRR15539874;34;32;0.352941176470588;22;12;0.147058823529412;0.352941176470588
Control.SRR15539874;31;32;0.516129032258065;15;16;0.0161290322580645;0.483870967741935
Control.SRR15539874;33;32;0.333333333333333;22;11;0.166666666666667;0.333333333333333
Control.SRR15539874;32;32;0.40625;19;13;0.09375;0.40625
Control.SRR15539874;34;32;0.294117647058824;24;10;0.205882352941176;0.294117647058824
Control.SRR15539874;36;32;0.666666666666667;12;24;0.166666666666667;0.333333333333333
Control.SRR15539874;35;32;0.457142857142857;19;16;0.0428571428571429;0.457142857142857
Control.SRR15539874;35;32;0.485714285714286;18;17;0.0142857142857143;0.485714285714286
Control.SRR15539874;36;32;0.416666666666667;21;15;0.0833333333333333;0.416666666666667
Control.SRR15539874;36;32;0.416666666666667;21;15;0.0833333333333333;0.416666666666667
Control.SRR15539874;32;32;0.40625;19;13;0.09375;0.40625
Control.SRR15539874;29;32;0.310344827586207;20;9;0.189655172413793;0.310344827586207
Control.SRR15539874;35;32;0.485714285714286;18;17;0.0142857142857143;0.485714285714286
Control.SRR15539874;31;32;0.548387096774194;14;17;0.0483870967741935;0.451612903225806
Control.SRR15539874;33;32;0.515151515151515;16;17;0.0151515151515151;0.484848484848485
Control.SRR15539874;34;32;0.411764705882353;20;14;0.0882352941176471;0.411764705882353
Control.SRR15539874;32;32;0.46875;17;15;0.03125;0.46875
Control.SRR15539874;34;32;0.588235294117647;14;20;0.0882352941176471;0.411764705882353
Control.SRR15539874;29;32;0.586206896551724;12;17;0.0862068965517241;0.413793103448276
Control.SRR15539874;34;32;0.441176470588235;19;15;0.0588235294117647;0.441176470588235
Control.SRR15539874;30;32;0.4;18;12;0.1;0.4
Control.SRR15539874;29;32;0.655172413793103;10;19;0.155172413793103;0.344827586206897
Control.SRR15539874;33;32;0.575757575757576;14;19;0.0757575757575758;0.424242424242424
Control.SRR15539874;33;32;0.484848484848485;17;16;0.0151515151515151;0.484848484848485
Control.SRR15539874;33;32;0.575757575757576;14;19;0.0757575757575758;0.424242424242424
Control.SRR15539874;31;32;0.516129032258065;15;16;0.0161290322580645;0.483870967741935
Control.SRR15539874;29;32;0.655172413793103;10;19;0.155172413793103;0.344827586206897
Control.SRR15539874;30;32;0.466666666666667;16;14;0.0333333333333333;0.466666666666667
Control.SRR15539874;37;32;0.486486486486487;19;18;0.0135135135135135;0.486486486486487
Control.SRR15539874;33;32;0.454545454545455;18;15;0.0454545454545455;0.454545454545455
Control.SRR15539874;32;32;0.40625;19;13;0.09375;0.40625
Control.SRR15539874;33;32;0.393939393939394;20;13;0.106060606060606;0.393939393939394
Control.SRR15539874;30;32;0.5;15;15;0;0.5
Control.SRR15539874;35;32;0.514285714285714;17;18;0.0142857142857142;0.485714285714286
Control.SRR15539874;32;32;0.5;16;16;0;0.5
Control.SRR15539874;33;32;0.575757575757576;14;19;0.0757575757575758;0.424242424242424
Control.SRR15539874;34;32;0.441176470588235;19;15;0.0588235294117647;0.441176470588235
Control.SRR15539874;36;32;0.5;18;18;0;0.5
Control.SRR15539874;37;32;0.432432432432432;21;16;0.0675675675675675;0.432432432432432
Control.SRR15539874;29;32;0.517241379310345;14;15;0.0172413793103449;0.482758620689655
Control.SRR15539874;29;32;0.482758620689655;15;14;0.0172413793103448;0.482758620689655
Control.SRR15539874;31;32;0.451612903225806;17;14;0.0483870967741936;0.451612903225806
Control.SRR15539874;35;32;0.571428571428571;15;20;0.0714285714285714;0.428571428571429
Control.SRR15539874;32;32;0.46875;17;15;0.03125;0.46875
Control.SRR15539874;31;32;0.483870967741935;16;15;0.0161290322580645;0.483870967741935
Control.SRR15539874;34;32;0.382352941176471;21;13;0.117647058823529;0.382352941176471
Control.SRR15539874;32;32;0.5;16;16;0;0.5
Control.SRR15539874;34;32;0.411764705882353;20;14;0.0882352941176471;0.411764705882353
Control.SRR15539874;32;32;0.5625;14;18;0.0625;0.4375
Control.SRR15539874;37;32;0.432432432432432;21;16;0.0675675675675675;0.432432432432432
Control.SRR15539874;34;32;0.735294117647059;9;25;0.235294117647059;0.264705882352941
Control.SRR15539874;29;32;0.413793103448276;17;12;0.0862068965517241;0.413793103448276
Control.SRR15539874;33;32;0.666666666666667;11;22;0.166666666666667;0.333333333333333
Control.SRR15539874;32;32;0.53125;15;17;0.03125;0.46875
Control.SRR15539874;35;32;0.6;14;21;0.1;0.4
Control.SRR15539874;34;32;0.5;17;17;0;0.5
Control.SRR15539874;37;32;0.513513513513513;18;19;0.0135135135135135;0.486486486486487
Control.SRR15539874;31;32;0.483870967741935;16;15;0.0161290322580645;0.483870967741935
Control.SRR15539874;30;32;0.566666666666667;13;17;0.0666666666666667;0.433333333333333
Control.SRR15539874;30;32;0.3;21;9;0.2;0.3
Control.SRR15539874;29;32;0.551724137931034;13;16;0.0517241379310345;0.448275862068966
Control.SRR15539874;31;32;0.354838709677419;20;11;0.145161290322581;0.354838709677419
Control.SRR15539874;37;32;0.540540540540541;17;20;0.0405405405405406;0.459459459459459
Control.SRR15539874;36;32;0.388888888888889;22;14;0.111111111111111;0.388888888888889
Control.SRR15539874;31;32;0.516129032258065;15;16;0.0161290322580645;0.483870967741935
Control.SRR15539874;31;32;0.548387096774194;14;17;0.0483870967741935;0.451612903225806
Control.SRR15539874;37;32;0.513513513513513;18;19;0.0135135135135135;0.486486486486487
Control.SRR15539874;36;32;0.666666666666667;12;24;0.166666666666667;0.333333333333333
Control.SRR15539874;37;32;0.567567567567568;16;21;0.0675675675675675;0.432432432432432
Control.SRR15539874;30;32;0.433333333333333;17;13;0.0666666666666667;0.433333333333333
Control.SRR15539874;32;32;0.34375;21;11;0.15625;0.34375
Control.SRR15539874;32;32;0.53125;15;17;0.03125;0.46875
Control.SRR15539874;29;32;0.551724137931034;13;16;0.0517241379310345;0.448275862068966
Control.SRR15539874;30;32;0.7;9;21;0.2;0.3
Control.SRR15539874;29;32;0.448275862068966;16;13;0.0517241379310345;0.448275862068966
Control.SRR15539874;33;32;0.515151515151515;16;17;0.0151515151515151;0.484848484848485
Control.SRR15539874;34;32;0.558823529411765;15;19;0.0588235294117647;0.441176470588235
Control.SRR15539874;36;32;0.583333333333333;15;21;0.0833333333333334;0.416666666666667
Control.SRR15539874;31;32;0.387096774193548;19;12;0.112903225806452;0.387096774193548
Control.SRR15539874;30;32;0.266666666666667;22;8;0.233333333333333;0.266666666666667
Control.SRR15539874;35;32;0.571428571428571;15;20;0.0714285714285714;0.428571428571429
Control.SRR15539874;29;32;0.275862068965517;21;8;0.224137931034483;0.275862068965517
Control.SRR15539874;34;32;0.441176470588235;19;15;0.0588235294117647;0.441176470588235
Control.SRR15539874;33;32;0.484848484848485;17;16;0.0151515151515151;0.484848484848485
Control.SRR15539874;35;32;0.542857142857143;16;19;0.0428571428571428;0.457142857142857
Control.SRR15539874;34;32;0.382352941176471;21;13;0.117647058823529;0.382352941176471
Control.SRR15539874;30;32;0.566666666666667;13;17;0.0666666666666667;0.433333333333333
Control.SRR15539874;34;32;0.470588235294118;18;16;0.0294117647058824;0.470588235294118
Control.SRR15539874;34;32;0.558823529411765;15;19;0.0588235294117647;0.441176470588235
Control.SRR15539874;35;32;0.457142857142857;19;16;0.0428571428571429;0.457142857142857
Control.SRR15539874;32;32;0.5625;14;18;0.0625;0.4375
Control.SRR15539874;31;32;0.548387096774194;14;17;0.0483870967741935;0.451612903225806
Control.SRR15539874;35;32;0.542857142857143;16;19;0.0428571428571428;0.457142857142857
Control.SRR15539874;30;32;0.333333333333333;20;10;0.166666666666667;0.333333333333333
Control.SRR15539874;35;32;0.457142857142857;19;16;0.0428571428571429;0.457142857142857
Control.SRR15539874;31;32;0.548387096774194;14;17;0.0483870967741935;0.451612903225806
Control.SRR15539874;35;32;0.657142857142857;12;23;0.157142857142857;0.342857142857143
Control.SRR15539874;32;32;0.53125;15;17;0.03125;0.46875
Control.SRR15539874;29;32;0.344827586206897;19;10;0.155172413793103;0.344827586206897
Control.SRR15539874;32;32;0.5;16;16;0;0.5
Control.SRR15539874;30;32;0.433333333333333;17;13;0.0666666666666667;0.433333333333333
Control.SRR15539874;32;32;0.4375;18;14;0.0625;0.4375
Control.SRR15539874;29;32;0.551724137931034;13;16;0.0517241379310345;0.448275862068966
Control.SRR15539874;37;32;0.648648648648649;13;24;0.148648648648649;0.351351351351351
Control.SRR15539874;31;32;0.419354838709677;18;13;0.0806451612903226;0.419354838709677
Control.SRR15539874;31;32;0.419354838709677;18;13;0.0806451612903226;0.419354838709677
Control.SRR15539874;35;32;0.571428571428571;15;20;0.0714285714285714;0.428571428571429
Control.SRR15539874;30;32;0.533333333333333;14;16;0.0333333333333333;0.466666666666667
Control.SRR15539874;31;32;0.612903225806452;12;19;0.112903225806452;0.387096774193548
Control.SRR15539874;36;32;0.611111111111111;14;22;0.111111111111111;0.388888888888889
Control.SRR15539874;32;32;0.4375;18;14;0.0625;0.4375
Control.SRR15539874;29;32;0.586206896551724;12;17;0.0862068965517241;0.413793103448276
Control.SRR15539874;30;32;0.666666666666667;10;20;0.166666666666667;0.333333333333333
Control.SRR15539874;32;32;0.5;16;16;0;0.5
Control.SRR15539874;30;32;0.5;15;15;0;0.5
Control.SRR15539874;30;32;0.466666666666667;16;14;0.0333333333333333;0.466666666666667
Control.SRR15539874;33;32;0.424242424242424;19;14;0.0757575757575757;0.424242424242424
Control.SRR15539874;31;32;0.419354838709677;18;13;0.0806451612903226;0.419354838709677
Control.SRR15539874;32;32;0.5625;14;18;0.0625;0.4375
Control.SRR15539874;31;32;0.548387096774194;14;17;0.0483870967741935;0.451612903225806
Control.SRR15539874;37;32;0.567567567567568;16;21;0.0675675675675675;0.432432432432432
Control.SRR15539874;33;32;0.484848484848485;17;16;0.0151515151515151;0.484848484848485
Control.SRR15539874;31;32;0.483870967741935;16;15;0.0161290322580645;0.483870967741935
Control.SRR15539874;32;32;0.625;12;20;0.125;0.375
Control.SRR15539874;31;32;0.580645161290323;13;18;0.0806451612903226;0.419354838709677
Control.SRR15539874;37;32;0.486486486486487;19;18;0.0135135135135135;0.486486486486487
Control.SRR15539874;35;32;0.457142857142857;19;16;0.0428571428571429;0.457142857142857
Control.SRR15539874;33;32;0.515151515151515;16;17;0.0151515151515151;0.484848484848485
Control.SRR15539874;32;32;0.5;16;16;0;0.5
Control.SRR15539874;29;32;0.655172413793103;10;19;0.155172413793103;0.344827586206897
Control.SRR15539874;30;32;0.566666666666667;13;17;0.0666666666666667;0.433333333333333
Control.SRR15539874;36;32;0.555555555555556;16;20;0.0555555555555556;0.444444444444444
Control.SRR15539874;31;32;0.483870967741935;16;15;0.0161290322580645;0.483870967741935
Control.SRR15539874;37;32;0.378378378378378;23;14;0.121621621621622;0.378378378378378
Control.SRR15539874;29;32;0.448275862068966;16;13;0.0517241379310345;0.448275862068966
Control.SRR15539874;35;32;0.457142857142857;19;16;0.0428571428571429;0.457142857142857
Control.SRR15539874;37;32;0.513513513513513;18;19;0.0135135135135135;0.486486486486487
Control.SRR15539874;34;32;0.588235294117647;14;20;0.0882352941176471;0.411764705882353
Control.SRR15539874;37;32;0.567567567567568;16;21;0.0675675675675675;0.432432432432432
Control.SRR15539874;35;32;0.514285714285714;17;18;0.0142857142857142;0.485714285714286
Control.SRR15539874;32;32;0.4375;18;14;0.0625;0.4375
Control.SRR15539874;37;32;0.486486486486487;19;18;0.0135135135135135;0.486486486486487
Control.SRR15539874;32;32;0.5;16;16;0;0.5
Control.SRR15539874;31;32;0.516129032258065;15;16;0.0161290322580645;0.483870967741935
Control.SRR15539874;34;32;0.588235294117647;14;20;0.0882352941176471;0.411764705882353
Control.SRR15539874;29;32;0.655172413793103;10;19;0.155172413793103;0.344827586206897
Control.SRR15539874;37;32;0.486486486486487;19;18;0.0135135135135135;0.486486486486487
Control.SRR15539874;37;32;0.621621621621622;14;23;0.121621621621622;0.378378378378378
Control.SRR15539874;35;32;0.628571428571429;13;22;0.128571428571429;0.371428571428571
Control.SRR15539874;34;32;0.5;17;17;0;0.5
Control.SRR15539874;36;32;0.444444444444444;20;16;0.0555555555555556;0.444444444444444
Control.SRR15539874;30;32;0.533333333333333;14;16;0.0333333333333333;0.466666666666667
Control.SRR15539874;29;32;0.724137931034483;8;21;0.224137931034483;0.275862068965517
Control.SRR15539874;36;32;0.555555555555556;16;20;0.0555555555555556;0.444444444444444
Control.SRR15539874;35;32;0.628571428571429;13;22;0.128571428571429;0.371428571428571
Control.SRR15539874;29;32;0.448275862068966;16;13;0.0517241379310345;0.448275862068966
Control.SRR15539874;30;32;0.366666666666667;19;11;0.133333333333333;0.366666666666667
Control.SRR15539874;31;32;0.387096774193548;19;12;0.112903225806452;0.387096774193548
Control.SRR15539874;33;32;0.454545454545455;18;15;0.0454545454545455;0.454545454545455
Control.SRR15539874;35;32;0.6;14;21;0.1;0.4
Control.SRR15539874;33;32;0.515151515151515;16;17;0.0151515151515151;0.484848484848485
Control.SRR15539874;37;32;0.405405405405405;22;15;0.0945945945945946;0.405405405405405
Control.SRR15539874;36;32;0.444444444444444;20;16;0.0555555555555556;0.444444444444444
Control.SRR15539874;36;32;0.555555555555556;16;20;0.0555555555555556;0.444444444444444
Control.SRR15539874;33;32;0.575757575757576;14;19;0.0757575757575758;0.424242424242424
Control.SRR15539874;31;32;0.709677419354839;9;22;0.209677419354839;0.290322580645161
Control.SRR15539874;30;32;0.533333333333333;14;16;0.0333333333333333;0.466666666666667
Control.SRR15539874;29;32;0.413793103448276;17;12;0.0862068965517241;0.413793103448276
Control.SRR15539874;31;32;0.516129032258065;15;16;0.0161290322580645;0.483870967741935
Control.SRR15539874;34;32;0.352941176470588;22;12;0.147058823529412;0.352941176470588
Control.SRR15539874;30;32;0.533333333333333;14;16;0.0333333333333333;0.466666666666667
Control.SRR15539874;30;32;0.5;15;15;0;0.5
Control.SRR15539874;31;32;0.612903225806452;12;19;0.112903225806452;0.387096774193548
Control.SRR15539874;34;32;0.411764705882353;20;14;0.0882352941176471;0.411764705882353
Control.SRR15539874;34;32;0.411764705882353;20;14;0.0882352941176471;0.411764705882353
Control.SRR15539874;36;32;0.416666666666667;21;15;0.0833333333333333;0.416666666666667
Control.SRR15539874;31;32;0.548387096774194;14;17;0.0483870967741935;0.451612903225806
Control.SRR15539874;33;32;0.393939393939394;20;13;0.106060606060606;0.393939393939394
Control.SRR15539874;36;32;0.5;18;18;0;0.5
Control.SRR15539874;32;32;0.28125;23;9;0.21875;0.28125
Control.SRR15539874;29;32;0.551724137931034;13;16;0.0517241379310345;0.448275862068966
Control.SRR15539874;29;32;0.620689655172414;11;18;0.120689655172414;0.379310344827586
Control.SRR15539874;30;32;0.5;15;15;0;0.5
Control.SRR15539874;34;32;0.588235294117647;14;20;0.0882352941176471;0.411764705882353
Control.SRR15539874;33;32;0.393939393939394;20;13;0.106060606060606;0.393939393939394
Control.SRR15539874;29;32;0.448275862068966;16;13;0.0517241379310345;0.448275862068966
Control.SRR15539874;32;32;0.375;20;12;0.125;0.375
Control.SRR15539874;30;32;0.4;18;12;0.1;0.4
Control.SRR15539874;32;32;0.53125;15;17;0.03125;0.46875
Control.SRR15539874;30;32;0.466666666666667;16;14;0.0333333333333333;0.466666666666667
Control.SRR15539874;37;32;0.540540540540541;17;20;0.0405405405405406;0.459459459459459
Control.SRR15539874;30;32;0.366666666666667;19;11;0.133333333333333;0.366666666666667
Control.SRR15539874;33;32;0.393939393939394;20;13;0.106060606060606;0.393939393939394
Control.SRR15539874;31;32;0.451612903225806;17;14;0.0483870967741936;0.451612903225806
Control.SRR15539874;33;32;0.454545454545455;18;15;0.0454545454545455;0.454545454545455
Control.SRR15539874;34;32;0.441176470588235;19;15;0.0588235294117647;0.441176470588235
Control.SRR15539874;31;32;0.451612903225806;17;14;0.0483870967741936;0.451612903225806
Control.SRR15539874;32;32;0.5;16;16;0;0.5
Control.SRR15539874;31;32;0.258064516129032;23;8;0.241935483870968;0.258064516129032
Control.SRR15539874;34;32;0.617647058823529;13;21;0.117647058823529;0.382352941176471
Control.SRR15539874;31;32;0.387096774193548;19;12;0.112903225806452;0.387096774193548
Control.SRR15539874;31;32;0.483870967741935;16;15;0.0161290322580645;0.483870967741935
Control.SRR15539874;36;32;0.444444444444444;20;16;0.0555555555555556;0.444444444444444
Control.SRR15539874;34;32;0.529411764705882;16;18;0.0294117647058824;0.470588235294118
Control.SRR15539874;36;32;0.694444444444444;11;25;0.194444444444444;0.305555555555556
Control.SRR15539874;34;32;0.529411764705882;16;18;0.0294117647058824;0.470588235294118
Control.SRR15539874;35;32;0.428571428571429;20;15;0.0714285714285715;0.428571428571429
Control.SRR15539874;32;32;0.53125;15;17;0.03125;0.46875
Control.SRR15539874;32;32;0.34375;21;11;0.15625;0.34375
Control.SRR15539874;35;32;0.514285714285714;17;18;0.0142857142857142;0.485714285714286
Control.SRR15539874;34;32;0.5;17;17;0;0.5
Control.SRR15539874;36;32;0.527777777777778;17;19;0.0277777777777778;0.472222222222222
Control.SRR15539874;32;32;0.46875;17;15;0.03125;0.46875
Control.SRR15539874;32;32;0.28125;23;9;0.21875;0.28125
Control.SRR15539874;29;32;0.310344827586207;20;9;0.189655172413793;0.310344827586207
Control.SRR15539874;35;32;0.457142857142857;19;16;0.0428571428571429;0.457142857142857
Control.SRR15539874;30;32;0.533333333333333;14;16;0.0333333333333333;0.466666666666667
Control.SRR15539874;29;32;0.413793103448276;17;12;0.0862068965517241;0.413793103448276
Control.SRR15539874;31;32;0.548387096774194;14;17;0.0483870967741935;0.451612903225806
Control.SRR15539874;32;32;0.5;16;16;0;0.5
Control.SRR15539874;36;32;0.527777777777778;17;19;0.0277777777777778;0.472222222222222
Control.SRR15539874;34;32;0.352941176470588;22;12;0.147058823529412;0.352941176470588
Control.SRR15539874;37;32;0.459459459459459;20;17;0.0405405405405405;0.459459459459459
Control.SRR15539874;36;32;0.444444444444444;20;16;0.0555555555555556;0.444444444444444
Control.SRR15539874;29;32;0.517241379310345;14;15;0.0172413793103449;0.482758620689655
Control.SRR15539874;32;32;0.46875;17;15;0.03125;0.46875
Control.SRR15539874;37;32;0.432432432432432;21;16;0.0675675675675675;0.432432432432432
Control.SRR15539874;31;32;0.451612903225806;17;14;0.0483870967741936;0.451612903225806
Control.SRR15539874;33;32;0.484848484848485;17;16;0.0151515151515151;0.484848484848485
Control.SRR15539874;31;32;0.387096774193548;19;12;0.112903225806452;0.387096774193548
Control.SRR15539874;32;32;0.59375;13;19;0.09375;0.40625
Control.SRR15539874;37;32;0.486486486486487;19;18;0.0135135135135135;0.486486486486487
Control.SRR15539874;31;32;0.548387096774194;14;17;0.0483870967741935;0.451612903225806
Control.SRR15539874;32;32;0.46875;17;15;0.03125;0.46875
Control.SRR15539874;37;32;0.378378378378378;23;14;0.121621621621622;0.378378378378378
Control.SRR15539874;31;32;0.548387096774194;14;17;0.0483870967741935;0.451612903225806
Control.SRR15539874;35;32;0.342857142857143;23;12;0.157142857142857;0.342857142857143
Control.SRR15539874;31;32;0.451612903225806;17;14;0.0483870967741936;0.451612903225806
Control.SRR15539874;33;32;0.454545454545455;18;15;0.0454545454545455;0.454545454545455
Control.SRR15539874;32;32;0.59375;13;19;0.09375;0.40625
Control.SRR15539874;31;32;0.419354838709677;18;13;0.0806451612903226;0.419354838709677
Control.SRR15539874;32;32;0.5625;14;18;0.0625;0.4375
Control.SRR15539874;34;32;0.558823529411765;15;19;0.0588235294117647;0.441176470588235
Control.SRR15539874;29;32;0.482758620689655;15;14;0.0172413793103448;0.482758620689655
Control.SRR15539874;34;32;0.323529411764706;23;11;0.176470588235294;0.323529411764706
Control.SRR15539874;36;32;0.305555555555556;25;11;0.194444444444444;0.305555555555556
Control.SRR15539874;30;32;0.5;15;15;0;0.5
Control.SRR15539874;34;32;0.470588235294118;18;16;0.0294117647058824;0.470588235294118
Control.SRR15539874;31;32;0.451612903225806;17;14;0.0483870967741936;0.451612903225806
Control.SRR15539874;33;32;0.606060606060606;13;20;0.106060606060606;0.393939393939394
Control.SRR15539874;29;32;0.275862068965517;21;8;0.224137931034483;0.275862068965517
Control.SRR15539874;36;32;0.5;18;18;0;0.5
Control.SRR15539874;34;32;0.470588235294118;18;16;0.0294117647058824;0.470588235294118
Control.SRR15539874;35;32;0.514285714285714;17;18;0.0142857142857142;0.485714285714286
Control.SRR15539874;31;32;0.580645161290323;13;18;0.0806451612903226;0.419354838709677
Control.SRR15539874;37;32;0.486486486486487;19;18;0.0135135135135135;0.486486486486487
Control.SRR15539874;29;32;0.551724137931034;13;16;0.0517241379310345;0.448275862068966
Control.SRR15539874;35;32;0.457142857142857;19;16;0.0428571428571429;0.457142857142857
Control.SRR15539874;33;32;0.484848484848485;17;16;0.0151515151515151;0.484848484848485
Control.SRR15539874;29;32;0.551724137931034;13;16;0.0517241379310345;0.448275862068966
Control.SRR15539874;35;32;0.428571428571429;20;15;0.0714285714285715;0.428571428571429
Control.SRR15539874;33;32;0.454545454545455;18;15;0.0454545454545455;0.454545454545455
Control.SRR15539874;35;32;0.6;14;21;0.1;0.4
Control.SRR15539874;33;32;0.424242424242424;19;14;0.0757575757575757;0.424242424242424
Control.SRR15539874;36;32;0.416666666666667;21;15;0.0833333333333333;0.416666666666667
Control.SRR15539874;34;32;0.411764705882353;20;14;0.0882352941176471;0.411764705882353
Control.SRR15539874;33;32;0.424242424242424;19;14;0.0757575757575757;0.424242424242424
Control.SRR15539874;31;32;0.580645161290323;13;18;0.0806451612903226;0.419354838709677
Control.SRR15539874;29;32;0.551724137931034;13;16;0.0517241379310345;0.448275862068966
Control.SRR15539874;35;32;0.457142857142857;19;16;0.0428571428571429;0.457142857142857
Control.SRR15539874;29;32;0.448275862068966;16;13;0.0517241379310345;0.448275862068966
Control.SRR15539874;30;32;0.7;9;21;0.2;0.3
Control.SRR15539874;31;32;0.645161290322581;11;20;0.145161290322581;0.354838709677419
Control.SRR15539874;34;32;0.470588235294118;18;16;0.0294117647058824;0.470588235294118
Control.SRR15539874;35;32;0.485714285714286;18;17;0.0142857142857143;0.485714285714286
Control.SRR15539874;31;32;0.516129032258065;15;16;0.0161290322580645;0.483870967741935
Control.SRR15539874;35;32;0.628571428571429;13;22;0.128571428571429;0.371428571428571
Control.SRR15539874;33;32;0.515151515151515;16;17;0.0151515151515151;0.484848484848485
Control.SRR15539874;29;32;0.517241379310345;14;15;0.0172413793103449;0.482758620689655
Control.SRR15539874;31;32;0.516129032258065;15;16;0.0161290322580645;0.483870967741935
Control.SRR15539874;35;32;0.428571428571429;20;15;0.0714285714285715;0.428571428571429
Control.SRR15539874;30;32;0.4;18;12;0.1;0.4
Control.SRR15539874;37;32;0.594594594594595;15;22;0.0945945945945946;0.405405405405405
Control.SRR15539874;31;32;0.451612903225806;17;14;0.0483870967741936;0.451612903225806
Control.SRR15539874;30;32;0.633333333333333;11;19;0.133333333333333;0.366666666666667
Control.SRR15539874;32;32;0.53125;15;17;0.03125;0.46875
Control.SRR15539874;30;32;0.5;15;15;0;0.5
Control.SRR15539874;34;32;0.441176470588235;19;15;0.0588235294117647;0.441176470588235
Control.SRR15539874;29;32;0.310344827586207;20;9;0.189655172413793;0.310344827586207
Control.SRR15539874;33;32;0.606060606060606;13;20;0.106060606060606;0.393939393939394
Control.SRR15539874;34;32;0.441176470588235;19;15;0.0588235294117647;0.441176470588235
Control.SRR15539874;30;32;0.433333333333333;17;13;0.0666666666666667;0.433333333333333
Control.SRR15539874;30;32;0.433333333333333;17;13;0.0666666666666667;0.433333333333333
Control.SRR15539874;32;32;0.59375;13;19;0.09375;0.40625
Control.SRR15539874;29;32;0.517241379310345;14;15;0.0172413793103449;0.482758620689655
Control.SRR15539874;36;32;0.472222222222222;19;17;0.0277777777777778;0.472222222222222
Control.SRR15539874;34;32;0.558823529411765;15;19;0.0588235294117647;0.441176470588235
Control.SRR15539874;34;32;0.558823529411765;15;19;0.0588235294117647;0.441176470588235
Control.SRR15539874;32;32;0.46875;17;15;0.03125;0.46875
Control.SRR15539874;30;32;0.4;18;12;0.1;0.4
Control.SRR15539874;35;32;0.4;21;14;0.1;0.4
Control.SRR15539874;36;32;0.25;27;9;0.25;0.25
Control.SRR15539874;33;32;0.666666666666667;11;22;0.166666666666667;0.333333333333333
Control.SRR15539874;32;32;0.75;8;24;0.25;0.25
Control.SRR15539874;33;32;0.393939393939394;20;13;0.106060606060606;0.393939393939394
Control.SRR15539874;32;32;0.5;16;16;0;0.5
Control.SRR15539874;31;32;0.67741935483871;10;21;0.17741935483871;0.32258064516129
Control.SRR15539874;37;32;0.486486486486487;19;18;0.0135135135135135;0.486486486486487
Control.SRR15539874;32;32;0.46875;17;15;0.03125;0.46875
Control.SRR15539874;32;32;0.5625;14;18;0.0625;0.4375
Control.SRR15539874;36;32;0.611111111111111;14;22;0.111111111111111;0.388888888888889
Control.SRR15539874;36;32;0.611111111111111;14;22;0.111111111111111;0.388888888888889
Control.SRR15539874;37;32;0.594594594594595;15;22;0.0945945945945946;0.405405405405405
Control.SRR15539874;36;32;0.416666666666667;21;15;0.0833333333333333;0.416666666666667
Control.SRR15539874;32;32;0.40625;19;13;0.09375;0.40625
Control.SRR15539874;36;32;0.416666666666667;21;15;0.0833333333333333;0.416666666666667
Control.SRR15539874;36;32;0.361111111111111;23;13;0.138888888888889;0.361111111111111
Control.SRR15539874;34;32;0.558823529411765;15;19;0.0588235294117647;0.441176470588235
Control.SRR15539874;37;32;0.567567567567568;16;21;0.0675675675675675;0.432432432432432
Control.SRR15539874;32;32;0.5;16;16;0;0.5
Control.SRR15539874;29;32;0.482758620689655;15;14;0.0172413793103448;0.482758620689655
Control.SRR15539874;29;32;0.482758620689655;15;14;0.0172413793103448;0.482758620689655
Control.SRR15539874;30;32;0.566666666666667;13;17;0.0666666666666667;0.433333333333333
Control.SRR15539874;31;32;0.516129032258065;15;16;0.0161290322580645;0.483870967741935
Control.SRR15539874;33;32;0.484848484848485;17;16;0.0151515151515151;0.484848484848485
Control.SRR15539874;33;32;0.454545454545455;18;15;0.0454545454545455;0.454545454545455
Control.SRR15539874;35;32;0.542857142857143;16;19;0.0428571428571428;0.457142857142857
Control.SRR15539874;37;32;0.513513513513513;18;19;0.0135135135135135;0.486486486486487
Control.SRR15539874;36;32;0.5;18;18;0;0.5
Control.SRR15539874;32;32;0.65625;11;21;0.15625;0.34375
Control.SRR15539874;32;32;0.53125;15;17;0.03125;0.46875
Control.SRR15539874;34;32;0.558823529411765;15;19;0.0588235294117647;0.441176470588235
Control.SRR15539874;35;32;0.457142857142857;19;16;0.0428571428571429;0.457142857142857
Control.SRR15539874;32;32;0.40625;19;13;0.09375;0.40625
Control.SRR15539874;30;32;0.6;12;18;0.1;0.4
Control.SRR15539874;33;32;0.454545454545455;18;15;0.0454545454545455;0.454545454545455
Control.SRR15539874;33;32;0.454545454545455;18;15;0.0454545454545455;0.454545454545455
Control.SRR15539874;30;32;0.466666666666667;16;14;0.0333333333333333;0.466666666666667
Control.SRR15539874;31;32;0.483870967741935;16;15;0.0161290322580645;0.483870967741935
Control.SRR15539874;29;32;0.551724137931034;13;16;0.0517241379310345;0.448275862068966
Control.SRR15539874;34;32;0.529411764705882;16;18;0.0294117647058824;0.470588235294118
Control.SRR15539874;35;32;0.628571428571429;13;22;0.128571428571429;0.371428571428571
Control.SRR15539874;33;32;0.454545454545455;18;15;0.0454545454545455;0.454545454545455
Control.SRR15539874;30;32;0.466666666666667;16;14;0.0333333333333333;0.466666666666667
Control.SRR15539874;32;32;0.625;12;20;0.125;0.375
Control.SRR15539874;36;32;0.472222222222222;19;17;0.0277777777777778;0.472222222222222
Control.SRR15539874;29;32;0.620689655172414;11;18;0.120689655172414;0.379310344827586
Control.SRR15539874;31;32;0.612903225806452;12;19;0.112903225806452;0.387096774193548
Control.SRR15539874;34;32;0.5;17;17;0;0.5
Control.SRR15539874;33;32;0.454545454545455;18;15;0.0454545454545455;0.454545454545455
Control.SRR15539874;36;32;0.638888888888889;13;23;0.138888888888889;0.361111111111111
Control.SRR15539874;35;32;0.514285714285714;17;18;0.0142857142857142;0.485714285714286
Control.SRR15539874;33;32;0.454545454545455;18;15;0.0454545454545455;0.454545454545455
Control.SRR15539874;37;32;0.594594594594595;15;22;0.0945945945945946;0.405405405405405
Control.SRR15539874;36;32;0.472222222222222;19;17;0.0277777777777778;0.472222222222222
Control.SRR15539874;35;32;0.542857142857143;16;19;0.0428571428571428;0.457142857142857
Control.SRR15539874;37;32;0.459459459459459;20;17;0.0405405405405405;0.459459459459459
Control.SRR15539874;37;32;0.459459459459459;20;17;0.0405405405405405;0.459459459459459
Control.SRR15539874;33;32;0.575757575757576;14;19;0.0757575757575758;0.424242424242424
Control.SRR15539874;35;32;0.514285714285714;17;18;0.0142857142857142;0.485714285714286
Control.SRR15539874;36;32;0.5;18;18;0;0.5
Control.SRR15539874;32;32;0.5;16;16;0;0.5
Control.SRR15539874;30;32;0.466666666666667;16;14;0.0333333333333333;0.466666666666667
Control.SRR15539874;29;32;0.448275862068966;16;13;0.0517241379310345;0.448275862068966
Control.SRR15539874;30;32;0.533333333333333;14;16;0.0333333333333333;0.466666666666667
Control.SRR15539874;30;32;0.4;18;12;0.1;0.4
Control.SRR15539874;37;32;0.405405405405405;22;15;0.0945945945945946;0.405405405405405
Control.SRR15539874;34;32;0.352941176470588;22;12;0.147058823529412;0.352941176470588
Control.SRR15539874;33;32;0.515151515151515;16;17;0.0151515151515151;0.484848484848485
Control.SRR15539874;35;32;0.514285714285714;17;18;0.0142857142857142;0.485714285714286
Control.SRR15539874;36;32;0.5;18;18;0;0.5
Control.SRR15539874;29;32;0.413793103448276;17;12;0.0862068965517241;0.413793103448276
Control.SRR15539874;31;32;0.483870967741935;16;15;0.0161290322580645;0.483870967741935
Control.SRR15539874;36;32;0.555555555555556;16;20;0.0555555555555556;0.444444444444444
Control.SRR15539874;36;32;0.416666666666667;21;15;0.0833333333333333;0.416666666666667
Control.SRR15539874;32;32;0.625;12;20;0.125;0.375
Control.SRR15539874;33;32;0.575757575757576;14;19;0.0757575757575758;0.424242424242424
Control.SRR15539874;36;32;0.666666666666667;12;24;0.166666666666667;0.333333333333333
Control.SRR15539874;32;32;0.65625;11;21;0.15625;0.34375
Control.SRR15539874;32;32;0.53125;15;17;0.03125;0.46875
Control.SRR15539874;32;32;0.4375;18;14;0.0625;0.4375
Control.SRR15539874;32;32;0.625;12;20;0.125;0.375
Control.SRR15539874;33;32;0.575757575757576;14;19;0.0757575757575758;0.424242424242424
Control.SRR15539874;35;32;0.514285714285714;17;18;0.0142857142857142;0.485714285714286
Control.SRR15539874;30;32;0.533333333333333;14;16;0.0333333333333333;0.466666666666667
Control.SRR15539874;34;32;0.617647058823529;13;21;0.117647058823529;0.382352941176471
Control.SRR15539874;36;32;0.333333333333333;24;12;0.166666666666667;0.333333333333333
Control.SRR15539874;31;32;0.580645161290323;13;18;0.0806451612903226;0.419354838709677
Control.SRR15539874;30;32;0.566666666666667;13;17;0.0666666666666667;0.433333333333333
Control.SRR15539874;31;32;0.451612903225806;17;14;0.0483870967741936;0.451612903225806
Control.SRR15539874;31;32;0.419354838709677;18;13;0.0806451612903226;0.419354838709677
Control.SRR15539874;35;32;0.485714285714286;18;17;0.0142857142857143;0.485714285714286
Control.SRR15539874;30;32;0.433333333333333;17;13;0.0666666666666667;0.433333333333333
Control.SRR15539874;36;32;0.361111111111111;23;13;0.138888888888889;0.361111111111111
Control.SRR15539874;30;32;0.4;18;12;0.1;0.4
Control.SRR15539874;35;32;0.6;14;21;0.1;0.4
Control.SRR15539874;32;32;0.59375;13;19;0.09375;0.40625
Control.SRR15539874;32;32;0.375;20;12;0.125;0.375
Control.SRR15539874;36;32;0.555555555555556;16;20;0.0555555555555556;0.444444444444444
Control.SRR15539874;33;32;0.575757575757576;14;19;0.0757575757575758;0.424242424242424
Control.SRR15539874;30;32;0.433333333333333;17;13;0.0666666666666667;0.433333333333333
Control.SRR15539874;35;32;0.6;14;21;0.1;0.4
Control.SRR15539874;33;32;0.545454545454545;15;18;0.0454545454545454;0.454545454545455
Control.SRR15539874;30;32;0.433333333333333;17;13;0.0666666666666667;0.433333333333333
Control.SRR15539874;32;32;0.65625;11;21;0.15625;0.34375
Control.SRR15539874;35;32;0.457142857142857;19;16;0.0428571428571429;0.457142857142857
Control.SRR15539874;36;32;0.416666666666667;21;15;0.0833333333333333;0.416666666666667
Control.SRR15539874;36;32;0.583333333333333;15;21;0.0833333333333334;0.416666666666667
Control.SRR15539874;31;32;0.516129032258065;15;16;0.0161290322580645;0.483870967741935
Control.SRR15539874;34;32;0.441176470588235;19;15;0.0588235294117647;0.441176470588235
Control.SRR15539874;35;32;0.457142857142857;19;16;0.0428571428571429;0.457142857142857
Control.SRR15539874;35;32;0.628571428571429;13;22;0.128571428571429;0.371428571428571
Control.SRR15539874;32;32;0.375;20;12;0.125;0.375
Control.SRR15539874;35;32;0.514285714285714;17;18;0.0142857142857142;0.485714285714286
Control.SRR15539874;32;32;0.5625;14;18;0.0625;0.4375
Control.SRR15539874;30;32;0.466666666666667;16;14;0.0333333333333333;0.466666666666667
Control.SRR15539874;30;32;0.633333333333333;11;19;0.133333333333333;0.366666666666667
Control.SRR15539874;33;32;0.303030303030303;23;10;0.196969696969697;0.303030303030303
Control.SRR15539874;36;32;0.416666666666667;21;15;0.0833333333333333;0.416666666666667
Control.SRR15539874;37;32;0.567567567567568;16;21;0.0675675675675675;0.432432432432432
Control.SRR15539874;37;32;0.459459459459459;20;17;0.0405405405405405;0.459459459459459
Control.SRR15539874;37;32;0.513513513513513;18;19;0.0135135135135135;0.486486486486487
Control.SRR15539874;31;32;0.580645161290323;13;18;0.0806451612903226;0.419354838709677
Control.SRR15539874;33;32;0.454545454545455;18;15;0.0454545454545455;0.454545454545455
Control.SRR15539874;34;32;0.382352941176471;21;13;0.117647058823529;0.382352941176471
Control.SRR15539874;37;32;0.405405405405405;22;15;0.0945945945945946;0.405405405405405
Control.SRR15539874;34;32;0.441176470588235;19;15;0.0588235294117647;0.441176470588235
Control.SRR15539874;30;32;0.5;15;15;0;0.5
Control.SRR15539874;37;32;0.432432432432432;21;16;0.0675675675675675;0.432432432432432
Control.SRR15539874;33;32;0.575757575757576;14;19;0.0757575757575758;0.424242424242424
Control.SRR15539874;29;32;0.413793103448276;17;12;0.0862068965517241;0.413793103448276
Control.SRR15539874;35;32;0.4;21;14;0.1;0.4
Control.SRR15539874;33;32;0.424242424242424;19;14;0.0757575757575757;0.424242424242424
Control.SRR15539874;34;32;0.470588235294118;18;16;0.0294117647058824;0.470588235294118
Control.SRR15539874;31;32;0.709677419354839;9;22;0.209677419354839;0.290322580645161
Control.SRR15539874;36;32;0.388888888888889;22;14;0.111111111111111;0.388888888888889
Control.SRR15539874;29;32;0.517241379310345;14;15;0.0172413793103449;0.482758620689655
Control.SRR15539874;34;32;0.529411764705882;16;18;0.0294117647058824;0.470588235294118
Control.SRR15539874;36;32;0.555555555555556;16;20;0.0555555555555556;0.444444444444444
Control.SRR15539874;32;32;0.4375;18;14;0.0625;0.4375
Control.SRR15539874;30;32;0.466666666666667;16;14;0.0333333333333333;0.466666666666667
Control.SRR15539874;35;32;0.571428571428571;15;20;0.0714285714285714;0.428571428571429
Control.SRR15539874;34;32;0.323529411764706;23;11;0.176470588235294;0.323529411764706
Control.SRR15539874;37;32;0.621621621621622;14;23;0.121621621621622;0.378378378378378
Control.SRR15539874;37;32;0.567567567567568;16;21;0.0675675675675675;0.432432432432432
Control.SRR15539874;33;32;0.393939393939394;20;13;0.106060606060606;0.393939393939394
Control.SRR15539874;30;32;0.5;15;15;0;0.5
Control.SRR15539874;30;32;0.6;12;18;0.1;0.4
Control.SRR15539874;31;32;0.483870967741935;16;15;0.0161290322580645;0.483870967741935
Control.SRR15539874;35;32;0.485714285714286;18;17;0.0142857142857143;0.485714285714286
Control.SRR15539874;37;32;0.567567567567568;16;21;0.0675675675675675;0.432432432432432
Control.SRR15539874;33;32;0.606060606060606;13;20;0.106060606060606;0.393939393939394
Control.SRR15539874;33;32;0.575757575757576;14;19;0.0757575757575758;0.424242424242424
Control.SRR15539874;32;32;0.5625;14;18;0.0625;0.4375
Control.SRR15539874;33;32;0.424242424242424;19;14;0.0757575757575757;0.424242424242424
Control.SRR15539874;30;32;0.533333333333333;14;16;0.0333333333333333;0.466666666666667
Control.SRR15539874;32;32;0.40625;19;13;0.09375;0.40625
Control.SRR15539874;32;32;0.5;16;16;0;0.5
Control.SRR15539874;34;32;0.558823529411765;15;19;0.0588235294117647;0.441176470588235
Control.SRR15539874;30;32;0.466666666666667;16;14;0.0333333333333333;0.466666666666667
Control.SRR15539874;29;32;0.551724137931034;13;16;0.0517241379310345;0.448275862068966
Control.SRR15539874;34;32;0.470588235294118;18;16;0.0294117647058824;0.470588235294118
Control.SRR15539874;32;32;0.4375;18;14;0.0625;0.4375
Control.SRR15539874;29;32;0.551724137931034;13;16;0.0517241379310345;0.448275862068966
Control.SRR15539874;34;32;0.588235294117647;14;20;0.0882352941176471;0.411764705882353
Control.SRR15539874;35;32;0.485714285714286;18;17;0.0142857142857143;0.485714285714286
Control.SRR15539874;35;32;0.457142857142857;19;16;0.0428571428571429;0.457142857142857
Control.SRR15539874;37;32;0.432432432432432;21;16;0.0675675675675675;0.432432432432432
Control.SRR15539874;34;32;0.529411764705882;16;18;0.0294117647058824;0.470588235294118
Control.SRR15539874;36;32;0.583333333333333;15;21;0.0833333333333334;0.416666666666667
Control.SRR15539874;29;32;0.448275862068966;16;13;0.0517241379310345;0.448275862068966
Control.SRR15539874;33;32;0.636363636363636;12;21;0.136363636363636;0.363636363636364
Control.SRR15539874;36;32;0.638888888888889;13;23;0.138888888888889;0.361111111111111
Control.SRR15539874;36;32;0.5;18;18;0;0.5
Control.SRR15539874;31;32;0.516129032258065;15;16;0.0161290322580645;0.483870967741935
Control.SRR15539874;33;32;0.515151515151515;16;17;0.0151515151515151;0.484848484848485
Control.SRR15539874;34;32;0.5;17;17;0;0.5
Control.SRR15539874;31;32;0.645161290322581;11;20;0.145161290322581;0.354838709677419
Control.SRR15539874;31;32;0.483870967741935;16;15;0.0161290322580645;0.483870967741935
Control.SRR15539874;34;32;0.411764705882353;20;14;0.0882352941176471;0.411764705882353
Control.SRR15539874;37;32;0.513513513513513;18;19;0.0135135135135135;0.486486486486487
Control.SRR15539874;37;32;0.594594594594595;15;22;0.0945945945945946;0.405405405405405
Control.SRR15539874;37;32;0.378378378378378;23;14;0.121621621621622;0.378378378378378
Control.SRR15539874;34;32;0.352941176470588;22;12;0.147058823529412;0.352941176470588
Control.SRR15539874;31;32;0.516129032258065;15;16;0.0161290322580645;0.483870967741935
Control.SRR15539874;34;32;0.441176470588235;19;15;0.0588235294117647;0.441176470588235
Control.SRR15539874;31;32;0.516129032258065;15;16;0.0161290322580645;0.483870967741935
Control.SRR15539874;36;32;0.388888888888889;22;14;0.111111111111111;0.388888888888889
Control.SRR15539874;36;32;0.5;18;18;0;0.5
Control.SRR15539874;37;32;0.459459459459459;20;17;0.0405405405405405;0.459459459459459
Control.SRR15539874;34;32;0.352941176470588;22;12;0.147058823529412;0.352941176470588
Control.SRR15539874;34;32;0.676470588235294;11;23;0.176470588235294;0.323529411764706
Control.SRR15539874;31;32;0.516129032258065;15;16;0.0161290322580645;0.483870967741935
Control.SRR15539874;30;32;0.466666666666667;16;14;0.0333333333333333;0.466666666666667
Control.SRR15539874;34;32;0.441176470588235;19;15;0.0588235294117647;0.441176470588235
Control.SRR15539874;32;32;0.40625;19;13;0.09375;0.40625
Control.SRR15539874;35;32;0.514285714285714;17;18;0.0142857142857142;0.485714285714286
Control.SRR15539874;34;32;0.529411764705882;16;18;0.0294117647058824;0.470588235294118
Control.SRR15539874;30;32;0.6;12;18;0.1;0.4
Control.SRR15539874;35;32;0.485714285714286;18;17;0.0142857142857143;0.485714285714286
Control.SRR15539874;29;32;0.724137931034483;8;21;0.224137931034483;0.275862068965517
Control.SRR15539874;34;32;0.588235294117647;14;20;0.0882352941176471;0.411764705882353
Control.SRR15539874;36;32;0.444444444444444;20;16;0.0555555555555556;0.444444444444444
Control.SRR15539874;37;32;0.540540540540541;17;20;0.0405405405405406;0.459459459459459
Control.SRR15539874;30;32;0.566666666666667;13;17;0.0666666666666667;0.433333333333333
Control.SRR15539874;29;32;0.551724137931034;13;16;0.0517241379310345;0.448275862068966
Control.SRR15539874;34;32;0.558823529411765;15;19;0.0588235294117647;0.441176470588235
Control.SRR15539874;33;32;0.575757575757576;14;19;0.0757575757575758;0.424242424242424
Control.SRR15539874;35;32;0.457142857142857;19;16;0.0428571428571429;0.457142857142857
Control.SRR15539874;31;32;0.451612903225806;17;14;0.0483870967741936;0.451612903225806
Control.SRR15539874;35;32;0.6;14;21;0.1;0.4
Control.SRR15539874;37;32;0.594594594594595;15;22;0.0945945945945946;0.405405405405405
Control.SRR15539874;33;32;0.363636363636364;21;12;0.136363636363636;0.363636363636364
Control.SRR15539874;34;32;0.5;17;17;0;0.5
Control.SRR15539874;37;32;0.567567567567568;16;21;0.0675675675675675;0.432432432432432
Control.SRR15539874;29;32;0.655172413793103;10;19;0.155172413793103;0.344827586206897
Control.SRR15539874;31;32;0.483870967741935;16;15;0.0161290322580645;0.483870967741935
Control.SRR15539874;34;32;0.588235294117647;14;20;0.0882352941176471;0.411764705882353
Control.SRR15539874;32;32;0.46875;17;15;0.03125;0.46875
Control.SRR15539874;37;32;0.459459459459459;20;17;0.0405405405405405;0.459459459459459
Control.SRR15539874;33;32;0.696969696969697;10;23;0.196969696969697;0.303030303030303
Control.SRR15539874;32;32;0.40625;19;13;0.09375;0.40625
Control.SRR15539874;30;32;0.5;15;15;0;0.5
Control.SRR15539874;29;32;0.517241379310345;14;15;0.0172413793103449;0.482758620689655
Control.SRR15539874;30;32;0.633333333333333;11;19;0.133333333333333;0.366666666666667
Control.SRR15539874;32;32;0.46875;17;15;0.03125;0.46875
Control.SRR15539874;29;32;0.758620689655172;7;22;0.258620689655172;0.241379310344828
Control.SRR15539874;30;32;0.433333333333333;17;13;0.0666666666666667;0.433333333333333
Control.SRR15539874;37;32;0.486486486486487;19;18;0.0135135135135135;0.486486486486487
Control.SRR15539874;29;32;0.413793103448276;17;12;0.0862068965517241;0.413793103448276
Control.SRR15539874;37;32;0.405405405405405;22;15;0.0945945945945946;0.405405405405405
Control.SRR15539874;34;32;0.558823529411765;15;19;0.0588235294117647;0.441176470588235
Control.SRR15539874;34;32;0.588235294117647;14;20;0.0882352941176471;0.411764705882353
Control.SRR15539874;31;32;0.645161290322581;11;20;0.145161290322581;0.354838709677419
Control.SRR15539874;29;32;0.448275862068966;16;13;0.0517241379310345;0.448275862068966
Control.SRR15539874;33;32;0.484848484848485;17;16;0.0151515151515151;0.484848484848485
Control.SRR15539874;31;32;0.483870967741935;16;15;0.0161290322580645;0.483870967741935
Control.SRR15539874;33;32;0.424242424242424;19;14;0.0757575757575757;0.424242424242424
Control.SRR15539874;32;32;0.5;16;16;0;0.5
Control.SRR15539874;34;32;0.441176470588235;19;15;0.0588235294117647;0.441176470588235
Control.SRR15539874;35;32;0.485714285714286;18;17;0.0142857142857143;0.485714285714286
Control.SRR15539874;35;32;0.628571428571429;13;22;0.128571428571429;0.371428571428571
Control.SRR15539874;35;32;0.457142857142857;19;16;0.0428571428571429;0.457142857142857
Control.SRR15539874;32;32;0.5625;14;18;0.0625;0.4375
Control.SRR15539874;35;32;0.428571428571429;20;15;0.0714285714285715;0.428571428571429
Control.SRR15539874;33;32;0.515151515151515;16;17;0.0151515151515151;0.484848484848485
Control.SRR15539874;32;32;0.53125;15;17;0.03125;0.46875
Control.SRR15539874;35;32;0.542857142857143;16;19;0.0428571428571428;0.457142857142857
Control.SRR15539874;33;32;0.424242424242424;19;14;0.0757575757575757;0.424242424242424
Control.SRR15539874;36;32;0.472222222222222;19;17;0.0277777777777778;0.472222222222222
Control.SRR15539874;36;32;0.555555555555556;16;20;0.0555555555555556;0.444444444444444
Control.SRR15539874;30;32;0.4;18;12;0.1;0.4
Control.SRR15539874;35;32;0.514285714285714;17;18;0.0142857142857142;0.485714285714286
Control.SRR15539874;29;32;0.482758620689655;15;14;0.0172413793103448;0.482758620689655
Control.SRR15539874;37;32;0.513513513513513;18;19;0.0135135135135135;0.486486486486487
Control.SRR15539874;34;32;0.411764705882353;20;14;0.0882352941176471;0.411764705882353
Control.SRR15539874;35;32;0.514285714285714;17;18;0.0142857142857142;0.485714285714286
Control.SRR15539874;33;32;0.393939393939394;20;13;0.106060606060606;0.393939393939394
Control.SRR15539874;33;32;0.606060606060606;13;20;0.106060606060606;0.393939393939394
Control.SRR15539874;32;32;0.53125;15;17;0.03125;0.46875
Control.SRR15539874;34;32;0.647058823529412;12;22;0.147058823529412;0.352941176470588
Control.SRR15539874;37;32;0.513513513513513;18;19;0.0135135135135135;0.486486486486487
Control.SRR15539874;37;32;0.486486486486487;19;18;0.0135135135135135;0.486486486486487
Control.SRR15539874;30;32;0.466666666666667;16;14;0.0333333333333333;0.466666666666667
Control.SRR15539874;34;32;0.470588235294118;18;16;0.0294117647058824;0.470588235294118
Control.SRR15539874;35;32;0.628571428571429;13;22;0.128571428571429;0.371428571428571
Control.SRR15539874;33;32;0.424242424242424;19;14;0.0757575757575757;0.424242424242424
Control.SRR15539874;35;32;0.4;21;14;0.1;0.4
Control.SRR15539874;34;32;0.558823529411765;15;19;0.0588235294117647;0.441176470588235
Control.SRR15539874;35;32;0.514285714285714;17;18;0.0142857142857142;0.485714285714286
Control.SRR15539874;36;32;0.444444444444444;20;16;0.0555555555555556;0.444444444444444
Control.SRR15539874;36;32;0.555555555555556;16;20;0.0555555555555556;0.444444444444444
Control.SRR15539874;32;32;0.5;16;16;0;0.5
Control.SRR15539874;32;32;0.5625;14;18;0.0625;0.4375
Control.SRR15539874;37;32;0.540540540540541;17;20;0.0405405405405406;0.459459459459459
Control.SRR15539874;34;32;0.352941176470588;22;12;0.147058823529412;0.352941176470588
Control.SRR15539874;34;32;0.441176470588235;19;15;0.0588235294117647;0.441176470588235
Control.SRR15539874;33;32;0.636363636363636;12;21;0.136363636363636;0.363636363636364
Control.SRR15539874;32;32;0.5;16;16;0;0.5
Control.SRR15539874;35;32;0.514285714285714;17;18;0.0142857142857142;0.485714285714286
Control.SRR15539874;31;32;0.516129032258065;15;16;0.0161290322580645;0.483870967741935
Control.SRR15539874;37;32;0.540540540540541;17;20;0.0405405405405406;0.459459459459459
Control.SRR15539874;33;32;0.515151515151515;16;17;0.0151515151515151;0.484848484848485
Control.SRR15539874;33;32;0.606060606060606;13;20;0.106060606060606;0.393939393939394
Control.SRR15539874;31;32;0.645161290322581;11;20;0.145161290322581;0.354838709677419
Control.SRR15539874;32;32;0.40625;19;13;0.09375;0.40625
Control.SRR15539874;31;32;0.354838709677419;20;11;0.145161290322581;0.354838709677419
Control.SRR15539874;31;32;0.516129032258065;15;16;0.0161290322580645;0.483870967741935
Control.SRR15539874;34;32;0.558823529411765;15;19;0.0588235294117647;0.441176470588235
Control.SRR15539874;32;32;0.4375;18;14;0.0625;0.4375
Control.SRR15539874;36;32;0.527777777777778;17;19;0.0277777777777778;0.472222222222222
Control.SRR15539874;34;32;0.411764705882353;20;14;0.0882352941176471;0.411764705882353
Control.SRR15539874;34;32;0.382352941176471;21;13;0.117647058823529;0.382352941176471
Control.SRR15539874;33;32;0.424242424242424;19;14;0.0757575757575757;0.424242424242424
Control.SRR15539874;32;32;0.46875;17;15;0.03125;0.46875
Control.SRR15539874;31;32;0.354838709677419;20;11;0.145161290322581;0.354838709677419
Control.SRR15539874;32;32;0.5625;14;18;0.0625;0.4375
Control.SRR15539874;36;32;0.527777777777778;17;19;0.0277777777777778;0.472222222222222
Control.SRR15539874;36;32;0.666666666666667;12;24;0.166666666666667;0.333333333333333
Control.SRR15539874;32;32;0.53125;15;17;0.03125;0.46875
Control.SRR15539874;33;32;0.363636363636364;21;12;0.136363636363636;0.363636363636364
Control.SRR15539874;33;32;0.454545454545455;18;15;0.0454545454545455;0.454545454545455
Control.SRR15539874;36;32;0.333333333333333;24;12;0.166666666666667;0.333333333333333
Control.SRR15539874;32;32;0.5;16;16;0;0.5
Control.SRR15539874;33;32;0.484848484848485;17;16;0.0151515151515151;0.484848484848485
Control.SRR15539874;32;32;0.65625;11;21;0.15625;0.34375
Control.SRR15539874;32;32;0.5;16;16;0;0.5
Control.SRR15539874;35;32;0.657142857142857;12;23;0.157142857142857;0.342857142857143
Control.SRR15539874;29;32;0.482758620689655;15;14;0.0172413793103448;0.482758620689655
Control.SRR15539874;37;32;0.648648648648649;13;24;0.148648648648649;0.351351351351351
Control.SRR15539874;36;32;0.444444444444444;20;16;0.0555555555555556;0.444444444444444
Control.SRR15539874;37;32;0.432432432432432;21;16;0.0675675675675675;0.432432432432432
Control.SRR15539874;36;32;0.472222222222222;19;17;0.0277777777777778;0.472222222222222
Control.SRR15539874;35;32;0.514285714285714;17;18;0.0142857142857142;0.485714285714286
Control.SRR15539874;30;32;0.433333333333333;17;13;0.0666666666666667;0.433333333333333
Control.SRR15539874;37;32;0.405405405405405;22;15;0.0945945945945946;0.405405405405405
Control.SRR15539874;34;32;0.5;17;17;0;0.5
Control.SRR15539874;31;32;0.387096774193548;19;12;0.112903225806452;0.387096774193548
Control.SRR15539874;33;32;0.424242424242424;19;14;0.0757575757575757;0.424242424242424
Control.SRR15539874;29;32;0.655172413793103;10;19;0.155172413793103;0.344827586206897
Control.SRR15539874;36;32;0.555555555555556;16;20;0.0555555555555556;0.444444444444444
Control.SRR15539874;36;32;0.388888888888889;22;14;0.111111111111111;0.388888888888889
Control.SRR15539874;37;32;0.432432432432432;21;16;0.0675675675675675;0.432432432432432
Control.SRR15539874;35;32;0.6;14;21;0.1;0.4
Control.SRR15539874;37;32;0.540540540540541;17;20;0.0405405405405406;0.459459459459459
Control.SRR15539874;36;32;0.5;18;18;0;0.5
Control.SRR15539874;31;32;0.612903225806452;12;19;0.112903225806452;0.387096774193548
Control.SRR15539874;32;32;0.4375;18;14;0.0625;0.4375
Control.SRR15539874;35;32;0.6;14;21;0.1;0.4
Control.SRR15539874;31;32;0.483870967741935;16;15;0.0161290322580645;0.483870967741935
Control.SRR15539874;29;32;0.620689655172414;11;18;0.120689655172414;0.379310344827586
Control.SRR15539874;32;32;0.5625;14;18;0.0625;0.4375
Control.SRR15539874;37;32;0.567567567567568;16;21;0.0675675675675675;0.432432432432432
Control.SRR15539874;35;32;0.457142857142857;19;16;0.0428571428571429;0.457142857142857
Control.SRR15539874;33;32;0.484848484848485;17;16;0.0151515151515151;0.484848484848485
Control.SRR15539874;31;32;0.612903225806452;12;19;0.112903225806452;0.387096774193548
Control.SRR15539874;33;32;0.606060606060606;13;20;0.106060606060606;0.393939393939394
Control.SRR15539874;30;32;0.566666666666667;13;17;0.0666666666666667;0.433333333333333
Control.SRR15539874;29;32;0.517241379310345;14;15;0.0172413793103449;0.482758620689655
Control.SRR15539874;36;32;0.583333333333333;15;21;0.0833333333333334;0.416666666666667
Control.SRR15539874;31;32;0.451612903225806;17;14;0.0483870967741936;0.451612903225806
Control.SRR15539874;34;32;0.5;17;17;0;0.5
Control.SRR15539874;35;32;0.514285714285714;17;18;0.0142857142857142;0.485714285714286
Control.SRR15539874;29;32;0.517241379310345;14;15;0.0172413793103449;0.482758620689655
Control.SRR15539874;31;32;0.451612903225806;17;14;0.0483870967741936;0.451612903225806
Control.SRR15539874;31;32;0.612903225806452;12;19;0.112903225806452;0.387096774193548
Control.SRR15539874;32;32;0.5;16;16;0;0.5
Control.SRR15539874;34;32;0.470588235294118;18;16;0.0294117647058824;0.470588235294118
Control.SRR15539874;30;32;0.533333333333333;14;16;0.0333333333333333;0.466666666666667
Control.SRR15539874;32;32;0.5;16;16;0;0.5
Control.SRR15539874;34;32;0.647058823529412;12;22;0.147058823529412;0.352941176470588
Control.SRR15539874;33;32;0.666666666666667;11;22;0.166666666666667;0.333333333333333
Control.SRR15539874;30;32;0.6;12;18;0.1;0.4
Control.SRR15539874;31;32;0.483870967741935;16;15;0.0161290322580645;0.483870967741935
Control.SRR15539874;31;32;0.354838709677419;20;11;0.145161290322581;0.354838709677419
Control.SRR15539874;35;32;0.6;14;21;0.1;0.4
Control.SRR15539874;31;32;0.32258064516129;21;10;0.17741935483871;0.32258064516129
Control.SRR15539874;33;32;0.515151515151515;16;17;0.0151515151515151;0.484848484848485
Control.SRR15539874;34;32;0.5;17;17;0;0.5
Control.SRR15539874;30;32;0.6;12;18;0.1;0.4
Control.SRR15539874;33;32;0.363636363636364;21;12;0.136363636363636;0.363636363636364
Control.SRR15539874;33;32;0.606060606060606;13;20;0.106060606060606;0.393939393939394
Control.SRR15539874;34;32;0.441176470588235;19;15;0.0588235294117647;0.441176470588235
Control.SRR15539874;32;32;0.53125;15;17;0.03125;0.46875
Control.SRR15539874;35;32;0.457142857142857;19;16;0.0428571428571429;0.457142857142857
Control.SRR15539874;33;32;0.575757575757576;14;19;0.0757575757575758;0.424242424242424
Control.SRR15539874;30;32;0.5;15;15;0;0.5
Control.SRR15539874;32;32;0.5625;14;18;0.0625;0.4375
Control.SRR15539874;30;32;0.433333333333333;17;13;0.0666666666666667;0.433333333333333
Control.SRR15539874;34;32;0.470588235294118;18;16;0.0294117647058824;0.470588235294118
Control.SRR15539874;37;32;0.432432432432432;21;16;0.0675675675675675;0.432432432432432
Control.SRR15539874;36;32;0.388888888888889;22;14;0.111111111111111;0.388888888888889
Control.SRR15539874;35;32;0.485714285714286;18;17;0.0142857142857143;0.485714285714286
Control.SRR15539874;35;32;0.428571428571429;20;15;0.0714285714285715;0.428571428571429
Control.SRR15539874;32;32;0.5625;14;18;0.0625;0.4375
Control.SRR15539874;30;32;0.666666666666667;10;20;0.166666666666667;0.333333333333333
Control.SRR15539874;31;32;0.612903225806452;12;19;0.112903225806452;0.387096774193548
Control.SRR15539874;31;32;0.580645161290323;13;18;0.0806451612903226;0.419354838709677
Control.SRR15539874;37;32;0.486486486486487;19;18;0.0135135135135135;0.486486486486487
Control.SRR15539874;35;32;0.6;14;21;0.1;0.4
Control.SRR15539874;32;32;0.59375;13;19;0.09375;0.40625
Control.SRR15539874;34;32;0.558823529411765;15;19;0.0588235294117647;0.441176470588235
Control.SRR15539874;33;32;0.606060606060606;13;20;0.106060606060606;0.393939393939394
Control.SRR15539874;35;32;0.571428571428571;15;20;0.0714285714285714;0.428571428571429
Control.SRR15539874;36;32;0.611111111111111;14;22;0.111111111111111;0.388888888888889
Control.SRR15539874;33;32;0.363636363636364;21;12;0.136363636363636;0.363636363636364
Control.SRR15539874;29;32;0.482758620689655;15;14;0.0172413793103448;0.482758620689655
Control.SRR15539874;35;32;0.371428571428571;22;13;0.128571428571429;0.371428571428571
Control.SRR15539874;35;32;0.485714285714286;18;17;0.0142857142857143;0.485714285714286
Control.SRR15539874;37;32;0.513513513513513;18;19;0.0135135135135135;0.486486486486487
Control.SRR15539874;33;32;0.454545454545455;18;15;0.0454545454545455;0.454545454545455
Control.SRR15539874;30;32;0.466666666666667;16;14;0.0333333333333333;0.466666666666667
Control.SRR15539874;36;32;0.444444444444444;20;16;0.0555555555555556;0.444444444444444
Control.SRR15539874;33;32;0.515151515151515;16;17;0.0151515151515151;0.484848484848485
Control.SRR15539874;34;32;0.441176470588235;19;15;0.0588235294117647;0.441176470588235
Control.SRR15539874;30;32;0.533333333333333;14;16;0.0333333333333333;0.466666666666667
Control.SRR15539874;31;32;0.516129032258065;15;16;0.0161290322580645;0.483870967741935
Control.SRR15539874;36;32;0.527777777777778;17;19;0.0277777777777778;0.472222222222222
Control.SRR15539874;31;32;0.451612903225806;17;14;0.0483870967741936;0.451612903225806
Control.SRR15539874;34;32;0.558823529411765;15;19;0.0588235294117647;0.441176470588235
Control.SRR15539874;32;32;0.375;20;12;0.125;0.375
Control.SRR15539874;29;32;0.586206896551724;12;17;0.0862068965517241;0.413793103448276
Control.SRR15539874;34;32;0.382352941176471;21;13;0.117647058823529;0.382352941176471
Control.SRR15539874;32;32;0.53125;15;17;0.03125;0.46875
Control.SRR15539874;31;32;0.483870967741935;16;15;0.0161290322580645;0.483870967741935
Control.SRR15539874;36;32;0.444444444444444;20;16;0.0555555555555556;0.444444444444444
Control.SRR15539874;34;32;0.558823529411765;15;19;0.0588235294117647;0.441176470588235
Control.SRR15539874;37;32;0.432432432432432;21;16;0.0675675675675675;0.432432432432432
Control.SRR15539874;29;32;0.620689655172414;11;18;0.120689655172414;0.379310344827586
Control.SRR15539874;37;32;0.594594594594595;15;22;0.0945945945945946;0.405405405405405
Control.SRR15539874;34;32;0.5;17;17;0;0.5
Control.SRR15539874;30;32;0.5;15;15;0;0.5
Control.SRR15539874;33;32;0.515151515151515;16;17;0.0151515151515151;0.484848484848485
Control.SRR15539874;32;32;0.53125;15;17;0.03125;0.46875
Control.SRR15539874;32;32;0.5;16;16;0;0.5
Control.SRR15539874;34;32;0.411764705882353;20;14;0.0882352941176471;0.411764705882353
Control.SRR15539874;31;32;0.290322580645161;22;9;0.209677419354839;0.290322580645161
Control.SRR15539874;34;32;0.5;17;17;0;0.5
Control.SRR15539874;32;32;0.4375;18;14;0.0625;0.4375
Control.SRR15539874;35;32;0.4;21;14;0.1;0.4
Control.SRR15539874;35;32;0.428571428571429;20;15;0.0714285714285715;0.428571428571429
Control.SRR15539874;33;32;0.303030303030303;23;10;0.196969696969697;0.303030303030303
Control.SRR15539874;29;32;0.517241379310345;14;15;0.0172413793103449;0.482758620689655
Control.SRR15539874;36;32;0.5;18;18;0;0.5
Control.SRR15539874;34;32;0.617647058823529;13;21;0.117647058823529;0.382352941176471
Control.SRR15539874;30;32;0.566666666666667;13;17;0.0666666666666667;0.433333333333333
Control.SRR15539874;34;32;0.676470588235294;11;23;0.176470588235294;0.323529411764706
Control.SRR15539874;36;32;0.527777777777778;17;19;0.0277777777777778;0.472222222222222
Control.SRR15539874;33;32;0.515151515151515;16;17;0.0151515151515151;0.484848484848485
Control.SRR15539874;33;32;0.545454545454545;15;18;0.0454545454545454;0.454545454545455
Control.SRR15539874;29;32;0.586206896551724;12;17;0.0862068965517241;0.413793103448276
Control.SRR15539874;31;32;0.32258064516129;21;10;0.17741935483871;0.32258064516129
Control.SRR15539874;30;32;0.433333333333333;17;13;0.0666666666666667;0.433333333333333
Control.SRR15539874;31;32;0.548387096774194;14;17;0.0483870967741935;0.451612903225806
Control.SRR15539874;37;32;0.567567567567568;16;21;0.0675675675675675;0.432432432432432
Control.SRR15539874;32;32;0.46875;17;15;0.03125;0.46875
Control.SRR15539874;30;32;0.533333333333333;14;16;0.0333333333333333;0.466666666666667
Control.SRR15539874;35;32;0.571428571428571;15;20;0.0714285714285714;0.428571428571429
Control.SRR15539874;29;32;0.551724137931034;13;16;0.0517241379310345;0.448275862068966
Control.SRR15539874;29;32;0.482758620689655;15;14;0.0172413793103448;0.482758620689655
Control.SRR15539874;29;32;0.379310344827586;18;11;0.120689655172414;0.379310344827586
Control.SRR15539874;32;32;0.5625;14;18;0.0625;0.4375
Control.SRR15539874;30;32;0.433333333333333;17;13;0.0666666666666667;0.433333333333333
Control.SRR15539874;36;32;0.583333333333333;15;21;0.0833333333333334;0.416666666666667
Control.SRR15539874;37;32;0.540540540540541;17;20;0.0405405405405406;0.459459459459459
Control.SRR15539874;32;32;0.40625;19;13;0.09375;0.40625
Control.SRR15539874;34;32;0.529411764705882;16;18;0.0294117647058824;0.470588235294118
Control.SRR15539874;36;32;0.25;27;9;0.25;0.25
Control.SRR15539874;35;32;0.457142857142857;19;16;0.0428571428571429;0.457142857142857
Control.SRR15539874;34;32;0.441176470588235;19;15;0.0588235294117647;0.441176470588235
Control.SRR15539874;33;32;0.545454545454545;15;18;0.0454545454545454;0.454545454545455
Control.SRR15539874;33;32;0.363636363636364;21;12;0.136363636363636;0.363636363636364
Control.SRR15539874;29;32;0.517241379310345;14;15;0.0172413793103449;0.482758620689655
Control.SRR15539874;30;32;0.533333333333333;14;16;0.0333333333333333;0.466666666666667
Control.SRR15539874;32;32;0.46875;17;15;0.03125;0.46875
Control.SRR15539874;36;32;0.472222222222222;19;17;0.0277777777777778;0.472222222222222
Control.SRR15539874;30;32;0.6;12;18;0.1;0.4
Control.SRR15539874;35;32;0.428571428571429;20;15;0.0714285714285715;0.428571428571429
Control.SRR15539874;30;32;0.433333333333333;17;13;0.0666666666666667;0.433333333333333
Control.SRR15539874;30;32;0.3;21;9;0.2;0.3
Control.SRR15539874;36;32;0.472222222222222;19;17;0.0277777777777778;0.472222222222222
Control.SRR15539874;34;32;0.352941176470588;22;12;0.147058823529412;0.352941176470588
Control.SRR15539874;31;32;0.451612903225806;17;14;0.0483870967741936;0.451612903225806
Control.SRR15539874;34;32;0.470588235294118;18;16;0.0294117647058824;0.470588235294118
Control.SRR15539874;31;32;0.419354838709677;18;13;0.0806451612903226;0.419354838709677
Control.SRR15539874;36;32;0.472222222222222;19;17;0.0277777777777778;0.472222222222222
Control.SRR15539874;29;32;0.413793103448276;17;12;0.0862068965517241;0.413793103448276
Control.SRR15539874;35;32;0.571428571428571;15;20;0.0714285714285714;0.428571428571429
Control.SRR15539874;33;32;0.393939393939394;20;13;0.106060606060606;0.393939393939394
Control.SRR15539874;31;32;0.645161290322581;11;20;0.145161290322581;0.354838709677419
Control.SRR15539874;37;32;0.405405405405405;22;15;0.0945945945945946;0.405405405405405
Control.SRR15539874;36;32;0.638888888888889;13;23;0.138888888888889;0.361111111111111
Control.SRR15539874;35;32;0.542857142857143;16;19;0.0428571428571428;0.457142857142857
Control.SRR15539874;35;32;0.428571428571429;20;15;0.0714285714285715;0.428571428571429
Control.SRR15539874;31;32;0.516129032258065;15;16;0.0161290322580645;0.483870967741935
Control.SRR15539874;30;32;0.366666666666667;19;11;0.133333333333333;0.366666666666667
Control.SRR15539874;36;32;0.388888888888889;22;14;0.111111111111111;0.388888888888889
Control.SRR15539874;31;32;0.483870967741935;16;15;0.0161290322580645;0.483870967741935
Control.SRR15539874;31;32;0.387096774193548;19;12;0.112903225806452;0.387096774193548
Control.SRR15539874;36;32;0.333333333333333;24;12;0.166666666666667;0.333333333333333
Control.SRR15539874;34;32;0.441176470588235;19;15;0.0588235294117647;0.441176470588235
Control.SRR15539874;30;32;0.7;9;21;0.2;0.3
Control.SRR15539874;35;32;0.571428571428571;15;20;0.0714285714285714;0.428571428571429
Control.SRR15539874;30;32;0.566666666666667;13;17;0.0666666666666667;0.433333333333333
Control.SRR15539874;30;32;0.5;15;15;0;0.5
Control.SRR15539874;33;32;0.484848484848485;17;16;0.0151515151515151;0.484848484848485
Control.SRR15539874;34;32;0.5;17;17;0;0.5
Control.SRR15539874;33;32;0.515151515151515;16;17;0.0151515151515151;0.484848484848485
Control.SRR15539874;34;32;0.352941176470588;22;12;0.147058823529412;0.352941176470588
Control.SRR15539874;29;32;0.482758620689655;15;14;0.0172413793103448;0.482758620689655
Control.SRR15539874;31;32;0.580645161290323;13;18;0.0806451612903226;0.419354838709677
Control.SRR15539874;36;32;0.611111111111111;14;22;0.111111111111111;0.388888888888889
Control.SRR15539874;36;32;0.638888888888889;13;23;0.138888888888889;0.361111111111111
Control.SRR15539874;33;32;0.606060606060606;13;20;0.106060606060606;0.393939393939394
Control.SRR15539874;34;32;0.441176470588235;19;15;0.0588235294117647;0.441176470588235
Control.SRR15539874;33;32;0.515151515151515;16;17;0.0151515151515151;0.484848484848485
Control.SRR15539874;30;32;0.5;15;15;0;0.5
Control.SRR15539874;36;32;0.416666666666667;21;15;0.0833333333333333;0.416666666666667
Control.SRR15539874;29;32;0.586206896551724;12;17;0.0862068965517241;0.413793103448276
Control.SRR15539874;29;32;0.379310344827586;18;11;0.120689655172414;0.379310344827586
Control.SRR15539874;33;32;0.545454545454545;15;18;0.0454545454545454;0.454545454545455
Control.SRR15539874;32;32;0.4375;18;14;0.0625;0.4375
Control.SRR15539874;31;32;0.516129032258065;15;16;0.0161290322580645;0.483870967741935
Control.SRR15539874;29;32;0.551724137931034;13;16;0.0517241379310345;0.448275862068966
Control.SRR15539874;29;32;0.517241379310345;14;15;0.0172413793103449;0.482758620689655
Control.SRR15539874;29;32;0.517241379310345;14;15;0.0172413793103449;0.482758620689655
Control.SRR15539874;36;32;0.361111111111111;23;13;0.138888888888889;0.361111111111111
Control.SRR15539874;36;32;0.472222222222222;19;17;0.0277777777777778;0.472222222222222
Control.SRR15539874;32;32;0.4375;18;14;0.0625;0.4375
Control.SRR15539874;31;32;0.483870967741935;16;15;0.0161290322580645;0.483870967741935
Control.SRR15539874;31;32;0.645161290322581;11;20;0.145161290322581;0.354838709677419
Control.SRR15539874;35;32;0.542857142857143;16;19;0.0428571428571428;0.457142857142857
Control.SRR15539874;35;32;0.542857142857143;16;19;0.0428571428571428;0.457142857142857
Control.SRR15539874;30;32;0.433333333333333;17;13;0.0666666666666667;0.433333333333333
Control.SRR15539874;30;32;0.366666666666667;19;11;0.133333333333333;0.366666666666667
Control.SRR15539874;32;32;0.53125;15;17;0.03125;0.46875
Control.SRR15539874;33;32;0.515151515151515;16;17;0.0151515151515151;0.484848484848485
Control.SRR15539874;37;32;0.405405405405405;22;15;0.0945945945945946;0.405405405405405
Control.SRR15539874;30;32;0.433333333333333;17;13;0.0666666666666667;0.433333333333333
Control.SRR15539874;30;32;0.533333333333333;14;16;0.0333333333333333;0.466666666666667
Control.SRR15539874;32;32;0.5625;14;18;0.0625;0.4375
Control.SRR15539874;34;32;0.205882352941176;27;7;0.294117647058824;0.205882352941176
Control.SRR15539874;32;32;0.4375;18;14;0.0625;0.4375
Control.SRR15539874;29;32;0.586206896551724;12;17;0.0862068965517241;0.413793103448276
Control.SRR15539874;29;32;0.620689655172414;11;18;0.120689655172414;0.379310344827586
Control.SRR15539874;30;32;0.533333333333333;14;16;0.0333333333333333;0.466666666666667
Control.SRR15539874;31;32;0.451612903225806;17;14;0.0483870967741936;0.451612903225806
Control.SRR15539874;33;32;0.393939393939394;20;13;0.106060606060606;0.393939393939394
Control.SRR15539874;35;32;0.4;21;14;0.1;0.4
Control.SRR15539874;34;32;0.676470588235294;11;23;0.176470588235294;0.323529411764706
Control.SRR15539874;33;32;0.424242424242424;19;14;0.0757575757575757;0.424242424242424
Control.SRR15539874;30;32;0.533333333333333;14;16;0.0333333333333333;0.466666666666667
Control.SRR15539874;29;32;0.586206896551724;12;17;0.0862068965517241;0.413793103448276
Control.SRR15539874;29;32;0.620689655172414;11;18;0.120689655172414;0.379310344827586
Control.SRR15539874;36;32;0.444444444444444;20;16;0.0555555555555556;0.444444444444444
Control.SRR15539874;34;32;0.441176470588235;19;15;0.0588235294117647;0.441176470588235
Control.SRR15539874;33;32;0.424242424242424;19;14;0.0757575757575757;0.424242424242424
Control.SRR15539874;35;32;0.485714285714286;18;17;0.0142857142857143;0.485714285714286
Control.SRR15539874;30;32;0.533333333333333;14;16;0.0333333333333333;0.466666666666667
Control.SRR15539874;32;32;0.3125;22;10;0.1875;0.3125
Control.SRR15539874;31;32;0.483870967741935;16;15;0.0161290322580645;0.483870967741935
Control.SRR15539874;33;32;0.484848484848485;17;16;0.0151515151515151;0.484848484848485
Control.SRR15539874;37;32;0.540540540540541;17;20;0.0405405405405406;0.459459459459459
Control.SRR15539874;32;32;0.46875;17;15;0.03125;0.46875
Control.SRR15539874;33;32;0.424242424242424;19;14;0.0757575757575757;0.424242424242424
Control.SRR15539874;33;32;0.545454545454545;15;18;0.0454545454545454;0.454545454545455
Control.SRR15539874;35;32;0.542857142857143;16;19;0.0428571428571428;0.457142857142857
Control.SRR15539874;33;32;0.363636363636364;21;12;0.136363636363636;0.363636363636364
Control.SRR15539874;33;32;0.575757575757576;14;19;0.0757575757575758;0.424242424242424
Control.SRR15539874;34;32;0.558823529411765;15;19;0.0588235294117647;0.441176470588235
Control.SRR15539874;34;32;0.382352941176471;21;13;0.117647058823529;0.382352941176471
Control.SRR15539874;34;32;0.470588235294118;18;16;0.0294117647058824;0.470588235294118
Control.SRR15539874;37;32;0.405405405405405;22;15;0.0945945945945946;0.405405405405405
Control.SRR15539874;34;32;0.529411764705882;16;18;0.0294117647058824;0.470588235294118
Control.SRR15539874;33;32;0.424242424242424;19;14;0.0757575757575757;0.424242424242424
Control.SRR15539874;35;32;0.628571428571429;13;22;0.128571428571429;0.371428571428571
Control.SRR15539874;34;32;0.529411764705882;16;18;0.0294117647058824;0.470588235294118
Control.SRR15539874;33;32;0.606060606060606;13;20;0.106060606060606;0.393939393939394
Control.SRR15539874;35;32;0.514285714285714;17;18;0.0142857142857142;0.485714285714286
Control.SRR15539874;36;32;0.444444444444444;20;16;0.0555555555555556;0.444444444444444
Control.SRR15539874;35;32;0.4;21;14;0.1;0.4
Control.SRR15539874;30;32;0.633333333333333;11;19;0.133333333333333;0.366666666666667
Control.SRR15539874;35;32;0.514285714285714;17;18;0.0142857142857142;0.485714285714286
Control.SRR15539874;32;32;0.5;16;16;0;0.5
Control.SRR15539874;34;32;0.382352941176471;21;13;0.117647058823529;0.382352941176471
Control.SRR15539874;31;32;0.483870967741935;16;15;0.0161290322580645;0.483870967741935
Control.SRR15539874;30;32;0.6;12;18;0.1;0.4
Control.SRR15539874;31;32;0.645161290322581;11;20;0.145161290322581;0.354838709677419
Control.SRR15539874;31;32;0.548387096774194;14;17;0.0483870967741935;0.451612903225806
Control.SRR15539874;31;32;0.483870967741935;16;15;0.0161290322580645;0.483870967741935
Control.SRR15539874;30;32;0.366666666666667;19;11;0.133333333333333;0.366666666666667
Control.SRR15539874;33;32;0.484848484848485;17;16;0.0151515151515151;0.484848484848485
Control.SRR15539874;33;32;0.545454545454545;15;18;0.0454545454545454;0.454545454545455
Control.SRR15539874;35;32;0.6;14;21;0.1;0.4
Control.SRR15539874;31;32;0.387096774193548;19;12;0.112903225806452;0.387096774193548
Control.SRR15539874;32;32;0.59375;13;19;0.09375;0.40625
Control.SRR15539874;31;32;0.354838709677419;20;11;0.145161290322581;0.354838709677419
Control.SRR15539874;31;32;0.483870967741935;16;15;0.0161290322580645;0.483870967741935
Control.SRR15539874;32;32;0.53125;15;17;0.03125;0.46875
Control.SRR15539874;35;32;0.428571428571429;20;15;0.0714285714285715;0.428571428571429
Control.SRR15539874;29;32;0.448275862068966;16;13;0.0517241379310345;0.448275862068966
Control.SRR15539874;32;32;0.625;12;20;0.125;0.375
Control.SRR15539874;34;32;0.588235294117647;14;20;0.0882352941176471;0.411764705882353
Control.SRR15539874;29;32;0.344827586206897;19;10;0.155172413793103;0.344827586206897
Control.SRR15539874;31;32;0.516129032258065;15;16;0.0161290322580645;0.483870967741935
Control.SRR15539874;33;32;0.484848484848485;17;16;0.0151515151515151;0.484848484848485
Control.SRR15539874;36;32;0.5;18;18;0;0.5
Control.SRR15539874;35;32;0.457142857142857;19;16;0.0428571428571429;0.457142857142857
Control.SRR15539874;36;32;0.5;18;18;0;0.5
Control.SRR15539874;30;32;0.5;15;15;0;0.5
Control.SRR15539874;32;32;0.5625;14;18;0.0625;0.4375
Control.SRR15539874;37;32;0.378378378378378;23;14;0.121621621621622;0.378378378378378
Control.SRR15539874;34;32;0.382352941176471;21;13;0.117647058823529;0.382352941176471
Control.SRR15539874;32;32;0.34375;21;11;0.15625;0.34375
Control.SRR15539874;34;32;0.617647058823529;13;21;0.117647058823529;0.382352941176471
Control.SRR15539874;31;32;0.32258064516129;21;10;0.17741935483871;0.32258064516129
Control.SRR15539874;30;32;0.533333333333333;14;16;0.0333333333333333;0.466666666666667
Control.SRR15539874;33;32;0.636363636363636;12;21;0.136363636363636;0.363636363636364
Control.SRR15539874;31;32;0.483870967741935;16;15;0.0161290322580645;0.483870967741935
Control.SRR15539874;34;32;0.382352941176471;21;13;0.117647058823529;0.382352941176471
Control.SRR15539874;36;32;0.444444444444444;20;16;0.0555555555555556;0.444444444444444
Control.SRR15539874;32;32;0.46875;17;15;0.03125;0.46875
Control.SRR15539874;32;32;0.34375;21;11;0.15625;0.34375
Control.SRR15539874;35;32;0.485714285714286;18;17;0.0142857142857143;0.485714285714286
Control.SRR15539874;33;32;0.575757575757576;14;19;0.0757575757575758;0.424242424242424
Control.SRR15539874;37;32;0.513513513513513;18;19;0.0135135135135135;0.486486486486487
Control.SRR15539874;31;32;0.548387096774194;14;17;0.0483870967741935;0.451612903225806
Control.SRR15539874;30;32;0.566666666666667;13;17;0.0666666666666667;0.433333333333333
Control.SRR15539874;33;32;0.545454545454545;15;18;0.0454545454545454;0.454545454545455
Control.SRR15539874;33;32;0.424242424242424;19;14;0.0757575757575757;0.424242424242424
Control.SRR15539874;34;32;0.470588235294118;18;16;0.0294117647058824;0.470588235294118
Control.SRR15539874;30;32;0.466666666666667;16;14;0.0333333333333333;0.466666666666667
Control.SRR15539874;35;32;0.457142857142857;19;16;0.0428571428571429;0.457142857142857
Control.SRR15539874;35;32;0.428571428571429;20;15;0.0714285714285715;0.428571428571429
Control.SRR15539874;36;32;0.5;18;18;0;0.5
Control.SRR15539874;30;32;0.5;15;15;0;0.5
Control.SRR15539874;31;32;0.516129032258065;15;16;0.0161290322580645;0.483870967741935
Control.SRR15539874;30;32;0.533333333333333;14;16;0.0333333333333333;0.466666666666667
Control.SRR15539874;30;32;0.4;18;12;0.1;0.4
Control.SRR15539874;30;32;0.533333333333333;14;16;0.0333333333333333;0.466666666666667
Control.SRR15539874;33;32;0.545454545454545;15;18;0.0454545454545454;0.454545454545455
Control.SRR15539874;35;32;0.485714285714286;18;17;0.0142857142857143;0.485714285714286
Control.SRR15539874;30;32;0.4;18;12;0.1;0.4
Control.SRR15539874;29;32;0.344827586206897;19;10;0.155172413793103;0.344827586206897
Control.SRR15539874;29;32;0.517241379310345;14;15;0.0172413793103449;0.482758620689655
Control.SRR15539874;30;32;0.433333333333333;17;13;0.0666666666666667;0.433333333333333
Control.SRR15539874;30;32;0.466666666666667;16;14;0.0333333333333333;0.466666666666667
Control.SRR15539874;33;32;0.484848484848485;17;16;0.0151515151515151;0.484848484848485
Control.SRR15539874;30;32;0.6;12;18;0.1;0.4
Control.SRR15539874;31;32;0.483870967741935;16;15;0.0161290322580645;0.483870967741935
Control.SRR15539874;37;32;0.621621621621622;14;23;0.121621621621622;0.378378378378378
Control.SRR15539874;36;32;0.5;18;18;0;0.5
Control.SRR15539874;31;32;0.483870967741935;16;15;0.0161290322580645;0.483870967741935
Control.SRR15539874;31;32;0.451612903225806;17;14;0.0483870967741936;0.451612903225806
Control.SRR15539874;31;32;0.516129032258065;15;16;0.0161290322580645;0.483870967741935
Control.SRR15539874;37;32;0.486486486486487;19;18;0.0135135135135135;0.486486486486487
Control.SRR15539874;30;32;0.566666666666667;13;17;0.0666666666666667;0.433333333333333
Control.SRR15539874;34;32;0.470588235294118;18;16;0.0294117647058824;0.470588235294118
Control.SRR15539874;33;32;0.515151515151515;16;17;0.0151515151515151;0.484848484848485
Control.SRR15539874;34;32;0.5;17;17;0;0.5
Control.SRR15539874;33;32;0.515151515151515;16;17;0.0151515151515151;0.484848484848485
Control.SRR15539874;34;32;0.5;17;17;0;0.5
Control.SRR15539874;34;32;0.411764705882353;20;14;0.0882352941176471;0.411764705882353
Control.SRR15539874;32;32;0.40625;19;13;0.09375;0.40625
Control.SRR15539874;37;32;0.459459459459459;20;17;0.0405405405405405;0.459459459459459
Control.SRR15539874;35;32;0.4;21;14;0.1;0.4
Control.SRR15539874;30;32;0.4;18;12;0.1;0.4
Control.SRR15539874;35;32;0.571428571428571;15;20;0.0714285714285714;0.428571428571429
Control.SRR15539874;30;32;0.6;12;18;0.1;0.4
Control.SRR15539874;35;32;0.428571428571429;20;15;0.0714285714285715;0.428571428571429
Control.SRR15539874;34;32;0.441176470588235;19;15;0.0588235294117647;0.441176470588235
Control.SRR15539874;34;32;0.352941176470588;22;12;0.147058823529412;0.352941176470588
Control.SRR15539874;37;32;0.459459459459459;20;17;0.0405405405405405;0.459459459459459
Control.SRR15539874;31;32;0.516129032258065;15;16;0.0161290322580645;0.483870967741935
Control.SRR15539874;29;32;0.551724137931034;13;16;0.0517241379310345;0.448275862068966
Control.SRR15539874;32;32;0.40625;19;13;0.09375;0.40625
Control.SRR15539874;35;32;0.485714285714286;18;17;0.0142857142857143;0.485714285714286
Control.SRR15539874;34;32;0.382352941176471;21;13;0.117647058823529;0.382352941176471
Control.SRR15539874;36;32;0.527777777777778;17;19;0.0277777777777778;0.472222222222222
Control.SRR15539874;37;32;0.378378378378378;23;14;0.121621621621622;0.378378378378378
Control.SRR15539874;32;32;0.375;20;12;0.125;0.375
Control.SRR15539874;30;32;0.633333333333333;11;19;0.133333333333333;0.366666666666667
Control.SRR15539874;36;32;0.611111111111111;14;22;0.111111111111111;0.388888888888889
Control.SRR15539874;30;32;0.666666666666667;10;20;0.166666666666667;0.333333333333333
Control.SRR15539874;30;32;0.533333333333333;14;16;0.0333333333333333;0.466666666666667
Control.SRR15539874;30;32;0.566666666666667;13;17;0.0666666666666667;0.433333333333333
Control.SRR15539874;30;32;0.666666666666667;10;20;0.166666666666667;0.333333333333333
Control.SRR15539874;29;32;0.448275862068966;16;13;0.0517241379310345;0.448275862068966
Control.SRR15539874;34;32;0.617647058823529;13;21;0.117647058823529;0.382352941176471
Control.SRR15539874;33;32;0.515151515151515;16;17;0.0151515151515151;0.484848484848485
Control.SRR15539874;32;32;0.625;12;20;0.125;0.375
Control.SRR15539874;30;32;0.4;18;12;0.1;0.4
Control.SRR15539874;33;32;0.545454545454545;15;18;0.0454545454545454;0.454545454545455
Control.SRR15539874;33;32;0.575757575757576;14;19;0.0757575757575758;0.424242424242424
Control.SRR15539874;36;32;0.583333333333333;15;21;0.0833333333333334;0.416666666666667
Control.SRR15539874;30;32;0.533333333333333;14;16;0.0333333333333333;0.466666666666667
Control.SRR15539874;31;32;0.548387096774194;14;17;0.0483870967741935;0.451612903225806
Control.SRR15539874;37;32;0.405405405405405;22;15;0.0945945945945946;0.405405405405405
Control.SRR15539874;36;32;0.388888888888889;22;14;0.111111111111111;0.388888888888889
Control.SRR15539874;35;32;0.628571428571429;13;22;0.128571428571429;0.371428571428571
Control.SRR15539874;34;32;0.411764705882353;20;14;0.0882352941176471;0.411764705882353
Control.SRR15539874;37;32;0.378378378378378;23;14;0.121621621621622;0.378378378378378
Control.SRR15539874;30;32;0.5;15;15;0;0.5
Control.SRR15539874;34;32;0.588235294117647;14;20;0.0882352941176471;0.411764705882353
Control.SRR15539874;30;32;0.5;15;15;0;0.5
Control.SRR15539874;32;32;0.375;20;12;0.125;0.375
Control.SRR15539874;35;32;0.428571428571429;20;15;0.0714285714285715;0.428571428571429
Control.SRR15539874;31;32;0.516129032258065;15;16;0.0161290322580645;0.483870967741935
Control.SRR15539874;35;32;0.542857142857143;16;19;0.0428571428571428;0.457142857142857
Control.SRR15539874;37;32;0.459459459459459;20;17;0.0405405405405405;0.459459459459459
Control.SRR15539874;30;32;0.733333333333333;8;22;0.233333333333333;0.266666666666667
Control.SRR15539874;30;32;0.566666666666667;13;17;0.0666666666666667;0.433333333333333
Control.SRR15539874;34;32;0.529411764705882;16;18;0.0294117647058824;0.470588235294118
Control.SRR15539874;35;32;0.571428571428571;15;20;0.0714285714285714;0.428571428571429
Control.SRR15539874;30;32;0.433333333333333;17;13;0.0666666666666667;0.433333333333333
Control.SRR15539874;32;32;0.4375;18;14;0.0625;0.4375
Control.SRR15539874;31;32;0.580645161290323;13;18;0.0806451612903226;0.419354838709677
Control.SRR15539874;34;32;0.441176470588235;19;15;0.0588235294117647;0.441176470588235
Control.SRR15539874;34;32;0.382352941176471;21;13;0.117647058823529;0.382352941176471
Control.SRR15539874;30;32;0.466666666666667;16;14;0.0333333333333333;0.466666666666667
Control.SRR15539874;36;32;0.583333333333333;15;21;0.0833333333333334;0.416666666666667
Control.SRR15539874;37;32;0.513513513513513;18;19;0.0135135135135135;0.486486486486487
Control.SRR15539874;29;32;0.586206896551724;12;17;0.0862068965517241;0.413793103448276
Control.SRR15539874;31;32;0.483870967741935;16;15;0.0161290322580645;0.483870967741935
Control.SRR15539874;37;32;0.513513513513513;18;19;0.0135135135135135;0.486486486486487
Control.SRR15539874;31;32;0.32258064516129;21;10;0.17741935483871;0.32258064516129
Control.SRR15539874;34;32;0.470588235294118;18;16;0.0294117647058824;0.470588235294118
Control.SRR15539874;30;32;0.533333333333333;14;16;0.0333333333333333;0.466666666666667
Control.SRR15539874;37;32;0.567567567567568;16;21;0.0675675675675675;0.432432432432432
Control.SRR15539874;34;32;0.382352941176471;21;13;0.117647058823529;0.382352941176471
Control.SRR15539874;30;32;0.533333333333333;14;16;0.0333333333333333;0.466666666666667
Control.SRR15539874;30;32;0.5;15;15;0;0.5
Control.SRR15539874;33;32;0.515151515151515;16;17;0.0151515151515151;0.484848484848485
Control.SRR15539874;35;32;0.657142857142857;12;23;0.157142857142857;0.342857142857143
Control.SRR15539874;31;32;0.612903225806452;12;19;0.112903225806452;0.387096774193548
Control.SRR15539874;36;32;0.444444444444444;20;16;0.0555555555555556;0.444444444444444
Control.SRR15539874;35;32;0.6;14;21;0.1;0.4
Control.SRR15539874;33;32;0.515151515151515;16;17;0.0151515151515151;0.484848484848485
Control.SRR15539874;36;32;0.583333333333333;15;21;0.0833333333333334;0.416666666666667
Control.SRR15539874;35;32;0.457142857142857;19;16;0.0428571428571429;0.457142857142857
Control.SRR15539874;31;32;0.709677419354839;9;22;0.209677419354839;0.290322580645161
Control.SRR15539874;35;32;0.485714285714286;18;17;0.0142857142857143;0.485714285714286
Control.SRR15539874;29;32;0.551724137931034;13;16;0.0517241379310345;0.448275862068966
Control.SRR15539874;34;32;0.323529411764706;23;11;0.176470588235294;0.323529411764706
Control.SRR15539874;35;32;0.6;14;21;0.1;0.4
Control.SRR15539874;32;32;0.53125;15;17;0.03125;0.46875
Control.SRR15539874;31;32;0.387096774193548;19;12;0.112903225806452;0.387096774193548
Control.SRR15539874;35;32;0.514285714285714;17;18;0.0142857142857142;0.485714285714286
Control.SRR15539874;33;32;0.515151515151515;16;17;0.0151515151515151;0.484848484848485
Control.SRR15539874;30;32;0.566666666666667;13;17;0.0666666666666667;0.433333333333333
Control.SRR15539874;33;32;0.393939393939394;20;13;0.106060606060606;0.393939393939394
Control.SRR15539874;37;32;0.351351351351351;24;13;0.148648648648649;0.351351351351351
Control.SRR15539874;34;32;0.294117647058824;24;10;0.205882352941176;0.294117647058824
Control.SRR15539874;29;32;0.310344827586207;20;9;0.189655172413793;0.310344827586207
Control.SRR15539874;30;32;0.5;15;15;0;0.5
Control.SRR15539874;29;32;0.517241379310345;14;15;0.0172413793103449;0.482758620689655
Control.SRR15539874;30;32;0.533333333333333;14;16;0.0333333333333333;0.466666666666667
Control.SRR15539874;31;32;0.580645161290323;13;18;0.0806451612903226;0.419354838709677
Control.SRR15539874;30;32;0.566666666666667;13;17;0.0666666666666667;0.433333333333333
Control.SRR15539874;30;32;0.7;9;21;0.2;0.3
Control.SRR15539874;31;32;0.548387096774194;14;17;0.0483870967741935;0.451612903225806
Control.SRR15539874;32;32;0.46875;17;15;0.03125;0.46875
Control.SRR15539874;32;32;0.5625;14;18;0.0625;0.4375
Control.SRR15539874;32;32;0.4375;18;14;0.0625;0.4375
Control.SRR15539874;34;32;0.470588235294118;18;16;0.0294117647058824;0.470588235294118
Control.SRR15539874;37;32;0.378378378378378;23;14;0.121621621621622;0.378378378378378
Control.SRR15539874;33;32;0.545454545454545;15;18;0.0454545454545454;0.454545454545455
Control.SRR15539874;32;32;0.5;16;16;0;0.5
Control.SRR15539874;37;32;0.378378378378378;23;14;0.121621621621622;0.378378378378378
Control.SRR15539874;29;32;0.448275862068966;16;13;0.0517241379310345;0.448275862068966
Control.SRR15539874;33;32;0.484848484848485;17;16;0.0151515151515151;0.484848484848485
Control.SRR15539874;36;32;0.472222222222222;19;17;0.0277777777777778;0.472222222222222
Control.SRR15539874;34;32;0.470588235294118;18;16;0.0294117647058824;0.470588235294118
Control.SRR15539874;30;32;0.566666666666667;13;17;0.0666666666666667;0.433333333333333
Control.SRR15539874;34;32;0.411764705882353;20;14;0.0882352941176471;0.411764705882353
Control.SRR15539874;37;32;0.540540540540541;17;20;0.0405405405405406;0.459459459459459
Control.SRR15539874;29;32;0.413793103448276;17;12;0.0862068965517241;0.413793103448276
Control.SRR15539874;31;32;0.258064516129032;23;8;0.241935483870968;0.258064516129032
Control.SRR15539874;30;32;0.566666666666667;13;17;0.0666666666666667;0.433333333333333
Control.SRR15539874;29;32;0.448275862068966;16;13;0.0517241379310345;0.448275862068966
Control.SRR15539874;36;32;0.416666666666667;21;15;0.0833333333333333;0.416666666666667
Control.SRR15539874;29;32;0.620689655172414;11;18;0.120689655172414;0.379310344827586
Control.SRR15539874;32;32;0.5625;14;18;0.0625;0.4375
Control.SRR15539874;30;32;0.5;15;15;0;0.5
Control.SRR15539874;31;32;0.645161290322581;11;20;0.145161290322581;0.354838709677419
Control.SRR15539874;37;32;0.378378378378378;23;14;0.121621621621622;0.378378378378378
Control.SRR15539874;33;32;0.515151515151515;16;17;0.0151515151515151;0.484848484848485
Control.SRR15539874;29;32;0.482758620689655;15;14;0.0172413793103448;0.482758620689655
Control.SRR15539874;31;32;0.483870967741935;16;15;0.0161290322580645;0.483870967741935
Control.SRR15539874;34;32;0.441176470588235;19;15;0.0588235294117647;0.441176470588235
Control.SRR15539874;34;32;0.617647058823529;13;21;0.117647058823529;0.382352941176471
Control.SRR15539874;31;32;0.548387096774194;14;17;0.0483870967741935;0.451612903225806
Control.SRR15539874;32;32;0.34375;21;11;0.15625;0.34375
Control.SRR15539874;31;32;0.451612903225806;17;14;0.0483870967741936;0.451612903225806
Control.SRR15539874;37;32;0.459459459459459;20;17;0.0405405405405405;0.459459459459459
Control.SRR15539874;32;32;0.53125;15;17;0.03125;0.46875
Control.SRR15539874;36;32;0.472222222222222;19;17;0.0277777777777778;0.472222222222222
Control.SRR15539874;31;32;0.516129032258065;15;16;0.0161290322580645;0.483870967741935
Control.SRR15539874;30;32;0.533333333333333;14;16;0.0333333333333333;0.466666666666667
Control.SRR15539874;34;32;0.617647058823529;13;21;0.117647058823529;0.382352941176471
Control.SRR15539874;33;32;0.393939393939394;20;13;0.106060606060606;0.393939393939394
Control.SRR15539874;37;32;0.513513513513513;18;19;0.0135135135135135;0.486486486486487
Control.SRR15539874;37;32;0.621621621621622;14;23;0.121621621621622;0.378378378378378
Control.SRR15539874;30;32;0.366666666666667;19;11;0.133333333333333;0.366666666666667
Control.SRR15539874;36;32;0.333333333333333;24;12;0.166666666666667;0.333333333333333
Control.SRR15539874;31;32;0.451612903225806;17;14;0.0483870967741936;0.451612903225806
Control.SRR15539874;35;32;0.514285714285714;17;18;0.0142857142857142;0.485714285714286
Control.SRR15539874;35;32;0.342857142857143;23;12;0.157142857142857;0.342857142857143
Control.SRR15539874;36;32;0.583333333333333;15;21;0.0833333333333334;0.416666666666667
Control.SRR15539874;32;32;0.5;16;16;0;0.5
Control.SRR15539874;36;32;0.527777777777778;17;19;0.0277777777777778;0.472222222222222
Control.SRR15539874;36;32;0.527777777777778;17;19;0.0277777777777778;0.472222222222222
Control.SRR15539874;31;32;0.516129032258065;15;16;0.0161290322580645;0.483870967741935
Control.SRR15539874;31;32;0.451612903225806;17;14;0.0483870967741936;0.451612903225806
Control.SRR15539874;31;32;0.483870967741935;16;15;0.0161290322580645;0.483870967741935
Control.SRR15539874;37;32;0.513513513513513;18;19;0.0135135135135135;0.486486486486487
Control.SRR15539874;36;32;0.527777777777778;17;19;0.0277777777777778;0.472222222222222
Control.SRR15539874;31;32;0.548387096774194;14;17;0.0483870967741935;0.451612903225806
Control.SRR15539874;33;32;0.545454545454545;15;18;0.0454545454545454;0.454545454545455
Control.SRR15539874;35;32;0.457142857142857;19;16;0.0428571428571429;0.457142857142857
Control.SRR15539874;36;32;0.527777777777778;17;19;0.0277777777777778;0.472222222222222
Control.SRR15539874;34;32;0.382352941176471;21;13;0.117647058823529;0.382352941176471
Control.SRR15539874;30;32;0.4;18;12;0.1;0.4
Control.SRR15539874;35;32;0.514285714285714;17;18;0.0142857142857142;0.485714285714286
Control.SRR15539874;34;32;0.529411764705882;16;18;0.0294117647058824;0.470588235294118
Control.SRR15539874;34;32;0.676470588235294;11;23;0.176470588235294;0.323529411764706
Control.SRR15539874;35;32;0.371428571428571;22;13;0.128571428571429;0.371428571428571
Control.SRR15539874;34;32;0.352941176470588;22;12;0.147058823529412;0.352941176470588
Control.SRR15539874;31;32;0.483870967741935;16;15;0.0161290322580645;0.483870967741935
Control.SRR15539874;37;32;0.432432432432432;21;16;0.0675675675675675;0.432432432432432
Control.SRR15539874;33;32;0.454545454545455;18;15;0.0454545454545455;0.454545454545455
Control.SRR15539874;35;32;0.485714285714286;18;17;0.0142857142857143;0.485714285714286
Control.SRR15539874;35;32;0.342857142857143;23;12;0.157142857142857;0.342857142857143
Control.SRR15539874;36;32;0.583333333333333;15;21;0.0833333333333334;0.416666666666667
Control.SRR15539874;34;32;0.647058823529412;12;22;0.147058823529412;0.352941176470588
Control.SRR15539874;29;32;0.448275862068966;16;13;0.0517241379310345;0.448275862068966
Control.SRR15539874;34;32;0.5;17;17;0;0.5
Control.SRR15539874;34;32;0.382352941176471;21;13;0.117647058823529;0.382352941176471
Control.SRR15539874;32;32;0.46875;17;15;0.03125;0.46875
Control.SRR15539874;37;32;0.432432432432432;21;16;0.0675675675675675;0.432432432432432
Control.SRR15539874;30;32;0.4;18;12;0.1;0.4
Control.SRR15539874;29;32;0.517241379310345;14;15;0.0172413793103449;0.482758620689655
Control.SRR15539874;32;32;0.59375;13;19;0.09375;0.40625
Control.SRR15539874;35;32;0.457142857142857;19;16;0.0428571428571429;0.457142857142857
Control.SRR15539874;37;32;0.405405405405405;22;15;0.0945945945945946;0.405405405405405
Control.SRR15539874;35;32;0.428571428571429;20;15;0.0714285714285715;0.428571428571429
Control.SRR15539874;35;32;0.514285714285714;17;18;0.0142857142857142;0.485714285714286
Control.SRR15539874;34;32;0.529411764705882;16;18;0.0294117647058824;0.470588235294118
Control.SRR15539874;35;32;0.485714285714286;18;17;0.0142857142857143;0.485714285714286
Control.SRR15539874;33;32;0.484848484848485;17;16;0.0151515151515151;0.484848484848485
Control.SRR15539874;36;32;0.416666666666667;21;15;0.0833333333333333;0.416666666666667
Control.SRR15539874;30;32;0.5;15;15;0;0.5
Control.SRR15539874;32;32;0.5;16;16;0;0.5
Control.SRR15539874;35;32;0.457142857142857;19;16;0.0428571428571429;0.457142857142857
Control.SRR15539874;37;32;0.459459459459459;20;17;0.0405405405405405;0.459459459459459
Control.SRR15539874;33;32;0.666666666666667;11;22;0.166666666666667;0.333333333333333
Control.SRR15539874;31;32;0.548387096774194;14;17;0.0483870967741935;0.451612903225806
Control.SRR15539874;36;32;0.416666666666667;21;15;0.0833333333333333;0.416666666666667
Control.SRR15539874;35;32;0.542857142857143;16;19;0.0428571428571428;0.457142857142857
Control.SRR15539874;30;32;0.566666666666667;13;17;0.0666666666666667;0.433333333333333
Control.SRR15539874;30;32;0.266666666666667;22;8;0.233333333333333;0.266666666666667
Control.SRR15539874;31;32;0.67741935483871;10;21;0.17741935483871;0.32258064516129
Control.SRR15539874;34;32;0.588235294117647;14;20;0.0882352941176471;0.411764705882353
Control.SRR15539874;37;32;0.486486486486487;19;18;0.0135135135135135;0.486486486486487
Control.SRR15539874;37;32;0.459459459459459;20;17;0.0405405405405405;0.459459459459459
Control.SRR15539874;37;32;0.459459459459459;20;17;0.0405405405405405;0.459459459459459
Control.SRR15539874;30;32;0.4;18;12;0.1;0.4
Control.SRR15539874;36;32;0.472222222222222;19;17;0.0277777777777778;0.472222222222222
Control.SRR15539874;32;32;0.53125;15;17;0.03125;0.46875
Control.SRR15539874;32;32;0.53125;15;17;0.03125;0.46875
Control.SRR15539874;37;32;0.513513513513513;18;19;0.0135135135135135;0.486486486486487
Control.SRR15539874;33;32;0.484848484848485;17;16;0.0151515151515151;0.484848484848485
Control.SRR15539874;31;32;0.548387096774194;14;17;0.0483870967741935;0.451612903225806
Control.SRR15539874;37;32;0.621621621621622;14;23;0.121621621621622;0.378378378378378
Control.SRR15539874;30;32;0.433333333333333;17;13;0.0666666666666667;0.433333333333333
Control.SRR15539874;37;32;0.540540540540541;17;20;0.0405405405405406;0.459459459459459
Control.SRR15539874;37;32;0.459459459459459;20;17;0.0405405405405405;0.459459459459459
Control.SRR15539874;35;32;0.314285714285714;24;11;0.185714285714286;0.314285714285714
Control.SRR15539874;32;32;0.4375;18;14;0.0625;0.4375
Control.SRR15539874;34;32;0.470588235294118;18;16;0.0294117647058824;0.470588235294118
Control.SRR15539874;34;32;0.470588235294118;18;16;0.0294117647058824;0.470588235294118
Control.SRR15539874;35;32;0.542857142857143;16;19;0.0428571428571428;0.457142857142857
Control.SRR15539874;32;32;0.5625;14;18;0.0625;0.4375
Control.SRR15539874;37;32;0.567567567567568;16;21;0.0675675675675675;0.432432432432432
Control.SRR15539874;32;32;0.5;16;16;0;0.5
Control.SRR15539874;30;32;0.566666666666667;13;17;0.0666666666666667;0.433333333333333
Control.SRR15539874;30;32;0.4;18;12;0.1;0.4
Control.SRR15539874;30;32;0.6;12;18;0.1;0.4
Control.SRR15539874;31;32;0.645161290322581;11;20;0.145161290322581;0.354838709677419
Control.SRR15539874;33;32;0.545454545454545;15;18;0.0454545454545454;0.454545454545455
Control.SRR15539874;30;32;0.433333333333333;17;13;0.0666666666666667;0.433333333333333
Control.SRR15539874;35;32;0.514285714285714;17;18;0.0142857142857142;0.485714285714286
Control.SRR15539874;34;32;0.5;17;17;0;0.5
Control.SRR15539874;30;32;0.433333333333333;17;13;0.0666666666666667;0.433333333333333
Control.SRR15539874;34;32;0.529411764705882;16;18;0.0294117647058824;0.470588235294118
Control.SRR15539874;34;32;0.470588235294118;18;16;0.0294117647058824;0.470588235294118
Control.SRR15539874;32;32;0.375;20;12;0.125;0.375
Control.SRR15539874;35;32;0.485714285714286;18;17;0.0142857142857143;0.485714285714286
Control.SRR15539874;37;32;0.486486486486487;19;18;0.0135135135135135;0.486486486486487
Control.SRR15539874;36;32;0.472222222222222;19;17;0.0277777777777778;0.472222222222222
Control.SRR15539874;33;32;0.575757575757576;14;19;0.0757575757575758;0.424242424242424
Control.SRR15539874;36;32;0.583333333333333;15;21;0.0833333333333334;0.416666666666667
Control.SRR15539874;36;32;0.638888888888889;13;23;0.138888888888889;0.361111111111111
Control.SRR15539874;37;32;0.432432432432432;21;16;0.0675675675675675;0.432432432432432
Control.SRR15539874;33;32;0.484848484848485;17;16;0.0151515151515151;0.484848484848485
Control.SRR15539874;33;32;0.545454545454545;15;18;0.0454545454545454;0.454545454545455
Control.SRR15539874;32;32;0.4375;18;14;0.0625;0.4375
Control.SRR15539874;32;32;0.5;16;16;0;0.5
Control.SRR15539874;31;32;0.451612903225806;17;14;0.0483870967741936;0.451612903225806
Control.SRR15539874;35;32;0.514285714285714;17;18;0.0142857142857142;0.485714285714286
Control.SRR15539874;29;32;0.551724137931034;13;16;0.0517241379310345;0.448275862068966
Control.SRR15539874;29;32;0.586206896551724;12;17;0.0862068965517241;0.413793103448276
Control.SRR15539874;36;32;0.472222222222222;19;17;0.0277777777777778;0.472222222222222
Control.SRR15539874;29;32;0.586206896551724;12;17;0.0862068965517241;0.413793103448276
Control.SRR15539874;32;32;0.625;12;20;0.125;0.375
Control.SRR15539874;34;32;0.5;17;17;0;0.5
Control.SRR15539874;35;32;0.485714285714286;18;17;0.0142857142857143;0.485714285714286
Control.SRR15539874;31;32;0.32258064516129;21;10;0.17741935483871;0.32258064516129
Control.SRR15539874;30;32;0.4;18;12;0.1;0.4
Control.SRR15539874;30;32;0.433333333333333;17;13;0.0666666666666667;0.433333333333333
Control.SRR15539874;29;32;0.655172413793103;10;19;0.155172413793103;0.344827586206897
Control.SRR15539874;37;32;0.459459459459459;20;17;0.0405405405405405;0.459459459459459
Control.SRR15539874;31;32;0.483870967741935;16;15;0.0161290322580645;0.483870967741935
Control.SRR15539874;37;32;0.378378378378378;23;14;0.121621621621622;0.378378378378378
Control.SRR15539874;35;32;0.485714285714286;18;17;0.0142857142857143;0.485714285714286
Control.SRR15539874;35;32;0.6;14;21;0.1;0.4
Control.SRR15539874;34;32;0.470588235294118;18;16;0.0294117647058824;0.470588235294118
Control.SRR15539874;37;32;0.540540540540541;17;20;0.0405405405405406;0.459459459459459
Control.SRR15539874;37;32;0.540540540540541;17;20;0.0405405405405406;0.459459459459459
Control.SRR15539874;34;32;0.5;17;17;0;0.5
Control.SRR15539874;30;32;0.466666666666667;16;14;0.0333333333333333;0.466666666666667
Control.SRR15539874;35;32;0.457142857142857;19;16;0.0428571428571429;0.457142857142857
Control.SRR15539874;37;32;0.513513513513513;18;19;0.0135135135135135;0.486486486486487
Control.SRR15539874;30;32;0.6;12;18;0.1;0.4
Control.SRR15539874;35;32;0.428571428571429;20;15;0.0714285714285715;0.428571428571429
Control.SRR15539874;32;32;0.625;12;20;0.125;0.375
Control.SRR15539874;37;32;0.459459459459459;20;17;0.0405405405405405;0.459459459459459
Control.SRR15539874;31;32;0.516129032258065;15;16;0.0161290322580645;0.483870967741935
Control.SRR15539874;31;32;0.483870967741935;16;15;0.0161290322580645;0.483870967741935
Control.SRR15539874;35;32;0.4;21;14;0.1;0.4
Control.SRR15539874;34;32;0.205882352941176;27;7;0.294117647058824;0.205882352941176
Control.SRR15539874;35;32;0.428571428571429;20;15;0.0714285714285715;0.428571428571429
Control.SRR15539874;33;32;0.515151515151515;16;17;0.0151515151515151;0.484848484848485
Control.SRR15539874;35;32;0.371428571428571;22;13;0.128571428571429;0.371428571428571
Control.SRR15539874;32;32;0.53125;15;17;0.03125;0.46875
Control.SRR15539874;29;32;0.448275862068966;16;13;0.0517241379310345;0.448275862068966
Control.SRR15539874;37;32;0.567567567567568;16;21;0.0675675675675675;0.432432432432432
Control.SRR15539874;29;32;0.413793103448276;17;12;0.0862068965517241;0.413793103448276
Control.SRR15539874;37;32;0.432432432432432;21;16;0.0675675675675675;0.432432432432432
Control.SRR15539874;37;32;0.432432432432432;21;16;0.0675675675675675;0.432432432432432
Control.SRR15539874;35;32;0.485714285714286;18;17;0.0142857142857143;0.485714285714286
Control.SRR15539874;32;32;0.5;16;16;0;0.5
Control.SRR15539874;34;32;0.5;17;17;0;0.5
Control.SRR15539874;32;32;0.5;16;16;0;0.5
Control.SRR15539874;37;32;0.567567567567568;16;21;0.0675675675675675;0.432432432432432
Control.SRR15539874;33;32;0.393939393939394;20;13;0.106060606060606;0.393939393939394
Control.SRR15539874;37;32;0.486486486486487;19;18;0.0135135135135135;0.486486486486487
Control.SRR15539874;31;32;0.483870967741935;16;15;0.0161290322580645;0.483870967741935
Control.SRR15539874;32;32;0.625;12;20;0.125;0.375
Control.SRR15539874;35;32;0.542857142857143;16;19;0.0428571428571428;0.457142857142857
Control.SRR15539874;36;32;0.444444444444444;20;16;0.0555555555555556;0.444444444444444
Control.SRR15539874;33;32;0.515151515151515;16;17;0.0151515151515151;0.484848484848485
Control.SRR15539874;36;32;0.666666666666667;12;24;0.166666666666667;0.333333333333333
Control.SRR15539874;34;32;0.558823529411765;15;19;0.0588235294117647;0.441176470588235
Control.SRR15539874;36;32;0.611111111111111;14;22;0.111111111111111;0.388888888888889
Control.SRR15539874;36;32;0.472222222222222;19;17;0.0277777777777778;0.472222222222222
Control.SRR15539874;34;32;0.588235294117647;14;20;0.0882352941176471;0.411764705882353
Control.SRR15539874;33;32;0.575757575757576;14;19;0.0757575757575758;0.424242424242424
Control.SRR15539874;37;32;0.567567567567568;16;21;0.0675675675675675;0.432432432432432
Control.SRR15539874;32;32;0.5;16;16;0;0.5
Control.SRR15539874;29;32;0.448275862068966;16;13;0.0517241379310345;0.448275862068966
Control.SRR15539874;34;32;0.411764705882353;20;14;0.0882352941176471;0.411764705882353
Control.SRR15539874;31;32;0.516129032258065;15;16;0.0161290322580645;0.483870967741935
Control.SRR15539874;36;32;0.5;18;18;0;0.5
Control.SRR15539874;33;32;0.696969696969697;10;23;0.196969696969697;0.303030303030303
Control.SRR15539874;31;32;0.451612903225806;17;14;0.0483870967741936;0.451612903225806
Control.SRR15539874;33;32;0.484848484848485;17;16;0.0151515151515151;0.484848484848485
Control.SRR15539874;34;32;0.558823529411765;15;19;0.0588235294117647;0.441176470588235
Control.SRR15539874;33;32;0.515151515151515;16;17;0.0151515151515151;0.484848484848485
Control.SRR15539874;37;32;0.486486486486487;19;18;0.0135135135135135;0.486486486486487
Control.SRR15539874;35;32;0.571428571428571;15;20;0.0714285714285714;0.428571428571429
Control.SRR15539874;33;32;0.515151515151515;16;17;0.0151515151515151;0.484848484848485
Control.SRR15539874;31;32;0.451612903225806;17;14;0.0483870967741936;0.451612903225806
Control.SRR15539874;29;32;0.379310344827586;18;11;0.120689655172414;0.379310344827586
Control.SRR15539874;32;32;0.46875;17;15;0.03125;0.46875
Control.SRR15539874;30;32;0.466666666666667;16;14;0.0333333333333333;0.466666666666667
Control.SRR15539874;33;32;0.606060606060606;13;20;0.106060606060606;0.393939393939394
Control.SRR15539874;34;32;0.470588235294118;18;16;0.0294117647058824;0.470588235294118
Control.SRR15539874;36;32;0.611111111111111;14;22;0.111111111111111;0.388888888888889
Control.SRR15539874;36;32;0.5;18;18;0;0.5
Control.SRR15539874;37;32;0.567567567567568;16;21;0.0675675675675675;0.432432432432432
Control.SRR15539874;32;32;0.46875;17;15;0.03125;0.46875
Control.SRR15539874;36;32;0.583333333333333;15;21;0.0833333333333334;0.416666666666667
Control.SRR15539874;37;32;0.486486486486487;19;18;0.0135135135135135;0.486486486486487
Control.SRR15539874;34;32;0.470588235294118;18;16;0.0294117647058824;0.470588235294118
Control.SRR15539874;32;32;0.71875;9;23;0.21875;0.28125
Control.SRR15539874;30;32;0.333333333333333;20;10;0.166666666666667;0.333333333333333
Control.SRR15539874;29;32;0.413793103448276;17;12;0.0862068965517241;0.413793103448276
Control.SRR15539874;33;32;0.454545454545455;18;15;0.0454545454545455;0.454545454545455
Control.SRR15539874;29;32;0.482758620689655;15;14;0.0172413793103448;0.482758620689655
Control.SRR15539874;30;32;0.566666666666667;13;17;0.0666666666666667;0.433333333333333
Control.SRR15539874;37;32;0.702702702702703;11;26;0.202702702702703;0.297297297297297
Control.SRR15539874;35;32;0.342857142857143;23;12;0.157142857142857;0.342857142857143
Control.SRR15539874;35;32;0.485714285714286;18;17;0.0142857142857143;0.485714285714286
Control.SRR15539874;34;32;0.529411764705882;16;18;0.0294117647058824;0.470588235294118
Control.SRR15539874;37;32;0.648648648648649;13;24;0.148648648648649;0.351351351351351
Control.SRR15539874;29;32;0.344827586206897;19;10;0.155172413793103;0.344827586206897
Control.SRR15539874;30;32;0.4;18;12;0.1;0.4
Control.SRR15539874;30;32;0.533333333333333;14;16;0.0333333333333333;0.466666666666667
Control.SRR15539874;35;32;0.657142857142857;12;23;0.157142857142857;0.342857142857143
Control.SRR15539874;35;32;0.4;21;14;0.1;0.4
Control.SRR15539874;37;32;0.27027027027027;27;10;0.22972972972973;0.27027027027027
Control.SRR15539874;29;32;0.344827586206897;19;10;0.155172413793103;0.344827586206897
Control.SRR15539874;37;32;0.540540540540541;17;20;0.0405405405405406;0.459459459459459
Control.SRR15539874;32;32;0.5625;14;18;0.0625;0.4375
Control.SRR15539874;33;32;0.575757575757576;14;19;0.0757575757575758;0.424242424242424
Control.SRR15539874;30;32;0.566666666666667;13;17;0.0666666666666667;0.433333333333333
Control.SRR15539874;35;32;0.428571428571429;20;15;0.0714285714285715;0.428571428571429
Control.SRR15539874;30;32;0.466666666666667;16;14;0.0333333333333333;0.466666666666667
Control.SRR15539874;36;32;0.5;18;18;0;0.5
Control.SRR15539874;35;32;0.485714285714286;18;17;0.0142857142857143;0.485714285714286
Control.SRR15539874;33;32;0.333333333333333;22;11;0.166666666666667;0.333333333333333
Control.SRR15539874;31;32;0.483870967741935;16;15;0.0161290322580645;0.483870967741935
Control.SRR15539874;36;32;0.388888888888889;22;14;0.111111111111111;0.388888888888889
Control.SRR15539874;33;32;0.515151515151515;16;17;0.0151515151515151;0.484848484848485
Control.SRR15539874;33;32;0.484848484848485;17;16;0.0151515151515151;0.484848484848485
Control.SRR15539874;32;32;0.59375;13;19;0.09375;0.40625
Control.SRR15539874;30;32;0.566666666666667;13;17;0.0666666666666667;0.433333333333333
Control.SRR15539874;32;32;0.6875;10;22;0.1875;0.3125
Control.SRR15539874;30;32;0.466666666666667;16;14;0.0333333333333333;0.466666666666667
Control.SRR15539874;36;32;0.5;18;18;0;0.5
Control.SRR15539874;33;32;0.454545454545455;18;15;0.0454545454545455;0.454545454545455
Control.SRR15539874;35;32;0.514285714285714;17;18;0.0142857142857142;0.485714285714286
Control.SRR15539874;29;32;0.517241379310345;14;15;0.0172413793103449;0.482758620689655
Control.SRR15539874;37;32;0.540540540540541;17;20;0.0405405405405406;0.459459459459459
Control.SRR15539874;35;32;0.457142857142857;19;16;0.0428571428571429;0.457142857142857
Control.SRR15539874;30;32;0.533333333333333;14;16;0.0333333333333333;0.466666666666667
Control.SRR15539874;30;32;0.566666666666667;13;17;0.0666666666666667;0.433333333333333
Control.SRR15539874;37;32;0.486486486486487;19;18;0.0135135135135135;0.486486486486487
Control.SRR15539874;36;32;0.5;18;18;0;0.5
Control.SRR15539874;34;32;0.5;17;17;0;0.5
Control.SRR15539874;32;32;0.4375;18;14;0.0625;0.4375
Control.SRR15539874;33;32;0.454545454545455;18;15;0.0454545454545455;0.454545454545455
Control.SRR15539874;36;32;0.666666666666667;12;24;0.166666666666667;0.333333333333333
Control.SRR15539874;34;32;0.411764705882353;20;14;0.0882352941176471;0.411764705882353
Control.SRR15539874;34;32;0.411764705882353;20;14;0.0882352941176471;0.411764705882353
Control.SRR15539874;30;32;0.4;18;12;0.1;0.4
Control.SRR15539874;34;32;0.705882352941177;10;24;0.205882352941177;0.294117647058824
Control.SRR15539874;37;32;0.324324324324324;25;12;0.175675675675676;0.324324324324324
Control.SRR15539874;34;32;0.5;17;17;0;0.5
Control.SRR15539874;34;32;0.5;17;17;0;0.5
Control.SRR15539874;30;32;0.533333333333333;14;16;0.0333333333333333;0.466666666666667
Control.SRR15539874;30;32;0.4;18;12;0.1;0.4
Control.SRR15539874;37;32;0.540540540540541;17;20;0.0405405405405406;0.459459459459459
Control.SRR15539874;34;32;0.382352941176471;21;13;0.117647058823529;0.382352941176471
Control.SRR15539874;35;32;0.428571428571429;20;15;0.0714285714285715;0.428571428571429
Control.SRR15539874;34;32;0.588235294117647;14;20;0.0882352941176471;0.411764705882353
Control.SRR15539874;37;32;0.459459459459459;20;17;0.0405405405405405;0.459459459459459
Control.SRR15539874;37;32;0.540540540540541;17;20;0.0405405405405406;0.459459459459459
Control.SRR15539874;31;32;0.387096774193548;19;12;0.112903225806452;0.387096774193548
Control.SRR15539874;33;32;0.636363636363636;12;21;0.136363636363636;0.363636363636364
Control.SRR15539874;33;32;0.545454545454545;15;18;0.0454545454545454;0.454545454545455
Control.SRR15539874;35;32;0.6;14;21;0.1;0.4
Control.SRR15539874;34;32;0.529411764705882;16;18;0.0294117647058824;0.470588235294118
Control.SRR15539874;34;32;0.470588235294118;18;16;0.0294117647058824;0.470588235294118
Control.SRR15539874;35;32;0.457142857142857;19;16;0.0428571428571429;0.457142857142857
Control.SRR15539874;35;32;0.485714285714286;18;17;0.0142857142857143;0.485714285714286
Control.SRR15539874;37;32;0.540540540540541;17;20;0.0405405405405406;0.459459459459459
Control.SRR15539874;36;32;0.472222222222222;19;17;0.0277777777777778;0.472222222222222
Control.SRR15539874;34;32;0.529411764705882;16;18;0.0294117647058824;0.470588235294118
Control.SRR15539874;35;32;0.485714285714286;18;17;0.0142857142857143;0.485714285714286
Control.SRR15539874;31;32;0.483870967741935;16;15;0.0161290322580645;0.483870967741935
Control.SRR15539874;29;32;0.344827586206897;19;10;0.155172413793103;0.344827586206897
Control.SRR15539874;35;32;0.457142857142857;19;16;0.0428571428571429;0.457142857142857
Control.SRR15539874;29;32;0.551724137931034;13;16;0.0517241379310345;0.448275862068966
Control.SRR15539874;37;32;0.405405405405405;22;15;0.0945945945945946;0.405405405405405
Control.SRR15539874;31;32;0.516129032258065;15;16;0.0161290322580645;0.483870967741935
Control.SRR15539874;35;32;0.457142857142857;19;16;0.0428571428571429;0.457142857142857
Control.SRR15539874;30;32;0.433333333333333;17;13;0.0666666666666667;0.433333333333333
Control.SRR15539874;31;32;0.387096774193548;19;12;0.112903225806452;0.387096774193548
Control.SRR15539874;31;32;0.580645161290323;13;18;0.0806451612903226;0.419354838709677
Control.SRR15539874;36;32;0.444444444444444;20;16;0.0555555555555556;0.444444444444444
Control.SRR15539874;29;32;0.413793103448276;17;12;0.0862068965517241;0.413793103448276
Control.SRR15539874;36;32;0.555555555555556;16;20;0.0555555555555556;0.444444444444444
Control.SRR15539874;31;32;0.32258064516129;21;10;0.17741935483871;0.32258064516129
Control.SRR15539874;37;32;0.567567567567568;16;21;0.0675675675675675;0.432432432432432
Control.SRR15539874;37;32;0.567567567567568;16;21;0.0675675675675675;0.432432432432432
Control.SRR15539874;35;32;0.485714285714286;18;17;0.0142857142857143;0.485714285714286
Control.SRR15539874;32;32;0.5625;14;18;0.0625;0.4375
Control.SRR15539874;35;32;0.4;21;14;0.1;0.4
Control.SRR15539874;30;32;0.466666666666667;16;14;0.0333333333333333;0.466666666666667
Control.SRR15539874;35;32;0.514285714285714;17;18;0.0142857142857142;0.485714285714286
Control.SRR15539874;29;32;0.517241379310345;14;15;0.0172413793103449;0.482758620689655
Control.SRR15539874;30;32;0.6;12;18;0.1;0.4
Control.SRR15539874;36;32;0.555555555555556;16;20;0.0555555555555556;0.444444444444444
Control.SRR15539874;36;32;0.472222222222222;19;17;0.0277777777777778;0.472222222222222
Control.SRR15539874;34;32;0.470588235294118;18;16;0.0294117647058824;0.470588235294118
Control.SRR15539874;33;32;0.333333333333333;22;11;0.166666666666667;0.333333333333333
Control.SRR15539874;32;32;0.5;16;16;0;0.5
Control.SRR15539874;31;32;0.645161290322581;11;20;0.145161290322581;0.354838709677419
Control.SRR15539874;33;32;0.454545454545455;18;15;0.0454545454545455;0.454545454545455
Control.SRR15539874;33;32;0.484848484848485;17;16;0.0151515151515151;0.484848484848485
Control.SRR15539874;37;32;0.513513513513513;18;19;0.0135135135135135;0.486486486486487
Control.SRR15539874;32;32;0.40625;19;13;0.09375;0.40625
Control.SRR15539874;35;32;0.457142857142857;19;16;0.0428571428571429;0.457142857142857
Control.SRR15539874;37;32;0.432432432432432;21;16;0.0675675675675675;0.432432432432432
Control.SRR15539874;34;32;0.441176470588235;19;15;0.0588235294117647;0.441176470588235
Control.SRR15539874;35;32;0.514285714285714;17;18;0.0142857142857142;0.485714285714286
Control.SRR15539874;36;32;0.527777777777778;17;19;0.0277777777777778;0.472222222222222
Control.SRR15539874;31;32;0.580645161290323;13;18;0.0806451612903226;0.419354838709677
Control.SRR15539874;36;32;0.611111111111111;14;22;0.111111111111111;0.388888888888889
Control.SRR15539874;31;32;0.483870967741935;16;15;0.0161290322580645;0.483870967741935
Control.SRR15539874;31;32;0.580645161290323;13;18;0.0806451612903226;0.419354838709677
Control.SRR15539874;32;32;0.40625;19;13;0.09375;0.40625
Control.SRR15539874;31;32;0.580645161290323;13;18;0.0806451612903226;0.419354838709677
Control.SRR15539874;35;32;0.4;21;14;0.1;0.4
Control.SRR15539874;33;32;0.454545454545455;18;15;0.0454545454545455;0.454545454545455
Control.SRR15539874;32;32;0.625;12;20;0.125;0.375
Control.SRR15539874;30;32;0.533333333333333;14;16;0.0333333333333333;0.466666666666667
Control.SRR15539874;36;32;0.555555555555556;16;20;0.0555555555555556;0.444444444444444
Control.SRR15539874;30;32;0.6;12;18;0.1;0.4
Control.SRR15539874;36;32;0.472222222222222;19;17;0.0277777777777778;0.472222222222222
Control.SRR15539874;36;32;0.5;18;18;0;0.5
Control.SRR15539874;32;32;0.59375;13;19;0.09375;0.40625
Control.SRR15539874;31;32;0.548387096774194;14;17;0.0483870967741935;0.451612903225806
Control.SRR15539874;35;32;0.457142857142857;19;16;0.0428571428571429;0.457142857142857
Control.SRR15539874;31;32;0.548387096774194;14;17;0.0483870967741935;0.451612903225806
Control.SRR15539874;35;32;0.542857142857143;16;19;0.0428571428571428;0.457142857142857
Control.SRR15539874;36;32;0.5;18;18;0;0.5
Control.SRR15539874;35;32;0.514285714285714;17;18;0.0142857142857142;0.485714285714286
Control.SRR15539874;36;32;0.527777777777778;17;19;0.0277777777777778;0.472222222222222
Control.SRR15539874;31;32;0.516129032258065;15;16;0.0161290322580645;0.483870967741935
Control.SRR15539874;30;32;0.633333333333333;11;19;0.133333333333333;0.366666666666667
Control.SRR15539874;37;32;0.378378378378378;23;14;0.121621621621622;0.378378378378378
Control.SRR15539874;31;32;0.516129032258065;15;16;0.0161290322580645;0.483870967741935
Control.SRR15539874;32;32;0.5;16;16;0;0.5
Control.SRR15539874;29;32;0.482758620689655;15;14;0.0172413793103448;0.482758620689655
Control.SRR15539874;37;32;0.540540540540541;17;20;0.0405405405405406;0.459459459459459
Control.SRR15539874;37;32;0.540540540540541;17;20;0.0405405405405406;0.459459459459459
Control.SRR15539874;35;32;0.485714285714286;18;17;0.0142857142857143;0.485714285714286
Control.SRR15539874;31;32;0.419354838709677;18;13;0.0806451612903226;0.419354838709677
Control.SRR15539874;34;32;0.5;17;17;0;0.5
Control.SRR15539874;31;32;0.483870967741935;16;15;0.0161290322580645;0.483870967741935
Control.SRR15539874;36;32;0.5;18;18;0;0.5
Control.SRR15539874;30;32;0.6;12;18;0.1;0.4
Control.SRR15539874;35;32;0.514285714285714;17;18;0.0142857142857142;0.485714285714286
Control.SRR15539874;30;32;0.5;15;15;0;0.5
Control.SRR15539874;35;32;0.4;21;14;0.1;0.4
Control.SRR15539874;32;32;0.5;16;16;0;0.5
Control.SRR15539874;32;32;0.53125;15;17;0.03125;0.46875
Control.SRR15539874;34;32;0.5;17;17;0;0.5
Control.SRR15539874;36;32;0.5;18;18;0;0.5
Control.SRR15539874;37;32;0.459459459459459;20;17;0.0405405405405405;0.459459459459459
Control.SRR15539874;31;32;0.548387096774194;14;17;0.0483870967741935;0.451612903225806
Control.SRR15539874;32;32;0.59375;13;19;0.09375;0.40625
Control.SRR15539874;29;32;0.482758620689655;15;14;0.0172413793103448;0.482758620689655
Control.SRR15539874;30;32;0.666666666666667;10;20;0.166666666666667;0.333333333333333
Control.SRR15539874;32;32;0.625;12;20;0.125;0.375
Control.SRR15539874;36;32;0.583333333333333;15;21;0.0833333333333334;0.416666666666667
Control.SRR15539874;37;32;0.648648648648649;13;24;0.148648648648649;0.351351351351351
Control.SRR15539874;37;32;0.486486486486487;19;18;0.0135135135135135;0.486486486486487
Control.SRR15539874;36;32;0.5;18;18;0;0.5
Control.SRR15539874;32;32;0.375;20;12;0.125;0.375
Control.SRR15539874;29;32;0.620689655172414;11;18;0.120689655172414;0.379310344827586
Control.SRR15539874;35;32;0.4;21;14;0.1;0.4
Control.SRR15539874;33;32;0.515151515151515;16;17;0.0151515151515151;0.484848484848485
Control.SRR15539874;31;32;0.387096774193548;19;12;0.112903225806452;0.387096774193548
Control.SRR15539874;30;32;0.533333333333333;14;16;0.0333333333333333;0.466666666666667
Control.SRR15539874;36;32;0.416666666666667;21;15;0.0833333333333333;0.416666666666667
Control.SRR15539874;29;32;0.517241379310345;14;15;0.0172413793103449;0.482758620689655
Control.SRR15539874;31;32;0.67741935483871;10;21;0.17741935483871;0.32258064516129
Control.SRR15539874;35;32;0.457142857142857;19;16;0.0428571428571429;0.457142857142857
Control.SRR15539874;31;32;0.419354838709677;18;13;0.0806451612903226;0.419354838709677
Control.SRR15539874;33;32;0.545454545454545;15;18;0.0454545454545454;0.454545454545455
Control.SRR15539874;35;32;0.628571428571429;13;22;0.128571428571429;0.371428571428571
Control.SRR15539874;34;32;0.411764705882353;20;14;0.0882352941176471;0.411764705882353
Control.SRR15539874;32;32;0.59375;13;19;0.09375;0.40625
Control.SRR15539874;36;32;0.527777777777778;17;19;0.0277777777777778;0.472222222222222
Control.SRR15539874;35;32;0.571428571428571;15;20;0.0714285714285714;0.428571428571429
Control.SRR15539874;34;32;0.558823529411765;15;19;0.0588235294117647;0.441176470588235
Control.SRR15539874;29;32;0.517241379310345;14;15;0.0172413793103449;0.482758620689655
Control.SRR15539874;32;32;0.40625;19;13;0.09375;0.40625
Control.SRR15539874;37;32;0.540540540540541;17;20;0.0405405405405406;0.459459459459459
Control.SRR15539874;34;32;0.5;17;17;0;0.5
Control.SRR15539874;35;32;0.685714285714286;11;24;0.185714285714286;0.314285714285714
Control.SRR15539874;36;32;0.444444444444444;20;16;0.0555555555555556;0.444444444444444
Control.SRR15539874;35;32;0.542857142857143;16;19;0.0428571428571428;0.457142857142857
Control.SRR15539874;34;32;0.647058823529412;12;22;0.147058823529412;0.352941176470588
Control.SRR15539874;34;32;0.558823529411765;15;19;0.0588235294117647;0.441176470588235
Control.SRR15539874;32;32;0.46875;17;15;0.03125;0.46875
Control.SRR15539874;33;32;0.363636363636364;21;12;0.136363636363636;0.363636363636364
Control.SRR15539874;29;32;0.482758620689655;15;14;0.0172413793103448;0.482758620689655
Control.SRR15539874;30;32;0.433333333333333;17;13;0.0666666666666667;0.433333333333333
Control.SRR15539874;35;32;0.542857142857143;16;19;0.0428571428571428;0.457142857142857
Control.SRR15539874;33;32;0.303030303030303;23;10;0.196969696969697;0.303030303030303
Control.SRR15539874;29;32;0.482758620689655;15;14;0.0172413793103448;0.482758620689655
Control.SRR15539874;36;32;0.416666666666667;21;15;0.0833333333333333;0.416666666666667
Control.SRR15539874;32;32;0.59375;13;19;0.09375;0.40625
Control.SRR15539874;35;32;0.514285714285714;17;18;0.0142857142857142;0.485714285714286
Control.SRR15539874;34;32;0.558823529411765;15;19;0.0588235294117647;0.441176470588235
Control.SRR15539874;29;32;0.448275862068966;16;13;0.0517241379310345;0.448275862068966
Control.SRR15539874;31;32;0.451612903225806;17;14;0.0483870967741936;0.451612903225806
Control.SRR15539874;37;32;0.513513513513513;18;19;0.0135135135135135;0.486486486486487
Control.SRR15539874;32;32;0.5;16;16;0;0.5
Control.SRR15539874;31;32;0.258064516129032;23;8;0.241935483870968;0.258064516129032
Control.SRR15539874;32;32;0.5625;14;18;0.0625;0.4375
Control.SRR15539874;30;32;0.4;18;12;0.1;0.4
Control.SRR15539874;34;32;0.470588235294118;18;16;0.0294117647058824;0.470588235294118
Control.SRR15539874;36;32;0.555555555555556;16;20;0.0555555555555556;0.444444444444444
Control.SRR15539874;31;32;0.451612903225806;17;14;0.0483870967741936;0.451612903225806
Control.SRR15539874;36;32;0.416666666666667;21;15;0.0833333333333333;0.416666666666667
Control.SRR15539874;36;32;0.777777777777778;8;28;0.277777777777778;0.222222222222222
Control.SRR15539874;30;32;0.5;15;15;0;0.5
Control.SRR15539874;29;32;0.379310344827586;18;11;0.120689655172414;0.379310344827586
Control.SRR15539874;30;32;0.533333333333333;14;16;0.0333333333333333;0.466666666666667
Control.SRR15539874;32;32;0.6875;10;22;0.1875;0.3125
Control.SRR15539874;34;32;0.617647058823529;13;21;0.117647058823529;0.382352941176471
Control.SRR15539874;33;32;0.484848484848485;17;16;0.0151515151515151;0.484848484848485
Control.SRR15539874;33;32;0.545454545454545;15;18;0.0454545454545454;0.454545454545455
Control.SRR15539874;31;32;0.451612903225806;17;14;0.0483870967741936;0.451612903225806
Control.SRR15539874;37;32;0.540540540540541;17;20;0.0405405405405406;0.459459459459459
Control.SRR15539874;30;32;0.633333333333333;11;19;0.133333333333333;0.366666666666667
Control.SRR15539874;32;32;0.46875;17;15;0.03125;0.46875
Control.SRR15539874;35;32;0.485714285714286;18;17;0.0142857142857143;0.485714285714286
Control.SRR15539874;33;32;0.545454545454545;15;18;0.0454545454545454;0.454545454545455
Control.SRR15539874;29;32;0.379310344827586;18;11;0.120689655172414;0.379310344827586
Control.SRR15539874;31;32;0.516129032258065;15;16;0.0161290322580645;0.483870967741935
Control.SRR15539874;32;32;0.5625;14;18;0.0625;0.4375
Control.SRR15539874;29;32;0.586206896551724;12;17;0.0862068965517241;0.413793103448276
Control.SRR15539874;34;32;0.382352941176471;21;13;0.117647058823529;0.382352941176471
Control.SRR15539874;34;32;0.529411764705882;16;18;0.0294117647058824;0.470588235294118
Control.SRR15539874;29;32;0.586206896551724;12;17;0.0862068965517241;0.413793103448276
Control.SRR15539874;30;32;0.5;15;15;0;0.5
Control.SRR15539874;32;32;0.53125;15;17;0.03125;0.46875
Control.SRR15539874;31;32;0.548387096774194;14;17;0.0483870967741935;0.451612903225806
Control.SRR15539874;37;32;0.594594594594595;15;22;0.0945945945945946;0.405405405405405
Control.SRR15539874;35;32;0.571428571428571;15;20;0.0714285714285714;0.428571428571429
Control.SRR15539874;37;32;0.486486486486487;19;18;0.0135135135135135;0.486486486486487
Control.SRR15539874;34;32;0.382352941176471;21;13;0.117647058823529;0.382352941176471
Control.SRR15539874;33;32;0.454545454545455;18;15;0.0454545454545455;0.454545454545455
Control.SRR15539874;33;32;0.454545454545455;18;15;0.0454545454545455;0.454545454545455
Control.SRR15539874;29;32;0.275862068965517;21;8;0.224137931034483;0.275862068965517
Control.SRR15539874;29;32;0.586206896551724;12;17;0.0862068965517241;0.413793103448276
Control.SRR15539874;31;32;0.451612903225806;17;14;0.0483870967741936;0.451612903225806
Control.SRR15539874;29;32;0.517241379310345;14;15;0.0172413793103449;0.482758620689655
Control.SRR15539874;32;32;0.5625;14;18;0.0625;0.4375
Control.SRR15539874;34;32;0.5;17;17;0;0.5
Control.SRR15539874;32;32;0.65625;11;21;0.15625;0.34375
Control.SRR15539874;33;32;0.393939393939394;20;13;0.106060606060606;0.393939393939394
Control.SRR15539874;36;32;0.388888888888889;22;14;0.111111111111111;0.388888888888889
Control.SRR15539874;30;32;0.566666666666667;13;17;0.0666666666666667;0.433333333333333
Control.SRR15539874;31;32;0.483870967741935;16;15;0.0161290322580645;0.483870967741935
Control.SRR15539874;34;32;0.588235294117647;14;20;0.0882352941176471;0.411764705882353
Control.SRR15539874;36;32;0.416666666666667;21;15;0.0833333333333333;0.416666666666667
Control.SRR15539874;37;32;0.513513513513513;18;19;0.0135135135135135;0.486486486486487
Control.SRR15539874;33;32;0.424242424242424;19;14;0.0757575757575757;0.424242424242424
Control.SRR15539874;32;32;0.5;16;16;0;0.5
Control.SRR15539874;37;32;0.540540540540541;17;20;0.0405405405405406;0.459459459459459
Control.SRR15539874;37;32;0.459459459459459;20;17;0.0405405405405405;0.459459459459459
Control.SRR15539874;31;32;0.516129032258065;15;16;0.0161290322580645;0.483870967741935
Control.SRR15539874;36;32;0.472222222222222;19;17;0.0277777777777778;0.472222222222222
Control.SRR15539874;32;32;0.53125;15;17;0.03125;0.46875
Control.SRR15539874;29;32;0.655172413793103;10;19;0.155172413793103;0.344827586206897
Control.SRR15539874;35;32;0.4;21;14;0.1;0.4
Control.SRR15539874;37;32;0.432432432432432;21;16;0.0675675675675675;0.432432432432432
Control.SRR15539874;32;32;0.40625;19;13;0.09375;0.40625
Control.SRR15539874;32;32;0.53125;15;17;0.03125;0.46875
Control.SRR15539874;37;32;0.459459459459459;20;17;0.0405405405405405;0.459459459459459
Control.SRR15539874;30;32;0.433333333333333;17;13;0.0666666666666667;0.433333333333333
Control.SRR15539874;36;32;0.5;18;18;0;0.5
Control.SRR15539874;36;32;0.611111111111111;14;22;0.111111111111111;0.388888888888889
Control.SRR15539874;37;32;0.621621621621622;14;23;0.121621621621622;0.378378378378378
Control.SRR15539874;30;32;0.466666666666667;16;14;0.0333333333333333;0.466666666666667
Control.SRR15539874;35;32;0.371428571428571;22;13;0.128571428571429;0.371428571428571
Control.SRR15539874;33;32;0.363636363636364;21;12;0.136363636363636;0.363636363636364
Control.SRR15539874;35;32;0.428571428571429;20;15;0.0714285714285715;0.428571428571429
Control.SRR15539874;35;32;0.457142857142857;19;16;0.0428571428571429;0.457142857142857
Control.SRR15539874;29;32;0.517241379310345;14;15;0.0172413793103449;0.482758620689655
Control.SRR15539874;34;32;0.411764705882353;20;14;0.0882352941176471;0.411764705882353
Control.SRR15539874;33;32;0.333333333333333;22;11;0.166666666666667;0.333333333333333
Control.SRR15539874;29;32;0.620689655172414;11;18;0.120689655172414;0.379310344827586
Control.SRR15539874;30;32;0.466666666666667;16;14;0.0333333333333333;0.466666666666667
Control.SRR15539874;35;32;0.514285714285714;17;18;0.0142857142857142;0.485714285714286
Control.SRR15539874;35;32;0.457142857142857;19;16;0.0428571428571429;0.457142857142857
Control.SRR15539874;31;32;0.483870967741935;16;15;0.0161290322580645;0.483870967741935
Control.SRR15539874;35;32;0.457142857142857;19;16;0.0428571428571429;0.457142857142857
Control.SRR15539874;29;32;0.517241379310345;14;15;0.0172413793103449;0.482758620689655
Control.SRR15539874;29;32;0.551724137931034;13;16;0.0517241379310345;0.448275862068966
Control.SRR15539874;30;32;0.4;18;12;0.1;0.4
Control.SRR15539874;34;32;0.5;17;17;0;0.5
Control.SRR15539874;32;32;0.53125;15;17;0.03125;0.46875
Control.SRR15539874;36;32;0.583333333333333;15;21;0.0833333333333334;0.416666666666667
Control.SRR15539874;31;32;0.548387096774194;14;17;0.0483870967741935;0.451612903225806
Control.SRR15539874;34;32;0.352941176470588;22;12;0.147058823529412;0.352941176470588
Control.SRR15539874;30;32;0.4;18;12;0.1;0.4
Control.SRR15539874;35;32;0.4;21;14;0.1;0.4
Control.SRR15539874;33;32;0.484848484848485;17;16;0.0151515151515151;0.484848484848485
Control.SRR15539874;29;32;0.482758620689655;15;14;0.0172413793103448;0.482758620689655
Control.SRR15539874;37;32;0.594594594594595;15;22;0.0945945945945946;0.405405405405405
Control.SRR15539874;36;32;0.5;18;18;0;0.5
Control.SRR15539874;35;32;0.428571428571429;20;15;0.0714285714285715;0.428571428571429
Control.SRR15539874;34;32;0.529411764705882;16;18;0.0294117647058824;0.470588235294118
Control.SRR15539874;29;32;0.344827586206897;19;10;0.155172413793103;0.344827586206897
Control.SRR15539874;32;32;0.53125;15;17;0.03125;0.46875
Control.SRR15539874;29;32;0.689655172413793;9;20;0.189655172413793;0.310344827586207
Control.SRR15539874;30;32;0.4;18;12;0.1;0.4
Control.SRR15539874;31;32;0.419354838709677;18;13;0.0806451612903226;0.419354838709677
Control.SRR15539874;30;32;0.433333333333333;17;13;0.0666666666666667;0.433333333333333
Control.SRR15539874;33;32;0.515151515151515;16;17;0.0151515151515151;0.484848484848485
Control.SRR15539874;30;32;0.466666666666667;16;14;0.0333333333333333;0.466666666666667
Control.SRR15539874;30;32;0.466666666666667;16;14;0.0333333333333333;0.466666666666667
Control.SRR15539874;33;32;0.666666666666667;11;22;0.166666666666667;0.333333333333333
Control.SRR15539874;34;32;0.382352941176471;21;13;0.117647058823529;0.382352941176471
Control.SRR15539874;29;32;0.448275862068966;16;13;0.0517241379310345;0.448275862068966
Control.SRR15539874;33;32;0.696969696969697;10;23;0.196969696969697;0.303030303030303
Control.SRR15539874;31;32;0.419354838709677;18;13;0.0806451612903226;0.419354838709677
Control.SRR15539874;35;32;0.457142857142857;19;16;0.0428571428571429;0.457142857142857
Control.SRR15539874;32;32;0.4375;18;14;0.0625;0.4375
Control.SRR15539874;29;32;0.551724137931034;13;16;0.0517241379310345;0.448275862068966
Control.SRR15539874;29;32;0.482758620689655;15;14;0.0172413793103448;0.482758620689655
Control.SRR15539874;31;32;0.516129032258065;15;16;0.0161290322580645;0.483870967741935
Control.SRR15539874;32;32;0.5;16;16;0;0.5
Control.SRR15539874;34;32;0.441176470588235;19;15;0.0588235294117647;0.441176470588235
Control.SRR15539874;32;32;0.46875;17;15;0.03125;0.46875
Control.SRR15539874;30;32;0.466666666666667;16;14;0.0333333333333333;0.466666666666667
Control.SRR15539874;35;32;0.657142857142857;12;23;0.157142857142857;0.342857142857143
Control.SRR15539874;37;32;0.459459459459459;20;17;0.0405405405405405;0.459459459459459
Control.SRR15539874;33;32;0.424242424242424;19;14;0.0757575757575757;0.424242424242424
Control.SRR15539874;30;32;0.633333333333333;11;19;0.133333333333333;0.366666666666667
Control.SRR15539874;36;32;0.583333333333333;15;21;0.0833333333333334;0.416666666666667
Control.SRR15539874;36;32;0.527777777777778;17;19;0.0277777777777778;0.472222222222222
Control.SRR15539874;36;32;0.5;18;18;0;0.5
Control.SRR15539874;37;32;0.594594594594595;15;22;0.0945945945945946;0.405405405405405
Control.SRR15539874;29;32;0.448275862068966;16;13;0.0517241379310345;0.448275862068966
Control.SRR15539874;33;32;0.424242424242424;19;14;0.0757575757575757;0.424242424242424
Control.SRR15539874;35;32;0.514285714285714;17;18;0.0142857142857142;0.485714285714286
Control.SRR15539874;37;32;0.486486486486487;19;18;0.0135135135135135;0.486486486486487
Control.SRR15539874;35;32;0.514285714285714;17;18;0.0142857142857142;0.485714285714286
Control.SRR15539874;32;32;0.625;12;20;0.125;0.375
Control.SRR15539874;34;32;0.558823529411765;15;19;0.0588235294117647;0.441176470588235
Control.SRR15539874;33;32;0.454545454545455;18;15;0.0454545454545455;0.454545454545455
Control.SRR15539874;35;32;0.542857142857143;16;19;0.0428571428571428;0.457142857142857
Control.SRR15539874;32;32;0.46875;17;15;0.03125;0.46875
Control.SRR15539874;29;32;0.551724137931034;13;16;0.0517241379310345;0.448275862068966
Control.SRR15539874;36;32;0.583333333333333;15;21;0.0833333333333334;0.416666666666667
Control.SRR15539874;37;32;0.594594594594595;15;22;0.0945945945945946;0.405405405405405
Control.SRR15539874;32;32;0.53125;15;17;0.03125;0.46875
Control.SRR15539874;35;32;0.542857142857143;16;19;0.0428571428571428;0.457142857142857
Control.SRR15539874;34;32;0.352941176470588;22;12;0.147058823529412;0.352941176470588
Control.SRR15539874;32;32;0.625;12;20;0.125;0.375
Control.SRR15539874;31;32;0.580645161290323;13;18;0.0806451612903226;0.419354838709677
Control.SRR15539874;30;32;0.6;12;18;0.1;0.4
Control.SRR15539874;29;32;0.517241379310345;14;15;0.0172413793103449;0.482758620689655
Control.SRR15539874;30;32;0.466666666666667;16;14;0.0333333333333333;0.466666666666667
Control.SRR15539874;36;32;0.583333333333333;15;21;0.0833333333333334;0.416666666666667
Control.SRR15539874;37;32;0.540540540540541;17;20;0.0405405405405406;0.459459459459459
Control.SRR15539874;33;32;0.424242424242424;19;14;0.0757575757575757;0.424242424242424
Control.SRR15539874;29;32;0.517241379310345;14;15;0.0172413793103449;0.482758620689655
Control.SRR15539874;31;32;0.483870967741935;16;15;0.0161290322580645;0.483870967741935
Control.SRR15539874;31;32;0.612903225806452;12;19;0.112903225806452;0.387096774193548
Control.SRR15539874;33;32;0.484848484848485;17;16;0.0151515151515151;0.484848484848485
Control.SRR15539874;36;32;0.416666666666667;21;15;0.0833333333333333;0.416666666666667
Control.SRR15539874;31;32;0.645161290322581;11;20;0.145161290322581;0.354838709677419
Control.SRR15539874;30;32;0.4;18;12;0.1;0.4
Control.SRR15539874;33;32;0.424242424242424;19;14;0.0757575757575757;0.424242424242424
Control.SRR15539874;37;32;0.432432432432432;21;16;0.0675675675675675;0.432432432432432
Control.SRR15539874;36;32;0.472222222222222;19;17;0.0277777777777778;0.472222222222222
Control.SRR15539874;36;32;0.555555555555556;16;20;0.0555555555555556;0.444444444444444
Control.SRR15539874;33;32;0.484848484848485;17;16;0.0151515151515151;0.484848484848485
Control.SRR15539874;37;32;0.459459459459459;20;17;0.0405405405405405;0.459459459459459
Control.SRR15539874;34;32;0.529411764705882;16;18;0.0294117647058824;0.470588235294118
Control.SRR15539874;29;32;0.482758620689655;15;14;0.0172413793103448;0.482758620689655
Control.SRR15539874;30;32;0.4;18;12;0.1;0.4
Control.SRR15539874;37;32;0.432432432432432;21;16;0.0675675675675675;0.432432432432432
Control.SRR15539874;32;32;0.4375;18;14;0.0625;0.4375
Control.SRR15539874;33;32;0.545454545454545;15;18;0.0454545454545454;0.454545454545455
Control.SRR15539874;29;32;0.482758620689655;15;14;0.0172413793103448;0.482758620689655
Control.SRR15539874;35;32;0.6;14;21;0.1;0.4
Control.SRR15539874;36;32;0.555555555555556;16;20;0.0555555555555556;0.444444444444444
Control.SRR15539874;29;32;0.413793103448276;17;12;0.0862068965517241;0.413793103448276
Control.SRR15539874;29;32;0.517241379310345;14;15;0.0172413793103449;0.482758620689655
Control.SRR15539874;33;32;0.424242424242424;19;14;0.0757575757575757;0.424242424242424
Control.SRR15539874;34;32;0.382352941176471;21;13;0.117647058823529;0.382352941176471
Control.SRR15539874;34;32;0.558823529411765;15;19;0.0588235294117647;0.441176470588235
Control.SRR15539874;31;32;0.419354838709677;18;13;0.0806451612903226;0.419354838709677
Control.SRR15539874;34;32;0.382352941176471;21;13;0.117647058823529;0.382352941176471
Control.SRR15539874;34;32;0.5;17;17;0;0.5
Control.SRR15539874;37;32;0.567567567567568;16;21;0.0675675675675675;0.432432432432432
Control.SRR15539874;37;32;0.405405405405405;22;15;0.0945945945945946;0.405405405405405
Control.SRR15539874;30;32;0.533333333333333;14;16;0.0333333333333333;0.466666666666667
Control.SRR15539874;34;32;0.588235294117647;14;20;0.0882352941176471;0.411764705882353
Control.SRR15539874;30;32;0.333333333333333;20;10;0.166666666666667;0.333333333333333
Control.SRR15539874;31;32;0.354838709677419;20;11;0.145161290322581;0.354838709677419
Control.SRR15539874;32;32;0.46875;17;15;0.03125;0.46875
Control.SRR15539874;32;32;0.59375;13;19;0.09375;0.40625
Control.SRR15539874;32;32;0.21875;25;7;0.28125;0.21875
Control.SRR15539874;33;32;0.545454545454545;15;18;0.0454545454545454;0.454545454545455
Control.SRR15539874;33;32;0.515151515151515;16;17;0.0151515151515151;0.484848484848485
Control.SRR15539874;33;32;0.545454545454545;15;18;0.0454545454545454;0.454545454545455
Control.SRR15539874;33;32;0.363636363636364;21;12;0.136363636363636;0.363636363636364
Control.SRR15539874;31;32;0.516129032258065;15;16;0.0161290322580645;0.483870967741935
Control.SRR15539874;31;32;0.645161290322581;11;20;0.145161290322581;0.354838709677419
Control.SRR15539874;31;32;0.548387096774194;14;17;0.0483870967741935;0.451612903225806
Control.SRR15539874;32;32;0.4375;18;14;0.0625;0.4375
Control.SRR15539874;35;32;0.542857142857143;16;19;0.0428571428571428;0.457142857142857
Control.SRR15539874;34;32;0.529411764705882;16;18;0.0294117647058824;0.470588235294118
Control.SRR15539874;32;32;0.5;16;16;0;0.5
Control.SRR15539874;31;32;0.387096774193548;19;12;0.112903225806452;0.387096774193548
Control.SRR15539874;36;32;0.472222222222222;19;17;0.0277777777777778;0.472222222222222
Control.SRR15539874;36;32;0.388888888888889;22;14;0.111111111111111;0.388888888888889
Control.SRR15539874;30;32;0.433333333333333;17;13;0.0666666666666667;0.433333333333333
Control.SRR15539874;34;32;0.5;17;17;0;0.5
Control.SRR15539874;37;32;0.486486486486487;19;18;0.0135135135135135;0.486486486486487
Control.SRR15539874;36;32;0.555555555555556;16;20;0.0555555555555556;0.444444444444444
Control.SRR15539874;29;32;0.448275862068966;16;13;0.0517241379310345;0.448275862068966
Control.SRR15539874;29;32;0.551724137931034;13;16;0.0517241379310345;0.448275862068966
Control.SRR15539874;32;32;0.5;16;16;0;0.5
Control.SRR15539874;32;32;0.625;12;20;0.125;0.375
Control.SRR15539874;33;32;0.575757575757576;14;19;0.0757575757575758;0.424242424242424
Control.SRR15539874;37;32;0.567567567567568;16;21;0.0675675675675675;0.432432432432432
Control.SRR15539874;31;32;0.516129032258065;15;16;0.0161290322580645;0.483870967741935
Control.SRR15539874;31;32;0.548387096774194;14;17;0.0483870967741935;0.451612903225806
Control.SRR15539874;35;32;0.457142857142857;19;16;0.0428571428571429;0.457142857142857
Control.SRR15539874;31;32;0.741935483870968;8;23;0.241935483870968;0.258064516129032
Control.SRR15539874;35;32;0.4;21;14;0.1;0.4
Control.SRR15539874;37;32;0.594594594594595;15;22;0.0945945945945946;0.405405405405405
Control.SRR15539874;33;32;0.484848484848485;17;16;0.0151515151515151;0.484848484848485
Control.SRR15539874;34;32;0.5;17;17;0;0.5
Control.SRR15539874;33;32;0.424242424242424;19;14;0.0757575757575757;0.424242424242424
Control.SRR15539874;30;32;0.533333333333333;14;16;0.0333333333333333;0.466666666666667
Control.SRR15539874;31;32;0.483870967741935;16;15;0.0161290322580645;0.483870967741935
Control.SRR15539874;31;32;0.387096774193548;19;12;0.112903225806452;0.387096774193548
Control.SRR15539874;37;32;0.486486486486487;19;18;0.0135135135135135;0.486486486486487
Control.SRR15539874;37;32;0.459459459459459;20;17;0.0405405405405405;0.459459459459459
Control.SRR15539874;31;32;0.580645161290323;13;18;0.0806451612903226;0.419354838709677
Control.SRR15539874;30;32;0.4;18;12;0.1;0.4
Control.SRR15539874;33;32;0.545454545454545;15;18;0.0454545454545454;0.454545454545455
Control.SRR15539874;37;32;0.621621621621622;14;23;0.121621621621622;0.378378378378378
Control.SRR15539874;32;32;0.65625;11;21;0.15625;0.34375
Control.SRR15539874;33;32;0.636363636363636;12;21;0.136363636363636;0.363636363636364
Control.SRR15539874;35;32;0.514285714285714;17;18;0.0142857142857142;0.485714285714286
Control.SRR15539874;31;32;0.387096774193548;19;12;0.112903225806452;0.387096774193548
Control.SRR15539874;33;32;0.515151515151515;16;17;0.0151515151515151;0.484848484848485
Control.SRR15539874;31;32;0.548387096774194;14;17;0.0483870967741935;0.451612903225806
Control.SRR15539874;31;32;0.580645161290323;13;18;0.0806451612903226;0.419354838709677
Control.SRR15539874;35;32;0.485714285714286;18;17;0.0142857142857143;0.485714285714286
Control.SRR15539874;35;32;0.571428571428571;15;20;0.0714285714285714;0.428571428571429
Control.SRR15539874;30;32;0.6;12;18;0.1;0.4
Control.SRR15539874;29;32;0.551724137931034;13;16;0.0517241379310345;0.448275862068966
Control.SRR15539874;36;32;0.472222222222222;19;17;0.0277777777777778;0.472222222222222
Control.SRR15539874;32;32;0.53125;15;17;0.03125;0.46875
Control.SRR15539874;31;32;0.516129032258065;15;16;0.0161290322580645;0.483870967741935
Control.SRR15539874;33;32;0.575757575757576;14;19;0.0757575757575758;0.424242424242424
Control.SRR15539874;30;32;0.633333333333333;11;19;0.133333333333333;0.366666666666667
Control.SRR15539874;35;32;0.485714285714286;18;17;0.0142857142857143;0.485714285714286
Control.SRR15539874;37;32;0.486486486486487;19;18;0.0135135135135135;0.486486486486487
Control.SRR15539874;31;32;0.580645161290323;13;18;0.0806451612903226;0.419354838709677
Control.SRR15539874;31;32;0.548387096774194;14;17;0.0483870967741935;0.451612903225806
Control.SRR15539874;31;32;0.548387096774194;14;17;0.0483870967741935;0.451612903225806
Control.SRR15539874;34;32;0.558823529411765;15;19;0.0588235294117647;0.441176470588235
Control.SRR15539874;35;32;0.571428571428571;15;20;0.0714285714285714;0.428571428571429
Control.SRR15539874;36;32;0.555555555555556;16;20;0.0555555555555556;0.444444444444444
Control.SRR15539874;36;32;0.583333333333333;15;21;0.0833333333333334;0.416666666666667
Control.SRR15539874;32;32;0.5;16;16;0;0.5
Control.SRR15539874;30;32;0.4;18;12;0.1;0.4
Control.SRR15539874;35;32;0.457142857142857;19;16;0.0428571428571429;0.457142857142857
Control.SRR15539874;32;32;0.53125;15;17;0.03125;0.46875
Control.SRR15539874;37;32;0.324324324324324;25;12;0.175675675675676;0.324324324324324
Control.SRR15539874;35;32;0.514285714285714;17;18;0.0142857142857142;0.485714285714286
Control.SRR15539874;33;32;0.636363636363636;12;21;0.136363636363636;0.363636363636364
Control.SRR15539874;33;32;0.515151515151515;16;17;0.0151515151515151;0.484848484848485
Control.SRR15539874;36;32;0.555555555555556;16;20;0.0555555555555556;0.444444444444444
Control.SRR15539874;36;32;0.527777777777778;17;19;0.0277777777777778;0.472222222222222
Control.SRR15539874;29;32;0.482758620689655;15;14;0.0172413793103448;0.482758620689655
Control.SRR15539874;34;32;0.558823529411765;15;19;0.0588235294117647;0.441176470588235
Control.SRR15539874;34;32;0.558823529411765;15;19;0.0588235294117647;0.441176470588235
Control.SRR15539874;29;32;0.482758620689655;15;14;0.0172413793103448;0.482758620689655
Control.SRR15539874;31;32;0.387096774193548;19;12;0.112903225806452;0.387096774193548
Control.SRR15539874;32;32;0.375;20;12;0.125;0.375
Control.SRR15539874;29;32;0.413793103448276;17;12;0.0862068965517241;0.413793103448276
Control.SRR15539874;29;32;0.517241379310345;14;15;0.0172413793103449;0.482758620689655
Control.SRR15539874;34;32;0.529411764705882;16;18;0.0294117647058824;0.470588235294118
Control.SRR15539874;33;32;0.484848484848485;17;16;0.0151515151515151;0.484848484848485
Control.SRR15539874;37;32;0.567567567567568;16;21;0.0675675675675675;0.432432432432432
Control.SRR15539874;34;32;0.588235294117647;14;20;0.0882352941176471;0.411764705882353
Control.SRR15539874;35;32;0.542857142857143;16;19;0.0428571428571428;0.457142857142857
Control.SRR15539874;31;32;0.548387096774194;14;17;0.0483870967741935;0.451612903225806
Control.SRR15539874;32;32;0.46875;17;15;0.03125;0.46875
Control.SRR15539874;30;32;0.5;15;15;0;0.5
Control.SRR15539874;36;32;0.555555555555556;16;20;0.0555555555555556;0.444444444444444
Control.SRR15539874;33;32;0.545454545454545;15;18;0.0454545454545454;0.454545454545455
Control.SRR15539874;31;32;0.354838709677419;20;11;0.145161290322581;0.354838709677419
Control.SRR15539874;32;32;0.59375;13;19;0.09375;0.40625
Control.SRR15539874;30;32;0.266666666666667;22;8;0.233333333333333;0.266666666666667
Control.SRR15539874;32;32;0.53125;15;17;0.03125;0.46875
Control.SRR15539874;35;32;0.371428571428571;22;13;0.128571428571429;0.371428571428571
Control.SRR15539874;29;32;0.448275862068966;16;13;0.0517241379310345;0.448275862068966
Control.SRR15539874;34;32;0.5;17;17;0;0.5
Control.SRR15539874;29;32;0.413793103448276;17;12;0.0862068965517241;0.413793103448276
Control.SRR15539874;29;32;0.448275862068966;16;13;0.0517241379310345;0.448275862068966
Control.SRR15539874;30;32;0.633333333333333;11;19;0.133333333333333;0.366666666666667
Control.SRR15539874;33;32;0.515151515151515;16;17;0.0151515151515151;0.484848484848485
Control.SRR15539874;35;32;0.485714285714286;18;17;0.0142857142857143;0.485714285714286
Control.SRR15539874;34;32;0.558823529411765;15;19;0.0588235294117647;0.441176470588235
Control.SRR15539874;30;32;0.566666666666667;13;17;0.0666666666666667;0.433333333333333
Control.SRR15539874;33;32;0.515151515151515;16;17;0.0151515151515151;0.484848484848485
Control.SRR15539874;37;32;0.432432432432432;21;16;0.0675675675675675;0.432432432432432
Control.SRR15539874;29;32;0.620689655172414;11;18;0.120689655172414;0.379310344827586
Control.SRR15539874;29;32;0.517241379310345;14;15;0.0172413793103449;0.482758620689655
Control.SRR15539874;35;32;0.542857142857143;16;19;0.0428571428571428;0.457142857142857
Control.SRR15539874;32;32;0.34375;21;11;0.15625;0.34375
Control.SRR15539874;32;32;0.53125;15;17;0.03125;0.46875
Control.SRR15539874;34;32;0.411764705882353;20;14;0.0882352941176471;0.411764705882353
Control.SRR15539874;32;32;0.4375;18;14;0.0625;0.4375
Control.SRR15539874;30;32;0.633333333333333;11;19;0.133333333333333;0.366666666666667
Control.SRR15539874;35;32;0.514285714285714;17;18;0.0142857142857142;0.485714285714286
Control.SRR15539874;34;32;0.558823529411765;15;19;0.0588235294117647;0.441176470588235
Control.SRR15539874;37;32;0.486486486486487;19;18;0.0135135135135135;0.486486486486487
Control.SRR15539874;31;32;0.419354838709677;18;13;0.0806451612903226;0.419354838709677
Control.SRR15539874;31;32;0.483870967741935;16;15;0.0161290322580645;0.483870967741935
Control.SRR15539874;37;32;0.513513513513513;18;19;0.0135135135135135;0.486486486486487
Control.SRR15539874;34;32;0.529411764705882;16;18;0.0294117647058824;0.470588235294118
Control.SRR15539874;33;32;0.515151515151515;16;17;0.0151515151515151;0.484848484848485
Control.SRR15539874;33;32;0.454545454545455;18;15;0.0454545454545455;0.454545454545455
Control.SRR15539874;37;32;0.405405405405405;22;15;0.0945945945945946;0.405405405405405
Control.SRR15539874;30;32;0.633333333333333;11;19;0.133333333333333;0.366666666666667
Control.SRR15539874;31;32;0.419354838709677;18;13;0.0806451612903226;0.419354838709677
Control.SRR15539874;33;32;0.575757575757576;14;19;0.0757575757575758;0.424242424242424
Control.SRR15539874;36;32;0.444444444444444;20;16;0.0555555555555556;0.444444444444444
Control.SRR15539874;37;32;0.486486486486487;19;18;0.0135135135135135;0.486486486486487
Control.SRR15539874;32;32;0.40625;19;13;0.09375;0.40625
Control.SRR15539874;29;32;0.551724137931034;13;16;0.0517241379310345;0.448275862068966
Control.SRR15539874;31;32;0.451612903225806;17;14;0.0483870967741936;0.451612903225806
Control.SRR15539874;29;32;0.448275862068966;16;13;0.0517241379310345;0.448275862068966
Control.SRR15539874;31;32;0.451612903225806;17;14;0.0483870967741936;0.451612903225806
Control.SRR15539874;31;32;0.483870967741935;16;15;0.0161290322580645;0.483870967741935
Control.SRR15539874;30;32;0.566666666666667;13;17;0.0666666666666667;0.433333333333333
Control.SRR15539874;34;32;0.558823529411765;15;19;0.0588235294117647;0.441176470588235
Control.SRR15539874;31;32;0.548387096774194;14;17;0.0483870967741935;0.451612903225806
Control.SRR15539874;34;32;0.5;17;17;0;0.5
Control.SRR15539874;30;32;0.366666666666667;19;11;0.133333333333333;0.366666666666667
Control.SRR15539874;36;32;0.416666666666667;21;15;0.0833333333333333;0.416666666666667
Control.SRR15539874;37;32;0.432432432432432;21;16;0.0675675675675675;0.432432432432432
Control.SRR15539874;29;32;0.379310344827586;18;11;0.120689655172414;0.379310344827586
Control.SRR15539874;33;32;0.545454545454545;15;18;0.0454545454545454;0.454545454545455
Control.SRR15539874;32;32;0.53125;15;17;0.03125;0.46875
Control.SRR15539874;29;32;0.448275862068966;16;13;0.0517241379310345;0.448275862068966
Control.SRR15539874;29;32;0.551724137931034;13;16;0.0517241379310345;0.448275862068966
Control.SRR15539874;32;32;0.53125;15;17;0.03125;0.46875
Control.SRR15539874;30;32;0.533333333333333;14;16;0.0333333333333333;0.466666666666667
Control.SRR15539874;34;32;0.470588235294118;18;16;0.0294117647058824;0.470588235294118
Control.SRR15539874;37;32;0.486486486486487;19;18;0.0135135135135135;0.486486486486487
Control.SRR15539874;33;32;0.515151515151515;16;17;0.0151515151515151;0.484848484848485
Control.SRR15539874;30;32;0.466666666666667;16;14;0.0333333333333333;0.466666666666667
Control.SRR15539874;37;32;0.405405405405405;22;15;0.0945945945945946;0.405405405405405
Control.SRR15539874;30;32;0.466666666666667;16;14;0.0333333333333333;0.466666666666667
Control.SRR15539874;35;32;0.428571428571429;20;15;0.0714285714285715;0.428571428571429
Control.SRR15539874;37;32;0.756756756756757;9;28;0.256756756756757;0.243243243243243
Control.SRR15539874;36;32;0.361111111111111;23;13;0.138888888888889;0.361111111111111
Control.SRR15539874;37;32;0.459459459459459;20;17;0.0405405405405405;0.459459459459459
Control.SRR15539874;37;32;0.486486486486487;19;18;0.0135135135135135;0.486486486486487
Control.SRR15539874;35;32;0.542857142857143;16;19;0.0428571428571428;0.457142857142857
Control.SRR15539874;37;32;0.540540540540541;17;20;0.0405405405405406;0.459459459459459
Control.SRR15539874;34;32;0.588235294117647;14;20;0.0882352941176471;0.411764705882353
Control.SRR15539874;36;32;0.444444444444444;20;16;0.0555555555555556;0.444444444444444
Control.SRR15539874;32;32;0.5;16;16;0;0.5
Control.SRR15539874;31;32;0.516129032258065;15;16;0.0161290322580645;0.483870967741935
Control.SRR15539874;35;32;0.457142857142857;19;16;0.0428571428571429;0.457142857142857
Control.SRR15539874;36;32;0.555555555555556;16;20;0.0555555555555556;0.444444444444444
Control.SRR15539874;29;32;0.551724137931034;13;16;0.0517241379310345;0.448275862068966
Control.SRR15539874;33;32;0.424242424242424;19;14;0.0757575757575757;0.424242424242424
Control.SRR15539874;30;32;0.5;15;15;0;0.5
Control.SRR15539874;33;32;0.363636363636364;21;12;0.136363636363636;0.363636363636364
Control.SRR15539874;31;32;0.483870967741935;16;15;0.0161290322580645;0.483870967741935
Control.SRR15539874;33;32;0.393939393939394;20;13;0.106060606060606;0.393939393939394
Control.SRR15539874;37;32;0.513513513513513;18;19;0.0135135135135135;0.486486486486487
Control.SRR15539874;37;32;0.540540540540541;17;20;0.0405405405405406;0.459459459459459
Control.SRR15539874;35;32;0.542857142857143;16;19;0.0428571428571428;0.457142857142857
Control.SRR15539874;31;32;0.548387096774194;14;17;0.0483870967741935;0.451612903225806
Control.SRR15539874;37;32;0.513513513513513;18;19;0.0135135135135135;0.486486486486487
Control.SRR15539874;30;32;0.533333333333333;14;16;0.0333333333333333;0.466666666666667
Control.SRR15539874;33;32;0.484848484848485;17;16;0.0151515151515151;0.484848484848485
Control.SRR15539874;29;32;0.517241379310345;14;15;0.0172413793103449;0.482758620689655
Control.SRR15539874;33;32;0.545454545454545;15;18;0.0454545454545454;0.454545454545455
Control.SRR15539874;34;32;0.529411764705882;16;18;0.0294117647058824;0.470588235294118
Control.SRR15539874;35;32;0.457142857142857;19;16;0.0428571428571429;0.457142857142857
Control.SRR15539874;29;32;0.517241379310345;14;15;0.0172413793103449;0.482758620689655
Control.SRR15539874;35;32;0.542857142857143;16;19;0.0428571428571428;0.457142857142857
Control.SRR15539874;31;32;0.548387096774194;14;17;0.0483870967741935;0.451612903225806
Control.SRR15539874;29;32;0.379310344827586;18;11;0.120689655172414;0.379310344827586
Control.SRR15539874;35;32;0.4;21;14;0.1;0.4
Control.SRR15539874;29;32;0.448275862068966;16;13;0.0517241379310345;0.448275862068966
Control.SRR15539874;32;32;0.53125;15;17;0.03125;0.46875
Control.SRR15539874;32;32;0.46875;17;15;0.03125;0.46875
Control.SRR15539874;33;32;0.454545454545455;18;15;0.0454545454545455;0.454545454545455
Control.SRR15539874;33;32;0.575757575757576;14;19;0.0757575757575758;0.424242424242424
Control.SRR15539874;31;32;0.451612903225806;17;14;0.0483870967741936;0.451612903225806
Control.SRR15539874;33;32;0.666666666666667;11;22;0.166666666666667;0.333333333333333
Control.SRR15539874;31;32;0.516129032258065;15;16;0.0161290322580645;0.483870967741935
Control.SRR15539874;30;32;0.6;12;18;0.1;0.4
Control.SRR15539874;31;32;0.387096774193548;19;12;0.112903225806452;0.387096774193548
Control.SRR15539874;33;32;0.484848484848485;17;16;0.0151515151515151;0.484848484848485
Control.SRR15539874;37;32;0.567567567567568;16;21;0.0675675675675675;0.432432432432432
Control.SRR15539874;31;32;0.483870967741935;16;15;0.0161290322580645;0.483870967741935
Control.SRR15539874;34;32;0.529411764705882;16;18;0.0294117647058824;0.470588235294118
Control.SRR15539874;32;32;0.40625;19;13;0.09375;0.40625
Control.SRR15539874;33;32;0.545454545454545;15;18;0.0454545454545454;0.454545454545455
Control.SRR15539874;30;32;0.5;15;15;0;0.5
Control.SRR15539874;35;32;0.428571428571429;20;15;0.0714285714285715;0.428571428571429
Control.SRR15539874;33;32;0.424242424242424;19;14;0.0757575757575757;0.424242424242424
Control.SRR15539874;33;32;0.363636363636364;21;12;0.136363636363636;0.363636363636364
Control.SRR15539874;32;32;0.4375;18;14;0.0625;0.4375
Control.SRR15539874;34;32;0.5;17;17;0;0.5
Control.SRR15539874;35;32;0.628571428571429;13;22;0.128571428571429;0.371428571428571
Control.SRR15539874;31;32;0.451612903225806;17;14;0.0483870967741936;0.451612903225806
Control.SRR15539874;30;32;0.5;15;15;0;0.5
Control.SRR15539874;30;32;0.466666666666667;16;14;0.0333333333333333;0.466666666666667
Control.SRR15539874;31;32;0.419354838709677;18;13;0.0806451612903226;0.419354838709677
Control.SRR15539874;31;32;0.451612903225806;17;14;0.0483870967741936;0.451612903225806
Control.SRR15539874;34;32;0.470588235294118;18;16;0.0294117647058824;0.470588235294118
Control.SRR15539874;31;32;0.612903225806452;12;19;0.112903225806452;0.387096774193548
Control.SRR15539874;35;32;0.4;21;14;0.1;0.4
Control.SRR15539874;29;32;0.551724137931034;13;16;0.0517241379310345;0.448275862068966
Control.SRR15539874;36;32;0.5;18;18;0;0.5
Control.SRR15539874;35;32;0.685714285714286;11;24;0.185714285714286;0.314285714285714
Control.SRR15539874;31;32;0.419354838709677;18;13;0.0806451612903226;0.419354838709677
Control.SRR15539874;31;32;0.548387096774194;14;17;0.0483870967741935;0.451612903225806
Control.SRR15539874;32;32;0.53125;15;17;0.03125;0.46875
Control.SRR15539874;36;32;0.444444444444444;20;16;0.0555555555555556;0.444444444444444
Control.SRR15539874;34;32;0.5;17;17;0;0.5
Control.SRR15539874;30;32;0.466666666666667;16;14;0.0333333333333333;0.466666666666667
Control.SRR15539874;29;32;0.551724137931034;13;16;0.0517241379310345;0.448275862068966
Control.SRR15539874;29;32;0.586206896551724;12;17;0.0862068965517241;0.413793103448276
Control.SRR15539874;29;32;0.517241379310345;14;15;0.0172413793103449;0.482758620689655
Control.SRR15539874;32;32;0.46875;17;15;0.03125;0.46875
Control.SRR15539874;32;32;0.5625;14;18;0.0625;0.4375
Control.SRR15539874;29;32;0.551724137931034;13;16;0.0517241379310345;0.448275862068966
Control.SRR15539874;35;32;0.485714285714286;18;17;0.0142857142857143;0.485714285714286
Control.SRR15539874;31;32;0.451612903225806;17;14;0.0483870967741936;0.451612903225806
Control.SRR15539874;36;32;0.583333333333333;15;21;0.0833333333333334;0.416666666666667
Control.SRR15539874;35;32;0.514285714285714;17;18;0.0142857142857142;0.485714285714286
Control.SRR15539874;31;32;0.645161290322581;11;20;0.145161290322581;0.354838709677419
Control.SRR15539874;33;32;0.424242424242424;19;14;0.0757575757575757;0.424242424242424
Control.SRR15539874;31;32;0.354838709677419;20;11;0.145161290322581;0.354838709677419
Control.SRR15539874;36;32;0.416666666666667;21;15;0.0833333333333333;0.416666666666667
Control.SRR15539874;29;32;0.379310344827586;18;11;0.120689655172414;0.379310344827586
Control.SRR15539874;34;32;0.558823529411765;15;19;0.0588235294117647;0.441176470588235
Control.SRR15539874;37;32;0.513513513513513;18;19;0.0135135135135135;0.486486486486487
Control.SRR15539874;32;32;0.5;16;16;0;0.5
Control.SRR15539874;36;32;0.527777777777778;17;19;0.0277777777777778;0.472222222222222
Control.SRR15539874;37;32;0.513513513513513;18;19;0.0135135135135135;0.486486486486487
Control.SRR15539874;33;32;0.545454545454545;15;18;0.0454545454545454;0.454545454545455
Control.SRR15539874;37;32;0.486486486486487;19;18;0.0135135135135135;0.486486486486487
Control.SRR15539874;34;32;0.441176470588235;19;15;0.0588235294117647;0.441176470588235
Control.SRR15539874;30;32;0.5;15;15;0;0.5
Control.SRR15539874;30;32;0.466666666666667;16;14;0.0333333333333333;0.466666666666667
Control.SRR15539874;32;32;0.5625;14;18;0.0625;0.4375
Control.SRR15539874;33;32;0.515151515151515;16;17;0.0151515151515151;0.484848484848485
Control.SRR15539874;33;32;0.424242424242424;19;14;0.0757575757575757;0.424242424242424
Control.SRR15539874;34;32;0.529411764705882;16;18;0.0294117647058824;0.470588235294118
Control.SRR15539874;33;32;0.636363636363636;12;21;0.136363636363636;0.363636363636364
Control.SRR15539874;34;32;0.558823529411765;15;19;0.0588235294117647;0.441176470588235
Control.SRR15539874;29;32;0.448275862068966;16;13;0.0517241379310345;0.448275862068966
Control.SRR15539874;36;32;0.472222222222222;19;17;0.0277777777777778;0.472222222222222
Control.SRR15539874;33;32;0.454545454545455;18;15;0.0454545454545455;0.454545454545455
Control.SRR15539874;31;32;0.483870967741935;16;15;0.0161290322580645;0.483870967741935
Control.SRR15539874;36;32;0.472222222222222;19;17;0.0277777777777778;0.472222222222222
Control.SRR15539874;35;32;0.571428571428571;15;20;0.0714285714285714;0.428571428571429
Control.SRR15539874;32;32;0.4375;18;14;0.0625;0.4375
Control.SRR15539874;31;32;0.612903225806452;12;19;0.112903225806452;0.387096774193548
Control.SRR15539874;30;32;0.5;15;15;0;0.5
Control.SRR15539874;34;32;0.5;17;17;0;0.5
Control.SRR15539874;36;32;0.472222222222222;19;17;0.0277777777777778;0.472222222222222
Control.SRR15539874;34;32;0.617647058823529;13;21;0.117647058823529;0.382352941176471
Control.SRR15539874;31;32;0.548387096774194;14;17;0.0483870967741935;0.451612903225806
Control.SRR15539874;33;32;0.454545454545455;18;15;0.0454545454545455;0.454545454545455
Control.SRR15539874;29;32;0.344827586206897;19;10;0.155172413793103;0.344827586206897
Control.SRR15539874;31;32;0.612903225806452;12;19;0.112903225806452;0.387096774193548
Control.SRR15539874;30;32;0.6;12;18;0.1;0.4
Control.SRR15539874;30;32;0.7;9;21;0.2;0.3
Control.SRR15539874;29;32;0.655172413793103;10;19;0.155172413793103;0.344827586206897
Control.SRR15539874;34;32;0.558823529411765;15;19;0.0588235294117647;0.441176470588235
Control.SRR15539874;31;32;0.516129032258065;15;16;0.0161290322580645;0.483870967741935
Control.SRR15539874;29;32;0.482758620689655;15;14;0.0172413793103448;0.482758620689655
Control.SRR15539874;31;32;0.419354838709677;18;13;0.0806451612903226;0.419354838709677
Control.SRR15539874;33;32;0.696969696969697;10;23;0.196969696969697;0.303030303030303
Control.SRR15539874;31;32;0.612903225806452;12;19;0.112903225806452;0.387096774193548
Control.SRR15539874;29;32;0.551724137931034;13;16;0.0517241379310345;0.448275862068966
Control.SRR15539874;32;32;0.375;20;12;0.125;0.375
Control.SRR15539874;33;32;0.333333333333333;22;11;0.166666666666667;0.333333333333333
Control.SRR15539874;33;32;0.393939393939394;20;13;0.106060606060606;0.393939393939394
Control.SRR15539874;32;32;0.53125;15;17;0.03125;0.46875
Control.SRR15539874;31;32;0.516129032258065;15;16;0.0161290322580645;0.483870967741935
Control.SRR15539874;35;32;0.428571428571429;20;15;0.0714285714285715;0.428571428571429
Control.SRR15539874;29;32;0.413793103448276;17;12;0.0862068965517241;0.413793103448276
Control.SRR15539874;36;32;0.472222222222222;19;17;0.0277777777777778;0.472222222222222
Control.SRR15539874;37;32;0.540540540540541;17;20;0.0405405405405406;0.459459459459459
Control.SRR15539874;33;32;0.545454545454545;15;18;0.0454545454545454;0.454545454545455
Control.SRR15539874;34;32;0.617647058823529;13;21;0.117647058823529;0.382352941176471
Control.SRR15539874;31;32;0.451612903225806;17;14;0.0483870967741936;0.451612903225806
Control.SRR15539874;31;32;0.516129032258065;15;16;0.0161290322580645;0.483870967741935
Control.SRR15539874;31;32;0.580645161290323;13;18;0.0806451612903226;0.419354838709677
Control.SRR15539874;29;32;0.620689655172414;11;18;0.120689655172414;0.379310344827586
Control.SRR15539874;29;32;0.344827586206897;19;10;0.155172413793103;0.344827586206897
Control.SRR15539874;33;32;0.515151515151515;16;17;0.0151515151515151;0.484848484848485
Control.SRR15539874;33;32;0.363636363636364;21;12;0.136363636363636;0.363636363636364
Control.SRR15539874;29;32;0.517241379310345;14;15;0.0172413793103449;0.482758620689655
Control.SRR15539874;37;32;0.459459459459459;20;17;0.0405405405405405;0.459459459459459
Control.SRR15539874;34;32;0.588235294117647;14;20;0.0882352941176471;0.411764705882353
Control.SRR15539874;37;32;0.540540540540541;17;20;0.0405405405405406;0.459459459459459
Control.SRR15539874;30;32;0.433333333333333;17;13;0.0666666666666667;0.433333333333333
Control.SRR15539874;36;32;0.611111111111111;14;22;0.111111111111111;0.388888888888889
Control.SRR15539874;36;32;0.555555555555556;16;20;0.0555555555555556;0.444444444444444
Control.SRR15539874;34;32;0.588235294117647;14;20;0.0882352941176471;0.411764705882353
Control.SRR15539874;31;32;0.419354838709677;18;13;0.0806451612903226;0.419354838709677
Control.SRR15539874;32;32;0.53125;15;17;0.03125;0.46875
Control.SRR15539874;33;32;0.575757575757576;14;19;0.0757575757575758;0.424242424242424
Control.SRR15539874;35;32;0.485714285714286;18;17;0.0142857142857143;0.485714285714286
Control.SRR15539874;34;32;0.5;17;17;0;0.5
Control.SRR15539874;37;32;0.621621621621622;14;23;0.121621621621622;0.378378378378378
Control.SRR15539874;34;32;0.588235294117647;14;20;0.0882352941176471;0.411764705882353
Control.SRR15539874;37;32;0.513513513513513;18;19;0.0135135135135135;0.486486486486487
Control.SRR15539874;32;32;0.59375;13;19;0.09375;0.40625
Control.SRR15539874;34;32;0.529411764705882;16;18;0.0294117647058824;0.470588235294118
Control.SRR15539874;31;32;0.483870967741935;16;15;0.0161290322580645;0.483870967741935
Control.SRR15539874;33;32;0.454545454545455;18;15;0.0454545454545455;0.454545454545455
Control.SRR15539874;36;32;0.527777777777778;17;19;0.0277777777777778;0.472222222222222
Control.SRR15539874;33;32;0.484848484848485;17;16;0.0151515151515151;0.484848484848485
Control.SRR15539874;36;32;0.305555555555556;25;11;0.194444444444444;0.305555555555556
Control.SRR15539874;32;32;0.40625;19;13;0.09375;0.40625
Control.SRR15539874;34;32;0.588235294117647;14;20;0.0882352941176471;0.411764705882353
Control.SRR15539874;33;32;0.515151515151515;16;17;0.0151515151515151;0.484848484848485
Control.SRR15539874;33;32;0.303030303030303;23;10;0.196969696969697;0.303030303030303
Control.SRR15539874;35;32;0.457142857142857;19;16;0.0428571428571429;0.457142857142857
Control.SRR15539874;34;32;0.470588235294118;18;16;0.0294117647058824;0.470588235294118
Control.SRR15539874;34;32;0.441176470588235;19;15;0.0588235294117647;0.441176470588235
Control.SRR15539874;32;32;0.46875;17;15;0.03125;0.46875
Control.SRR15539874;32;32;0.59375;13;19;0.09375;0.40625
Control.SRR15539874;37;32;0.567567567567568;16;21;0.0675675675675675;0.432432432432432
Control.SRR15539874;29;32;0.482758620689655;15;14;0.0172413793103448;0.482758620689655
Control.SRR15539874;32;32;0.46875;17;15;0.03125;0.46875
Control.SRR15539874;30;32;0.466666666666667;16;14;0.0333333333333333;0.466666666666667
Control.SRR15539874;33;32;0.363636363636364;21;12;0.136363636363636;0.363636363636364
Control.SRR15539874;29;32;0.517241379310345;14;15;0.0172413793103449;0.482758620689655
Control.SRR15539874;33;32;0.424242424242424;19;14;0.0757575757575757;0.424242424242424
Control.SRR15539874;36;32;0.527777777777778;17;19;0.0277777777777778;0.472222222222222
Control.SRR15539874;33;32;0.454545454545455;18;15;0.0454545454545455;0.454545454545455
Control.SRR15539874;37;32;0.297297297297297;26;11;0.202702702702703;0.297297297297297
Control.SRR15539874;36;32;0.5;18;18;0;0.5
Control.SRR15539874;30;32;0.5;15;15;0;0.5
Control.SRR15539874;34;32;0.5;17;17;0;0.5
Control.SRR15539874;35;32;0.485714285714286;18;17;0.0142857142857143;0.485714285714286
Control.SRR15539874;36;32;0.555555555555556;16;20;0.0555555555555556;0.444444444444444
Control.SRR15539874;35;32;0.485714285714286;18;17;0.0142857142857143;0.485714285714286
Control.SRR15539874;33;32;0.424242424242424;19;14;0.0757575757575757;0.424242424242424
Control.SRR15539874;33;32;0.333333333333333;22;11;0.166666666666667;0.333333333333333
Control.SRR15539874;36;32;0.5;18;18;0;0.5
Control.SRR15539874;37;32;0.648648648648649;13;24;0.148648648648649;0.351351351351351
Control.SRR15539874;30;32;0.433333333333333;17;13;0.0666666666666667;0.433333333333333
Control.SRR15539874;33;32;0.484848484848485;17;16;0.0151515151515151;0.484848484848485
Control.SRR15539874;35;32;0.514285714285714;17;18;0.0142857142857142;0.485714285714286
Control.SRR15539874;37;32;0.513513513513513;18;19;0.0135135135135135;0.486486486486487
Control.SRR15539874;36;32;0.444444444444444;20;16;0.0555555555555556;0.444444444444444
Control.SRR15539874;32;32;0.5625;14;18;0.0625;0.4375
Control.SRR15539874;37;32;0.567567567567568;16;21;0.0675675675675675;0.432432432432432
Control.SRR15539874;30;32;0.4;18;12;0.1;0.4
Control.SRR15539874;32;32;0.34375;21;11;0.15625;0.34375
Control.SRR15539874;37;32;0.432432432432432;21;16;0.0675675675675675;0.432432432432432
Control.SRR15539874;29;32;0.448275862068966;16;13;0.0517241379310345;0.448275862068966
Control.SRR15539874;35;32;0.542857142857143;16;19;0.0428571428571428;0.457142857142857
Control.SRR15539874;33;32;0.606060606060606;13;20;0.106060606060606;0.393939393939394
Control.SRR15539874;29;32;0.689655172413793;9;20;0.189655172413793;0.310344827586207
Control.SRR15539874;30;32;0.4;18;12;0.1;0.4
Control.SRR15539874;34;32;0.470588235294118;18;16;0.0294117647058824;0.470588235294118
Control.SRR15539874;37;32;0.459459459459459;20;17;0.0405405405405405;0.459459459459459
Control.SRR15539874;36;32;0.444444444444444;20;16;0.0555555555555556;0.444444444444444
Control.SRR15539874;33;32;0.484848484848485;17;16;0.0151515151515151;0.484848484848485
Control.SRR15539874;33;32;0.545454545454545;15;18;0.0454545454545454;0.454545454545455
Control.SRR15539874;37;32;0.378378378378378;23;14;0.121621621621622;0.378378378378378
Control.SRR15539874;33;32;0.393939393939394;20;13;0.106060606060606;0.393939393939394
Control.SRR15539874;30;32;0.266666666666667;22;8;0.233333333333333;0.266666666666667
Control.SRR15539874;30;32;0.5;15;15;0;0.5
Control.SRR15539874;32;32;0.46875;17;15;0.03125;0.46875
Control.SRR15539874;36;32;0.388888888888889;22;14;0.111111111111111;0.388888888888889
Control.SRR15539874;34;32;0.411764705882353;20;14;0.0882352941176471;0.411764705882353
Control.SRR15539874;29;32;0.344827586206897;19;10;0.155172413793103;0.344827586206897
Control.SRR15539874;29;32;0.448275862068966;16;13;0.0517241379310345;0.448275862068966
Control.SRR15539874;35;32;0.485714285714286;18;17;0.0142857142857143;0.485714285714286
Control.SRR15539874;35;32;0.514285714285714;17;18;0.0142857142857142;0.485714285714286
Control.SRR15539874;31;32;0.387096774193548;19;12;0.112903225806452;0.387096774193548
Control.SRR15539874;31;32;0.483870967741935;16;15;0.0161290322580645;0.483870967741935
Control.SRR15539874;36;32;0.416666666666667;21;15;0.0833333333333333;0.416666666666667
Control.SRR15539874;29;32;0.620689655172414;11;18;0.120689655172414;0.379310344827586
Control.SRR15539874;32;32;0.46875;17;15;0.03125;0.46875
Control.SRR15539874;29;32;0.482758620689655;15;14;0.0172413793103448;0.482758620689655
Control.SRR15539874;32;32;0.59375;13;19;0.09375;0.40625
Control.SRR15539874;29;32;0.517241379310345;14;15;0.0172413793103449;0.482758620689655
Control.SRR15539874;30;32;0.466666666666667;16;14;0.0333333333333333;0.466666666666667
Control.SRR15539874;36;32;0.444444444444444;20;16;0.0555555555555556;0.444444444444444
Control.SRR15539874;29;32;0.413793103448276;17;12;0.0862068965517241;0.413793103448276
Control.SRR15539874;34;32;0.558823529411765;15;19;0.0588235294117647;0.441176470588235
Control.SRR15539874;35;32;0.628571428571429;13;22;0.128571428571429;0.371428571428571
Control.SRR15539874;29;32;0.310344827586207;20;9;0.189655172413793;0.310344827586207
Control.SRR15539874;35;32;0.485714285714286;18;17;0.0142857142857143;0.485714285714286
Control.SRR15539874;34;32;0.382352941176471;21;13;0.117647058823529;0.382352941176471
Control.SRR15539874;31;32;0.548387096774194;14;17;0.0483870967741935;0.451612903225806
Control.SRR15539874;32;32;0.59375;13;19;0.09375;0.40625
Control.SRR15539874;37;32;0.513513513513513;18;19;0.0135135135135135;0.486486486486487
Control.SRR15539874;32;32;0.5;16;16;0;0.5
Control.SRR15539874;29;32;0.482758620689655;15;14;0.0172413793103448;0.482758620689655
Control.SRR15539874;32;32;0.65625;11;21;0.15625;0.34375
Control.SRR15539874;33;32;0.545454545454545;15;18;0.0454545454545454;0.454545454545455
Control.SRR15539874;37;32;0.351351351351351;24;13;0.148648648648649;0.351351351351351
Control.SRR15539874;35;32;0.485714285714286;18;17;0.0142857142857143;0.485714285714286
Control.SRR15539874;34;32;0.5;17;17;0;0.5
Control.SRR15539874;36;32;0.5;18;18;0;0.5
Control.SRR15539874;36;32;0.555555555555556;16;20;0.0555555555555556;0.444444444444444
Control.SRR15539874;35;32;0.6;14;21;0.1;0.4
Control.SRR15539874;30;32;0.5;15;15;0;0.5
Control.SRR15539874;29;32;0.482758620689655;15;14;0.0172413793103448;0.482758620689655
Control.SRR15539874;31;32;0.516129032258065;15;16;0.0161290322580645;0.483870967741935
Control.SRR15539874;30;32;0.433333333333333;17;13;0.0666666666666667;0.433333333333333
Control.SRR15539874;32;32;0.34375;21;11;0.15625;0.34375
Control.SRR15539874;34;32;0.676470588235294;11;23;0.176470588235294;0.323529411764706
Control.SRR15539874;32;32;0.625;12;20;0.125;0.375
Control.SRR15539874;34;32;0.617647058823529;13;21;0.117647058823529;0.382352941176471
Control.SRR15539874;35;32;0.628571428571429;13;22;0.128571428571429;0.371428571428571
Control.SRR15539874;32;32;0.59375;13;19;0.09375;0.40625
Control.SRR15539874;35;32;0.457142857142857;19;16;0.0428571428571429;0.457142857142857
Control.SRR15539874;37;32;0.540540540540541;17;20;0.0405405405405406;0.459459459459459
Control.SRR15539874;35;32;0.542857142857143;16;19;0.0428571428571428;0.457142857142857
Control.SRR15539874;29;32;0.517241379310345;14;15;0.0172413793103449;0.482758620689655
Control.SRR15539874;32;32;0.5;16;16;0;0.5
Control.SRR15539874;36;32;0.527777777777778;17;19;0.0277777777777778;0.472222222222222
Control.SRR15539874;36;32;0.527777777777778;17;19;0.0277777777777778;0.472222222222222
Control.SRR15539874;29;32;0.413793103448276;17;12;0.0862068965517241;0.413793103448276
Control.SRR15539874;34;32;0.470588235294118;18;16;0.0294117647058824;0.470588235294118
Control.SRR15539874;29;32;0.482758620689655;15;14;0.0172413793103448;0.482758620689655
Control.SRR15539874;31;32;0.354838709677419;20;11;0.145161290322581;0.354838709677419
Control.SRR15539874;35;32;0.485714285714286;18;17;0.0142857142857143;0.485714285714286
Control.SRR15539874;33;32;0.636363636363636;12;21;0.136363636363636;0.363636363636364
Control.SRR15539874;36;32;0.555555555555556;16;20;0.0555555555555556;0.444444444444444
Control.SRR15539874;30;32;0.533333333333333;14;16;0.0333333333333333;0.466666666666667
Control.SRR15539874;37;32;0.513513513513513;18;19;0.0135135135135135;0.486486486486487
Control.SRR15539874;31;32;0.645161290322581;11;20;0.145161290322581;0.354838709677419
Control.SRR15539874;30;32;0.333333333333333;20;10;0.166666666666667;0.333333333333333
Control.SRR15539874;31;32;0.419354838709677;18;13;0.0806451612903226;0.419354838709677
Control.SRR15539874;35;32;0.4;21;14;0.1;0.4
Control.SRR15539874;30;32;0.333333333333333;20;10;0.166666666666667;0.333333333333333
Control.SRR15539874;34;32;0.735294117647059;9;25;0.235294117647059;0.264705882352941
Control.SRR15539874;35;32;0.542857142857143;16;19;0.0428571428571428;0.457142857142857
Control.SRR15539874;36;32;0.5;18;18;0;0.5
Control.SRR15539874;30;32;0.433333333333333;17;13;0.0666666666666667;0.433333333333333
Control.SRR15539874;37;32;0.432432432432432;21;16;0.0675675675675675;0.432432432432432
Control.SRR15539874;31;32;0.451612903225806;17;14;0.0483870967741936;0.451612903225806
Control.SRR15539874;31;32;0.548387096774194;14;17;0.0483870967741935;0.451612903225806
Control.SRR15539874;33;32;0.393939393939394;20;13;0.106060606060606;0.393939393939394
Control.SRR15539874;34;32;0.352941176470588;22;12;0.147058823529412;0.352941176470588
Control.SRR15539874;36;32;0.583333333333333;15;21;0.0833333333333334;0.416666666666667
Control.SRR15539874;34;32;0.558823529411765;15;19;0.0588235294117647;0.441176470588235
Control.SRR15539874;37;32;0.405405405405405;22;15;0.0945945945945946;0.405405405405405
Control.SRR15539874;34;32;0.5;17;17;0;0.5
Control.SRR15539874;34;32;0.676470588235294;11;23;0.176470588235294;0.323529411764706
Control.SRR15539874;34;32;0.735294117647059;9;25;0.235294117647059;0.264705882352941
Control.SRR15539874;31;32;0.516129032258065;15;16;0.0161290322580645;0.483870967741935
Control.SRR15539874;30;32;0.433333333333333;17;13;0.0666666666666667;0.433333333333333
Control.SRR15539874;32;32;0.46875;17;15;0.03125;0.46875
Control.SRR15539874;34;32;0.411764705882353;20;14;0.0882352941176471;0.411764705882353
Control.SRR15539874;33;32;0.515151515151515;16;17;0.0151515151515151;0.484848484848485
Control.SRR15539874;33;32;0.484848484848485;17;16;0.0151515151515151;0.484848484848485
Control.SRR15539874;35;32;0.542857142857143;16;19;0.0428571428571428;0.457142857142857
Control.SRR15539874;36;32;0.527777777777778;17;19;0.0277777777777778;0.472222222222222
Control.SRR15539874;29;32;0.551724137931034;13;16;0.0517241379310345;0.448275862068966
Control.SRR15539874;31;32;0.709677419354839;9;22;0.209677419354839;0.290322580645161
Control.SRR15539874;35;32;0.485714285714286;18;17;0.0142857142857143;0.485714285714286
Control.SRR15539874;31;32;0.451612903225806;17;14;0.0483870967741936;0.451612903225806
Control.SRR15539874;31;32;0.548387096774194;14;17;0.0483870967741935;0.451612903225806
Control.SRR15539874;37;32;0.513513513513513;18;19;0.0135135135135135;0.486486486486487
Control.SRR15539874;31;32;0.451612903225806;17;14;0.0483870967741936;0.451612903225806
Control.SRR15539874;32;32;0.5;16;16;0;0.5
Control.SRR15539874;35;32;0.485714285714286;18;17;0.0142857142857143;0.485714285714286
Control.SRR15539874;35;32;0.457142857142857;19;16;0.0428571428571429;0.457142857142857
Control.SRR15539874;30;32;0.566666666666667;13;17;0.0666666666666667;0.433333333333333
Control.SRR15539874;32;32;0.65625;11;21;0.15625;0.34375
Control.SRR15539874;29;32;0.517241379310345;14;15;0.0172413793103449;0.482758620689655
Control.SRR15539874;29;32;0.517241379310345;14;15;0.0172413793103449;0.482758620689655
Control.SRR15539874;32;32;0.5625;14;18;0.0625;0.4375
Control.SRR15539874;31;32;0.387096774193548;19;12;0.112903225806452;0.387096774193548
Control.SRR15539874;37;32;0.567567567567568;16;21;0.0675675675675675;0.432432432432432
Control.SRR15539874;30;32;0.6;12;18;0.1;0.4
Control.SRR15539874;33;32;0.515151515151515;16;17;0.0151515151515151;0.484848484848485
Control.SRR15539874;36;32;0.5;18;18;0;0.5
Control.SRR15539874;34;32;0.588235294117647;14;20;0.0882352941176471;0.411764705882353
Control.SRR15539874;32;32;0.5625;14;18;0.0625;0.4375
Control.SRR15539874;29;32;0.517241379310345;14;15;0.0172413793103449;0.482758620689655
Control.SRR15539874;31;32;0.645161290322581;11;20;0.145161290322581;0.354838709677419
Control.SRR15539874;32;32;0.53125;15;17;0.03125;0.46875
Control.SRR15539874;34;32;0.470588235294118;18;16;0.0294117647058824;0.470588235294118
Control.SRR15539874;30;32;0.7;9;21;0.2;0.3
Control.SRR15539874;34;32;0.558823529411765;15;19;0.0588235294117647;0.441176470588235
Control.SRR15539874;32;32;0.59375;13;19;0.09375;0.40625
Control.SRR15539874;30;32;0.333333333333333;20;10;0.166666666666667;0.333333333333333
Control.SRR15539874;29;32;0.379310344827586;18;11;0.120689655172414;0.379310344827586
Control.SRR15539874;33;32;0.515151515151515;16;17;0.0151515151515151;0.484848484848485
Control.SRR15539874;33;32;0.545454545454545;15;18;0.0454545454545454;0.454545454545455
Control.SRR15539874;34;32;0.441176470588235;19;15;0.0588235294117647;0.441176470588235
Control.SRR15539874;35;32;0.457142857142857;19;16;0.0428571428571429;0.457142857142857
Control.SRR15539874;35;32;0.485714285714286;18;17;0.0142857142857143;0.485714285714286
Control.SRR15539874;33;32;0.515151515151515;16;17;0.0151515151515151;0.484848484848485
Control.SRR15539874;33;32;0.393939393939394;20;13;0.106060606060606;0.393939393939394
Control.SRR15539874;36;32;0.555555555555556;16;20;0.0555555555555556;0.444444444444444
Control.SRR15539874;31;32;0.451612903225806;17;14;0.0483870967741936;0.451612903225806
Control.SRR15539874;29;32;0.655172413793103;10;19;0.155172413793103;0.344827586206897
Control.SRR15539874;29;32;0.344827586206897;19;10;0.155172413793103;0.344827586206897
Control.SRR15539874;34;32;0.588235294117647;14;20;0.0882352941176471;0.411764705882353
Control.SRR15539874;31;32;0.483870967741935;16;15;0.0161290322580645;0.483870967741935
Control.SRR15539874;31;32;0.387096774193548;19;12;0.112903225806452;0.387096774193548
Control.SRR15539874;32;32;0.34375;21;11;0.15625;0.34375
Control.SRR15539874;35;32;0.571428571428571;15;20;0.0714285714285714;0.428571428571429
Control.SRR15539874;37;32;0.459459459459459;20;17;0.0405405405405405;0.459459459459459
Control.SRR15539874;36;32;0.527777777777778;17;19;0.0277777777777778;0.472222222222222
Control.SRR15539874;34;32;0.529411764705882;16;18;0.0294117647058824;0.470588235294118
Control.SRR15539874;31;32;0.580645161290323;13;18;0.0806451612903226;0.419354838709677
Control.SRR15539874;29;32;0.724137931034483;8;21;0.224137931034483;0.275862068965517
Control.SRR15539874;34;32;0.647058823529412;12;22;0.147058823529412;0.352941176470588
Control.SRR15539874;32;32;0.59375;13;19;0.09375;0.40625
Control.SRR15539874;34;32;0.529411764705882;16;18;0.0294117647058824;0.470588235294118
Control.SRR15539874;31;32;0.483870967741935;16;15;0.0161290322580645;0.483870967741935
Control.SRR15539874;37;32;0.540540540540541;17;20;0.0405405405405406;0.459459459459459
Control.SRR15539874;31;32;0.612903225806452;12;19;0.112903225806452;0.387096774193548
Control.SRR15539874;31;32;0.419354838709677;18;13;0.0806451612903226;0.419354838709677
Control.SRR15539874;34;32;0.5;17;17;0;0.5
Control.SRR15539874;35;32;0.714285714285714;10;25;0.214285714285714;0.285714285714286
Control.SRR15539874;37;32;0.621621621621622;14;23;0.121621621621622;0.378378378378378
Control.SRR15539874;37;32;0.486486486486487;19;18;0.0135135135135135;0.486486486486487
Control.SRR15539874;31;32;0.483870967741935;16;15;0.0161290322580645;0.483870967741935
Control.SRR15539874;30;32;0.5;15;15;0;0.5
Control.SRR15539874;36;32;0.583333333333333;15;21;0.0833333333333334;0.416666666666667
Control.SRR15539874;36;32;0.666666666666667;12;24;0.166666666666667;0.333333333333333
Control.SRR15539874;35;32;0.542857142857143;16;19;0.0428571428571428;0.457142857142857
Control.SRR15539874;33;32;0.545454545454545;15;18;0.0454545454545454;0.454545454545455
Control.SRR15539874;33;32;0.424242424242424;19;14;0.0757575757575757;0.424242424242424
Control.SRR15539874;37;32;0.621621621621622;14;23;0.121621621621622;0.378378378378378
Control.SRR15539874;33;32;0.515151515151515;16;17;0.0151515151515151;0.484848484848485
Control.SRR15539874;31;32;0.548387096774194;14;17;0.0483870967741935;0.451612903225806
Control.SRR15539874;37;32;0.594594594594595;15;22;0.0945945945945946;0.405405405405405
Control.SRR15539874;32;32;0.4375;18;14;0.0625;0.4375
Control.SRR15539874;33;32;0.393939393939394;20;13;0.106060606060606;0.393939393939394
Control.SRR15539874;30;32;0.433333333333333;17;13;0.0666666666666667;0.433333333333333
Control.SRR15539874;35;32;0.4;21;14;0.1;0.4
Control.SRR15539874;36;32;0.416666666666667;21;15;0.0833333333333333;0.416666666666667
Control.SRR15539874;35;32;0.542857142857143;16;19;0.0428571428571428;0.457142857142857
Control.SRR15539874;36;32;0.5;18;18;0;0.5
Control.SRR15539874;29;32;0.517241379310345;14;15;0.0172413793103449;0.482758620689655
Control.SRR15539874;37;32;0.513513513513513;18;19;0.0135135135135135;0.486486486486487
Control.SRR15539874;31;32;0.516129032258065;15;16;0.0161290322580645;0.483870967741935
Control.SRR15539874;33;32;0.424242424242424;19;14;0.0757575757575757;0.424242424242424
Control.SRR15539874;30;32;0.533333333333333;14;16;0.0333333333333333;0.466666666666667
Control.SRR15539874;34;32;0.5;17;17;0;0.5
Control.SRR15539874;33;32;0.393939393939394;20;13;0.106060606060606;0.393939393939394
Control.SRR15539874;37;32;0.567567567567568;16;21;0.0675675675675675;0.432432432432432
Control.SRR15539874;35;32;0.428571428571429;20;15;0.0714285714285715;0.428571428571429
Control.SRR15539874;34;32;0.5;17;17;0;0.5
Control.SRR15539874;35;32;0.457142857142857;19;16;0.0428571428571429;0.457142857142857
Control.SRR15539874;36;32;0.416666666666667;21;15;0.0833333333333333;0.416666666666667
Control.SRR15539874;36;32;0.5;18;18;0;0.5
Control.SRR15539874;31;32;0.483870967741935;16;15;0.0161290322580645;0.483870967741935
Control.SRR15539874;33;32;0.393939393939394;20;13;0.106060606060606;0.393939393939394
Control.SRR15539874;33;32;0.454545454545455;18;15;0.0454545454545455;0.454545454545455
Control.SRR15539874;37;32;0.486486486486487;19;18;0.0135135135135135;0.486486486486487
Control.SRR15539874;37;32;0.540540540540541;17;20;0.0405405405405406;0.459459459459459
Control.SRR15539874;35;32;0.371428571428571;22;13;0.128571428571429;0.371428571428571
Control.SRR15539874;32;32;0.4375;18;14;0.0625;0.4375
Control.SRR15539874;37;32;0.540540540540541;17;20;0.0405405405405406;0.459459459459459
Control.SRR15539874;35;32;0.571428571428571;15;20;0.0714285714285714;0.428571428571429
Control.SRR15539874;31;32;0.451612903225806;17;14;0.0483870967741936;0.451612903225806
Control.SRR15539874;32;32;0.46875;17;15;0.03125;0.46875
Control.SRR15539874;33;32;0.545454545454545;15;18;0.0454545454545454;0.454545454545455
Control.SRR15539874;35;32;0.485714285714286;18;17;0.0142857142857143;0.485714285714286
Control.SRR15539874;33;32;0.515151515151515;16;17;0.0151515151515151;0.484848484848485
Control.SRR15539874;33;32;0.545454545454545;15;18;0.0454545454545454;0.454545454545455
Control.SRR15539874;36;32;0.5;18;18;0;0.5
Control.SRR15539874;35;32;0.571428571428571;15;20;0.0714285714285714;0.428571428571429
Control.SRR15539874;37;32;0.459459459459459;20;17;0.0405405405405405;0.459459459459459
Control.SRR15539874;33;32;0.424242424242424;19;14;0.0757575757575757;0.424242424242424
Control.SRR15539874;37;32;0.378378378378378;23;14;0.121621621621622;0.378378378378378
Control.SRR15539874;34;32;0.705882352941177;10;24;0.205882352941177;0.294117647058824
Control.SRR15539874;34;32;0.470588235294118;18;16;0.0294117647058824;0.470588235294118
Control.SRR15539874;37;32;0.486486486486487;19;18;0.0135135135135135;0.486486486486487
Control.SRR15539874;36;32;0.611111111111111;14;22;0.111111111111111;0.388888888888889
Control.SRR15539874;32;32;0.375;20;12;0.125;0.375
Control.SRR15539874;37;32;0.378378378378378;23;14;0.121621621621622;0.378378378378378
Control.SRR15539874;31;32;0.483870967741935;16;15;0.0161290322580645;0.483870967741935
Control.SRR15539874;37;32;0.459459459459459;20;17;0.0405405405405405;0.459459459459459
Control.SRR15539874;36;32;0.416666666666667;21;15;0.0833333333333333;0.416666666666667
Control.SRR15539874;36;32;0.361111111111111;23;13;0.138888888888889;0.361111111111111
Control.SRR15539874;34;32;0.5;17;17;0;0.5
Control.SRR15539874;32;32;0.375;20;12;0.125;0.375
Control.SRR15539874;36;32;0.333333333333333;24;12;0.166666666666667;0.333333333333333
Control.SRR15539874;36;32;0.416666666666667;21;15;0.0833333333333333;0.416666666666667
Control.SRR15539874;37;32;0.567567567567568;16;21;0.0675675675675675;0.432432432432432
Control.SRR15539874;37;32;0.405405405405405;22;15;0.0945945945945946;0.405405405405405
Control.SRR15539874;35;32;0.485714285714286;18;17;0.0142857142857143;0.485714285714286
Control.SRR15539874;29;32;0.413793103448276;17;12;0.0862068965517241;0.413793103448276
Control.SRR15539874;29;32;0.586206896551724;12;17;0.0862068965517241;0.413793103448276
Control.SRR15539874;31;32;0.483870967741935;16;15;0.0161290322580645;0.483870967741935
Control.SRR15539874;33;32;0.545454545454545;15;18;0.0454545454545454;0.454545454545455
Control.SRR15539874;35;32;0.628571428571429;13;22;0.128571428571429;0.371428571428571
Control.SRR15539874;34;32;0.558823529411765;15;19;0.0588235294117647;0.441176470588235
Control.SRR15539874;34;32;0.588235294117647;14;20;0.0882352941176471;0.411764705882353
Control.SRR15539874;33;32;0.484848484848485;17;16;0.0151515151515151;0.484848484848485
Control.SRR15539874;31;32;0.516129032258065;15;16;0.0161290322580645;0.483870967741935
Control.SRR15539874;33;32;0.393939393939394;20;13;0.106060606060606;0.393939393939394
Control.SRR15539874;32;32;0.375;20;12;0.125;0.375
Control.SRR15539874;31;32;0.548387096774194;14;17;0.0483870967741935;0.451612903225806
Control.SRR15539874;36;32;0.527777777777778;17;19;0.0277777777777778;0.472222222222222
Control.SRR15539874;35;32;0.457142857142857;19;16;0.0428571428571429;0.457142857142857
Control.SRR15539874;33;32;0.545454545454545;15;18;0.0454545454545454;0.454545454545455
Control.SRR15539874;32;32;0.46875;17;15;0.03125;0.46875
Control.SRR15539874;36;32;0.472222222222222;19;17;0.0277777777777778;0.472222222222222
Control.SRR15539874;31;32;0.580645161290323;13;18;0.0806451612903226;0.419354838709677
Control.SRR15539874;29;32;0.551724137931034;13;16;0.0517241379310345;0.448275862068966
Control.SRR15539874;36;32;0.5;18;18;0;0.5
Control.SRR15539874;36;32;0.333333333333333;24;12;0.166666666666667;0.333333333333333
Control.SRR15539874;30;32;0.5;15;15;0;0.5
Control.SRR15539874;37;32;0.513513513513513;18;19;0.0135135135135135;0.486486486486487
Control.SRR15539874;37;32;0.486486486486487;19;18;0.0135135135135135;0.486486486486487
Control.SRR15539874;32;32;0.53125;15;17;0.03125;0.46875
Control.SRR15539874;37;32;0.432432432432432;21;16;0.0675675675675675;0.432432432432432
Control.SRR15539874;32;32;0.5625;14;18;0.0625;0.4375
Control.SRR15539874;34;32;0.5;17;17;0;0.5
Control.SRR15539874;29;32;0.551724137931034;13;16;0.0517241379310345;0.448275862068966
Control.SRR15539874;31;32;0.483870967741935;16;15;0.0161290322580645;0.483870967741935
Control.SRR15539874;32;32;0.375;20;12;0.125;0.375
Control.SRR15539874;30;32;0.4;18;12;0.1;0.4
Control.SRR15539874;32;32;0.4375;18;14;0.0625;0.4375
Control.SRR15539874;37;32;0.567567567567568;16;21;0.0675675675675675;0.432432432432432
Control.SRR15539874;34;32;0.647058823529412;12;22;0.147058823529412;0.352941176470588
Control.SRR15539874;31;32;0.483870967741935;16;15;0.0161290322580645;0.483870967741935
Control.SRR15539874;32;32;0.46875;17;15;0.03125;0.46875
Control.SRR15539874;30;32;0.533333333333333;14;16;0.0333333333333333;0.466666666666667
Control.SRR15539874;29;32;0.482758620689655;15;14;0.0172413793103448;0.482758620689655
Control.SRR15539874;36;32;0.5;18;18;0;0.5
Control.SRR15539874;36;32;0.555555555555556;16;20;0.0555555555555556;0.444444444444444
Control.SRR15539874;36;32;0.361111111111111;23;13;0.138888888888889;0.361111111111111
Control.SRR15539874;30;32;0.566666666666667;13;17;0.0666666666666667;0.433333333333333
Control.SRR15539874;35;32;0.428571428571429;20;15;0.0714285714285715;0.428571428571429
Control.SRR15539874;35;32;0.485714285714286;18;17;0.0142857142857143;0.485714285714286
Control.SRR15539874;30;32;0.366666666666667;19;11;0.133333333333333;0.366666666666667
Control.SRR15539874;34;32;0.470588235294118;18;16;0.0294117647058824;0.470588235294118
Control.SRR15539874;30;32;0.433333333333333;17;13;0.0666666666666667;0.433333333333333
Control.SRR15539874;36;32;0.5;18;18;0;0.5
Control.SRR15539874;35;32;0.542857142857143;16;19;0.0428571428571428;0.457142857142857
Control.SRR15539874;31;32;0.451612903225806;17;14;0.0483870967741936;0.451612903225806
Control.SRR15539874;32;32;0.53125;15;17;0.03125;0.46875
Control.SRR15539874;35;32;0.428571428571429;20;15;0.0714285714285715;0.428571428571429
Control.SRR15539874;34;32;0.558823529411765;15;19;0.0588235294117647;0.441176470588235
Control.SRR15539874;29;32;0.448275862068966;16;13;0.0517241379310345;0.448275862068966
Control.SRR15539874;36;32;0.583333333333333;15;21;0.0833333333333334;0.416666666666667
Control.SRR15539874;37;32;0.486486486486487;19;18;0.0135135135135135;0.486486486486487
Control.SRR15539874;32;32;0.46875;17;15;0.03125;0.46875
Control.SRR15539874;36;32;0.472222222222222;19;17;0.0277777777777778;0.472222222222222
Control.SRR15539874;31;32;0.67741935483871;10;21;0.17741935483871;0.32258064516129
Control.SRR15539874;36;32;0.388888888888889;22;14;0.111111111111111;0.388888888888889
Control.SRR15539874;37;32;0.540540540540541;17;20;0.0405405405405406;0.459459459459459
Control.SRR15539874;31;32;0.516129032258065;15;16;0.0161290322580645;0.483870967741935
Control.SRR15539874;34;32;0.558823529411765;15;19;0.0588235294117647;0.441176470588235
Control.SRR15539874;36;32;0.555555555555556;16;20;0.0555555555555556;0.444444444444444
Control.SRR15539874;35;32;0.514285714285714;17;18;0.0142857142857142;0.485714285714286
Control.SRR15539874;30;32;0.666666666666667;10;20;0.166666666666667;0.333333333333333
Control.SRR15539874;34;32;0.588235294117647;14;20;0.0882352941176471;0.411764705882353
Control.SRR15539874;35;32;0.571428571428571;15;20;0.0714285714285714;0.428571428571429
Control.SRR15539874;33;32;0.545454545454545;15;18;0.0454545454545454;0.454545454545455
Control.SRR15539874;35;32;0.542857142857143;16;19;0.0428571428571428;0.457142857142857
Control.SRR15539874;36;32;0.583333333333333;15;21;0.0833333333333334;0.416666666666667
Control.SRR15539874;29;32;0.448275862068966;16;13;0.0517241379310345;0.448275862068966
Control.SRR15539874;32;32;0.65625;11;21;0.15625;0.34375
Control.SRR15539874;35;32;0.542857142857143;16;19;0.0428571428571428;0.457142857142857
Control.SRR15539874;36;32;0.555555555555556;16;20;0.0555555555555556;0.444444444444444
Control.SRR15539874;36;32;0.583333333333333;15;21;0.0833333333333334;0.416666666666667
Control.SRR15539874;31;32;0.419354838709677;18;13;0.0806451612903226;0.419354838709677
Control.SRR15539874;35;32;0.4;21;14;0.1;0.4
Control.SRR15539874;29;32;0.482758620689655;15;14;0.0172413793103448;0.482758620689655
Control.SRR15539874;34;32;0.441176470588235;19;15;0.0588235294117647;0.441176470588235
Control.SRR15539874;36;32;0.611111111111111;14;22;0.111111111111111;0.388888888888889
Control.SRR15539874;37;32;0.324324324324324;25;12;0.175675675675676;0.324324324324324
Control.SRR15539874;35;32;0.542857142857143;16;19;0.0428571428571428;0.457142857142857
Control.SRR15539874;32;32;0.46875;17;15;0.03125;0.46875
Control.SRR15539874;29;32;0.344827586206897;19;10;0.155172413793103;0.344827586206897
Control.SRR15539874;31;32;0.451612903225806;17;14;0.0483870967741936;0.451612903225806
Control.SRR15539874;33;32;0.484848484848485;17;16;0.0151515151515151;0.484848484848485
Control.SRR15539874;29;32;0.551724137931034;13;16;0.0517241379310345;0.448275862068966
Control.SRR15539874;35;32;0.542857142857143;16;19;0.0428571428571428;0.457142857142857
Control.SRR15539874;29;32;0.551724137931034;13;16;0.0517241379310345;0.448275862068966
Control.SRR15539874;35;32;0.485714285714286;18;17;0.0142857142857143;0.485714285714286
Control.SRR15539874;36;32;0.527777777777778;17;19;0.0277777777777778;0.472222222222222
Control.SRR15539874;29;32;0.517241379310345;14;15;0.0172413793103449;0.482758620689655
Control.SRR15539874;32;32;0.4375;18;14;0.0625;0.4375
Control.SRR15539874;34;32;0.470588235294118;18;16;0.0294117647058824;0.470588235294118
Control.SRR15539874;34;32;0.529411764705882;16;18;0.0294117647058824;0.470588235294118
Control.SRR15539874;33;32;0.545454545454545;15;18;0.0454545454545454;0.454545454545455
Control.SRR15539874;32;32;0.46875;17;15;0.03125;0.46875
Control.SRR15539874;32;32;0.40625;19;13;0.09375;0.40625
Control.SRR15539874;31;32;0.387096774193548;19;12;0.112903225806452;0.387096774193548
Control.SRR15539874;36;32;0.527777777777778;17;19;0.0277777777777778;0.472222222222222
Control.SRR15539874;37;32;0.567567567567568;16;21;0.0675675675675675;0.432432432432432
Control.SRR15539874;35;32;0.685714285714286;11;24;0.185714285714286;0.314285714285714
Control.SRR15539874;37;32;0.432432432432432;21;16;0.0675675675675675;0.432432432432432
Control.SRR15539874;36;32;0.555555555555556;16;20;0.0555555555555556;0.444444444444444
Control.SRR15539874;29;32;0.758620689655172;7;22;0.258620689655172;0.241379310344828
Control.SRR15539874;29;32;0.551724137931034;13;16;0.0517241379310345;0.448275862068966
Control.SRR15539874;31;32;0.645161290322581;11;20;0.145161290322581;0.354838709677419
Control.SRR15539874;36;32;0.416666666666667;21;15;0.0833333333333333;0.416666666666667
Control.SRR15539874;33;32;0.636363636363636;12;21;0.136363636363636;0.363636363636364
Control.SRR15539874;35;32;0.514285714285714;17;18;0.0142857142857142;0.485714285714286
Control.SRR15539874;35;32;0.428571428571429;20;15;0.0714285714285715;0.428571428571429
Control.SRR15539874;34;32;0.529411764705882;16;18;0.0294117647058824;0.470588235294118
Control.SRR15539874;35;32;0.628571428571429;13;22;0.128571428571429;0.371428571428571
Control.SRR15539874;35;32;0.542857142857143;16;19;0.0428571428571428;0.457142857142857
Control.SRR15539874;34;32;0.588235294117647;14;20;0.0882352941176471;0.411764705882353
Control.SRR15539874;33;32;0.454545454545455;18;15;0.0454545454545455;0.454545454545455
Control.SRR15539874;30;32;0.6;12;18;0.1;0.4
Control.SRR15539874;37;32;0.486486486486487;19;18;0.0135135135135135;0.486486486486487
Control.SRR15539874;37;32;0.567567567567568;16;21;0.0675675675675675;0.432432432432432
Control.SRR15539874;29;32;0.586206896551724;12;17;0.0862068965517241;0.413793103448276
Control.SRR15539874;30;32;0.433333333333333;17;13;0.0666666666666667;0.433333333333333
Control.SRR15539874;30;32;0.666666666666667;10;20;0.166666666666667;0.333333333333333
Control.SRR15539874;36;32;0.555555555555556;16;20;0.0555555555555556;0.444444444444444
Control.SRR15539874;37;32;0.324324324324324;25;12;0.175675675675676;0.324324324324324
Control.SRR15539874;34;32;0.411764705882353;20;14;0.0882352941176471;0.411764705882353
Control.SRR15539874;33;32;0.515151515151515;16;17;0.0151515151515151;0.484848484848485
Control.SRR15539874;36;32;0.5;18;18;0;0.5
Control.SRR15539874;29;32;0.482758620689655;15;14;0.0172413793103448;0.482758620689655
Control.SRR15539874;37;32;0.540540540540541;17;20;0.0405405405405406;0.459459459459459
Control.SRR15539874;35;32;0.428571428571429;20;15;0.0714285714285715;0.428571428571429
Control.SRR15539874;34;32;0.617647058823529;13;21;0.117647058823529;0.382352941176471
Control.SRR15539874;34;32;0.441176470588235;19;15;0.0588235294117647;0.441176470588235
Control.SRR15539874;36;32;0.472222222222222;19;17;0.0277777777777778;0.472222222222222
Control.SRR15539874;34;32;0.558823529411765;15;19;0.0588235294117647;0.441176470588235
Control.SRR15539874;33;32;0.484848484848485;17;16;0.0151515151515151;0.484848484848485
Control.SRR15539874;30;32;0.6;12;18;0.1;0.4
Control.SRR15539874;33;32;0.454545454545455;18;15;0.0454545454545455;0.454545454545455
Control.SRR15539874;31;32;0.516129032258065;15;16;0.0161290322580645;0.483870967741935
Control.SRR15539874;35;32;0.571428571428571;15;20;0.0714285714285714;0.428571428571429
Control.SRR15539874;35;32;0.485714285714286;18;17;0.0142857142857143;0.485714285714286
Control.SRR15539874;33;32;0.484848484848485;17;16;0.0151515151515151;0.484848484848485
Control.SRR15539874;36;32;0.444444444444444;20;16;0.0555555555555556;0.444444444444444
Control.SRR15539874;36;32;0.472222222222222;19;17;0.0277777777777778;0.472222222222222
Control.SRR15539874;31;32;0.516129032258065;15;16;0.0161290322580645;0.483870967741935
Control.SRR15539874;37;32;0.459459459459459;20;17;0.0405405405405405;0.459459459459459
Control.SRR15539874;32;32;0.59375;13;19;0.09375;0.40625
Control.SRR15539874;36;32;0.527777777777778;17;19;0.0277777777777778;0.472222222222222
Control.SRR15539874;32;32;0.40625;19;13;0.09375;0.40625
Control.SRR15539874;35;32;0.485714285714286;18;17;0.0142857142857143;0.485714285714286
Control.SRR15539874;35;32;0.685714285714286;11;24;0.185714285714286;0.314285714285714
Control.SRR15539874;35;32;0.628571428571429;13;22;0.128571428571429;0.371428571428571
Control.SRR15539874;33;32;0.454545454545455;18;15;0.0454545454545455;0.454545454545455
Control.SRR15539874;29;32;0.379310344827586;18;11;0.120689655172414;0.379310344827586
Control.SRR15539874;37;32;0.459459459459459;20;17;0.0405405405405405;0.459459459459459
Control.SRR15539874;36;32;0.472222222222222;19;17;0.0277777777777778;0.472222222222222
Control.SRR15539874;33;32;0.484848484848485;17;16;0.0151515151515151;0.484848484848485
Control.SRR15539874;34;32;0.352941176470588;22;12;0.147058823529412;0.352941176470588
Control.SRR15539874;35;32;0.371428571428571;22;13;0.128571428571429;0.371428571428571
Control.SRR15539874;29;32;0.413793103448276;17;12;0.0862068965517241;0.413793103448276
Control.SRR15539874;30;32;0.533333333333333;14;16;0.0333333333333333;0.466666666666667
Control.SRR15539874;31;32;0.387096774193548;19;12;0.112903225806452;0.387096774193548
Control.SRR15539874;37;32;0.432432432432432;21;16;0.0675675675675675;0.432432432432432
Control.SRR15539874;29;32;0.448275862068966;16;13;0.0517241379310345;0.448275862068966
Control.SRR15539874;34;32;0.441176470588235;19;15;0.0588235294117647;0.441176470588235
Control.SRR15539874;34;32;0.382352941176471;21;13;0.117647058823529;0.382352941176471
Control.SRR15539874;29;32;0.551724137931034;13;16;0.0517241379310345;0.448275862068966
Control.SRR15539874;36;32;0.416666666666667;21;15;0.0833333333333333;0.416666666666667
Control.SRR15539874;33;32;0.606060606060606;13;20;0.106060606060606;0.393939393939394
Control.SRR15539874;36;32;0.527777777777778;17;19;0.0277777777777778;0.472222222222222
Control.SRR15539874;32;32;0.5625;14;18;0.0625;0.4375
Control.SRR15539874;29;32;0.448275862068966;16;13;0.0517241379310345;0.448275862068966
Control.SRR15539874;31;32;0.451612903225806;17;14;0.0483870967741936;0.451612903225806
Control.SRR15539874;30;32;0.466666666666667;16;14;0.0333333333333333;0.466666666666667
Control.SRR15539874;33;32;0.363636363636364;21;12;0.136363636363636;0.363636363636364
Control.SRR15539874;29;32;0.517241379310345;14;15;0.0172413793103449;0.482758620689655
Control.SRR15539874;31;32;0.419354838709677;18;13;0.0806451612903226;0.419354838709677
Control.SRR15539874;35;32;0.371428571428571;22;13;0.128571428571429;0.371428571428571
Control.SRR15539874;31;32;0.483870967741935;16;15;0.0161290322580645;0.483870967741935
Control.SRR15539874;37;32;0.405405405405405;22;15;0.0945945945945946;0.405405405405405
Control.SRR15539874;29;32;0.517241379310345;14;15;0.0172413793103449;0.482758620689655
Control.SRR15539874;29;32;0.551724137931034;13;16;0.0517241379310345;0.448275862068966
Control.SRR15539874;29;32;0.551724137931034;13;16;0.0517241379310345;0.448275862068966
Control.SRR15539874;29;32;0.482758620689655;15;14;0.0172413793103448;0.482758620689655
Control.SRR15539874;30;32;0.433333333333333;17;13;0.0666666666666667;0.433333333333333
Control.SRR15539874;35;32;0.514285714285714;17;18;0.0142857142857142;0.485714285714286
Control.SRR15539874;37;32;0.594594594594595;15;22;0.0945945945945946;0.405405405405405
Control.SRR15539874;32;32;0.40625;19;13;0.09375;0.40625
Control.SRR15539874;30;32;0.466666666666667;16;14;0.0333333333333333;0.466666666666667
Control.SRR15539874;34;32;0.470588235294118;18;16;0.0294117647058824;0.470588235294118
Control.SRR15539874;35;32;0.428571428571429;20;15;0.0714285714285715;0.428571428571429
Control.SRR15539874;37;32;0.621621621621622;14;23;0.121621621621622;0.378378378378378
Control.SRR15539874;33;32;0.515151515151515;16;17;0.0151515151515151;0.484848484848485
Control.SRR15539874;35;32;0.485714285714286;18;17;0.0142857142857143;0.485714285714286
Control.SRR15539874;36;32;0.472222222222222;19;17;0.0277777777777778;0.472222222222222
Control.SRR15539874;36;32;0.527777777777778;17;19;0.0277777777777778;0.472222222222222
Control.SRR15539874;35;32;0.371428571428571;22;13;0.128571428571429;0.371428571428571
Control.SRR15539874;29;32;0.655172413793103;10;19;0.155172413793103;0.344827586206897
Control.SRR15539874;30;32;0.5;15;15;0;0.5
Control.SRR15539874;35;32;0.4;21;14;0.1;0.4
Control.SRR15539874;35;32;0.428571428571429;20;15;0.0714285714285715;0.428571428571429
Control.SRR15539874;32;32;0.46875;17;15;0.03125;0.46875
Control.SRR15539874;35;32;0.485714285714286;18;17;0.0142857142857143;0.485714285714286
Control.SRR15539874;36;32;0.444444444444444;20;16;0.0555555555555556;0.444444444444444
Control.SRR15539874;33;32;0.393939393939394;20;13;0.106060606060606;0.393939393939394
Control.SRR15539874;35;32;0.514285714285714;17;18;0.0142857142857142;0.485714285714286
Control.SRR15539874;37;32;0.459459459459459;20;17;0.0405405405405405;0.459459459459459
Control.SRR15539874;35;32;0.542857142857143;16;19;0.0428571428571428;0.457142857142857
Control.SRR15539874;32;32;0.5625;14;18;0.0625;0.4375
Control.SRR15539874;34;32;0.558823529411765;15;19;0.0588235294117647;0.441176470588235
Control.SRR15539874;30;32;0.366666666666667;19;11;0.133333333333333;0.366666666666667
Control.SRR15539874;36;32;0.527777777777778;17;19;0.0277777777777778;0.472222222222222
Control.SRR15539874;32;32;0.46875;17;15;0.03125;0.46875
Control.SRR15539874;29;32;0.517241379310345;14;15;0.0172413793103449;0.482758620689655
Control.SRR15539874;33;32;0.636363636363636;12;21;0.136363636363636;0.363636363636364
Control.SRR15539874;33;32;0.484848484848485;17;16;0.0151515151515151;0.484848484848485
Control.SRR15539874;30;32;0.4;18;12;0.1;0.4
Control.SRR15539874;36;32;0.583333333333333;15;21;0.0833333333333334;0.416666666666667
Control.SRR15539874;33;32;0.484848484848485;17;16;0.0151515151515151;0.484848484848485
Control.SRR15539874;29;32;0.586206896551724;12;17;0.0862068965517241;0.413793103448276
Control.SRR15539874;35;32;0.514285714285714;17;18;0.0142857142857142;0.485714285714286
Control.SRR15539874;34;32;0.558823529411765;15;19;0.0588235294117647;0.441176470588235
Control.SRR15539874;29;32;0.517241379310345;14;15;0.0172413793103449;0.482758620689655
Control.SRR15539874;32;32;0.5625;14;18;0.0625;0.4375
Control.SRR15539874;35;32;0.428571428571429;20;15;0.0714285714285715;0.428571428571429
Control.SRR15539874;29;32;0.551724137931034;13;16;0.0517241379310345;0.448275862068966
Control.SRR15539874;33;32;0.666666666666667;11;22;0.166666666666667;0.333333333333333
Control.SRR15539874;31;32;0.290322580645161;22;9;0.209677419354839;0.290322580645161
Control.SRR15539874;36;32;0.333333333333333;24;12;0.166666666666667;0.333333333333333
Control.SRR15539874;29;32;0.413793103448276;17;12;0.0862068965517241;0.413793103448276
Control.SRR15539874;30;32;0.566666666666667;13;17;0.0666666666666667;0.433333333333333
Control.SRR15539874;32;32;0.4375;18;14;0.0625;0.4375
Control.SRR15539874;31;32;0.645161290322581;11;20;0.145161290322581;0.354838709677419
Control.SRR15539874;30;32;0.566666666666667;13;17;0.0666666666666667;0.433333333333333
Control.SRR15539874;30;32;0.566666666666667;13;17;0.0666666666666667;0.433333333333333
Control.SRR15539874;32;32;0.4375;18;14;0.0625;0.4375
Control.SRR15539874;31;32;0.451612903225806;17;14;0.0483870967741936;0.451612903225806
Control.SRR15539874;31;32;0.483870967741935;16;15;0.0161290322580645;0.483870967741935
Control.SRR15539874;34;32;0.470588235294118;18;16;0.0294117647058824;0.470588235294118
Control.SRR15539874;29;32;0.448275862068966;16;13;0.0517241379310345;0.448275862068966
Control.SRR15539874;31;32;0.612903225806452;12;19;0.112903225806452;0.387096774193548
Control.SRR15539874;31;32;0.612903225806452;12;19;0.112903225806452;0.387096774193548
Control.SRR15539874;35;32;0.514285714285714;17;18;0.0142857142857142;0.485714285714286
Control.SRR15539874;34;32;0.382352941176471;21;13;0.117647058823529;0.382352941176471
Control.SRR15539874;32;32;0.46875;17;15;0.03125;0.46875
Control.SRR15539874;33;32;0.424242424242424;19;14;0.0757575757575757;0.424242424242424
Control.SRR15539874;37;32;0.432432432432432;21;16;0.0675675675675675;0.432432432432432
Control.SRR15539874;35;32;0.4;21;14;0.1;0.4
Control.SRR15539874;32;32;0.53125;15;17;0.03125;0.46875
Control.SRR15539874;32;32;0.625;12;20;0.125;0.375
Control.SRR15539874;32;32;0.4375;18;14;0.0625;0.4375
Control.SRR15539874;31;32;0.451612903225806;17;14;0.0483870967741936;0.451612903225806
Control.SRR15539874;30;32;0.5;15;15;0;0.5
Control.SRR15539874;33;32;0.454545454545455;18;15;0.0454545454545455;0.454545454545455
Control.SRR15539874;35;32;0.6;14;21;0.1;0.4
Control.SRR15539874;34;32;0.588235294117647;14;20;0.0882352941176471;0.411764705882353
Control.SRR15539874;30;32;0.566666666666667;13;17;0.0666666666666667;0.433333333333333
Control.SRR15539874;32;32;0.59375;13;19;0.09375;0.40625
Control.SRR15539874;29;32;0.551724137931034;13;16;0.0517241379310345;0.448275862068966
Control.SRR15539874;31;32;0.451612903225806;17;14;0.0483870967741936;0.451612903225806
Control.SRR15539874;30;32;0.433333333333333;17;13;0.0666666666666667;0.433333333333333
Control.SRR15539874;35;32;0.542857142857143;16;19;0.0428571428571428;0.457142857142857
Control.SRR15539874;36;32;0.472222222222222;19;17;0.0277777777777778;0.472222222222222
Control.SRR15539874;30;32;0.433333333333333;17;13;0.0666666666666667;0.433333333333333
Control.SRR15539874;37;32;0.486486486486487;19;18;0.0135135135135135;0.486486486486487
Control.SRR15539874;33;32;0.515151515151515;16;17;0.0151515151515151;0.484848484848485
Control.SRR15539874;35;32;0.628571428571429;13;22;0.128571428571429;0.371428571428571
Control.SRR15539874;29;32;0.448275862068966;16;13;0.0517241379310345;0.448275862068966
Control.SRR15539874;30;32;0.566666666666667;13;17;0.0666666666666667;0.433333333333333
Control.SRR15539874;29;32;0.517241379310345;14;15;0.0172413793103449;0.482758620689655
Control.SRR15539874;29;32;0.482758620689655;15;14;0.0172413793103448;0.482758620689655
Control.SRR15539874;30;32;0.433333333333333;17;13;0.0666666666666667;0.433333333333333
Control.SRR15539874;36;32;0.5;18;18;0;0.5
Control.SRR15539874;31;32;0.516129032258065;15;16;0.0161290322580645;0.483870967741935
Control.SRR15539874;37;32;0.513513513513513;18;19;0.0135135135135135;0.486486486486487
Control.SRR15539874;35;32;0.628571428571429;13;22;0.128571428571429;0.371428571428571
Control.SRR15539874;34;32;0.5;17;17;0;0.5
Control.SRR15539874;36;32;0.666666666666667;12;24;0.166666666666667;0.333333333333333
Control.SRR15539874;37;32;0.432432432432432;21;16;0.0675675675675675;0.432432432432432
Control.SRR15539874;36;32;0.5;18;18;0;0.5
Control.SRR15539874;31;32;0.516129032258065;15;16;0.0161290322580645;0.483870967741935
Control.SRR15539874;30;32;0.633333333333333;11;19;0.133333333333333;0.366666666666667
Control.SRR15539874;34;32;0.470588235294118;18;16;0.0294117647058824;0.470588235294118
Control.SRR15539874;31;32;0.451612903225806;17;14;0.0483870967741936;0.451612903225806
Control.SRR15539874;35;32;0.485714285714286;18;17;0.0142857142857143;0.485714285714286
Control.SRR15539874;31;32;0.580645161290323;13;18;0.0806451612903226;0.419354838709677
Control.SRR15539874;36;32;0.5;18;18;0;0.5
Control.SRR15539874;30;32;0.566666666666667;13;17;0.0666666666666667;0.433333333333333
Control.SRR15539874;30;32;0.466666666666667;16;14;0.0333333333333333;0.466666666666667
Control.SRR15539874;34;32;0.411764705882353;20;14;0.0882352941176471;0.411764705882353
Control.SRR15539874;30;32;0.4;18;12;0.1;0.4
Control.SRR15539874;31;32;0.419354838709677;18;13;0.0806451612903226;0.419354838709677
Control.SRR15539874;30;32;0.566666666666667;13;17;0.0666666666666667;0.433333333333333
Control.SRR15539874;33;32;0.606060606060606;13;20;0.106060606060606;0.393939393939394
Control.SRR15539874;30;32;0.566666666666667;13;17;0.0666666666666667;0.433333333333333
Control.SRR15539874;37;32;0.567567567567568;16;21;0.0675675675675675;0.432432432432432
Control.SRR15539874;33;32;0.424242424242424;19;14;0.0757575757575757;0.424242424242424
Control.SRR15539874;32;32;0.34375;21;11;0.15625;0.34375
Control.SRR15539874;32;32;0.5;16;16;0;0.5
Control.SRR15539874;36;32;0.527777777777778;17;19;0.0277777777777778;0.472222222222222
Control.SRR15539874;37;32;0.432432432432432;21;16;0.0675675675675675;0.432432432432432
Control.SRR15539874;29;32;0.482758620689655;15;14;0.0172413793103448;0.482758620689655
Control.SRR15539874;30;32;0.5;15;15;0;0.5
Control.SRR15539874;33;32;0.393939393939394;20;13;0.106060606060606;0.393939393939394
Control.SRR15539874;33;32;0.575757575757576;14;19;0.0757575757575758;0.424242424242424
Control.SRR15539874;34;32;0.470588235294118;18;16;0.0294117647058824;0.470588235294118
Control.SRR15539874;32;32;0.59375;13;19;0.09375;0.40625
Control.SRR15539874;30;32;0.5;15;15;0;0.5
Control.SRR15539874;29;32;0.482758620689655;15;14;0.0172413793103448;0.482758620689655
Control.SRR15539874;32;32;0.71875;9;23;0.21875;0.28125
Control.SRR15539874;33;32;0.515151515151515;16;17;0.0151515151515151;0.484848484848485
Control.SRR15539874;30;32;0.533333333333333;14;16;0.0333333333333333;0.466666666666667
Control.SRR15539874;33;32;0.484848484848485;17;16;0.0151515151515151;0.484848484848485
Control.SRR15539874;29;32;0.517241379310345;14;15;0.0172413793103449;0.482758620689655
Control.SRR15539874;30;32;0.566666666666667;13;17;0.0666666666666667;0.433333333333333
Control.SRR15539874;31;32;0.354838709677419;20;11;0.145161290322581;0.354838709677419
Control.SRR15539874;36;32;0.555555555555556;16;20;0.0555555555555556;0.444444444444444
Control.SRR15539874;34;32;0.588235294117647;14;20;0.0882352941176471;0.411764705882353
Control.SRR15539874;35;32;0.514285714285714;17;18;0.0142857142857142;0.485714285714286
Control.SRR15539874;35;32;0.542857142857143;16;19;0.0428571428571428;0.457142857142857
Control.SRR15539874;33;32;0.606060606060606;13;20;0.106060606060606;0.393939393939394
Control.SRR15539874;32;32;0.53125;15;17;0.03125;0.46875
Control.SRR15539874;30;32;0.533333333333333;14;16;0.0333333333333333;0.466666666666667
Control.SRR15539874;34;32;0.588235294117647;14;20;0.0882352941176471;0.411764705882353
Control.SRR15539874;36;32;0.416666666666667;21;15;0.0833333333333333;0.416666666666667
Control.SRR15539874;37;32;0.486486486486487;19;18;0.0135135135135135;0.486486486486487
Control.SRR15539874;36;32;0.444444444444444;20;16;0.0555555555555556;0.444444444444444
Control.SRR15539874;35;32;0.657142857142857;12;23;0.157142857142857;0.342857142857143
Control.SRR15539874;34;32;0.5;17;17;0;0.5
Control.SRR15539874;33;32;0.545454545454545;15;18;0.0454545454545454;0.454545454545455
Control.SRR15539874;36;32;0.444444444444444;20;16;0.0555555555555556;0.444444444444444
Control.SRR15539874;34;32;0.529411764705882;16;18;0.0294117647058824;0.470588235294118
Control.SRR15539874;31;32;0.580645161290323;13;18;0.0806451612903226;0.419354838709677
Control.SRR15539874;30;32;0.433333333333333;17;13;0.0666666666666667;0.433333333333333
Control.SRR15539874;30;32;0.4;18;12;0.1;0.4
Control.SRR15539874;35;32;0.457142857142857;19;16;0.0428571428571429;0.457142857142857
Control.SRR15539874;34;32;0.5;17;17;0;0.5
Control.SRR15539874;34;32;0.5;17;17;0;0.5
Control.SRR15539874;33;32;0.606060606060606;13;20;0.106060606060606;0.393939393939394
Control.SRR15539874;33;32;0.484848484848485;17;16;0.0151515151515151;0.484848484848485
Control.SRR15539874;34;32;0.470588235294118;18;16;0.0294117647058824;0.470588235294118
Control.SRR15539874;34;32;0.352941176470588;22;12;0.147058823529412;0.352941176470588
Control.SRR15539874;35;32;0.514285714285714;17;18;0.0142857142857142;0.485714285714286
Control.SRR15539874;31;32;0.32258064516129;21;10;0.17741935483871;0.32258064516129
Control.SRR15539874;32;32;0.5625;14;18;0.0625;0.4375
Control.SRR15539874;31;32;0.548387096774194;14;17;0.0483870967741935;0.451612903225806
Control.SRR15539874;37;32;0.459459459459459;20;17;0.0405405405405405;0.459459459459459
Control.SRR15539874;34;32;0.5;17;17;0;0.5
Control.SRR15539874;36;32;0.472222222222222;19;17;0.0277777777777778;0.472222222222222
Control.SRR15539874;32;32;0.34375;21;11;0.15625;0.34375
Control.SRR15539874;32;32;0.375;20;12;0.125;0.375
Control.SRR15539874;29;32;0.517241379310345;14;15;0.0172413793103449;0.482758620689655
Control.SRR15539874;36;32;0.666666666666667;12;24;0.166666666666667;0.333333333333333
Control.SRR15539874;32;32;0.375;20;12;0.125;0.375
Control.SRR15539874;37;32;0.594594594594595;15;22;0.0945945945945946;0.405405405405405
Control.SRR15539874;31;32;0.580645161290323;13;18;0.0806451612903226;0.419354838709677
Control.SRR15539874;35;32;0.371428571428571;22;13;0.128571428571429;0.371428571428571
Control.SRR15539874;30;32;0.433333333333333;17;13;0.0666666666666667;0.433333333333333
Control.SRR15539874;34;32;0.705882352941177;10;24;0.205882352941177;0.294117647058824
Control.SRR15539874;35;32;0.571428571428571;15;20;0.0714285714285714;0.428571428571429
Control.SRR15539874;34;32;0.529411764705882;16;18;0.0294117647058824;0.470588235294118
Control.SRR15539874;31;32;0.419354838709677;18;13;0.0806451612903226;0.419354838709677
Control.SRR15539874;30;32;0.5;15;15;0;0.5
Control.SRR15539874;31;32;0.483870967741935;16;15;0.0161290322580645;0.483870967741935
Control.SRR15539874;36;32;0.527777777777778;17;19;0.0277777777777778;0.472222222222222
Control.SRR15539874;37;32;0.432432432432432;21;16;0.0675675675675675;0.432432432432432
Control.SRR15539874;33;32;0.545454545454545;15;18;0.0454545454545454;0.454545454545455
Control.SRR15539874;31;32;0.612903225806452;12;19;0.112903225806452;0.387096774193548
Control.SRR15539874;35;32;0.514285714285714;17;18;0.0142857142857142;0.485714285714286
Control.SRR15539874;31;32;0.451612903225806;17;14;0.0483870967741936;0.451612903225806
Control.SRR15539874;34;32;0.441176470588235;19;15;0.0588235294117647;0.441176470588235
Control.SRR15539874;29;32;0.448275862068966;16;13;0.0517241379310345;0.448275862068966
Control.SRR15539874;34;32;0.5;17;17;0;0.5
Control.SRR15539874;37;32;0.513513513513513;18;19;0.0135135135135135;0.486486486486487
Control.SRR15539874;37;32;0.621621621621622;14;23;0.121621621621622;0.378378378378378
Control.SRR15539874;34;32;0.411764705882353;20;14;0.0882352941176471;0.411764705882353
Control.SRR15539874;36;32;0.638888888888889;13;23;0.138888888888889;0.361111111111111
Control.SRR15539874;30;32;0.3;21;9;0.2;0.3
Control.SRR15539874;32;32;0.59375;13;19;0.09375;0.40625
Control.SRR15539874;33;32;0.575757575757576;14;19;0.0757575757575758;0.424242424242424
Control.SRR15539874;36;32;0.416666666666667;21;15;0.0833333333333333;0.416666666666667
Control.SRR15539874;35;32;0.571428571428571;15;20;0.0714285714285714;0.428571428571429
Control.SRR15539874;32;32;0.40625;19;13;0.09375;0.40625
Control.SRR15539874;33;32;0.454545454545455;18;15;0.0454545454545455;0.454545454545455
Control.SRR15539874;31;32;0.516129032258065;15;16;0.0161290322580645;0.483870967741935
Control.SRR15539874;33;32;0.454545454545455;18;15;0.0454545454545455;0.454545454545455
Control.SRR15539874;31;32;0.548387096774194;14;17;0.0483870967741935;0.451612903225806
Control.SRR15539874;34;32;0.411764705882353;20;14;0.0882352941176471;0.411764705882353
Control.SRR15539874;32;32;0.59375;13;19;0.09375;0.40625
Control.SRR15539874;30;32;0.466666666666667;16;14;0.0333333333333333;0.466666666666667
Control.SRR15539874;31;32;0.548387096774194;14;17;0.0483870967741935;0.451612903225806
Control.SRR15539874;34;32;0.5;17;17;0;0.5
Control.SRR15539874;31;32;0.516129032258065;15;16;0.0161290322580645;0.483870967741935
Control.SRR15539874;31;32;0.612903225806452;12;19;0.112903225806452;0.387096774193548
Control.SRR15539874;32;32;0.5625;14;18;0.0625;0.4375
Control.SRR15539874;33;32;0.545454545454545;15;18;0.0454545454545454;0.454545454545455
Control.SRR15539874;34;32;0.411764705882353;20;14;0.0882352941176471;0.411764705882353
Control.SRR15539874;34;32;0.5;17;17;0;0.5
Control.SRR15539874;32;32;0.5625;14;18;0.0625;0.4375
Control.SRR15539874;36;32;0.527777777777778;17;19;0.0277777777777778;0.472222222222222
Control.SRR15539874;35;32;0.457142857142857;19;16;0.0428571428571429;0.457142857142857
Control.SRR15539874;34;32;0.441176470588235;19;15;0.0588235294117647;0.441176470588235
Control.SRR15539874;29;32;0.379310344827586;18;11;0.120689655172414;0.379310344827586
Control.SRR15539874;32;32;0.46875;17;15;0.03125;0.46875
Control.SRR15539874;35;32;0.657142857142857;12;23;0.157142857142857;0.342857142857143
Control.SRR15539874;35;32;0.514285714285714;17;18;0.0142857142857142;0.485714285714286
Control.SRR15539874;31;32;0.483870967741935;16;15;0.0161290322580645;0.483870967741935
Control.SRR15539874;32;32;0.40625;19;13;0.09375;0.40625
Control.SRR15539874;35;32;0.542857142857143;16;19;0.0428571428571428;0.457142857142857
Control.SRR15539874;29;32;0.413793103448276;17;12;0.0862068965517241;0.413793103448276
Control.SRR15539874;29;32;0.482758620689655;15;14;0.0172413793103448;0.482758620689655
Control.SRR15539874;36;32;0.388888888888889;22;14;0.111111111111111;0.388888888888889
Control.SRR15539874;32;32;0.53125;15;17;0.03125;0.46875
Control.SRR15539874;32;32;0.625;12;20;0.125;0.375
Control.SRR15539874;29;32;0.551724137931034;13;16;0.0517241379310345;0.448275862068966
Control.SRR15539874;32;32;0.375;20;12;0.125;0.375
Control.SRR15539874;37;32;0.486486486486487;19;18;0.0135135135135135;0.486486486486487
Control.SRR15539874;29;32;0.413793103448276;17;12;0.0862068965517241;0.413793103448276
Control.SRR15539874;30;32;0.466666666666667;16;14;0.0333333333333333;0.466666666666667
Control.SRR15539874;37;32;0.459459459459459;20;17;0.0405405405405405;0.459459459459459
Control.SRR15539874;34;32;0.5;17;17;0;0.5
Control.SRR15539874;32;32;0.59375;13;19;0.09375;0.40625
Control.SRR15539874;29;32;0.586206896551724;12;17;0.0862068965517241;0.413793103448276
Control.SRR15539874;30;32;0.466666666666667;16;14;0.0333333333333333;0.466666666666667
Control.SRR15539874;34;32;0.529411764705882;16;18;0.0294117647058824;0.470588235294118
Control.SRR15539874;37;32;0.486486486486487;19;18;0.0135135135135135;0.486486486486487
Control.SRR15539874;36;32;0.444444444444444;20;16;0.0555555555555556;0.444444444444444
Control.SRR15539874;34;32;0.617647058823529;13;21;0.117647058823529;0.382352941176471
Control.SRR15539874;36;32;0.416666666666667;21;15;0.0833333333333333;0.416666666666667
Control.SRR15539874;29;32;0.448275862068966;16;13;0.0517241379310345;0.448275862068966
Control.SRR15539874;37;32;0.513513513513513;18;19;0.0135135135135135;0.486486486486487
Control.SRR15539874;36;32;0.555555555555556;16;20;0.0555555555555556;0.444444444444444
Control.SRR15539874;35;32;0.457142857142857;19;16;0.0428571428571429;0.457142857142857
Control.SRR15539874;33;32;0.454545454545455;18;15;0.0454545454545455;0.454545454545455
Control.SRR15539874;33;32;0.545454545454545;15;18;0.0454545454545454;0.454545454545455
Control.SRR15539874;33;32;0.424242424242424;19;14;0.0757575757575757;0.424242424242424
Control.SRR15539874;31;32;0.516129032258065;15;16;0.0161290322580645;0.483870967741935
Control.SRR15539874;35;32;0.628571428571429;13;22;0.128571428571429;0.371428571428571
Control.SRR15539874;34;32;0.617647058823529;13;21;0.117647058823529;0.382352941176471
Control.SRR15539874;35;32;0.6;14;21;0.1;0.4
Control.SRR15539874;36;32;0.388888888888889;22;14;0.111111111111111;0.388888888888889
Control.SRR15539874;32;32;0.59375;13;19;0.09375;0.40625
Control.SRR15539874;31;32;0.516129032258065;15;16;0.0161290322580645;0.483870967741935
Control.SRR15539874;30;32;0.233333333333333;23;7;0.266666666666667;0.233333333333333
Control.SRR15539874;29;32;0.448275862068966;16;13;0.0517241379310345;0.448275862068966
Control.SRR15539874;29;32;0.517241379310345;14;15;0.0172413793103449;0.482758620689655
Control.SRR15539874;36;32;0.527777777777778;17;19;0.0277777777777778;0.472222222222222
Control.SRR15539874;36;32;0.305555555555556;25;11;0.194444444444444;0.305555555555556
Control.SRR15539874;30;32;0.6;12;18;0.1;0.4
Control.SRR15539874;29;32;0.586206896551724;12;17;0.0862068965517241;0.413793103448276
Control.SRR15539874;35;32;0.571428571428571;15;20;0.0714285714285714;0.428571428571429
Control.SRR15539874;34;32;0.441176470588235;19;15;0.0588235294117647;0.441176470588235
Control.SRR15539874;34;32;0.441176470588235;19;15;0.0588235294117647;0.441176470588235
Control.SRR15539874;36;32;0.527777777777778;17;19;0.0277777777777778;0.472222222222222
Control.SRR15539874;31;32;0.451612903225806;17;14;0.0483870967741936;0.451612903225806
Control.SRR15539874;30;32;0.433333333333333;17;13;0.0666666666666667;0.433333333333333
Control.SRR15539874;34;32;0.5;17;17;0;0.5
Control.SRR15539874;32;32;0.5;16;16;0;0.5
Control.SRR15539874;35;32;0.485714285714286;18;17;0.0142857142857143;0.485714285714286
Control.SRR15539874;35;32;0.542857142857143;16;19;0.0428571428571428;0.457142857142857
Control.SRR15539874;31;32;0.32258064516129;21;10;0.17741935483871;0.32258064516129
Control.SRR15539874;35;32;0.428571428571429;20;15;0.0714285714285715;0.428571428571429
Control.SRR15539874;33;32;0.515151515151515;16;17;0.0151515151515151;0.484848484848485
Control.SRR15539874;30;32;0.433333333333333;17;13;0.0666666666666667;0.433333333333333
Control.SRR15539874;37;32;0.432432432432432;21;16;0.0675675675675675;0.432432432432432
Control.SRR15539874;34;32;0.529411764705882;16;18;0.0294117647058824;0.470588235294118
Control.SRR15539874;33;32;0.545454545454545;15;18;0.0454545454545454;0.454545454545455
Control.SRR15539874;31;32;0.451612903225806;17;14;0.0483870967741936;0.451612903225806
Control.SRR15539874;31;32;0.419354838709677;18;13;0.0806451612903226;0.419354838709677
Control.SRR15539874;33;32;0.424242424242424;19;14;0.0757575757575757;0.424242424242424
Control.SRR15539874;30;32;0.333333333333333;20;10;0.166666666666667;0.333333333333333
Control.SRR15539874;32;32;0.53125;15;17;0.03125;0.46875
Control.SRR15539874;35;32;0.457142857142857;19;16;0.0428571428571429;0.457142857142857
Control.SRR15539874;32;32;0.25;24;8;0.25;0.25
Control.SRR15539874;30;32;0.466666666666667;16;14;0.0333333333333333;0.466666666666667
Control.SRR15539874;30;32;0.566666666666667;13;17;0.0666666666666667;0.433333333333333
Control.SRR15539874;31;32;0.483870967741935;16;15;0.0161290322580645;0.483870967741935
Control.SRR15539874;34;32;0.558823529411765;15;19;0.0588235294117647;0.441176470588235
Control.SRR15539874;36;32;0.583333333333333;15;21;0.0833333333333334;0.416666666666667
Control.SRR15539874;30;32;0.3;21;9;0.2;0.3
Control.SRR15539874;31;32;0.387096774193548;19;12;0.112903225806452;0.387096774193548
Control.SRR15539874;34;32;0.470588235294118;18;16;0.0294117647058824;0.470588235294118
Control.SRR15539874;32;32;0.5625;14;18;0.0625;0.4375
Control.SRR15539874;37;32;0.540540540540541;17;20;0.0405405405405406;0.459459459459459
Control.SRR15539874;35;32;0.657142857142857;12;23;0.157142857142857;0.342857142857143
Control.SRR15539874;37;32;0.540540540540541;17;20;0.0405405405405406;0.459459459459459
Control.SRR15539874;35;32;0.4;21;14;0.1;0.4
Control.SRR15539874;29;32;0.586206896551724;12;17;0.0862068965517241;0.413793103448276
Control.SRR15539874;31;32;0.580645161290323;13;18;0.0806451612903226;0.419354838709677
Control.SRR15539874;37;32;0.567567567567568;16;21;0.0675675675675675;0.432432432432432
Control.SRR15539874;34;32;0.558823529411765;15;19;0.0588235294117647;0.441176470588235
Control.SRR15539874;31;32;0.483870967741935;16;15;0.0161290322580645;0.483870967741935
Control.SRR15539874;36;32;0.583333333333333;15;21;0.0833333333333334;0.416666666666667
Control.SRR15539874;37;32;0.405405405405405;22;15;0.0945945945945946;0.405405405405405
Control.SRR15539874;31;32;0.580645161290323;13;18;0.0806451612903226;0.419354838709677
Control.SRR15539874;30;32;0.5;15;15;0;0.5
Control.SRR15539874;31;32;0.483870967741935;16;15;0.0161290322580645;0.483870967741935
Control.SRR15539874;31;32;0.451612903225806;17;14;0.0483870967741936;0.451612903225806
Control.SRR15539874;31;32;0.580645161290323;13;18;0.0806451612903226;0.419354838709677
Control.SRR15539874;29;32;0.620689655172414;11;18;0.120689655172414;0.379310344827586
Control.SRR15539874;31;32;0.548387096774194;14;17;0.0483870967741935;0.451612903225806
Control.SRR15539874;36;32;0.5;18;18;0;0.5
Control.SRR15539874;35;32;0.4;21;14;0.1;0.4
Control.SRR15539874;35;32;0.4;21;14;0.1;0.4
Control.SRR15539874;33;32;0.393939393939394;20;13;0.106060606060606;0.393939393939394
Control.SRR15539874;29;32;0.655172413793103;10;19;0.155172413793103;0.344827586206897
Control.SRR15539874;29;32;0.482758620689655;15;14;0.0172413793103448;0.482758620689655
Control.SRR15539874;37;32;0.486486486486487;19;18;0.0135135135135135;0.486486486486487
Control.SRR15539874;31;32;0.548387096774194;14;17;0.0483870967741935;0.451612903225806
Control.SRR15539874;32;32;0.53125;15;17;0.03125;0.46875
Control.SRR15539874;29;32;0.551724137931034;13;16;0.0517241379310345;0.448275862068966
Control.SRR15539874;29;32;0.620689655172414;11;18;0.120689655172414;0.379310344827586
Control.SRR15539874;36;32;0.388888888888889;22;14;0.111111111111111;0.388888888888889
Control.SRR15539874;36;32;0.472222222222222;19;17;0.0277777777777778;0.472222222222222
Control.SRR15539874;35;32;0.6;14;21;0.1;0.4
Control.SRR15539874;33;32;0.515151515151515;16;17;0.0151515151515151;0.484848484848485
Control.SRR15539874;31;32;0.354838709677419;20;11;0.145161290322581;0.354838709677419
Control.SRR15539874;34;32;0.588235294117647;14;20;0.0882352941176471;0.411764705882353
Control.SRR15539874;33;32;0.424242424242424;19;14;0.0757575757575757;0.424242424242424
Control.SRR15539874;37;32;0.621621621621622;14;23;0.121621621621622;0.378378378378378
Control.SRR15539874;32;32;0.5625;14;18;0.0625;0.4375
Control.SRR15539874;37;32;0.405405405405405;22;15;0.0945945945945946;0.405405405405405
Control.SRR15539874;34;32;0.382352941176471;21;13;0.117647058823529;0.382352941176471
Control.SRR15539874;34;32;0.529411764705882;16;18;0.0294117647058824;0.470588235294118
Control.SRR15539874;37;32;0.540540540540541;17;20;0.0405405405405406;0.459459459459459
Control.SRR15539874;35;32;0.4;21;14;0.1;0.4
Control.SRR15539874;30;32;0.433333333333333;17;13;0.0666666666666667;0.433333333333333
Control.SRR15539874;29;32;0.413793103448276;17;12;0.0862068965517241;0.413793103448276
Control.SRR15539874;29;32;0.551724137931034;13;16;0.0517241379310345;0.448275862068966
Control.SRR15539874;36;32;0.472222222222222;19;17;0.0277777777777778;0.472222222222222
Control.SRR15539874;35;32;0.428571428571429;20;15;0.0714285714285715;0.428571428571429
Control.SRR15539874;33;32;0.545454545454545;15;18;0.0454545454545454;0.454545454545455
Control.SRR15539874;33;32;0.424242424242424;19;14;0.0757575757575757;0.424242424242424
Control.SRR15539874;30;32;0.466666666666667;16;14;0.0333333333333333;0.466666666666667
Control.SRR15539874;31;32;0.580645161290323;13;18;0.0806451612903226;0.419354838709677
Control.SRR15539874;31;32;0.516129032258065;15;16;0.0161290322580645;0.483870967741935
Control.SRR15539874;36;32;0.583333333333333;15;21;0.0833333333333334;0.416666666666667
Control.SRR15539874;34;32;0.529411764705882;16;18;0.0294117647058824;0.470588235294118
Control.SRR15539874;29;32;0.413793103448276;17;12;0.0862068965517241;0.413793103448276
Control.SRR15539874;34;32;0.5;17;17;0;0.5
Control.SRR15539874;31;32;0.419354838709677;18;13;0.0806451612903226;0.419354838709677
Control.SRR15539874;33;32;0.575757575757576;14;19;0.0757575757575758;0.424242424242424
Control.SRR15539874;37;32;0.405405405405405;22;15;0.0945945945945946;0.405405405405405
Control.SRR15539874;35;32;0.4;21;14;0.1;0.4
Control.SRR15539874;31;32;0.548387096774194;14;17;0.0483870967741935;0.451612903225806
Control.SRR15539874;32;32;0.5;16;16;0;0.5
Control.SRR15539874;35;32;0.514285714285714;17;18;0.0142857142857142;0.485714285714286
Control.SRR15539874;33;32;0.636363636363636;12;21;0.136363636363636;0.363636363636364
Control.SRR15539874;33;32;0.454545454545455;18;15;0.0454545454545455;0.454545454545455
Control.SRR15539874;33;32;0.515151515151515;16;17;0.0151515151515151;0.484848484848485
Control.SRR15539874;32;32;0.5625;14;18;0.0625;0.4375
Control.SRR15539874;35;32;0.571428571428571;15;20;0.0714285714285714;0.428571428571429
Control.SRR15539874;36;32;0.5;18;18;0;0.5
Control.SRR15539874;30;32;0.5;15;15;0;0.5
Control.SRR15539874;31;32;0.516129032258065;15;16;0.0161290322580645;0.483870967741935
Control.SRR15539874;30;32;0.4;18;12;0.1;0.4
Control.SRR15539874;34;32;0.588235294117647;14;20;0.0882352941176471;0.411764705882353
Control.SRR15539874;33;32;0.515151515151515;16;17;0.0151515151515151;0.484848484848485
Control.SRR15539874;36;32;0.5;18;18;0;0.5
Control.SRR15539874;31;32;0.451612903225806;17;14;0.0483870967741936;0.451612903225806
Control.SRR15539874;34;32;0.441176470588235;19;15;0.0588235294117647;0.441176470588235
Control.SRR15539874;33;32;0.363636363636364;21;12;0.136363636363636;0.363636363636364
Control.SRR15539874;34;32;0.676470588235294;11;23;0.176470588235294;0.323529411764706
Control.SRR15539874;29;32;0.413793103448276;17;12;0.0862068965517241;0.413793103448276
Control.SRR15539874;31;32;0.419354838709677;18;13;0.0806451612903226;0.419354838709677
Control.SRR15539874;34;32;0.5;17;17;0;0.5
Control.SRR15539874;36;32;0.305555555555556;25;11;0.194444444444444;0.305555555555556
Control.SRR15539874;36;32;0.472222222222222;19;17;0.0277777777777778;0.472222222222222
Control.SRR15539874;34;32;0.676470588235294;11;23;0.176470588235294;0.323529411764706
Control.SRR15539874;29;32;0.482758620689655;15;14;0.0172413793103448;0.482758620689655
Control.SRR15539874;35;32;0.571428571428571;15;20;0.0714285714285714;0.428571428571429
Control.SRR15539874;37;32;0.594594594594595;15;22;0.0945945945945946;0.405405405405405
Control.SRR15539874;32;32;0.46875;17;15;0.03125;0.46875
Control.SRR15539874;31;32;0.548387096774194;14;17;0.0483870967741935;0.451612903225806
Control.SRR15539874;34;32;0.617647058823529;13;21;0.117647058823529;0.382352941176471
Control.SRR15539874;35;32;0.285714285714286;25;10;0.214285714285714;0.285714285714286
Control.SRR15539874;33;32;0.424242424242424;19;14;0.0757575757575757;0.424242424242424
Control.SRR15539874;37;32;0.540540540540541;17;20;0.0405405405405406;0.459459459459459
Control.SRR15539874;36;32;0.611111111111111;14;22;0.111111111111111;0.388888888888889
Control.SRR15539874;34;32;0.470588235294118;18;16;0.0294117647058824;0.470588235294118
Control.SRR15539874;36;32;0.305555555555556;25;11;0.194444444444444;0.305555555555556
Control.SRR15539874;34;32;0.5;17;17;0;0.5
Control.SRR15539874;34;32;0.470588235294118;18;16;0.0294117647058824;0.470588235294118
Control.SRR15539874;32;32;0.34375;21;11;0.15625;0.34375
Control.SRR15539874;33;32;0.484848484848485;17;16;0.0151515151515151;0.484848484848485
Control.SRR15539874;36;32;0.472222222222222;19;17;0.0277777777777778;0.472222222222222
Control.SRR15539874;34;32;0.5;17;17;0;0.5
Control.SRR15539874;35;32;0.542857142857143;16;19;0.0428571428571428;0.457142857142857
Control.SRR15539874;33;32;0.393939393939394;20;13;0.106060606060606;0.393939393939394
Control.SRR15539874;34;32;0.558823529411765;15;19;0.0588235294117647;0.441176470588235
Control.SRR15539874;30;32;0.566666666666667;13;17;0.0666666666666667;0.433333333333333
Control.SRR15539874;36;32;0.444444444444444;20;16;0.0555555555555556;0.444444444444444
Control.SRR15539874;32;32;0.6875;10;22;0.1875;0.3125
Control.SRR15539874;34;32;0.470588235294118;18;16;0.0294117647058824;0.470588235294118
Control.SRR15539874;37;32;0.486486486486487;19;18;0.0135135135135135;0.486486486486487
Control.SRR15539874;33;32;0.484848484848485;17;16;0.0151515151515151;0.484848484848485
Control.SRR15539874;32;32;0.4375;18;14;0.0625;0.4375
Control.SRR15539874;29;32;0.620689655172414;11;18;0.120689655172414;0.379310344827586
Control.SRR15539874;35;32;0.314285714285714;24;11;0.185714285714286;0.314285714285714
Control.SRR15539874;36;32;0.472222222222222;19;17;0.0277777777777778;0.472222222222222
Control.SRR15539874;29;32;0.379310344827586;18;11;0.120689655172414;0.379310344827586
Control.SRR15539874;35;32;0.628571428571429;13;22;0.128571428571429;0.371428571428571
Control.SRR15539874;30;32;0.5;15;15;0;0.5
Control.SRR15539874;31;32;0.451612903225806;17;14;0.0483870967741936;0.451612903225806
Control.SRR15539874;36;32;0.388888888888889;22;14;0.111111111111111;0.388888888888889
Control.SRR15539874;29;32;0.379310344827586;18;11;0.120689655172414;0.379310344827586
Control.SRR15539874;31;32;0.580645161290323;13;18;0.0806451612903226;0.419354838709677
Control.SRR15539874;36;32;0.472222222222222;19;17;0.0277777777777778;0.472222222222222
Control.SRR15539874;35;32;0.542857142857143;16;19;0.0428571428571428;0.457142857142857
Control.SRR15539874;36;32;0.472222222222222;19;17;0.0277777777777778;0.472222222222222
Control.SRR15539874;30;32;0.4;18;12;0.1;0.4
Control.SRR15539874;35;32;0.457142857142857;19;16;0.0428571428571429;0.457142857142857
Control.SRR15539874;32;32;0.40625;19;13;0.09375;0.40625
Control.SRR15539874;32;32;0.4375;18;14;0.0625;0.4375
Control.SRR15539874;35;32;0.428571428571429;20;15;0.0714285714285715;0.428571428571429
Control.SRR15539874;33;32;0.575757575757576;14;19;0.0757575757575758;0.424242424242424
Control.SRR15539874;33;32;0.666666666666667;11;22;0.166666666666667;0.333333333333333
Control.SRR15539874;37;32;0.621621621621622;14;23;0.121621621621622;0.378378378378378
Control.SRR15539874;36;32;0.555555555555556;16;20;0.0555555555555556;0.444444444444444
Control.SRR15539874;34;32;0.5;17;17;0;0.5
Control.SRR15539874;36;32;0.638888888888889;13;23;0.138888888888889;0.361111111111111
Control.SRR15539874;32;32;0.46875;17;15;0.03125;0.46875
Control.SRR15539874;37;32;0.486486486486487;19;18;0.0135135135135135;0.486486486486487
Control.SRR15539874;37;32;0.594594594594595;15;22;0.0945945945945946;0.405405405405405
Control.SRR15539874;30;32;0.566666666666667;13;17;0.0666666666666667;0.433333333333333
Control.SRR15539874;30;32;0.533333333333333;14;16;0.0333333333333333;0.466666666666667
Control.SRR15539874;32;32;0.53125;15;17;0.03125;0.46875
Control.SRR15539874;31;32;0.451612903225806;17;14;0.0483870967741936;0.451612903225806
Control.SRR15539874;30;32;0.5;15;15;0;0.5
Control.SRR15539874;32;32;0.4375;18;14;0.0625;0.4375
Control.SRR15539874;32;32;0.53125;15;17;0.03125;0.46875
Control.SRR15539874;35;32;0.4;21;14;0.1;0.4
Control.SRR15539874;31;32;0.483870967741935;16;15;0.0161290322580645;0.483870967741935
Control.SRR15539874;33;32;0.454545454545455;18;15;0.0454545454545455;0.454545454545455
Control.SRR15539874;34;32;0.411764705882353;20;14;0.0882352941176471;0.411764705882353
Control.SRR15539874;35;32;0.342857142857143;23;12;0.157142857142857;0.342857142857143
Control.SRR15539874;31;32;0.419354838709677;18;13;0.0806451612903226;0.419354838709677
Control.SRR15539874;36;32;0.583333333333333;15;21;0.0833333333333334;0.416666666666667
Control.SRR15539874;37;32;0.648648648648649;13;24;0.148648648648649;0.351351351351351
Control.SRR15539874;36;32;0.638888888888889;13;23;0.138888888888889;0.361111111111111
Control.SRR15539874;36;32;0.638888888888889;13;23;0.138888888888889;0.361111111111111
Control.SRR15539874;34;32;0.5;17;17;0;0.5
Control.SRR15539874;35;32;0.428571428571429;20;15;0.0714285714285715;0.428571428571429
Control.SRR15539874;31;32;0.612903225806452;12;19;0.112903225806452;0.387096774193548
Control.SRR15539874;37;32;0.486486486486487;19;18;0.0135135135135135;0.486486486486487
Control.SRR15539874;37;32;0.486486486486487;19;18;0.0135135135135135;0.486486486486487
Control.SRR15539874;35;32;0.514285714285714;17;18;0.0142857142857142;0.485714285714286
Control.SRR15539874;35;32;0.457142857142857;19;16;0.0428571428571429;0.457142857142857
Control.SRR15539874;29;32;0.517241379310345;14;15;0.0172413793103449;0.482758620689655
Control.SRR15539874;30;32;0.533333333333333;14;16;0.0333333333333333;0.466666666666667
Control.SRR15539874;29;32;0.448275862068966;16;13;0.0517241379310345;0.448275862068966
Control.SRR15539874;36;32;0.388888888888889;22;14;0.111111111111111;0.388888888888889
Control.SRR15539874;34;32;0.470588235294118;18;16;0.0294117647058824;0.470588235294118
Control.SRR15539874;37;32;0.459459459459459;20;17;0.0405405405405405;0.459459459459459
Control.SRR15539874;36;32;0.527777777777778;17;19;0.0277777777777778;0.472222222222222
Control.SRR15539874;29;32;0.586206896551724;12;17;0.0862068965517241;0.413793103448276
Control.SRR15539874;33;32;0.333333333333333;22;11;0.166666666666667;0.333333333333333
Control.SRR15539874;37;32;0.486486486486487;19;18;0.0135135135135135;0.486486486486487
Control.SRR15539874;33;32;0.484848484848485;17;16;0.0151515151515151;0.484848484848485
Control.SRR15539874;30;32;0.666666666666667;10;20;0.166666666666667;0.333333333333333
Control.SRR15539874;32;32;0.59375;13;19;0.09375;0.40625
Control.SRR15539874;36;32;0.638888888888889;13;23;0.138888888888889;0.361111111111111
Control.SRR15539874;34;32;0.441176470588235;19;15;0.0588235294117647;0.441176470588235
Control.SRR15539874;31;32;0.580645161290323;13;18;0.0806451612903226;0.419354838709677
Control.SRR15539874;32;32;0.5;16;16;0;0.5
Control.SRR15539874;30;32;0.533333333333333;14;16;0.0333333333333333;0.466666666666667
Control.SRR15539874;36;32;0.416666666666667;21;15;0.0833333333333333;0.416666666666667
Control.SRR15539874;30;32;0.433333333333333;17;13;0.0666666666666667;0.433333333333333
Control.SRR15539874;31;32;0.516129032258065;15;16;0.0161290322580645;0.483870967741935
Control.SRR15539874;31;32;0.451612903225806;17;14;0.0483870967741936;0.451612903225806
Control.SRR15539874;32;32;0.46875;17;15;0.03125;0.46875
Control.SRR15539874;34;32;0.558823529411765;15;19;0.0588235294117647;0.441176470588235
Control.SRR15539874;29;32;0.413793103448276;17;12;0.0862068965517241;0.413793103448276
Control.SRR15539874;33;32;0.606060606060606;13;20;0.106060606060606;0.393939393939394
Control.SRR15539874;32;32;0.53125;15;17;0.03125;0.46875
Control.SRR15539874;35;32;0.457142857142857;19;16;0.0428571428571429;0.457142857142857
Control.SRR15539874;35;32;0.571428571428571;15;20;0.0714285714285714;0.428571428571429
Control.SRR15539874;33;32;0.666666666666667;11;22;0.166666666666667;0.333333333333333
Control.SRR15539874;35;32;0.685714285714286;11;24;0.185714285714286;0.314285714285714
Control.SRR15539874;31;32;0.580645161290323;13;18;0.0806451612903226;0.419354838709677
Control.SRR15539874;37;32;0.567567567567568;16;21;0.0675675675675675;0.432432432432432
Control.SRR15539874;31;32;0.451612903225806;17;14;0.0483870967741936;0.451612903225806
Control.SRR15539874;36;32;0.472222222222222;19;17;0.0277777777777778;0.472222222222222
Control.SRR15539874;32;32;0.625;12;20;0.125;0.375
Control.SRR15539874;35;32;0.6;14;21;0.1;0.4
Control.SRR15539874;37;32;0.432432432432432;21;16;0.0675675675675675;0.432432432432432
Control.SRR15539874;34;32;0.558823529411765;15;19;0.0588235294117647;0.441176470588235
Control.SRR15539874;37;32;0.459459459459459;20;17;0.0405405405405405;0.459459459459459
Control.SRR15539874;33;32;0.575757575757576;14;19;0.0757575757575758;0.424242424242424
Control.SRR15539874;34;32;0.264705882352941;25;9;0.235294117647059;0.264705882352941
Control.SRR15539874;32;32;0.5625;14;18;0.0625;0.4375
Control.SRR15539874;31;32;0.354838709677419;20;11;0.145161290322581;0.354838709677419
Control.SRR15539874;33;32;0.393939393939394;20;13;0.106060606060606;0.393939393939394
Control.SRR15539874;33;32;0.696969696969697;10;23;0.196969696969697;0.303030303030303
Control.SRR15539874;35;32;0.4;21;14;0.1;0.4
Control.SRR15539874;34;32;0.529411764705882;16;18;0.0294117647058824;0.470588235294118
Control.SRR15539874;33;32;0.393939393939394;20;13;0.106060606060606;0.393939393939394
Control.SRR15539874;29;32;0.379310344827586;18;11;0.120689655172414;0.379310344827586
Control.SRR15539874;36;32;0.361111111111111;23;13;0.138888888888889;0.361111111111111
Control.SRR15539874;30;32;0.433333333333333;17;13;0.0666666666666667;0.433333333333333
Control.SRR15539874;36;32;0.416666666666667;21;15;0.0833333333333333;0.416666666666667
Control.SRR15539874;37;32;0.486486486486487;19;18;0.0135135135135135;0.486486486486487
Control.SRR15539874;36;32;0.388888888888889;22;14;0.111111111111111;0.388888888888889
Control.SRR15539874;37;32;0.405405405405405;22;15;0.0945945945945946;0.405405405405405
Control.SRR15539874;34;32;0.529411764705882;16;18;0.0294117647058824;0.470588235294118
Control.SRR15539874;31;32;0.709677419354839;9;22;0.209677419354839;0.290322580645161
Control.SRR15539874;32;32;0.25;24;8;0.25;0.25
Control.SRR15539874;36;32;0.527777777777778;17;19;0.0277777777777778;0.472222222222222
Control.SRR15539874;32;32;0.53125;15;17;0.03125;0.46875
Control.SRR15539874;37;32;0.486486486486487;19;18;0.0135135135135135;0.486486486486487
Control.SRR15539874;36;32;0.416666666666667;21;15;0.0833333333333333;0.416666666666667
Control.SRR15539874;37;32;0.648648648648649;13;24;0.148648648648649;0.351351351351351
Control.SRR15539874;30;32;0.6;12;18;0.1;0.4
Control.SRR15539874;34;32;0.5;17;17;0;0.5
Control.SRR15539874;33;32;0.515151515151515;16;17;0.0151515151515151;0.484848484848485
Control.SRR15539874;29;32;0.448275862068966;16;13;0.0517241379310345;0.448275862068966
Control.SRR15539874;33;32;0.545454545454545;15;18;0.0454545454545454;0.454545454545455
Control.SRR15539874;31;32;0.516129032258065;15;16;0.0161290322580645;0.483870967741935
Control.SRR15539874;37;32;0.432432432432432;21;16;0.0675675675675675;0.432432432432432
Control.SRR15539874;34;32;0.617647058823529;13;21;0.117647058823529;0.382352941176471
Control.SRR15539874;32;32;0.625;12;20;0.125;0.375
Control.SRR15539874;33;32;0.484848484848485;17;16;0.0151515151515151;0.484848484848485
Control.SRR15539874;32;32;0.375;20;12;0.125;0.375
Control.SRR15539874;32;32;0.5;16;16;0;0.5
Control.SRR15539874;34;32;0.5;17;17;0;0.5
Control.SRR15539874;30;32;0.4;18;12;0.1;0.4
Control.SRR15539874;35;32;0.457142857142857;19;16;0.0428571428571429;0.457142857142857
Control.SRR15539874;29;32;0.379310344827586;18;11;0.120689655172414;0.379310344827586
Control.SRR15539874;31;32;0.548387096774194;14;17;0.0483870967741935;0.451612903225806
Control.SRR15539874;30;32;0.5;15;15;0;0.5
Control.SRR15539874;36;32;0.527777777777778;17;19;0.0277777777777778;0.472222222222222
Control.SRR15539874;35;32;0.457142857142857;19;16;0.0428571428571429;0.457142857142857
Control.SRR15539874;34;32;0.352941176470588;22;12;0.147058823529412;0.352941176470588
Control.SRR15539874;35;32;0.6;14;21;0.1;0.4
Control.SRR15539874;36;32;0.305555555555556;25;11;0.194444444444444;0.305555555555556
Control.SRR15539874;37;32;0.540540540540541;17;20;0.0405405405405406;0.459459459459459
Control.SRR15539874;34;32;0.617647058823529;13;21;0.117647058823529;0.382352941176471
Control.SRR15539874;35;32;0.371428571428571;22;13;0.128571428571429;0.371428571428571
Control.SRR15539874;33;32;0.575757575757576;14;19;0.0757575757575758;0.424242424242424
Control.SRR15539874;32;32;0.5;16;16;0;0.5
Control.SRR15539874;32;32;0.53125;15;17;0.03125;0.46875
Control.SRR15539874;31;32;0.451612903225806;17;14;0.0483870967741936;0.451612903225806
Control.SRR15539874;37;32;0.513513513513513;18;19;0.0135135135135135;0.486486486486487
Control.SRR15539874;34;32;0.617647058823529;13;21;0.117647058823529;0.382352941176471
Control.SRR15539874;35;32;0.485714285714286;18;17;0.0142857142857143;0.485714285714286
Control.SRR15539874;31;32;0.580645161290323;13;18;0.0806451612903226;0.419354838709677
Control.SRR15539874;37;32;0.432432432432432;21;16;0.0675675675675675;0.432432432432432
Control.SRR15539874;35;32;0.314285714285714;24;11;0.185714285714286;0.314285714285714
Control.SRR15539874;33;32;0.484848484848485;17;16;0.0151515151515151;0.484848484848485
Control.SRR15539874;35;32;0.571428571428571;15;20;0.0714285714285714;0.428571428571429
Control.SRR15539874;31;32;0.354838709677419;20;11;0.145161290322581;0.354838709677419
Control.SRR15539874;32;32;0.53125;15;17;0.03125;0.46875
Control.SRR15539874;30;32;0.533333333333333;14;16;0.0333333333333333;0.466666666666667
Control.SRR15539874;35;32;0.314285714285714;24;11;0.185714285714286;0.314285714285714
Control.SRR15539874;35;32;0.4;21;14;0.1;0.4
Control.SRR15539874;33;32;0.484848484848485;17;16;0.0151515151515151;0.484848484848485
Control.SRR15539874;36;32;0.527777777777778;17;19;0.0277777777777778;0.472222222222222
Control.SRR15539874;34;32;0.617647058823529;13;21;0.117647058823529;0.382352941176471
Control.SRR15539874;36;32;0.5;18;18;0;0.5
Control.SRR15539874;34;32;0.588235294117647;14;20;0.0882352941176471;0.411764705882353
Control.SRR15539874;33;32;0.454545454545455;18;15;0.0454545454545455;0.454545454545455
Control.SRR15539874;37;32;0.594594594594595;15;22;0.0945945945945946;0.405405405405405
Control.SRR15539874;37;32;0.432432432432432;21;16;0.0675675675675675;0.432432432432432
Control.SRR15539874;33;32;0.454545454545455;18;15;0.0454545454545455;0.454545454545455
Control.SRR15539874;29;32;0.551724137931034;13;16;0.0517241379310345;0.448275862068966
Control.SRR15539874;35;32;0.428571428571429;20;15;0.0714285714285715;0.428571428571429
Control.SRR15539874;33;32;0.545454545454545;15;18;0.0454545454545454;0.454545454545455
Control.SRR15539874;35;32;0.514285714285714;17;18;0.0142857142857142;0.485714285714286
Control.SRR15539874;35;32;0.4;21;14;0.1;0.4
Control.SRR15539874;32;32;0.5625;14;18;0.0625;0.4375
Control.SRR15539874;34;32;0.441176470588235;19;15;0.0588235294117647;0.441176470588235
Control.SRR15539874;35;32;0.457142857142857;19;16;0.0428571428571429;0.457142857142857
Control.SRR15539874;37;32;0.567567567567568;16;21;0.0675675675675675;0.432432432432432
Control.SRR15539874;31;32;0.483870967741935;16;15;0.0161290322580645;0.483870967741935
Control.SRR15539874;31;32;0.516129032258065;15;16;0.0161290322580645;0.483870967741935
Control.SRR15539874;29;32;0.482758620689655;15;14;0.0172413793103448;0.482758620689655
Control.SRR15539874;36;32;0.555555555555556;16;20;0.0555555555555556;0.444444444444444
Control.SRR15539874;34;32;0.352941176470588;22;12;0.147058823529412;0.352941176470588
Control.SRR15539874;34;32;0.470588235294118;18;16;0.0294117647058824;0.470588235294118
Control.SRR15539874;37;32;0.513513513513513;18;19;0.0135135135135135;0.486486486486487
Control.SRR15539874;35;32;0.457142857142857;19;16;0.0428571428571429;0.457142857142857
Control.SRR15539874;36;32;0.5;18;18;0;0.5
Control.SRR15539874;35;32;0.542857142857143;16;19;0.0428571428571428;0.457142857142857
Control.SRR15539874;31;32;0.354838709677419;20;11;0.145161290322581;0.354838709677419
Control.SRR15539874;33;32;0.333333333333333;22;11;0.166666666666667;0.333333333333333
Control.SRR15539874;34;32;0.382352941176471;21;13;0.117647058823529;0.382352941176471
Control.SRR15539874;33;32;0.636363636363636;12;21;0.136363636363636;0.363636363636364
Control.SRR15539874;33;32;0.454545454545455;18;15;0.0454545454545455;0.454545454545455
Control.SRR15539874;31;32;0.645161290322581;11;20;0.145161290322581;0.354838709677419
Control.SRR15539874;32;32;0.65625;11;21;0.15625;0.34375
Control.SRR15539874;31;32;0.419354838709677;18;13;0.0806451612903226;0.419354838709677
Control.SRR15539874;29;32;0.448275862068966;16;13;0.0517241379310345;0.448275862068966
Control.SRR15539874;37;32;0.432432432432432;21;16;0.0675675675675675;0.432432432432432
Control.SRR15539874;37;32;0.432432432432432;21;16;0.0675675675675675;0.432432432432432
Control.SRR15539874;37;32;0.594594594594595;15;22;0.0945945945945946;0.405405405405405
Control.SRR15539874;34;32;0.617647058823529;13;21;0.117647058823529;0.382352941176471
Control.SRR15539874;36;32;0.5;18;18;0;0.5
Control.SRR15539874;34;32;0.441176470588235;19;15;0.0588235294117647;0.441176470588235
Control.SRR15539874;34;32;0.529411764705882;16;18;0.0294117647058824;0.470588235294118
Control.SRR15539874;31;32;0.516129032258065;15;16;0.0161290322580645;0.483870967741935
Control.SRR15539874;36;32;0.611111111111111;14;22;0.111111111111111;0.388888888888889
Control.SRR15539874;37;32;0.513513513513513;18;19;0.0135135135135135;0.486486486486487
Control.SRR15539874;32;32;0.4375;18;14;0.0625;0.4375
Control.SRR15539874;34;32;0.529411764705882;16;18;0.0294117647058824;0.470588235294118
Control.SRR15539874;37;32;0.405405405405405;22;15;0.0945945945945946;0.405405405405405
Control.SRR15539874;35;32;0.457142857142857;19;16;0.0428571428571429;0.457142857142857
Control.SRR15539874;33;32;0.303030303030303;23;10;0.196969696969697;0.303030303030303
Control.SRR15539874;32;32;0.59375;13;19;0.09375;0.40625
Control.SRR15539874;35;32;0.457142857142857;19;16;0.0428571428571429;0.457142857142857
Control.SRR15539874;36;32;0.472222222222222;19;17;0.0277777777777778;0.472222222222222
Control.SRR15539874;31;32;0.516129032258065;15;16;0.0161290322580645;0.483870967741935
Control.SRR15539874;29;32;0.413793103448276;17;12;0.0862068965517241;0.413793103448276
Control.SRR15539874;31;32;0.483870967741935;16;15;0.0161290322580645;0.483870967741935
Control.SRR15539874;32;32;0.46875;17;15;0.03125;0.46875
Control.SRR15539874;29;32;0.413793103448276;17;12;0.0862068965517241;0.413793103448276
Control.SRR15539874;31;32;0.645161290322581;11;20;0.145161290322581;0.354838709677419
Control.SRR15539874;36;32;0.472222222222222;19;17;0.0277777777777778;0.472222222222222
Control.SRR15539874;33;32;0.606060606060606;13;20;0.106060606060606;0.393939393939394
Control.SRR15539874;30;32;0.5;15;15;0;0.5
Control.SRR15539874;34;32;0.5;17;17;0;0.5
Control.SRR15539874;36;32;0.5;18;18;0;0.5
Control.SRR15539874;34;32;0.470588235294118;18;16;0.0294117647058824;0.470588235294118
Control.SRR15539874;36;32;0.416666666666667;21;15;0.0833333333333333;0.416666666666667
Control.SRR15539874;29;32;0.448275862068966;16;13;0.0517241379310345;0.448275862068966
Control.SRR15539874;29;32;0.413793103448276;17;12;0.0862068965517241;0.413793103448276
Control.SRR15539874;35;32;0.428571428571429;20;15;0.0714285714285715;0.428571428571429
Control.SRR15539874;32;32;0.5625;14;18;0.0625;0.4375
Control.SRR15539874;36;32;0.416666666666667;21;15;0.0833333333333333;0.416666666666667
Control.SRR15539874;33;32;0.393939393939394;20;13;0.106060606060606;0.393939393939394
Control.SRR15539874;35;32;0.542857142857143;16;19;0.0428571428571428;0.457142857142857
Control.SRR15539874;37;32;0.513513513513513;18;19;0.0135135135135135;0.486486486486487
Control.SRR15539874;32;32;0.5625;14;18;0.0625;0.4375
Control.SRR15539874;33;32;0.606060606060606;13;20;0.106060606060606;0.393939393939394
Control.SRR15539874;33;32;0.484848484848485;17;16;0.0151515151515151;0.484848484848485
Control.SRR15539874;35;32;0.485714285714286;18;17;0.0142857142857143;0.485714285714286
Control.SRR15539874;32;32;0.5;16;16;0;0.5
Control.SRR15539874;34;32;0.470588235294118;18;16;0.0294117647058824;0.470588235294118
Control.SRR15539874;36;32;0.472222222222222;19;17;0.0277777777777778;0.472222222222222
Control.SRR15539874;30;32;0.4;18;12;0.1;0.4
Control.SRR15539874;30;32;0.666666666666667;10;20;0.166666666666667;0.333333333333333
Control.SRR15539874;34;32;0.558823529411765;15;19;0.0588235294117647;0.441176470588235
Control.SRR15539874;34;32;0.529411764705882;16;18;0.0294117647058824;0.470588235294118
Control.SRR15539874;36;32;0.444444444444444;20;16;0.0555555555555556;0.444444444444444
Control.SRR15539874;30;32;0.433333333333333;17;13;0.0666666666666667;0.433333333333333
Control.SRR15539874;30;32;0.433333333333333;17;13;0.0666666666666667;0.433333333333333
Control.SRR15539874;33;32;0.333333333333333;22;11;0.166666666666667;0.333333333333333
Control.SRR15539874;31;32;0.483870967741935;16;15;0.0161290322580645;0.483870967741935
Control.SRR15539874;35;32;0.685714285714286;11;24;0.185714285714286;0.314285714285714
Control.SRR15539874;37;32;0.324324324324324;25;12;0.175675675675676;0.324324324324324
Control.SRR15539874;32;32;0.28125;23;9;0.21875;0.28125
Control.SRR15539874;35;32;0.685714285714286;11;24;0.185714285714286;0.314285714285714
Control.SRR15539874;35;32;0.628571428571429;13;22;0.128571428571429;0.371428571428571
Control.SRR15539874;29;32;0.551724137931034;13;16;0.0517241379310345;0.448275862068966
Control.SRR15539874;33;32;0.303030303030303;23;10;0.196969696969697;0.303030303030303
Control.SRR15539874;36;32;0.472222222222222;19;17;0.0277777777777778;0.472222222222222
Control.SRR15539874;36;32;0.472222222222222;19;17;0.0277777777777778;0.472222222222222
Control.SRR15539874;34;32;0.529411764705882;16;18;0.0294117647058824;0.470588235294118
Control.SRR15539874;33;32;0.484848484848485;17;16;0.0151515151515151;0.484848484848485
Control.SRR15539874;37;32;0.540540540540541;17;20;0.0405405405405406;0.459459459459459
Control.SRR15539874;30;32;0.4;18;12;0.1;0.4
Control.SRR15539874;37;32;0.513513513513513;18;19;0.0135135135135135;0.486486486486487
Control.SRR15539874;36;32;0.611111111111111;14;22;0.111111111111111;0.388888888888889
Control.SRR15539874;29;32;0.724137931034483;8;21;0.224137931034483;0.275862068965517
Control.SRR15539874;33;32;0.424242424242424;19;14;0.0757575757575757;0.424242424242424
Control.SRR15539874;34;32;0.441176470588235;19;15;0.0588235294117647;0.441176470588235
Control.SRR15539874;35;32;0.4;21;14;0.1;0.4
Control.SRR15539874;29;32;0.344827586206897;19;10;0.155172413793103;0.344827586206897
Control.SRR15539874;30;32;0.666666666666667;10;20;0.166666666666667;0.333333333333333
Control.SRR15539874;32;32;0.53125;15;17;0.03125;0.46875
Control.SRR15539874;35;32;0.6;14;21;0.1;0.4
Control.SRR15539874;31;32;0.516129032258065;15;16;0.0161290322580645;0.483870967741935
Control.SRR15539874;37;32;0.405405405405405;22;15;0.0945945945945946;0.405405405405405
Control.SRR15539874;34;32;0.470588235294118;18;16;0.0294117647058824;0.470588235294118
Control.SRR15539874;35;32;0.342857142857143;23;12;0.157142857142857;0.342857142857143
Control.SRR15539874;37;32;0.540540540540541;17;20;0.0405405405405406;0.459459459459459
Control.SRR15539874;33;32;0.606060606060606;13;20;0.106060606060606;0.393939393939394
Control.SRR15539874;33;32;0.484848484848485;17;16;0.0151515151515151;0.484848484848485
Control.SRR15539874;35;32;0.514285714285714;17;18;0.0142857142857142;0.485714285714286
Control.SRR15539874;37;32;0.513513513513513;18;19;0.0135135135135135;0.486486486486487
Control.SRR15539874;32;32;0.375;20;12;0.125;0.375
Control.SRR15539874;35;32;0.657142857142857;12;23;0.157142857142857;0.342857142857143
Control.SRR15539874;32;32;0.5;16;16;0;0.5
Control.SRR15539874;35;32;0.371428571428571;22;13;0.128571428571429;0.371428571428571
Control.SRR15539874;35;32;0.628571428571429;13;22;0.128571428571429;0.371428571428571
Control.SRR15539874;34;32;0.470588235294118;18;16;0.0294117647058824;0.470588235294118
Control.SRR15539874;34;32;0.588235294117647;14;20;0.0882352941176471;0.411764705882353
Control.SRR15539874;33;32;0.303030303030303;23;10;0.196969696969697;0.303030303030303
Control.SRR15539874;30;32;0.4;18;12;0.1;0.4
Control.SRR15539874;33;32;0.333333333333333;22;11;0.166666666666667;0.333333333333333
Control.SRR15539874;33;32;0.484848484848485;17;16;0.0151515151515151;0.484848484848485
Control.SRR15539874;30;32;0.4;18;12;0.1;0.4
Control.SRR15539874;36;32;0.277777777777778;26;10;0.222222222222222;0.277777777777778
Control.SRR15539874;36;32;0.444444444444444;20;16;0.0555555555555556;0.444444444444444
Control.SRR15539874;31;32;0.548387096774194;14;17;0.0483870967741935;0.451612903225806
Control.SRR15539874;32;32;0.5;16;16;0;0.5
Control.SRR15539874;30;32;0.7;9;21;0.2;0.3
Control.SRR15539874;37;32;0.459459459459459;20;17;0.0405405405405405;0.459459459459459
Control.SRR15539874;33;32;0.454545454545455;18;15;0.0454545454545455;0.454545454545455
Control.SRR15539874;32;32;0.5;16;16;0;0.5
Control.SRR15539874;32;32;0.34375;21;11;0.15625;0.34375
Control.SRR15539874;35;32;0.542857142857143;16;19;0.0428571428571428;0.457142857142857
Control.SRR15539874;32;32;0.4375;18;14;0.0625;0.4375
Control.SRR15539874;30;32;0.466666666666667;16;14;0.0333333333333333;0.466666666666667
Control.SRR15539874;37;32;0.648648648648649;13;24;0.148648648648649;0.351351351351351
Control.SRR15539874;36;32;0.472222222222222;19;17;0.0277777777777778;0.472222222222222
Control.SRR15539874;36;32;0.638888888888889;13;23;0.138888888888889;0.361111111111111
Control.SRR15539874;37;32;0.378378378378378;23;14;0.121621621621622;0.378378378378378
Control.SRR15539874;29;32;0.551724137931034;13;16;0.0517241379310345;0.448275862068966
Control.SRR15539874;29;32;0.551724137931034;13;16;0.0517241379310345;0.448275862068966
Control.SRR15539874;36;32;0.388888888888889;22;14;0.111111111111111;0.388888888888889
Control.SRR15539874;33;32;0.363636363636364;21;12;0.136363636363636;0.363636363636364
Control.SRR15539874;30;32;0.533333333333333;14;16;0.0333333333333333;0.466666666666667
Control.SRR15539874;34;32;0.411764705882353;20;14;0.0882352941176471;0.411764705882353
Control.SRR15539874;34;32;0.588235294117647;14;20;0.0882352941176471;0.411764705882353
Control.SRR15539874;32;32;0.53125;15;17;0.03125;0.46875
Control.SRR15539874;37;32;0.432432432432432;21;16;0.0675675675675675;0.432432432432432
Control.SRR15539874;36;32;0.444444444444444;20;16;0.0555555555555556;0.444444444444444
Control.SRR15539874;35;32;0.485714285714286;18;17;0.0142857142857143;0.485714285714286
Control.SRR15539874;36;32;0.472222222222222;19;17;0.0277777777777778;0.472222222222222
Control.SRR15539874;31;32;0.580645161290323;13;18;0.0806451612903226;0.419354838709677
Control.SRR15539874;34;32;0.5;17;17;0;0.5
Control.SRR15539874;33;32;0.454545454545455;18;15;0.0454545454545455;0.454545454545455
Control.SRR15539874;36;32;0.611111111111111;14;22;0.111111111111111;0.388888888888889
Control.SRR15539874;37;32;0.432432432432432;21;16;0.0675675675675675;0.432432432432432
Control.SRR15539874;35;32;0.571428571428571;15;20;0.0714285714285714;0.428571428571429
Control.SRR15539874;35;32;0.571428571428571;15;20;0.0714285714285714;0.428571428571429
Control.SRR15539874;37;32;0.540540540540541;17;20;0.0405405405405406;0.459459459459459
Control.SRR15539874;31;32;0.483870967741935;16;15;0.0161290322580645;0.483870967741935
Control.SRR15539874;36;32;0.416666666666667;21;15;0.0833333333333333;0.416666666666667
Control.SRR15539874;32;32;0.46875;17;15;0.03125;0.46875
Control.SRR15539874;36;32;0.583333333333333;15;21;0.0833333333333334;0.416666666666667
Control.SRR15539874;35;32;0.514285714285714;17;18;0.0142857142857142;0.485714285714286
Control.SRR15539874;36;32;0.472222222222222;19;17;0.0277777777777778;0.472222222222222
Control.SRR15539874;36;32;0.5;18;18;0;0.5
Control.SRR15539874;35;32;0.571428571428571;15;20;0.0714285714285714;0.428571428571429
Control.SRR15539874;32;32;0.59375;13;19;0.09375;0.40625
Control.SRR15539874;30;32;0.433333333333333;17;13;0.0666666666666667;0.433333333333333
Control.SRR15539874;30;32;0.533333333333333;14;16;0.0333333333333333;0.466666666666667
Control.SRR15539874;32;32;0.625;12;20;0.125;0.375
Control.SRR15539874;33;32;0.484848484848485;17;16;0.0151515151515151;0.484848484848485
Control.SRR15539874;32;32;0.28125;23;9;0.21875;0.28125
Control.SRR15539874;33;32;0.545454545454545;15;18;0.0454545454545454;0.454545454545455
Control.SRR15539874;34;32;0.529411764705882;16;18;0.0294117647058824;0.470588235294118
Control.SRR15539874;37;32;0.648648648648649;13;24;0.148648648648649;0.351351351351351
Control.SRR15539874;34;32;0.588235294117647;14;20;0.0882352941176471;0.411764705882353
Control.SRR15539874;34;32;0.470588235294118;18;16;0.0294117647058824;0.470588235294118
Control.SRR15539874;34;32;0.5;17;17;0;0.5
Control.SRR15539874;29;32;0.689655172413793;9;20;0.189655172413793;0.310344827586207
Control.SRR15539874;30;32;0.433333333333333;17;13;0.0666666666666667;0.433333333333333
Control.SRR15539874;34;32;0.5;17;17;0;0.5
Control.SRR15539874;29;32;0.551724137931034;13;16;0.0517241379310345;0.448275862068966
Control.SRR15539874;30;32;0.4;18;12;0.1;0.4
Control.SRR15539874;34;32;0.411764705882353;20;14;0.0882352941176471;0.411764705882353
Control.SRR15539874;32;32;0.46875;17;15;0.03125;0.46875
Control.SRR15539874;36;32;0.416666666666667;21;15;0.0833333333333333;0.416666666666667
Control.SRR15539874;33;32;0.545454545454545;15;18;0.0454545454545454;0.454545454545455
Control.SRR15539874;36;32;0.444444444444444;20;16;0.0555555555555556;0.444444444444444
Control.SRR15539874;37;32;0.540540540540541;17;20;0.0405405405405406;0.459459459459459
Control.SRR15539874;36;32;0.5;18;18;0;0.5
Control.SRR15539874;37;32;0.459459459459459;20;17;0.0405405405405405;0.459459459459459
Control.SRR15539874;35;32;0.514285714285714;17;18;0.0142857142857142;0.485714285714286
Control.SRR15539874;30;32;0.6;12;18;0.1;0.4
Control.SRR15539874;32;32;0.59375;13;19;0.09375;0.40625
Control.SRR15539874;32;32;0.3125;22;10;0.1875;0.3125
Control.SRR15539874;37;32;0.513513513513513;18;19;0.0135135135135135;0.486486486486487
Control.SRR15539874;36;32;0.5;18;18;0;0.5
Control.SRR15539874;29;32;0.689655172413793;9;20;0.189655172413793;0.310344827586207
Control.SRR15539874;30;32;0.466666666666667;16;14;0.0333333333333333;0.466666666666667
Control.SRR15539874;34;32;0.558823529411765;15;19;0.0588235294117647;0.441176470588235
Control.SRR15539874;33;32;0.515151515151515;16;17;0.0151515151515151;0.484848484848485
Control.SRR15539874;32;32;0.40625;19;13;0.09375;0.40625
Control.SRR15539874;29;32;0.655172413793103;10;19;0.155172413793103;0.344827586206897
Control.SRR15539874;31;32;0.387096774193548;19;12;0.112903225806452;0.387096774193548
Control.SRR15539874;31;32;0.580645161290323;13;18;0.0806451612903226;0.419354838709677
Control.SRR15539874;34;32;0.5;17;17;0;0.5
Control.SRR15539874;32;32;0.5625;14;18;0.0625;0.4375
Control.SRR15539874;32;32;0.46875;17;15;0.03125;0.46875
Control.SRR15539874;33;32;0.545454545454545;15;18;0.0454545454545454;0.454545454545455
Control.SRR15539874;33;32;0.424242424242424;19;14;0.0757575757575757;0.424242424242424
Control.SRR15539874;33;32;0.484848484848485;17;16;0.0151515151515151;0.484848484848485
Control.SRR15539874;30;32;0.666666666666667;10;20;0.166666666666667;0.333333333333333
Control.SRR15539874;35;32;0.542857142857143;16;19;0.0428571428571428;0.457142857142857
Control.SRR15539874;31;32;0.419354838709677;18;13;0.0806451612903226;0.419354838709677
Control.SRR15539874;33;32;0.424242424242424;19;14;0.0757575757575757;0.424242424242424
Control.SRR15539874;37;32;0.459459459459459;20;17;0.0405405405405405;0.459459459459459
Control.SRR15539874;32;32;0.53125;15;17;0.03125;0.46875
Control.SRR15539874;33;32;0.575757575757576;14;19;0.0757575757575758;0.424242424242424
Control.SRR15539874;32;32;0.65625;11;21;0.15625;0.34375
Control.SRR15539874;29;32;0.482758620689655;15;14;0.0172413793103448;0.482758620689655
Control.SRR15539874;31;32;0.483870967741935;16;15;0.0161290322580645;0.483870967741935
Control.SRR15539874;29;32;0.551724137931034;13;16;0.0517241379310345;0.448275862068966
Control.SRR15539874;32;32;0.5;16;16;0;0.5
Control.SRR15539874;31;32;0.580645161290323;13;18;0.0806451612903226;0.419354838709677
Control.SRR15539874;33;32;0.636363636363636;12;21;0.136363636363636;0.363636363636364
Control.SRR15539874;30;32;0.433333333333333;17;13;0.0666666666666667;0.433333333333333
Control.SRR15539874;33;32;0.545454545454545;15;18;0.0454545454545454;0.454545454545455
Control.SRR15539874;31;32;0.548387096774194;14;17;0.0483870967741935;0.451612903225806
Control.SRR15539874;32;32;0.4375;18;14;0.0625;0.4375
Control.SRR15539874;28;32;0.357142857142857;18;10;0.142857142857143;0.357142857142857
Control.SRR15539874;30;32;0.466666666666667;16;14;0.0333333333333333;0.466666666666667
Control.SRR15539874;31;32;0.483870967741935;16;15;0.0161290322580645;0.483870967741935
Control.SRR15539874;30;32;0.366666666666667;19;11;0.133333333333333;0.366666666666667
Control.SRR15539874;33;32;0.454545454545455;18;15;0.0454545454545455;0.454545454545455
Control.SRR15539874;34;32;0.529411764705882;16;18;0.0294117647058824;0.470588235294118
Control.SRR15539874;32;32;0.625;12;20;0.125;0.375
Control.SRR15539874;29;32;0.344827586206897;19;10;0.155172413793103;0.344827586206897
Control.SRR15539874;34;32;0.382352941176471;21;13;0.117647058823529;0.382352941176471
Control.SRR15539874;33;32;0.636363636363636;12;21;0.136363636363636;0.363636363636364
Control.SRR15539874;29;32;0.586206896551724;12;17;0.0862068965517241;0.413793103448276
Control.SRR15539874;35;32;0.457142857142857;19;16;0.0428571428571429;0.457142857142857
Control.SRR15539874;36;32;0.472222222222222;19;17;0.0277777777777778;0.472222222222222
Control.SRR15539874;28;32;0.392857142857143;17;11;0.107142857142857;0.392857142857143
Control.SRR15539874;30;32;0.6;12;18;0.1;0.4
Control.SRR15539874;30;32;0.666666666666667;10;20;0.166666666666667;0.333333333333333
Control.SRR15539874;28;32;0.678571428571429;9;19;0.178571428571429;0.321428571428571
Control.SRR15539874;31;32;0.548387096774194;14;17;0.0483870967741935;0.451612903225806
Control.SRR15539874;30;32;0.4;18;12;0.1;0.4
Control.SRR15539874;32;32;0.625;12;20;0.125;0.375
Control.SRR15539874;32;32;0.4375;18;14;0.0625;0.4375
Control.SRR15539874;35;32;0.4;21;14;0.1;0.4
Control.SRR15539874;34;32;0.558823529411765;15;19;0.0588235294117647;0.441176470588235
Control.SRR15539874;29;32;0.551724137931034;13;16;0.0517241379310345;0.448275862068966
Control.SRR15539874;29;32;0.275862068965517;21;8;0.224137931034483;0.275862068965517
Control.SRR15539874;31;32;0.774193548387097;7;24;0.274193548387097;0.225806451612903
Control.SRR15539874;34;32;0.647058823529412;12;22;0.147058823529412;0.352941176470588
Control.SRR15539874;32;32;0.53125;15;17;0.03125;0.46875
Control.SRR15539874;36;32;0.5;18;18;0;0.5
Control.SRR15539874;30;32;0.466666666666667;16;14;0.0333333333333333;0.466666666666667
Control.SRR15539874;28;32;0.428571428571429;16;12;0.0714285714285715;0.428571428571429
Control.SRR15539874;32;32;0.40625;19;13;0.09375;0.40625
Control.SRR15539874;34;32;0.470588235294118;18;16;0.0294117647058824;0.470588235294118
Control.SRR15539874;30;32;0.5;15;15;0;0.5
Control.SRR15539874;29;32;0.482758620689655;15;14;0.0172413793103448;0.482758620689655
Control.SRR15539874;31;32;0.483870967741935;16;15;0.0161290322580645;0.483870967741935
Control.SRR15539874;36;32;0.555555555555556;16;20;0.0555555555555556;0.444444444444444
Control.SRR15539874;31;32;0.451612903225806;17;14;0.0483870967741936;0.451612903225806
Control.SRR15539874;30;32;0.4;18;12;0.1;0.4
Control.SRR15539874;34;32;0.470588235294118;18;16;0.0294117647058824;0.470588235294118
Control.SRR15539874;32;32;0.53125;15;17;0.03125;0.46875
Control.SRR15539874;34;32;0.352941176470588;22;12;0.147058823529412;0.352941176470588
Control.SRR15539874;36;32;0.388888888888889;22;14;0.111111111111111;0.388888888888889
Control.SRR15539874;33;32;0.727272727272727;9;24;0.227272727272727;0.272727272727273
Control.SRR15539874;30;32;0.333333333333333;20;10;0.166666666666667;0.333333333333333
Control.SRR15539874;31;32;0.419354838709677;18;13;0.0806451612903226;0.419354838709677
Control.SRR15539874;28;32;0.607142857142857;11;17;0.107142857142857;0.392857142857143
Control.SRR15539874;33;32;0.363636363636364;21;12;0.136363636363636;0.363636363636364
Control.SRR15539874;36;32;0.5;18;18;0;0.5
Control.SRR15539874;34;32;0.441176470588235;19;15;0.0588235294117647;0.441176470588235
Control.SRR15539874;32;32;0.53125;15;17;0.03125;0.46875
Control.SRR15539874;28;32;0.392857142857143;17;11;0.107142857142857;0.392857142857143
Control.SRR15539874;29;32;0.310344827586207;20;9;0.189655172413793;0.310344827586207
Control.SRR15539874;30;32;0.633333333333333;11;19;0.133333333333333;0.366666666666667
Control.SRR15539874;32;32;0.375;20;12;0.125;0.375
Control.SRR15539874;28;32;0.5;14;14;0;0.5
Control.SRR15539874;28;32;0.535714285714286;13;15;0.0357142857142857;0.464285714285714
Control.SRR15539874;34;32;0.323529411764706;23;11;0.176470588235294;0.323529411764706
Control.SRR15539874;34;32;0.558823529411765;15;19;0.0588235294117647;0.441176470588235
Control.SRR15539874;35;32;0.485714285714286;18;17;0.0142857142857143;0.485714285714286
Control.SRR15539874;29;32;0.379310344827586;18;11;0.120689655172414;0.379310344827586
Control.SRR15539874;33;32;0.454545454545455;18;15;0.0454545454545455;0.454545454545455
Control.SRR15539874;30;32;0.433333333333333;17;13;0.0666666666666667;0.433333333333333
Control.SRR15539874;35;32;0.628571428571429;13;22;0.128571428571429;0.371428571428571
Control.SRR15539874;36;32;0.416666666666667;21;15;0.0833333333333333;0.416666666666667
Control.SRR15539874;35;32;0.542857142857143;16;19;0.0428571428571428;0.457142857142857
Control.SRR15539874;34;32;0.5;17;17;0;0.5
Control.SRR15539874;31;32;0.580645161290323;13;18;0.0806451612903226;0.419354838709677
Control.SRR15539874;30;32;0.533333333333333;14;16;0.0333333333333333;0.466666666666667
Control.SRR15539874;36;32;0.361111111111111;23;13;0.138888888888889;0.361111111111111
Control.SRR15539874;32;32;0.59375;13;19;0.09375;0.40625
Control.SRR15539874;32;32;0.65625;11;21;0.15625;0.34375
Control.SRR15539874;33;32;0.575757575757576;14;19;0.0757575757575758;0.424242424242424
Control.SRR15539874;30;32;0.333333333333333;20;10;0.166666666666667;0.333333333333333
Control.SRR15539874;34;32;0.5;17;17;0;0.5
Control.SRR15539874;35;32;0.485714285714286;18;17;0.0142857142857143;0.485714285714286
Control.SRR15539874;29;32;0.517241379310345;14;15;0.0172413793103449;0.482758620689655
Control.SRR15539874;34;32;0.323529411764706;23;11;0.176470588235294;0.323529411764706
Control.SRR15539874;33;32;0.545454545454545;15;18;0.0454545454545454;0.454545454545455
Control.SRR15539874;33;32;0.545454545454545;15;18;0.0454545454545454;0.454545454545455
Control.SRR15539874;36;32;0.333333333333333;24;12;0.166666666666667;0.333333333333333
Control.SRR15539874;36;32;0.444444444444444;20;16;0.0555555555555556;0.444444444444444
Control.SRR15539874;28;32;0.535714285714286;13;15;0.0357142857142857;0.464285714285714
Control.SRR15539874;30;32;0.5;15;15;0;0.5
Control.SRR15539874;30;32;0.5;15;15;0;0.5
Control.SRR15539874;29;32;0.413793103448276;17;12;0.0862068965517241;0.413793103448276
Control.SRR15539874;36;32;0.555555555555556;16;20;0.0555555555555556;0.444444444444444
Control.SRR15539874;28;32;0.5;14;14;0;0.5
Control.SRR15539874;34;32;0.705882352941177;10;24;0.205882352941177;0.294117647058824
Control.SRR15539874;33;32;0.515151515151515;16;17;0.0151515151515151;0.484848484848485
Control.SRR15539874;33;32;0.575757575757576;14;19;0.0757575757575758;0.424242424242424
Control.SRR15539874;28;32;0.571428571428571;12;16;0.0714285714285714;0.428571428571429
Control.SRR15539874;29;32;0.517241379310345;14;15;0.0172413793103449;0.482758620689655
Control.SRR15539874;29;32;0.551724137931034;13;16;0.0517241379310345;0.448275862068966
Control.SRR15539874;35;32;0.457142857142857;19;16;0.0428571428571429;0.457142857142857
Control.SRR15539874;35;32;0.371428571428571;22;13;0.128571428571429;0.371428571428571
Control.SRR15539874;33;32;0.424242424242424;19;14;0.0757575757575757;0.424242424242424
Control.SRR15539874;29;32;0.551724137931034;13;16;0.0517241379310345;0.448275862068966
Control.SRR15539874;34;32;0.470588235294118;18;16;0.0294117647058824;0.470588235294118
Control.SRR15539874;31;32;0.516129032258065;15;16;0.0161290322580645;0.483870967741935
Control.SRR15539874;36;32;0.666666666666667;12;24;0.166666666666667;0.333333333333333
Control.SRR15539874;35;32;0.542857142857143;16;19;0.0428571428571428;0.457142857142857
Control.SRR15539874;28;32;0.535714285714286;13;15;0.0357142857142857;0.464285714285714
Control.SRR15539874;32;32;0.5625;14;18;0.0625;0.4375
Control.SRR15539874;31;32;0.612903225806452;12;19;0.112903225806452;0.387096774193548
Control.SRR15539874;35;32;0.571428571428571;15;20;0.0714285714285714;0.428571428571429
Control.SRR15539874;34;32;0.558823529411765;15;19;0.0588235294117647;0.441176470588235
Control.SRR15539874;34;32;0.558823529411765;15;19;0.0588235294117647;0.441176470588235
Control.SRR15539874;36;32;0.555555555555556;16;20;0.0555555555555556;0.444444444444444
Control.SRR15539874;29;32;0.758620689655172;7;22;0.258620689655172;0.241379310344828
Control.SRR15539874;29;32;0.413793103448276;17;12;0.0862068965517241;0.413793103448276
Control.SRR15539874;30;32;0.466666666666667;16;14;0.0333333333333333;0.466666666666667
Control.SRR15539874;34;32;0.529411764705882;16;18;0.0294117647058824;0.470588235294118
Control.SRR15539874;33;32;0.575757575757576;14;19;0.0757575757575758;0.424242424242424
Control.SRR15539874;35;32;0.457142857142857;19;16;0.0428571428571429;0.457142857142857
Control.SRR15539874;33;32;0.575757575757576;14;19;0.0757575757575758;0.424242424242424
Control.SRR15539874;33;32;0.606060606060606;13;20;0.106060606060606;0.393939393939394
Control.SRR15539874;35;32;0.371428571428571;22;13;0.128571428571429;0.371428571428571
Control.SRR15539874;36;32;0.583333333333333;15;21;0.0833333333333334;0.416666666666667
Control.SRR15539874;35;32;0.485714285714286;18;17;0.0142857142857143;0.485714285714286
Control.SRR15539874;28;32;0.464285714285714;15;13;0.0357142857142857;0.464285714285714
Control.SRR15539874;28;32;0.571428571428571;12;16;0.0714285714285714;0.428571428571429
Control.SRR15539874;29;32;0.620689655172414;11;18;0.120689655172414;0.379310344827586
Control.SRR15539874;35;32;0.4;21;14;0.1;0.4
Control.SRR15539874;34;32;0.588235294117647;14;20;0.0882352941176471;0.411764705882353
Control.SRR15539874;35;32;0.685714285714286;11;24;0.185714285714286;0.314285714285714
Control.SRR15539874;29;32;0.413793103448276;17;12;0.0862068965517241;0.413793103448276
Control.SRR15539874;36;32;0.388888888888889;22;14;0.111111111111111;0.388888888888889
Control.SRR15539874;28;32;0.357142857142857;18;10;0.142857142857143;0.357142857142857
Control.SRR15539874;30;32;0.466666666666667;16;14;0.0333333333333333;0.466666666666667
Control.SRR15539874;32;32;0.53125;15;17;0.03125;0.46875
Control.SRR15539874;32;32;0.5;16;16;0;0.5
Control.SRR15539874;30;32;0.466666666666667;16;14;0.0333333333333333;0.466666666666667
Control.SRR15539874;30;32;0.533333333333333;14;16;0.0333333333333333;0.466666666666667
Control.SRR15539874;32;32;0.59375;13;19;0.09375;0.40625
Control.SRR15539874;30;32;0.433333333333333;17;13;0.0666666666666667;0.433333333333333
Control.SRR15539874;30;32;0.4;18;12;0.1;0.4
Control.SRR15539874;33;32;0.545454545454545;15;18;0.0454545454545454;0.454545454545455
Control.SRR15539874;31;32;0.548387096774194;14;17;0.0483870967741935;0.451612903225806
Control.SRR15539874;32;32;0.375;20;12;0.125;0.375
Control.SRR15539874;34;32;0.352941176470588;22;12;0.147058823529412;0.352941176470588
Control.SRR15539874;30;32;0.566666666666667;13;17;0.0666666666666667;0.433333333333333
Control.SRR15539874;28;32;0.571428571428571;12;16;0.0714285714285714;0.428571428571429
Control.SRR15539874;34;32;0.441176470588235;19;15;0.0588235294117647;0.441176470588235
Control.SRR15539874;36;32;0.527777777777778;17;19;0.0277777777777778;0.472222222222222
Control.SRR15539874;32;32;0.375;20;12;0.125;0.375
Control.SRR15539874;33;32;0.393939393939394;20;13;0.106060606060606;0.393939393939394
Control.SRR15539874;28;32;0.607142857142857;11;17;0.107142857142857;0.392857142857143
Control.SRR15539874;31;32;0.612903225806452;12;19;0.112903225806452;0.387096774193548
Control.SRR15539874;31;32;0.387096774193548;19;12;0.112903225806452;0.387096774193548
Control.SRR15539874;32;32;0.375;20;12;0.125;0.375
Control.SRR15539874;32;32;0.4375;18;14;0.0625;0.4375
Control.SRR15539874;28;32;0.535714285714286;13;15;0.0357142857142857;0.464285714285714
Control.SRR15539874;31;32;0.483870967741935;16;15;0.0161290322580645;0.483870967741935
Control.SRR15539874;30;32;0.566666666666667;13;17;0.0666666666666667;0.433333333333333
Control.SRR15539874;28;32;0.428571428571429;16;12;0.0714285714285715;0.428571428571429
Control.SRR15539874;29;32;0.551724137931034;13;16;0.0517241379310345;0.448275862068966
Control.SRR15539874;29;32;0.448275862068966;16;13;0.0517241379310345;0.448275862068966
Control.SRR15539874;30;32;0.6;12;18;0.1;0.4
Control.SRR15539874;34;32;0.470588235294118;18;16;0.0294117647058824;0.470588235294118
Control.SRR15539874;32;32;0.46875;17;15;0.03125;0.46875
Control.SRR15539874;30;32;0.466666666666667;16;14;0.0333333333333333;0.466666666666667
Control.SRR15539874;33;32;0.636363636363636;12;21;0.136363636363636;0.363636363636364
Control.SRR15539874;36;32;0.388888888888889;22;14;0.111111111111111;0.388888888888889
Control.SRR15539874;32;32;0.375;20;12;0.125;0.375
Control.SRR15539874;30;32;0.466666666666667;16;14;0.0333333333333333;0.466666666666667
Control.SRR15539874;29;32;0.448275862068966;16;13;0.0517241379310345;0.448275862068966
Control.SRR15539874;30;32;0.533333333333333;14;16;0.0333333333333333;0.466666666666667
Control.SRR15539874;34;32;0.352941176470588;22;12;0.147058823529412;0.352941176470588
Control.SRR15539874;29;32;0.241379310344828;22;7;0.258620689655172;0.241379310344828
Control.SRR15539874;29;32;0.517241379310345;14;15;0.0172413793103449;0.482758620689655
Control.SRR15539874;31;32;0.483870967741935;16;15;0.0161290322580645;0.483870967741935
Control.SRR15539874;29;32;0.482758620689655;15;14;0.0172413793103448;0.482758620689655
Control.SRR15539874;28;32;0.571428571428571;12;16;0.0714285714285714;0.428571428571429
Control.SRR15539874;36;32;0.583333333333333;15;21;0.0833333333333334;0.416666666666667
Control.SRR15539874;31;32;0.516129032258065;15;16;0.0161290322580645;0.483870967741935
Control.SRR15539874;35;32;0.571428571428571;15;20;0.0714285714285714;0.428571428571429
Control.SRR15539874;29;32;0.482758620689655;15;14;0.0172413793103448;0.482758620689655
Control.SRR15539874;35;32;0.457142857142857;19;16;0.0428571428571429;0.457142857142857
Control.SRR15539874;36;32;0.583333333333333;15;21;0.0833333333333334;0.416666666666667
Control.SRR15539874;36;32;0.5;18;18;0;0.5
Control.SRR15539874;31;32;0.354838709677419;20;11;0.145161290322581;0.354838709677419
Control.SRR15539874;29;32;0.310344827586207;20;9;0.189655172413793;0.310344827586207
Control.SRR15539874;31;32;0.419354838709677;18;13;0.0806451612903226;0.419354838709677
Control.SRR15539874;33;32;0.454545454545455;18;15;0.0454545454545455;0.454545454545455
Control.SRR15539874;34;32;0.588235294117647;14;20;0.0882352941176471;0.411764705882353
Control.SRR15539874;34;32;0.558823529411765;15;19;0.0588235294117647;0.441176470588235
Control.SRR15539874;28;32;0.5;14;14;0;0.5
Control.SRR15539874;34;32;0.647058823529412;12;22;0.147058823529412;0.352941176470588
Control.SRR15539874;35;32;0.514285714285714;17;18;0.0142857142857142;0.485714285714286
Control.SRR15539874;31;32;0.483870967741935;16;15;0.0161290322580645;0.483870967741935
Control.SRR15539874;33;32;0.484848484848485;17;16;0.0151515151515151;0.484848484848485
Control.SRR15539874;32;32;0.625;12;20;0.125;0.375
Control.SRR15539874;36;32;0.472222222222222;19;17;0.0277777777777778;0.472222222222222
Control.SRR15539874;33;32;0.484848484848485;17;16;0.0151515151515151;0.484848484848485
Control.SRR15539874;33;32;0.515151515151515;16;17;0.0151515151515151;0.484848484848485
Control.SRR15539874;28;32;0.25;21;7;0.25;0.25
Control.SRR15539874;30;32;0.366666666666667;19;11;0.133333333333333;0.366666666666667
Control.SRR15539874;32;32;0.375;20;12;0.125;0.375
Control.SRR15539874;32;32;0.4375;18;14;0.0625;0.4375
Control.SRR15539874;29;32;0.551724137931034;13;16;0.0517241379310345;0.448275862068966
Control.SRR15539874;30;32;0.433333333333333;17;13;0.0666666666666667;0.433333333333333
Control.SRR15539874;34;32;0.470588235294118;18;16;0.0294117647058824;0.470588235294118
Control.SRR15539874;31;32;0.451612903225806;17;14;0.0483870967741936;0.451612903225806
Control.SRR15539874;32;32;0.65625;11;21;0.15625;0.34375
Control.SRR15539874;35;32;0.457142857142857;19;16;0.0428571428571429;0.457142857142857
Control.SRR15539874;34;32;0.411764705882353;20;14;0.0882352941176471;0.411764705882353
Control.SRR15539874;29;32;0.482758620689655;15;14;0.0172413793103448;0.482758620689655
Control.SRR15539874;36;32;0.472222222222222;19;17;0.0277777777777778;0.472222222222222
Control.SRR15539874;33;32;0.515151515151515;16;17;0.0151515151515151;0.484848484848485
Control.SRR15539874;30;32;0.4;18;12;0.1;0.4
Control.SRR15539874;36;32;0.5;18;18;0;0.5
Control.SRR15539874;36;32;0.527777777777778;17;19;0.0277777777777778;0.472222222222222
Control.SRR15539874;36;32;0.583333333333333;15;21;0.0833333333333334;0.416666666666667
Control.SRR15539874;30;32;0.4;18;12;0.1;0.4
Control.SRR15539874;32;32;0.5625;14;18;0.0625;0.4375
Control.SRR15539874;33;32;0.393939393939394;20;13;0.106060606060606;0.393939393939394
Control.SRR15539874;35;32;0.685714285714286;11;24;0.185714285714286;0.314285714285714
Control.SRR15539874;30;32;0.5;15;15;0;0.5
Control.SRR15539874;31;32;0.483870967741935;16;15;0.0161290322580645;0.483870967741935
Control.SRR15539874;28;32;0.571428571428571;12;16;0.0714285714285714;0.428571428571429
Control.SRR15539874;31;32;0.354838709677419;20;11;0.145161290322581;0.354838709677419
Control.SRR15539874;35;32;0.485714285714286;18;17;0.0142857142857143;0.485714285714286
Control.SRR15539874;31;32;0.419354838709677;18;13;0.0806451612903226;0.419354838709677
Control.SRR15539874;32;32;0.40625;19;13;0.09375;0.40625
Control.SRR15539874;36;32;0.361111111111111;23;13;0.138888888888889;0.361111111111111
Control.SRR15539874;36;32;0.5;18;18;0;0.5
Control.SRR15539874;34;32;0.382352941176471;21;13;0.117647058823529;0.382352941176471
Control.SRR15539874;29;32;0.517241379310345;14;15;0.0172413793103449;0.482758620689655
Control.SRR15539874;34;32;0.558823529411765;15;19;0.0588235294117647;0.441176470588235
Control.SRR15539874;31;32;0.548387096774194;14;17;0.0483870967741935;0.451612903225806
Control.SRR15539874;33;32;0.606060606060606;13;20;0.106060606060606;0.393939393939394
Control.SRR15539874;29;32;0.517241379310345;14;15;0.0172413793103449;0.482758620689655
Control.SRR15539874;33;32;0.393939393939394;20;13;0.106060606060606;0.393939393939394
Control.SRR15539874;30;32;0.566666666666667;13;17;0.0666666666666667;0.433333333333333
Control.SRR15539874;31;32;0.354838709677419;20;11;0.145161290322581;0.354838709677419
Control.SRR15539874;35;32;0.571428571428571;15;20;0.0714285714285714;0.428571428571429
Control.SRR15539874;36;32;0.416666666666667;21;15;0.0833333333333333;0.416666666666667
Control.SRR15539874;36;32;0.5;18;18;0;0.5
Control.SRR15539874;34;32;0.529411764705882;16;18;0.0294117647058824;0.470588235294118
Control.SRR15539874;32;32;0.5;16;16;0;0.5
Control.SRR15539874;32;32;0.59375;13;19;0.09375;0.40625
Control.SRR15539874;33;32;0.363636363636364;21;12;0.136363636363636;0.363636363636364
Control.SRR15539874;31;32;0.548387096774194;14;17;0.0483870967741935;0.451612903225806
Control.SRR15539874;35;32;0.371428571428571;22;13;0.128571428571429;0.371428571428571
Control.SRR15539874;33;32;0.363636363636364;21;12;0.136363636363636;0.363636363636364
Control.SRR15539874;28;32;0.392857142857143;17;11;0.107142857142857;0.392857142857143
Control.SRR15539874;28;32;0.5;14;14;0;0.5
Control.SRR15539874;30;32;0.666666666666667;10;20;0.166666666666667;0.333333333333333
Control.SRR15539874;36;32;0.388888888888889;22;14;0.111111111111111;0.388888888888889
Control.SRR15539874;34;32;0.617647058823529;13;21;0.117647058823529;0.382352941176471
Control.SRR15539874;36;32;0.416666666666667;21;15;0.0833333333333333;0.416666666666667
Control.SRR15539874;32;32;0.625;12;20;0.125;0.375
Control.SRR15539874;35;32;0.4;21;14;0.1;0.4
Control.SRR15539874;32;32;0.4375;18;14;0.0625;0.4375
Control.SRR15539874;31;32;0.483870967741935;16;15;0.0161290322580645;0.483870967741935
Control.SRR15539874;28;32;0.535714285714286;13;15;0.0357142857142857;0.464285714285714
Control.SRR15539874;32;32;0.6875;10;22;0.1875;0.3125
Control.SRR15539874;30;32;0.533333333333333;14;16;0.0333333333333333;0.466666666666667
Control.SRR15539874;29;32;0.310344827586207;20;9;0.189655172413793;0.310344827586207
Control.SRR15539874;36;32;0.527777777777778;17;19;0.0277777777777778;0.472222222222222
Control.SRR15539874;29;32;0.517241379310345;14;15;0.0172413793103449;0.482758620689655
Control.SRR15539874;32;32;0.53125;15;17;0.03125;0.46875
Control.SRR15539874;30;32;0.433333333333333;17;13;0.0666666666666667;0.433333333333333
Control.SRR15539874;36;32;0.444444444444444;20;16;0.0555555555555556;0.444444444444444
Control.SRR15539874;29;32;0.620689655172414;11;18;0.120689655172414;0.379310344827586
Control.SRR15539874;34;32;0.558823529411765;15;19;0.0588235294117647;0.441176470588235
Control.SRR15539874;34;32;0.529411764705882;16;18;0.0294117647058824;0.470588235294118
Control.SRR15539874;35;32;0.542857142857143;16;19;0.0428571428571428;0.457142857142857
Control.SRR15539874;29;32;0.482758620689655;15;14;0.0172413793103448;0.482758620689655
Control.SRR15539874;32;32;0.53125;15;17;0.03125;0.46875
Control.SRR15539874;31;32;0.451612903225806;17;14;0.0483870967741936;0.451612903225806
Control.SRR15539874;34;32;0.529411764705882;16;18;0.0294117647058824;0.470588235294118
Control.SRR15539874;30;32;0.5;15;15;0;0.5
Control.SRR15539874;32;32;0.71875;9;23;0.21875;0.28125
Control.SRR15539874;35;32;0.514285714285714;17;18;0.0142857142857142;0.485714285714286
Control.SRR15539874;28;32;0.428571428571429;16;12;0.0714285714285715;0.428571428571429
Control.SRR15539874;29;32;0.586206896551724;12;17;0.0862068965517241;0.413793103448276
Control.SRR15539874;36;32;0.5;18;18;0;0.5
Control.SRR15539874;36;32;0.555555555555556;16;20;0.0555555555555556;0.444444444444444
Control.SRR15539874;29;32;0.448275862068966;16;13;0.0517241379310345;0.448275862068966
Control.SRR15539874;29;32;0.448275862068966;16;13;0.0517241379310345;0.448275862068966
Control.SRR15539874;32;32;0.53125;15;17;0.03125;0.46875
Control.SRR15539874;30;32;0.433333333333333;17;13;0.0666666666666667;0.433333333333333
Control.SRR15539874;33;32;0.515151515151515;16;17;0.0151515151515151;0.484848484848485
Control.SRR15539874;35;32;0.571428571428571;15;20;0.0714285714285714;0.428571428571429
Control.SRR15539874;34;32;0.558823529411765;15;19;0.0588235294117647;0.441176470588235
Control.SRR15539874;34;32;0.382352941176471;21;13;0.117647058823529;0.382352941176471
Control.SRR15539874;32;32;0.4375;18;14;0.0625;0.4375
Control.SRR15539874;31;32;0.483870967741935;16;15;0.0161290322580645;0.483870967741935
Control.SRR15539874;34;32;0.529411764705882;16;18;0.0294117647058824;0.470588235294118
Control.SRR15539874;33;32;0.545454545454545;15;18;0.0454545454545454;0.454545454545455
Control.SRR15539874;33;32;0.454545454545455;18;15;0.0454545454545455;0.454545454545455
Control.SRR15539874;28;32;0.392857142857143;17;11;0.107142857142857;0.392857142857143
Control.SRR15539874;31;32;0.387096774193548;19;12;0.112903225806452;0.387096774193548
Control.SRR15539874;34;32;0.382352941176471;21;13;0.117647058823529;0.382352941176471
Control.SRR15539874;34;32;0.529411764705882;16;18;0.0294117647058824;0.470588235294118
Control.SRR15539874;36;32;0.472222222222222;19;17;0.0277777777777778;0.472222222222222
Control.SRR15539874;36;32;0.527777777777778;17;19;0.0277777777777778;0.472222222222222
Control.SRR15539874;32;32;0.53125;15;17;0.03125;0.46875
Control.SRR15539874;34;32;0.411764705882353;20;14;0.0882352941176471;0.411764705882353
Control.SRR15539874;34;32;0.5;17;17;0;0.5
Control.SRR15539874;34;32;0.5;17;17;0;0.5
Control.SRR15539874;31;32;0.580645161290323;13;18;0.0806451612903226;0.419354838709677
Control.SRR15539874;29;32;0.655172413793103;10;19;0.155172413793103;0.344827586206897
Control.SRR15539874;30;32;0.5;15;15;0;0.5
Control.SRR15539874;32;32;0.4375;18;14;0.0625;0.4375
Control.SRR15539874;33;32;0.515151515151515;16;17;0.0151515151515151;0.484848484848485
Control.SRR15539874;34;32;0.529411764705882;16;18;0.0294117647058824;0.470588235294118
Control.SRR15539874;36;32;0.527777777777778;17;19;0.0277777777777778;0.472222222222222
Control.SRR15539874;36;32;0.611111111111111;14;22;0.111111111111111;0.388888888888889
Control.SRR15539874;32;32;0.53125;15;17;0.03125;0.46875
Control.SRR15539874;33;32;0.606060606060606;13;20;0.106060606060606;0.393939393939394
Control.SRR15539874;30;32;0.666666666666667;10;20;0.166666666666667;0.333333333333333
Control.SRR15539874;29;32;0.413793103448276;17;12;0.0862068965517241;0.413793103448276
Control.SRR15539874;32;32;0.4375;18;14;0.0625;0.4375
Control.SRR15539874;34;32;0.470588235294118;18;16;0.0294117647058824;0.470588235294118
Control.SRR15539874;33;32;0.484848484848485;17;16;0.0151515151515151;0.484848484848485
Control.SRR15539874;34;32;0.529411764705882;16;18;0.0294117647058824;0.470588235294118
Control.SRR15539874;32;32;0.46875;17;15;0.03125;0.46875
Control.SRR15539874;31;32;0.580645161290323;13;18;0.0806451612903226;0.419354838709677
Control.SRR15539874;32;32;0.40625;19;13;0.09375;0.40625
Control.SRR15539874;30;32;0.4;18;12;0.1;0.4
Control.SRR15539874;31;32;0.483870967741935;16;15;0.0161290322580645;0.483870967741935
Control.SRR15539874;32;32;0.5;16;16;0;0.5
Control.SRR15539874;35;32;0.4;21;14;0.1;0.4
Control.SRR15539874;30;32;0.466666666666667;16;14;0.0333333333333333;0.466666666666667
Control.SRR15539874;32;32;0.375;20;12;0.125;0.375
Control.SRR15539874;34;32;0.382352941176471;21;13;0.117647058823529;0.382352941176471
Control.SRR15539874;30;32;0.4;18;12;0.1;0.4
Control.SRR15539874;28;32;0.357142857142857;18;10;0.142857142857143;0.357142857142857
Control.SRR15539874;35;32;0.714285714285714;10;25;0.214285714285714;0.285714285714286
Control.SRR15539874;32;32;0.40625;19;13;0.09375;0.40625
Control.SRR15539874;35;32;0.342857142857143;23;12;0.157142857142857;0.342857142857143
Control.SRR15539874;36;32;0.527777777777778;17;19;0.0277777777777778;0.472222222222222
Control.SRR15539874;32;32;0.375;20;12;0.125;0.375
Control.SRR15539874;33;32;0.484848484848485;17;16;0.0151515151515151;0.484848484848485
Control.SRR15539874;36;32;0.444444444444444;20;16;0.0555555555555556;0.444444444444444
Control.SRR15539874;31;32;0.419354838709677;18;13;0.0806451612903226;0.419354838709677
Control.SRR15539874;33;32;0.606060606060606;13;20;0.106060606060606;0.393939393939394
Control.SRR15539874;35;32;0.457142857142857;19;16;0.0428571428571429;0.457142857142857
Control.SRR15539874;36;32;0.472222222222222;19;17;0.0277777777777778;0.472222222222222
Control.SRR15539874;32;32;0.34375;21;11;0.15625;0.34375
Control.SRR15539874;30;32;0.533333333333333;14;16;0.0333333333333333;0.466666666666667
Control.SRR15539874;36;32;0.472222222222222;19;17;0.0277777777777778;0.472222222222222
Control.SRR15539874;35;32;0.542857142857143;16;19;0.0428571428571428;0.457142857142857
Control.SRR15539874;35;32;0.428571428571429;20;15;0.0714285714285715;0.428571428571429
Control.SRR15539874;33;32;0.303030303030303;23;10;0.196969696969697;0.303030303030303
Control.SRR15539874;32;32;0.3125;22;10;0.1875;0.3125
Control.SRR15539874;35;32;0.514285714285714;17;18;0.0142857142857142;0.485714285714286
Control.SRR15539874;31;32;0.612903225806452;12;19;0.112903225806452;0.387096774193548
Control.SRR15539874;28;32;0.464285714285714;15;13;0.0357142857142857;0.464285714285714
Control.SRR15539874;36;32;0.583333333333333;15;21;0.0833333333333334;0.416666666666667
Control.SRR15539874;35;32;0.4;21;14;0.1;0.4
Control.SRR15539874;29;32;0.413793103448276;17;12;0.0862068965517241;0.413793103448276
Control.SRR15539874;36;32;0.555555555555556;16;20;0.0555555555555556;0.444444444444444
Control.SRR15539874;32;32;0.59375;13;19;0.09375;0.40625
Control.SRR15539874;28;32;0.392857142857143;17;11;0.107142857142857;0.392857142857143
Control.SRR15539874;28;32;0.464285714285714;15;13;0.0357142857142857;0.464285714285714
Control.SRR15539874;33;32;0.333333333333333;22;11;0.166666666666667;0.333333333333333
Control.SRR15539874;29;32;0.344827586206897;19;10;0.155172413793103;0.344827586206897
Control.SRR15539874;34;32;0.529411764705882;16;18;0.0294117647058824;0.470588235294118
Control.SRR15539874;34;32;0.617647058823529;13;21;0.117647058823529;0.382352941176471
Control.SRR15539874;34;32;0.5;17;17;0;0.5
Control.SRR15539874;32;32;0.53125;15;17;0.03125;0.46875
Control.SRR15539874;34;32;0.441176470588235;19;15;0.0588235294117647;0.441176470588235
Control.SRR15539874;32;32;0.4375;18;14;0.0625;0.4375
Control.SRR15539874;29;32;0.551724137931034;13;16;0.0517241379310345;0.448275862068966
Control.SRR15539874;31;32;0.451612903225806;17;14;0.0483870967741936;0.451612903225806
Control.SRR15539874;28;32;0.607142857142857;11;17;0.107142857142857;0.392857142857143
Control.SRR15539874;33;32;0.606060606060606;13;20;0.106060606060606;0.393939393939394
Control.SRR15539874;34;32;0.411764705882353;20;14;0.0882352941176471;0.411764705882353
Control.SRR15539874;35;32;0.514285714285714;17;18;0.0142857142857142;0.485714285714286
Control.SRR15539874;30;32;0.333333333333333;20;10;0.166666666666667;0.333333333333333
Control.SRR15539874;29;32;0.482758620689655;15;14;0.0172413793103448;0.482758620689655
Control.SRR15539874;36;32;0.5;18;18;0;0.5
Control.SRR15539874;34;32;0.441176470588235;19;15;0.0588235294117647;0.441176470588235
Control.SRR15539874;33;32;0.363636363636364;21;12;0.136363636363636;0.363636363636364
Control.SRR15539874;32;32;0.53125;15;17;0.03125;0.46875
Control.SRR15539874;29;32;0.620689655172414;11;18;0.120689655172414;0.379310344827586
Control.SRR15539874;30;32;0.5;15;15;0;0.5
Control.SRR15539874;30;32;0.466666666666667;16;14;0.0333333333333333;0.466666666666667
Control.SRR15539874;30;32;0.5;15;15;0;0.5
Control.SRR15539874;30;32;0.466666666666667;16;14;0.0333333333333333;0.466666666666667
Control.SRR15539874;35;32;0.342857142857143;23;12;0.157142857142857;0.342857142857143
Control.SRR15539874;34;32;0.529411764705882;16;18;0.0294117647058824;0.470588235294118
Control.SRR15539874;33;32;0.484848484848485;17;16;0.0151515151515151;0.484848484848485
Control.SRR15539874;30;32;0.7;9;21;0.2;0.3
Control.SRR15539874;31;32;0.419354838709677;18;13;0.0806451612903226;0.419354838709677
Control.SRR15539874;35;32;0.371428571428571;22;13;0.128571428571429;0.371428571428571
Control.SRR15539874;36;32;0.416666666666667;21;15;0.0833333333333333;0.416666666666667
Control.SRR15539874;35;32;0.571428571428571;15;20;0.0714285714285714;0.428571428571429
Control.SRR15539874;34;32;0.470588235294118;18;16;0.0294117647058824;0.470588235294118
Control.SRR15539874;33;32;0.363636363636364;21;12;0.136363636363636;0.363636363636364
Control.SRR15539874;31;32;0.516129032258065;15;16;0.0161290322580645;0.483870967741935
Control.SRR15539874;35;32;0.514285714285714;17;18;0.0142857142857142;0.485714285714286
Control.SRR15539874;32;32;0.5;16;16;0;0.5
Control.SRR15539874;33;32;0.545454545454545;15;18;0.0454545454545454;0.454545454545455
Control.SRR15539874;28;32;0.607142857142857;11;17;0.107142857142857;0.392857142857143
Control.SRR15539874;32;32;0.40625;19;13;0.09375;0.40625
Control.SRR15539874;30;32;0.633333333333333;11;19;0.133333333333333;0.366666666666667
Control.SRR15539874;32;32;0.65625;11;21;0.15625;0.34375
Control.SRR15539874;29;32;0.586206896551724;12;17;0.0862068965517241;0.413793103448276
Control.SRR15539874;31;32;0.419354838709677;18;13;0.0806451612903226;0.419354838709677
Control.SRR15539874;34;32;0.5;17;17;0;0.5
Control.SRR15539874;34;32;0.558823529411765;15;19;0.0588235294117647;0.441176470588235
Control.SRR15539874;36;32;0.583333333333333;15;21;0.0833333333333334;0.416666666666667
Control.SRR15539874;33;32;0.545454545454545;15;18;0.0454545454545454;0.454545454545455
Control.SRR15539874;36;32;0.444444444444444;20;16;0.0555555555555556;0.444444444444444
Control.SRR15539874;35;32;0.485714285714286;18;17;0.0142857142857143;0.485714285714286
Control.SRR15539874;28;32;0.535714285714286;13;15;0.0357142857142857;0.464285714285714
Control.SRR15539874;32;32;0.5625;14;18;0.0625;0.4375
Control.SRR15539874;34;32;0.617647058823529;13;21;0.117647058823529;0.382352941176471
Control.SRR15539874;34;32;0.382352941176471;21;13;0.117647058823529;0.382352941176471
Control.SRR15539874;33;32;0.484848484848485;17;16;0.0151515151515151;0.484848484848485
Control.SRR15539874;31;32;0.516129032258065;15;16;0.0161290322580645;0.483870967741935
Control.SRR15539874;33;32;0.515151515151515;16;17;0.0151515151515151;0.484848484848485
Control.SRR15539874;32;32;0.65625;11;21;0.15625;0.34375
Control.SRR15539874;33;32;0.484848484848485;17;16;0.0151515151515151;0.484848484848485
Control.SRR15539874;29;32;0.482758620689655;15;14;0.0172413793103448;0.482758620689655
Control.SRR15539874;30;32;0.6;12;18;0.1;0.4
Control.SRR15539874;33;32;0.545454545454545;15;18;0.0454545454545454;0.454545454545455
Control.SRR15539874;32;32;0.46875;17;15;0.03125;0.46875
Control.SRR15539874;28;32;0.464285714285714;15;13;0.0357142857142857;0.464285714285714
Control.SRR15539874;28;32;0.464285714285714;15;13;0.0357142857142857;0.464285714285714
Control.SRR15539874;33;32;0.515151515151515;16;17;0.0151515151515151;0.484848484848485
Control.SRR15539874;35;32;0.514285714285714;17;18;0.0142857142857142;0.485714285714286
Control.SRR15539874;32;32;0.59375;13;19;0.09375;0.40625
Control.SRR15539874;34;32;0.588235294117647;14;20;0.0882352941176471;0.411764705882353
Control.SRR15539874;32;32;0.5;16;16;0;0.5
Control.SRR15539874;33;32;0.484848484848485;17;16;0.0151515151515151;0.484848484848485
Control.SRR15539874;28;32;0.428571428571429;16;12;0.0714285714285715;0.428571428571429
Control.SRR15539874;33;32;0.333333333333333;22;11;0.166666666666667;0.333333333333333
Control.SRR15539874;35;32;0.428571428571429;20;15;0.0714285714285715;0.428571428571429
Control.SRR15539874;28;32;0.428571428571429;16;12;0.0714285714285715;0.428571428571429
Control.SRR15539874;30;32;0.566666666666667;13;17;0.0666666666666667;0.433333333333333
Control.SRR15539874;29;32;0.413793103448276;17;12;0.0862068965517241;0.413793103448276
Control.SRR15539874;35;32;0.371428571428571;22;13;0.128571428571429;0.371428571428571
Control.SRR15539874;33;32;0.606060606060606;13;20;0.106060606060606;0.393939393939394
Control.SRR15539874;36;32;0.361111111111111;23;13;0.138888888888889;0.361111111111111
Control.SRR15539874;35;32;0.342857142857143;23;12;0.157142857142857;0.342857142857143
Control.SRR15539874;29;32;0.517241379310345;14;15;0.0172413793103449;0.482758620689655
Control.SRR15539874;29;32;0.448275862068966;16;13;0.0517241379310345;0.448275862068966
Control.SRR15539874;35;32;0.542857142857143;16;19;0.0428571428571428;0.457142857142857
Control.SRR15539874;34;32;0.617647058823529;13;21;0.117647058823529;0.382352941176471
Control.SRR15539874;36;32;0.666666666666667;12;24;0.166666666666667;0.333333333333333
Control.SRR15539874;30;32;0.466666666666667;16;14;0.0333333333333333;0.466666666666667
Control.SRR15539874;35;32;0.4;21;14;0.1;0.4
Control.SRR15539874;36;32;0.527777777777778;17;19;0.0277777777777778;0.472222222222222
Control.SRR15539874;35;32;0.428571428571429;20;15;0.0714285714285715;0.428571428571429
Control.SRR15539874;35;32;0.571428571428571;15;20;0.0714285714285714;0.428571428571429
Control.SRR15539874;31;32;0.548387096774194;14;17;0.0483870967741935;0.451612903225806
Control.SRR15539874;31;32;0.548387096774194;14;17;0.0483870967741935;0.451612903225806
Control.SRR15539874;31;32;0.419354838709677;18;13;0.0806451612903226;0.419354838709677
Control.SRR15539874;33;32;0.575757575757576;14;19;0.0757575757575758;0.424242424242424
Control.SRR15539874;33;32;0.666666666666667;11;22;0.166666666666667;0.333333333333333
Control.SRR15539874;31;32;0.483870967741935;16;15;0.0161290322580645;0.483870967741935
Control.SRR15539874;31;32;0.516129032258065;15;16;0.0161290322580645;0.483870967741935
Control.SRR15539874;28;32;0.642857142857143;10;18;0.142857142857143;0.357142857142857
Control.SRR15539874;34;32;0.411764705882353;20;14;0.0882352941176471;0.411764705882353
Control.SRR15539874;32;32;0.4375;18;14;0.0625;0.4375
Control.SRR15539874;35;32;0.485714285714286;18;17;0.0142857142857143;0.485714285714286
Control.SRR15539874;32;32;0.4375;18;14;0.0625;0.4375
Control.SRR15539874;35;32;0.542857142857143;16;19;0.0428571428571428;0.457142857142857
Control.SRR15539874;28;32;0.428571428571429;16;12;0.0714285714285715;0.428571428571429
Control.SRR15539874;35;32;0.485714285714286;18;17;0.0142857142857143;0.485714285714286
Control.SRR15539874;35;32;0.514285714285714;17;18;0.0142857142857142;0.485714285714286
Control.SRR15539874;29;32;0.379310344827586;18;11;0.120689655172414;0.379310344827586
Control.SRR15539874;32;32;0.5;16;16;0;0.5
Control.SRR15539874;31;32;0.451612903225806;17;14;0.0483870967741936;0.451612903225806
Control.SRR15539874;28;32;0.571428571428571;12;16;0.0714285714285714;0.428571428571429
Control.SRR15539874;30;32;0.433333333333333;17;13;0.0666666666666667;0.433333333333333
Control.SRR15539874;33;32;0.515151515151515;16;17;0.0151515151515151;0.484848484848485
Control.SRR15539874;35;32;0.428571428571429;20;15;0.0714285714285715;0.428571428571429
Control.SRR15539874;35;32;0.4;21;14;0.1;0.4
Control.SRR15539874;32;32;0.53125;15;17;0.03125;0.46875
Control.SRR15539874;36;32;0.555555555555556;16;20;0.0555555555555556;0.444444444444444
Control.SRR15539874;36;32;0.472222222222222;19;17;0.0277777777777778;0.472222222222222
Control.SRR15539874;35;32;0.571428571428571;15;20;0.0714285714285714;0.428571428571429
Control.SRR15539874;32;32;0.5625;14;18;0.0625;0.4375
Control.SRR15539874;35;32;0.457142857142857;19;16;0.0428571428571429;0.457142857142857
Control.SRR15539874;31;32;0.451612903225806;17;14;0.0483870967741936;0.451612903225806
Control.SRR15539874;32;32;0.4375;18;14;0.0625;0.4375
Control.SRR15539874;31;32;0.451612903225806;17;14;0.0483870967741936;0.451612903225806
Control.SRR15539874;36;32;0.444444444444444;20;16;0.0555555555555556;0.444444444444444
Control.SRR15539874;31;32;0.387096774193548;19;12;0.112903225806452;0.387096774193548
Control.SRR15539874;36;32;0.5;18;18;0;0.5
Control.SRR15539874;32;32;0.25;24;8;0.25;0.25
Control.SRR15539874;33;32;0.424242424242424;19;14;0.0757575757575757;0.424242424242424
Control.SRR15539874;34;32;0.529411764705882;16;18;0.0294117647058824;0.470588235294118
Control.SRR15539874;36;32;0.555555555555556;16;20;0.0555555555555556;0.444444444444444
Control.SRR15539874;33;32;0.575757575757576;14;19;0.0757575757575758;0.424242424242424
Control.SRR15539874;28;32;0.464285714285714;15;13;0.0357142857142857;0.464285714285714
Control.SRR15539874;35;32;0.514285714285714;17;18;0.0142857142857142;0.485714285714286
Control.SRR15539874;30;32;0.433333333333333;17;13;0.0666666666666667;0.433333333333333
Control.SRR15539874;30;32;0.533333333333333;14;16;0.0333333333333333;0.466666666666667
Control.SRR15539874;34;32;0.441176470588235;19;15;0.0588235294117647;0.441176470588235
Control.SRR15539874;34;32;0.5;17;17;0;0.5
Control.SRR15539874;30;32;0.5;15;15;0;0.5
Control.SRR15539874;28;32;0.678571428571429;9;19;0.178571428571429;0.321428571428571
Control.SRR15539874;31;32;0.419354838709677;18;13;0.0806451612903226;0.419354838709677
Control.SRR15539874;32;32;0.40625;19;13;0.09375;0.40625
Control.SRR15539874;35;32;0.542857142857143;16;19;0.0428571428571428;0.457142857142857
Control.SRR15539874;35;32;0.542857142857143;16;19;0.0428571428571428;0.457142857142857
Control.SRR15539874;32;32;0.5;16;16;0;0.5
Control.SRR15539874;35;32;0.514285714285714;17;18;0.0142857142857142;0.485714285714286
Control.SRR15539874;32;32;0.5;16;16;0;0.5
Control.SRR15539874;31;32;0.483870967741935;16;15;0.0161290322580645;0.483870967741935
Control.SRR15539874;28;32;0.571428571428571;12;16;0.0714285714285714;0.428571428571429
Control.SRR15539874;30;32;0.433333333333333;17;13;0.0666666666666667;0.433333333333333
Control.SRR15539874;34;32;0.529411764705882;16;18;0.0294117647058824;0.470588235294118
Control.SRR15539874;32;32;0.53125;15;17;0.03125;0.46875
Control.SRR15539874;29;32;0.448275862068966;16;13;0.0517241379310345;0.448275862068966
Control.SRR15539874;29;32;0.482758620689655;15;14;0.0172413793103448;0.482758620689655
Control.SRR15539874;29;32;0.310344827586207;20;9;0.189655172413793;0.310344827586207
Control.SRR15539874;28;32;0.428571428571429;16;12;0.0714285714285715;0.428571428571429
Control.SRR15539874;28;32;0.714285714285714;8;20;0.214285714285714;0.285714285714286
Control.SRR15539874;32;32;0.46875;17;15;0.03125;0.46875
Control.SRR15539874;29;32;0.586206896551724;12;17;0.0862068965517241;0.413793103448276
Control.SRR15539874;33;32;0.515151515151515;16;17;0.0151515151515151;0.484848484848485
Control.SRR15539874;34;32;0.5;17;17;0;0.5
Control.SRR15539874;34;32;0.5;17;17;0;0.5
Control.SRR15539874;33;32;0.424242424242424;19;14;0.0757575757575757;0.424242424242424
Control.SRR15539874;34;32;0.588235294117647;14;20;0.0882352941176471;0.411764705882353
Control.SRR15539874;28;32;0.535714285714286;13;15;0.0357142857142857;0.464285714285714
Control.SRR15539874;28;32;0.392857142857143;17;11;0.107142857142857;0.392857142857143
Control.SRR15539874;32;32;0.71875;9;23;0.21875;0.28125
Control.SRR15539874;33;32;0.424242424242424;19;14;0.0757575757575757;0.424242424242424
Control.SRR15539874;29;32;0.586206896551724;12;17;0.0862068965517241;0.413793103448276
Control.SRR15539874;34;32;0.5;17;17;0;0.5
Control.SRR15539874;28;32;0.571428571428571;12;16;0.0714285714285714;0.428571428571429
Control.SRR15539874;30;32;0.433333333333333;17;13;0.0666666666666667;0.433333333333333
Control.SRR15539874;32;32;0.4375;18;14;0.0625;0.4375
Control.SRR15539874;36;32;0.361111111111111;23;13;0.138888888888889;0.361111111111111
Control.SRR15539874;36;32;0.444444444444444;20;16;0.0555555555555556;0.444444444444444
Control.SRR15539874;31;32;0.548387096774194;14;17;0.0483870967741935;0.451612903225806
Control.SRR15539874;28;32;0.5;14;14;0;0.5
Control.SRR15539874;32;32;0.34375;21;11;0.15625;0.34375
Control.SRR15539874;28;32;0.535714285714286;13;15;0.0357142857142857;0.464285714285714
Control.SRR15539874;30;32;0.4;18;12;0.1;0.4
Control.SRR15539874;34;32;0.5;17;17;0;0.5
Control.SRR15539874;28;32;0.464285714285714;15;13;0.0357142857142857;0.464285714285714
Control.SRR15539874;33;32;0.454545454545455;18;15;0.0454545454545455;0.454545454545455
Control.SRR15539874;28;32;0.607142857142857;11;17;0.107142857142857;0.392857142857143
Control.SRR15539874;34;32;0.558823529411765;15;19;0.0588235294117647;0.441176470588235
Control.SRR15539874;34;32;0.470588235294118;18;16;0.0294117647058824;0.470588235294118
Control.SRR15539874;31;32;0.387096774193548;19;12;0.112903225806452;0.387096774193548
Control.SRR15539874;32;32;0.59375;13;19;0.09375;0.40625
Control.SRR15539874;31;32;0.387096774193548;19;12;0.112903225806452;0.387096774193548
Control.SRR15539874;28;32;0.5;14;14;0;0.5
Control.SRR15539874;33;32;0.484848484848485;17;16;0.0151515151515151;0.484848484848485
Control.SRR15539874;36;32;0.416666666666667;21;15;0.0833333333333333;0.416666666666667
Control.SRR15539874;35;32;0.571428571428571;15;20;0.0714285714285714;0.428571428571429
Control.SRR15539874;35;32;0.542857142857143;16;19;0.0428571428571428;0.457142857142857
Control.SRR15539874;36;32;0.444444444444444;20;16;0.0555555555555556;0.444444444444444
Control.SRR15539874;29;32;0.517241379310345;14;15;0.0172413793103449;0.482758620689655
Control.SRR15539874;28;32;0.714285714285714;8;20;0.214285714285714;0.285714285714286
Control.SRR15539874;35;32;0.428571428571429;20;15;0.0714285714285715;0.428571428571429
Control.SRR15539874;29;32;0.689655172413793;9;20;0.189655172413793;0.310344827586207
Control.SRR15539874;28;32;0.607142857142857;11;17;0.107142857142857;0.392857142857143
Control.SRR15539874;34;32;0.617647058823529;13;21;0.117647058823529;0.382352941176471
Control.SRR15539874;29;32;0.517241379310345;14;15;0.0172413793103449;0.482758620689655
Control.SRR15539874;35;32;0.485714285714286;18;17;0.0142857142857143;0.485714285714286
Control.SRR15539874;29;32;0.482758620689655;15;14;0.0172413793103448;0.482758620689655
Control.SRR15539874;34;32;0.411764705882353;20;14;0.0882352941176471;0.411764705882353
Control.SRR15539874;33;32;0.393939393939394;20;13;0.106060606060606;0.393939393939394
Control.SRR15539874;29;32;0.448275862068966;16;13;0.0517241379310345;0.448275862068966
Control.SRR15539874;33;32;0.303030303030303;23;10;0.196969696969697;0.303030303030303
Control.SRR15539874;31;32;0.612903225806452;12;19;0.112903225806452;0.387096774193548
Control.SRR15539874;33;32;0.424242424242424;19;14;0.0757575757575757;0.424242424242424
Control.SRR15539874;29;32;0.689655172413793;9;20;0.189655172413793;0.310344827586207
Control.SRR15539874;33;32;0.515151515151515;16;17;0.0151515151515151;0.484848484848485
Control.SRR15539874;35;32;0.457142857142857;19;16;0.0428571428571429;0.457142857142857
Control.SRR15539874;30;32;0.633333333333333;11;19;0.133333333333333;0.366666666666667
Control.SRR15539874;28;32;0.5;14;14;0;0.5
Control.SRR15539874;33;32;0.515151515151515;16;17;0.0151515151515151;0.484848484848485
Control.SRR15539874;33;32;0.333333333333333;22;11;0.166666666666667;0.333333333333333
Control.SRR15539874;34;32;0.529411764705882;16;18;0.0294117647058824;0.470588235294118
Control.SRR15539874;36;32;0.527777777777778;17;19;0.0277777777777778;0.472222222222222
Control.SRR15539874;28;32;0.464285714285714;15;13;0.0357142857142857;0.464285714285714
Control.SRR15539874;28;32;0.607142857142857;11;17;0.107142857142857;0.392857142857143
Control.SRR15539874;31;32;0.516129032258065;15;16;0.0161290322580645;0.483870967741935
Control.SRR15539874;32;32;0.5625;14;18;0.0625;0.4375
Control.SRR15539874;33;32;0.484848484848485;17;16;0.0151515151515151;0.484848484848485
Control.SRR15539874;34;32;0.558823529411765;15;19;0.0588235294117647;0.441176470588235
Control.SRR15539874;36;32;0.5;18;18;0;0.5
Control.SRR15539874;28;32;0.535714285714286;13;15;0.0357142857142857;0.464285714285714
Control.SRR15539874;30;32;0.433333333333333;17;13;0.0666666666666667;0.433333333333333
Control.SRR15539874;31;32;0.516129032258065;15;16;0.0161290322580645;0.483870967741935
Control.SRR15539874;33;32;0.545454545454545;15;18;0.0454545454545454;0.454545454545455
Control.SRR15539874;30;32;0.7;9;21;0.2;0.3
Control.SRR15539874;33;32;0.606060606060606;13;20;0.106060606060606;0.393939393939394
Control.SRR15539874;31;32;0.419354838709677;18;13;0.0806451612903226;0.419354838709677
Control.SRR15539874;35;32;0.428571428571429;20;15;0.0714285714285715;0.428571428571429
Control.SRR15539874;29;32;0.517241379310345;14;15;0.0172413793103449;0.482758620689655
Control.SRR15539874;33;32;0.545454545454545;15;18;0.0454545454545454;0.454545454545455
Control.SRR15539874;30;32;0.466666666666667;16;14;0.0333333333333333;0.466666666666667
Control.SRR15539874;35;32;0.428571428571429;20;15;0.0714285714285715;0.428571428571429
Control.SRR15539874;33;32;0.484848484848485;17;16;0.0151515151515151;0.484848484848485
Control.SRR15539874;29;32;0.379310344827586;18;11;0.120689655172414;0.379310344827586
Control.SRR15539874;32;32;0.5;16;16;0;0.5
Control.SRR15539874;35;32;0.6;14;21;0.1;0.4
Control.SRR15539874;28;32;0.607142857142857;11;17;0.107142857142857;0.392857142857143
Control.SRR15539874;36;32;0.444444444444444;20;16;0.0555555555555556;0.444444444444444
Control.SRR15539874;35;32;0.485714285714286;18;17;0.0142857142857143;0.485714285714286
Control.SRR15539874;34;32;0.5;17;17;0;0.5
Control.SRR15539874;31;32;0.67741935483871;10;21;0.17741935483871;0.32258064516129
Control.SRR15539874;29;32;0.482758620689655;15;14;0.0172413793103448;0.482758620689655
Control.SRR15539874;33;32;0.606060606060606;13;20;0.106060606060606;0.393939393939394
Control.SRR15539874;28;32;0.464285714285714;15;13;0.0357142857142857;0.464285714285714
Control.SRR15539874;30;32;0.566666666666667;13;17;0.0666666666666667;0.433333333333333
Control.SRR15539874;35;32;0.542857142857143;16;19;0.0428571428571428;0.457142857142857
Control.SRR15539874;36;32;0.583333333333333;15;21;0.0833333333333334;0.416666666666667
Control.SRR15539874;28;32;0.535714285714286;13;15;0.0357142857142857;0.464285714285714
Control.SRR15539874;32;32;0.5625;14;18;0.0625;0.4375
Control.SRR15539874;30;32;0.333333333333333;20;10;0.166666666666667;0.333333333333333
Control.SRR15539874;30;32;0.566666666666667;13;17;0.0666666666666667;0.433333333333333
Control.SRR15539874;32;32;0.4375;18;14;0.0625;0.4375
Control.SRR15539874;32;32;0.46875;17;15;0.03125;0.46875
Control.SRR15539874;35;32;0.542857142857143;16;19;0.0428571428571428;0.457142857142857
Control.SRR15539874;29;32;0.517241379310345;14;15;0.0172413793103449;0.482758620689655
Control.SRR15539874;28;32;0.5;14;14;0;0.5
Control.SRR15539874;33;32;0.363636363636364;21;12;0.136363636363636;0.363636363636364
Control.SRR15539874;33;32;0.454545454545455;18;15;0.0454545454545455;0.454545454545455
Control.SRR15539874;35;32;0.514285714285714;17;18;0.0142857142857142;0.485714285714286
Control.SRR15539874;35;32;0.342857142857143;23;12;0.157142857142857;0.342857142857143
Control.SRR15539874;32;32;0.40625;19;13;0.09375;0.40625
Control.SRR15539874;31;32;0.612903225806452;12;19;0.112903225806452;0.387096774193548
Control.SRR15539874;33;32;0.575757575757576;14;19;0.0757575757575758;0.424242424242424
Control.SRR15539874;29;32;0.482758620689655;15;14;0.0172413793103448;0.482758620689655
Control.SRR15539874;32;32;0.5625;14;18;0.0625;0.4375
Control.SRR15539874;35;32;0.571428571428571;15;20;0.0714285714285714;0.428571428571429
Control.SRR15539874;34;32;0.529411764705882;16;18;0.0294117647058824;0.470588235294118
Control.SRR15539874;29;32;0.517241379310345;14;15;0.0172413793103449;0.482758620689655
Control.SRR15539874;29;32;0.310344827586207;20;9;0.189655172413793;0.310344827586207
Control.SRR15539874;28;32;0.571428571428571;12;16;0.0714285714285714;0.428571428571429
Control.SRR15539874;36;32;0.472222222222222;19;17;0.0277777777777778;0.472222222222222
Control.SRR15539874;34;32;0.382352941176471;21;13;0.117647058823529;0.382352941176471
Control.SRR15539874;35;32;0.542857142857143;16;19;0.0428571428571428;0.457142857142857
Control.SRR15539874;31;32;0.709677419354839;9;22;0.209677419354839;0.290322580645161
Control.SRR15539874;36;32;0.555555555555556;16;20;0.0555555555555556;0.444444444444444
Control.SRR15539874;33;32;0.454545454545455;18;15;0.0454545454545455;0.454545454545455
Control.SRR15539874;30;32;0.533333333333333;14;16;0.0333333333333333;0.466666666666667
Control.SRR15539874;33;32;0.424242424242424;19;14;0.0757575757575757;0.424242424242424
Control.SRR15539874;34;32;0.647058823529412;12;22;0.147058823529412;0.352941176470588
Control.SRR15539874;29;32;0.724137931034483;8;21;0.224137931034483;0.275862068965517
Control.SRR15539874;29;32;0.517241379310345;14;15;0.0172413793103449;0.482758620689655
Control.SRR15539874;31;32;0.419354838709677;18;13;0.0806451612903226;0.419354838709677
Control.SRR15539874;30;32;0.6;12;18;0.1;0.4
Control.SRR15539874;30;32;0.566666666666667;13;17;0.0666666666666667;0.433333333333333
Control.SRR15539874;29;32;0.310344827586207;20;9;0.189655172413793;0.310344827586207
Control.SRR15539874;33;32;0.727272727272727;9;24;0.227272727272727;0.272727272727273
Control.SRR15539874;29;32;0.586206896551724;12;17;0.0862068965517241;0.413793103448276
Control.SRR15539874;29;32;0.517241379310345;14;15;0.0172413793103449;0.482758620689655
Control.SRR15539874;32;32;0.40625;19;13;0.09375;0.40625
Control.SRR15539874;29;32;0.482758620689655;15;14;0.0172413793103448;0.482758620689655
Control.SRR15539874;30;32;0.566666666666667;13;17;0.0666666666666667;0.433333333333333
Control.SRR15539874;28;32;0.5;14;14;0;0.5
Control.SRR15539874;33;32;0.545454545454545;15;18;0.0454545454545454;0.454545454545455
Control.SRR15539874;31;32;0.483870967741935;16;15;0.0161290322580645;0.483870967741935
Control.SRR15539874;35;32;0.657142857142857;12;23;0.157142857142857;0.342857142857143
Control.SRR15539874;30;32;0.5;15;15;0;0.5
Control.SRR15539874;36;32;0.5;18;18;0;0.5
Control.SRR15539874;30;32;0.566666666666667;13;17;0.0666666666666667;0.433333333333333
Control.SRR15539874;33;32;0.666666666666667;11;22;0.166666666666667;0.333333333333333
Control.SRR15539874;33;32;0.484848484848485;17;16;0.0151515151515151;0.484848484848485
Control.SRR15539874;34;32;0.470588235294118;18;16;0.0294117647058824;0.470588235294118
Control.SRR15539874;34;32;0.5;17;17;0;0.5
Control.SRR15539874;31;32;0.387096774193548;19;12;0.112903225806452;0.387096774193548
Control.SRR15539874;30;32;0.533333333333333;14;16;0.0333333333333333;0.466666666666667
Control.SRR15539874;35;32;0.542857142857143;16;19;0.0428571428571428;0.457142857142857
Control.SRR15539874;30;32;0.466666666666667;16;14;0.0333333333333333;0.466666666666667
Control.SRR15539874;30;32;0.5;15;15;0;0.5
Control.SRR15539874;29;32;0.344827586206897;19;10;0.155172413793103;0.344827586206897
Control.SRR15539874;34;32;0.558823529411765;15;19;0.0588235294117647;0.441176470588235
Control.SRR15539874;30;32;0.566666666666667;13;17;0.0666666666666667;0.433333333333333
Control.SRR15539874;32;32;0.5625;14;18;0.0625;0.4375
Control.SRR15539874;33;32;0.363636363636364;21;12;0.136363636363636;0.363636363636364
Control.SRR15539874;31;32;0.580645161290323;13;18;0.0806451612903226;0.419354838709677
Control.SRR15539874;33;32;0.424242424242424;19;14;0.0757575757575757;0.424242424242424
Control.SRR15539874;34;32;0.617647058823529;13;21;0.117647058823529;0.382352941176471
Control.SRR15539874;35;32;0.514285714285714;17;18;0.0142857142857142;0.485714285714286
Control.SRR15539874;29;32;0.448275862068966;16;13;0.0517241379310345;0.448275862068966
Control.SRR15539874;35;32;0.428571428571429;20;15;0.0714285714285715;0.428571428571429
Control.SRR15539874;32;32;0.5;16;16;0;0.5
Control.SRR15539874;34;32;0.588235294117647;14;20;0.0882352941176471;0.411764705882353
Control.SRR15539874;32;32;0.53125;15;17;0.03125;0.46875
Control.SRR15539874;36;32;0.5;18;18;0;0.5
Control.SRR15539874;31;32;0.67741935483871;10;21;0.17741935483871;0.32258064516129
Control.SRR15539874;29;32;0.586206896551724;12;17;0.0862068965517241;0.413793103448276
Control.SRR15539874;31;32;0.483870967741935;16;15;0.0161290322580645;0.483870967741935
Control.SRR15539874;31;32;0.548387096774194;14;17;0.0483870967741935;0.451612903225806
Control.SRR15539874;28;32;0.535714285714286;13;15;0.0357142857142857;0.464285714285714
Control.SRR15539874;32;32;0.5;16;16;0;0.5
Control.SRR15539874;28;32;0.392857142857143;17;11;0.107142857142857;0.392857142857143
Control.SRR15539874;35;32;0.485714285714286;18;17;0.0142857142857143;0.485714285714286
Control.SRR15539874;31;32;0.451612903225806;17;14;0.0483870967741936;0.451612903225806
Control.SRR15539874;28;32;0.571428571428571;12;16;0.0714285714285714;0.428571428571429
Control.SRR15539874;29;32;0.517241379310345;14;15;0.0172413793103449;0.482758620689655
Control.SRR15539874;31;32;0.516129032258065;15;16;0.0161290322580645;0.483870967741935
Control.SRR15539874;29;32;0.517241379310345;14;15;0.0172413793103449;0.482758620689655
Control.SRR15539874;34;32;0.411764705882353;20;14;0.0882352941176471;0.411764705882353
Control.SRR15539874;31;32;0.741935483870968;8;23;0.241935483870968;0.258064516129032
Control.SRR15539874;36;32;0.555555555555556;16;20;0.0555555555555556;0.444444444444444
Control.SRR15539874;30;32;0.666666666666667;10;20;0.166666666666667;0.333333333333333
Control.SRR15539874;28;32;0.607142857142857;11;17;0.107142857142857;0.392857142857143
Control.SRR15539874;30;32;0.433333333333333;17;13;0.0666666666666667;0.433333333333333
Control.SRR15539874;29;32;0.310344827586207;20;9;0.189655172413793;0.310344827586207
Control.SRR15539874;29;32;0.448275862068966;16;13;0.0517241379310345;0.448275862068966
Control.SRR15539874;34;32;0.352941176470588;22;12;0.147058823529412;0.352941176470588
Control.SRR15539874;35;32;0.485714285714286;18;17;0.0142857142857143;0.485714285714286
Control.SRR15539874;29;32;0.517241379310345;14;15;0.0172413793103449;0.482758620689655
Control.SRR15539874;31;32;0.645161290322581;11;20;0.145161290322581;0.354838709677419
Control.SRR15539874;32;32;0.625;12;20;0.125;0.375
Control.SRR15539874;31;32;0.451612903225806;17;14;0.0483870967741936;0.451612903225806
Control.SRR15539874;34;32;0.558823529411765;15;19;0.0588235294117647;0.441176470588235
Control.SRR15539874;31;32;0.483870967741935;16;15;0.0161290322580645;0.483870967741935
Control.SRR15539874;30;32;0.4;18;12;0.1;0.4
Control.SRR15539874;33;32;0.545454545454545;15;18;0.0454545454545454;0.454545454545455
Control.SRR15539874;29;32;0.551724137931034;13;16;0.0517241379310345;0.448275862068966
Control.SRR15539874;33;32;0.333333333333333;22;11;0.166666666666667;0.333333333333333
Control.SRR15539874;28;32;0.285714285714286;20;8;0.214285714285714;0.285714285714286
Control.SRR15539874;30;32;0.666666666666667;10;20;0.166666666666667;0.333333333333333
Control.SRR15539874;31;32;0.580645161290323;13;18;0.0806451612903226;0.419354838709677
Control.SRR15539874;31;32;0.483870967741935;16;15;0.0161290322580645;0.483870967741935
Control.SRR15539874;32;32;0.4375;18;14;0.0625;0.4375
Control.SRR15539874;36;32;0.416666666666667;21;15;0.0833333333333333;0.416666666666667
Control.SRR15539874;35;32;0.514285714285714;17;18;0.0142857142857142;0.485714285714286
Control.SRR15539874;33;32;0.575757575757576;14;19;0.0757575757575758;0.424242424242424
Control.SRR15539874;35;32;0.685714285714286;11;24;0.185714285714286;0.314285714285714
Control.SRR15539874;36;32;0.388888888888889;22;14;0.111111111111111;0.388888888888889
Control.SRR15539874;35;32;0.514285714285714;17;18;0.0142857142857142;0.485714285714286
Control.SRR15539874;31;32;0.483870967741935;16;15;0.0161290322580645;0.483870967741935
Control.SRR15539874;31;32;0.483870967741935;16;15;0.0161290322580645;0.483870967741935
Control.SRR15539874;28;32;0.5;14;14;0;0.5
Control.SRR15539874;29;32;0.655172413793103;10;19;0.155172413793103;0.344827586206897
Control.SRR15539874;29;32;0.586206896551724;12;17;0.0862068965517241;0.413793103448276
Control.SRR15539874;33;32;0.575757575757576;14;19;0.0757575757575758;0.424242424242424
Control.SRR15539874;36;32;0.444444444444444;20;16;0.0555555555555556;0.444444444444444
Control.SRR15539874;31;32;0.419354838709677;18;13;0.0806451612903226;0.419354838709677
Control.SRR15539874;33;32;0.424242424242424;19;14;0.0757575757575757;0.424242424242424
Control.SRR15539874;32;32;0.59375;13;19;0.09375;0.40625
Control.SRR15539874;30;32;0.4;18;12;0.1;0.4
Control.SRR15539874;28;32;0.535714285714286;13;15;0.0357142857142857;0.464285714285714
Control.SRR15539874;28;32;0.464285714285714;15;13;0.0357142857142857;0.464285714285714
Control.SRR15539874;30;32;0.5;15;15;0;0.5
Control.SRR15539874;30;32;0.533333333333333;14;16;0.0333333333333333;0.466666666666667
Control.SRR15539874;30;32;0.633333333333333;11;19;0.133333333333333;0.366666666666667
Control.SRR15539874;30;32;0.6;12;18;0.1;0.4
Control.SRR15539874;29;32;0.517241379310345;14;15;0.0172413793103449;0.482758620689655
Control.SRR15539874;29;32;0.551724137931034;13;16;0.0517241379310345;0.448275862068966
Control.SRR15539874;29;32;0.586206896551724;12;17;0.0862068965517241;0.413793103448276
Control.SRR15539874;30;32;0.666666666666667;10;20;0.166666666666667;0.333333333333333
Control.SRR15539874;30;32;0.333333333333333;20;10;0.166666666666667;0.333333333333333
Control.SRR15539874;36;32;0.444444444444444;20;16;0.0555555555555556;0.444444444444444
Control.SRR15539874;33;32;0.515151515151515;16;17;0.0151515151515151;0.484848484848485
Control.SRR15539874;34;32;0.323529411764706;23;11;0.176470588235294;0.323529411764706
Control.SRR15539874;36;32;0.444444444444444;20;16;0.0555555555555556;0.444444444444444
Control.SRR15539874;35;32;0.542857142857143;16;19;0.0428571428571428;0.457142857142857
Control.SRR15539874;29;32;0.482758620689655;15;14;0.0172413793103448;0.482758620689655
Control.SRR15539874;29;32;0.482758620689655;15;14;0.0172413793103448;0.482758620689655
Control.SRR15539874;32;32;0.5625;14;18;0.0625;0.4375
Control.SRR15539874;30;32;0.4;18;12;0.1;0.4
Control.SRR15539874;32;32;0.375;20;12;0.125;0.375
Control.SRR15539874;30;32;0.5;15;15;0;0.5
Control.SRR15539874;34;32;0.411764705882353;20;14;0.0882352941176471;0.411764705882353
Control.SRR15539874;30;32;0.533333333333333;14;16;0.0333333333333333;0.466666666666667
Control.SRR15539874;30;32;0.5;15;15;0;0.5
Control.SRR15539874;36;32;0.472222222222222;19;17;0.0277777777777778;0.472222222222222
Control.SRR15539874;28;32;0.642857142857143;10;18;0.142857142857143;0.357142857142857
Control.SRR15539874;36;32;0.555555555555556;16;20;0.0555555555555556;0.444444444444444
Control.SRR15539874;28;32;0.428571428571429;16;12;0.0714285714285715;0.428571428571429
Control.SRR15539874;31;32;0.612903225806452;12;19;0.112903225806452;0.387096774193548
Control.SRR15539874;35;32;0.542857142857143;16;19;0.0428571428571428;0.457142857142857
Control.SRR15539874;34;32;0.588235294117647;14;20;0.0882352941176471;0.411764705882353
Control.SRR15539874;30;32;0.566666666666667;13;17;0.0666666666666667;0.433333333333333
Control.SRR15539874;32;32;0.34375;21;11;0.15625;0.34375
Control.SRR15539874;32;32;0.53125;15;17;0.03125;0.46875
Control.SRR15539874;30;32;0.466666666666667;16;14;0.0333333333333333;0.466666666666667
Control.SRR15539874;28;32;0.571428571428571;12;16;0.0714285714285714;0.428571428571429
Control.SRR15539874;28;32;0.642857142857143;10;18;0.142857142857143;0.357142857142857
Control.SRR15539874;30;32;0.433333333333333;17;13;0.0666666666666667;0.433333333333333
Control.SRR15539874;34;32;0.441176470588235;19;15;0.0588235294117647;0.441176470588235
Control.SRR15539874;29;32;0.620689655172414;11;18;0.120689655172414;0.379310344827586
Control.SRR15539874;33;32;0.515151515151515;16;17;0.0151515151515151;0.484848484848485
Control.SRR15539874;29;32;0.620689655172414;11;18;0.120689655172414;0.379310344827586
Control.SRR15539874;29;32;0.482758620689655;15;14;0.0172413793103448;0.482758620689655
Control.SRR15539874;29;32;0.551724137931034;13;16;0.0517241379310345;0.448275862068966
Control.SRR15539874;28;32;0.428571428571429;16;12;0.0714285714285715;0.428571428571429
Control.SRR15539874;31;32;0.451612903225806;17;14;0.0483870967741936;0.451612903225806
Control.SRR15539874;31;32;0.387096774193548;19;12;0.112903225806452;0.387096774193548
Control.SRR15539874;32;32;0.46875;17;15;0.03125;0.46875
Control.SRR15539874;32;32;0.5;16;16;0;0.5
Control.SRR15539874;28;32;0.321428571428571;19;9;0.178571428571429;0.321428571428571
Control.SRR15539874;30;32;0.366666666666667;19;11;0.133333333333333;0.366666666666667
Control.SRR15539874;29;32;0.517241379310345;14;15;0.0172413793103449;0.482758620689655
Control.SRR15539874;34;32;0.441176470588235;19;15;0.0588235294117647;0.441176470588235
Control.SRR15539874;36;32;0.388888888888889;22;14;0.111111111111111;0.388888888888889
Control.SRR15539874;28;32;0.392857142857143;17;11;0.107142857142857;0.392857142857143
Control.SRR15539874;31;32;0.548387096774194;14;17;0.0483870967741935;0.451612903225806
Control.SRR15539874;31;32;0.645161290322581;11;20;0.145161290322581;0.354838709677419
Control.SRR15539874;34;32;0.529411764705882;16;18;0.0294117647058824;0.470588235294118
Control.SRR15539874;28;32;0.607142857142857;11;17;0.107142857142857;0.392857142857143
Control.SRR15539874;30;32;0.566666666666667;13;17;0.0666666666666667;0.433333333333333
Control.SRR15539874;36;32;0.472222222222222;19;17;0.0277777777777778;0.472222222222222
Control.SRR15539874;32;32;0.5625;14;18;0.0625;0.4375
Control.SRR15539874;28;32;0.428571428571429;16;12;0.0714285714285715;0.428571428571429
Control.SRR15539874;28;32;0.535714285714286;13;15;0.0357142857142857;0.464285714285714
Control.SRR15539874;28;32;0.678571428571429;9;19;0.178571428571429;0.321428571428571
Control.SRR15539874;28;32;0.535714285714286;13;15;0.0357142857142857;0.464285714285714
Control.SRR15539874;33;32;0.454545454545455;18;15;0.0454545454545455;0.454545454545455
Control.SRR15539874;35;32;0.342857142857143;23;12;0.157142857142857;0.342857142857143
Control.SRR15539874;29;32;0.413793103448276;17;12;0.0862068965517241;0.413793103448276
Control.SRR15539874;30;32;0.4;18;12;0.1;0.4
Control.SRR15539874;28;32;0.678571428571429;9;19;0.178571428571429;0.321428571428571
Control.SRR15539874;28;32;0.464285714285714;15;13;0.0357142857142857;0.464285714285714
Control.SRR15539874;28;32;0.535714285714286;13;15;0.0357142857142857;0.464285714285714
Control.SRR15539874;36;32;0.416666666666667;21;15;0.0833333333333333;0.416666666666667
Control.SRR15539874;33;32;0.515151515151515;16;17;0.0151515151515151;0.484848484848485
Control.SRR15539874;34;32;0.529411764705882;16;18;0.0294117647058824;0.470588235294118
Control.SRR15539874;30;32;0.5;15;15;0;0.5
Control.SRR15539874;32;32;0.59375;13;19;0.09375;0.40625
Control.SRR15539874;28;32;0.5;14;14;0;0.5
Control.SRR15539874;29;32;0.586206896551724;12;17;0.0862068965517241;0.413793103448276
Control.SRR15539874;28;32;0.571428571428571;12;16;0.0714285714285714;0.428571428571429
Control.SRR15539874;31;32;0.387096774193548;19;12;0.112903225806452;0.387096774193548
Control.SRR15539874;28;32;0.428571428571429;16;12;0.0714285714285715;0.428571428571429
Control.SRR15539874;33;32;0.545454545454545;15;18;0.0454545454545454;0.454545454545455
Control.SRR15539874;33;32;0.545454545454545;15;18;0.0454545454545454;0.454545454545455
Control.SRR15539874;29;32;0.551724137931034;13;16;0.0517241379310345;0.448275862068966
Control.SRR15539874;35;32;0.514285714285714;17;18;0.0142857142857142;0.485714285714286
Control.SRR15539874;31;32;0.451612903225806;17;14;0.0483870967741936;0.451612903225806
Control.SRR15539874;28;32;0.428571428571429;16;12;0.0714285714285715;0.428571428571429
Control.SRR15539874;32;32;0.53125;15;17;0.03125;0.46875
Control.SRR15539874;31;32;0.451612903225806;17;14;0.0483870967741936;0.451612903225806
Control.SRR15539874;32;32;0.53125;15;17;0.03125;0.46875
Control.SRR15539874;30;32;0.5;15;15;0;0.5
Control.SRR15539874;33;32;0.515151515151515;16;17;0.0151515151515151;0.484848484848485
Control.SRR15539874;32;32;0.53125;15;17;0.03125;0.46875
Control.SRR15539874;28;32;0.357142857142857;18;10;0.142857142857143;0.357142857142857
Control.SRR15539874;33;32;0.424242424242424;19;14;0.0757575757575757;0.424242424242424
Control.SRR15539874;31;32;0.612903225806452;12;19;0.112903225806452;0.387096774193548
Control.SRR15539874;36;32;0.472222222222222;19;17;0.0277777777777778;0.472222222222222
Control.SRR15539874;34;32;0.470588235294118;18;16;0.0294117647058824;0.470588235294118
Control.SRR15539874;32;32;0.4375;18;14;0.0625;0.4375
Control.SRR15539874;31;32;0.387096774193548;19;12;0.112903225806452;0.387096774193548
Control.SRR15539874;28;32;0.571428571428571;12;16;0.0714285714285714;0.428571428571429
Control.SRR15539874;33;32;0.484848484848485;17;16;0.0151515151515151;0.484848484848485
Control.SRR15539874;34;32;0.411764705882353;20;14;0.0882352941176471;0.411764705882353
Control.SRR15539874;28;32;0.321428571428571;19;9;0.178571428571429;0.321428571428571
Control.SRR15539874;34;32;0.647058823529412;12;22;0.147058823529412;0.352941176470588
Control.SRR15539874;31;32;0.483870967741935;16;15;0.0161290322580645;0.483870967741935
Control.SRR15539874;31;32;0.580645161290323;13;18;0.0806451612903226;0.419354838709677
Control.SRR15539874;28;32;0.535714285714286;13;15;0.0357142857142857;0.464285714285714
Control.SRR15539874;29;32;0.655172413793103;10;19;0.155172413793103;0.344827586206897
Control.SRR15539874;29;32;0.551724137931034;13;16;0.0517241379310345;0.448275862068966
Control.SRR15539874;28;32;0.428571428571429;16;12;0.0714285714285715;0.428571428571429
Control.SRR15539874;36;32;0.527777777777778;17;19;0.0277777777777778;0.472222222222222
Control.SRR15539874;34;32;0.5;17;17;0;0.5
Control.SRR15539874;35;32;0.314285714285714;24;11;0.185714285714286;0.314285714285714
Control.SRR15539874;32;32;0.53125;15;17;0.03125;0.46875
Control.SRR15539874;35;32;0.4;21;14;0.1;0.4
Control.SRR15539874;28;32;0.5;14;14;0;0.5
Control.SRR15539874;32;32;0.21875;25;7;0.28125;0.21875
Control.SRR15539874;28;32;0.642857142857143;10;18;0.142857142857143;0.357142857142857
Control.SRR15539874;31;32;0.387096774193548;19;12;0.112903225806452;0.387096774193548
Control.SRR15539874;28;32;0.535714285714286;13;15;0.0357142857142857;0.464285714285714
Control.SRR15539874;31;32;0.354838709677419;20;11;0.145161290322581;0.354838709677419
Control.SRR15539874;28;32;0.642857142857143;10;18;0.142857142857143;0.357142857142857
Control.SRR15539874;33;32;0.515151515151515;16;17;0.0151515151515151;0.484848484848485
Control.SRR15539874;30;32;0.366666666666667;19;11;0.133333333333333;0.366666666666667
Control.SRR15539874;28;32;0.428571428571429;16;12;0.0714285714285715;0.428571428571429
Control.SRR15539874;28;32;0.642857142857143;10;18;0.142857142857143;0.357142857142857
Control.SRR15539874;29;32;0.413793103448276;17;12;0.0862068965517241;0.413793103448276
Control.SRR15539874;31;32;0.419354838709677;18;13;0.0806451612903226;0.419354838709677
Control.SRR15539874;29;32;0.482758620689655;15;14;0.0172413793103448;0.482758620689655
Control.SRR15539874;35;32;0.571428571428571;15;20;0.0714285714285714;0.428571428571429
Control.SRR15539874;36;32;0.666666666666667;12;24;0.166666666666667;0.333333333333333
Control.SRR15539874;36;32;0.555555555555556;16;20;0.0555555555555556;0.444444444444444
Control.SRR15539874;33;32;0.606060606060606;13;20;0.106060606060606;0.393939393939394
Control.SRR15539874;29;32;0.620689655172414;11;18;0.120689655172414;0.379310344827586
Control.SRR15539874;32;32;0.5;16;16;0;0.5
Control.SRR15539874;28;32;0.428571428571429;16;12;0.0714285714285715;0.428571428571429
Control.SRR15539874;35;32;0.4;21;14;0.1;0.4
Control.SRR15539874;33;32;0.333333333333333;22;11;0.166666666666667;0.333333333333333
Control.SRR15539874;34;32;0.5;17;17;0;0.5
Control.SRR15539874;29;32;0.655172413793103;10;19;0.155172413793103;0.344827586206897
Control.SRR15539874;31;32;0.483870967741935;16;15;0.0161290322580645;0.483870967741935
Control.SRR15539874;29;32;0.413793103448276;17;12;0.0862068965517241;0.413793103448276
Control.SRR15539874;34;32;0.529411764705882;16;18;0.0294117647058824;0.470588235294118
Control.SRR15539874;35;32;0.485714285714286;18;17;0.0142857142857143;0.485714285714286
Control.SRR15539874;36;32;0.472222222222222;19;17;0.0277777777777778;0.472222222222222
Control.SRR15539874;36;32;0.638888888888889;13;23;0.138888888888889;0.361111111111111
Control.SRR15539874;33;32;0.333333333333333;22;11;0.166666666666667;0.333333333333333
Control.SRR15539874;29;32;0.551724137931034;13;16;0.0517241379310345;0.448275862068966
Control.SRR15539874;37;32;0.567567567567568;16;21;0.0675675675675675;0.432432432432432
Control.SRR15539874;30;32;0.633333333333333;11;19;0.133333333333333;0.366666666666667
Control.SRR15539874;31;32;0.483870967741935;16;15;0.0161290322580645;0.483870967741935
Control.SRR15539874;31;32;0.612903225806452;12;19;0.112903225806452;0.387096774193548
Control.SRR15539874;35;32;0.457142857142857;19;16;0.0428571428571429;0.457142857142857
Control.SRR15539874;32;32;0.5;16;16;0;0.5
Control.SRR15539874;33;32;0.484848484848485;17;16;0.0151515151515151;0.484848484848485
Control.SRR15539874;30;32;0.366666666666667;19;11;0.133333333333333;0.366666666666667
Control.SRR15539874;36;32;0.444444444444444;20;16;0.0555555555555556;0.444444444444444
Control.SRR15539874;35;32;0.628571428571429;13;22;0.128571428571429;0.371428571428571
Control.SRR15539874;29;32;0.586206896551724;12;17;0.0862068965517241;0.413793103448276
Control.SRR15539874;34;32;0.382352941176471;21;13;0.117647058823529;0.382352941176471
Control.SRR15539874;29;32;0.413793103448276;17;12;0.0862068965517241;0.413793103448276
Control.SRR15539874;32;32;0.5625;14;18;0.0625;0.4375
Control.SRR15539874;33;32;0.424242424242424;19;14;0.0757575757575757;0.424242424242424
Control.SRR15539874;34;32;0.411764705882353;20;14;0.0882352941176471;0.411764705882353
Control.SRR15539874;36;32;0.527777777777778;17;19;0.0277777777777778;0.472222222222222
Control.SRR15539874;31;32;0.548387096774194;14;17;0.0483870967741935;0.451612903225806
Control.SRR15539874;33;32;0.545454545454545;15;18;0.0454545454545454;0.454545454545455
Control.SRR15539874;30;32;0.3;21;9;0.2;0.3
Control.SRR15539874;30;32;0.533333333333333;14;16;0.0333333333333333;0.466666666666667
Control.SRR15539874;32;32;0.53125;15;17;0.03125;0.46875
Control.SRR15539874;29;32;0.482758620689655;15;14;0.0172413793103448;0.482758620689655
Control.SRR15539874;36;32;0.5;18;18;0;0.5
Control.SRR15539874;29;32;0.379310344827586;18;11;0.120689655172414;0.379310344827586
Control.SRR15539874;30;32;0.533333333333333;14;16;0.0333333333333333;0.466666666666667
Control.SRR15539874;37;32;0.459459459459459;20;17;0.0405405405405405;0.459459459459459
Control.SRR15539874;35;32;0.342857142857143;23;12;0.157142857142857;0.342857142857143
Control.SRR15539874;31;32;0.516129032258065;15;16;0.0161290322580645;0.483870967741935
Control.SRR15539874;36;32;0.527777777777778;17;19;0.0277777777777778;0.472222222222222
Control.SRR15539874;35;32;0.4;21;14;0.1;0.4
Control.SRR15539874;34;32;0.411764705882353;20;14;0.0882352941176471;0.411764705882353
Control.SRR15539874;30;32;0.633333333333333;11;19;0.133333333333333;0.366666666666667
Control.SRR15539874;35;32;0.6;14;21;0.1;0.4
Control.SRR15539874;35;32;0.514285714285714;17;18;0.0142857142857142;0.485714285714286
Control.SRR15539874;34;32;0.676470588235294;11;23;0.176470588235294;0.323529411764706
Control.SRR15539874;33;32;0.484848484848485;17;16;0.0151515151515151;0.484848484848485
Control.SRR15539874;35;32;0.571428571428571;15;20;0.0714285714285714;0.428571428571429
Control.SRR15539874;30;32;0.333333333333333;20;10;0.166666666666667;0.333333333333333
Control.SRR15539874;36;32;0.472222222222222;19;17;0.0277777777777778;0.472222222222222
Control.SRR15539874;35;32;0.542857142857143;16;19;0.0428571428571428;0.457142857142857
Control.SRR15539874;35;32;0.571428571428571;15;20;0.0714285714285714;0.428571428571429
Control.SRR15539874;32;32;0.6875;10;22;0.1875;0.3125
Control.SRR15539874;33;32;0.636363636363636;12;21;0.136363636363636;0.363636363636364
Control.SRR15539874;37;32;0.540540540540541;17;20;0.0405405405405406;0.459459459459459
Control.SRR15539874;35;32;0.457142857142857;19;16;0.0428571428571429;0.457142857142857
Control.SRR15539874;33;32;0.606060606060606;13;20;0.106060606060606;0.393939393939394
Control.SRR15539874;33;32;0.636363636363636;12;21;0.136363636363636;0.363636363636364
Control.SRR15539874;34;32;0.558823529411765;15;19;0.0588235294117647;0.441176470588235
Control.SRR15539874;34;32;0.5;17;17;0;0.5
Control.SRR15539874;31;32;0.580645161290323;13;18;0.0806451612903226;0.419354838709677
Control.SRR15539874;30;32;0.633333333333333;11;19;0.133333333333333;0.366666666666667
Control.SRR15539874;37;32;0.513513513513513;18;19;0.0135135135135135;0.486486486486487
Control.SRR15539874;33;32;0.545454545454545;15;18;0.0454545454545454;0.454545454545455
Control.SRR15539874;32;32;0.4375;18;14;0.0625;0.4375
Control.SRR15539874;34;32;0.352941176470588;22;12;0.147058823529412;0.352941176470588
Control.SRR15539874;32;32;0.4375;18;14;0.0625;0.4375
Control.SRR15539874;32;32;0.375;20;12;0.125;0.375
Control.SRR15539874;32;32;0.5;16;16;0;0.5
Control.SRR15539874;30;32;0.5;15;15;0;0.5
Control.SRR15539874;33;32;0.545454545454545;15;18;0.0454545454545454;0.454545454545455
Control.SRR15539874;36;32;0.472222222222222;19;17;0.0277777777777778;0.472222222222222
Control.SRR15539874;37;32;0.486486486486487;19;18;0.0135135135135135;0.486486486486487
Control.SRR15539874;37;32;0.567567567567568;16;21;0.0675675675675675;0.432432432432432
Control.SRR15539874;37;32;0.594594594594595;15;22;0.0945945945945946;0.405405405405405
Control.SRR15539874;32;32;0.5625;14;18;0.0625;0.4375
Control.SRR15539874;37;32;0.405405405405405;22;15;0.0945945945945946;0.405405405405405
Control.SRR15539874;31;32;0.32258064516129;21;10;0.17741935483871;0.32258064516129
Control.SRR15539874;32;32;0.5;16;16;0;0.5
Control.SRR15539874;35;32;0.542857142857143;16;19;0.0428571428571428;0.457142857142857
Control.SRR15539874;35;32;0.6;14;21;0.1;0.4
Control.SRR15539874;31;32;0.387096774193548;19;12;0.112903225806452;0.387096774193548
Control.SRR15539874;32;32;0.53125;15;17;0.03125;0.46875
Control.SRR15539874;35;32;0.571428571428571;15;20;0.0714285714285714;0.428571428571429
Control.SRR15539874;31;32;0.645161290322581;11;20;0.145161290322581;0.354838709677419
Control.SRR15539874;34;32;0.411764705882353;20;14;0.0882352941176471;0.411764705882353
Control.SRR15539874;31;32;0.516129032258065;15;16;0.0161290322580645;0.483870967741935
Control.SRR15539874;33;32;0.606060606060606;13;20;0.106060606060606;0.393939393939394
Control.SRR15539874;32;32;0.375;20;12;0.125;0.375
Control.SRR15539874;32;32;0.53125;15;17;0.03125;0.46875
Control.SRR15539874;29;32;0.379310344827586;18;11;0.120689655172414;0.379310344827586
Control.SRR15539874;33;32;0.545454545454545;15;18;0.0454545454545454;0.454545454545455
Control.SRR15539874;36;32;0.5;18;18;0;0.5
Control.SRR15539874;34;32;0.529411764705882;16;18;0.0294117647058824;0.470588235294118
Control.SRR15539874;34;32;0.558823529411765;15;19;0.0588235294117647;0.441176470588235
Control.SRR15539874;34;32;0.529411764705882;16;18;0.0294117647058824;0.470588235294118
Control.SRR15539874;29;32;0.586206896551724;12;17;0.0862068965517241;0.413793103448276
Control.SRR15539874;31;32;0.548387096774194;14;17;0.0483870967741935;0.451612903225806
Control.SRR15539874;32;32;0.46875;17;15;0.03125;0.46875
Control.SRR15539874;35;32;0.571428571428571;15;20;0.0714285714285714;0.428571428571429
Control.SRR15539874;33;32;0.424242424242424;19;14;0.0757575757575757;0.424242424242424
Control.SRR15539874;37;32;0.513513513513513;18;19;0.0135135135135135;0.486486486486487
Control.SRR15539874;30;32;0.333333333333333;20;10;0.166666666666667;0.333333333333333
Control.SRR15539874;30;32;0.566666666666667;13;17;0.0666666666666667;0.433333333333333
Control.SRR15539874;34;32;0.441176470588235;19;15;0.0588235294117647;0.441176470588235
Control.SRR15539874;34;32;0.411764705882353;20;14;0.0882352941176471;0.411764705882353
Control.SRR15539874;33;32;0.575757575757576;14;19;0.0757575757575758;0.424242424242424
Control.SRR15539874;34;32;0.558823529411765;15;19;0.0588235294117647;0.441176470588235
Control.SRR15539874;31;32;0.741935483870968;8;23;0.241935483870968;0.258064516129032
Control.SRR15539874;29;32;0.655172413793103;10;19;0.155172413793103;0.344827586206897
Control.SRR15539874;35;32;0.571428571428571;15;20;0.0714285714285714;0.428571428571429
Control.SRR15539874;37;32;0.351351351351351;24;13;0.148648648648649;0.351351351351351
Control.SRR15539874;35;32;0.4;21;14;0.1;0.4
Control.SRR15539874;37;32;0.513513513513513;18;19;0.0135135135135135;0.486486486486487
Control.SRR15539874;32;32;0.5625;14;18;0.0625;0.4375
Control.SRR15539874;30;32;0.4;18;12;0.1;0.4
Control.SRR15539874;35;32;0.4;21;14;0.1;0.4
Control.SRR15539874;35;32;0.428571428571429;20;15;0.0714285714285715;0.428571428571429
Control.SRR15539874;34;32;0.558823529411765;15;19;0.0588235294117647;0.441176470588235
Control.SRR15539874;32;32;0.53125;15;17;0.03125;0.46875
Control.SRR15539874;30;32;0.5;15;15;0;0.5
Control.SRR15539874;32;32;0.40625;19;13;0.09375;0.40625
Control.SRR15539874;29;32;0.551724137931034;13;16;0.0517241379310345;0.448275862068966
Control.SRR15539874;31;32;0.645161290322581;11;20;0.145161290322581;0.354838709677419
Control.SRR15539874;33;32;0.484848484848485;17;16;0.0151515151515151;0.484848484848485
Control.SRR15539874;37;32;0.459459459459459;20;17;0.0405405405405405;0.459459459459459
Control.SRR15539874;34;32;0.382352941176471;21;13;0.117647058823529;0.382352941176471
Control.SRR15539874;36;32;0.611111111111111;14;22;0.111111111111111;0.388888888888889
Control.SRR15539874;34;32;0.352941176470588;22;12;0.147058823529412;0.352941176470588
Control.SRR15539874;33;32;0.545454545454545;15;18;0.0454545454545454;0.454545454545455
Control.SRR15539874;32;32;0.5625;14;18;0.0625;0.4375
Control.SRR15539874;29;32;0.655172413793103;10;19;0.155172413793103;0.344827586206897
Control.SRR15539874;30;32;0.5;15;15;0;0.5
Control.SRR15539874;30;32;0.466666666666667;16;14;0.0333333333333333;0.466666666666667
Control.SRR15539874;37;32;0.594594594594595;15;22;0.0945945945945946;0.405405405405405
Control.SRR15539874;32;32;0.59375;13;19;0.09375;0.40625
Control.SRR15539874;32;32;0.5625;14;18;0.0625;0.4375
Control.SRR15539874;31;32;0.67741935483871;10;21;0.17741935483871;0.32258064516129
Control.SRR15539874;35;32;0.457142857142857;19;16;0.0428571428571429;0.457142857142857
Control.SRR15539874;34;32;0.470588235294118;18;16;0.0294117647058824;0.470588235294118
Control.SRR15539874;30;32;0.633333333333333;11;19;0.133333333333333;0.366666666666667
Control.SRR15539874;35;32;0.485714285714286;18;17;0.0142857142857143;0.485714285714286
Control.SRR15539874;32;32;0.53125;15;17;0.03125;0.46875
Control.SRR15539874;31;32;0.709677419354839;9;22;0.209677419354839;0.290322580645161
Control.SRR15539874;30;32;0.466666666666667;16;14;0.0333333333333333;0.466666666666667
Control.SRR15539874;37;32;0.513513513513513;18;19;0.0135135135135135;0.486486486486487
Control.SRR15539874;34;32;0.588235294117647;14;20;0.0882352941176471;0.411764705882353
Control.SRR15539874;34;32;0.558823529411765;15;19;0.0588235294117647;0.441176470588235
Control.SRR15539874;36;32;0.472222222222222;19;17;0.0277777777777778;0.472222222222222
Control.SRR15539874;33;32;0.454545454545455;18;15;0.0454545454545455;0.454545454545455
Control.SRR15539874;33;32;0.515151515151515;16;17;0.0151515151515151;0.484848484848485
Control.SRR15539874;29;32;0.586206896551724;12;17;0.0862068965517241;0.413793103448276
Control.SRR15539874;33;32;0.424242424242424;19;14;0.0757575757575757;0.424242424242424
Control.SRR15539874;33;32;0.393939393939394;20;13;0.106060606060606;0.393939393939394
Control.SRR15539874;35;32;0.571428571428571;15;20;0.0714285714285714;0.428571428571429
Control.SRR15539874;37;32;0.594594594594595;15;22;0.0945945945945946;0.405405405405405
Control.SRR15539874;33;32;0.575757575757576;14;19;0.0757575757575758;0.424242424242424
Control.SRR15539874;30;32;0.533333333333333;14;16;0.0333333333333333;0.466666666666667
Control.SRR15539874;33;32;0.575757575757576;14;19;0.0757575757575758;0.424242424242424
Control.SRR15539874;32;32;0.6875;10;22;0.1875;0.3125
Control.SRR15539874;29;32;0.655172413793103;10;19;0.155172413793103;0.344827586206897
Control.SRR15539874;34;32;0.411764705882353;20;14;0.0882352941176471;0.411764705882353
Control.SRR15539874;35;32;0.6;14;21;0.1;0.4
Control.SRR15539874;37;32;0.540540540540541;17;20;0.0405405405405406;0.459459459459459
Control.SRR15539874;34;32;0.558823529411765;15;19;0.0588235294117647;0.441176470588235
Control.SRR15539874;30;32;0.7;9;21;0.2;0.3
Control.SRR15539874;29;32;0.482758620689655;15;14;0.0172413793103448;0.482758620689655
Control.SRR15539874;29;32;0.448275862068966;16;13;0.0517241379310345;0.448275862068966
Control.SRR15539874;30;32;0.666666666666667;10;20;0.166666666666667;0.333333333333333
Control.SRR15539874;32;32;0.65625;11;21;0.15625;0.34375
Control.SRR15539874;33;32;0.484848484848485;17;16;0.0151515151515151;0.484848484848485
Control.SRR15539874;36;32;0.416666666666667;21;15;0.0833333333333333;0.416666666666667
Control.SRR15539874;36;32;0.583333333333333;15;21;0.0833333333333334;0.416666666666667
Control.SRR15539874;31;32;0.451612903225806;17;14;0.0483870967741936;0.451612903225806
Control.SRR15539874;30;32;0.7;9;21;0.2;0.3
Control.SRR15539874;35;32;0.4;21;14;0.1;0.4
Control.SRR15539874;33;32;0.575757575757576;14;19;0.0757575757575758;0.424242424242424
Control.SRR15539874;37;32;0.513513513513513;18;19;0.0135135135135135;0.486486486486487
Control.SRR15539874;31;32;0.451612903225806;17;14;0.0483870967741936;0.451612903225806
Control.SRR15539874;34;32;0.470588235294118;18;16;0.0294117647058824;0.470588235294118
Control.SRR15539874;36;32;0.555555555555556;16;20;0.0555555555555556;0.444444444444444
Control.SRR15539874;36;32;0.5;18;18;0;0.5
Control.SRR15539874;37;32;0.540540540540541;17;20;0.0405405405405406;0.459459459459459
Control.SRR15539874;29;32;0.655172413793103;10;19;0.155172413793103;0.344827586206897
Control.SRR15539874;34;32;0.588235294117647;14;20;0.0882352941176471;0.411764705882353
Control.SRR15539874;37;32;0.513513513513513;18;19;0.0135135135135135;0.486486486486487
Control.SRR15539874;29;32;0.482758620689655;15;14;0.0172413793103448;0.482758620689655
Control.SRR15539874;29;32;0.689655172413793;9;20;0.189655172413793;0.310344827586207
Control.SRR15539874;31;32;0.483870967741935;16;15;0.0161290322580645;0.483870967741935
Control.SRR15539874;37;32;0.513513513513513;18;19;0.0135135135135135;0.486486486486487
Control.SRR15539874;34;32;0.588235294117647;14;20;0.0882352941176471;0.411764705882353
Control.SRR15539874;33;32;0.484848484848485;17;16;0.0151515151515151;0.484848484848485
Control.SRR15539874;33;32;0.333333333333333;22;11;0.166666666666667;0.333333333333333
Control.SRR15539874;35;32;0.457142857142857;19;16;0.0428571428571429;0.457142857142857
Control.SRR15539874;31;32;0.419354838709677;18;13;0.0806451612903226;0.419354838709677
Control.SRR15539874;33;32;0.303030303030303;23;10;0.196969696969697;0.303030303030303
Control.SRR15539874;33;32;0.515151515151515;16;17;0.0151515151515151;0.484848484848485
Control.SRR15539874;35;32;0.371428571428571;22;13;0.128571428571429;0.371428571428571
Control.SRR15539874;29;32;0.413793103448276;17;12;0.0862068965517241;0.413793103448276
Control.SRR15539874;29;32;0.689655172413793;9;20;0.189655172413793;0.310344827586207
Control.SRR15539874;33;32;0.393939393939394;20;13;0.106060606060606;0.393939393939394
Control.SRR15539874;35;32;0.628571428571429;13;22;0.128571428571429;0.371428571428571
Control.SRR15539874;33;32;0.303030303030303;23;10;0.196969696969697;0.303030303030303
Control.SRR15539874;34;32;0.441176470588235;19;15;0.0588235294117647;0.441176470588235
Control.SRR15539874;37;32;0.486486486486487;19;18;0.0135135135135135;0.486486486486487
Control.SRR15539874;33;32;0.484848484848485;17;16;0.0151515151515151;0.484848484848485
Control.SRR15539874;37;32;0.459459459459459;20;17;0.0405405405405405;0.459459459459459
Control.SRR15539874;34;32;0.235294117647059;26;8;0.264705882352941;0.235294117647059
Control.SRR15539874;34;32;0.647058823529412;12;22;0.147058823529412;0.352941176470588
Control.SRR15539874;36;32;0.555555555555556;16;20;0.0555555555555556;0.444444444444444
Control.SRR15539874;36;32;0.666666666666667;12;24;0.166666666666667;0.333333333333333
Control.SRR15539874;33;32;0.454545454545455;18;15;0.0454545454545455;0.454545454545455
Control.SRR15539874;37;32;0.540540540540541;17;20;0.0405405405405406;0.459459459459459
Control.SRR15539874;37;32;0.513513513513513;18;19;0.0135135135135135;0.486486486486487
Control.SRR15539874;30;32;0.433333333333333;17;13;0.0666666666666667;0.433333333333333
Control.SRR15539874;37;32;0.432432432432432;21;16;0.0675675675675675;0.432432432432432
Control.SRR15539874;32;32;0.46875;17;15;0.03125;0.46875
Control.SRR15539874;31;32;0.516129032258065;15;16;0.0161290322580645;0.483870967741935
Control.SRR15539874;33;32;0.515151515151515;16;17;0.0151515151515151;0.484848484848485
Control.SRR15539874;30;32;0.433333333333333;17;13;0.0666666666666667;0.433333333333333
Control.SRR15539874;36;32;0.444444444444444;20;16;0.0555555555555556;0.444444444444444
Control.SRR15539874;37;32;0.459459459459459;20;17;0.0405405405405405;0.459459459459459
Control.SRR15539874;35;32;0.428571428571429;20;15;0.0714285714285715;0.428571428571429
Control.SRR15539874;30;32;0.366666666666667;19;11;0.133333333333333;0.366666666666667
Control.SRR15539874;35;32;0.457142857142857;19;16;0.0428571428571429;0.457142857142857
Control.SRR15539874;33;32;0.393939393939394;20;13;0.106060606060606;0.393939393939394
Control.SRR15539874;29;32;0.551724137931034;13;16;0.0517241379310345;0.448275862068966
Control.SRR15539874;37;32;0.486486486486487;19;18;0.0135135135135135;0.486486486486487
Control.SRR15539874;32;32;0.5;16;16;0;0.5
Control.SRR15539874;37;32;0.567567567567568;16;21;0.0675675675675675;0.432432432432432
Control.SRR15539874;36;32;0.5;18;18;0;0.5
Control.SRR15539874;35;32;0.542857142857143;16;19;0.0428571428571428;0.457142857142857
Control.SRR15539874;32;32;0.40625;19;13;0.09375;0.40625
Control.SRR15539874;32;32;0.21875;25;7;0.28125;0.21875
Control.SRR15539874;33;32;0.454545454545455;18;15;0.0454545454545455;0.454545454545455
Control.SRR15539874;34;32;0.529411764705882;16;18;0.0294117647058824;0.470588235294118
Control.SRR15539874;34;32;0.588235294117647;14;20;0.0882352941176471;0.411764705882353
Control.SRR15539874;34;32;0.5;17;17;0;0.5
Control.SRR15539874;30;32;0.433333333333333;17;13;0.0666666666666667;0.433333333333333
Control.SRR15539874;37;32;0.459459459459459;20;17;0.0405405405405405;0.459459459459459
Control.SRR15539874;32;32;0.375;20;12;0.125;0.375
Control.SRR15539874;35;32;0.542857142857143;16;19;0.0428571428571428;0.457142857142857
Control.SRR15539874;31;32;0.451612903225806;17;14;0.0483870967741936;0.451612903225806
Control.SRR15539874;33;32;0.484848484848485;17;16;0.0151515151515151;0.484848484848485
Control.SRR15539874;31;32;0.451612903225806;17;14;0.0483870967741936;0.451612903225806
Control.SRR15539874;32;32;0.5625;14;18;0.0625;0.4375
Control.SRR15539874;33;32;0.545454545454545;15;18;0.0454545454545454;0.454545454545455
Control.SRR15539874;30;32;0.6;12;18;0.1;0.4
Control.SRR15539874;31;32;0.419354838709677;18;13;0.0806451612903226;0.419354838709677
Control.SRR15539874;31;32;0.516129032258065;15;16;0.0161290322580645;0.483870967741935
Control.SRR15539874;34;32;0.470588235294118;18;16;0.0294117647058824;0.470588235294118
Control.SRR15539874;29;32;0.413793103448276;17;12;0.0862068965517241;0.413793103448276
Control.SRR15539874;34;32;0.558823529411765;15;19;0.0588235294117647;0.441176470588235
Control.SRR15539874;36;32;0.416666666666667;21;15;0.0833333333333333;0.416666666666667
Control.SRR15539874;29;32;0.413793103448276;17;12;0.0862068965517241;0.413793103448276
Control.SRR15539874;37;32;0.432432432432432;21;16;0.0675675675675675;0.432432432432432
Control.SRR15539874;36;32;0.527777777777778;17;19;0.0277777777777778;0.472222222222222
Control.SRR15539874;36;32;0.361111111111111;23;13;0.138888888888889;0.361111111111111
Control.SRR15539874;31;32;0.516129032258065;15;16;0.0161290322580645;0.483870967741935
Control.SRR15539874;33;32;0.454545454545455;18;15;0.0454545454545455;0.454545454545455
Control.SRR15539874;35;32;0.571428571428571;15;20;0.0714285714285714;0.428571428571429
Control.SRR15539874;33;32;0.484848484848485;17;16;0.0151515151515151;0.484848484848485
Control.SRR15539874;33;32;0.575757575757576;14;19;0.0757575757575758;0.424242424242424
Control.SRR15539874;31;32;0.67741935483871;10;21;0.17741935483871;0.32258064516129
Control.SRR15539874;31;32;0.645161290322581;11;20;0.145161290322581;0.354838709677419
Control.SRR15539874;29;32;0.482758620689655;15;14;0.0172413793103448;0.482758620689655
Control.SRR15539874;33;32;0.515151515151515;16;17;0.0151515151515151;0.484848484848485
Control.SRR15539874;33;32;0.575757575757576;14;19;0.0757575757575758;0.424242424242424
Control.SRR15539874;37;32;0.459459459459459;20;17;0.0405405405405405;0.459459459459459
Control.SRR15539874;33;32;0.484848484848485;17;16;0.0151515151515151;0.484848484848485
Control.SRR15539874;33;32;0.424242424242424;19;14;0.0757575757575757;0.424242424242424
Control.SRR15539874;37;32;0.486486486486487;19;18;0.0135135135135135;0.486486486486487
Control.SRR15539874;30;32;0.5;15;15;0;0.5
Control.SRR15539874;33;32;0.515151515151515;16;17;0.0151515151515151;0.484848484848485
Control.SRR15539874;35;32;0.542857142857143;16;19;0.0428571428571428;0.457142857142857
Control.SRR15539874;34;32;0.470588235294118;18;16;0.0294117647058824;0.470588235294118
Control.SRR15539874;29;32;0.448275862068966;16;13;0.0517241379310345;0.448275862068966
Control.SRR15539874;36;32;0.555555555555556;16;20;0.0555555555555556;0.444444444444444
Control.SRR15539874;29;32;0.586206896551724;12;17;0.0862068965517241;0.413793103448276
Control.SRR15539874;31;32;0.516129032258065;15;16;0.0161290322580645;0.483870967741935
Control.SRR15539874;35;32;0.371428571428571;22;13;0.128571428571429;0.371428571428571
Control.SRR15539874;36;32;0.388888888888889;22;14;0.111111111111111;0.388888888888889
Control.SRR15539874;33;32;0.454545454545455;18;15;0.0454545454545455;0.454545454545455
Control.SRR15539874;33;32;0.606060606060606;13;20;0.106060606060606;0.393939393939394
Control.SRR15539874;33;32;0.515151515151515;16;17;0.0151515151515151;0.484848484848485
Control.SRR15539874;37;32;0.540540540540541;17;20;0.0405405405405406;0.459459459459459
Control.SRR15539874;31;32;0.483870967741935;16;15;0.0161290322580645;0.483870967741935
Control.SRR15539874;36;32;0.444444444444444;20;16;0.0555555555555556;0.444444444444444
Control.SRR15539874;36;32;0.527777777777778;17;19;0.0277777777777778;0.472222222222222
Control.SRR15539874;33;32;0.515151515151515;16;17;0.0151515151515151;0.484848484848485
Control.SRR15539874;37;32;0.486486486486487;19;18;0.0135135135135135;0.486486486486487
Control.SRR15539874;35;32;0.485714285714286;18;17;0.0142857142857143;0.485714285714286
Control.SRR15539874;31;32;0.516129032258065;15;16;0.0161290322580645;0.483870967741935
Control.SRR15539874;32;32;0.59375;13;19;0.09375;0.40625
Control.SRR15539874;33;32;0.636363636363636;12;21;0.136363636363636;0.363636363636364
Control.SRR15539874;31;32;0.419354838709677;18;13;0.0806451612903226;0.419354838709677
Control.SRR15539874;34;32;0.647058823529412;12;22;0.147058823529412;0.352941176470588
Control.SRR15539874;34;32;0.647058823529412;12;22;0.147058823529412;0.352941176470588
Control.SRR15539874;31;32;0.580645161290323;13;18;0.0806451612903226;0.419354838709677
Control.SRR15539874;35;32;0.571428571428571;15;20;0.0714285714285714;0.428571428571429
Control.SRR15539874;34;32;0.529411764705882;16;18;0.0294117647058824;0.470588235294118
Control.SRR15539874;33;32;0.454545454545455;18;15;0.0454545454545455;0.454545454545455
Control.SRR15539874;33;32;0.545454545454545;15;18;0.0454545454545454;0.454545454545455
Control.SRR15539874;36;32;0.472222222222222;19;17;0.0277777777777778;0.472222222222222
Control.SRR15539874;36;32;0.527777777777778;17;19;0.0277777777777778;0.472222222222222
Control.SRR15539874;36;32;0.5;18;18;0;0.5
Control.SRR15539874;35;32;0.571428571428571;15;20;0.0714285714285714;0.428571428571429
Control.SRR15539874;36;32;0.472222222222222;19;17;0.0277777777777778;0.472222222222222
Control.SRR15539874;36;32;0.444444444444444;20;16;0.0555555555555556;0.444444444444444
Control.SRR15539874;37;32;0.567567567567568;16;21;0.0675675675675675;0.432432432432432
Control.SRR15539874;31;32;0.419354838709677;18;13;0.0806451612903226;0.419354838709677
Control.SRR15539874;34;32;0.470588235294118;18;16;0.0294117647058824;0.470588235294118
Control.SRR15539874;30;32;0.533333333333333;14;16;0.0333333333333333;0.466666666666667
Control.SRR15539874;31;32;0.548387096774194;14;17;0.0483870967741935;0.451612903225806
Control.SRR15539874;37;32;0.324324324324324;25;12;0.175675675675676;0.324324324324324
Control.SRR15539874;36;32;0.611111111111111;14;22;0.111111111111111;0.388888888888889
Control.SRR15539874;31;32;0.483870967741935;16;15;0.0161290322580645;0.483870967741935
Control.SRR15539874;34;32;0.558823529411765;15;19;0.0588235294117647;0.441176470588235
Control.SRR15539874;35;32;0.514285714285714;17;18;0.0142857142857142;0.485714285714286
Control.SRR15539874;34;32;0.558823529411765;15;19;0.0588235294117647;0.441176470588235
Control.SRR15539874;36;32;0.5;18;18;0;0.5
Control.SRR15539874;31;32;0.612903225806452;12;19;0.112903225806452;0.387096774193548
Control.SRR15539874;36;32;0.444444444444444;20;16;0.0555555555555556;0.444444444444444
Control.SRR15539874;36;32;0.5;18;18;0;0.5
Control.SRR15539874;37;32;0.432432432432432;21;16;0.0675675675675675;0.432432432432432
Control.SRR15539874;35;32;0.457142857142857;19;16;0.0428571428571429;0.457142857142857
Control.SRR15539874;36;32;0.555555555555556;16;20;0.0555555555555556;0.444444444444444
Control.SRR15539874;35;32;0.6;14;21;0.1;0.4
Control.SRR15539874;37;32;0.621621621621622;14;23;0.121621621621622;0.378378378378378
Control.SRR15539874;37;32;0.459459459459459;20;17;0.0405405405405405;0.459459459459459
Control.SRR15539874;35;32;0.485714285714286;18;17;0.0142857142857143;0.485714285714286
Control.SRR15539874;30;32;0.433333333333333;17;13;0.0666666666666667;0.433333333333333
Control.SRR15539874;34;32;0.558823529411765;15;19;0.0588235294117647;0.441176470588235
Control.SRR15539874;37;32;0.432432432432432;21;16;0.0675675675675675;0.432432432432432
Control.SRR15539874;32;32;0.3125;22;10;0.1875;0.3125
Control.SRR15539874;32;32;0.53125;15;17;0.03125;0.46875
Control.SRR15539874;33;32;0.484848484848485;17;16;0.0151515151515151;0.484848484848485
Control.SRR15539874;29;32;0.620689655172414;11;18;0.120689655172414;0.379310344827586
Control.SRR15539874;37;32;0.540540540540541;17;20;0.0405405405405406;0.459459459459459
Control.SRR15539874;36;32;0.388888888888889;22;14;0.111111111111111;0.388888888888889
Control.SRR15539874;31;32;0.419354838709677;18;13;0.0806451612903226;0.419354838709677
Control.SRR15539874;35;32;0.457142857142857;19;16;0.0428571428571429;0.457142857142857
Control.SRR15539874;35;32;0.542857142857143;16;19;0.0428571428571428;0.457142857142857
Control.SRR15539874;30;32;0.5;15;15;0;0.5
Control.SRR15539874;37;32;0.432432432432432;21;16;0.0675675675675675;0.432432432432432
Control.SRR15539874;32;32;0.53125;15;17;0.03125;0.46875
Control.SRR15539874;29;32;0.517241379310345;14;15;0.0172413793103449;0.482758620689655
Control.SRR15539874;33;32;0.575757575757576;14;19;0.0757575757575758;0.424242424242424
Control.SRR15539874;37;32;0.378378378378378;23;14;0.121621621621622;0.378378378378378
Control.SRR15539874;37;32;0.486486486486487;19;18;0.0135135135135135;0.486486486486487
Control.SRR15539874;31;32;0.387096774193548;19;12;0.112903225806452;0.387096774193548
Control.SRR15539874;29;32;0.413793103448276;17;12;0.0862068965517241;0.413793103448276
Control.SRR15539874;35;32;0.285714285714286;25;10;0.214285714285714;0.285714285714286
Control.SRR15539874;32;32;0.625;12;20;0.125;0.375
Control.SRR15539874;33;32;0.515151515151515;16;17;0.0151515151515151;0.484848484848485
Control.SRR15539874;35;32;0.457142857142857;19;16;0.0428571428571429;0.457142857142857
Control.SRR15539874;36;32;0.416666666666667;21;15;0.0833333333333333;0.416666666666667
Control.SRR15539874;31;32;0.354838709677419;20;11;0.145161290322581;0.354838709677419
Control.SRR15539874;34;32;0.529411764705882;16;18;0.0294117647058824;0.470588235294118
Control.SRR15539874;31;32;0.483870967741935;16;15;0.0161290322580645;0.483870967741935
Control.SRR15539874;32;32;0.46875;17;15;0.03125;0.46875
Control.SRR15539874;36;32;0.5;18;18;0;0.5
Control.SRR15539874;31;32;0.419354838709677;18;13;0.0806451612903226;0.419354838709677
Control.SRR15539874;32;32;0.375;20;12;0.125;0.375
Control.SRR15539874;37;32;0.405405405405405;22;15;0.0945945945945946;0.405405405405405
Control.SRR15539874;34;32;0.470588235294118;18;16;0.0294117647058824;0.470588235294118
Control.SRR15539874;37;32;0.594594594594595;15;22;0.0945945945945946;0.405405405405405
Control.SRR15539874;33;32;0.363636363636364;21;12;0.136363636363636;0.363636363636364
Control.SRR15539874;31;32;0.387096774193548;19;12;0.112903225806452;0.387096774193548
Control.SRR15539874;34;32;0.617647058823529;13;21;0.117647058823529;0.382352941176471
Control.SRR15539874;32;32;0.40625;19;13;0.09375;0.40625
Control.SRR15539874;33;32;0.393939393939394;20;13;0.106060606060606;0.393939393939394
Control.SRR15539874;29;32;0.517241379310345;14;15;0.0172413793103449;0.482758620689655
Control.SRR15539874;33;32;0.545454545454545;15;18;0.0454545454545454;0.454545454545455
Control.SRR15539874;32;32;0.5;16;16;0;0.5
Control.SRR15539874;32;32;0.40625;19;13;0.09375;0.40625
Control.SRR15539874;32;32;0.53125;15;17;0.03125;0.46875
Control.SRR15539874;36;32;0.555555555555556;16;20;0.0555555555555556;0.444444444444444
Control.SRR15539874;36;32;0.5;18;18;0;0.5
Control.SRR15539874;35;32;0.571428571428571;15;20;0.0714285714285714;0.428571428571429
Control.SRR15539874;36;32;0.5;18;18;0;0.5
Control.SRR15539874;30;32;0.433333333333333;17;13;0.0666666666666667;0.433333333333333
Control.SRR15539874;37;32;0.621621621621622;14;23;0.121621621621622;0.378378378378378
Control.SRR15539874;34;32;0.441176470588235;19;15;0.0588235294117647;0.441176470588235
Control.SRR15539874;34;32;0.558823529411765;15;19;0.0588235294117647;0.441176470588235
Control.SRR15539874;32;32;0.65625;11;21;0.15625;0.34375
Control.SRR15539874;33;32;0.424242424242424;19;14;0.0757575757575757;0.424242424242424
Control.SRR15539874;36;32;0.527777777777778;17;19;0.0277777777777778;0.472222222222222
Control.SRR15539874;30;32;0.4;18;12;0.1;0.4
Control.SRR15539874;30;32;0.566666666666667;13;17;0.0666666666666667;0.433333333333333
Control.SRR15539874;30;32;0.5;15;15;0;0.5
Control.SRR15539874;30;32;0.666666666666667;10;20;0.166666666666667;0.333333333333333
Control.SRR15539874;35;32;0.514285714285714;17;18;0.0142857142857142;0.485714285714286
Control.SRR15539874;29;32;0.448275862068966;16;13;0.0517241379310345;0.448275862068966
Control.SRR15539874;29;32;0.551724137931034;13;16;0.0517241379310345;0.448275862068966
Control.SRR15539874;34;32;0.470588235294118;18;16;0.0294117647058824;0.470588235294118
Control.SRR15539874;31;32;0.419354838709677;18;13;0.0806451612903226;0.419354838709677
Control.SRR15539874;35;32;0.428571428571429;20;15;0.0714285714285715;0.428571428571429
Control.SRR15539874;30;32;0.5;15;15;0;0.5
Control.SRR15539874;34;32;0.411764705882353;20;14;0.0882352941176471;0.411764705882353
Control.SRR15539874;30;32;0.6;12;18;0.1;0.4
Control.SRR15539874;33;32;0.393939393939394;20;13;0.106060606060606;0.393939393939394
Control.SRR15539874;34;32;0.588235294117647;14;20;0.0882352941176471;0.411764705882353
Control.SRR15539874;32;32;0.34375;21;11;0.15625;0.34375
Control.SRR15539874;34;32;0.352941176470588;22;12;0.147058823529412;0.352941176470588
Control.SRR15539874;37;32;0.459459459459459;20;17;0.0405405405405405;0.459459459459459
Control.SRR15539874;29;32;0.482758620689655;15;14;0.0172413793103448;0.482758620689655
Control.SRR15539874;32;32;0.3125;22;10;0.1875;0.3125
Control.SRR15539874;29;32;0.586206896551724;12;17;0.0862068965517241;0.413793103448276
Control.SRR15539874;32;32;0.4375;18;14;0.0625;0.4375
Control.SRR15539874;32;32;0.5;16;16;0;0.5
Control.SRR15539874;35;32;0.514285714285714;17;18;0.0142857142857142;0.485714285714286
Control.SRR15539874;35;32;0.514285714285714;17;18;0.0142857142857142;0.485714285714286
Control.SRR15539874;34;32;0.529411764705882;16;18;0.0294117647058824;0.470588235294118
Control.SRR15539874;34;32;0.5;17;17;0;0.5
Control.SRR15539874;36;32;0.472222222222222;19;17;0.0277777777777778;0.472222222222222
Control.SRR15539874;29;32;0.724137931034483;8;21;0.224137931034483;0.275862068965517
Control.SRR15539874;32;32;0.59375;13;19;0.09375;0.40625
Control.SRR15539874;29;32;0.586206896551724;12;17;0.0862068965517241;0.413793103448276
Control.SRR15539874;30;32;0.566666666666667;13;17;0.0666666666666667;0.433333333333333
Control.SRR15539874;32;32;0.59375;13;19;0.09375;0.40625
Control.SRR15539874;37;32;0.405405405405405;22;15;0.0945945945945946;0.405405405405405
Control.SRR15539874;33;32;0.484848484848485;17;16;0.0151515151515151;0.484848484848485
Control.SRR15539874;34;32;0.441176470588235;19;15;0.0588235294117647;0.441176470588235
Control.SRR15539874;29;32;0.551724137931034;13;16;0.0517241379310345;0.448275862068966
Control.SRR15539874;34;32;0.676470588235294;11;23;0.176470588235294;0.323529411764706
Control.SRR15539874;32;32;0.625;12;20;0.125;0.375
Control.SRR15539874;29;32;0.620689655172414;11;18;0.120689655172414;0.379310344827586
Control.SRR15539874;32;32;0.4375;18;14;0.0625;0.4375
Control.SRR15539874;33;32;0.454545454545455;18;15;0.0454545454545455;0.454545454545455
Control.SRR15539874;31;32;0.483870967741935;16;15;0.0161290322580645;0.483870967741935
Control.SRR15539874;33;32;0.636363636363636;12;21;0.136363636363636;0.363636363636364
Control.SRR15539874;33;32;0.575757575757576;14;19;0.0757575757575758;0.424242424242424
Control.SRR15539874;31;32;0.483870967741935;16;15;0.0161290322580645;0.483870967741935
Control.SRR15539874;30;32;0.5;15;15;0;0.5
Control.SRR15539874;29;32;0.448275862068966;16;13;0.0517241379310345;0.448275862068966
Control.SRR15539874;31;32;0.548387096774194;14;17;0.0483870967741935;0.451612903225806
Control.SRR15539874;30;32;0.566666666666667;13;17;0.0666666666666667;0.433333333333333
Control.SRR15539874;34;32;0.558823529411765;15;19;0.0588235294117647;0.441176470588235
Control.SRR15539874;36;32;0.388888888888889;22;14;0.111111111111111;0.388888888888889
Control.SRR15539874;37;32;0.486486486486487;19;18;0.0135135135135135;0.486486486486487
Control.SRR15539874;35;32;0.371428571428571;22;13;0.128571428571429;0.371428571428571
Control.SRR15539874;36;32;0.5;18;18;0;0.5
Control.SRR15539874;32;32;0.5;16;16;0;0.5
Control.SRR15539874;31;32;0.516129032258065;15;16;0.0161290322580645;0.483870967741935
Control.SRR15539874;34;32;0.382352941176471;21;13;0.117647058823529;0.382352941176471
Control.SRR15539874;30;32;0.366666666666667;19;11;0.133333333333333;0.366666666666667
Control.SRR15539874;32;32;0.53125;15;17;0.03125;0.46875
Control.SRR15539874;35;32;0.514285714285714;17;18;0.0142857142857142;0.485714285714286
Control.SRR15539874;37;32;0.513513513513513;18;19;0.0135135135135135;0.486486486486487
Control.SRR15539874;37;32;0.405405405405405;22;15;0.0945945945945946;0.405405405405405
Control.SRR15539874;36;32;0.472222222222222;19;17;0.0277777777777778;0.472222222222222
Control.SRR15539874;35;32;0.542857142857143;16;19;0.0428571428571428;0.457142857142857
Control.SRR15539874;37;32;0.621621621621622;14;23;0.121621621621622;0.378378378378378
Control.SRR15539874;36;32;0.555555555555556;16;20;0.0555555555555556;0.444444444444444
Control.SRR15539874;36;32;0.638888888888889;13;23;0.138888888888889;0.361111111111111
Control.SRR15539874;37;32;0.486486486486487;19;18;0.0135135135135135;0.486486486486487
Control.SRR15539874;33;32;0.484848484848485;17;16;0.0151515151515151;0.484848484848485
Control.SRR15539874;33;32;0.363636363636364;21;12;0.136363636363636;0.363636363636364
Control.SRR15539874;36;32;0.388888888888889;22;14;0.111111111111111;0.388888888888889
Control.SRR15539874;37;32;0.540540540540541;17;20;0.0405405405405406;0.459459459459459
Control.SRR15539874;37;32;0.459459459459459;20;17;0.0405405405405405;0.459459459459459
Control.SRR15539874;36;32;0.444444444444444;20;16;0.0555555555555556;0.444444444444444
Control.SRR15539874;35;32;0.428571428571429;20;15;0.0714285714285715;0.428571428571429
Control.SRR15539874;35;32;0.428571428571429;20;15;0.0714285714285715;0.428571428571429
Control.SRR15539874;30;32;0.3;21;9;0.2;0.3
Control.SRR15539874;31;32;0.419354838709677;18;13;0.0806451612903226;0.419354838709677
Control.SRR15539874;35;32;0.542857142857143;16;19;0.0428571428571428;0.457142857142857
Control.SRR15539874;35;32;0.485714285714286;18;17;0.0142857142857143;0.485714285714286
Control.SRR15539874;37;32;0.621621621621622;14;23;0.121621621621622;0.378378378378378
Control.SRR15539874;33;32;0.515151515151515;16;17;0.0151515151515151;0.484848484848485
Control.SRR15539874;33;32;0.484848484848485;17;16;0.0151515151515151;0.484848484848485
Control.SRR15539874;33;32;0.424242424242424;19;14;0.0757575757575757;0.424242424242424
Control.SRR15539874;32;32;0.46875;17;15;0.03125;0.46875
Control.SRR15539874;36;32;0.611111111111111;14;22;0.111111111111111;0.388888888888889
Control.SRR15539874;32;32;0.21875;25;7;0.28125;0.21875
Control.SRR15539874;35;32;0.457142857142857;19;16;0.0428571428571429;0.457142857142857
Control.SRR15539874;36;32;0.527777777777778;17;19;0.0277777777777778;0.472222222222222
Control.SRR15539874;37;32;0.567567567567568;16;21;0.0675675675675675;0.432432432432432
Control.SRR15539874;33;32;0.484848484848485;17;16;0.0151515151515151;0.484848484848485
Control.SRR15539874;31;32;0.451612903225806;17;14;0.0483870967741936;0.451612903225806
Control.SRR15539874;30;32;0.466666666666667;16;14;0.0333333333333333;0.466666666666667
Control.SRR15539874;29;32;0.517241379310345;14;15;0.0172413793103449;0.482758620689655
Control.SRR15539874;31;32;0.580645161290323;13;18;0.0806451612903226;0.419354838709677
Control.SRR15539874;35;32;0.428571428571429;20;15;0.0714285714285715;0.428571428571429
Control.SRR15539874;34;32;0.411764705882353;20;14;0.0882352941176471;0.411764705882353
Control.SRR15539874;35;32;0.428571428571429;20;15;0.0714285714285715;0.428571428571429
Control.SRR15539874;33;32;0.636363636363636;12;21;0.136363636363636;0.363636363636364
Control.SRR15539874;30;32;0.366666666666667;19;11;0.133333333333333;0.366666666666667
Control.SRR15539874;30;32;0.566666666666667;13;17;0.0666666666666667;0.433333333333333
Control.SRR15539874;31;32;0.645161290322581;11;20;0.145161290322581;0.354838709677419
Control.SRR15539874;36;32;0.555555555555556;16;20;0.0555555555555556;0.444444444444444
Control.SRR15539874;32;32;0.46875;17;15;0.03125;0.46875
Control.SRR15539874;35;32;0.457142857142857;19;16;0.0428571428571429;0.457142857142857
Control.SRR15539874;29;32;0.620689655172414;11;18;0.120689655172414;0.379310344827586
Control.SRR15539874;33;32;0.636363636363636;12;21;0.136363636363636;0.363636363636364
Control.SRR15539874;37;32;0.297297297297297;26;11;0.202702702702703;0.297297297297297
Control.SRR15539874;32;32;0.4375;18;14;0.0625;0.4375
Control.SRR15539874;31;32;0.548387096774194;14;17;0.0483870967741935;0.451612903225806
Control.SRR15539874;35;32;0.628571428571429;13;22;0.128571428571429;0.371428571428571
Control.SRR15539874;31;32;0.483870967741935;16;15;0.0161290322580645;0.483870967741935
Control.SRR15539874;37;32;0.405405405405405;22;15;0.0945945945945946;0.405405405405405
Control.SRR15539874;33;32;0.575757575757576;14;19;0.0757575757575758;0.424242424242424
Control.SRR15539874;34;32;0.558823529411765;15;19;0.0588235294117647;0.441176470588235
Control.SRR15539874;33;32;0.636363636363636;12;21;0.136363636363636;0.363636363636364
Control.SRR15539874;37;32;0.486486486486487;19;18;0.0135135135135135;0.486486486486487
Control.SRR15539874;30;32;0.633333333333333;11;19;0.133333333333333;0.366666666666667
Control.SRR15539874;30;32;0.533333333333333;14;16;0.0333333333333333;0.466666666666667
Control.SRR15539874;31;32;0.419354838709677;18;13;0.0806451612903226;0.419354838709677
Control.SRR15539874;35;32;0.485714285714286;18;17;0.0142857142857143;0.485714285714286
Control.SRR15539874;29;32;0.655172413793103;10;19;0.155172413793103;0.344827586206897
Control.SRR15539874;30;32;0.566666666666667;13;17;0.0666666666666667;0.433333333333333
Control.SRR15539874;32;32;0.5625;14;18;0.0625;0.4375
Control.SRR15539874;33;32;0.545454545454545;15;18;0.0454545454545454;0.454545454545455
Control.SRR15539874;33;32;0.545454545454545;15;18;0.0454545454545454;0.454545454545455
Control.SRR15539874;32;32;0.5;16;16;0;0.5
Control.SRR15539874;32;32;0.53125;15;17;0.03125;0.46875
Control.SRR15539874;35;32;0.542857142857143;16;19;0.0428571428571428;0.457142857142857
Control.SRR15539874;35;32;0.542857142857143;16;19;0.0428571428571428;0.457142857142857
Control.SRR15539874;30;32;0.5;15;15;0;0.5
Control.SRR15539874;36;32;0.444444444444444;20;16;0.0555555555555556;0.444444444444444
Control.SRR15539874;30;32;0.4;18;12;0.1;0.4
Control.SRR15539874;35;32;0.514285714285714;17;18;0.0142857142857142;0.485714285714286
Control.SRR15539874;35;32;0.6;14;21;0.1;0.4
Control.SRR15539874;37;32;0.405405405405405;22;15;0.0945945945945946;0.405405405405405
Control.SRR15539874;34;32;0.470588235294118;18;16;0.0294117647058824;0.470588235294118
Control.SRR15539874;34;32;0.411764705882353;20;14;0.0882352941176471;0.411764705882353
Control.SRR15539874;36;32;0.361111111111111;23;13;0.138888888888889;0.361111111111111
Control.SRR15539874;32;32;0.34375;21;11;0.15625;0.34375
Control.SRR15539874;34;32;0.470588235294118;18;16;0.0294117647058824;0.470588235294118
Control.SRR15539874;29;32;0.551724137931034;13;16;0.0517241379310345;0.448275862068966
Control.SRR15539874;32;32;0.59375;13;19;0.09375;0.40625
Control.SRR15539874;34;32;0.558823529411765;15;19;0.0588235294117647;0.441176470588235
Control.SRR15539874;32;32;0.78125;7;25;0.28125;0.21875
Control.SRR15539874;29;32;0.586206896551724;12;17;0.0862068965517241;0.413793103448276
Control.SRR15539874;34;32;0.470588235294118;18;16;0.0294117647058824;0.470588235294118
Control.SRR15539874;29;32;0.551724137931034;13;16;0.0517241379310345;0.448275862068966
Control.SRR15539874;34;32;0.352941176470588;22;12;0.147058823529412;0.352941176470588
Control.SRR15539874;35;32;0.514285714285714;17;18;0.0142857142857142;0.485714285714286
Control.SRR15539874;33;32;0.484848484848485;17;16;0.0151515151515151;0.484848484848485
Control.SRR15539874;33;32;0.393939393939394;20;13;0.106060606060606;0.393939393939394
Control.SRR15539874;33;32;0.545454545454545;15;18;0.0454545454545454;0.454545454545455
Control.SRR15539874;37;32;0.702702702702703;11;26;0.202702702702703;0.297297297297297
Control.SRR15539874;32;32;0.53125;15;17;0.03125;0.46875
Control.SRR15539874;33;32;0.545454545454545;15;18;0.0454545454545454;0.454545454545455
Control.SRR15539874;32;32;0.3125;22;10;0.1875;0.3125
Control.SRR15539874;33;32;0.515151515151515;16;17;0.0151515151515151;0.484848484848485
Control.SRR15539874;29;32;0.551724137931034;13;16;0.0517241379310345;0.448275862068966
Control.SRR15539874;37;32;0.405405405405405;22;15;0.0945945945945946;0.405405405405405
Control.SRR15539874;34;32;0.558823529411765;15;19;0.0588235294117647;0.441176470588235
Control.SRR15539874;33;32;0.393939393939394;20;13;0.106060606060606;0.393939393939394
Control.SRR15539874;32;32;0.625;12;20;0.125;0.375
Control.SRR15539874;33;32;0.484848484848485;17;16;0.0151515151515151;0.484848484848485
Control.SRR15539874;29;32;0.482758620689655;15;14;0.0172413793103448;0.482758620689655
Control.SRR15539874;31;32;0.483870967741935;16;15;0.0161290322580645;0.483870967741935
Control.SRR15539874;29;32;0.241379310344828;22;7;0.258620689655172;0.241379310344828
Control.SRR15539874;36;32;0.555555555555556;16;20;0.0555555555555556;0.444444444444444
Control.SRR15539874;32;32;0.53125;15;17;0.03125;0.46875
Control.SRR15539874;37;32;0.432432432432432;21;16;0.0675675675675675;0.432432432432432
Control.SRR15539874;34;32;0.323529411764706;23;11;0.176470588235294;0.323529411764706
Control.SRR15539874;35;32;0.457142857142857;19;16;0.0428571428571429;0.457142857142857
Control.SRR15539874;32;32;0.46875;17;15;0.03125;0.46875
Control.SRR15539874;33;32;0.545454545454545;15;18;0.0454545454545454;0.454545454545455
Control.SRR15539874;36;32;0.611111111111111;14;22;0.111111111111111;0.388888888888889
Control.SRR15539874;35;32;0.514285714285714;17;18;0.0142857142857142;0.485714285714286
Control.SRR15539874;33;32;0.454545454545455;18;15;0.0454545454545455;0.454545454545455
Control.SRR15539874;31;32;0.548387096774194;14;17;0.0483870967741935;0.451612903225806
Control.SRR15539874;32;32;0.53125;15;17;0.03125;0.46875
Control.SRR15539874;33;32;0.515151515151515;16;17;0.0151515151515151;0.484848484848485
Control.SRR15539874;29;32;0.482758620689655;15;14;0.0172413793103448;0.482758620689655
Control.SRR15539874;31;32;0.354838709677419;20;11;0.145161290322581;0.354838709677419
Control.SRR15539874;34;32;0.5;17;17;0;0.5
Control.SRR15539874;30;32;0.5;15;15;0;0.5
Control.SRR15539874;29;32;0.482758620689655;15;14;0.0172413793103448;0.482758620689655
Control.SRR15539874;33;32;0.484848484848485;17;16;0.0151515151515151;0.484848484848485
Control.SRR15539874;33;32;0.454545454545455;18;15;0.0454545454545455;0.454545454545455
Control.SRR15539874;35;32;0.428571428571429;20;15;0.0714285714285715;0.428571428571429
Control.SRR15539874;36;32;0.694444444444444;11;25;0.194444444444444;0.305555555555556
Control.SRR15539874;31;32;0.645161290322581;11;20;0.145161290322581;0.354838709677419
Control.SRR15539874;37;32;0.405405405405405;22;15;0.0945945945945946;0.405405405405405
Control.SRR15539874;35;32;0.457142857142857;19;16;0.0428571428571429;0.457142857142857
Control.SRR15539874;32;32;0.46875;17;15;0.03125;0.46875
Control.SRR15539874;30;32;0.433333333333333;17;13;0.0666666666666667;0.433333333333333
Control.SRR15539874;35;32;0.457142857142857;19;16;0.0428571428571429;0.457142857142857
Control.SRR15539874;30;32;0.466666666666667;16;14;0.0333333333333333;0.466666666666667
Control.SRR15539874;32;32;0.53125;15;17;0.03125;0.46875
Control.SRR15539874;32;32;0.375;20;12;0.125;0.375
Control.SRR15539874;37;32;0.459459459459459;20;17;0.0405405405405405;0.459459459459459
Control.SRR15539874;35;32;0.485714285714286;18;17;0.0142857142857143;0.485714285714286
Control.SRR15539874;30;32;0.4;18;12;0.1;0.4
Control.SRR15539874;35;32;0.628571428571429;13;22;0.128571428571429;0.371428571428571
Control.SRR15539874;30;32;0.233333333333333;23;7;0.266666666666667;0.233333333333333
Control.SRR15539874;34;32;0.5;17;17;0;0.5
Control.SRR15539874;32;32;0.5625;14;18;0.0625;0.4375
Control.SRR15539874;29;32;0.482758620689655;15;14;0.0172413793103448;0.482758620689655
Control.SRR15539874;37;32;0.567567567567568;16;21;0.0675675675675675;0.432432432432432
Control.SRR15539874;36;32;0.444444444444444;20;16;0.0555555555555556;0.444444444444444
Control.SRR15539874;32;32;0.40625;19;13;0.09375;0.40625
Control.SRR15539874;37;32;0.513513513513513;18;19;0.0135135135135135;0.486486486486487
Control.SRR15539874;29;32;0.517241379310345;14;15;0.0172413793103449;0.482758620689655
Control.SRR15539874;34;32;0.529411764705882;16;18;0.0294117647058824;0.470588235294118
Control.SRR15539874;36;32;0.416666666666667;21;15;0.0833333333333333;0.416666666666667
Control.SRR15539874;34;32;0.588235294117647;14;20;0.0882352941176471;0.411764705882353
Control.SRR15539874;37;32;0.540540540540541;17;20;0.0405405405405406;0.459459459459459
Control.SRR15539874;29;32;0.413793103448276;17;12;0.0862068965517241;0.413793103448276
Control.SRR15539874;37;32;0.594594594594595;15;22;0.0945945945945946;0.405405405405405
Control.SRR15539874;34;32;0.441176470588235;19;15;0.0588235294117647;0.441176470588235
Control.SRR15539874;35;32;0.485714285714286;18;17;0.0142857142857143;0.485714285714286
Control.SRR15539874;33;32;0.606060606060606;13;20;0.106060606060606;0.393939393939394
Control.SRR15539874;33;32;0.636363636363636;12;21;0.136363636363636;0.363636363636364
Control.SRR15539874;35;32;0.485714285714286;18;17;0.0142857142857143;0.485714285714286
Control.SRR15539874;32;32;0.40625;19;13;0.09375;0.40625
Control.SRR15539874;30;32;0.5;15;15;0;0.5
Control.SRR15539874;32;32;0.625;12;20;0.125;0.375
Control.SRR15539874;29;32;0.379310344827586;18;11;0.120689655172414;0.379310344827586
Control.SRR15539874;29;32;0.551724137931034;13;16;0.0517241379310345;0.448275862068966
Control.SRR15539874;35;32;0.4;21;14;0.1;0.4
Control.SRR15539874;35;32;0.342857142857143;23;12;0.157142857142857;0.342857142857143
Control.SRR15539874;36;32;0.527777777777778;17;19;0.0277777777777778;0.472222222222222
Control.SRR15539874;29;32;0.517241379310345;14;15;0.0172413793103449;0.482758620689655
Control.SRR15539874;37;32;0.486486486486487;19;18;0.0135135135135135;0.486486486486487
Control.SRR15539874;32;32;0.4375;18;14;0.0625;0.4375
Control.SRR15539874;30;32;0.633333333333333;11;19;0.133333333333333;0.366666666666667
Control.SRR15539874;33;32;0.242424242424242;25;8;0.257575757575758;0.242424242424242
Control.SRR15539874;29;32;0.482758620689655;15;14;0.0172413793103448;0.482758620689655
Control.SRR15539874;32;32;0.375;20;12;0.125;0.375
Control.SRR15539874;33;32;0.424242424242424;19;14;0.0757575757575757;0.424242424242424
Control.SRR15539874;33;32;0.575757575757576;14;19;0.0757575757575758;0.424242424242424
Control.SRR15539874;36;32;0.611111111111111;14;22;0.111111111111111;0.388888888888889
Control.SRR15539874;31;32;0.516129032258065;15;16;0.0161290322580645;0.483870967741935
Control.SRR15539874;32;32;0.59375;13;19;0.09375;0.40625
Control.SRR15539874;32;32;0.4375;18;14;0.0625;0.4375
Control.SRR15539874;33;32;0.545454545454545;15;18;0.0454545454545454;0.454545454545455
Control.SRR15539874;31;32;0.612903225806452;12;19;0.112903225806452;0.387096774193548
Control.SRR15539874;35;32;0.428571428571429;20;15;0.0714285714285715;0.428571428571429
Control.SRR15539874;34;32;0.5;17;17;0;0.5
Control.SRR15539874;33;32;0.484848484848485;17;16;0.0151515151515151;0.484848484848485
Control.SRR15539874;29;32;0.517241379310345;14;15;0.0172413793103449;0.482758620689655
Control.SRR15539874;36;32;0.611111111111111;14;22;0.111111111111111;0.388888888888889
Control.SRR15539874;32;32;0.5;16;16;0;0.5
Control.SRR15539874;32;32;0.5;16;16;0;0.5
Control.SRR15539874;34;32;0.558823529411765;15;19;0.0588235294117647;0.441176470588235
Control.SRR15539874;37;32;0.621621621621622;14;23;0.121621621621622;0.378378378378378
Control.SRR15539874;31;32;0.451612903225806;17;14;0.0483870967741936;0.451612903225806
Control.SRR15539874;32;32;0.40625;19;13;0.09375;0.40625
Control.SRR15539874;35;32;0.542857142857143;16;19;0.0428571428571428;0.457142857142857
Control.SRR15539874;35;32;0.371428571428571;22;13;0.128571428571429;0.371428571428571
Control.SRR15539874;34;32;0.470588235294118;18;16;0.0294117647058824;0.470588235294118
Control.SRR15539874;34;32;0.617647058823529;13;21;0.117647058823529;0.382352941176471
Control.SRR15539874;31;32;0.419354838709677;18;13;0.0806451612903226;0.419354838709677
Control.SRR15539874;36;32;0.472222222222222;19;17;0.0277777777777778;0.472222222222222
Control.SRR15539874;30;32;0.533333333333333;14;16;0.0333333333333333;0.466666666666667
Control.SRR15539874;30;32;0.533333333333333;14;16;0.0333333333333333;0.466666666666667
Control.SRR15539874;34;32;0.411764705882353;20;14;0.0882352941176471;0.411764705882353
Control.SRR15539874;31;32;0.483870967741935;16;15;0.0161290322580645;0.483870967741935
Control.SRR15539874;37;32;0.432432432432432;21;16;0.0675675675675675;0.432432432432432
Control.SRR15539874;30;32;0.333333333333333;20;10;0.166666666666667;0.333333333333333
Control.SRR15539874;31;32;0.580645161290323;13;18;0.0806451612903226;0.419354838709677
Control.SRR15539874;30;32;0.666666666666667;10;20;0.166666666666667;0.333333333333333
Control.SRR15539874;33;32;0.454545454545455;18;15;0.0454545454545455;0.454545454545455
Control.SRR15539874;37;32;0.486486486486487;19;18;0.0135135135135135;0.486486486486487
Control.SRR15539874;29;32;0.413793103448276;17;12;0.0862068965517241;0.413793103448276
Control.SRR15539874;29;32;0.379310344827586;18;11;0.120689655172414;0.379310344827586
Control.SRR15539874;33;32;0.545454545454545;15;18;0.0454545454545454;0.454545454545455
Control.SRR15539874;35;32;0.514285714285714;17;18;0.0142857142857142;0.485714285714286
Control.SRR15539874;36;32;0.333333333333333;24;12;0.166666666666667;0.333333333333333
Control.SRR15539874;33;32;0.515151515151515;16;17;0.0151515151515151;0.484848484848485
Control.SRR15539874;34;32;0.441176470588235;19;15;0.0588235294117647;0.441176470588235
Control.SRR15539874;32;32;0.5625;14;18;0.0625;0.4375
Control.SRR15539874;36;32;0.555555555555556;16;20;0.0555555555555556;0.444444444444444
Control.SRR15539874;36;32;0.555555555555556;16;20;0.0555555555555556;0.444444444444444
Control.SRR15539874;31;32;0.483870967741935;16;15;0.0161290322580645;0.483870967741935
Control.SRR15539874;32;32;0.59375;13;19;0.09375;0.40625
Control.SRR15539874;32;32;0.375;20;12;0.125;0.375
Control.SRR15539874;36;32;0.555555555555556;16;20;0.0555555555555556;0.444444444444444
Control.SRR15539874;29;32;0.379310344827586;18;11;0.120689655172414;0.379310344827586
Control.SRR15539874;32;32;0.5;16;16;0;0.5
Control.SRR15539874;34;32;0.5;17;17;0;0.5
Control.SRR15539874;31;32;0.451612903225806;17;14;0.0483870967741936;0.451612903225806
Control.SRR15539874;33;32;0.636363636363636;12;21;0.136363636363636;0.363636363636364
Control.SRR15539874;29;32;0.551724137931034;13;16;0.0517241379310345;0.448275862068966
Control.SRR15539874;31;32;0.67741935483871;10;21;0.17741935483871;0.32258064516129
Control.SRR15539874;30;32;0.5;15;15;0;0.5
Control.SRR15539874;30;32;0.566666666666667;13;17;0.0666666666666667;0.433333333333333
Control.SRR15539874;32;32;0.65625;11;21;0.15625;0.34375
Control.SRR15539874;32;32;0.4375;18;14;0.0625;0.4375
Control.SRR15539874;29;32;0.482758620689655;15;14;0.0172413793103448;0.482758620689655
Control.SRR15539874;32;32;0.46875;17;15;0.03125;0.46875
Control.SRR15539874;29;32;0.689655172413793;9;20;0.189655172413793;0.310344827586207
Control.SRR15539874;32;32;0.5;16;16;0;0.5
Control.SRR15539874;34;32;0.647058823529412;12;22;0.147058823529412;0.352941176470588
Control.SRR15539874;32;32;0.53125;15;17;0.03125;0.46875
Control.SRR15539874;36;32;0.388888888888889;22;14;0.111111111111111;0.388888888888889
Control.SRR15539874;35;32;0.342857142857143;23;12;0.157142857142857;0.342857142857143
Control.SRR15539874;35;32;0.485714285714286;18;17;0.0142857142857143;0.485714285714286
Control.SRR15539874;36;32;0.555555555555556;16;20;0.0555555555555556;0.444444444444444
Control.SRR15539874;35;32;0.485714285714286;18;17;0.0142857142857143;0.485714285714286
Control.SRR15539874;36;32;0.388888888888889;22;14;0.111111111111111;0.388888888888889
Control.SRR15539874;36;32;0.444444444444444;20;16;0.0555555555555556;0.444444444444444
Control.SRR15539874;35;32;0.514285714285714;17;18;0.0142857142857142;0.485714285714286
Control.SRR15539874;37;32;0.405405405405405;22;15;0.0945945945945946;0.405405405405405
Control.SRR15539874;31;32;0.548387096774194;14;17;0.0483870967741935;0.451612903225806
Control.SRR15539874;37;32;0.486486486486487;19;18;0.0135135135135135;0.486486486486487
Control.SRR15539874;36;32;0.444444444444444;20;16;0.0555555555555556;0.444444444444444
Control.SRR15539874;33;32;0.515151515151515;16;17;0.0151515151515151;0.484848484848485
Control.SRR15539874;30;32;0.533333333333333;14;16;0.0333333333333333;0.466666666666667
Control.SRR15539874;31;32;0.580645161290323;13;18;0.0806451612903226;0.419354838709677
Control.SRR15539874;32;32;0.53125;15;17;0.03125;0.46875
Control.SRR15539874;29;32;0.482758620689655;15;14;0.0172413793103448;0.482758620689655
Control.SRR15539874;35;32;0.571428571428571;15;20;0.0714285714285714;0.428571428571429
Control.SRR15539874;34;32;0.617647058823529;13;21;0.117647058823529;0.382352941176471
Control.SRR15539874;32;32;0.5;16;16;0;0.5
Control.SRR15539874;37;32;0.675675675675676;12;25;0.175675675675676;0.324324324324324
Control.SRR15539874;29;32;0.655172413793103;10;19;0.155172413793103;0.344827586206897
Control.SRR15539874;30;32;0.433333333333333;17;13;0.0666666666666667;0.433333333333333
Control.SRR15539874;32;32;0.53125;15;17;0.03125;0.46875
Control.SRR15539874;29;32;0.482758620689655;15;14;0.0172413793103448;0.482758620689655
Control.SRR15539874;34;32;0.5;17;17;0;0.5
Control.SRR15539874;37;32;0.540540540540541;17;20;0.0405405405405406;0.459459459459459
Control.SRR15539874;33;32;0.515151515151515;16;17;0.0151515151515151;0.484848484848485
Control.SRR15539874;36;32;0.583333333333333;15;21;0.0833333333333334;0.416666666666667
Control.SRR15539874;29;32;0.620689655172414;11;18;0.120689655172414;0.379310344827586
Control.SRR15539874;31;32;0.645161290322581;11;20;0.145161290322581;0.354838709677419
Control.SRR15539874;31;32;0.612903225806452;12;19;0.112903225806452;0.387096774193548
Control.SRR15539874;35;32;0.6;14;21;0.1;0.4
Control.SRR15539874;34;32;0.5;17;17;0;0.5
Control.SRR15539874;34;32;0.470588235294118;18;16;0.0294117647058824;0.470588235294118
Control.SRR15539874;35;32;0.514285714285714;17;18;0.0142857142857142;0.485714285714286
Control.SRR15539874;35;32;0.4;21;14;0.1;0.4
Control.SRR15539874;35;32;0.342857142857143;23;12;0.157142857142857;0.342857142857143
Control.SRR15539874;37;32;0.297297297297297;26;11;0.202702702702703;0.297297297297297
Control.SRR15539874;37;32;0.378378378378378;23;14;0.121621621621622;0.378378378378378
Control.SRR15539874;36;32;0.361111111111111;23;13;0.138888888888889;0.361111111111111
Control.SRR15539874;36;32;0.416666666666667;21;15;0.0833333333333333;0.416666666666667
Control.SRR15539874;29;32;0.517241379310345;14;15;0.0172413793103449;0.482758620689655
Control.SRR15539874;31;32;0.516129032258065;15;16;0.0161290322580645;0.483870967741935
Control.SRR15539874;33;32;0.484848484848485;17;16;0.0151515151515151;0.484848484848485
Control.SRR15539874;35;32;0.428571428571429;20;15;0.0714285714285715;0.428571428571429
Control.SRR15539874;33;32;0.515151515151515;16;17;0.0151515151515151;0.484848484848485
Control.SRR15539874;34;32;0.529411764705882;16;18;0.0294117647058824;0.470588235294118
Control.SRR15539874;33;32;0.333333333333333;22;11;0.166666666666667;0.333333333333333
Control.SRR15539874;33;32;0.515151515151515;16;17;0.0151515151515151;0.484848484848485
Control.SRR15539874;32;32;0.5625;14;18;0.0625;0.4375
Control.SRR15539874;33;32;0.424242424242424;19;14;0.0757575757575757;0.424242424242424
Control.SRR15539874;31;32;0.612903225806452;12;19;0.112903225806452;0.387096774193548
Control.SRR15539874;30;32;0.466666666666667;16;14;0.0333333333333333;0.466666666666667
Control.SRR15539874;30;32;0.5;15;15;0;0.5
Control.SRR15539874;29;32;0.379310344827586;18;11;0.120689655172414;0.379310344827586
Control.SRR15539874;29;32;0.517241379310345;14;15;0.0172413793103449;0.482758620689655
Control.SRR15539874;34;32;0.588235294117647;14;20;0.0882352941176471;0.411764705882353
Control.SRR15539874;32;32;0.375;20;12;0.125;0.375
Control.SRR15539874;35;32;0.514285714285714;17;18;0.0142857142857142;0.485714285714286
Control.SRR15539874;33;32;0.272727272727273;24;9;0.227272727272727;0.272727272727273
Control.SRR15539874;36;32;0.527777777777778;17;19;0.0277777777777778;0.472222222222222
Control.SRR15539874;37;32;0.567567567567568;16;21;0.0675675675675675;0.432432432432432
Control.SRR15539874;33;32;0.303030303030303;23;10;0.196969696969697;0.303030303030303
Control.SRR15539874;34;32;0.558823529411765;15;19;0.0588235294117647;0.441176470588235
Control.SRR15539874;37;32;0.513513513513513;18;19;0.0135135135135135;0.486486486486487
Control.SRR15539874;36;32;0.444444444444444;20;16;0.0555555555555556;0.444444444444444
Control.SRR15539874;34;32;0.441176470588235;19;15;0.0588235294117647;0.441176470588235
Control.SRR15539874;31;32;0.451612903225806;17;14;0.0483870967741936;0.451612903225806
Control.SRR15539874;35;32;0.428571428571429;20;15;0.0714285714285715;0.428571428571429
Control.SRR15539874;31;32;0.225806451612903;24;7;0.274193548387097;0.225806451612903
Control.SRR15539874;30;32;0.566666666666667;13;17;0.0666666666666667;0.433333333333333
Control.SRR15539874;30;32;0.5;15;15;0;0.5
Control.SRR15539874;29;32;0.517241379310345;14;15;0.0172413793103449;0.482758620689655
Control.SRR15539874;37;32;0.540540540540541;17;20;0.0405405405405406;0.459459459459459
Control.SRR15539874;34;32;0.529411764705882;16;18;0.0294117647058824;0.470588235294118
Control.SRR15539874;31;32;0.516129032258065;15;16;0.0161290322580645;0.483870967741935
Control.SRR15539874;33;32;0.636363636363636;12;21;0.136363636363636;0.363636363636364
Control.SRR15539874;33;32;0.484848484848485;17;16;0.0151515151515151;0.484848484848485
Control.SRR15539874;32;32;0.40625;19;13;0.09375;0.40625
Control.SRR15539874;35;32;0.628571428571429;13;22;0.128571428571429;0.371428571428571
Control.SRR15539874;32;32;0.4375;18;14;0.0625;0.4375
Control.SRR15539874;34;32;0.529411764705882;16;18;0.0294117647058824;0.470588235294118
Control.SRR15539874;33;32;0.606060606060606;13;20;0.106060606060606;0.393939393939394
Control.SRR15539874;35;32;0.542857142857143;16;19;0.0428571428571428;0.457142857142857
Control.SRR15539874;32;32;0.46875;17;15;0.03125;0.46875
Control.SRR15539874;30;32;0.366666666666667;19;11;0.133333333333333;0.366666666666667
Control.SRR15539874;35;32;0.371428571428571;22;13;0.128571428571429;0.371428571428571
Control.SRR15539874;29;32;0.448275862068966;16;13;0.0517241379310345;0.448275862068966
Control.SRR15539874;32;32;0.4375;18;14;0.0625;0.4375
Control.SRR15539874;31;32;0.483870967741935;16;15;0.0161290322580645;0.483870967741935
Control.SRR15539874;35;32;0.6;14;21;0.1;0.4
Control.SRR15539874;33;32;0.666666666666667;11;22;0.166666666666667;0.333333333333333
Control.SRR15539874;29;32;0.620689655172414;11;18;0.120689655172414;0.379310344827586
Control.SRR15539874;35;32;0.6;14;21;0.1;0.4
Control.SRR15539874;34;32;0.5;17;17;0;0.5
Control.SRR15539874;33;32;0.606060606060606;13;20;0.106060606060606;0.393939393939394
Control.SRR15539874;34;32;0.647058823529412;12;22;0.147058823529412;0.352941176470588
Control.SRR15539874;36;32;0.527777777777778;17;19;0.0277777777777778;0.472222222222222
Control.SRR15539874;29;32;0.551724137931034;13;16;0.0517241379310345;0.448275862068966
Control.SRR15539874;37;32;0.432432432432432;21;16;0.0675675675675675;0.432432432432432
Control.SRR15539874;33;32;0.575757575757576;14;19;0.0757575757575758;0.424242424242424
Control.SRR15539874;34;32;0.529411764705882;16;18;0.0294117647058824;0.470588235294118
Control.SRR15539874;30;32;0.366666666666667;19;11;0.133333333333333;0.366666666666667
Control.SRR15539874;35;32;0.342857142857143;23;12;0.157142857142857;0.342857142857143
Control.SRR15539874;33;32;0.393939393939394;20;13;0.106060606060606;0.393939393939394
Control.SRR15539874;32;32;0.53125;15;17;0.03125;0.46875
Control.SRR15539874;35;32;0.428571428571429;20;15;0.0714285714285715;0.428571428571429
Control.SRR15539874;36;32;0.611111111111111;14;22;0.111111111111111;0.388888888888889
Control.SRR15539874;29;32;0.448275862068966;16;13;0.0517241379310345;0.448275862068966
Control.SRR15539874;31;32;0.354838709677419;20;11;0.145161290322581;0.354838709677419
Control.SRR15539874;29;32;0.379310344827586;18;11;0.120689655172414;0.379310344827586
Control.SRR15539874;32;32;0.46875;17;15;0.03125;0.46875
Control.SRR15539874;32;32;0.5;16;16;0;0.5
Control.SRR15539874;33;32;0.545454545454545;15;18;0.0454545454545454;0.454545454545455
Control.SRR15539874;30;32;0.566666666666667;13;17;0.0666666666666667;0.433333333333333
Control.SRR15539874;34;32;0.5;17;17;0;0.5
Control.SRR15539874;29;32;0.413793103448276;17;12;0.0862068965517241;0.413793103448276
Control.SRR15539874;33;32;0.606060606060606;13;20;0.106060606060606;0.393939393939394
Control.SRR15539874;31;32;0.387096774193548;19;12;0.112903225806452;0.387096774193548
Control.SRR15539874;29;32;0.586206896551724;12;17;0.0862068965517241;0.413793103448276
Control.SRR15539874;31;32;0.483870967741935;16;15;0.0161290322580645;0.483870967741935
Control.SRR15539874;29;32;0.517241379310345;14;15;0.0172413793103449;0.482758620689655
Control.SRR15539874;31;32;0.548387096774194;14;17;0.0483870967741935;0.451612903225806
Control.SRR15539874;32;32;0.46875;17;15;0.03125;0.46875
Control.SRR15539874;34;32;0.441176470588235;19;15;0.0588235294117647;0.441176470588235
Control.SRR15539874;33;32;0.454545454545455;18;15;0.0454545454545455;0.454545454545455
Control.SRR15539874;36;32;0.444444444444444;20;16;0.0555555555555556;0.444444444444444
Control.SRR15539874;33;32;0.696969696969697;10;23;0.196969696969697;0.303030303030303
Control.SRR15539874;31;32;0.387096774193548;19;12;0.112903225806452;0.387096774193548
Control.SRR15539874;29;32;0.517241379310345;14;15;0.0172413793103449;0.482758620689655
Control.SRR15539874;32;32;0.53125;15;17;0.03125;0.46875
Control.SRR15539874;30;32;0.5;15;15;0;0.5
Control.SRR15539874;33;32;0.484848484848485;17;16;0.0151515151515151;0.484848484848485
Control.SRR15539874;35;32;0.485714285714286;18;17;0.0142857142857143;0.485714285714286
Control.SRR15539874;32;32;0.65625;11;21;0.15625;0.34375
Control.SRR15539874;33;32;0.696969696969697;10;23;0.196969696969697;0.303030303030303
Control.SRR15539874;35;32;0.6;14;21;0.1;0.4
Control.SRR15539874;31;32;0.483870967741935;16;15;0.0161290322580645;0.483870967741935
Control.SRR15539874;31;32;0.516129032258065;15;16;0.0161290322580645;0.483870967741935
Control.SRR15539874;33;32;0.575757575757576;14;19;0.0757575757575758;0.424242424242424
Control.SRR15539874;34;32;0.558823529411765;15;19;0.0588235294117647;0.441176470588235
Control.SRR15539874;31;32;0.354838709677419;20;11;0.145161290322581;0.354838709677419
Control.SRR15539874;34;32;0.647058823529412;12;22;0.147058823529412;0.352941176470588
Control.SRR15539874;34;32;0.470588235294118;18;16;0.0294117647058824;0.470588235294118
Control.SRR15539874;29;32;0.448275862068966;16;13;0.0517241379310345;0.448275862068966
Control.SRR15539874;30;32;0.466666666666667;16;14;0.0333333333333333;0.466666666666667
Control.SRR15539874;36;32;0.527777777777778;17;19;0.0277777777777778;0.472222222222222
Control.SRR15539874;35;32;0.514285714285714;17;18;0.0142857142857142;0.485714285714286
Control.SRR15539874;34;32;0.382352941176471;21;13;0.117647058823529;0.382352941176471
Control.SRR15539874;30;32;0.4;18;12;0.1;0.4
Control.SRR15539874;36;32;0.611111111111111;14;22;0.111111111111111;0.388888888888889
Control.SRR15539874;34;32;0.617647058823529;13;21;0.117647058823529;0.382352941176471
Control.SRR15539874;37;32;0.621621621621622;14;23;0.121621621621622;0.378378378378378
Control.SRR15539874;37;32;0.540540540540541;17;20;0.0405405405405406;0.459459459459459
Control.SRR15539874;34;32;0.382352941176471;21;13;0.117647058823529;0.382352941176471
Control.SRR15539874;30;32;0.6;12;18;0.1;0.4
Control.SRR15539874;29;32;0.586206896551724;12;17;0.0862068965517241;0.413793103448276
Control.SRR15539874;35;32;0.6;14;21;0.1;0.4
Control.SRR15539874;34;32;0.5;17;17;0;0.5
Control.SRR15539874;29;32;0.413793103448276;17;12;0.0862068965517241;0.413793103448276
Control.SRR15539874;33;32;0.545454545454545;15;18;0.0454545454545454;0.454545454545455
Control.SRR15539874;29;32;0.517241379310345;14;15;0.0172413793103449;0.482758620689655
Control.SRR15539874;29;32;0.620689655172414;11;18;0.120689655172414;0.379310344827586
Control.SRR15539874;35;32;0.485714285714286;18;17;0.0142857142857143;0.485714285714286
Control.SRR15539874;32;32;0.5625;14;18;0.0625;0.4375
Control.SRR15539874;34;32;0.470588235294118;18;16;0.0294117647058824;0.470588235294118
Control.SRR15539874;31;32;0.580645161290323;13;18;0.0806451612903226;0.419354838709677
Control.SRR15539874;35;32;0.457142857142857;19;16;0.0428571428571429;0.457142857142857
Control.SRR15539874;36;32;0.472222222222222;19;17;0.0277777777777778;0.472222222222222
Control.SRR15539874;36;32;0.611111111111111;14;22;0.111111111111111;0.388888888888889
Control.SRR15539874;32;32;0.53125;15;17;0.03125;0.46875
Control.SRR15539874;30;32;0.566666666666667;13;17;0.0666666666666667;0.433333333333333
Control.SRR15539874;30;32;0.466666666666667;16;14;0.0333333333333333;0.466666666666667
Control.SRR15539874;37;32;0.72972972972973;10;27;0.22972972972973;0.27027027027027
Control.SRR15539874;37;32;0.486486486486487;19;18;0.0135135135135135;0.486486486486487
Control.SRR15539874;34;32;0.441176470588235;19;15;0.0588235294117647;0.441176470588235
Control.SRR15539874;29;32;0.517241379310345;14;15;0.0172413793103449;0.482758620689655
Control.SRR15539874;37;32;0.486486486486487;19;18;0.0135135135135135;0.486486486486487
Control.SRR15539874;31;32;0.483870967741935;16;15;0.0161290322580645;0.483870967741935
Control.SRR15539874;31;32;0.645161290322581;11;20;0.145161290322581;0.354838709677419
Control.SRR15539874;31;32;0.483870967741935;16;15;0.0161290322580645;0.483870967741935
Control.SRR15539874;32;32;0.6875;10;22;0.1875;0.3125
Control.SRR15539874;37;32;0.540540540540541;17;20;0.0405405405405406;0.459459459459459
Control.SRR15539874;33;32;0.363636363636364;21;12;0.136363636363636;0.363636363636364
Control.SRR15539874;33;32;0.575757575757576;14;19;0.0757575757575758;0.424242424242424
Control.SRR15539874;31;32;0.548387096774194;14;17;0.0483870967741935;0.451612903225806
Control.SRR15539874;33;32;0.515151515151515;16;17;0.0151515151515151;0.484848484848485
Control.SRR15539874;33;32;0.454545454545455;18;15;0.0454545454545455;0.454545454545455
Control.SRR15539874;33;32;0.575757575757576;14;19;0.0757575757575758;0.424242424242424
Control.SRR15539874;32;32;0.53125;15;17;0.03125;0.46875
Control.SRR15539874;30;32;0.566666666666667;13;17;0.0666666666666667;0.433333333333333
Control.SRR15539874;30;32;0.633333333333333;11;19;0.133333333333333;0.366666666666667
Control.SRR15539874;36;32;0.472222222222222;19;17;0.0277777777777778;0.472222222222222
Control.SRR15539874;35;32;0.514285714285714;17;18;0.0142857142857142;0.485714285714286
Control.SRR15539874;33;32;0.606060606060606;13;20;0.106060606060606;0.393939393939394
Control.SRR15539874;29;32;0.551724137931034;13;16;0.0517241379310345;0.448275862068966
Control.SRR15539874;29;32;0.448275862068966;16;13;0.0517241379310345;0.448275862068966
Control.SRR15539874;29;32;0.344827586206897;19;10;0.155172413793103;0.344827586206897
Control.SRR15539874;30;32;0.433333333333333;17;13;0.0666666666666667;0.433333333333333
Control.SRR15539874;32;32;0.4375;18;14;0.0625;0.4375
Control.SRR15539874;35;32;0.542857142857143;16;19;0.0428571428571428;0.457142857142857
Control.SRR15539874;36;32;0.416666666666667;21;15;0.0833333333333333;0.416666666666667
Control.SRR15539874;29;32;0.586206896551724;12;17;0.0862068965517241;0.413793103448276
Control.SRR15539874;32;32;0.375;20;12;0.125;0.375
Control.SRR15539874;30;32;0.566666666666667;13;17;0.0666666666666667;0.433333333333333
Control.SRR15539874;36;32;0.416666666666667;21;15;0.0833333333333333;0.416666666666667
Control.SRR15539874;37;32;0.432432432432432;21;16;0.0675675675675675;0.432432432432432
Control.SRR15539874;34;32;0.5;17;17;0;0.5
Control.SRR15539874;37;32;0.486486486486487;19;18;0.0135135135135135;0.486486486486487
Control.SRR15539874;32;32;0.46875;17;15;0.03125;0.46875
Control.SRR15539874;35;32;0.4;21;14;0.1;0.4
Control.SRR15539874;36;32;0.638888888888889;13;23;0.138888888888889;0.361111111111111
Control.SRR15539874;29;32;0.620689655172414;11;18;0.120689655172414;0.379310344827586
Control.SRR15539874;32;32;0.40625;19;13;0.09375;0.40625
Control.SRR15539874;31;32;0.32258064516129;21;10;0.17741935483871;0.32258064516129
Control.SRR15539874;30;32;0.6;12;18;0.1;0.4
Control.SRR15539874;29;32;0.620689655172414;11;18;0.120689655172414;0.379310344827586
Control.SRR15539874;33;32;0.454545454545455;18;15;0.0454545454545455;0.454545454545455
Control.SRR15539874;33;32;0.454545454545455;18;15;0.0454545454545455;0.454545454545455
Control.SRR15539874;31;32;0.548387096774194;14;17;0.0483870967741935;0.451612903225806
Control.SRR15539874;35;32;0.457142857142857;19;16;0.0428571428571429;0.457142857142857
Control.SRR15539874;35;32;0.457142857142857;19;16;0.0428571428571429;0.457142857142857
Control.SRR15539874;36;32;0.444444444444444;20;16;0.0555555555555556;0.444444444444444
Control.SRR15539874;36;32;0.472222222222222;19;17;0.0277777777777778;0.472222222222222
Control.SRR15539874;31;32;0.612903225806452;12;19;0.112903225806452;0.387096774193548
Control.SRR15539874;34;32;0.529411764705882;16;18;0.0294117647058824;0.470588235294118
Control.SRR15539874;32;32;0.46875;17;15;0.03125;0.46875
Control.SRR15539874;34;32;0.588235294117647;14;20;0.0882352941176471;0.411764705882353
Control.SRR15539874;32;32;0.65625;11;21;0.15625;0.34375
Control.SRR15539874;29;32;0.379310344827586;18;11;0.120689655172414;0.379310344827586
Control.SRR15539874;30;32;0.333333333333333;20;10;0.166666666666667;0.333333333333333
Control.SRR15539874;31;32;0.483870967741935;16;15;0.0161290322580645;0.483870967741935
Control.SRR15539874;32;32;0.625;12;20;0.125;0.375
Control.SRR15539874;29;32;0.551724137931034;13;16;0.0517241379310345;0.448275862068966
Control.SRR15539874;34;32;0.470588235294118;18;16;0.0294117647058824;0.470588235294118
Control.SRR15539874;37;32;0.486486486486487;19;18;0.0135135135135135;0.486486486486487
Control.SRR15539874;31;32;0.451612903225806;17;14;0.0483870967741936;0.451612903225806
Control.SRR15539874;36;32;0.5;18;18;0;0.5
Control.SRR15539874;37;32;0.459459459459459;20;17;0.0405405405405405;0.459459459459459
Control.SRR15539874;37;32;0.459459459459459;20;17;0.0405405405405405;0.459459459459459
Control.SRR15539874;34;32;0.617647058823529;13;21;0.117647058823529;0.382352941176471
Control.SRR15539874;32;32;0.40625;19;13;0.09375;0.40625
Control.SRR15539874;35;32;0.685714285714286;11;24;0.185714285714286;0.314285714285714
Control.SRR15539874;30;32;0.5;15;15;0;0.5
Control.SRR15539874;29;32;0.448275862068966;16;13;0.0517241379310345;0.448275862068966
Control.SRR15539874;37;32;0.513513513513513;18;19;0.0135135135135135;0.486486486486487
Control.SRR15539874;29;32;0.517241379310345;14;15;0.0172413793103449;0.482758620689655
Control.SRR15539874;37;32;0.513513513513513;18;19;0.0135135135135135;0.486486486486487
Control.SRR15539874;37;32;0.486486486486487;19;18;0.0135135135135135;0.486486486486487
Control.SRR15539874;31;32;0.580645161290323;13;18;0.0806451612903226;0.419354838709677
Control.SRR15539874;36;32;0.472222222222222;19;17;0.0277777777777778;0.472222222222222
Control.SRR15539874;35;32;0.485714285714286;18;17;0.0142857142857143;0.485714285714286
Control.SRR15539874;32;32;0.5;16;16;0;0.5
Control.SRR15539874;33;32;0.606060606060606;13;20;0.106060606060606;0.393939393939394
Control.SRR15539874;31;32;0.516129032258065;15;16;0.0161290322580645;0.483870967741935
Control.SRR15539874;33;32;0.424242424242424;19;14;0.0757575757575757;0.424242424242424
Control.SRR15539874;32;32;0.5625;14;18;0.0625;0.4375
Control.SRR15539874;33;32;0.484848484848485;17;16;0.0151515151515151;0.484848484848485
Control.SRR15539874;33;32;0.666666666666667;11;22;0.166666666666667;0.333333333333333
Control.SRR15539874;31;32;0.483870967741935;16;15;0.0161290322580645;0.483870967741935
Control.SRR15539874;32;32;0.3125;22;10;0.1875;0.3125
Control.SRR15539874;29;32;0.517241379310345;14;15;0.0172413793103449;0.482758620689655
Control.SRR15539874;31;32;0.483870967741935;16;15;0.0161290322580645;0.483870967741935
Control.SRR15539874;33;32;0.454545454545455;18;15;0.0454545454545455;0.454545454545455
Control.SRR15539874;34;32;0.382352941176471;21;13;0.117647058823529;0.382352941176471
Control.SRR15539874;34;32;0.529411764705882;16;18;0.0294117647058824;0.470588235294118
Control.SRR15539874;36;32;0.388888888888889;22;14;0.111111111111111;0.388888888888889
Control.SRR15539874;30;32;0.6;12;18;0.1;0.4
Control.SRR15539874;31;32;0.709677419354839;9;22;0.209677419354839;0.290322580645161
Control.SRR15539874;30;32;0.466666666666667;16;14;0.0333333333333333;0.466666666666667
Control.SRR15539874;35;32;0.4;21;14;0.1;0.4
Control.SRR15539874;32;32;0.59375;13;19;0.09375;0.40625
Control.SRR15539874;32;32;0.5625;14;18;0.0625;0.4375
Control.SRR15539874;35;32;0.485714285714286;18;17;0.0142857142857143;0.485714285714286
Control.SRR15539874;30;32;0.633333333333333;11;19;0.133333333333333;0.366666666666667
Control.SRR15539874;31;32;0.483870967741935;16;15;0.0161290322580645;0.483870967741935
Control.SRR15539874;33;32;0.575757575757576;14;19;0.0757575757575758;0.424242424242424
Control.SRR15539874;32;32;0.625;12;20;0.125;0.375
Control.SRR15539874;31;32;0.580645161290323;13;18;0.0806451612903226;0.419354838709677
Control.SRR15539874;30;32;0.366666666666667;19;11;0.133333333333333;0.366666666666667
Control.SRR15539874;30;32;0.6;12;18;0.1;0.4
Control.SRR15539874;35;32;0.371428571428571;22;13;0.128571428571429;0.371428571428571
Control.SRR15539874;33;32;0.515151515151515;16;17;0.0151515151515151;0.484848484848485
Control.SRR15539874;35;32;0.514285714285714;17;18;0.0142857142857142;0.485714285714286
Control.SRR15539874;33;32;0.393939393939394;20;13;0.106060606060606;0.393939393939394
Control.SRR15539874;30;32;0.433333333333333;17;13;0.0666666666666667;0.433333333333333
Control.SRR15539874;36;32;0.444444444444444;20;16;0.0555555555555556;0.444444444444444
Control.SRR15539874;34;32;0.441176470588235;19;15;0.0588235294117647;0.441176470588235
Control.SRR15539874;33;32;0.424242424242424;19;14;0.0757575757575757;0.424242424242424
Control.SRR15539874;32;32;0.5625;14;18;0.0625;0.4375
Control.SRR15539874;30;32;0.433333333333333;17;13;0.0666666666666667;0.433333333333333
Control.SRR15539874;35;32;0.685714285714286;11;24;0.185714285714286;0.314285714285714
Control.SRR15539874;31;32;0.258064516129032;23;8;0.241935483870968;0.258064516129032
Control.SRR15539874;37;32;0.513513513513513;18;19;0.0135135135135135;0.486486486486487
Control.SRR15539874;35;32;0.457142857142857;19;16;0.0428571428571429;0.457142857142857
Control.SRR15539874;33;32;0.606060606060606;13;20;0.106060606060606;0.393939393939394
Control.SRR15539874;34;32;0.470588235294118;18;16;0.0294117647058824;0.470588235294118
Control.SRR15539874;34;32;0.441176470588235;19;15;0.0588235294117647;0.441176470588235
Control.SRR15539874;36;32;0.444444444444444;20;16;0.0555555555555556;0.444444444444444
Control.SRR15539874;34;32;0.411764705882353;20;14;0.0882352941176471;0.411764705882353
Control.SRR15539874;37;32;0.486486486486487;19;18;0.0135135135135135;0.486486486486487
Control.SRR15539874;37;32;0.621621621621622;14;23;0.121621621621622;0.378378378378378
Control.SRR15539874;29;32;0.655172413793103;10;19;0.155172413793103;0.344827586206897
Control.SRR15539874;33;32;0.666666666666667;11;22;0.166666666666667;0.333333333333333
Control.SRR15539874;36;32;0.416666666666667;21;15;0.0833333333333333;0.416666666666667
Control.SRR15539874;36;32;0.416666666666667;21;15;0.0833333333333333;0.416666666666667
Control.SRR15539874;31;32;0.387096774193548;19;12;0.112903225806452;0.387096774193548
Control.SRR15539874;32;32;0.6875;10;22;0.1875;0.3125
Control.SRR15539874;31;32;0.451612903225806;17;14;0.0483870967741936;0.451612903225806
Control.SRR15539874;33;32;0.636363636363636;12;21;0.136363636363636;0.363636363636364
Control.SRR15539874;31;32;0.451612903225806;17;14;0.0483870967741936;0.451612903225806
Control.SRR15539874;31;32;0.548387096774194;14;17;0.0483870967741935;0.451612903225806
Control.SRR15539874;34;32;0.441176470588235;19;15;0.0588235294117647;0.441176470588235
Control.SRR15539874;32;32;0.625;12;20;0.125;0.375
Control.SRR15539874;36;32;0.583333333333333;15;21;0.0833333333333334;0.416666666666667
Control.SRR15539874;37;32;0.432432432432432;21;16;0.0675675675675675;0.432432432432432
Control.SRR15539874;31;32;0.451612903225806;17;14;0.0483870967741936;0.451612903225806
Control.SRR15539874;33;32;0.545454545454545;15;18;0.0454545454545454;0.454545454545455
Control.SRR15539874;31;32;0.580645161290323;13;18;0.0806451612903226;0.419354838709677
Control.SRR15539874;30;32;0.5;15;15;0;0.5
Control.SRR15539874;31;32;0.419354838709677;18;13;0.0806451612903226;0.419354838709677
Control.SRR15539874;36;32;0.472222222222222;19;17;0.0277777777777778;0.472222222222222
Control.SRR15539874;37;32;0.459459459459459;20;17;0.0405405405405405;0.459459459459459
Control.SRR15539874;34;32;0.529411764705882;16;18;0.0294117647058824;0.470588235294118
Control.SRR15539874;32;32;0.46875;17;15;0.03125;0.46875
Control.SRR15539874;32;32;0.5625;14;18;0.0625;0.4375
Control.SRR15539874;35;32;0.314285714285714;24;11;0.185714285714286;0.314285714285714
Control.SRR15539874;35;32;0.4;21;14;0.1;0.4
Control.SRR15539874;30;32;0.566666666666667;13;17;0.0666666666666667;0.433333333333333
Control.SRR15539874;33;32;0.606060606060606;13;20;0.106060606060606;0.393939393939394
Control.SRR15539874;33;32;0.545454545454545;15;18;0.0454545454545454;0.454545454545455
Control.SRR15539874;32;32;0.25;24;8;0.25;0.25
Control.SRR15539874;32;32;0.4375;18;14;0.0625;0.4375
Control.SRR15539874;29;32;0.517241379310345;14;15;0.0172413793103449;0.482758620689655
Control.SRR15539874;32;32;0.5;16;16;0;0.5
Control.SRR15539874;30;32;0.5;15;15;0;0.5
Control.SRR15539874;35;32;0.485714285714286;18;17;0.0142857142857143;0.485714285714286
Control.SRR15539874;34;32;0.411764705882353;20;14;0.0882352941176471;0.411764705882353
Control.SRR15539874;33;32;0.484848484848485;17;16;0.0151515151515151;0.484848484848485
Control.SRR15539874;36;32;0.472222222222222;19;17;0.0277777777777778;0.472222222222222
Control.SRR15539874;31;32;0.419354838709677;18;13;0.0806451612903226;0.419354838709677
Control.SRR15539874;34;32;0.382352941176471;21;13;0.117647058823529;0.382352941176471
Control.SRR15539874;31;32;0.483870967741935;16;15;0.0161290322580645;0.483870967741935
Control.SRR15539874;31;32;0.354838709677419;20;11;0.145161290322581;0.354838709677419
Control.SRR15539874;29;32;0.448275862068966;16;13;0.0517241379310345;0.448275862068966
Control.SRR15539874;31;32;0.612903225806452;12;19;0.112903225806452;0.387096774193548
Control.SRR15539874;30;32;0.466666666666667;16;14;0.0333333333333333;0.466666666666667
Control.SRR15539874;33;32;0.393939393939394;20;13;0.106060606060606;0.393939393939394
Control.SRR15539874;32;32;0.65625;11;21;0.15625;0.34375
Control.SRR15539874;32;32;0.4375;18;14;0.0625;0.4375
Control.SRR15539874;32;32;0.5;16;16;0;0.5
Control.SRR15539874;35;32;0.628571428571429;13;22;0.128571428571429;0.371428571428571
Control.SRR15539874;29;32;0.413793103448276;17;12;0.0862068965517241;0.413793103448276
Control.SRR15539874;37;32;0.459459459459459;20;17;0.0405405405405405;0.459459459459459
Control.SRR15539874;33;32;0.454545454545455;18;15;0.0454545454545455;0.454545454545455
Control.SRR15539874;37;32;0.378378378378378;23;14;0.121621621621622;0.378378378378378
Control.SRR15539874;30;32;0.366666666666667;19;11;0.133333333333333;0.366666666666667
Control.SRR15539874;37;32;0.378378378378378;23;14;0.121621621621622;0.378378378378378
Control.SRR15539874;36;32;0.5;18;18;0;0.5
Control.SRR15539874;31;32;0.548387096774194;14;17;0.0483870967741935;0.451612903225806
Control.SRR15539874;32;32;0.5;16;16;0;0.5
Control.SRR15539874;32;32;0.46875;17;15;0.03125;0.46875
Control.SRR15539874;32;32;0.78125;7;25;0.28125;0.21875
Control.SRR15539874;33;32;0.515151515151515;16;17;0.0151515151515151;0.484848484848485
Control.SRR15539874;31;32;0.419354838709677;18;13;0.0806451612903226;0.419354838709677
Control.SRR15539874;37;32;0.459459459459459;20;17;0.0405405405405405;0.459459459459459
Control.SRR15539874;31;32;0.612903225806452;12;19;0.112903225806452;0.387096774193548
Control.SRR15539874;31;32;0.516129032258065;15;16;0.0161290322580645;0.483870967741935
Control.SRR15539874;32;32;0.71875;9;23;0.21875;0.28125
Control.SRR15539874;33;32;0.424242424242424;19;14;0.0757575757575757;0.424242424242424
Control.SRR15539874;33;32;0.545454545454545;15;18;0.0454545454545454;0.454545454545455
Control.SRR15539874;33;32;0.303030303030303;23;10;0.196969696969697;0.303030303030303
Control.SRR15539874;29;32;0.517241379310345;14;15;0.0172413793103449;0.482758620689655
Control.SRR15539874;32;32;0.5;16;16;0;0.5
Control.SRR15539874;29;32;0.448275862068966;16;13;0.0517241379310345;0.448275862068966
Control.SRR15539874;30;32;0.333333333333333;20;10;0.166666666666667;0.333333333333333
Control.SRR15539874;34;32;0.588235294117647;14;20;0.0882352941176471;0.411764705882353
Control.SRR15539874;36;32;0.555555555555556;16;20;0.0555555555555556;0.444444444444444
Control.SRR15539874;34;32;0.470588235294118;18;16;0.0294117647058824;0.470588235294118
Control.SRR15539874;36;32;0.583333333333333;15;21;0.0833333333333334;0.416666666666667
Control.SRR15539874;31;32;0.419354838709677;18;13;0.0806451612903226;0.419354838709677
Control.SRR15539874;29;32;0.413793103448276;17;12;0.0862068965517241;0.413793103448276
Control.SRR15539874;29;32;0.689655172413793;9;20;0.189655172413793;0.310344827586207
Control.SRR15539874;30;32;0.566666666666667;13;17;0.0666666666666667;0.433333333333333
Control.SRR15539874;29;32;0.551724137931034;13;16;0.0517241379310345;0.448275862068966
Control.SRR15539874;30;32;0.633333333333333;11;19;0.133333333333333;0.366666666666667
Control.SRR15539874;30;32;0.466666666666667;16;14;0.0333333333333333;0.466666666666667
Control.SRR15539874;30;32;0.6;12;18;0.1;0.4
Control.SRR15539874;29;32;0.517241379310345;14;15;0.0172413793103449;0.482758620689655
Control.SRR15539874;36;32;0.416666666666667;21;15;0.0833333333333333;0.416666666666667
Control.SRR15539874;35;32;0.742857142857143;9;26;0.242857142857143;0.257142857142857
Control.SRR15539874;36;32;0.583333333333333;15;21;0.0833333333333334;0.416666666666667
Control.SRR15539874;29;32;0.448275862068966;16;13;0.0517241379310345;0.448275862068966
Control.SRR15539874;33;32;0.454545454545455;18;15;0.0454545454545455;0.454545454545455
Control.SRR15539874;37;32;0.459459459459459;20;17;0.0405405405405405;0.459459459459459
Control.SRR15539874;33;32;0.515151515151515;16;17;0.0151515151515151;0.484848484848485
Control.SRR15539874;35;32;0.485714285714286;18;17;0.0142857142857143;0.485714285714286
Control.SRR15539874;32;32;0.5;16;16;0;0.5
Control.SRR15539874;33;32;0.666666666666667;11;22;0.166666666666667;0.333333333333333
Control.SRR15539874;30;32;0.366666666666667;19;11;0.133333333333333;0.366666666666667
Control.SRR15539874;29;32;0.448275862068966;16;13;0.0517241379310345;0.448275862068966
Control.SRR15539874;29;32;0.482758620689655;15;14;0.0172413793103448;0.482758620689655
Control.SRR15539874;30;32;0.433333333333333;17;13;0.0666666666666667;0.433333333333333
Control.SRR15539874;33;32;0.575757575757576;14;19;0.0757575757575758;0.424242424242424
Control.SRR15539874;34;32;0.5;17;17;0;0.5
Control.SRR15539874;33;32;0.575757575757576;14;19;0.0757575757575758;0.424242424242424
Control.SRR15539874;31;32;0.580645161290323;13;18;0.0806451612903226;0.419354838709677
Control.SRR15539874;31;32;0.580645161290323;13;18;0.0806451612903226;0.419354838709677
Control.SRR15539874;31;32;0.483870967741935;16;15;0.0161290322580645;0.483870967741935
Control.SRR15539874;35;32;0.342857142857143;23;12;0.157142857142857;0.342857142857143
Control.SRR15539874;32;32;0.53125;15;17;0.03125;0.46875
Control.SRR15539874;29;32;0.655172413793103;10;19;0.155172413793103;0.344827586206897
Control.SRR15539874;30;32;0.5;15;15;0;0.5
Control.SRR15539874;34;32;0.588235294117647;14;20;0.0882352941176471;0.411764705882353
Control.SRR15539874;35;32;0.571428571428571;15;20;0.0714285714285714;0.428571428571429
Control.SRR15539874;31;32;0.483870967741935;16;15;0.0161290322580645;0.483870967741935
Control.SRR15539874;29;32;0.379310344827586;18;11;0.120689655172414;0.379310344827586
Control.SRR15539874;32;32;0.53125;15;17;0.03125;0.46875
Control.SRR15539874;37;32;0.459459459459459;20;17;0.0405405405405405;0.459459459459459
Control.SRR15539874;29;32;0.448275862068966;16;13;0.0517241379310345;0.448275862068966
Control.SRR15539874;30;32;0.6;12;18;0.1;0.4
Control.SRR15539874;30;32;0.733333333333333;8;22;0.233333333333333;0.266666666666667
Control.SRR15539874;32;32;0.59375;13;19;0.09375;0.40625
Control.SRR15539874;33;32;0.606060606060606;13;20;0.106060606060606;0.393939393939394
Control.SRR15539874;31;32;0.419354838709677;18;13;0.0806451612903226;0.419354838709677
Control.SRR15539874;28;32;0.464285714285714;15;13;0.0357142857142857;0.464285714285714
Control.SRR15539874;34;32;0.558823529411765;15;19;0.0588235294117647;0.441176470588235
Control.SRR15539874;36;32;0.472222222222222;19;17;0.0277777777777778;0.472222222222222
Control.SRR15539874;30;32;0.366666666666667;19;11;0.133333333333333;0.366666666666667
Control.SRR15539874;34;32;0.5;17;17;0;0.5
Control.SRR15539874;35;32;0.542857142857143;16;19;0.0428571428571428;0.457142857142857
Control.SRR15539874;32;32;0.5625;14;18;0.0625;0.4375
Control.SRR15539874;28;32;0.392857142857143;17;11;0.107142857142857;0.392857142857143
Control.SRR15539874;29;32;0.551724137931034;13;16;0.0517241379310345;0.448275862068966
Control.SRR15539874;33;32;0.696969696969697;10;23;0.196969696969697;0.303030303030303
Control.SRR15539874;31;32;0.580645161290323;13;18;0.0806451612903226;0.419354838709677
Control.SRR15539874;36;32;0.555555555555556;16;20;0.0555555555555556;0.444444444444444
Control.SRR15539874;31;32;0.516129032258065;15;16;0.0161290322580645;0.483870967741935
Control.SRR15539874;34;32;0.470588235294118;18;16;0.0294117647058824;0.470588235294118
Control.SRR15539874;31;32;0.419354838709677;18;13;0.0806451612903226;0.419354838709677
Control.SRR15539874;35;32;0.542857142857143;16;19;0.0428571428571428;0.457142857142857
Control.SRR15539874;30;32;0.6;12;18;0.1;0.4
Control.SRR15539874;31;32;0.516129032258065;15;16;0.0161290322580645;0.483870967741935
Control.SRR15539874;35;32;0.485714285714286;18;17;0.0142857142857143;0.485714285714286
Control.SRR15539874;34;32;0.5;17;17;0;0.5
Control.SRR15539874;31;32;0.612903225806452;12;19;0.112903225806452;0.387096774193548
Control.SRR15539874;30;32;0.4;18;12;0.1;0.4
Control.SRR15539874;30;32;0.466666666666667;16;14;0.0333333333333333;0.466666666666667
Control.SRR15539874;33;32;0.666666666666667;11;22;0.166666666666667;0.333333333333333
Control.SRR15539874;32;32;0.71875;9;23;0.21875;0.28125
Control.SRR15539874;36;32;0.555555555555556;16;20;0.0555555555555556;0.444444444444444
Control.SRR15539874;31;32;0.419354838709677;18;13;0.0806451612903226;0.419354838709677
Control.SRR15539874;28;32;0.464285714285714;15;13;0.0357142857142857;0.464285714285714
Control.SRR15539874;32;32;0.40625;19;13;0.09375;0.40625
Control.SRR15539874;28;32;0.5;14;14;0;0.5
Control.SRR15539874;34;32;0.529411764705882;16;18;0.0294117647058824;0.470588235294118
Control.SRR15539874;35;32;0.542857142857143;16;19;0.0428571428571428;0.457142857142857
Control.SRR15539874;35;32;0.6;14;21;0.1;0.4
Control.SRR15539874;32;32;0.53125;15;17;0.03125;0.46875
Control.SRR15539874;31;32;0.612903225806452;12;19;0.112903225806452;0.387096774193548
Control.SRR15539874;29;32;0.448275862068966;16;13;0.0517241379310345;0.448275862068966
Control.SRR15539874;34;32;0.382352941176471;21;13;0.117647058823529;0.382352941176471
Control.SRR15539874;36;32;0.472222222222222;19;17;0.0277777777777778;0.472222222222222
Control.SRR15539874;35;32;0.485714285714286;18;17;0.0142857142857143;0.485714285714286
Control.SRR15539874;31;32;0.451612903225806;17;14;0.0483870967741936;0.451612903225806
Control.SRR15539874;35;32;0.571428571428571;15;20;0.0714285714285714;0.428571428571429
Control.SRR15539874;29;32;0.551724137931034;13;16;0.0517241379310345;0.448275862068966
Control.SRR15539874;30;32;0.5;15;15;0;0.5
Control.SRR15539874;30;32;0.566666666666667;13;17;0.0666666666666667;0.433333333333333
Control.SRR15539874;29;32;0.586206896551724;12;17;0.0862068965517241;0.413793103448276
Control.SRR15539874;33;32;0.515151515151515;16;17;0.0151515151515151;0.484848484848485
Control.SRR15539874;34;32;0.558823529411765;15;19;0.0588235294117647;0.441176470588235
Control.SRR15539874;35;32;0.514285714285714;17;18;0.0142857142857142;0.485714285714286
Control.SRR15539874;33;32;0.454545454545455;18;15;0.0454545454545455;0.454545454545455
Control.SRR15539874;33;32;0.454545454545455;18;15;0.0454545454545455;0.454545454545455
Control.SRR15539874;35;32;0.571428571428571;15;20;0.0714285714285714;0.428571428571429
Control.SRR15539874;30;32;0.5;15;15;0;0.5
Control.SRR15539874;34;32;0.647058823529412;12;22;0.147058823529412;0.352941176470588
Control.SRR15539874;34;32;0.529411764705882;16;18;0.0294117647058824;0.470588235294118
Control.SRR15539874;34;32;0.529411764705882;16;18;0.0294117647058824;0.470588235294118
Control.SRR15539874;33;32;0.454545454545455;18;15;0.0454545454545455;0.454545454545455
Control.SRR15539874;33;32;0.484848484848485;17;16;0.0151515151515151;0.484848484848485
Control.SRR15539874;35;32;0.571428571428571;15;20;0.0714285714285714;0.428571428571429
Control.SRR15539874;35;32;0.514285714285714;17;18;0.0142857142857142;0.485714285714286
Control.SRR15539874;35;32;0.485714285714286;18;17;0.0142857142857143;0.485714285714286
Control.SRR15539874;28;32;0.535714285714286;13;15;0.0357142857142857;0.464285714285714
Control.SRR15539874;34;32;0.382352941176471;21;13;0.117647058823529;0.382352941176471
Control.SRR15539874;36;32;0.5;18;18;0;0.5
Control.SRR15539874;30;32;0.3;21;9;0.2;0.3
Control.SRR15539874;29;32;0.551724137931034;13;16;0.0517241379310345;0.448275862068966
Control.SRR15539874;33;32;0.606060606060606;13;20;0.106060606060606;0.393939393939394
Control.SRR15539874;32;32;0.4375;18;14;0.0625;0.4375
Control.SRR15539874;28;32;0.535714285714286;13;15;0.0357142857142857;0.464285714285714
Control.SRR15539874;32;32;0.53125;15;17;0.03125;0.46875
Control.SRR15539874;28;32;0.428571428571429;16;12;0.0714285714285715;0.428571428571429
Control.SRR15539874;34;32;0.5;17;17;0;0.5
Control.SRR15539874;31;32;0.709677419354839;9;22;0.209677419354839;0.290322580645161
Control.SRR15539874;34;32;0.558823529411765;15;19;0.0588235294117647;0.441176470588235
Control.SRR15539874;30;32;0.5;15;15;0;0.5
Control.SRR15539874;35;32;0.342857142857143;23;12;0.157142857142857;0.342857142857143
Control.SRR15539874;36;32;0.527777777777778;17;19;0.0277777777777778;0.472222222222222
Control.SRR15539874;31;32;0.451612903225806;17;14;0.0483870967741936;0.451612903225806
Control.SRR15539874;29;32;0.448275862068966;16;13;0.0517241379310345;0.448275862068966
Control.SRR15539874;31;32;0.387096774193548;19;12;0.112903225806452;0.387096774193548
Control.SRR15539874;33;32;0.515151515151515;16;17;0.0151515151515151;0.484848484848485
Control.SRR15539874;34;32;0.529411764705882;16;18;0.0294117647058824;0.470588235294118
Control.SRR15539874;30;32;0.366666666666667;19;11;0.133333333333333;0.366666666666667
Control.SRR15539874;30;32;0.433333333333333;17;13;0.0666666666666667;0.433333333333333
Control.SRR15539874;29;32;0.413793103448276;17;12;0.0862068965517241;0.413793103448276
Control.SRR15539874;29;32;0.482758620689655;15;14;0.0172413793103448;0.482758620689655
Control.SRR15539874;28;32;0.571428571428571;12;16;0.0714285714285714;0.428571428571429
Control.SRR15539874;30;32;0.633333333333333;11;19;0.133333333333333;0.366666666666667
Control.SRR15539874;32;32;0.4375;18;14;0.0625;0.4375
Control.SRR15539874;30;32;0.6;12;18;0.1;0.4
Control.SRR15539874;28;32;0.5;14;14;0;0.5
Control.SRR15539874;34;32;0.411764705882353;20;14;0.0882352941176471;0.411764705882353
Control.SRR15539874;28;32;0.285714285714286;20;8;0.214285714285714;0.285714285714286
Control.SRR15539874;31;32;0.645161290322581;11;20;0.145161290322581;0.354838709677419
Control.SRR15539874;30;32;0.5;15;15;0;0.5
Control.SRR15539874;34;32;0.5;17;17;0;0.5
Control.SRR15539874;28;32;0.535714285714286;13;15;0.0357142857142857;0.464285714285714
Control.SRR15539874;31;32;0.483870967741935;16;15;0.0161290322580645;0.483870967741935
Control.SRR15539874;30;32;0.433333333333333;17;13;0.0666666666666667;0.433333333333333
Control.SRR15539874;34;32;0.470588235294118;18;16;0.0294117647058824;0.470588235294118
Control.SRR15539874;36;32;0.444444444444444;20;16;0.0555555555555556;0.444444444444444
Control.SRR15539874;32;32;0.53125;15;17;0.03125;0.46875
Control.SRR15539874;33;32;0.545454545454545;15;18;0.0454545454545454;0.454545454545455
Control.SRR15539874;30;32;0.5;15;15;0;0.5
Control.SRR15539874;31;32;0.516129032258065;15;16;0.0161290322580645;0.483870967741935
Control.SRR15539874;31;32;0.548387096774194;14;17;0.0483870967741935;0.451612903225806
Control.SRR15539874;31;32;0.580645161290323;13;18;0.0806451612903226;0.419354838709677
Control.SRR15539874;31;32;0.451612903225806;17;14;0.0483870967741936;0.451612903225806
Control.SRR15539874;31;32;0.451612903225806;17;14;0.0483870967741936;0.451612903225806
Control.SRR15539874;36;32;0.611111111111111;14;22;0.111111111111111;0.388888888888889
Control.SRR15539874;28;32;0.5;14;14;0;0.5
Control.SRR15539874;28;32;0.5;14;14;0;0.5
Control.SRR15539874;31;32;0.516129032258065;15;16;0.0161290322580645;0.483870967741935
Control.SRR15539874;28;32;0.607142857142857;11;17;0.107142857142857;0.392857142857143
Control.SRR15539874;31;32;0.580645161290323;13;18;0.0806451612903226;0.419354838709677
Control.SRR15539874;34;32;0.470588235294118;18;16;0.0294117647058824;0.470588235294118
Control.SRR15539874;33;32;0.515151515151515;16;17;0.0151515151515151;0.484848484848485
Control.SRR15539874;33;32;0.575757575757576;14;19;0.0757575757575758;0.424242424242424
Control.SRR15539874;31;32;0.483870967741935;16;15;0.0161290322580645;0.483870967741935
Control.SRR15539874;34;32;0.441176470588235;19;15;0.0588235294117647;0.441176470588235
Control.SRR15539874;33;32;0.484848484848485;17;16;0.0151515151515151;0.484848484848485
Control.SRR15539874;35;32;0.714285714285714;10;25;0.214285714285714;0.285714285714286
Control.SRR15539874;31;32;0.483870967741935;16;15;0.0161290322580645;0.483870967741935
Control.SRR15539874;29;32;0.482758620689655;15;14;0.0172413793103448;0.482758620689655
Control.SRR15539874;30;32;0.433333333333333;17;13;0.0666666666666667;0.433333333333333
Control.SRR15539874;33;32;0.363636363636364;21;12;0.136363636363636;0.363636363636364
Control.SRR15539874;36;32;0.611111111111111;14;22;0.111111111111111;0.388888888888889
Control.SRR15539874;34;32;0.470588235294118;18;16;0.0294117647058824;0.470588235294118
Control.SRR15539874;32;32;0.5;16;16;0;0.5
Control.SRR15539874;36;32;0.472222222222222;19;17;0.0277777777777778;0.472222222222222
Control.SRR15539874;36;32;0.527777777777778;17;19;0.0277777777777778;0.472222222222222
Control.SRR15539874;31;32;0.548387096774194;14;17;0.0483870967741935;0.451612903225806
Control.SRR15539874;32;32;0.4375;18;14;0.0625;0.4375
Control.SRR15539874;33;32;0.545454545454545;15;18;0.0454545454545454;0.454545454545455
Control.SRR15539874;28;32;0.607142857142857;11;17;0.107142857142857;0.392857142857143
Control.SRR15539874;28;32;0.357142857142857;18;10;0.142857142857143;0.357142857142857
Control.SRR15539874;33;32;0.484848484848485;17;16;0.0151515151515151;0.484848484848485
Control.SRR15539874;35;32;0.428571428571429;20;15;0.0714285714285715;0.428571428571429
Control.SRR15539874;36;32;0.5;18;18;0;0.5
Control.SRR15539874;32;32;0.625;12;20;0.125;0.375
Control.SRR15539874;33;32;0.424242424242424;19;14;0.0757575757575757;0.424242424242424
Control.SRR15539874;31;32;0.451612903225806;17;14;0.0483870967741936;0.451612903225806
Control.SRR15539874;29;32;0.448275862068966;16;13;0.0517241379310345;0.448275862068966
Control.SRR15539874;32;32;0.46875;17;15;0.03125;0.46875
Control.SRR15539874;29;32;0.310344827586207;20;9;0.189655172413793;0.310344827586207
Control.SRR15539874;35;32;0.514285714285714;17;18;0.0142857142857142;0.485714285714286
Control.SRR15539874;31;32;0.580645161290323;13;18;0.0806451612903226;0.419354838709677
Control.SRR15539874;36;32;0.388888888888889;22;14;0.111111111111111;0.388888888888889
Control.SRR15539874;34;32;0.5;17;17;0;0.5
Control.SRR15539874;34;32;0.441176470588235;19;15;0.0588235294117647;0.441176470588235
Control.SRR15539874;32;32;0.46875;17;15;0.03125;0.46875
Control.SRR15539874;34;32;0.529411764705882;16;18;0.0294117647058824;0.470588235294118
Control.SRR15539874;30;32;0.433333333333333;17;13;0.0666666666666667;0.433333333333333
Control.SRR15539874;29;32;0.689655172413793;9;20;0.189655172413793;0.310344827586207
Control.SRR15539874;28;32;0.571428571428571;12;16;0.0714285714285714;0.428571428571429
Control.SRR15539874;29;32;0.482758620689655;15;14;0.0172413793103448;0.482758620689655
Control.SRR15539874;32;32;0.53125;15;17;0.03125;0.46875
Control.SRR15539874;35;32;0.4;21;14;0.1;0.4
Control.SRR15539874;34;32;0.705882352941177;10;24;0.205882352941177;0.294117647058824
Control.SRR15539874;29;32;0.413793103448276;17;12;0.0862068965517241;0.413793103448276
Control.SRR15539874;31;32;0.451612903225806;17;14;0.0483870967741936;0.451612903225806
Control.SRR15539874;35;32;0.428571428571429;20;15;0.0714285714285715;0.428571428571429
Control.SRR15539874;29;32;0.482758620689655;15;14;0.0172413793103448;0.482758620689655
Control.SRR15539874;29;32;0.241379310344828;22;7;0.258620689655172;0.241379310344828
Control.SRR15539874;35;32;0.428571428571429;20;15;0.0714285714285715;0.428571428571429
Control.SRR15539874;30;32;0.6;12;18;0.1;0.4
Control.SRR15539874;36;32;0.638888888888889;13;23;0.138888888888889;0.361111111111111
Control.SRR15539874;31;32;0.483870967741935;16;15;0.0161290322580645;0.483870967741935
Control.SRR15539874;30;32;0.366666666666667;19;11;0.133333333333333;0.366666666666667
Control.SRR15539874;34;32;0.5;17;17;0;0.5
Control.SRR15539874;36;32;0.638888888888889;13;23;0.138888888888889;0.361111111111111
Control.SRR15539874;34;32;0.441176470588235;19;15;0.0588235294117647;0.441176470588235
Control.SRR15539874;30;32;0.466666666666667;16;14;0.0333333333333333;0.466666666666667
Control.SRR15539874;30;32;0.3;21;9;0.2;0.3
Control.SRR15539874;34;32;0.352941176470588;22;12;0.147058823529412;0.352941176470588
Control.SRR15539874;36;32;0.305555555555556;25;11;0.194444444444444;0.305555555555556
Control.SRR15539874;35;32;0.542857142857143;16;19;0.0428571428571428;0.457142857142857
Control.SRR15539874;28;32;0.5;14;14;0;0.5
Control.SRR15539874;32;32;0.5;16;16;0;0.5
Control.SRR15539874;34;32;0.352941176470588;22;12;0.147058823529412;0.352941176470588
Control.SRR15539874;33;32;0.424242424242424;19;14;0.0757575757575757;0.424242424242424
Control.SRR15539874;32;32;0.40625;19;13;0.09375;0.40625
Control.SRR15539874;34;32;0.470588235294118;18;16;0.0294117647058824;0.470588235294118
Control.SRR15539874;33;32;0.272727272727273;24;9;0.227272727272727;0.272727272727273
Control.SRR15539874;35;32;0.514285714285714;17;18;0.0142857142857142;0.485714285714286
Control.SRR15539874;36;32;0.611111111111111;14;22;0.111111111111111;0.388888888888889
Control.SRR15539874;34;32;0.558823529411765;15;19;0.0588235294117647;0.441176470588235
Control.SRR15539874;28;32;0.5;14;14;0;0.5
Control.SRR15539874;35;32;0.285714285714286;25;10;0.214285714285714;0.285714285714286
Control.SRR15539874;33;32;0.515151515151515;16;17;0.0151515151515151;0.484848484848485
Control.SRR15539874;32;32;0.5625;14;18;0.0625;0.4375
Control.SRR15539874;34;32;0.441176470588235;19;15;0.0588235294117647;0.441176470588235
Control.SRR15539874;36;32;0.611111111111111;14;22;0.111111111111111;0.388888888888889
Control.SRR15539874;35;32;0.457142857142857;19;16;0.0428571428571429;0.457142857142857
Control.SRR15539874;33;32;0.515151515151515;16;17;0.0151515151515151;0.484848484848485
Control.SRR15539874;30;32;0.633333333333333;11;19;0.133333333333333;0.366666666666667
Control.SRR15539874;30;32;0.433333333333333;17;13;0.0666666666666667;0.433333333333333
Control.SRR15539874;32;32;0.46875;17;15;0.03125;0.46875
Control.SRR15539874;29;32;0.482758620689655;15;14;0.0172413793103448;0.482758620689655
Control.SRR15539874;29;32;0.551724137931034;13;16;0.0517241379310345;0.448275862068966
Control.SRR15539874;28;32;0.392857142857143;17;11;0.107142857142857;0.392857142857143
Control.SRR15539874;28;32;0.464285714285714;15;13;0.0357142857142857;0.464285714285714
Control.SRR15539874;28;32;0.464285714285714;15;13;0.0357142857142857;0.464285714285714
Control.SRR15539874;32;32;0.5;16;16;0;0.5
Control.SRR15539874;34;32;0.323529411764706;23;11;0.176470588235294;0.323529411764706
Control.SRR15539874;28;32;0.535714285714286;13;15;0.0357142857142857;0.464285714285714
Control.SRR15539874;35;32;0.514285714285714;17;18;0.0142857142857142;0.485714285714286
Control.SRR15539874;33;32;0.363636363636364;21;12;0.136363636363636;0.363636363636364
Control.SRR15539874;29;32;0.620689655172414;11;18;0.120689655172414;0.379310344827586
Control.SRR15539874;31;32;0.387096774193548;19;12;0.112903225806452;0.387096774193548
Control.SRR15539874;31;32;0.419354838709677;18;13;0.0806451612903226;0.419354838709677
Control.SRR15539874;30;32;0.533333333333333;14;16;0.0333333333333333;0.466666666666667
Control.SRR15539874;31;32;0.290322580645161;22;9;0.209677419354839;0.290322580645161
Control.SRR15539874;35;32;0.485714285714286;18;17;0.0142857142857143;0.485714285714286
Control.SRR15539874;34;32;0.382352941176471;21;13;0.117647058823529;0.382352941176471
Control.SRR15539874;33;32;0.545454545454545;15;18;0.0454545454545454;0.454545454545455
Control.SRR15539874;29;32;0.689655172413793;9;20;0.189655172413793;0.310344827586207
Control.SRR15539874;35;32;0.514285714285714;17;18;0.0142857142857142;0.485714285714286
Control.SRR15539874;35;32;0.657142857142857;12;23;0.157142857142857;0.342857142857143
Control.SRR15539874;35;32;0.571428571428571;15;20;0.0714285714285714;0.428571428571429
Control.SRR15539874;33;32;0.545454545454545;15;18;0.0454545454545454;0.454545454545455
Control.SRR15539874;31;32;0.548387096774194;14;17;0.0483870967741935;0.451612903225806
Control.SRR15539874;30;32;0.3;21;9;0.2;0.3
Control.SRR15539874;34;32;0.5;17;17;0;0.5
Control.SRR15539874;34;32;0.441176470588235;19;15;0.0588235294117647;0.441176470588235
Control.SRR15539874;30;32;0.5;15;15;0;0.5
Control.SRR15539874;29;32;0.620689655172414;11;18;0.120689655172414;0.379310344827586
Control.SRR15539874;36;32;0.555555555555556;16;20;0.0555555555555556;0.444444444444444
Control.SRR15539874;35;32;0.571428571428571;15;20;0.0714285714285714;0.428571428571429
Control.SRR15539874;32;32;0.46875;17;15;0.03125;0.46875
Control.SRR15539874;31;32;0.516129032258065;15;16;0.0161290322580645;0.483870967741935
Control.SRR15539874;31;32;0.580645161290323;13;18;0.0806451612903226;0.419354838709677
Control.SRR15539874;35;32;0.485714285714286;18;17;0.0142857142857143;0.485714285714286
Control.SRR15539874;30;32;0.433333333333333;17;13;0.0666666666666667;0.433333333333333
Control.SRR15539874;35;32;0.685714285714286;11;24;0.185714285714286;0.314285714285714
Control.SRR15539874;30;32;0.533333333333333;14;16;0.0333333333333333;0.466666666666667
Control.SRR15539874;32;32;0.5625;14;18;0.0625;0.4375
Control.SRR15539874;36;32;0.583333333333333;15;21;0.0833333333333334;0.416666666666667
Control.SRR15539874;30;32;0.533333333333333;14;16;0.0333333333333333;0.466666666666667
Control.SRR15539874;34;32;0.617647058823529;13;21;0.117647058823529;0.382352941176471
Control.SRR15539874;31;32;0.451612903225806;17;14;0.0483870967741936;0.451612903225806
Control.SRR15539874;31;32;0.548387096774194;14;17;0.0483870967741935;0.451612903225806
Control.SRR15539874;35;32;0.571428571428571;15;20;0.0714285714285714;0.428571428571429
Control.SRR15539874;35;32;0.514285714285714;17;18;0.0142857142857142;0.485714285714286
Control.SRR15539874;31;32;0.548387096774194;14;17;0.0483870967741935;0.451612903225806
Control.SRR15539874;35;32;0.571428571428571;15;20;0.0714285714285714;0.428571428571429
Control.SRR15539874;32;32;0.3125;22;10;0.1875;0.3125
Control.SRR15539874;34;32;0.352941176470588;22;12;0.147058823529412;0.352941176470588
Control.SRR15539874;32;32;0.34375;21;11;0.15625;0.34375
Control.SRR15539874;29;32;0.482758620689655;15;14;0.0172413793103448;0.482758620689655
Control.SRR15539874;30;32;0.466666666666667;16;14;0.0333333333333333;0.466666666666667
Control.SRR15539874;32;32;0.28125;23;9;0.21875;0.28125
Control.SRR15539874;32;32;0.40625;19;13;0.09375;0.40625
Control.SRR15539874;35;32;0.542857142857143;16;19;0.0428571428571428;0.457142857142857
Control.SRR15539874;30;32;0.466666666666667;16;14;0.0333333333333333;0.466666666666667
Control.SRR15539874;34;32;0.470588235294118;18;16;0.0294117647058824;0.470588235294118
Control.SRR15539874;28;32;0.464285714285714;15;13;0.0357142857142857;0.464285714285714
Control.SRR15539874;28;32;0.464285714285714;15;13;0.0357142857142857;0.464285714285714
Control.SRR15539874;29;32;0.482758620689655;15;14;0.0172413793103448;0.482758620689655
Control.SRR15539874;36;32;0.638888888888889;13;23;0.138888888888889;0.361111111111111
Control.SRR15539874;35;32;0.542857142857143;16;19;0.0428571428571428;0.457142857142857
Control.SRR15539874;29;32;0.448275862068966;16;13;0.0517241379310345;0.448275862068966
Control.SRR15539874;33;32;0.515151515151515;16;17;0.0151515151515151;0.484848484848485
Control.SRR15539874;36;32;0.5;18;18;0;0.5
Control.SRR15539874;28;32;0.607142857142857;11;17;0.107142857142857;0.392857142857143
Control.SRR15539874;29;32;0.689655172413793;9;20;0.189655172413793;0.310344827586207
Control.SRR15539874;32;32;0.5;16;16;0;0.5
Control.SRR15539874;31;32;0.419354838709677;18;13;0.0806451612903226;0.419354838709677
Control.SRR15539874;29;32;0.413793103448276;17;12;0.0862068965517241;0.413793103448276
Control.SRR15539874;28;32;0.571428571428571;12;16;0.0714285714285714;0.428571428571429
Control.SRR15539874;30;32;0.4;18;12;0.1;0.4
Control.SRR15539874;28;32;0.607142857142857;11;17;0.107142857142857;0.392857142857143
Control.SRR15539874;28;32;0.428571428571429;16;12;0.0714285714285715;0.428571428571429
Control.SRR15539874;36;32;0.472222222222222;19;17;0.0277777777777778;0.472222222222222
Control.SRR15539874;30;32;0.433333333333333;17;13;0.0666666666666667;0.433333333333333
Control.SRR15539874;35;32;0.485714285714286;18;17;0.0142857142857143;0.485714285714286
Control.SRR15539874;34;32;0.529411764705882;16;18;0.0294117647058824;0.470588235294118
Control.SRR15539874;29;32;0.448275862068966;16;13;0.0517241379310345;0.448275862068966
Control.SRR15539874;32;32;0.59375;13;19;0.09375;0.40625
Control.SRR15539874;30;32;0.4;18;12;0.1;0.4
Control.SRR15539874;31;32;0.580645161290323;13;18;0.0806451612903226;0.419354838709677
Control.SRR15539874;28;32;0.571428571428571;12;16;0.0714285714285714;0.428571428571429
Control.SRR15539874;28;32;0.392857142857143;17;11;0.107142857142857;0.392857142857143
Control.SRR15539874;28;32;0.535714285714286;13;15;0.0357142857142857;0.464285714285714
Control.SRR15539874;36;32;0.444444444444444;20;16;0.0555555555555556;0.444444444444444
Control.SRR15539874;29;32;0.620689655172414;11;18;0.120689655172414;0.379310344827586
Control.SRR15539874;34;32;0.411764705882353;20;14;0.0882352941176471;0.411764705882353
Control.SRR15539874;32;32;0.40625;19;13;0.09375;0.40625
Control.SRR15539874;33;32;0.515151515151515;16;17;0.0151515151515151;0.484848484848485
Control.SRR15539874;28;32;0.5;14;14;0;0.5
Control.SRR15539874;36;32;0.472222222222222;19;17;0.0277777777777778;0.472222222222222
Control.SRR15539874;31;32;0.516129032258065;15;16;0.0161290322580645;0.483870967741935
Control.SRR15539874;32;32;0.53125;15;17;0.03125;0.46875
Control.SRR15539874;31;32;0.451612903225806;17;14;0.0483870967741936;0.451612903225806
Control.SRR15539874;31;32;0.516129032258065;15;16;0.0161290322580645;0.483870967741935
Control.SRR15539874;29;32;0.275862068965517;21;8;0.224137931034483;0.275862068965517
Control.SRR15539874;35;32;0.571428571428571;15;20;0.0714285714285714;0.428571428571429
Control.SRR15539874;32;32;0.4375;18;14;0.0625;0.4375
Control.SRR15539874;30;32;0.433333333333333;17;13;0.0666666666666667;0.433333333333333
Control.SRR15539874;36;32;0.388888888888889;22;14;0.111111111111111;0.388888888888889
Control.SRR15539874;29;32;0.413793103448276;17;12;0.0862068965517241;0.413793103448276
Control.SRR15539874;31;32;0.516129032258065;15;16;0.0161290322580645;0.483870967741935
Control.SRR15539874;33;32;0.484848484848485;17;16;0.0151515151515151;0.484848484848485
Control.SRR15539874;29;32;0.586206896551724;12;17;0.0862068965517241;0.413793103448276
Control.SRR15539874;36;32;0.527777777777778;17;19;0.0277777777777778;0.472222222222222
Control.SRR15539874;34;32;0.588235294117647;14;20;0.0882352941176471;0.411764705882353
Control.SRR15539874;35;32;0.485714285714286;18;17;0.0142857142857143;0.485714285714286
Control.SRR15539874;36;32;0.444444444444444;20;16;0.0555555555555556;0.444444444444444
Control.SRR15539874;36;32;0.583333333333333;15;21;0.0833333333333334;0.416666666666667
Control.SRR15539874;34;32;0.441176470588235;19;15;0.0588235294117647;0.441176470588235
Control.SRR15539874;33;32;0.545454545454545;15;18;0.0454545454545454;0.454545454545455
Control.SRR15539874;30;32;0.366666666666667;19;11;0.133333333333333;0.366666666666667
Control.SRR15539874;31;32;0.451612903225806;17;14;0.0483870967741936;0.451612903225806
Control.SRR15539874;30;32;0.5;15;15;0;0.5
Control.SRR15539874;33;32;0.424242424242424;19;14;0.0757575757575757;0.424242424242424
Control.SRR15539874;28;32;0.464285714285714;15;13;0.0357142857142857;0.464285714285714
Control.SRR15539874;33;32;0.575757575757576;14;19;0.0757575757575758;0.424242424242424
Control.SRR15539874;28;32;0.5;14;14;0;0.5
Control.SRR15539874;30;32;0.7;9;21;0.2;0.3
Control.SRR15539874;29;32;0.620689655172414;11;18;0.120689655172414;0.379310344827586
Control.SRR15539874;30;32;0.466666666666667;16;14;0.0333333333333333;0.466666666666667
Control.SRR15539874;31;32;0.612903225806452;12;19;0.112903225806452;0.387096774193548
Control.SRR15539874;36;32;0.444444444444444;20;16;0.0555555555555556;0.444444444444444
Control.SRR15539874;33;32;0.424242424242424;19;14;0.0757575757575757;0.424242424242424
Control.SRR15539874;30;32;0.466666666666667;16;14;0.0333333333333333;0.466666666666667
Control.SRR15539874;33;32;0.545454545454545;15;18;0.0454545454545454;0.454545454545455
Control.SRR15539874;33;32;0.363636363636364;21;12;0.136363636363636;0.363636363636364
Control.SRR15539874;36;32;0.5;18;18;0;0.5
Control.SRR15539874;34;32;0.588235294117647;14;20;0.0882352941176471;0.411764705882353
Control.SRR15539874;30;32;0.533333333333333;14;16;0.0333333333333333;0.466666666666667
Control.SRR15539874;30;32;0.5;15;15;0;0.5
Control.SRR15539874;29;32;0.413793103448276;17;12;0.0862068965517241;0.413793103448276
Control.SRR15539874;32;32;0.53125;15;17;0.03125;0.46875
Control.SRR15539874;29;32;0.620689655172414;11;18;0.120689655172414;0.379310344827586
Control.SRR15539874;31;32;0.612903225806452;12;19;0.112903225806452;0.387096774193548
Control.SRR15539874;33;32;0.484848484848485;17;16;0.0151515151515151;0.484848484848485
Control.SRR15539874;35;32;0.457142857142857;19;16;0.0428571428571429;0.457142857142857
Control.SRR15539874;34;32;0.529411764705882;16;18;0.0294117647058824;0.470588235294118
Control.SRR15539874;30;32;0.333333333333333;20;10;0.166666666666667;0.333333333333333
Control.SRR15539874;34;32;0.470588235294118;18;16;0.0294117647058824;0.470588235294118
Control.SRR15539874;30;32;0.566666666666667;13;17;0.0666666666666667;0.433333333333333
Control.SRR15539874;31;32;0.548387096774194;14;17;0.0483870967741935;0.451612903225806
Control.SRR15539874;31;32;0.354838709677419;20;11;0.145161290322581;0.354838709677419
Control.SRR15539874;31;32;0.419354838709677;18;13;0.0806451612903226;0.419354838709677
Control.SRR15539874;33;32;0.303030303030303;23;10;0.196969696969697;0.303030303030303
Control.SRR15539874;28;32;0.464285714285714;15;13;0.0357142857142857;0.464285714285714
Control.SRR15539874;36;32;0.555555555555556;16;20;0.0555555555555556;0.444444444444444
Control.SRR15539874;30;32;0.366666666666667;19;11;0.133333333333333;0.366666666666667
Control.SRR15539874;34;32;0.558823529411765;15;19;0.0588235294117647;0.441176470588235
Control.SRR15539874;34;32;0.5;17;17;0;0.5
Control.SRR15539874;36;32;0.388888888888889;22;14;0.111111111111111;0.388888888888889
Control.SRR15539874;32;32;0.34375;21;11;0.15625;0.34375
Control.SRR15539874;35;32;0.542857142857143;16;19;0.0428571428571428;0.457142857142857
Control.SRR15539874;30;32;0.4;18;12;0.1;0.4
Control.SRR15539874;31;32;0.451612903225806;17;14;0.0483870967741936;0.451612903225806
Control.SRR15539874;28;32;0.678571428571429;9;19;0.178571428571429;0.321428571428571
Control.SRR15539874;35;32;0.314285714285714;24;11;0.185714285714286;0.314285714285714
Control.SRR15539874;36;32;0.416666666666667;21;15;0.0833333333333333;0.416666666666667
Control.SRR15539874;35;32;0.6;14;21;0.1;0.4
Control.SRR15539874;29;32;0.482758620689655;15;14;0.0172413793103448;0.482758620689655
Control.SRR15539874;36;32;0.527777777777778;17;19;0.0277777777777778;0.472222222222222
Control.SRR15539874;34;32;0.558823529411765;15;19;0.0588235294117647;0.441176470588235
Control.SRR15539874;29;32;0.344827586206897;19;10;0.155172413793103;0.344827586206897
Control.SRR15539874;28;32;0.642857142857143;10;18;0.142857142857143;0.357142857142857
Control.SRR15539874;30;32;0.6;12;18;0.1;0.4
Control.SRR15539874;33;32;0.515151515151515;16;17;0.0151515151515151;0.484848484848485
Control.SRR15539874;33;32;0.454545454545455;18;15;0.0454545454545455;0.454545454545455
Control.SRR15539874;32;32;0.53125;15;17;0.03125;0.46875
Control.SRR15539874;33;32;0.575757575757576;14;19;0.0757575757575758;0.424242424242424
Control.SRR15539874;34;32;0.588235294117647;14;20;0.0882352941176471;0.411764705882353
Control.SRR15539874;33;32;0.393939393939394;20;13;0.106060606060606;0.393939393939394
Control.SRR15539874;31;32;0.258064516129032;23;8;0.241935483870968;0.258064516129032
Control.SRR15539874;31;32;0.387096774193548;19;12;0.112903225806452;0.387096774193548
Control.SRR15539874;31;32;0.516129032258065;15;16;0.0161290322580645;0.483870967741935
Control.SRR15539874;31;32;0.645161290322581;11;20;0.145161290322581;0.354838709677419
Control.SRR15539874;35;32;0.542857142857143;16;19;0.0428571428571428;0.457142857142857
Control.SRR15539874;33;32;0.606060606060606;13;20;0.106060606060606;0.393939393939394
Control.SRR15539874;29;32;0.482758620689655;15;14;0.0172413793103448;0.482758620689655
Control.SRR15539874;29;32;0.482758620689655;15;14;0.0172413793103448;0.482758620689655
Control.SRR15539874;29;32;0.517241379310345;14;15;0.0172413793103449;0.482758620689655
Control.SRR15539874;31;32;0.419354838709677;18;13;0.0806451612903226;0.419354838709677
Control.SRR15539874;36;32;0.611111111111111;14;22;0.111111111111111;0.388888888888889
Control.SRR15539874;29;32;0.517241379310345;14;15;0.0172413793103449;0.482758620689655
Control.SRR15539874;33;32;0.515151515151515;16;17;0.0151515151515151;0.484848484848485
Control.SRR15539874;29;32;0.482758620689655;15;14;0.0172413793103448;0.482758620689655
Control.SRR15539874;29;32;0.517241379310345;14;15;0.0172413793103449;0.482758620689655
Control.SRR15539874;30;32;0.466666666666667;16;14;0.0333333333333333;0.466666666666667
Control.SRR15539874;35;32;0.571428571428571;15;20;0.0714285714285714;0.428571428571429
Control.SRR15539874;29;32;0.517241379310345;14;15;0.0172413793103449;0.482758620689655
Control.SRR15539874;34;32;0.5;17;17;0;0.5
Control.SRR15539874;32;32;0.5625;14;18;0.0625;0.4375
Control.SRR15539874;36;32;0.527777777777778;17;19;0.0277777777777778;0.472222222222222
Control.SRR15539874;36;32;0.527777777777778;17;19;0.0277777777777778;0.472222222222222
Control.SRR15539874;33;32;0.363636363636364;21;12;0.136363636363636;0.363636363636364
Control.SRR15539874;29;32;0.620689655172414;11;18;0.120689655172414;0.379310344827586
Control.SRR15539874;30;32;0.633333333333333;11;19;0.133333333333333;0.366666666666667
Control.SRR15539874;36;32;0.666666666666667;12;24;0.166666666666667;0.333333333333333
Control.SRR15539874;35;32;0.485714285714286;18;17;0.0142857142857143;0.485714285714286
Control.SRR15539874;34;32;0.5;17;17;0;0.5
Control.SRR15539874;35;32;0.342857142857143;23;12;0.157142857142857;0.342857142857143
Control.SRR15539874;34;32;0.588235294117647;14;20;0.0882352941176471;0.411764705882353
Control.SRR15539874;34;32;0.617647058823529;13;21;0.117647058823529;0.382352941176471
Control.SRR15539874;30;32;0.3;21;9;0.2;0.3
Control.SRR15539874;34;32;0.588235294117647;14;20;0.0882352941176471;0.411764705882353
Control.SRR15539874;33;32;0.515151515151515;16;17;0.0151515151515151;0.484848484848485
Control.SRR15539874;34;32;0.470588235294118;18;16;0.0294117647058824;0.470588235294118
Control.SRR15539874;35;32;0.542857142857143;16;19;0.0428571428571428;0.457142857142857
Control.SRR15539874;35;32;0.4;21;14;0.1;0.4
Control.SRR15539874;36;32;0.583333333333333;15;21;0.0833333333333334;0.416666666666667
Control.SRR15539874;34;32;0.411764705882353;20;14;0.0882352941176471;0.411764705882353
Control.SRR15539874;29;32;0.448275862068966;16;13;0.0517241379310345;0.448275862068966
Control.SRR15539874;33;32;0.484848484848485;17;16;0.0151515151515151;0.484848484848485
Control.SRR15539874;31;32;0.483870967741935;16;15;0.0161290322580645;0.483870967741935
Control.SRR15539874;28;32;0.428571428571429;16;12;0.0714285714285715;0.428571428571429
Control.SRR15539874;34;32;0.588235294117647;14;20;0.0882352941176471;0.411764705882353
Control.SRR15539874;28;32;0.464285714285714;15;13;0.0357142857142857;0.464285714285714
Control.SRR15539874;28;32;0.714285714285714;8;20;0.214285714285714;0.285714285714286
Control.SRR15539874;34;32;0.617647058823529;13;21;0.117647058823529;0.382352941176471
Control.SRR15539874;33;32;0.484848484848485;17;16;0.0151515151515151;0.484848484848485
Control.SRR15539874;36;32;0.5;18;18;0;0.5
Control.SRR15539874;35;32;0.542857142857143;16;19;0.0428571428571428;0.457142857142857
Control.SRR15539874;35;32;0.485714285714286;18;17;0.0142857142857143;0.485714285714286
Control.SRR15539874;34;32;0.5;17;17;0;0.5
Control.SRR15539874;31;32;0.419354838709677;18;13;0.0806451612903226;0.419354838709677
Control.SRR15539874;31;32;0.548387096774194;14;17;0.0483870967741935;0.451612903225806
Control.SRR15539874;33;32;0.575757575757576;14;19;0.0757575757575758;0.424242424242424
Control.SRR15539874;31;32;0.548387096774194;14;17;0.0483870967741935;0.451612903225806
Control.SRR15539874;30;32;0.266666666666667;22;8;0.233333333333333;0.266666666666667
Control.SRR15539874;32;32;0.5625;14;18;0.0625;0.4375
Control.SRR15539874;28;32;0.642857142857143;10;18;0.142857142857143;0.357142857142857
Control.SRR15539874;29;32;0.517241379310345;14;15;0.0172413793103449;0.482758620689655
Control.SRR15539874;30;32;0.5;15;15;0;0.5
Control.SRR15539874;33;32;0.333333333333333;22;11;0.166666666666667;0.333333333333333
Control.SRR15539874;31;32;0.451612903225806;17;14;0.0483870967741936;0.451612903225806
Control.SRR15539874;33;32;0.515151515151515;16;17;0.0151515151515151;0.484848484848485
Control.SRR15539874;31;32;0.451612903225806;17;14;0.0483870967741936;0.451612903225806
Control.SRR15539874;36;32;0.555555555555556;16;20;0.0555555555555556;0.444444444444444
Control.SRR15539874;31;32;0.516129032258065;15;16;0.0161290322580645;0.483870967741935
Control.SRR15539874;33;32;0.484848484848485;17;16;0.0151515151515151;0.484848484848485
Control.SRR15539874;32;32;0.625;12;20;0.125;0.375
Control.SRR15539874;36;32;0.611111111111111;14;22;0.111111111111111;0.388888888888889
Control.SRR15539874;34;32;0.558823529411765;15;19;0.0588235294117647;0.441176470588235
Control.SRR15539874;36;32;0.472222222222222;19;17;0.0277777777777778;0.472222222222222
Control.SRR15539874;35;32;0.542857142857143;16;19;0.0428571428571428;0.457142857142857
Control.SRR15539874;29;32;0.413793103448276;17;12;0.0862068965517241;0.413793103448276
Control.SRR15539874;29;32;0.379310344827586;18;11;0.120689655172414;0.379310344827586
Control.SRR15539874;32;32;0.5625;14;18;0.0625;0.4375
Control.SRR15539874;28;32;0.464285714285714;15;13;0.0357142857142857;0.464285714285714
Control.SRR15539874;30;32;0.5;15;15;0;0.5
Control.SRR15539874;29;32;0.344827586206897;19;10;0.155172413793103;0.344827586206897
Control.SRR15539874;29;32;0.413793103448276;17;12;0.0862068965517241;0.413793103448276
Control.SRR15539874;35;32;0.571428571428571;15;20;0.0714285714285714;0.428571428571429
Control.SRR15539874;36;32;0.583333333333333;15;21;0.0833333333333334;0.416666666666667
Control.SRR15539874;34;32;0.323529411764706;23;11;0.176470588235294;0.323529411764706
Control.SRR15539874;34;32;0.617647058823529;13;21;0.117647058823529;0.382352941176471
Control.SRR15539874;29;32;0.448275862068966;16;13;0.0517241379310345;0.448275862068966
Control.SRR15539874;28;32;0.464285714285714;15;13;0.0357142857142857;0.464285714285714
Control.SRR15539874;33;32;0.515151515151515;16;17;0.0151515151515151;0.484848484848485
Control.SRR15539874;33;32;0.545454545454545;15;18;0.0454545454545454;0.454545454545455
Control.SRR15539874;31;32;0.516129032258065;15;16;0.0161290322580645;0.483870967741935
Control.SRR15539874;33;32;0.636363636363636;12;21;0.136363636363636;0.363636363636364
Control.SRR15539874;35;32;0.371428571428571;22;13;0.128571428571429;0.371428571428571
Control.SRR15539874;28;32;0.392857142857143;17;11;0.107142857142857;0.392857142857143
Control.SRR15539874;28;32;0.571428571428571;12;16;0.0714285714285714;0.428571428571429
Control.SRR15539874;34;32;0.352941176470588;22;12;0.147058823529412;0.352941176470588
Control.SRR15539874;34;32;0.529411764705882;16;18;0.0294117647058824;0.470588235294118
Control.SRR15539874;31;32;0.387096774193548;19;12;0.112903225806452;0.387096774193548
Control.SRR15539874;31;32;0.67741935483871;10;21;0.17741935483871;0.32258064516129
Control.SRR15539874;33;32;0.515151515151515;16;17;0.0151515151515151;0.484848484848485
Control.SRR15539874;33;32;0.545454545454545;15;18;0.0454545454545454;0.454545454545455
Control.SRR15539874;36;32;0.416666666666667;21;15;0.0833333333333333;0.416666666666667
Control.SRR15539874;30;32;0.566666666666667;13;17;0.0666666666666667;0.433333333333333
Control.SRR15539874;28;32;0.464285714285714;15;13;0.0357142857142857;0.464285714285714
Control.SRR15539874;34;32;0.588235294117647;14;20;0.0882352941176471;0.411764705882353
Control.SRR15539874;33;32;0.545454545454545;15;18;0.0454545454545454;0.454545454545455
Control.SRR15539874;31;32;0.548387096774194;14;17;0.0483870967741935;0.451612903225806
Control.SRR15539874;31;32;0.451612903225806;17;14;0.0483870967741936;0.451612903225806
Control.SRR15539874;34;32;0.529411764705882;16;18;0.0294117647058824;0.470588235294118
Control.SRR15539874;30;32;0.433333333333333;17;13;0.0666666666666667;0.433333333333333
Control.SRR15539874;32;32;0.53125;15;17;0.03125;0.46875
Control.SRR15539874;30;32;0.666666666666667;10;20;0.166666666666667;0.333333333333333
Control.SRR15539874;28;32;0.321428571428571;19;9;0.178571428571429;0.321428571428571
Control.SRR15539874;29;32;0.482758620689655;15;14;0.0172413793103448;0.482758620689655
Control.SRR15539874;31;32;0.483870967741935;16;15;0.0161290322580645;0.483870967741935
Control.SRR15539874;35;32;0.628571428571429;13;22;0.128571428571429;0.371428571428571
Control.SRR15539874;36;32;0.472222222222222;19;17;0.0277777777777778;0.472222222222222
Control.SRR15539874;34;32;0.441176470588235;19;15;0.0588235294117647;0.441176470588235
Control.SRR15539874;33;32;0.484848484848485;17;16;0.0151515151515151;0.484848484848485
Control.SRR15539874;35;32;0.4;21;14;0.1;0.4
Control.SRR15539874;30;32;0.4;18;12;0.1;0.4
Control.SRR15539874;30;32;0.5;15;15;0;0.5
Control.SRR15539874;32;32;0.59375;13;19;0.09375;0.40625
Control.SRR15539874;32;32;0.5625;14;18;0.0625;0.4375
Control.SRR15539874;36;32;0.416666666666667;21;15;0.0833333333333333;0.416666666666667
Control.SRR15539874;33;32;0.696969696969697;10;23;0.196969696969697;0.303030303030303
Control.SRR15539874;32;32;0.46875;17;15;0.03125;0.46875
Control.SRR15539874;29;32;0.448275862068966;16;13;0.0517241379310345;0.448275862068966
Control.SRR15539874;34;32;0.470588235294118;18;16;0.0294117647058824;0.470588235294118
Control.SRR15539874;33;32;0.575757575757576;14;19;0.0757575757575758;0.424242424242424
Control.SRR15539874;33;32;0.484848484848485;17;16;0.0151515151515151;0.484848484848485
Control.SRR15539874;34;32;0.441176470588235;19;15;0.0588235294117647;0.441176470588235
Control.SRR15539874;28;32;0.392857142857143;17;11;0.107142857142857;0.392857142857143
Control.SRR15539874;30;32;0.5;15;15;0;0.5
Control.SRR15539874;30;32;0.333333333333333;20;10;0.166666666666667;0.333333333333333
Control.SRR15539874;29;32;0.482758620689655;15;14;0.0172413793103448;0.482758620689655
Control.SRR15539874;31;32;0.548387096774194;14;17;0.0483870967741935;0.451612903225806
Control.SRR15539874;30;32;0.466666666666667;16;14;0.0333333333333333;0.466666666666667
Control.SRR15539874;31;32;0.645161290322581;11;20;0.145161290322581;0.354838709677419
Control.SRR15539874;36;32;0.527777777777778;17;19;0.0277777777777778;0.472222222222222
Control.SRR15539874;32;32;0.40625;19;13;0.09375;0.40625
Control.SRR15539874;30;32;0.466666666666667;16;14;0.0333333333333333;0.466666666666667
Control.SRR15539874;34;32;0.558823529411765;15;19;0.0588235294117647;0.441176470588235
Control.SRR15539874;30;32;0.566666666666667;13;17;0.0666666666666667;0.433333333333333
Control.SRR15539874;34;32;0.411764705882353;20;14;0.0882352941176471;0.411764705882353
Control.SRR15539874;35;32;0.514285714285714;17;18;0.0142857142857142;0.485714285714286
Control.SRR15539874;34;32;0.411764705882353;20;14;0.0882352941176471;0.411764705882353
Control.SRR15539874;33;32;0.454545454545455;18;15;0.0454545454545455;0.454545454545455
Control.SRR15539874;34;32;0.764705882352941;8;26;0.264705882352941;0.235294117647059
Control.SRR15539874;33;32;0.515151515151515;16;17;0.0151515151515151;0.484848484848485
Control.SRR15539874;32;32;0.46875;17;15;0.03125;0.46875
Control.SRR15539874;33;32;0.424242424242424;19;14;0.0757575757575757;0.424242424242424
Control.SRR15539874;28;32;0.678571428571429;9;19;0.178571428571429;0.321428571428571
Control.SRR15539874;28;32;0.5;14;14;0;0.5
Control.SRR15539874;32;32;0.59375;13;19;0.09375;0.40625
Control.SRR15539874;33;32;0.606060606060606;13;20;0.106060606060606;0.393939393939394
Control.SRR15539874;34;32;0.529411764705882;16;18;0.0294117647058824;0.470588235294118
Control.SRR15539874;32;32;0.5;16;16;0;0.5
Control.SRR15539874;33;32;0.515151515151515;16;17;0.0151515151515151;0.484848484848485
Control.SRR15539874;36;32;0.583333333333333;15;21;0.0833333333333334;0.416666666666667
Control.SRR15539874;28;32;0.464285714285714;15;13;0.0357142857142857;0.464285714285714
Control.SRR15539874;29;32;0.413793103448276;17;12;0.0862068965517241;0.413793103448276
Control.SRR15539874;32;32;0.5625;14;18;0.0625;0.4375
Control.SRR15539874;28;32;0.392857142857143;17;11;0.107142857142857;0.392857142857143
Control.SRR15539874;34;32;0.441176470588235;19;15;0.0588235294117647;0.441176470588235
Control.SRR15539874;33;32;0.545454545454545;15;18;0.0454545454545454;0.454545454545455
Control.SRR15539874;33;32;0.424242424242424;19;14;0.0757575757575757;0.424242424242424
Control.SRR15539874;36;32;0.555555555555556;16;20;0.0555555555555556;0.444444444444444
Control.SRR15539874;36;32;0.444444444444444;20;16;0.0555555555555556;0.444444444444444
Control.SRR15539874;35;32;0.542857142857143;16;19;0.0428571428571428;0.457142857142857
Control.SRR15539874;31;32;0.548387096774194;14;17;0.0483870967741935;0.451612903225806
Control.SRR15539874;35;32;0.571428571428571;15;20;0.0714285714285714;0.428571428571429
Control.SRR15539874;31;32;0.580645161290323;13;18;0.0806451612903226;0.419354838709677
Control.SRR15539874;33;32;0.242424242424242;25;8;0.257575757575758;0.242424242424242
Control.SRR15539874;30;32;0.533333333333333;14;16;0.0333333333333333;0.466666666666667
Control.SRR15539874;30;32;0.4;18;12;0.1;0.4
Control.SRR15539874;28;32;0.5;14;14;0;0.5
Control.SRR15539874;32;32;0.5625;14;18;0.0625;0.4375
Control.SRR15539874;31;32;0.580645161290323;13;18;0.0806451612903226;0.419354838709677
Control.SRR15539874;32;32;0.3125;22;10;0.1875;0.3125
Control.SRR15539874;31;32;0.516129032258065;15;16;0.0161290322580645;0.483870967741935
Control.SRR15539874;28;32;0.571428571428571;12;16;0.0714285714285714;0.428571428571429
Control.SRR15539874;35;32;0.457142857142857;19;16;0.0428571428571429;0.457142857142857
Control.SRR15539874;31;32;0.67741935483871;10;21;0.17741935483871;0.32258064516129
Control.SRR15539874;36;32;0.555555555555556;16;20;0.0555555555555556;0.444444444444444
Control.SRR15539874;35;32;0.542857142857143;16;19;0.0428571428571428;0.457142857142857
Control.SRR15539874;34;32;0.5;17;17;0;0.5
Control.SRR15539874;36;32;0.555555555555556;16;20;0.0555555555555556;0.444444444444444
Control.SRR15539874;32;32;0.5;16;16;0;0.5
Control.SRR15539874;36;32;0.555555555555556;16;20;0.0555555555555556;0.444444444444444
Control.SRR15539874;31;32;0.419354838709677;18;13;0.0806451612903226;0.419354838709677
Control.SRR15539874;32;32;0.53125;15;17;0.03125;0.46875
Control.SRR15539874;32;32;0.5625;14;18;0.0625;0.4375
Control.SRR15539874;31;32;0.483870967741935;16;15;0.0161290322580645;0.483870967741935
Control.SRR15539874;31;32;0.483870967741935;16;15;0.0161290322580645;0.483870967741935
Control.SRR15539874;33;32;0.545454545454545;15;18;0.0454545454545454;0.454545454545455
Control.SRR15539874;30;32;0.366666666666667;19;11;0.133333333333333;0.366666666666667
Control.SRR15539874;32;32;0.4375;18;14;0.0625;0.4375
Control.SRR15539874;34;32;0.411764705882353;20;14;0.0882352941176471;0.411764705882353
Control.SRR15539874;31;32;0.451612903225806;17;14;0.0483870967741936;0.451612903225806
Control.SRR15539874;29;32;0.448275862068966;16;13;0.0517241379310345;0.448275862068966
Control.SRR15539874;32;32;0.375;20;12;0.125;0.375
Control.SRR15539874;28;32;0.464285714285714;15;13;0.0357142857142857;0.464285714285714
Control.SRR15539874;36;32;0.444444444444444;20;16;0.0555555555555556;0.444444444444444
Control.SRR15539874;32;32;0.625;12;20;0.125;0.375
Control.SRR15539874;33;32;0.515151515151515;16;17;0.0151515151515151;0.484848484848485
Control.SRR15539874;35;32;0.571428571428571;15;20;0.0714285714285714;0.428571428571429
Control.SRR15539874;33;32;0.484848484848485;17;16;0.0151515151515151;0.484848484848485
Control.SRR15539874;33;32;0.575757575757576;14;19;0.0757575757575758;0.424242424242424
Control.SRR15539874;31;32;0.483870967741935;16;15;0.0161290322580645;0.483870967741935
Control.SRR15539874;34;32;0.529411764705882;16;18;0.0294117647058824;0.470588235294118
Control.SRR15539874;32;32;0.5625;14;18;0.0625;0.4375
Control.SRR15539874;34;32;0.588235294117647;14;20;0.0882352941176471;0.411764705882353
Control.SRR15539874;32;32;0.65625;11;21;0.15625;0.34375
Control.SRR15539874;34;32;0.5;17;17;0;0.5
Control.SRR15539874;35;32;0.457142857142857;19;16;0.0428571428571429;0.457142857142857
Control.SRR15539874;32;32;0.53125;15;17;0.03125;0.46875
Control.SRR15539874;32;32;0.46875;17;15;0.03125;0.46875
Control.SRR15539874;35;32;0.542857142857143;16;19;0.0428571428571428;0.457142857142857
Control.SRR15539874;35;32;0.457142857142857;19;16;0.0428571428571429;0.457142857142857
Control.SRR15539874;32;32;0.59375;13;19;0.09375;0.40625
Control.SRR15539874;30;32;0.366666666666667;19;11;0.133333333333333;0.366666666666667
Control.SRR15539874;31;32;0.483870967741935;16;15;0.0161290322580645;0.483870967741935
Control.SRR15539874;35;32;0.485714285714286;18;17;0.0142857142857143;0.485714285714286
Control.SRR15539874;36;32;0.555555555555556;16;20;0.0555555555555556;0.444444444444444
Control.SRR15539874;28;32;0.428571428571429;16;12;0.0714285714285715;0.428571428571429
Control.SRR15539874;34;32;0.352941176470588;22;12;0.147058823529412;0.352941176470588
Control.SRR15539874;31;32;0.483870967741935;16;15;0.0161290322580645;0.483870967741935
Control.SRR15539874;30;32;0.566666666666667;13;17;0.0666666666666667;0.433333333333333
Control.SRR15539874;34;32;0.676470588235294;11;23;0.176470588235294;0.323529411764706
Control.SRR15539874;32;32;0.5625;14;18;0.0625;0.4375
Control.SRR15539874;29;32;0.448275862068966;16;13;0.0517241379310345;0.448275862068966
Control.SRR15539874;35;32;0.4;21;14;0.1;0.4
Control.SRR15539874;31;32;0.516129032258065;15;16;0.0161290322580645;0.483870967741935
Control.SRR15539874;29;32;0.551724137931034;13;16;0.0517241379310345;0.448275862068966
Control.SRR15539874;29;32;0.586206896551724;12;17;0.0862068965517241;0.413793103448276
Control.SRR15539874;32;32;0.5;16;16;0;0.5
Control.SRR15539874;29;32;0.517241379310345;14;15;0.0172413793103449;0.482758620689655
Control.SRR15539874;33;32;0.454545454545455;18;15;0.0454545454545455;0.454545454545455
Control.SRR15539874;31;32;0.741935483870968;8;23;0.241935483870968;0.258064516129032
Control.SRR15539874;34;32;0.617647058823529;13;21;0.117647058823529;0.382352941176471
Control.SRR15539874;34;32;0.558823529411765;15;19;0.0588235294117647;0.441176470588235
Control.SRR15539874;28;32;0.5;14;14;0;0.5
Control.SRR15539874;30;32;0.366666666666667;19;11;0.133333333333333;0.366666666666667
Control.SRR15539874;32;32;0.46875;17;15;0.03125;0.46875
Control.SRR15539874;36;32;0.5;18;18;0;0.5
Control.SRR15539874;33;32;0.454545454545455;18;15;0.0454545454545455;0.454545454545455
Control.SRR15539874;30;32;0.633333333333333;11;19;0.133333333333333;0.366666666666667
Control.SRR15539874;35;32;0.6;14;21;0.1;0.4
Control.SRR15539874;35;32;0.542857142857143;16;19;0.0428571428571428;0.457142857142857
Control.SRR15539874;36;32;0.583333333333333;15;21;0.0833333333333334;0.416666666666667
Control.SRR15539874;33;32;0.515151515151515;16;17;0.0151515151515151;0.484848484848485
Control.SRR15539874;31;32;0.516129032258065;15;16;0.0161290322580645;0.483870967741935
Control.SRR15539874;34;32;0.529411764705882;16;18;0.0294117647058824;0.470588235294118
Control.SRR15539874;36;32;0.555555555555556;16;20;0.0555555555555556;0.444444444444444
Control.SRR15539874;32;32;0.46875;17;15;0.03125;0.46875
Control.SRR15539874;33;32;0.515151515151515;16;17;0.0151515151515151;0.484848484848485
Control.SRR15539874;36;32;0.555555555555556;16;20;0.0555555555555556;0.444444444444444
Control.SRR15539874;35;32;0.514285714285714;17;18;0.0142857142857142;0.485714285714286
Control.SRR15539874;30;32;0.633333333333333;11;19;0.133333333333333;0.366666666666667
Control.SRR15539874;28;32;0.464285714285714;15;13;0.0357142857142857;0.464285714285714
Control.SRR15539874;34;32;0.5;17;17;0;0.5
Control.SRR15539874;30;32;0.466666666666667;16;14;0.0333333333333333;0.466666666666667
Control.SRR15539874;30;32;0.566666666666667;13;17;0.0666666666666667;0.433333333333333
Control.SRR15539874;35;32;0.514285714285714;17;18;0.0142857142857142;0.485714285714286
Control.SRR15539874;30;32;0.4;18;12;0.1;0.4
Control.SRR15539874;29;32;0.586206896551724;12;17;0.0862068965517241;0.413793103448276
Control.SRR15539874;29;32;0.482758620689655;15;14;0.0172413793103448;0.482758620689655
Control.SRR15539874;28;32;0.392857142857143;17;11;0.107142857142857;0.392857142857143
Control.SRR15539874;32;32;0.4375;18;14;0.0625;0.4375
Control.SRR15539874;30;32;0.5;15;15;0;0.5
Control.SRR15539874;31;32;0.451612903225806;17;14;0.0483870967741936;0.451612903225806
Control.SRR15539874;35;32;0.542857142857143;16;19;0.0428571428571428;0.457142857142857
Control.SRR15539874;29;32;0.586206896551724;12;17;0.0862068965517241;0.413793103448276
Control.SRR15539874;31;32;0.516129032258065;15;16;0.0161290322580645;0.483870967741935
Control.SRR15539874;33;32;0.454545454545455;18;15;0.0454545454545455;0.454545454545455
Control.SRR15539874;36;32;0.555555555555556;16;20;0.0555555555555556;0.444444444444444
Control.SRR15539874;35;32;0.514285714285714;17;18;0.0142857142857142;0.485714285714286
Control.SRR15539874;28;32;0.428571428571429;16;12;0.0714285714285715;0.428571428571429
Control.SRR15539874;29;32;0.586206896551724;12;17;0.0862068965517241;0.413793103448276
Control.SRR15539874;28;32;0.607142857142857;11;17;0.107142857142857;0.392857142857143
Control.SRR15539874;30;32;0.433333333333333;17;13;0.0666666666666667;0.433333333333333
Control.SRR15539874;33;32;0.575757575757576;14;19;0.0757575757575758;0.424242424242424
Control.SRR15539874;29;32;0.448275862068966;16;13;0.0517241379310345;0.448275862068966
Control.SRR15539874;33;32;0.696969696969697;10;23;0.196969696969697;0.303030303030303
Control.SRR15539874;35;32;0.514285714285714;17;18;0.0142857142857142;0.485714285714286
Control.SRR15539874;29;32;0.517241379310345;14;15;0.0172413793103449;0.482758620689655
Control.SRR15539874;35;32;0.628571428571429;13;22;0.128571428571429;0.371428571428571
Control.SRR15539874;32;32;0.40625;19;13;0.09375;0.40625
Control.SRR15539874;29;32;0.448275862068966;16;13;0.0517241379310345;0.448275862068966
Control.SRR15539874;34;32;0.352941176470588;22;12;0.147058823529412;0.352941176470588
Control.SRR15539874;30;32;0.4;18;12;0.1;0.4
Control.SRR15539874;30;32;0.366666666666667;19;11;0.133333333333333;0.366666666666667
Control.SRR15539874;34;32;0.5;17;17;0;0.5
Control.SRR15539874;33;32;0.515151515151515;16;17;0.0151515151515151;0.484848484848485
Control.SRR15539874;33;32;0.666666666666667;11;22;0.166666666666667;0.333333333333333
Control.SRR15539874;36;32;0.527777777777778;17;19;0.0277777777777778;0.472222222222222
Control.SRR15539874;35;32;0.4;21;14;0.1;0.4
Control.SRR15539874;31;32;0.354838709677419;20;11;0.145161290322581;0.354838709677419
Control.SRR15539874;35;32;0.514285714285714;17;18;0.0142857142857142;0.485714285714286
Control.SRR15539874;35;32;0.628571428571429;13;22;0.128571428571429;0.371428571428571
Control.SRR15539874;31;32;0.67741935483871;10;21;0.17741935483871;0.32258064516129
Control.SRR15539874;34;32;0.382352941176471;21;13;0.117647058823529;0.382352941176471
Control.SRR15539874;30;32;0.433333333333333;17;13;0.0666666666666667;0.433333333333333
Control.SRR15539874;28;32;0.464285714285714;15;13;0.0357142857142857;0.464285714285714
Control.SRR15539874;34;32;0.558823529411765;15;19;0.0588235294117647;0.441176470588235
Control.SRR15539874;34;32;0.558823529411765;15;19;0.0588235294117647;0.441176470588235
Control.SRR15539874;30;32;0.533333333333333;14;16;0.0333333333333333;0.466666666666667
Control.SRR15539874;34;32;0.470588235294118;18;16;0.0294117647058824;0.470588235294118
Control.SRR15539874;28;32;0.571428571428571;12;16;0.0714285714285714;0.428571428571429
Control.SRR15539874;31;32;0.548387096774194;14;17;0.0483870967741935;0.451612903225806
Control.SRR15539874;29;32;0.448275862068966;16;13;0.0517241379310345;0.448275862068966
Control.SRR15539874;34;32;0.617647058823529;13;21;0.117647058823529;0.382352941176471
Control.SRR15539874;33;32;0.515151515151515;16;17;0.0151515151515151;0.484848484848485
Control.SRR15539874;33;32;0.363636363636364;21;12;0.136363636363636;0.363636363636364
Control.SRR15539874;32;32;0.46875;17;15;0.03125;0.46875
Control.SRR15539874;29;32;0.448275862068966;16;13;0.0517241379310345;0.448275862068966
Control.SRR15539874;32;32;0.5;16;16;0;0.5
Control.SRR15539874;30;32;0.5;15;15;0;0.5
Control.SRR15539874;33;32;0.454545454545455;18;15;0.0454545454545455;0.454545454545455
Control.SRR15539874;31;32;0.612903225806452;12;19;0.112903225806452;0.387096774193548
Control.SRR15539874;34;32;0.617647058823529;13;21;0.117647058823529;0.382352941176471
Control.SRR15539874;32;32;0.6875;10;22;0.1875;0.3125
Control.SRR15539874;35;32;0.685714285714286;11;24;0.185714285714286;0.314285714285714
Control.SRR15539874;30;32;0.533333333333333;14;16;0.0333333333333333;0.466666666666667
Control.SRR15539874;32;32;0.5;16;16;0;0.5
Control.SRR15539874;34;32;0.529411764705882;16;18;0.0294117647058824;0.470588235294118
Control.SRR15539874;32;32;0.65625;11;21;0.15625;0.34375
Control.SRR15539874;35;32;0.657142857142857;12;23;0.157142857142857;0.342857142857143
Control.SRR15539874;30;32;0.333333333333333;20;10;0.166666666666667;0.333333333333333
Control.SRR15539874;30;32;0.533333333333333;14;16;0.0333333333333333;0.466666666666667
Control.SRR15539874;31;32;0.580645161290323;13;18;0.0806451612903226;0.419354838709677
Control.SRR15539874;33;32;0.454545454545455;18;15;0.0454545454545455;0.454545454545455
Control.SRR15539874;34;32;0.617647058823529;13;21;0.117647058823529;0.382352941176471
Control.SRR15539874;30;32;0.566666666666667;13;17;0.0666666666666667;0.433333333333333
Control.SRR15539874;29;32;0.655172413793103;10;19;0.155172413793103;0.344827586206897
Control.SRR15539874;34;32;0.529411764705882;16;18;0.0294117647058824;0.470588235294118
Control.SRR15539874;30;32;0.6;12;18;0.1;0.4
Control.SRR15539874;33;32;0.575757575757576;14;19;0.0757575757575758;0.424242424242424
Control.SRR15539874;31;32;0.580645161290323;13;18;0.0806451612903226;0.419354838709677
Control.SRR15539874;31;32;0.451612903225806;17;14;0.0483870967741936;0.451612903225806
Control.SRR15539874;35;32;0.571428571428571;15;20;0.0714285714285714;0.428571428571429
Control.SRR15539874;34;32;0.558823529411765;15;19;0.0588235294117647;0.441176470588235
Control.SRR15539874;28;32;0.5;14;14;0;0.5
Control.SRR15539874;35;32;0.571428571428571;15;20;0.0714285714285714;0.428571428571429
Control.SRR15539874;35;32;0.514285714285714;17;18;0.0142857142857142;0.485714285714286
Control.SRR15539874;31;32;0.612903225806452;12;19;0.112903225806452;0.387096774193548
Control.SRR15539874;31;32;0.451612903225806;17;14;0.0483870967741936;0.451612903225806
Control.SRR15539874;28;32;0.428571428571429;16;12;0.0714285714285715;0.428571428571429
Control.SRR15539874;30;32;0.7;9;21;0.2;0.3
Control.SRR15539874;32;32;0.625;12;20;0.125;0.375
Control.SRR15539874;32;32;0.5;16;16;0;0.5
Control.SRR15539874;31;32;0.451612903225806;17;14;0.0483870967741936;0.451612903225806
Control.SRR15539874;31;32;0.483870967741935;16;15;0.0161290322580645;0.483870967741935
Control.SRR15539874;33;32;0.606060606060606;13;20;0.106060606060606;0.393939393939394
Control.SRR15539874;35;32;0.514285714285714;17;18;0.0142857142857142;0.485714285714286
Control.SRR15539874;32;32;0.4375;18;14;0.0625;0.4375
Control.SRR15539874;32;32;0.53125;15;17;0.03125;0.46875
Control.SRR15539874;31;32;0.548387096774194;14;17;0.0483870967741935;0.451612903225806
Control.SRR15539874;32;32;0.59375;13;19;0.09375;0.40625
Control.SRR15539874;35;32;0.628571428571429;13;22;0.128571428571429;0.371428571428571
Control.SRR15539874;35;32;0.485714285714286;18;17;0.0142857142857143;0.485714285714286
Control.SRR15539874;35;32;0.6;14;21;0.1;0.4
Control.SRR15539874;33;32;0.363636363636364;21;12;0.136363636363636;0.363636363636364
Control.SRR15539874;33;32;0.575757575757576;14;19;0.0757575757575758;0.424242424242424
Control.SRR15539874;31;32;0.612903225806452;12;19;0.112903225806452;0.387096774193548
Control.SRR15539874;28;32;0.535714285714286;13;15;0.0357142857142857;0.464285714285714
Control.SRR15539874;30;32;0.566666666666667;13;17;0.0666666666666667;0.433333333333333
Control.SRR15539874;30;32;0.366666666666667;19;11;0.133333333333333;0.366666666666667
Control.SRR15539874;28;32;0.464285714285714;15;13;0.0357142857142857;0.464285714285714
Control.SRR15539874;35;32;0.6;14;21;0.1;0.4
Control.SRR15539874;31;32;0.516129032258065;15;16;0.0161290322580645;0.483870967741935
Control.SRR15539874;34;32;0.382352941176471;21;13;0.117647058823529;0.382352941176471
Control.SRR15539874;36;32;0.694444444444444;11;25;0.194444444444444;0.305555555555556
Control.SRR15539874;28;32;0.535714285714286;13;15;0.0357142857142857;0.464285714285714
Control.SRR15539874;32;32;0.5625;14;18;0.0625;0.4375
Control.SRR15539874;30;32;0.433333333333333;17;13;0.0666666666666667;0.433333333333333
Control.SRR15539874;31;32;0.516129032258065;15;16;0.0161290322580645;0.483870967741935
Control.SRR15539874;28;32;0.535714285714286;13;15;0.0357142857142857;0.464285714285714
Control.SRR15539874;28;32;0.464285714285714;15;13;0.0357142857142857;0.464285714285714
Control.SRR15539874;29;32;0.448275862068966;16;13;0.0517241379310345;0.448275862068966
Control.SRR15539874;32;32;0.375;20;12;0.125;0.375
Control.SRR15539874;31;32;0.516129032258065;15;16;0.0161290322580645;0.483870967741935
Control.SRR15539874;30;32;0.433333333333333;17;13;0.0666666666666667;0.433333333333333
Control.SRR15539874;34;32;0.470588235294118;18;16;0.0294117647058824;0.470588235294118
Control.SRR15539874;33;32;0.515151515151515;16;17;0.0151515151515151;0.484848484848485
Control.SRR15539874;31;32;0.612903225806452;12;19;0.112903225806452;0.387096774193548
Control.SRR15539874;34;32;0.441176470588235;19;15;0.0588235294117647;0.441176470588235
Control.SRR15539874;36;32;0.5;18;18;0;0.5
Control.SRR15539874;34;32;0.470588235294118;18;16;0.0294117647058824;0.470588235294118
Control.SRR15539874;29;32;0.413793103448276;17;12;0.0862068965517241;0.413793103448276
Control.SRR15539874;28;32;0.428571428571429;16;12;0.0714285714285715;0.428571428571429
Control.SRR15539874;36;32;0.583333333333333;15;21;0.0833333333333334;0.416666666666667
Control.SRR15539874;35;32;0.542857142857143;16;19;0.0428571428571428;0.457142857142857
Control.SRR15539874;35;32;0.514285714285714;17;18;0.0142857142857142;0.485714285714286
Control.SRR15539874;31;32;0.516129032258065;15;16;0.0161290322580645;0.483870967741935
Control.SRR15539874;35;32;0.371428571428571;22;13;0.128571428571429;0.371428571428571
Control.SRR15539874;34;32;0.558823529411765;15;19;0.0588235294117647;0.441176470588235
Control.SRR15539874;35;32;0.457142857142857;19;16;0.0428571428571429;0.457142857142857
Control.SRR15539874;31;32;0.548387096774194;14;17;0.0483870967741935;0.451612903225806
Control.SRR15539874;33;32;0.484848484848485;17;16;0.0151515151515151;0.484848484848485
Control.SRR15539874;35;32;0.342857142857143;23;12;0.157142857142857;0.342857142857143
Control.SRR15539874;34;32;0.529411764705882;16;18;0.0294117647058824;0.470588235294118
Control.SRR15539874;34;32;0.588235294117647;14;20;0.0882352941176471;0.411764705882353
Control.SRR15539874;29;32;0.379310344827586;18;11;0.120689655172414;0.379310344827586
Control.SRR15539874;31;32;0.516129032258065;15;16;0.0161290322580645;0.483870967741935
Control.SRR15539874;35;32;0.485714285714286;18;17;0.0142857142857143;0.485714285714286
Control.SRR15539874;31;32;0.483870967741935;16;15;0.0161290322580645;0.483870967741935
Control.SRR15539874;29;32;0.517241379310345;14;15;0.0172413793103449;0.482758620689655
Control.SRR15539874;30;32;0.4;18;12;0.1;0.4
Control.SRR15539874;35;32;0.6;14;21;0.1;0.4
Control.SRR15539874;30;32;0.6;12;18;0.1;0.4
Control.SRR15539874;35;32;0.514285714285714;17;18;0.0142857142857142;0.485714285714286
Control.SRR15539874;36;32;0.611111111111111;14;22;0.111111111111111;0.388888888888889
Control.SRR15539874;34;32;0.558823529411765;15;19;0.0588235294117647;0.441176470588235
Control.SRR15539874;34;32;0.529411764705882;16;18;0.0294117647058824;0.470588235294118
Control.SRR15539874;30;32;0.566666666666667;13;17;0.0666666666666667;0.433333333333333
Control.SRR15539874;32;32;0.40625;19;13;0.09375;0.40625
Control.SRR15539874;36;32;0.555555555555556;16;20;0.0555555555555556;0.444444444444444
Control.SRR15539874;31;32;0.483870967741935;16;15;0.0161290322580645;0.483870967741935
Control.SRR15539874;30;32;0.566666666666667;13;17;0.0666666666666667;0.433333333333333
Control.SRR15539874;32;32;0.46875;17;15;0.03125;0.46875
Control.SRR15539874;28;32;0.571428571428571;12;16;0.0714285714285714;0.428571428571429
Control.SRR15539874;33;32;0.575757575757576;14;19;0.0757575757575758;0.424242424242424
Control.SRR15539874;30;32;0.433333333333333;17;13;0.0666666666666667;0.433333333333333
Control.SRR15539874;34;32;0.411764705882353;20;14;0.0882352941176471;0.411764705882353
Control.SRR15539874;28;32;0.571428571428571;12;16;0.0714285714285714;0.428571428571429
Control.SRR15539874;34;32;0.529411764705882;16;18;0.0294117647058824;0.470588235294118
Control.SRR15539874;29;32;0.344827586206897;19;10;0.155172413793103;0.344827586206897
Control.SRR15539874;31;32;0.645161290322581;11;20;0.145161290322581;0.354838709677419
Control.SRR15539874;35;32;0.4;21;14;0.1;0.4
Control.SRR15539874;36;32;0.416666666666667;21;15;0.0833333333333333;0.416666666666667
Control.SRR15539874;36;32;0.361111111111111;23;13;0.138888888888889;0.361111111111111
Control.SRR15539874;32;32;0.46875;17;15;0.03125;0.46875
Control.SRR15539874;35;32;0.428571428571429;20;15;0.0714285714285715;0.428571428571429
Control.SRR15539874;36;32;0.583333333333333;15;21;0.0833333333333334;0.416666666666667
Control.SRR15539874;31;32;0.225806451612903;24;7;0.274193548387097;0.225806451612903
Control.SRR15539874;36;32;0.555555555555556;16;20;0.0555555555555556;0.444444444444444
Control.SRR15539874;34;32;0.529411764705882;16;18;0.0294117647058824;0.470588235294118
Control.SRR15539874;32;32;0.40625;19;13;0.09375;0.40625
Control.SRR15539874;31;32;0.516129032258065;15;16;0.0161290322580645;0.483870967741935
Control.SRR15539874;33;32;0.454545454545455;18;15;0.0454545454545455;0.454545454545455
Control.SRR15539874;35;32;0.571428571428571;15;20;0.0714285714285714;0.428571428571429
Control.SRR15539874;36;32;0.444444444444444;20;16;0.0555555555555556;0.444444444444444
Control.SRR15539874;28;32;0.535714285714286;13;15;0.0357142857142857;0.464285714285714
Control.SRR15539874;34;32;0.470588235294118;18;16;0.0294117647058824;0.470588235294118
Control.SRR15539874;36;32;0.472222222222222;19;17;0.0277777777777778;0.472222222222222
Control.SRR15539874;32;32;0.53125;15;17;0.03125;0.46875
Control.SRR15539874;30;32;0.433333333333333;17;13;0.0666666666666667;0.433333333333333
Control.SRR15539874;28;32;0.5;14;14;0;0.5
Control.SRR15539874;34;32;0.470588235294118;18;16;0.0294117647058824;0.470588235294118
Control.SRR15539874;33;32;0.545454545454545;15;18;0.0454545454545454;0.454545454545455
Control.SRR15539874;35;32;0.514285714285714;17;18;0.0142857142857142;0.485714285714286
Control.SRR15539874;36;32;0.472222222222222;19;17;0.0277777777777778;0.472222222222222
Control.SRR15539874;28;32;0.5;14;14;0;0.5
Control.SRR15539874;28;32;0.535714285714286;13;15;0.0357142857142857;0.464285714285714
Control.SRR15539874;30;32;0.5;15;15;0;0.5
Control.SRR15539874;32;32;0.5;16;16;0;0.5
Control.SRR15539874;36;32;0.555555555555556;16;20;0.0555555555555556;0.444444444444444
Control.SRR15539874;29;32;0.482758620689655;15;14;0.0172413793103448;0.482758620689655
Control.SRR15539874;29;32;0.482758620689655;15;14;0.0172413793103448;0.482758620689655
Control.SRR15539874;35;32;0.457142857142857;19;16;0.0428571428571429;0.457142857142857
Control.SRR15539874;32;32;0.46875;17;15;0.03125;0.46875
Control.SRR15539874;36;32;0.527777777777778;17;19;0.0277777777777778;0.472222222222222
Control.SRR15539874;29;32;0.517241379310345;14;15;0.0172413793103449;0.482758620689655
Control.SRR15539874;34;32;0.588235294117647;14;20;0.0882352941176471;0.411764705882353
Control.SRR15539874;36;32;0.472222222222222;19;17;0.0277777777777778;0.472222222222222
Control.SRR15539874;31;32;0.548387096774194;14;17;0.0483870967741935;0.451612903225806
Control.SRR15539874;35;32;0.514285714285714;17;18;0.0142857142857142;0.485714285714286
Control.SRR15539874;36;32;0.388888888888889;22;14;0.111111111111111;0.388888888888889
Control.SRR15539874;36;32;0.583333333333333;15;21;0.0833333333333334;0.416666666666667
Control.SRR15539874;32;32;0.28125;23;9;0.21875;0.28125
Control.SRR15539874;33;32;0.484848484848485;17;16;0.0151515151515151;0.484848484848485
Control.SRR15539874;36;32;0.361111111111111;23;13;0.138888888888889;0.361111111111111
Control.SRR15539874;34;32;0.558823529411765;15;19;0.0588235294117647;0.441176470588235
Control.SRR15539874;33;32;0.393939393939394;20;13;0.106060606060606;0.393939393939394
Control.SRR15539874;36;32;0.5;18;18;0;0.5
Control.SRR15539874;35;32;0.485714285714286;18;17;0.0142857142857143;0.485714285714286
Control.SRR15539874;34;32;0.705882352941177;10;24;0.205882352941177;0.294117647058824
Control.SRR15539874;35;32;0.428571428571429;20;15;0.0714285714285715;0.428571428571429
Control.SRR15539874;36;32;0.611111111111111;14;22;0.111111111111111;0.388888888888889
Control.SRR15539874;33;32;0.393939393939394;20;13;0.106060606060606;0.393939393939394
Control.SRR15539874;36;32;0.444444444444444;20;16;0.0555555555555556;0.444444444444444
Control.SRR15539874;36;32;0.555555555555556;16;20;0.0555555555555556;0.444444444444444
Control.SRR15539874;32;32;0.28125;23;9;0.21875;0.28125
Control.SRR15539874;31;32;0.580645161290323;13;18;0.0806451612903226;0.419354838709677
Control.SRR15539874;35;32;0.342857142857143;23;12;0.157142857142857;0.342857142857143
Control.SRR15539874;36;32;0.444444444444444;20;16;0.0555555555555556;0.444444444444444
Control.SRR15539874;36;32;0.472222222222222;19;17;0.0277777777777778;0.472222222222222
Control.SRR15539874;35;32;0.628571428571429;13;22;0.128571428571429;0.371428571428571
Control.SRR15539874;35;32;0.514285714285714;17;18;0.0142857142857142;0.485714285714286
Control.SRR15539874;28;32;0.5;14;14;0;0.5
Control.SRR15539874;35;32;0.514285714285714;17;18;0.0142857142857142;0.485714285714286
Control.SRR15539874;34;32;0.470588235294118;18;16;0.0294117647058824;0.470588235294118
Control.SRR15539874;34;32;0.382352941176471;21;13;0.117647058823529;0.382352941176471
Control.SRR15539874;33;32;0.424242424242424;19;14;0.0757575757575757;0.424242424242424
Control.SRR15539874;31;32;0.483870967741935;16;15;0.0161290322580645;0.483870967741935
Control.SRR15539874;31;32;0.516129032258065;15;16;0.0161290322580645;0.483870967741935
Control.SRR15539874;33;32;0.606060606060606;13;20;0.106060606060606;0.393939393939394
Control.SRR15539874;28;32;0.5;14;14;0;0.5
Control.SRR15539874;35;32;0.571428571428571;15;20;0.0714285714285714;0.428571428571429
Control.SRR15539874;29;32;0.551724137931034;13;16;0.0517241379310345;0.448275862068966
Control.SRR15539874;32;32;0.59375;13;19;0.09375;0.40625
Control.SRR15539874;32;32;0.46875;17;15;0.03125;0.46875
Control.SRR15539874;33;32;0.636363636363636;12;21;0.136363636363636;0.363636363636364
Control.SRR15539874;35;32;0.457142857142857;19;16;0.0428571428571429;0.457142857142857
Control.SRR15539874;36;32;0.583333333333333;15;21;0.0833333333333334;0.416666666666667
Control.SRR15539874;34;32;0.588235294117647;14;20;0.0882352941176471;0.411764705882353
Control.SRR15539874;36;32;0.444444444444444;20;16;0.0555555555555556;0.444444444444444
Control.SRR15539874;33;32;0.515151515151515;16;17;0.0151515151515151;0.484848484848485
Control.SRR15539874;29;32;0.620689655172414;11;18;0.120689655172414;0.379310344827586
Control.SRR15539874;32;32;0.5625;14;18;0.0625;0.4375
Control.SRR15539874;32;32;0.5625;14;18;0.0625;0.4375
Control.SRR15539874;31;32;0.483870967741935;16;15;0.0161290322580645;0.483870967741935
Control.SRR15539874;34;32;0.441176470588235;19;15;0.0588235294117647;0.441176470588235
Control.SRR15539874;33;32;0.424242424242424;19;14;0.0757575757575757;0.424242424242424
Control.SRR15539874;29;32;0.655172413793103;10;19;0.155172413793103;0.344827586206897
Control.SRR15539874;33;32;0.424242424242424;19;14;0.0757575757575757;0.424242424242424
Control.SRR15539874;32;32;0.4375;18;14;0.0625;0.4375
Control.SRR15539874;29;32;0.551724137931034;13;16;0.0517241379310345;0.448275862068966
Control.SRR15539874;34;32;0.529411764705882;16;18;0.0294117647058824;0.470588235294118
Control.SRR15539874;28;32;0.571428571428571;12;16;0.0714285714285714;0.428571428571429
Control.SRR15539874;31;32;0.32258064516129;21;10;0.17741935483871;0.32258064516129
Control.SRR15539874;30;32;0.6;12;18;0.1;0.4
Control.SRR15539874;31;32;0.548387096774194;14;17;0.0483870967741935;0.451612903225806
Control.SRR15539874;33;32;0.484848484848485;17;16;0.0151515151515151;0.484848484848485
Control.SRR15539874;33;32;0.424242424242424;19;14;0.0757575757575757;0.424242424242424
Control.SRR15539874;28;32;0.428571428571429;16;12;0.0714285714285715;0.428571428571429
Control.SRR15539874;32;32;0.34375;21;11;0.15625;0.34375
Control.SRR15539874;28;32;0.5;14;14;0;0.5
Control.SRR15539874;36;32;0.472222222222222;19;17;0.0277777777777778;0.472222222222222
Control.SRR15539874;30;32;0.6;12;18;0.1;0.4
Control.SRR15539874;31;32;0.516129032258065;15;16;0.0161290322580645;0.483870967741935
Control.SRR15539874;32;32;0.53125;15;17;0.03125;0.46875
Control.SRR15539874;29;32;0.586206896551724;12;17;0.0862068965517241;0.413793103448276
Control.SRR15539874;31;32;0.387096774193548;19;12;0.112903225806452;0.387096774193548
Control.SRR15539874;31;32;0.354838709677419;20;11;0.145161290322581;0.354838709677419
Control.SRR15539874;30;32;0.7;9;21;0.2;0.3
Control.SRR15539874;29;32;0.551724137931034;13;16;0.0517241379310345;0.448275862068966
Control.SRR15539874;33;32;0.484848484848485;17;16;0.0151515151515151;0.484848484848485
Control.SRR15539874;28;32;0.392857142857143;17;11;0.107142857142857;0.392857142857143
Control.SRR15539874;35;32;0.542857142857143;16;19;0.0428571428571428;0.457142857142857
Control.SRR15539874;29;32;0.655172413793103;10;19;0.155172413793103;0.344827586206897
Control.SRR15539874;33;32;0.606060606060606;13;20;0.106060606060606;0.393939393939394
Control.SRR15539874;32;32;0.625;12;20;0.125;0.375
Control.SRR15539874;34;32;0.470588235294118;18;16;0.0294117647058824;0.470588235294118
Control.SRR15539874;33;32;0.545454545454545;15;18;0.0454545454545454;0.454545454545455
Control.SRR15539874;31;32;0.580645161290323;13;18;0.0806451612903226;0.419354838709677
Control.SRR15539874;30;32;0.4;18;12;0.1;0.4
Control.SRR15539874;31;32;0.580645161290323;13;18;0.0806451612903226;0.419354838709677
Control.SRR15539874;32;32;0.46875;17;15;0.03125;0.46875
Control.SRR15539874;30;32;0.433333333333333;17;13;0.0666666666666667;0.433333333333333
Control.SRR15539874;34;32;0.647058823529412;12;22;0.147058823529412;0.352941176470588
Control.SRR15539874;34;32;0.382352941176471;21;13;0.117647058823529;0.382352941176471
Control.SRR15539874;36;32;0.5;18;18;0;0.5
Control.SRR15539874;29;32;0.517241379310345;14;15;0.0172413793103449;0.482758620689655
Control.SRR15539874;31;32;0.419354838709677;18;13;0.0806451612903226;0.419354838709677
Control.SRR15539874;36;32;0.5;18;18;0;0.5
Control.SRR15539874;30;32;0.433333333333333;17;13;0.0666666666666667;0.433333333333333
Control.SRR15539874;33;32;0.454545454545455;18;15;0.0454545454545455;0.454545454545455
Control.SRR15539874;29;32;0.655172413793103;10;19;0.155172413793103;0.344827586206897
Control.SRR15539874;28;32;0.464285714285714;15;13;0.0357142857142857;0.464285714285714
Control.SRR15539874;30;32;0.633333333333333;11;19;0.133333333333333;0.366666666666667
Control.SRR15539874;30;32;0.433333333333333;17;13;0.0666666666666667;0.433333333333333
Control.SRR15539874;36;32;0.555555555555556;16;20;0.0555555555555556;0.444444444444444
Control.SRR15539874;28;32;0.428571428571429;16;12;0.0714285714285715;0.428571428571429
Control.SRR15539874;30;32;0.433333333333333;17;13;0.0666666666666667;0.433333333333333
Control.SRR15539874;30;32;0.466666666666667;16;14;0.0333333333333333;0.466666666666667
Control.SRR15539874;35;32;0.485714285714286;18;17;0.0142857142857143;0.485714285714286
Control.SRR15539874;33;32;0.606060606060606;13;20;0.106060606060606;0.393939393939394
Control.SRR15539874;32;32;0.59375;13;19;0.09375;0.40625
Control.SRR15539874;29;32;0.620689655172414;11;18;0.120689655172414;0.379310344827586
Control.SRR15539874;34;32;0.411764705882353;20;14;0.0882352941176471;0.411764705882353
Control.SRR15539874;29;32;0.482758620689655;15;14;0.0172413793103448;0.482758620689655
Control.SRR15539874;35;32;0.514285714285714;17;18;0.0142857142857142;0.485714285714286
Control.SRR15539874;33;32;0.606060606060606;13;20;0.106060606060606;0.393939393939394
Control.SRR15539874;34;32;0.470588235294118;18;16;0.0294117647058824;0.470588235294118
Control.SRR15539874;32;32;0.5625;14;18;0.0625;0.4375
Control.SRR15539874;28;32;0.357142857142857;18;10;0.142857142857143;0.357142857142857
Control.SRR15539874;34;32;0.411764705882353;20;14;0.0882352941176471;0.411764705882353
Control.SRR15539874;35;32;0.428571428571429;20;15;0.0714285714285715;0.428571428571429
Control.SRR15539874;33;32;0.484848484848485;17;16;0.0151515151515151;0.484848484848485
Control.SRR15539874;32;32;0.53125;15;17;0.03125;0.46875
Control.SRR15539874;33;32;0.454545454545455;18;15;0.0454545454545455;0.454545454545455
Control.SRR15539874;30;32;0.433333333333333;17;13;0.0666666666666667;0.433333333333333
Control.SRR15539874;30;32;0.266666666666667;22;8;0.233333333333333;0.266666666666667
Control.SRR15539874;28;32;0.428571428571429;16;12;0.0714285714285715;0.428571428571429
Control.SRR15539874;33;32;0.515151515151515;16;17;0.0151515151515151;0.484848484848485
Control.SRR15539874;36;32;0.5;18;18;0;0.5
Control.SRR15539874;32;32;0.625;12;20;0.125;0.375
Control.SRR15539874;31;32;0.483870967741935;16;15;0.0161290322580645;0.483870967741935
Control.SRR15539874;36;32;0.388888888888889;22;14;0.111111111111111;0.388888888888889
Control.SRR15539874;32;32;0.4375;18;14;0.0625;0.4375
Control.SRR15539874;32;32;0.4375;18;14;0.0625;0.4375
Control.SRR15539874;30;32;0.466666666666667;16;14;0.0333333333333333;0.466666666666667
Control.SRR15539874;29;32;0.482758620689655;15;14;0.0172413793103448;0.482758620689655
Control.SRR15539874;31;32;0.387096774193548;19;12;0.112903225806452;0.387096774193548
Control.SRR15539874;31;32;0.419354838709677;18;13;0.0806451612903226;0.419354838709677
Control.SRR15539874;29;32;0.413793103448276;17;12;0.0862068965517241;0.413793103448276
Control.SRR15539874;36;32;0.555555555555556;16;20;0.0555555555555556;0.444444444444444
Control.SRR15539874;32;32;0.53125;15;17;0.03125;0.46875
Control.SRR15539874;34;32;0.470588235294118;18;16;0.0294117647058824;0.470588235294118
Control.SRR15539874;30;32;0.433333333333333;17;13;0.0666666666666667;0.433333333333333
Control.SRR15539874;30;32;0.633333333333333;11;19;0.133333333333333;0.366666666666667
Control.SRR15539874;34;32;0.558823529411765;15;19;0.0588235294117647;0.441176470588235
Control.SRR15539874;31;32;0.548387096774194;14;17;0.0483870967741935;0.451612903225806
Control.SRR15539874;36;32;0.5;18;18;0;0.5
Control.SRR15539874;36;32;0.5;18;18;0;0.5
Control.SRR15539874;30;32;0.433333333333333;17;13;0.0666666666666667;0.433333333333333
Control.SRR15539874;33;32;0.515151515151515;16;17;0.0151515151515151;0.484848484848485
Control.SRR15539874;32;32;0.53125;15;17;0.03125;0.46875
Control.SRR15539874;31;32;0.580645161290323;13;18;0.0806451612903226;0.419354838709677
Control.SRR15539874;34;32;0.5;17;17;0;0.5
Control.SRR15539874;35;32;0.542857142857143;16;19;0.0428571428571428;0.457142857142857
Control.SRR15539874;35;32;0.514285714285714;17;18;0.0142857142857142;0.485714285714286
Control.SRR15539874;31;32;0.387096774193548;19;12;0.112903225806452;0.387096774193548
Control.SRR15539874;35;32;0.371428571428571;22;13;0.128571428571429;0.371428571428571
Control.SRR15539874;35;32;0.285714285714286;25;10;0.214285714285714;0.285714285714286
Control.SRR15539874;33;32;0.545454545454545;15;18;0.0454545454545454;0.454545454545455
Control.SRR15539874;35;32;0.571428571428571;15;20;0.0714285714285714;0.428571428571429
Control.SRR15539874;36;32;0.527777777777778;17;19;0.0277777777777778;0.472222222222222
Control.SRR15539874;32;32;0.53125;15;17;0.03125;0.46875
Control.SRR15539874;34;32;0.617647058823529;13;21;0.117647058823529;0.382352941176471
Control.SRR15539874;30;32;0.466666666666667;16;14;0.0333333333333333;0.466666666666667
Control.SRR15539874;28;32;0.464285714285714;15;13;0.0357142857142857;0.464285714285714
Control.SRR15539874;36;32;0.444444444444444;20;16;0.0555555555555556;0.444444444444444
Control.SRR15539874;34;32;0.5;17;17;0;0.5
Control.SRR15539874;32;32;0.5;16;16;0;0.5
Control.SRR15539874;30;32;0.4;18;12;0.1;0.4
Control.SRR15539874;32;32;0.5;16;16;0;0.5
Control.SRR15539874;29;32;0.724137931034483;8;21;0.224137931034483;0.275862068965517
Control.SRR15539874;33;32;0.545454545454545;15;18;0.0454545454545454;0.454545454545455
Control.SRR15539874;28;32;0.464285714285714;15;13;0.0357142857142857;0.464285714285714
Control.SRR15539874;35;32;0.571428571428571;15;20;0.0714285714285714;0.428571428571429
Control.SRR15539874;30;32;0.433333333333333;17;13;0.0666666666666667;0.433333333333333
Control.SRR15539874;30;32;0.4;18;12;0.1;0.4
Control.SRR15539874;33;32;0.333333333333333;22;11;0.166666666666667;0.333333333333333
Control.SRR15539874;32;32;0.46875;17;15;0.03125;0.46875
Control.SRR15539874;31;32;0.516129032258065;15;16;0.0161290322580645;0.483870967741935
Control.SRR15539874;32;32;0.59375;13;19;0.09375;0.40625
Control.SRR15539874;29;32;0.517241379310345;14;15;0.0172413793103449;0.482758620689655
Control.SRR15539874;31;32;0.387096774193548;19;12;0.112903225806452;0.387096774193548
Control.SRR15539874;34;32;0.558823529411765;15;19;0.0588235294117647;0.441176470588235
Control.SRR15539874;36;32;0.444444444444444;20;16;0.0555555555555556;0.444444444444444
Control.SRR15539874;32;32;0.625;12;20;0.125;0.375
Control.SRR15539874;33;32;0.515151515151515;16;17;0.0151515151515151;0.484848484848485
Control.SRR15539874;34;32;0.5;17;17;0;0.5
Control.SRR15539874;36;32;0.5;18;18;0;0.5
Control.SRR15539874;33;32;0.545454545454545;15;18;0.0454545454545454;0.454545454545455
Control.SRR15539874;31;32;0.548387096774194;14;17;0.0483870967741935;0.451612903225806
Control.SRR15539874;34;32;0.529411764705882;16;18;0.0294117647058824;0.470588235294118
Control.SRR15539874;32;32;0.34375;21;11;0.15625;0.34375
Control.SRR15539874;32;32;0.5625;14;18;0.0625;0.4375
Control.SRR15539874;30;32;0.533333333333333;14;16;0.0333333333333333;0.466666666666667
Control.SRR15539874;31;32;0.516129032258065;15;16;0.0161290322580645;0.483870967741935
Control.SRR15539874;36;32;0.416666666666667;21;15;0.0833333333333333;0.416666666666667
Control.SRR15539874;28;32;0.464285714285714;15;13;0.0357142857142857;0.464285714285714
Control.SRR15539874;34;32;0.588235294117647;14;20;0.0882352941176471;0.411764705882353
Control.SRR15539874;29;32;0.413793103448276;17;12;0.0862068965517241;0.413793103448276
Control.SRR15539874;36;32;0.444444444444444;20;16;0.0555555555555556;0.444444444444444
Control.SRR15539874;36;32;0.527777777777778;17;19;0.0277777777777778;0.472222222222222
Control.SRR15539874;29;32;0.344827586206897;19;10;0.155172413793103;0.344827586206897
Control.SRR15539874;35;32;0.371428571428571;22;13;0.128571428571429;0.371428571428571
Control.SRR15539874;36;32;0.472222222222222;19;17;0.0277777777777778;0.472222222222222
Control.SRR15539874;33;32;0.545454545454545;15;18;0.0454545454545454;0.454545454545455
Control.SRR15539874;30;32;0.533333333333333;14;16;0.0333333333333333;0.466666666666667
Control.SRR15539874;30;32;0.566666666666667;13;17;0.0666666666666667;0.433333333333333
Control.SRR15539874;29;32;0.620689655172414;11;18;0.120689655172414;0.379310344827586
Control.SRR15539874;29;32;0.517241379310345;14;15;0.0172413793103449;0.482758620689655
Control.SRR15539874;28;32;0.428571428571429;16;12;0.0714285714285715;0.428571428571429
Control.SRR15539874;28;32;0.357142857142857;18;10;0.142857142857143;0.357142857142857
Control.SRR15539874;29;32;0.655172413793103;10;19;0.155172413793103;0.344827586206897
Control.SRR15539874;34;32;0.441176470588235;19;15;0.0588235294117647;0.441176470588235
Control.SRR15539874;29;32;0.448275862068966;16;13;0.0517241379310345;0.448275862068966
Control.SRR15539874;32;32;0.34375;21;11;0.15625;0.34375
Control.SRR15539874;33;32;0.575757575757576;14;19;0.0757575757575758;0.424242424242424
Control.SRR15539874;30;32;0.566666666666667;13;17;0.0666666666666667;0.433333333333333
Control.SRR15539874;34;32;0.470588235294118;18;16;0.0294117647058824;0.470588235294118
Control.SRR15539874;29;32;0.620689655172414;11;18;0.120689655172414;0.379310344827586
Control.SRR15539874;28;32;0.428571428571429;16;12;0.0714285714285715;0.428571428571429
Control.SRR15539874;28;32;0.535714285714286;13;15;0.0357142857142857;0.464285714285714
Control.SRR15539874;29;32;0.344827586206897;19;10;0.155172413793103;0.344827586206897
Control.SRR15539874;29;32;0.413793103448276;17;12;0.0862068965517241;0.413793103448276
Control.SRR15539874;30;32;0.6;12;18;0.1;0.4
Control.SRR15539874;28;32;0.5;14;14;0;0.5
Control.SRR15539874;30;32;0.366666666666667;19;11;0.133333333333333;0.366666666666667
Control.SRR15539874;28;32;0.535714285714286;13;15;0.0357142857142857;0.464285714285714
Control.SRR15539874;28;32;0.535714285714286;13;15;0.0357142857142857;0.464285714285714
Control.SRR15539874;32;32;0.625;12;20;0.125;0.375
Control.SRR15539874;32;32;0.5625;14;18;0.0625;0.4375
Control.SRR15539874;29;32;0.551724137931034;13;16;0.0517241379310345;0.448275862068966
Control.SRR15539874;29;32;0.448275862068966;16;13;0.0517241379310345;0.448275862068966
Control.SRR15539874;29;32;0.586206896551724;12;17;0.0862068965517241;0.413793103448276
Control.SRR15539874;28;32;0.571428571428571;12;16;0.0714285714285714;0.428571428571429
Control.SRR15539874;32;32;0.5;16;16;0;0.5
Control.SRR15539874;31;32;0.645161290322581;11;20;0.145161290322581;0.354838709677419
Control.SRR15539874;35;32;0.485714285714286;18;17;0.0142857142857143;0.485714285714286
Control.SRR15539874;35;32;0.685714285714286;11;24;0.185714285714286;0.314285714285714
Control.SRR15539874;36;32;0.5;18;18;0;0.5
Control.SRR15539874;36;32;0.416666666666667;21;15;0.0833333333333333;0.416666666666667
Control.SRR15539874;29;32;0.379310344827586;18;11;0.120689655172414;0.379310344827586
Control.SRR15539874;36;32;0.472222222222222;19;17;0.0277777777777778;0.472222222222222
Control.SRR15539874;31;32;0.516129032258065;15;16;0.0161290322580645;0.483870967741935
Control.SRR15539874;30;32;0.633333333333333;11;19;0.133333333333333;0.366666666666667
Control.SRR15539874;35;32;0.485714285714286;18;17;0.0142857142857143;0.485714285714286
Control.SRR15539874;35;32;0.542857142857143;16;19;0.0428571428571428;0.457142857142857
Control.SRR15539874;32;32;0.59375;13;19;0.09375;0.40625
Control.SRR15539874;33;32;0.454545454545455;18;15;0.0454545454545455;0.454545454545455
Control.SRR15539874;36;32;0.5;18;18;0;0.5
Control.SRR15539874;30;32;0.566666666666667;13;17;0.0666666666666667;0.433333333333333
Control.SRR15539874;31;32;0.516129032258065;15;16;0.0161290322580645;0.483870967741935
Control.SRR15539874;36;32;0.5;18;18;0;0.5
Control.SRR15539874;29;32;0.517241379310345;14;15;0.0172413793103449;0.482758620689655
Control.SRR15539874;33;32;0.484848484848485;17;16;0.0151515151515151;0.484848484848485
Control.SRR15539874;34;32;0.5;17;17;0;0.5
Control.SRR15539874;34;32;0.441176470588235;19;15;0.0588235294117647;0.441176470588235
Control.SRR15539874;33;32;0.484848484848485;17;16;0.0151515151515151;0.484848484848485
Control.SRR15539874;33;32;0.484848484848485;17;16;0.0151515151515151;0.484848484848485
Control.SRR15539874;29;32;0.482758620689655;15;14;0.0172413793103448;0.482758620689655
Control.SRR15539874;31;32;0.483870967741935;16;15;0.0161290322580645;0.483870967741935
Control.SRR15539874;35;32;0.457142857142857;19;16;0.0428571428571429;0.457142857142857
Control.SRR15539874;29;32;0.517241379310345;14;15;0.0172413793103449;0.482758620689655
Control.SRR15539874;29;32;0.413793103448276;17;12;0.0862068965517241;0.413793103448276
Control.SRR15539874;30;32;0.533333333333333;14;16;0.0333333333333333;0.466666666666667
Control.SRR15539874;33;32;0.484848484848485;17;16;0.0151515151515151;0.484848484848485
Control.SRR15539874;32;32;0.625;12;20;0.125;0.375
Control.SRR15539874;28;32;0.5;14;14;0;0.5
Control.SRR15539874;34;32;0.470588235294118;18;16;0.0294117647058824;0.470588235294118
Control.SRR15539874;36;32;0.5;18;18;0;0.5
Control.SRR15539874;32;32;0.5625;14;18;0.0625;0.4375
Control.SRR15539874;30;32;0.566666666666667;13;17;0.0666666666666667;0.433333333333333
Control.SRR15539874;29;32;0.620689655172414;11;18;0.120689655172414;0.379310344827586
Control.SRR15539874;33;32;0.575757575757576;14;19;0.0757575757575758;0.424242424242424
Control.SRR15539874;29;32;0.620689655172414;11;18;0.120689655172414;0.379310344827586
Control.SRR15539874;28;32;0.571428571428571;12;16;0.0714285714285714;0.428571428571429
Control.SRR15539874;33;32;0.363636363636364;21;12;0.136363636363636;0.363636363636364
Control.SRR15539874;34;32;0.5;17;17;0;0.5
Control.SRR15539874;32;32;0.59375;13;19;0.09375;0.40625
Control.SRR15539874;29;32;0.448275862068966;16;13;0.0517241379310345;0.448275862068966
Control.SRR15539874;31;32;0.516129032258065;15;16;0.0161290322580645;0.483870967741935
Control.SRR15539874;29;32;0.482758620689655;15;14;0.0172413793103448;0.482758620689655
Control.SRR15539874;30;32;0.466666666666667;16;14;0.0333333333333333;0.466666666666667
Control.SRR15539874;36;32;0.388888888888889;22;14;0.111111111111111;0.388888888888889
Control.SRR15539874;28;32;0.5;14;14;0;0.5
Control.SRR15539874;33;32;0.484848484848485;17;16;0.0151515151515151;0.484848484848485
Control.SRR15539874;31;32;0.516129032258065;15;16;0.0161290322580645;0.483870967741935
Control.SRR15539874;32;32;0.6875;10;22;0.1875;0.3125
Control.SRR15539874;29;32;0.448275862068966;16;13;0.0517241379310345;0.448275862068966
Control.SRR15539874;29;32;0.586206896551724;12;17;0.0862068965517241;0.413793103448276
Control.SRR15539874;29;32;0.379310344827586;18;11;0.120689655172414;0.379310344827586
Control.SRR15539874;29;32;0.517241379310345;14;15;0.0172413793103449;0.482758620689655
Control.SRR15539874;30;32;0.633333333333333;11;19;0.133333333333333;0.366666666666667
Control.SRR15539874;28;32;0.571428571428571;12;16;0.0714285714285714;0.428571428571429
Control.SRR15539874;34;32;0.470588235294118;18;16;0.0294117647058824;0.470588235294118
Control.SRR15539874;31;32;0.451612903225806;17;14;0.0483870967741936;0.451612903225806
Control.SRR15539874;35;32;0.4;21;14;0.1;0.4
Control.SRR15539874;30;32;0.666666666666667;10;20;0.166666666666667;0.333333333333333
Control.SRR15539874;34;32;0.441176470588235;19;15;0.0588235294117647;0.441176470588235
Control.SRR15539874;35;32;0.542857142857143;16;19;0.0428571428571428;0.457142857142857
Control.SRR15539874;28;32;0.357142857142857;18;10;0.142857142857143;0.357142857142857
Control.SRR15539874;32;32;0.625;12;20;0.125;0.375
Control.SRR15539874;36;32;0.527777777777778;17;19;0.0277777777777778;0.472222222222222
Control.SRR15539874;33;32;0.545454545454545;15;18;0.0454545454545454;0.454545454545455
Control.SRR15539874;31;32;0.516129032258065;15;16;0.0161290322580645;0.483870967741935
Control.SRR15539874;36;32;0.416666666666667;21;15;0.0833333333333333;0.416666666666667
Control.SRR15539874;32;32;0.5;16;16;0;0.5
Control.SRR15539874;36;32;0.5;18;18;0;0.5
Control.SRR15539874;29;32;0.275862068965517;21;8;0.224137931034483;0.275862068965517
Control.SRR15539874;29;32;0.448275862068966;16;13;0.0517241379310345;0.448275862068966
Control.SRR15539874;32;32;0.65625;11;21;0.15625;0.34375
Control.SRR15539874;35;32;0.457142857142857;19;16;0.0428571428571429;0.457142857142857
Control.SRR15539874;30;32;0.466666666666667;16;14;0.0333333333333333;0.466666666666667
Control.SRR15539874;36;32;0.555555555555556;16;20;0.0555555555555556;0.444444444444444
Control.SRR15539874;37;32;0.378378378378378;23;14;0.121621621621622;0.378378378378378
Control.SRR15539874;33;32;0.424242424242424;19;14;0.0757575757575757;0.424242424242424
Control.SRR15539874;35;32;0.485714285714286;18;17;0.0142857142857143;0.485714285714286
Control.SRR15539874;32;32;0.5;16;16;0;0.5
Control.SRR15539874;35;32;0.485714285714286;18;17;0.0142857142857143;0.485714285714286
Control.SRR15539874;32;32;0.59375;13;19;0.09375;0.40625
Control.SRR15539874;30;32;0.466666666666667;16;14;0.0333333333333333;0.466666666666667
Control.SRR15539874;31;32;0.419354838709677;18;13;0.0806451612903226;0.419354838709677
Control.SRR15539874;34;32;0.470588235294118;18;16;0.0294117647058824;0.470588235294118
Control.SRR15539874;29;32;0.620689655172414;11;18;0.120689655172414;0.379310344827586
Control.SRR15539874;37;32;0.486486486486487;19;18;0.0135135135135135;0.486486486486487
Control.SRR15539874;34;32;0.441176470588235;19;15;0.0588235294117647;0.441176470588235
Control.SRR15539874;33;32;0.393939393939394;20;13;0.106060606060606;0.393939393939394
Control.SRR15539874;35;32;0.6;14;21;0.1;0.4
Control.SRR15539874;35;32;0.514285714285714;17;18;0.0142857142857142;0.485714285714286
Control.SRR15539874;37;32;0.513513513513513;18;19;0.0135135135135135;0.486486486486487
Control.SRR15539874;30;32;0.433333333333333;17;13;0.0666666666666667;0.433333333333333
Control.SRR15539874;30;32;0.5;15;15;0;0.5
Control.SRR15539874;33;32;0.515151515151515;16;17;0.0151515151515151;0.484848484848485
Control.SRR15539874;34;32;0.558823529411765;15;19;0.0588235294117647;0.441176470588235
Control.SRR15539874;35;32;0.542857142857143;16;19;0.0428571428571428;0.457142857142857
Control.SRR15539874;30;32;0.466666666666667;16;14;0.0333333333333333;0.466666666666667
Control.SRR15539874;31;32;0.580645161290323;13;18;0.0806451612903226;0.419354838709677
Control.SRR15539874;36;32;0.416666666666667;21;15;0.0833333333333333;0.416666666666667
Control.SRR15539874;31;32;0.548387096774194;14;17;0.0483870967741935;0.451612903225806
Control.SRR15539874;37;32;0.378378378378378;23;14;0.121621621621622;0.378378378378378
Control.SRR15539874;33;32;0.575757575757576;14;19;0.0757575757575758;0.424242424242424
Control.SRR15539874;31;32;0.451612903225806;17;14;0.0483870967741936;0.451612903225806
Control.SRR15539874;29;32;0.517241379310345;14;15;0.0172413793103449;0.482758620689655
Control.SRR15539874;30;32;0.433333333333333;17;13;0.0666666666666667;0.433333333333333
Control.SRR15539874;33;32;0.545454545454545;15;18;0.0454545454545454;0.454545454545455
Control.SRR15539874;30;32;0.366666666666667;19;11;0.133333333333333;0.366666666666667
Control.SRR15539874;37;32;0.405405405405405;22;15;0.0945945945945946;0.405405405405405
Control.SRR15539874;37;32;0.486486486486487;19;18;0.0135135135135135;0.486486486486487
Control.SRR15539874;34;32;0.470588235294118;18;16;0.0294117647058824;0.470588235294118
Control.SRR15539874;29;32;0.689655172413793;9;20;0.189655172413793;0.310344827586207
Control.SRR15539874;33;32;0.454545454545455;18;15;0.0454545454545455;0.454545454545455
Control.SRR15539874;30;32;0.6;12;18;0.1;0.4
Control.SRR15539874;35;32;0.371428571428571;22;13;0.128571428571429;0.371428571428571
Control.SRR15539874;37;32;0.648648648648649;13;24;0.148648648648649;0.351351351351351
Control.SRR15539874;33;32;0.636363636363636;12;21;0.136363636363636;0.363636363636364
Control.SRR15539874;37;32;0.621621621621622;14;23;0.121621621621622;0.378378378378378
Control.SRR15539874;33;32;0.545454545454545;15;18;0.0454545454545454;0.454545454545455
Control.SRR15539874;33;32;0.272727272727273;24;9;0.227272727272727;0.272727272727273
Control.SRR15539874;31;32;0.516129032258065;15;16;0.0161290322580645;0.483870967741935
Control.SRR15539874;30;32;0.5;15;15;0;0.5
Control.SRR15539874;29;32;0.482758620689655;15;14;0.0172413793103448;0.482758620689655
Control.SRR15539874;30;32;0.466666666666667;16;14;0.0333333333333333;0.466666666666667
Control.SRR15539874;30;32;0.433333333333333;17;13;0.0666666666666667;0.433333333333333
Control.SRR15539874;37;32;0.513513513513513;18;19;0.0135135135135135;0.486486486486487
Control.SRR15539874;31;32;0.612903225806452;12;19;0.112903225806452;0.387096774193548
Control.SRR15539874;36;32;0.527777777777778;17;19;0.0277777777777778;0.472222222222222
Control.SRR15539874;31;32;0.548387096774194;14;17;0.0483870967741935;0.451612903225806
Control.SRR15539874;29;32;0.517241379310345;14;15;0.0172413793103449;0.482758620689655
Control.SRR15539874;30;32;0.433333333333333;17;13;0.0666666666666667;0.433333333333333
Control.SRR15539874;30;32;0.433333333333333;17;13;0.0666666666666667;0.433333333333333
Control.SRR15539874;33;32;0.333333333333333;22;11;0.166666666666667;0.333333333333333
Control.SRR15539874;30;32;0.5;15;15;0;0.5
Control.SRR15539874;37;32;0.513513513513513;18;19;0.0135135135135135;0.486486486486487
Control.SRR15539874;37;32;0.378378378378378;23;14;0.121621621621622;0.378378378378378
Control.SRR15539874;29;32;0.379310344827586;18;11;0.120689655172414;0.379310344827586
Control.SRR15539874;29;32;0.517241379310345;14;15;0.0172413793103449;0.482758620689655
Control.SRR15539874;35;32;0.457142857142857;19;16;0.0428571428571429;0.457142857142857
Control.SRR15539874;37;32;0.567567567567568;16;21;0.0675675675675675;0.432432432432432
Control.SRR15539874;33;32;0.333333333333333;22;11;0.166666666666667;0.333333333333333
Control.SRR15539874;30;32;0.433333333333333;17;13;0.0666666666666667;0.433333333333333
Control.SRR15539874;33;32;0.606060606060606;13;20;0.106060606060606;0.393939393939394
Control.SRR15539874;29;32;0.689655172413793;9;20;0.189655172413793;0.310344827586207
Control.SRR15539874;30;32;0.5;15;15;0;0.5
Control.SRR15539874;30;32;0.8;6;24;0.3;0.2
Control.SRR15539874;36;32;0.555555555555556;16;20;0.0555555555555556;0.444444444444444
Control.SRR15539874;36;32;0.472222222222222;19;17;0.0277777777777778;0.472222222222222
Control.SRR15539874;32;32;0.5625;14;18;0.0625;0.4375
Control.SRR15539874;33;32;0.484848484848485;17;16;0.0151515151515151;0.484848484848485
Control.SRR15539874;32;32;0.40625;19;13;0.09375;0.40625
Control.SRR15539874;31;32;0.645161290322581;11;20;0.145161290322581;0.354838709677419
Control.SRR15539874;31;32;0.354838709677419;20;11;0.145161290322581;0.354838709677419
Control.SRR15539874;29;32;0.413793103448276;17;12;0.0862068965517241;0.413793103448276
Control.SRR15539874;36;32;0.416666666666667;21;15;0.0833333333333333;0.416666666666667
Control.SRR15539874;36;32;0.416666666666667;21;15;0.0833333333333333;0.416666666666667
Control.SRR15539874;36;32;0.416666666666667;21;15;0.0833333333333333;0.416666666666667
Control.SRR15539874;32;32;0.625;12;20;0.125;0.375
Control.SRR15539874;37;32;0.540540540540541;17;20;0.0405405405405406;0.459459459459459
Control.SRR15539874;29;32;0.586206896551724;12;17;0.0862068965517241;0.413793103448276
Control.SRR15539874;34;32;0.529411764705882;16;18;0.0294117647058824;0.470588235294118
Control.SRR15539874;30;32;0.633333333333333;11;19;0.133333333333333;0.366666666666667
Control.SRR15539874;29;32;0.586206896551724;12;17;0.0862068965517241;0.413793103448276
Control.SRR15539874;36;32;0.611111111111111;14;22;0.111111111111111;0.388888888888889
Control.SRR15539874;32;32;0.5625;14;18;0.0625;0.4375
Control.SRR15539874;30;32;0.466666666666667;16;14;0.0333333333333333;0.466666666666667
Control.SRR15539874;33;32;0.454545454545455;18;15;0.0454545454545455;0.454545454545455
Control.SRR15539874;34;32;0.588235294117647;14;20;0.0882352941176471;0.411764705882353
Control.SRR15539874;32;32;0.375;20;12;0.125;0.375
Control.SRR15539874;33;32;0.454545454545455;18;15;0.0454545454545455;0.454545454545455
Control.SRR15539874;29;32;0.448275862068966;16;13;0.0517241379310345;0.448275862068966
Control.SRR15539874;29;32;0.482758620689655;15;14;0.0172413793103448;0.482758620689655
Control.SRR15539874;37;32;0.324324324324324;25;12;0.175675675675676;0.324324324324324
Control.SRR15539874;35;32;0.6;14;21;0.1;0.4
Control.SRR15539874;32;32;0.59375;13;19;0.09375;0.40625
Control.SRR15539874;30;32;0.466666666666667;16;14;0.0333333333333333;0.466666666666667
Control.SRR15539874;36;32;0.638888888888889;13;23;0.138888888888889;0.361111111111111
Control.SRR15539874;37;32;0.513513513513513;18;19;0.0135135135135135;0.486486486486487
Control.SRR15539874;29;32;0.482758620689655;15;14;0.0172413793103448;0.482758620689655
Control.SRR15539874;34;32;0.558823529411765;15;19;0.0588235294117647;0.441176470588235
Control.SRR15539874;29;32;0.551724137931034;13;16;0.0517241379310345;0.448275862068966
Control.SRR15539874;36;32;0.416666666666667;21;15;0.0833333333333333;0.416666666666667
Control.SRR15539874;36;32;0.444444444444444;20;16;0.0555555555555556;0.444444444444444
Control.SRR15539874;32;32;0.375;20;12;0.125;0.375
Control.SRR15539874;31;32;0.580645161290323;13;18;0.0806451612903226;0.419354838709677
Control.SRR15539874;34;32;0.529411764705882;16;18;0.0294117647058824;0.470588235294118
Control.SRR15539874;32;32;0.34375;21;11;0.15625;0.34375
Control.SRR15539874;30;32;0.533333333333333;14;16;0.0333333333333333;0.466666666666667
Control.SRR15539874;35;32;0.542857142857143;16;19;0.0428571428571428;0.457142857142857
Control.SRR15539874;32;32;0.59375;13;19;0.09375;0.40625
Control.SRR15539874;31;32;0.387096774193548;19;12;0.112903225806452;0.387096774193548
Control.SRR15539874;37;32;0.540540540540541;17;20;0.0405405405405406;0.459459459459459
Control.SRR15539874;36;32;0.5;18;18;0;0.5
Control.SRR15539874;36;32;0.361111111111111;23;13;0.138888888888889;0.361111111111111
Control.SRR15539874;37;32;0.648648648648649;13;24;0.148648648648649;0.351351351351351
Control.SRR15539874;36;32;0.416666666666667;21;15;0.0833333333333333;0.416666666666667
Control.SRR15539874;33;32;0.424242424242424;19;14;0.0757575757575757;0.424242424242424
Control.SRR15539874;35;32;0.514285714285714;17;18;0.0142857142857142;0.485714285714286
Control.SRR15539874;31;32;0.483870967741935;16;15;0.0161290322580645;0.483870967741935
Control.SRR15539874;33;32;0.575757575757576;14;19;0.0757575757575758;0.424242424242424
Control.SRR15539874;33;32;0.454545454545455;18;15;0.0454545454545455;0.454545454545455
Control.SRR15539874;32;32;0.53125;15;17;0.03125;0.46875
Control.SRR15539874;34;32;0.558823529411765;15;19;0.0588235294117647;0.441176470588235
Control.SRR15539874;29;32;0.413793103448276;17;12;0.0862068965517241;0.413793103448276
Control.SRR15539874;31;32;0.580645161290323;13;18;0.0806451612903226;0.419354838709677
Control.SRR15539874;35;32;0.514285714285714;17;18;0.0142857142857142;0.485714285714286
Control.SRR15539874;32;32;0.5625;14;18;0.0625;0.4375
Control.SRR15539874;32;32;0.53125;15;17;0.03125;0.46875
Control.SRR15539874;35;32;0.485714285714286;18;17;0.0142857142857143;0.485714285714286
Control.SRR15539874;33;32;0.515151515151515;16;17;0.0151515151515151;0.484848484848485
Control.SRR15539874;30;32;0.5;15;15;0;0.5
Control.SRR15539874;30;32;0.7;9;21;0.2;0.3
Control.SRR15539874;31;32;0.612903225806452;12;19;0.112903225806452;0.387096774193548
Control.SRR15539874;35;32;0.314285714285714;24;11;0.185714285714286;0.314285714285714
Control.SRR15539874;36;32;0.472222222222222;19;17;0.0277777777777778;0.472222222222222
Control.SRR15539874;33;32;0.484848484848485;17;16;0.0151515151515151;0.484848484848485
Control.SRR15539874;30;32;0.5;15;15;0;0.5
Control.SRR15539874;29;32;0.482758620689655;15;14;0.0172413793103448;0.482758620689655
Control.SRR15539874;36;32;0.361111111111111;23;13;0.138888888888889;0.361111111111111
Control.SRR15539874;32;32;0.5;16;16;0;0.5
Control.SRR15539874;30;32;0.5;15;15;0;0.5
Control.SRR15539874;31;32;0.548387096774194;14;17;0.0483870967741935;0.451612903225806
Control.SRR15539874;33;32;0.454545454545455;18;15;0.0454545454545455;0.454545454545455
Control.SRR15539874;34;32;0.352941176470588;22;12;0.147058823529412;0.352941176470588
Control.SRR15539874;36;32;0.5;18;18;0;0.5
Control.SRR15539874;31;32;0.451612903225806;17;14;0.0483870967741936;0.451612903225806
Control.SRR15539874;34;32;0.470588235294118;18;16;0.0294117647058824;0.470588235294118
Control.SRR15539874;36;32;0.472222222222222;19;17;0.0277777777777778;0.472222222222222
Control.SRR15539874;30;32;0.5;15;15;0;0.5
Control.SRR15539874;31;32;0.580645161290323;13;18;0.0806451612903226;0.419354838709677
Control.SRR15539874;33;32;0.393939393939394;20;13;0.106060606060606;0.393939393939394
Control.SRR15539874;33;32;0.272727272727273;24;9;0.227272727272727;0.272727272727273
Control.SRR15539874;30;32;0.6;12;18;0.1;0.4
Control.SRR15539874;30;32;0.633333333333333;11;19;0.133333333333333;0.366666666666667
Control.SRR15539874;35;32;0.428571428571429;20;15;0.0714285714285715;0.428571428571429
Control.SRR15539874;31;32;0.419354838709677;18;13;0.0806451612903226;0.419354838709677
Control.SRR15539874;33;32;0.666666666666667;11;22;0.166666666666667;0.333333333333333
Control.SRR15539874;34;32;0.529411764705882;16;18;0.0294117647058824;0.470588235294118
Control.SRR15539874;35;32;0.285714285714286;25;10;0.214285714285714;0.285714285714286
Control.SRR15539874;36;32;0.555555555555556;16;20;0.0555555555555556;0.444444444444444
Control.SRR15539874;36;32;0.5;18;18;0;0.5
Control.SRR15539874;33;32;0.393939393939394;20;13;0.106060606060606;0.393939393939394
Control.SRR15539874;30;32;0.4;18;12;0.1;0.4
Control.SRR15539874;32;32;0.46875;17;15;0.03125;0.46875
Control.SRR15539874;29;32;0.482758620689655;15;14;0.0172413793103448;0.482758620689655
Control.SRR15539874;33;32;0.606060606060606;13;20;0.106060606060606;0.393939393939394
Control.SRR15539874;33;32;0.484848484848485;17;16;0.0151515151515151;0.484848484848485
Control.SRR15539874;37;32;0.594594594594595;15;22;0.0945945945945946;0.405405405405405
Control.SRR15539874;31;32;0.451612903225806;17;14;0.0483870967741936;0.451612903225806
Control.SRR15539874;36;32;0.527777777777778;17;19;0.0277777777777778;0.472222222222222
Control.SRR15539874;35;32;0.542857142857143;16;19;0.0428571428571428;0.457142857142857
Control.SRR15539874;31;32;0.645161290322581;11;20;0.145161290322581;0.354838709677419
Control.SRR15539874;34;32;0.441176470588235;19;15;0.0588235294117647;0.441176470588235
Control.SRR15539874;32;32;0.4375;18;14;0.0625;0.4375
Control.SRR15539874;37;32;0.648648648648649;13;24;0.148648648648649;0.351351351351351
Control.SRR15539874;32;32;0.625;12;20;0.125;0.375
Control.SRR15539874;30;32;0.566666666666667;13;17;0.0666666666666667;0.433333333333333
Control.SRR15539874;30;32;0.533333333333333;14;16;0.0333333333333333;0.466666666666667
Control.SRR15539874;30;32;0.466666666666667;16;14;0.0333333333333333;0.466666666666667
Control.SRR15539874;33;32;0.424242424242424;19;14;0.0757575757575757;0.424242424242424
Control.SRR15539874;34;32;0.529411764705882;16;18;0.0294117647058824;0.470588235294118
Control.SRR15539874;36;32;0.555555555555556;16;20;0.0555555555555556;0.444444444444444
Control.SRR15539874;33;32;0.484848484848485;17;16;0.0151515151515151;0.484848484848485
Control.SRR15539874;36;32;0.472222222222222;19;17;0.0277777777777778;0.472222222222222
Control.SRR15539874;35;32;0.542857142857143;16;19;0.0428571428571428;0.457142857142857
Control.SRR15539874;37;32;0.594594594594595;15;22;0.0945945945945946;0.405405405405405
Control.SRR15539874;33;32;0.454545454545455;18;15;0.0454545454545455;0.454545454545455
Control.SRR15539874;31;32;0.387096774193548;19;12;0.112903225806452;0.387096774193548
Control.SRR15539874;35;32;0.542857142857143;16;19;0.0428571428571428;0.457142857142857
Control.SRR15539874;35;32;0.514285714285714;17;18;0.0142857142857142;0.485714285714286
Control.SRR15539874;30;32;0.566666666666667;13;17;0.0666666666666667;0.433333333333333
Control.SRR15539874;34;32;0.558823529411765;15;19;0.0588235294117647;0.441176470588235
Control.SRR15539874;29;32;0.482758620689655;15;14;0.0172413793103448;0.482758620689655
Control.SRR15539874;29;32;0.517241379310345;14;15;0.0172413793103449;0.482758620689655
Control.SRR15539874;33;32;0.575757575757576;14;19;0.0757575757575758;0.424242424242424
Control.SRR15539874;33;32;0.515151515151515;16;17;0.0151515151515151;0.484848484848485
Control.SRR15539874;35;32;0.342857142857143;23;12;0.157142857142857;0.342857142857143
Control.SRR15539874;36;32;0.5;18;18;0;0.5
Control.SRR15539874;31;32;0.548387096774194;14;17;0.0483870967741935;0.451612903225806
Control.SRR15539874;35;32;0.457142857142857;19;16;0.0428571428571429;0.457142857142857
Control.SRR15539874;32;32;0.625;12;20;0.125;0.375
Control.SRR15539874;36;32;0.5;18;18;0;0.5
Control.SRR15539874;29;32;0.413793103448276;17;12;0.0862068965517241;0.413793103448276
Control.SRR15539874;30;32;0.566666666666667;13;17;0.0666666666666667;0.433333333333333
Control.SRR15539874;31;32;0.483870967741935;16;15;0.0161290322580645;0.483870967741935
Control.SRR15539874;33;32;0.484848484848485;17;16;0.0151515151515151;0.484848484848485
Control.SRR15539874;31;32;0.419354838709677;18;13;0.0806451612903226;0.419354838709677
Control.SRR15539874;35;32;0.4;21;14;0.1;0.4
Control.SRR15539874;35;32;0.6;14;21;0.1;0.4
Control.SRR15539874;31;32;0.483870967741935;16;15;0.0161290322580645;0.483870967741935
Control.SRR15539874;34;32;0.441176470588235;19;15;0.0588235294117647;0.441176470588235
Control.SRR15539874;31;32;0.483870967741935;16;15;0.0161290322580645;0.483870967741935
Control.SRR15539874;32;32;0.6875;10;22;0.1875;0.3125
Control.SRR15539874;37;32;0.486486486486487;19;18;0.0135135135135135;0.486486486486487
Control.SRR15539874;34;32;0.5;17;17;0;0.5
Control.SRR15539874;32;32;0.34375;21;11;0.15625;0.34375
Control.SRR15539874;32;32;0.5625;14;18;0.0625;0.4375
Control.SRR15539874;33;32;0.424242424242424;19;14;0.0757575757575757;0.424242424242424
Control.SRR15539874;32;32;0.40625;19;13;0.09375;0.40625
Control.SRR15539874;36;32;0.555555555555556;16;20;0.0555555555555556;0.444444444444444
Control.SRR15539874;35;32;0.485714285714286;18;17;0.0142857142857143;0.485714285714286
Control.SRR15539874;37;32;0.405405405405405;22;15;0.0945945945945946;0.405405405405405
Control.SRR15539874;31;32;0.354838709677419;20;11;0.145161290322581;0.354838709677419
Control.SRR15539874;33;32;0.333333333333333;22;11;0.166666666666667;0.333333333333333
Control.SRR15539874;30;32;0.5;15;15;0;0.5
Control.SRR15539874;31;32;0.548387096774194;14;17;0.0483870967741935;0.451612903225806
Control.SRR15539874;32;32;0.625;12;20;0.125;0.375
Control.SRR15539874;31;32;0.67741935483871;10;21;0.17741935483871;0.32258064516129
Control.SRR15539874;30;32;0.666666666666667;10;20;0.166666666666667;0.333333333333333
Control.SRR15539874;30;32;0.433333333333333;17;13;0.0666666666666667;0.433333333333333
Control.SRR15539874;32;32;0.46875;17;15;0.03125;0.46875
Control.SRR15539874;31;32;0.645161290322581;11;20;0.145161290322581;0.354838709677419
Control.SRR15539874;31;32;0.516129032258065;15;16;0.0161290322580645;0.483870967741935
Control.SRR15539874;31;32;0.709677419354839;9;22;0.209677419354839;0.290322580645161
Control.SRR15539874;36;32;0.472222222222222;19;17;0.0277777777777778;0.472222222222222
Control.SRR15539874;32;32;0.59375;13;19;0.09375;0.40625
Control.SRR15539874;29;32;0.620689655172414;11;18;0.120689655172414;0.379310344827586
Control.SRR15539874;37;32;0.486486486486487;19;18;0.0135135135135135;0.486486486486487
Control.SRR15539874;33;32;0.545454545454545;15;18;0.0454545454545454;0.454545454545455
Control.SRR15539874;30;32;0.5;15;15;0;0.5
Control.SRR15539874;33;32;0.545454545454545;15;18;0.0454545454545454;0.454545454545455
Control.SRR15539874;35;32;0.457142857142857;19;16;0.0428571428571429;0.457142857142857
Control.SRR15539874;37;32;0.432432432432432;21;16;0.0675675675675675;0.432432432432432
Control.SRR15539874;34;32;0.441176470588235;19;15;0.0588235294117647;0.441176470588235
Control.SRR15539874;34;32;0.588235294117647;14;20;0.0882352941176471;0.411764705882353
Control.SRR15539874;30;32;0.466666666666667;16;14;0.0333333333333333;0.466666666666667
Control.SRR15539874;33;32;0.454545454545455;18;15;0.0454545454545455;0.454545454545455
Control.SRR15539874;33;32;0.484848484848485;17;16;0.0151515151515151;0.484848484848485
Control.SRR15539874;36;32;0.722222222222222;10;26;0.222222222222222;0.277777777777778
Control.SRR15539874;29;32;0.551724137931034;13;16;0.0517241379310345;0.448275862068966
Control.SRR15539874;33;32;0.484848484848485;17;16;0.0151515151515151;0.484848484848485
Control.SRR15539874;30;32;0.5;15;15;0;0.5
Control.SRR15539874;30;32;0.5;15;15;0;0.5
Control.SRR15539874;30;32;0.433333333333333;17;13;0.0666666666666667;0.433333333333333
Control.SRR15539874;30;32;0.7;9;21;0.2;0.3
Control.SRR15539874;31;32;0.516129032258065;15;16;0.0161290322580645;0.483870967741935
Control.SRR15539874;30;32;0.4;18;12;0.1;0.4
Control.SRR15539874;36;32;0.444444444444444;20;16;0.0555555555555556;0.444444444444444
Control.SRR15539874;32;32;0.5;16;16;0;0.5
Control.SRR15539874;33;32;0.606060606060606;13;20;0.106060606060606;0.393939393939394
Control.SRR15539874;30;32;0.4;18;12;0.1;0.4
Control.SRR15539874;30;32;0.6;12;18;0.1;0.4
Control.SRR15539874;36;32;0.388888888888889;22;14;0.111111111111111;0.388888888888889
Control.SRR15539874;29;32;0.551724137931034;13;16;0.0517241379310345;0.448275862068966
Control.SRR15539874;30;32;0.533333333333333;14;16;0.0333333333333333;0.466666666666667
Control.SRR15539874;29;32;0.586206896551724;12;17;0.0862068965517241;0.413793103448276
Control.SRR15539874;36;32;0.5;18;18;0;0.5
Control.SRR15539874;36;32;0.527777777777778;17;19;0.0277777777777778;0.472222222222222
Control.SRR15539874;31;32;0.290322580645161;22;9;0.209677419354839;0.290322580645161
Control.SRR15539874;32;32;0.53125;15;17;0.03125;0.46875
Control.SRR15539874;33;32;0.575757575757576;14;19;0.0757575757575758;0.424242424242424
Control.SRR15539874;31;32;0.612903225806452;12;19;0.112903225806452;0.387096774193548
Control.SRR15539874;35;32;0.542857142857143;16;19;0.0428571428571428;0.457142857142857
Control.SRR15539874;31;32;0.548387096774194;14;17;0.0483870967741935;0.451612903225806
Control.SRR15539874;33;32;0.484848484848485;17;16;0.0151515151515151;0.484848484848485
Control.SRR15539874;36;32;0.611111111111111;14;22;0.111111111111111;0.388888888888889
Control.SRR15539874;30;32;0.5;15;15;0;0.5
Control.SRR15539874;34;32;0.529411764705882;16;18;0.0294117647058824;0.470588235294118
Control.SRR15539874;32;32;0.59375;13;19;0.09375;0.40625
Control.SRR15539874;33;32;0.606060606060606;13;20;0.106060606060606;0.393939393939394
Control.SRR15539874;37;32;0.621621621621622;14;23;0.121621621621622;0.378378378378378
Control.SRR15539874;34;32;0.470588235294118;18;16;0.0294117647058824;0.470588235294118
Control.SRR15539874;29;32;0.482758620689655;15;14;0.0172413793103448;0.482758620689655
Control.SRR15539874;31;32;0.354838709677419;20;11;0.145161290322581;0.354838709677419
Control.SRR15539874;35;32;0.542857142857143;16;19;0.0428571428571428;0.457142857142857
Control.SRR15539874;32;32;0.5625;14;18;0.0625;0.4375
Control.SRR15539874;31;32;0.580645161290323;13;18;0.0806451612903226;0.419354838709677
Control.SRR15539874;31;32;0.516129032258065;15;16;0.0161290322580645;0.483870967741935
Control.SRR15539874;31;32;0.548387096774194;14;17;0.0483870967741935;0.451612903225806
Control.SRR15539874;30;32;0.7;9;21;0.2;0.3
Control.SRR15539874;32;32;0.40625;19;13;0.09375;0.40625
Control.SRR15539874;30;32;0.566666666666667;13;17;0.0666666666666667;0.433333333333333
Control.SRR15539874;35;32;0.514285714285714;17;18;0.0142857142857142;0.485714285714286
Control.SRR15539874;37;32;0.459459459459459;20;17;0.0405405405405405;0.459459459459459
Control.SRR15539874;37;32;0.567567567567568;16;21;0.0675675675675675;0.432432432432432
Control.SRR15539874;33;32;0.424242424242424;19;14;0.0757575757575757;0.424242424242424
Control.SRR15539874;33;32;0.515151515151515;16;17;0.0151515151515151;0.484848484848485
Control.SRR15539874;33;32;0.393939393939394;20;13;0.106060606060606;0.393939393939394
Control.SRR15539874;33;32;0.575757575757576;14;19;0.0757575757575758;0.424242424242424
Control.SRR15539874;34;32;0.441176470588235;19;15;0.0588235294117647;0.441176470588235
Control.SRR15539874;30;32;0.566666666666667;13;17;0.0666666666666667;0.433333333333333
Control.SRR15539874;29;32;0.551724137931034;13;16;0.0517241379310345;0.448275862068966
Control.SRR15539874;34;32;0.441176470588235;19;15;0.0588235294117647;0.441176470588235
Control.SRR15539874;31;32;0.516129032258065;15;16;0.0161290322580645;0.483870967741935
Control.SRR15539874;30;32;0.533333333333333;14;16;0.0333333333333333;0.466666666666667
Control.SRR15539874;32;32;0.53125;15;17;0.03125;0.46875
Control.SRR15539874;36;32;0.583333333333333;15;21;0.0833333333333334;0.416666666666667
Control.SRR15539874;30;32;0.466666666666667;16;14;0.0333333333333333;0.466666666666667
Control.SRR15539874;36;32;0.361111111111111;23;13;0.138888888888889;0.361111111111111
Control.SRR15539874;31;32;0.548387096774194;14;17;0.0483870967741935;0.451612903225806
Control.SRR15539874;36;32;0.361111111111111;23;13;0.138888888888889;0.361111111111111
Control.SRR15539874;30;32;0.4;18;12;0.1;0.4
Control.SRR15539874;31;32;0.612903225806452;12;19;0.112903225806452;0.387096774193548
Control.SRR15539874;34;32;0.529411764705882;16;18;0.0294117647058824;0.470588235294118
Control.SRR15539874;37;32;0.513513513513513;18;19;0.0135135135135135;0.486486486486487
Control.SRR15539874;34;32;0.529411764705882;16;18;0.0294117647058824;0.470588235294118
Control.SRR15539874;36;32;0.5;18;18;0;0.5
Control.SRR15539874;34;32;0.647058823529412;12;22;0.147058823529412;0.352941176470588
Control.SRR15539874;32;32;0.59375;13;19;0.09375;0.40625
Control.SRR15539874;36;32;0.583333333333333;15;21;0.0833333333333334;0.416666666666667
Control.SRR15539874;34;32;0.647058823529412;12;22;0.147058823529412;0.352941176470588
Control.SRR15539874;30;32;0.6;12;18;0.1;0.4
Control.SRR15539874;34;32;0.382352941176471;21;13;0.117647058823529;0.382352941176471
Control.SRR15539874;33;32;0.454545454545455;18;15;0.0454545454545455;0.454545454545455
Control.SRR15539874;30;32;0.5;15;15;0;0.5
Control.SRR15539874;33;32;0.454545454545455;18;15;0.0454545454545455;0.454545454545455
Control.SRR15539874;32;32;0.53125;15;17;0.03125;0.46875
Control.SRR15539874;34;32;0.588235294117647;14;20;0.0882352941176471;0.411764705882353
Control.SRR15539874;30;32;0.566666666666667;13;17;0.0666666666666667;0.433333333333333
Control.SRR15539874;30;32;0.6;12;18;0.1;0.4
Control.SRR15539874;36;32;0.555555555555556;16;20;0.0555555555555556;0.444444444444444
Control.SRR15539874;33;32;0.454545454545455;18;15;0.0454545454545455;0.454545454545455
Control.SRR15539874;32;32;0.75;8;24;0.25;0.25
Control.SRR15539874;32;32;0.46875;17;15;0.03125;0.46875
Control.SRR15539874;35;32;0.628571428571429;13;22;0.128571428571429;0.371428571428571
Control.SRR15539874;35;32;0.514285714285714;17;18;0.0142857142857142;0.485714285714286
Control.SRR15539874;31;32;0.580645161290323;13;18;0.0806451612903226;0.419354838709677
Control.SRR15539874;34;32;0.529411764705882;16;18;0.0294117647058824;0.470588235294118
Control.SRR15539874;32;32;0.5625;14;18;0.0625;0.4375
Control.SRR15539874;35;32;0.485714285714286;18;17;0.0142857142857143;0.485714285714286
Control.SRR15539874;37;32;0.594594594594595;15;22;0.0945945945945946;0.405405405405405
Control.SRR15539874;35;32;0.485714285714286;18;17;0.0142857142857143;0.485714285714286
Control.SRR15539874;33;32;0.454545454545455;18;15;0.0454545454545455;0.454545454545455
Control.SRR15539874;29;32;0.655172413793103;10;19;0.155172413793103;0.344827586206897
Control.SRR15539874;32;32;0.46875;17;15;0.03125;0.46875
Control.SRR15539874;34;32;0.5;17;17;0;0.5
Control.SRR15539874;35;32;0.542857142857143;16;19;0.0428571428571428;0.457142857142857
Control.SRR15539874;36;32;0.611111111111111;14;22;0.111111111111111;0.388888888888889
Control.SRR15539874;32;32;0.59375;13;19;0.09375;0.40625
Control.SRR15539874;33;32;0.515151515151515;16;17;0.0151515151515151;0.484848484848485
Control.SRR15539874;31;32;0.483870967741935;16;15;0.0161290322580645;0.483870967741935
Control.SRR15539874;37;32;0.459459459459459;20;17;0.0405405405405405;0.459459459459459
Control.SRR15539874;37;32;0.324324324324324;25;12;0.175675675675676;0.324324324324324
Control.SRR15539874;30;32;0.4;18;12;0.1;0.4
Control.SRR15539874;36;32;0.611111111111111;14;22;0.111111111111111;0.388888888888889
Control.SRR15539874;30;32;0.366666666666667;19;11;0.133333333333333;0.366666666666667
Control.SRR15539874;36;32;0.5;18;18;0;0.5
Control.SRR15539874;34;32;0.558823529411765;15;19;0.0588235294117647;0.441176470588235
Control.SRR15539874;33;32;0.545454545454545;15;18;0.0454545454545454;0.454545454545455
Control.SRR15539874;36;32;0.527777777777778;17;19;0.0277777777777778;0.472222222222222
Control.SRR15539874;36;32;0.583333333333333;15;21;0.0833333333333334;0.416666666666667
Control.SRR15539874;34;32;0.558823529411765;15;19;0.0588235294117647;0.441176470588235
Control.SRR15539874;29;32;0.344827586206897;19;10;0.155172413793103;0.344827586206897
Control.SRR15539874;36;32;0.5;18;18;0;0.5
Control.SRR15539874;36;32;0.527777777777778;17;19;0.0277777777777778;0.472222222222222
Control.SRR15539874;36;32;0.444444444444444;20;16;0.0555555555555556;0.444444444444444
Control.SRR15539874;34;32;0.529411764705882;16;18;0.0294117647058824;0.470588235294118
Control.SRR15539874;29;32;0.655172413793103;10;19;0.155172413793103;0.344827586206897
Control.SRR15539874;37;32;0.648648648648649;13;24;0.148648648648649;0.351351351351351
Control.SRR15539874;37;32;0.432432432432432;21;16;0.0675675675675675;0.432432432432432
Control.SRR15539874;34;32;0.470588235294118;18;16;0.0294117647058824;0.470588235294118
Control.SRR15539874;37;32;0.459459459459459;20;17;0.0405405405405405;0.459459459459459
Control.SRR15539874;35;32;0.542857142857143;16;19;0.0428571428571428;0.457142857142857
Control.SRR15539874;31;32;0.516129032258065;15;16;0.0161290322580645;0.483870967741935
Control.SRR15539874;35;32;0.371428571428571;22;13;0.128571428571429;0.371428571428571
Control.SRR15539874;36;32;0.527777777777778;17;19;0.0277777777777778;0.472222222222222
Control.SRR15539874;32;32;0.34375;21;11;0.15625;0.34375
Control.SRR15539874;34;32;0.5;17;17;0;0.5
Control.SRR15539874;36;32;0.472222222222222;19;17;0.0277777777777778;0.472222222222222
Control.SRR15539874;30;32;0.433333333333333;17;13;0.0666666666666667;0.433333333333333
Control.SRR15539874;31;32;0.258064516129032;23;8;0.241935483870968;0.258064516129032
Control.SRR15539874;32;32;0.46875;17;15;0.03125;0.46875
Control.SRR15539874;29;32;0.413793103448276;17;12;0.0862068965517241;0.413793103448276
Control.SRR15539874;34;32;0.529411764705882;16;18;0.0294117647058824;0.470588235294118
Control.SRR15539874;33;32;0.393939393939394;20;13;0.106060606060606;0.393939393939394
Control.SRR15539874;30;32;0.3;21;9;0.2;0.3
Control.SRR15539874;34;32;0.441176470588235;19;15;0.0588235294117647;0.441176470588235
Control.SRR15539874;29;32;0.482758620689655;15;14;0.0172413793103448;0.482758620689655
Control.SRR15539874;36;32;0.361111111111111;23;13;0.138888888888889;0.361111111111111
Control.SRR15539874;31;32;0.548387096774194;14;17;0.0483870967741935;0.451612903225806
Control.SRR15539874;33;32;0.545454545454545;15;18;0.0454545454545454;0.454545454545455
Control.SRR15539874;36;32;0.444444444444444;20;16;0.0555555555555556;0.444444444444444
Control.SRR15539874;32;32;0.375;20;12;0.125;0.375
Control.SRR15539874;35;32;0.457142857142857;19;16;0.0428571428571429;0.457142857142857
Control.SRR15539874;35;32;0.485714285714286;18;17;0.0142857142857143;0.485714285714286
Control.SRR15539874;35;32;0.485714285714286;18;17;0.0142857142857143;0.485714285714286
Control.SRR15539874;37;32;0.540540540540541;17;20;0.0405405405405406;0.459459459459459
Control.SRR15539874;29;32;0.689655172413793;9;20;0.189655172413793;0.310344827586207
Control.SRR15539874;29;32;0.586206896551724;12;17;0.0862068965517241;0.413793103448276
Control.SRR15539874;29;32;0.448275862068966;16;13;0.0517241379310345;0.448275862068966
Control.SRR15539874;36;32;0.5;18;18;0;0.5
Control.SRR15539874;36;32;0.472222222222222;19;17;0.0277777777777778;0.472222222222222
Control.SRR15539874;31;32;0.419354838709677;18;13;0.0806451612903226;0.419354838709677
Control.SRR15539874;34;32;0.441176470588235;19;15;0.0588235294117647;0.441176470588235
Control.SRR15539874;31;32;0.548387096774194;14;17;0.0483870967741935;0.451612903225806
Control.SRR15539874;36;32;0.583333333333333;15;21;0.0833333333333334;0.416666666666667
Control.SRR15539874;35;32;0.571428571428571;15;20;0.0714285714285714;0.428571428571429
Control.SRR15539874;37;32;0.486486486486487;19;18;0.0135135135135135;0.486486486486487
Control.SRR15539874;34;32;0.470588235294118;18;16;0.0294117647058824;0.470588235294118
Control.SRR15539874;31;32;0.483870967741935;16;15;0.0161290322580645;0.483870967741935
Control.SRR15539874;29;32;0.551724137931034;13;16;0.0517241379310345;0.448275862068966
Control.SRR15539874;31;32;0.451612903225806;17;14;0.0483870967741936;0.451612903225806
Control.SRR15539874;33;32;0.454545454545455;18;15;0.0454545454545455;0.454545454545455
Control.SRR15539874;31;32;0.516129032258065;15;16;0.0161290322580645;0.483870967741935
Control.SRR15539874;32;32;0.59375;13;19;0.09375;0.40625
Control.SRR15539874;33;32;0.575757575757576;14;19;0.0757575757575758;0.424242424242424
Control.SRR15539874;34;32;0.558823529411765;15;19;0.0588235294117647;0.441176470588235
Control.SRR15539874;35;32;0.457142857142857;19;16;0.0428571428571429;0.457142857142857
Control.SRR15539874;35;32;0.571428571428571;15;20;0.0714285714285714;0.428571428571429
Control.SRR15539874;35;32;0.485714285714286;18;17;0.0142857142857143;0.485714285714286
Control.SRR15539874;35;32;0.6;14;21;0.1;0.4
Control.SRR15539874;32;32;0.5625;14;18;0.0625;0.4375
Control.SRR15539874;29;32;0.482758620689655;15;14;0.0172413793103448;0.482758620689655
Control.SRR15539874;34;32;0.323529411764706;23;11;0.176470588235294;0.323529411764706
Control.SRR15539874;30;32;0.433333333333333;17;13;0.0666666666666667;0.433333333333333
Control.SRR15539874;32;32;0.4375;18;14;0.0625;0.4375
Control.SRR15539874;31;32;0.451612903225806;17;14;0.0483870967741936;0.451612903225806
Control.SRR15539874;31;32;0.516129032258065;15;16;0.0161290322580645;0.483870967741935
Control.SRR15539874;30;32;0.433333333333333;17;13;0.0666666666666667;0.433333333333333
Control.SRR15539874;34;32;0.382352941176471;21;13;0.117647058823529;0.382352941176471
Control.SRR15539874;36;32;0.5;18;18;0;0.5
Control.SRR15539874;34;32;0.411764705882353;20;14;0.0882352941176471;0.411764705882353
Control.SRR15539874;31;32;0.451612903225806;17;14;0.0483870967741936;0.451612903225806
Control.SRR15539874;37;32;0.459459459459459;20;17;0.0405405405405405;0.459459459459459
Control.SRR15539874;34;32;0.411764705882353;20;14;0.0882352941176471;0.411764705882353
Control.SRR15539874;35;32;0.514285714285714;17;18;0.0142857142857142;0.485714285714286
Control.SRR15539874;35;32;0.514285714285714;17;18;0.0142857142857142;0.485714285714286
Control.SRR15539874;34;32;0.382352941176471;21;13;0.117647058823529;0.382352941176471
Control.SRR15539874;33;32;0.606060606060606;13;20;0.106060606060606;0.393939393939394
Control.SRR15539874;33;32;0.484848484848485;17;16;0.0151515151515151;0.484848484848485
Control.SRR15539874;35;32;0.6;14;21;0.1;0.4
Control.SRR15539874;34;32;0.588235294117647;14;20;0.0882352941176471;0.411764705882353
Control.SRR15539874;31;32;0.516129032258065;15;16;0.0161290322580645;0.483870967741935
Control.SRR15539874;33;32;0.515151515151515;16;17;0.0151515151515151;0.484848484848485
Control.SRR15539874;30;32;0.566666666666667;13;17;0.0666666666666667;0.433333333333333
Control.SRR15539874;32;32;0.53125;15;17;0.03125;0.46875
Control.SRR15539874;37;32;0.567567567567568;16;21;0.0675675675675675;0.432432432432432
Control.SRR15539874;29;32;0.586206896551724;12;17;0.0862068965517241;0.413793103448276
Control.SRR15539874;34;32;0.617647058823529;13;21;0.117647058823529;0.382352941176471
Control.SRR15539874;35;32;0.371428571428571;22;13;0.128571428571429;0.371428571428571
Control.SRR15539874;34;32;0.352941176470588;22;12;0.147058823529412;0.352941176470588
Control.SRR15539874;36;32;0.416666666666667;21;15;0.0833333333333333;0.416666666666667
Control.SRR15539874;35;32;0.514285714285714;17;18;0.0142857142857142;0.485714285714286
Control.SRR15539874;36;32;0.472222222222222;19;17;0.0277777777777778;0.472222222222222
Control.SRR15539874;36;32;0.527777777777778;17;19;0.0277777777777778;0.472222222222222
Control.SRR15539874;30;32;0.566666666666667;13;17;0.0666666666666667;0.433333333333333
Control.SRR15539874;33;32;0.454545454545455;18;15;0.0454545454545455;0.454545454545455
Control.SRR15539874;31;32;0.548387096774194;14;17;0.0483870967741935;0.451612903225806
Control.SRR15539874;31;32;0.645161290322581;11;20;0.145161290322581;0.354838709677419
Control.SRR15539874;29;32;0.379310344827586;18;11;0.120689655172414;0.379310344827586
Control.SRR15539874;35;32;0.542857142857143;16;19;0.0428571428571428;0.457142857142857
Control.SRR15539874;33;32;0.545454545454545;15;18;0.0454545454545454;0.454545454545455
Control.SRR15539874;30;32;0.566666666666667;13;17;0.0666666666666667;0.433333333333333
Control.SRR15539874;34;32;0.382352941176471;21;13;0.117647058823529;0.382352941176471
Control.SRR15539874;31;32;0.548387096774194;14;17;0.0483870967741935;0.451612903225806
Control.SRR15539874;37;32;0.513513513513513;18;19;0.0135135135135135;0.486486486486487
Control.SRR15539874;34;32;0.5;17;17;0;0.5
Control.SRR15539874;30;32;0.4;18;12;0.1;0.4
Control.SRR15539874;32;32;0.4375;18;14;0.0625;0.4375
Control.SRR15539874;32;32;0.40625;19;13;0.09375;0.40625
Control.SRR15539874;34;32;0.588235294117647;14;20;0.0882352941176471;0.411764705882353
Control.SRR15539874;37;32;0.540540540540541;17;20;0.0405405405405406;0.459459459459459
Control.SRR15539874;37;32;0.513513513513513;18;19;0.0135135135135135;0.486486486486487
Control.SRR15539874;35;32;0.428571428571429;20;15;0.0714285714285715;0.428571428571429
Control.SRR15539874;29;32;0.482758620689655;15;14;0.0172413793103448;0.482758620689655
Control.SRR15539874;32;32;0.4375;18;14;0.0625;0.4375
Control.SRR15539874;35;32;0.6;14;21;0.1;0.4
Control.SRR15539874;36;32;0.611111111111111;14;22;0.111111111111111;0.388888888888889
Control.SRR15539874;35;32;0.314285714285714;24;11;0.185714285714286;0.314285714285714
Control.SRR15539874;30;32;0.633333333333333;11;19;0.133333333333333;0.366666666666667
Control.SRR15539874;37;32;0.594594594594595;15;22;0.0945945945945946;0.405405405405405
Control.SRR15539874;30;32;0.566666666666667;13;17;0.0666666666666667;0.433333333333333
Control.SRR15539874;35;32;0.457142857142857;19;16;0.0428571428571429;0.457142857142857
Control.SRR15539874;37;32;0.513513513513513;18;19;0.0135135135135135;0.486486486486487
Control.SRR15539874;34;32;0.558823529411765;15;19;0.0588235294117647;0.441176470588235
Control.SRR15539874;31;32;0.580645161290323;13;18;0.0806451612903226;0.419354838709677
Control.SRR15539874;34;32;0.441176470588235;19;15;0.0588235294117647;0.441176470588235
Control.SRR15539874;29;32;0.482758620689655;15;14;0.0172413793103448;0.482758620689655
Control.SRR15539874;35;32;0.485714285714286;18;17;0.0142857142857143;0.485714285714286
Control.SRR15539874;33;32;0.606060606060606;13;20;0.106060606060606;0.393939393939394
Control.SRR15539874;37;32;0.621621621621622;14;23;0.121621621621622;0.378378378378378
Control.SRR15539874;36;32;0.416666666666667;21;15;0.0833333333333333;0.416666666666667
Control.SRR15539874;33;32;0.575757575757576;14;19;0.0757575757575758;0.424242424242424
Control.SRR15539874;35;32;0.485714285714286;18;17;0.0142857142857143;0.485714285714286
Control.SRR15539874;35;32;0.542857142857143;16;19;0.0428571428571428;0.457142857142857
Control.SRR15539874;36;32;0.416666666666667;21;15;0.0833333333333333;0.416666666666667
Control.SRR15539874;37;32;0.594594594594595;15;22;0.0945945945945946;0.405405405405405
Control.SRR15539874;30;32;0.633333333333333;11;19;0.133333333333333;0.366666666666667
Control.SRR15539874;33;32;0.515151515151515;16;17;0.0151515151515151;0.484848484848485
Control.SRR15539874;31;32;0.451612903225806;17;14;0.0483870967741936;0.451612903225806
Control.SRR15539874;37;32;0.567567567567568;16;21;0.0675675675675675;0.432432432432432
Control.SRR15539874;37;32;0.702702702702703;11;26;0.202702702702703;0.297297297297297
Control.SRR15539874;36;32;0.527777777777778;17;19;0.0277777777777778;0.472222222222222
Control.SRR15539874;34;32;0.441176470588235;19;15;0.0588235294117647;0.441176470588235
Control.SRR15539874;35;32;0.6;14;21;0.1;0.4
Control.SRR15539874;36;32;0.638888888888889;13;23;0.138888888888889;0.361111111111111
Control.SRR15539874;33;32;0.515151515151515;16;17;0.0151515151515151;0.484848484848485
Control.SRR15539874;33;32;0.515151515151515;16;17;0.0151515151515151;0.484848484848485
Control.SRR15539874;30;32;0.566666666666667;13;17;0.0666666666666667;0.433333333333333
Control.SRR15539874;35;32;0.628571428571429;13;22;0.128571428571429;0.371428571428571
Control.SRR15539874;35;32;0.485714285714286;18;17;0.0142857142857143;0.485714285714286
Control.SRR15539874;29;32;0.448275862068966;16;13;0.0517241379310345;0.448275862068966
Control.SRR15539874;33;32;0.393939393939394;20;13;0.106060606060606;0.393939393939394
Control.SRR15539874;36;32;0.361111111111111;23;13;0.138888888888889;0.361111111111111
Control.SRR15539874;29;32;0.413793103448276;17;12;0.0862068965517241;0.413793103448276
Control.SRR15539874;34;32;0.5;17;17;0;0.5
Control.SRR15539874;31;32;0.387096774193548;19;12;0.112903225806452;0.387096774193548
Control.SRR15539874;32;32;0.5;16;16;0;0.5
Control.SRR15539874;35;32;0.4;21;14;0.1;0.4
Control.SRR15539874;36;32;0.5;18;18;0;0.5
Control.SRR15539874;33;32;0.636363636363636;12;21;0.136363636363636;0.363636363636364
Control.SRR15539874;31;32;0.451612903225806;17;14;0.0483870967741936;0.451612903225806
Control.SRR15539874;35;32;0.457142857142857;19;16;0.0428571428571429;0.457142857142857
Control.SRR15539874;36;32;0.555555555555556;16;20;0.0555555555555556;0.444444444444444
Control.SRR15539874;34;32;0.470588235294118;18;16;0.0294117647058824;0.470588235294118
Control.SRR15539874;34;32;0.558823529411765;15;19;0.0588235294117647;0.441176470588235
Control.SRR15539874;30;32;0.633333333333333;11;19;0.133333333333333;0.366666666666667
Control.SRR15539874;31;32;0.451612903225806;17;14;0.0483870967741936;0.451612903225806
Control.SRR15539874;30;32;0.6;12;18;0.1;0.4
Control.SRR15539874;37;32;0.540540540540541;17;20;0.0405405405405406;0.459459459459459
Control.SRR15539874;37;32;0.486486486486487;19;18;0.0135135135135135;0.486486486486487
Control.SRR15539874;37;32;0.432432432432432;21;16;0.0675675675675675;0.432432432432432
Control.SRR15539874;34;32;0.5;17;17;0;0.5
Control.SRR15539874;29;32;0.517241379310345;14;15;0.0172413793103449;0.482758620689655
Control.SRR15539874;31;32;0.483870967741935;16;15;0.0161290322580645;0.483870967741935
Control.SRR15539874;32;32;0.40625;19;13;0.09375;0.40625
Control.SRR15539874;30;32;0.466666666666667;16;14;0.0333333333333333;0.466666666666667
Control.SRR15539874;30;32;0.633333333333333;11;19;0.133333333333333;0.366666666666667
Control.SRR15539874;37;32;0.567567567567568;16;21;0.0675675675675675;0.432432432432432
Control.SRR15539874;36;32;0.333333333333333;24;12;0.166666666666667;0.333333333333333
Control.SRR15539874;35;32;0.514285714285714;17;18;0.0142857142857142;0.485714285714286
Control.SRR15539874;34;32;0.323529411764706;23;11;0.176470588235294;0.323529411764706
Control.SRR15539874;34;32;0.470588235294118;18;16;0.0294117647058824;0.470588235294118
Control.SRR15539874;36;32;0.416666666666667;21;15;0.0833333333333333;0.416666666666667
Control.SRR15539874;36;32;0.666666666666667;12;24;0.166666666666667;0.333333333333333
Control.SRR15539874;34;32;0.676470588235294;11;23;0.176470588235294;0.323529411764706
Control.SRR15539874;36;32;0.527777777777778;17;19;0.0277777777777778;0.472222222222222
Control.SRR15539874;32;32;0.28125;23;9;0.21875;0.28125
Control.SRR15539874;36;32;0.416666666666667;21;15;0.0833333333333333;0.416666666666667
Control.SRR15539874;37;32;0.513513513513513;18;19;0.0135135135135135;0.486486486486487
Control.SRR15539874;33;32;0.515151515151515;16;17;0.0151515151515151;0.484848484848485
Control.SRR15539874;33;32;0.484848484848485;17;16;0.0151515151515151;0.484848484848485
Control.SRR15539874;33;32;0.484848484848485;17;16;0.0151515151515151;0.484848484848485
Control.SRR15539874;37;32;0.513513513513513;18;19;0.0135135135135135;0.486486486486487
Control.SRR15539874;37;32;0.486486486486487;19;18;0.0135135135135135;0.486486486486487
Control.SRR15539874;36;32;0.527777777777778;17;19;0.0277777777777778;0.472222222222222
Control.SRR15539874;35;32;0.628571428571429;13;22;0.128571428571429;0.371428571428571
Control.SRR15539874;35;32;0.542857142857143;16;19;0.0428571428571428;0.457142857142857
Control.SRR15539874;32;32;0.25;24;8;0.25;0.25
Control.SRR15539874;36;32;0.5;18;18;0;0.5
Control.SRR15539874;35;32;0.457142857142857;19;16;0.0428571428571429;0.457142857142857
Control.SRR15539874;35;32;0.485714285714286;18;17;0.0142857142857143;0.485714285714286
Control.SRR15539874;34;32;0.5;17;17;0;0.5
Control.SRR15539874;30;32;0.433333333333333;17;13;0.0666666666666667;0.433333333333333
Control.SRR15539874;32;32;0.34375;21;11;0.15625;0.34375
Control.SRR15539874;31;32;0.516129032258065;15;16;0.0161290322580645;0.483870967741935
Control.SRR15539874;34;32;0.558823529411765;15;19;0.0588235294117647;0.441176470588235
Control.SRR15539874;34;32;0.588235294117647;14;20;0.0882352941176471;0.411764705882353
Control.SRR15539874;31;32;0.419354838709677;18;13;0.0806451612903226;0.419354838709677
Control.SRR15539874;31;32;0.645161290322581;11;20;0.145161290322581;0.354838709677419
Control.SRR15539874;34;32;0.558823529411765;15;19;0.0588235294117647;0.441176470588235
Control.SRR15539874;35;32;0.514285714285714;17;18;0.0142857142857142;0.485714285714286
Control.SRR15539874;37;32;0.540540540540541;17;20;0.0405405405405406;0.459459459459459
Control.SRR15539874;36;32;0.388888888888889;22;14;0.111111111111111;0.388888888888889
Control.SRR15539874;35;32;0.4;21;14;0.1;0.4
Control.SRR15539874;33;32;0.242424242424242;25;8;0.257575757575758;0.242424242424242
Control.SRR15539874;34;32;0.411764705882353;20;14;0.0882352941176471;0.411764705882353
Control.SRR15539874;37;32;0.351351351351351;24;13;0.148648648648649;0.351351351351351
Control.SRR15539874;32;32;0.4375;18;14;0.0625;0.4375
Control.SRR15539874;33;32;0.515151515151515;16;17;0.0151515151515151;0.484848484848485
Control.SRR15539874;33;32;0.363636363636364;21;12;0.136363636363636;0.363636363636364
Control.SRR15539874;32;32;0.34375;21;11;0.15625;0.34375
Control.SRR15539874;33;32;0.424242424242424;19;14;0.0757575757575757;0.424242424242424
Control.SRR15539874;32;32;0.59375;13;19;0.09375;0.40625
Control.SRR15539874;31;32;0.548387096774194;14;17;0.0483870967741935;0.451612903225806
Control.SRR15539874;35;32;0.571428571428571;15;20;0.0714285714285714;0.428571428571429
Control.SRR15539874;37;32;0.486486486486487;19;18;0.0135135135135135;0.486486486486487
Control.SRR15539874;36;32;0.333333333333333;24;12;0.166666666666667;0.333333333333333
Control.SRR15539874;30;32;0.466666666666667;16;14;0.0333333333333333;0.466666666666667
Control.SRR15539874;33;32;0.515151515151515;16;17;0.0151515151515151;0.484848484848485
Control.SRR15539874;37;32;0.648648648648649;13;24;0.148648648648649;0.351351351351351
Control.SRR15539874;37;32;0.567567567567568;16;21;0.0675675675675675;0.432432432432432
Control.SRR15539874;30;32;0.466666666666667;16;14;0.0333333333333333;0.466666666666667
Control.SRR15539874;37;32;0.486486486486487;19;18;0.0135135135135135;0.486486486486487
Control.SRR15539874;35;32;0.628571428571429;13;22;0.128571428571429;0.371428571428571
Control.SRR15539874;34;32;0.470588235294118;18;16;0.0294117647058824;0.470588235294118
Control.SRR15539874;33;32;0.484848484848485;17;16;0.0151515151515151;0.484848484848485
Control.SRR15539874;37;32;0.513513513513513;18;19;0.0135135135135135;0.486486486486487
Control.SRR15539874;33;32;0.454545454545455;18;15;0.0454545454545455;0.454545454545455
Control.SRR15539874;33;32;0.606060606060606;13;20;0.106060606060606;0.393939393939394
Control.SRR15539874;36;32;0.555555555555556;16;20;0.0555555555555556;0.444444444444444
Control.SRR15539874;30;32;0.433333333333333;17;13;0.0666666666666667;0.433333333333333
Control.SRR15539874;33;32;0.515151515151515;16;17;0.0151515151515151;0.484848484848485
Control.SRR15539874;31;32;0.580645161290323;13;18;0.0806451612903226;0.419354838709677
Control.SRR15539874;32;32;0.375;20;12;0.125;0.375
Control.SRR15539874;34;32;0.558823529411765;15;19;0.0588235294117647;0.441176470588235
Control.SRR15539874;36;32;0.555555555555556;16;20;0.0555555555555556;0.444444444444444
Control.SRR15539874;35;32;0.4;21;14;0.1;0.4
Control.SRR15539874;37;32;0.540540540540541;17;20;0.0405405405405406;0.459459459459459
Control.SRR15539874;31;32;0.580645161290323;13;18;0.0806451612903226;0.419354838709677
Control.SRR15539874;36;32;0.527777777777778;17;19;0.0277777777777778;0.472222222222222
Control.SRR15539874;32;32;0.4375;18;14;0.0625;0.4375
Control.SRR15539874;35;32;0.571428571428571;15;20;0.0714285714285714;0.428571428571429
Control.SRR15539874;29;32;0.482758620689655;15;14;0.0172413793103448;0.482758620689655
Control.SRR15539874;37;32;0.756756756756757;9;28;0.256756756756757;0.243243243243243
Control.SRR15539874;29;32;0.448275862068966;16;13;0.0517241379310345;0.448275862068966
Control.SRR15539874;30;32;0.566666666666667;13;17;0.0666666666666667;0.433333333333333
Control.SRR15539874;36;32;0.611111111111111;14;22;0.111111111111111;0.388888888888889
Control.SRR15539874;34;32;0.411764705882353;20;14;0.0882352941176471;0.411764705882353
Control.SRR15539874;34;32;0.558823529411765;15;19;0.0588235294117647;0.441176470588235
Control.SRR15539874;37;32;0.513513513513513;18;19;0.0135135135135135;0.486486486486487
Control.SRR15539874;30;32;0.5;15;15;0;0.5
Control.SRR15539874;30;32;0.5;15;15;0;0.5
Control.SRR15539874;31;32;0.354838709677419;20;11;0.145161290322581;0.354838709677419
Control.SRR15539874;29;32;0.482758620689655;15;14;0.0172413793103448;0.482758620689655
Control.SRR15539874;33;32;0.666666666666667;11;22;0.166666666666667;0.333333333333333
Control.SRR15539874;32;32;0.34375;21;11;0.15625;0.34375
Control.SRR15539874;34;32;0.470588235294118;18;16;0.0294117647058824;0.470588235294118
Control.SRR15539874;31;32;0.548387096774194;14;17;0.0483870967741935;0.451612903225806
Control.SRR15539874;30;32;0.6;12;18;0.1;0.4
Control.SRR15539874;34;32;0.411764705882353;20;14;0.0882352941176471;0.411764705882353
Control.SRR15539874;35;32;0.542857142857143;16;19;0.0428571428571428;0.457142857142857
Control.SRR15539874;33;32;0.545454545454545;15;18;0.0454545454545454;0.454545454545455
Control.SRR15539874;36;32;0.5;18;18;0;0.5
Control.SRR15539874;34;32;0.441176470588235;19;15;0.0588235294117647;0.441176470588235
Control.SRR15539874;37;32;0.378378378378378;23;14;0.121621621621622;0.378378378378378
Control.SRR15539874;33;32;0.575757575757576;14;19;0.0757575757575758;0.424242424242424
Control.SRR15539874;34;32;0.617647058823529;13;21;0.117647058823529;0.382352941176471
Control.SRR15539874;32;32;0.375;20;12;0.125;0.375
Control.SRR15539874;34;32;0.352941176470588;22;12;0.147058823529412;0.352941176470588
Control.SRR15539874;33;32;0.575757575757576;14;19;0.0757575757575758;0.424242424242424
Control.SRR15539874;33;32;0.393939393939394;20;13;0.106060606060606;0.393939393939394
Control.SRR15539874;35;32;0.542857142857143;16;19;0.0428571428571428;0.457142857142857
Control.SRR15539874;34;32;0.470588235294118;18;16;0.0294117647058824;0.470588235294118
Control.SRR15539874;31;32;0.419354838709677;18;13;0.0806451612903226;0.419354838709677
Control.SRR15539874;35;32;0.6;14;21;0.1;0.4
Control.SRR15539874;31;32;0.451612903225806;17;14;0.0483870967741936;0.451612903225806
Control.SRR15539874;32;32;0.53125;15;17;0.03125;0.46875
Control.SRR15539874;31;32;0.645161290322581;11;20;0.145161290322581;0.354838709677419
Control.SRR15539874;34;32;0.5;17;17;0;0.5
Control.SRR15539874;32;32;0.5;16;16;0;0.5
Control.SRR15539874;35;32;0.485714285714286;18;17;0.0142857142857143;0.485714285714286
Control.SRR15539874;36;32;0.472222222222222;19;17;0.0277777777777778;0.472222222222222
Control.SRR15539874;36;32;0.416666666666667;21;15;0.0833333333333333;0.416666666666667
Control.SRR15539874;37;32;0.486486486486487;19;18;0.0135135135135135;0.486486486486487
Control.SRR15539874;35;32;0.371428571428571;22;13;0.128571428571429;0.371428571428571
Control.SRR15539874;30;32;0.6;12;18;0.1;0.4
Control.SRR15539874;31;32;0.612903225806452;12;19;0.112903225806452;0.387096774193548
Control.SRR15539874;30;32;0.5;15;15;0;0.5
Control.SRR15539874;37;32;0.432432432432432;21;16;0.0675675675675675;0.432432432432432
Control.SRR15539874;31;32;0.483870967741935;16;15;0.0161290322580645;0.483870967741935
Control.SRR15539874;30;32;0.533333333333333;14;16;0.0333333333333333;0.466666666666667
Control.SRR15539874;34;32;0.558823529411765;15;19;0.0588235294117647;0.441176470588235
Control.SRR15539874;33;32;0.636363636363636;12;21;0.136363636363636;0.363636363636364
Control.SRR15539874;35;32;0.628571428571429;13;22;0.128571428571429;0.371428571428571
Control.SRR15539874;35;32;0.6;14;21;0.1;0.4
Control.SRR15539874;34;32;0.382352941176471;21;13;0.117647058823529;0.382352941176471
Control.SRR15539874;32;32;0.40625;19;13;0.09375;0.40625
Control.SRR15539874;36;32;0.5;18;18;0;0.5
Control.SRR15539874;31;32;0.612903225806452;12;19;0.112903225806452;0.387096774193548
Control.SRR15539874;37;32;0.513513513513513;18;19;0.0135135135135135;0.486486486486487
Control.SRR15539874;29;32;0.379310344827586;18;11;0.120689655172414;0.379310344827586
Control.SRR15539874;36;32;0.694444444444444;11;25;0.194444444444444;0.305555555555556
Control.SRR15539874;33;32;0.515151515151515;16;17;0.0151515151515151;0.484848484848485
Control.SRR15539874;36;32;0.5;18;18;0;0.5
Control.SRR15539874;35;32;0.485714285714286;18;17;0.0142857142857143;0.485714285714286
Control.SRR15539874;30;32;0.533333333333333;14;16;0.0333333333333333;0.466666666666667
Control.SRR15539874;30;32;0.333333333333333;20;10;0.166666666666667;0.333333333333333
Control.SRR15539874;31;32;0.516129032258065;15;16;0.0161290322580645;0.483870967741935
Control.SRR15539874;31;32;0.419354838709677;18;13;0.0806451612903226;0.419354838709677
Control.SRR15539874;32;32;0.53125;15;17;0.03125;0.46875
Control.SRR15539874;31;32;0.483870967741935;16;15;0.0161290322580645;0.483870967741935
Control.SRR15539874;35;32;0.457142857142857;19;16;0.0428571428571429;0.457142857142857
Control.SRR15539874;36;32;0.583333333333333;15;21;0.0833333333333334;0.416666666666667
Control.SRR15539874;35;32;0.6;14;21;0.1;0.4
Control.SRR15539874;34;32;0.529411764705882;16;18;0.0294117647058824;0.470588235294118
Control.SRR15539874;37;32;0.486486486486487;19;18;0.0135135135135135;0.486486486486487
Control.SRR15539874;32;32;0.46875;17;15;0.03125;0.46875
Control.SRR15539874;37;32;0.540540540540541;17;20;0.0405405405405406;0.459459459459459
Control.SRR15539874;36;32;0.611111111111111;14;22;0.111111111111111;0.388888888888889
Control.SRR15539874;31;32;0.612903225806452;12;19;0.112903225806452;0.387096774193548
Control.SRR15539874;31;32;0.387096774193548;19;12;0.112903225806452;0.387096774193548
Control.SRR15539874;35;32;0.457142857142857;19;16;0.0428571428571429;0.457142857142857
Control.SRR15539874;30;32;0.6;12;18;0.1;0.4
Control.SRR15539874;32;32;0.65625;11;21;0.15625;0.34375
Control.SRR15539874;34;32;0.529411764705882;16;18;0.0294117647058824;0.470588235294118
Control.SRR15539874;35;32;0.485714285714286;18;17;0.0142857142857143;0.485714285714286
Control.SRR15539874;31;32;0.580645161290323;13;18;0.0806451612903226;0.419354838709677
Control.SRR15539874;36;32;0.444444444444444;20;16;0.0555555555555556;0.444444444444444
Control.SRR15539874;33;32;0.454545454545455;18;15;0.0454545454545455;0.454545454545455
Control.SRR15539874;32;32;0.4375;18;14;0.0625;0.4375
Control.SRR15539874;35;32;0.457142857142857;19;16;0.0428571428571429;0.457142857142857
Control.SRR15539874;34;32;0.617647058823529;13;21;0.117647058823529;0.382352941176471
Control.SRR15539874;36;32;0.722222222222222;10;26;0.222222222222222;0.277777777777778
Control.SRR15539874;34;32;0.441176470588235;19;15;0.0588235294117647;0.441176470588235
Control.SRR15539874;33;32;0.515151515151515;16;17;0.0151515151515151;0.484848484848485
Control.SRR15539874;31;32;0.645161290322581;11;20;0.145161290322581;0.354838709677419
Control.SRR15539874;36;32;0.555555555555556;16;20;0.0555555555555556;0.444444444444444
Control.SRR15539874;37;32;0.540540540540541;17;20;0.0405405405405406;0.459459459459459
Control.SRR15539874;29;32;0.586206896551724;12;17;0.0862068965517241;0.413793103448276
Control.SRR15539874;35;32;0.4;21;14;0.1;0.4
Control.SRR15539874;35;32;0.657142857142857;12;23;0.157142857142857;0.342857142857143
Control.SRR15539874;36;32;0.472222222222222;19;17;0.0277777777777778;0.472222222222222
Control.SRR15539874;37;32;0.459459459459459;20;17;0.0405405405405405;0.459459459459459
Control.SRR15539874;31;32;0.387096774193548;19;12;0.112903225806452;0.387096774193548
Control.SRR15539874;35;32;0.6;14;21;0.1;0.4
Control.SRR15539874;31;32;0.387096774193548;19;12;0.112903225806452;0.387096774193548
Control.SRR15539874;31;32;0.548387096774194;14;17;0.0483870967741935;0.451612903225806
Control.SRR15539874;37;32;0.486486486486487;19;18;0.0135135135135135;0.486486486486487
Control.SRR15539874;36;32;0.611111111111111;14;22;0.111111111111111;0.388888888888889
Control.SRR15539874;35;32;0.571428571428571;15;20;0.0714285714285714;0.428571428571429
Control.SRR15539874;31;32;0.709677419354839;9;22;0.209677419354839;0.290322580645161
Control.SRR15539874;31;32;0.451612903225806;17;14;0.0483870967741936;0.451612903225806
Control.SRR15539874;35;32;0.485714285714286;18;17;0.0142857142857143;0.485714285714286
Control.SRR15539874;32;32;0.6875;10;22;0.1875;0.3125
Control.SRR15539874;31;32;0.483870967741935;16;15;0.0161290322580645;0.483870967741935
Control.SRR15539874;35;32;0.457142857142857;19;16;0.0428571428571429;0.457142857142857
Control.SRR15539874;33;32;0.545454545454545;15;18;0.0454545454545454;0.454545454545455
Control.SRR15539874;37;32;0.540540540540541;17;20;0.0405405405405406;0.459459459459459
Control.SRR15539874;31;32;0.516129032258065;15;16;0.0161290322580645;0.483870967741935
Control.SRR15539874;29;32;0.482758620689655;15;14;0.0172413793103448;0.482758620689655
Control.SRR15539874;34;32;0.411764705882353;20;14;0.0882352941176471;0.411764705882353
Control.SRR15539874;37;32;0.540540540540541;17;20;0.0405405405405406;0.459459459459459
Control.SRR15539874;36;32;0.527777777777778;17;19;0.0277777777777778;0.472222222222222
Control.SRR15539874;33;32;0.727272727272727;9;24;0.227272727272727;0.272727272727273
Control.SRR15539874;31;32;0.483870967741935;16;15;0.0161290322580645;0.483870967741935
Control.SRR15539874;32;32;0.4375;18;14;0.0625;0.4375
Control.SRR15539874;29;32;0.620689655172414;11;18;0.120689655172414;0.379310344827586
Control.SRR15539874;36;32;0.472222222222222;19;17;0.0277777777777778;0.472222222222222
Control.SRR15539874;36;32;0.5;18;18;0;0.5
Control.SRR15539874;32;32;0.5625;14;18;0.0625;0.4375
Control.SRR15539874;31;32;0.580645161290323;13;18;0.0806451612903226;0.419354838709677
Control.SRR15539874;30;32;0.533333333333333;14;16;0.0333333333333333;0.466666666666667
Control.SRR15539874;32;32;0.71875;9;23;0.21875;0.28125
Control.SRR15539874;36;32;0.527777777777778;17;19;0.0277777777777778;0.472222222222222
Control.SRR15539874;35;32;0.485714285714286;18;17;0.0142857142857143;0.485714285714286
Control.SRR15539874;29;32;0.413793103448276;17;12;0.0862068965517241;0.413793103448276
Control.SRR15539874;31;32;0.580645161290323;13;18;0.0806451612903226;0.419354838709677
Control.SRR15539874;37;32;0.486486486486487;19;18;0.0135135135135135;0.486486486486487
Control.SRR15539874;36;32;0.472222222222222;19;17;0.0277777777777778;0.472222222222222
Control.SRR15539874;32;32;0.375;20;12;0.125;0.375
Control.SRR15539874;31;32;0.483870967741935;16;15;0.0161290322580645;0.483870967741935
Control.SRR15539874;31;32;0.612903225806452;12;19;0.112903225806452;0.387096774193548
Control.SRR15539874;36;32;0.527777777777778;17;19;0.0277777777777778;0.472222222222222
Control.SRR15539874;36;32;0.5;18;18;0;0.5
Control.SRR15539874;31;32;0.32258064516129;21;10;0.17741935483871;0.32258064516129
Control.SRR15539874;33;32;0.424242424242424;19;14;0.0757575757575757;0.424242424242424
Control.SRR15539874;29;32;0.379310344827586;18;11;0.120689655172414;0.379310344827586
Control.SRR15539874;30;32;0.566666666666667;13;17;0.0666666666666667;0.433333333333333
Control.SRR15539874;29;32;0.758620689655172;7;22;0.258620689655172;0.241379310344828
Control.SRR15539874;33;32;0.515151515151515;16;17;0.0151515151515151;0.484848484848485
Control.SRR15539874;31;32;0.580645161290323;13;18;0.0806451612903226;0.419354838709677
Control.SRR15539874;36;32;0.472222222222222;19;17;0.0277777777777778;0.472222222222222
Control.SRR15539874;32;32;0.34375;21;11;0.15625;0.34375
Control.SRR15539874;36;32;0.444444444444444;20;16;0.0555555555555556;0.444444444444444
Control.SRR15539874;35;32;0.542857142857143;16;19;0.0428571428571428;0.457142857142857
Control.SRR15539874;36;32;0.472222222222222;19;17;0.0277777777777778;0.472222222222222
Control.SRR15539874;30;32;0.433333333333333;17;13;0.0666666666666667;0.433333333333333
Control.SRR15539874;36;32;0.416666666666667;21;15;0.0833333333333333;0.416666666666667
Control.SRR15539874;33;32;0.515151515151515;16;17;0.0151515151515151;0.484848484848485
Control.SRR15539874;30;32;0.433333333333333;17;13;0.0666666666666667;0.433333333333333
Control.SRR15539874;32;32;0.5625;14;18;0.0625;0.4375
Control.SRR15539874;35;32;0.342857142857143;23;12;0.157142857142857;0.342857142857143
Control.SRR15539874;35;32;0.485714285714286;18;17;0.0142857142857143;0.485714285714286
Control.SRR15539874;36;32;0.5;18;18;0;0.5
Control.SRR15539874;31;32;0.258064516129032;23;8;0.241935483870968;0.258064516129032
Control.SRR15539874;34;32;0.617647058823529;13;21;0.117647058823529;0.382352941176471
Control.SRR15539874;32;32;0.5625;14;18;0.0625;0.4375
Control.SRR15539874;33;32;0.515151515151515;16;17;0.0151515151515151;0.484848484848485
Control.SRR15539874;30;32;0.5;15;15;0;0.5
Control.SRR15539874;34;32;0.558823529411765;15;19;0.0588235294117647;0.441176470588235
Control.SRR15539874;29;32;0.448275862068966;16;13;0.0517241379310345;0.448275862068966
Control.SRR15539874;32;32;0.6875;10;22;0.1875;0.3125
Control.SRR15539874;31;32;0.419354838709677;18;13;0.0806451612903226;0.419354838709677
Control.SRR15539874;37;32;0.513513513513513;18;19;0.0135135135135135;0.486486486486487
Control.SRR15539874;35;32;0.6;14;21;0.1;0.4
Control.SRR15539874;36;32;0.472222222222222;19;17;0.0277777777777778;0.472222222222222
Control.SRR15539874;34;32;0.588235294117647;14;20;0.0882352941176471;0.411764705882353
Control.SRR15539874;33;32;0.454545454545455;18;15;0.0454545454545455;0.454545454545455
Control.SRR15539874;31;32;0.612903225806452;12;19;0.112903225806452;0.387096774193548
Control.SRR15539874;30;32;0.366666666666667;19;11;0.133333333333333;0.366666666666667
Control.SRR15539874;34;32;0.441176470588235;19;15;0.0588235294117647;0.441176470588235
Control.SRR15539874;35;32;0.371428571428571;22;13;0.128571428571429;0.371428571428571
Control.SRR15539874;29;32;0.482758620689655;15;14;0.0172413793103448;0.482758620689655
Control.SRR15539874;33;32;0.424242424242424;19;14;0.0757575757575757;0.424242424242424
Control.SRR15539874;33;32;0.606060606060606;13;20;0.106060606060606;0.393939393939394
Control.SRR15539874;35;32;0.485714285714286;18;17;0.0142857142857143;0.485714285714286
Control.SRR15539874;32;32;0.5625;14;18;0.0625;0.4375
Control.SRR15539874;29;32;0.413793103448276;17;12;0.0862068965517241;0.413793103448276
Control.SRR15539874;37;32;0.513513513513513;18;19;0.0135135135135135;0.486486486486487
Control.SRR15539874;37;32;0.486486486486487;19;18;0.0135135135135135;0.486486486486487
Control.SRR15539874;32;32;0.5625;14;18;0.0625;0.4375
Control.SRR15539874;32;32;0.53125;15;17;0.03125;0.46875
Control.SRR15539874;37;32;0.486486486486487;19;18;0.0135135135135135;0.486486486486487
Control.SRR15539874;35;32;0.485714285714286;18;17;0.0142857142857143;0.485714285714286
Control.SRR15539874;36;32;0.388888888888889;22;14;0.111111111111111;0.388888888888889
Control.SRR15539874;31;32;0.290322580645161;22;9;0.209677419354839;0.290322580645161
Control.SRR15539874;30;32;0.433333333333333;17;13;0.0666666666666667;0.433333333333333
Control.SRR15539874;37;32;0.621621621621622;14;23;0.121621621621622;0.378378378378378
Control.SRR15539874;30;32;0.466666666666667;16;14;0.0333333333333333;0.466666666666667
Control.SRR15539874;29;32;0.551724137931034;13;16;0.0517241379310345;0.448275862068966
Control.SRR15539874;35;32;0.457142857142857;19;16;0.0428571428571429;0.457142857142857
Control.SRR15539874;30;32;0.466666666666667;16;14;0.0333333333333333;0.466666666666667
Control.SRR15539874;29;32;0.586206896551724;12;17;0.0862068965517241;0.413793103448276
Control.SRR15539874;37;32;0.486486486486487;19;18;0.0135135135135135;0.486486486486487
Control.SRR15539874;33;32;0.545454545454545;15;18;0.0454545454545454;0.454545454545455
Control.SRR15539874;31;32;0.451612903225806;17;14;0.0483870967741936;0.451612903225806
Control.SRR15539874;31;32;0.580645161290323;13;18;0.0806451612903226;0.419354838709677
Control.SRR15539874;34;32;0.441176470588235;19;15;0.0588235294117647;0.441176470588235
Control.SRR15539874;31;32;0.483870967741935;16;15;0.0161290322580645;0.483870967741935
Control.SRR15539874;31;32;0.419354838709677;18;13;0.0806451612903226;0.419354838709677
Control.SRR15539874;37;32;0.513513513513513;18;19;0.0135135135135135;0.486486486486487
Control.SRR15539874;31;32;0.516129032258065;15;16;0.0161290322580645;0.483870967741935
Control.SRR15539874;37;32;0.648648648648649;13;24;0.148648648648649;0.351351351351351
Control.SRR15539874;35;32;0.6;14;21;0.1;0.4
Control.SRR15539874;32;32;0.5625;14;18;0.0625;0.4375
Control.SRR15539874;35;32;0.428571428571429;20;15;0.0714285714285715;0.428571428571429
Control.SRR15539874;35;32;0.514285714285714;17;18;0.0142857142857142;0.485714285714286
Control.SRR15539874;34;32;0.705882352941177;10;24;0.205882352941177;0.294117647058824
Control.SRR15539874;35;32;0.428571428571429;20;15;0.0714285714285715;0.428571428571429
Control.SRR15539874;30;32;0.433333333333333;17;13;0.0666666666666667;0.433333333333333
Control.SRR15539874;34;32;0.558823529411765;15;19;0.0588235294117647;0.441176470588235
Control.SRR15539874;37;32;0.567567567567568;16;21;0.0675675675675675;0.432432432432432
Control.SRR15539874;36;32;0.444444444444444;20;16;0.0555555555555556;0.444444444444444
Control.SRR15539874;35;32;0.542857142857143;16;19;0.0428571428571428;0.457142857142857
Control.SRR15539874;31;32;0.483870967741935;16;15;0.0161290322580645;0.483870967741935
Control.SRR15539874;33;32;0.484848484848485;17;16;0.0151515151515151;0.484848484848485
Control.SRR15539874;37;32;0.486486486486487;19;18;0.0135135135135135;0.486486486486487
Control.SRR15539874;35;32;0.371428571428571;22;13;0.128571428571429;0.371428571428571
Control.SRR15539874;36;32;0.444444444444444;20;16;0.0555555555555556;0.444444444444444
Control.SRR15539874;31;32;0.483870967741935;16;15;0.0161290322580645;0.483870967741935
Control.SRR15539874;34;32;0.5;17;17;0;0.5
Control.SRR15539874;31;32;0.483870967741935;16;15;0.0161290322580645;0.483870967741935
Control.SRR15539874;37;32;0.540540540540541;17;20;0.0405405405405406;0.459459459459459
Control.SRR15539874;30;32;0.366666666666667;19;11;0.133333333333333;0.366666666666667
Control.SRR15539874;33;32;0.515151515151515;16;17;0.0151515151515151;0.484848484848485
Control.SRR15539874;29;32;0.448275862068966;16;13;0.0517241379310345;0.448275862068966
Control.SRR15539874;31;32;0.387096774193548;19;12;0.112903225806452;0.387096774193548
Control.SRR15539874;37;32;0.567567567567568;16;21;0.0675675675675675;0.432432432432432
Control.SRR15539874;37;32;0.513513513513513;18;19;0.0135135135135135;0.486486486486487
Control.SRR15539874;35;32;0.485714285714286;18;17;0.0142857142857143;0.485714285714286
Control.SRR15539874;36;32;0.333333333333333;24;12;0.166666666666667;0.333333333333333
Control.SRR15539874;33;32;0.575757575757576;14;19;0.0757575757575758;0.424242424242424
Control.SRR15539874;33;32;0.424242424242424;19;14;0.0757575757575757;0.424242424242424
Control.SRR15539874;37;32;0.351351351351351;24;13;0.148648648648649;0.351351351351351
Control.SRR15539874;30;32;0.433333333333333;17;13;0.0666666666666667;0.433333333333333
Control.SRR15539874;32;32;0.59375;13;19;0.09375;0.40625
Control.SRR15539874;31;32;0.419354838709677;18;13;0.0806451612903226;0.419354838709677
Control.SRR15539874;33;32;0.636363636363636;12;21;0.136363636363636;0.363636363636364
Control.SRR15539874;37;32;0.567567567567568;16;21;0.0675675675675675;0.432432432432432
Control.SRR15539874;36;32;0.555555555555556;16;20;0.0555555555555556;0.444444444444444
Control.SRR15539874;32;32;0.4375;18;14;0.0625;0.4375
Control.SRR15539874;36;32;0.416666666666667;21;15;0.0833333333333333;0.416666666666667
Control.SRR15539874;33;32;0.424242424242424;19;14;0.0757575757575757;0.424242424242424
Control.SRR15539874;31;32;0.451612903225806;17;14;0.0483870967741936;0.451612903225806
Control.SRR15539874;35;32;0.428571428571429;20;15;0.0714285714285715;0.428571428571429
Control.SRR15539874;36;32;0.583333333333333;15;21;0.0833333333333334;0.416666666666667
Control.SRR15539874;36;32;0.472222222222222;19;17;0.0277777777777778;0.472222222222222
Control.SRR15539874;30;32;0.333333333333333;20;10;0.166666666666667;0.333333333333333
Control.SRR15539874;33;32;0.606060606060606;13;20;0.106060606060606;0.393939393939394
Control.SRR15539874;30;32;0.666666666666667;10;20;0.166666666666667;0.333333333333333
Control.SRR15539874;35;32;0.342857142857143;23;12;0.157142857142857;0.342857142857143
Control.SRR15539874;37;32;0.648648648648649;13;24;0.148648648648649;0.351351351351351
Control.SRR15539874;35;32;0.428571428571429;20;15;0.0714285714285715;0.428571428571429
Control.SRR15539874;34;32;0.705882352941177;10;24;0.205882352941177;0.294117647058824
Control.SRR15539874;32;32;0.4375;18;14;0.0625;0.4375
Control.SRR15539874;37;32;0.513513513513513;18;19;0.0135135135135135;0.486486486486487
Control.SRR15539874;36;32;0.416666666666667;21;15;0.0833333333333333;0.416666666666667
Control.SRR15539874;34;32;0.647058823529412;12;22;0.147058823529412;0.352941176470588
Control.SRR15539874;30;32;0.433333333333333;17;13;0.0666666666666667;0.433333333333333
Control.SRR15539874;33;32;0.606060606060606;13;20;0.106060606060606;0.393939393939394
Control.SRR15539874;32;32;0.53125;15;17;0.03125;0.46875
Control.SRR15539874;34;32;0.323529411764706;23;11;0.176470588235294;0.323529411764706
Control.SRR15539874;34;32;0.470588235294118;18;16;0.0294117647058824;0.470588235294118
Control.SRR15539874;32;32;0.4375;18;14;0.0625;0.4375
Control.SRR15539874;30;32;0.466666666666667;16;14;0.0333333333333333;0.466666666666667
Control.SRR15539874;32;32;0.4375;18;14;0.0625;0.4375
Control.SRR15539874;36;32;0.388888888888889;22;14;0.111111111111111;0.388888888888889
Control.SRR15539874;36;32;0.583333333333333;15;21;0.0833333333333334;0.416666666666667
Control.SRR15539874;32;32;0.53125;15;17;0.03125;0.46875
Control.SRR15539874;32;32;0.375;20;12;0.125;0.375
Control.SRR15539874;32;32;0.40625;19;13;0.09375;0.40625
Control.SRR15539874;32;32;0.75;8;24;0.25;0.25
Control.SRR15539874;33;32;0.515151515151515;16;17;0.0151515151515151;0.484848484848485
Control.SRR15539874;37;32;0.378378378378378;23;14;0.121621621621622;0.378378378378378
Control.SRR15539874;32;32;0.28125;23;9;0.21875;0.28125
Control.SRR15539874;34;32;0.470588235294118;18;16;0.0294117647058824;0.470588235294118
Control.SRR15539874;35;32;0.485714285714286;18;17;0.0142857142857143;0.485714285714286
Control.SRR15539874;36;32;0.333333333333333;24;12;0.166666666666667;0.333333333333333
Control.SRR15539874;34;32;0.411764705882353;20;14;0.0882352941176471;0.411764705882353
Control.SRR15539874;37;32;0.432432432432432;21;16;0.0675675675675675;0.432432432432432
Control.SRR15539874;31;32;0.354838709677419;20;11;0.145161290322581;0.354838709677419
Control.SRR15539874;34;32;0.470588235294118;18;16;0.0294117647058824;0.470588235294118
Control.SRR15539874;32;32;0.59375;13;19;0.09375;0.40625
Control.SRR15539874;37;32;0.486486486486487;19;18;0.0135135135135135;0.486486486486487
Control.SRR15539874;36;32;0.472222222222222;19;17;0.0277777777777778;0.472222222222222
Control.SRR15539874;32;32;0.4375;18;14;0.0625;0.4375
Control.SRR15539874;36;32;0.416666666666667;21;15;0.0833333333333333;0.416666666666667
Control.SRR15539874;36;32;0.472222222222222;19;17;0.0277777777777778;0.472222222222222
Control.SRR15539874;32;32;0.5625;14;18;0.0625;0.4375
Control.SRR15539874;36;32;0.388888888888889;22;14;0.111111111111111;0.388888888888889
Control.SRR15539874;31;32;0.483870967741935;16;15;0.0161290322580645;0.483870967741935
Control.SRR15539874;29;32;0.448275862068966;16;13;0.0517241379310345;0.448275862068966
Control.SRR15539874;34;32;0.5;17;17;0;0.5
Control.SRR15539874;36;32;0.416666666666667;21;15;0.0833333333333333;0.416666666666667
Control.SRR15539874;35;32;0.628571428571429;13;22;0.128571428571429;0.371428571428571
Control.SRR15539874;35;32;0.542857142857143;16;19;0.0428571428571428;0.457142857142857
Control.SRR15539874;32;32;0.5625;14;18;0.0625;0.4375
Control.SRR15539874;30;32;0.466666666666667;16;14;0.0333333333333333;0.466666666666667
Control.SRR15539874;32;32;0.46875;17;15;0.03125;0.46875
Control.SRR15539874;31;32;0.612903225806452;12;19;0.112903225806452;0.387096774193548
Control.SRR15539874;30;32;0.333333333333333;20;10;0.166666666666667;0.333333333333333
Control.SRR15539874;35;32;0.514285714285714;17;18;0.0142857142857142;0.485714285714286
Control.SRR15539874;36;32;0.555555555555556;16;20;0.0555555555555556;0.444444444444444
Control.SRR15539874;34;32;0.5;17;17;0;0.5
Control.SRR15539874;33;32;0.515151515151515;16;17;0.0151515151515151;0.484848484848485
Control.SRR15539874;29;32;0.517241379310345;14;15;0.0172413793103449;0.482758620689655
Control.SRR15539874;35;32;0.4;21;14;0.1;0.4
Control.SRR15539874;37;32;0.486486486486487;19;18;0.0135135135135135;0.486486486486487
Control.SRR15539874;37;32;0.432432432432432;21;16;0.0675675675675675;0.432432432432432
Control.SRR15539874;30;32;0.433333333333333;17;13;0.0666666666666667;0.433333333333333
Control.SRR15539874;33;32;0.606060606060606;13;20;0.106060606060606;0.393939393939394
Control.SRR15539874;36;32;0.416666666666667;21;15;0.0833333333333333;0.416666666666667
Control.SRR15539874;37;32;0.675675675675676;12;25;0.175675675675676;0.324324324324324
Control.SRR15539874;36;32;0.5;18;18;0;0.5
Control.SRR15539874;33;32;0.393939393939394;20;13;0.106060606060606;0.393939393939394
Control.SRR15539874;36;32;0.527777777777778;17;19;0.0277777777777778;0.472222222222222
Control.SRR15539874;32;32;0.5625;14;18;0.0625;0.4375
Control.SRR15539874;30;32;0.566666666666667;13;17;0.0666666666666667;0.433333333333333
Control.SRR15539874;32;32;0.53125;15;17;0.03125;0.46875
Control.SRR15539874;37;32;0.486486486486487;19;18;0.0135135135135135;0.486486486486487
Control.SRR15539874;32;32;0.4375;18;14;0.0625;0.4375
Control.SRR15539874;31;32;0.419354838709677;18;13;0.0806451612903226;0.419354838709677
Control.SRR15539874;33;32;0.545454545454545;15;18;0.0454545454545454;0.454545454545455
Control.SRR15539874;29;32;0.413793103448276;17;12;0.0862068965517241;0.413793103448276
Control.SRR15539874;29;32;0.482758620689655;15;14;0.0172413793103448;0.482758620689655
Control.SRR15539874;30;32;0.633333333333333;11;19;0.133333333333333;0.366666666666667
Control.SRR15539874;37;32;0.513513513513513;18;19;0.0135135135135135;0.486486486486487
Control.SRR15539874;31;32;0.548387096774194;14;17;0.0483870967741935;0.451612903225806
Control.SRR15539874;36;32;0.527777777777778;17;19;0.0277777777777778;0.472222222222222
Control.SRR15539874;37;32;0.513513513513513;18;19;0.0135135135135135;0.486486486486487
Control.SRR15539874;30;32;0.533333333333333;14;16;0.0333333333333333;0.466666666666667
Control.SRR15539874;30;32;0.433333333333333;17;13;0.0666666666666667;0.433333333333333
Control.SRR15539874;37;32;0.405405405405405;22;15;0.0945945945945946;0.405405405405405
Control.SRR15539874;34;32;0.5;17;17;0;0.5
Control.SRR15539874;34;32;0.529411764705882;16;18;0.0294117647058824;0.470588235294118
Control.SRR15539874;35;32;0.571428571428571;15;20;0.0714285714285714;0.428571428571429
Control.SRR15539874;35;32;0.457142857142857;19;16;0.0428571428571429;0.457142857142857
Control.SRR15539874;36;32;0.5;18;18;0;0.5
Control.SRR15539874;33;32;0.363636363636364;21;12;0.136363636363636;0.363636363636364
Control.SRR15539874;30;32;0.5;15;15;0;0.5
Control.SRR15539874;30;32;0.533333333333333;14;16;0.0333333333333333;0.466666666666667
Control.SRR15539874;35;32;0.571428571428571;15;20;0.0714285714285714;0.428571428571429
Control.SRR15539874;31;32;0.483870967741935;16;15;0.0161290322580645;0.483870967741935
Control.SRR15539874;35;32;0.6;14;21;0.1;0.4
Control.SRR15539874;33;32;0.454545454545455;18;15;0.0454545454545455;0.454545454545455
Control.SRR15539874;32;32;0.59375;13;19;0.09375;0.40625
Control.SRR15539874;31;32;0.580645161290323;13;18;0.0806451612903226;0.419354838709677
Control.SRR15539874;31;32;0.483870967741935;16;15;0.0161290322580645;0.483870967741935
Control.SRR15539874;36;32;0.555555555555556;16;20;0.0555555555555556;0.444444444444444
Control.SRR15539874;35;32;0.514285714285714;17;18;0.0142857142857142;0.485714285714286
Control.SRR15539874;33;32;0.454545454545455;18;15;0.0454545454545455;0.454545454545455
Control.SRR15539874;34;32;0.323529411764706;23;11;0.176470588235294;0.323529411764706
Control.SRR15539874;30;32;0.4;18;12;0.1;0.4
Control.SRR15539874;36;32;0.583333333333333;15;21;0.0833333333333334;0.416666666666667
Control.SRR15539874;34;32;0.382352941176471;21;13;0.117647058823529;0.382352941176471
Control.SRR15539874;33;32;0.575757575757576;14;19;0.0757575757575758;0.424242424242424
Control.SRR15539874;35;32;0.371428571428571;22;13;0.128571428571429;0.371428571428571
Control.SRR15539874;37;32;0.675675675675676;12;25;0.175675675675676;0.324324324324324
Control.SRR15539874;32;32;0.59375;13;19;0.09375;0.40625
Control.SRR15539874;36;32;0.5;18;18;0;0.5
Control.SRR15539874;36;32;0.5;18;18;0;0.5
Control.SRR15539874;32;32;0.53125;15;17;0.03125;0.46875
Control.SRR15539874;29;32;0.448275862068966;16;13;0.0517241379310345;0.448275862068966
Control.SRR15539874;36;32;0.583333333333333;15;21;0.0833333333333334;0.416666666666667
Control.SRR15539874;31;32;0.419354838709677;18;13;0.0806451612903226;0.419354838709677
Control.SRR15539874;36;32;0.666666666666667;12;24;0.166666666666667;0.333333333333333
Control.SRR15539874;31;32;0.419354838709677;18;13;0.0806451612903226;0.419354838709677
Control.SRR15539874;29;32;0.344827586206897;19;10;0.155172413793103;0.344827586206897
Control.SRR15539874;30;32;0.5;15;15;0;0.5
Control.SRR15539874;33;32;0.545454545454545;15;18;0.0454545454545454;0.454545454545455
Control.SRR15539874;31;32;0.548387096774194;14;17;0.0483870967741935;0.451612903225806
Control.SRR15539874;32;32;0.59375;13;19;0.09375;0.40625
Control.SRR15539874;31;32;0.645161290322581;11;20;0.145161290322581;0.354838709677419
Control.SRR15539874;33;32;0.515151515151515;16;17;0.0151515151515151;0.484848484848485
Control.SRR15539874;32;32;0.59375;13;19;0.09375;0.40625
Control.SRR15539874;37;32;0.540540540540541;17;20;0.0405405405405406;0.459459459459459
Control.SRR15539874;30;32;0.466666666666667;16;14;0.0333333333333333;0.466666666666667
Control.SRR15539874;32;32;0.59375;13;19;0.09375;0.40625
Control.SRR15539874;36;32;0.472222222222222;19;17;0.0277777777777778;0.472222222222222
Control.SRR15539874;32;32;0.40625;19;13;0.09375;0.40625
Control.SRR15539874;33;32;0.696969696969697;10;23;0.196969696969697;0.303030303030303
Control.SRR15539874;36;32;0.472222222222222;19;17;0.0277777777777778;0.472222222222222
Control.SRR15539874;29;32;0.413793103448276;17;12;0.0862068965517241;0.413793103448276
Control.SRR15539874;35;32;0.428571428571429;20;15;0.0714285714285715;0.428571428571429
Control.SRR15539874;33;32;0.454545454545455;18;15;0.0454545454545455;0.454545454545455
Control.SRR15539874;32;32;0.5;16;16;0;0.5
Control.SRR15539874;33;32;0.606060606060606;13;20;0.106060606060606;0.393939393939394
Control.SRR15539874;31;32;0.516129032258065;15;16;0.0161290322580645;0.483870967741935
Control.SRR15539874;34;32;0.558823529411765;15;19;0.0588235294117647;0.441176470588235
Control.SRR15539874;34;32;0.617647058823529;13;21;0.117647058823529;0.382352941176471
Control.SRR15539874;34;32;0.705882352941177;10;24;0.205882352941177;0.294117647058824
Control.SRR15539874;32;32;0.46875;17;15;0.03125;0.46875
Control.SRR15539874;32;32;0.5;16;16;0;0.5
Control.SRR15539874;36;32;0.611111111111111;14;22;0.111111111111111;0.388888888888889
Control.SRR15539874;32;32;0.5;16;16;0;0.5
Control.SRR15539874;34;32;0.323529411764706;23;11;0.176470588235294;0.323529411764706
Control.SRR15539874;33;32;0.636363636363636;12;21;0.136363636363636;0.363636363636364
Control.SRR15539874;36;32;0.5;18;18;0;0.5
Control.SRR15539874;37;32;0.486486486486487;19;18;0.0135135135135135;0.486486486486487
Control.SRR15539874;36;32;0.305555555555556;25;11;0.194444444444444;0.305555555555556
Control.SRR15539874;36;32;0.666666666666667;12;24;0.166666666666667;0.333333333333333
Control.SRR15539874;33;32;0.484848484848485;17;16;0.0151515151515151;0.484848484848485
Control.SRR15539874;35;32;0.457142857142857;19;16;0.0428571428571429;0.457142857142857
Control.SRR15539874;35;32;0.457142857142857;19;16;0.0428571428571429;0.457142857142857
Control.SRR15539874;36;32;0.472222222222222;19;17;0.0277777777777778;0.472222222222222
Control.SRR15539874;35;32;0.514285714285714;17;18;0.0142857142857142;0.485714285714286
Control.SRR15539874;30;32;0.366666666666667;19;11;0.133333333333333;0.366666666666667
Control.SRR15539874;34;32;0.352941176470588;22;12;0.147058823529412;0.352941176470588
Control.SRR15539874;30;32;0.466666666666667;16;14;0.0333333333333333;0.466666666666667
Control.SRR15539874;31;32;0.387096774193548;19;12;0.112903225806452;0.387096774193548
Control.SRR15539874;29;32;0.482758620689655;15;14;0.0172413793103448;0.482758620689655
Control.SRR15539874;30;32;0.533333333333333;14;16;0.0333333333333333;0.466666666666667
Control.SRR15539874;33;32;0.515151515151515;16;17;0.0151515151515151;0.484848484848485
Control.SRR15539874;37;32;0.486486486486487;19;18;0.0135135135135135;0.486486486486487
Control.SRR15539874;32;32;0.5625;14;18;0.0625;0.4375
Control.SRR15539874;35;32;0.6;14;21;0.1;0.4
Control.SRR15539874;34;32;0.5;17;17;0;0.5
Control.SRR15539874;32;32;0.375;20;12;0.125;0.375
Control.SRR15539874;37;32;0.540540540540541;17;20;0.0405405405405406;0.459459459459459
Control.SRR15539874;35;32;0.628571428571429;13;22;0.128571428571429;0.371428571428571
Control.SRR15539874;37;32;0.459459459459459;20;17;0.0405405405405405;0.459459459459459
Control.SRR15539874;33;32;0.303030303030303;23;10;0.196969696969697;0.303030303030303
Control.SRR15539874;29;32;0.482758620689655;15;14;0.0172413793103448;0.482758620689655
Control.SRR15539874;35;32;0.428571428571429;20;15;0.0714285714285715;0.428571428571429
Control.SRR15539874;33;32;0.424242424242424;19;14;0.0757575757575757;0.424242424242424
Control.SRR15539874;33;32;0.606060606060606;13;20;0.106060606060606;0.393939393939394
Control.SRR15539874;29;32;0.482758620689655;15;14;0.0172413793103448;0.482758620689655
Control.SRR15539874;29;32;0.482758620689655;15;14;0.0172413793103448;0.482758620689655
Control.SRR15539874;37;32;0.702702702702703;11;26;0.202702702702703;0.297297297297297
Control.SRR15539874;34;32;0.470588235294118;18;16;0.0294117647058824;0.470588235294118
Control.SRR15539874;33;32;0.454545454545455;18;15;0.0454545454545455;0.454545454545455
Control.SRR15539874;34;32;0.470588235294118;18;16;0.0294117647058824;0.470588235294118
Control.SRR15539874;32;32;0.5625;14;18;0.0625;0.4375
Control.SRR15539874;35;32;0.4;21;14;0.1;0.4
Control.SRR15539874;36;32;0.5;18;18;0;0.5
Control.SRR15539874;29;32;0.517241379310345;14;15;0.0172413793103449;0.482758620689655
Control.SRR15539874;32;32;0.5;16;16;0;0.5
Control.SRR15539874;29;32;0.620689655172414;11;18;0.120689655172414;0.379310344827586
Control.SRR15539874;31;32;0.67741935483871;10;21;0.17741935483871;0.32258064516129
Control.SRR15539874;34;32;0.5;17;17;0;0.5
Control.SRR15539874;30;32;0.566666666666667;13;17;0.0666666666666667;0.433333333333333
Control.SRR15539874;35;32;0.485714285714286;18;17;0.0142857142857143;0.485714285714286
Control.SRR15539874;36;32;0.472222222222222;19;17;0.0277777777777778;0.472222222222222
Control.SRR15539874;37;32;0.459459459459459;20;17;0.0405405405405405;0.459459459459459
Control.SRR15539874;36;32;0.5;18;18;0;0.5
Control.SRR15539874;34;32;0.470588235294118;18;16;0.0294117647058824;0.470588235294118
Control.SRR15539874;35;32;0.457142857142857;19;16;0.0428571428571429;0.457142857142857
Control.SRR15539874;35;32;0.314285714285714;24;11;0.185714285714286;0.314285714285714
Control.SRR15539874;36;32;0.416666666666667;21;15;0.0833333333333333;0.416666666666667
Control.SRR15539874;37;32;0.648648648648649;13;24;0.148648648648649;0.351351351351351
Control.SRR15539874;36;32;0.611111111111111;14;22;0.111111111111111;0.388888888888889
Control.SRR15539874;33;32;0.454545454545455;18;15;0.0454545454545455;0.454545454545455
Control.SRR15539874;30;32;0.4;18;12;0.1;0.4
Control.SRR15539874;30;32;0.5;15;15;0;0.5
Control.SRR15539874;29;32;0.482758620689655;15;14;0.0172413793103448;0.482758620689655
Control.SRR15539874;29;32;0.620689655172414;11;18;0.120689655172414;0.379310344827586
Control.SRR15539874;32;32;0.375;20;12;0.125;0.375
Control.SRR15539874;32;32;0.53125;15;17;0.03125;0.46875
Control.SRR15539874;31;32;0.354838709677419;20;11;0.145161290322581;0.354838709677419
Control.SRR15539874;29;32;0.413793103448276;17;12;0.0862068965517241;0.413793103448276
Control.SRR15539874;32;32;0.59375;13;19;0.09375;0.40625
Control.SRR15539874;34;32;0.411764705882353;20;14;0.0882352941176471;0.411764705882353
Control.SRR15539874;35;32;0.571428571428571;15;20;0.0714285714285714;0.428571428571429
Control.SRR15539874;29;32;0.275862068965517;21;8;0.224137931034483;0.275862068965517
Control.SRR15539874;30;32;0.366666666666667;19;11;0.133333333333333;0.366666666666667
Control.SRR15539874;35;32;0.571428571428571;15;20;0.0714285714285714;0.428571428571429
Control.SRR15539874;30;32;0.533333333333333;14;16;0.0333333333333333;0.466666666666667
Control.SRR15539874;30;32;0.566666666666667;13;17;0.0666666666666667;0.433333333333333
Control.SRR15539874;34;32;0.470588235294118;18;16;0.0294117647058824;0.470588235294118
Control.SRR15539874;29;32;0.551724137931034;13;16;0.0517241379310345;0.448275862068966
Control.SRR15539874;34;32;0.441176470588235;19;15;0.0588235294117647;0.441176470588235
Control.SRR15539874;34;32;0.705882352941177;10;24;0.205882352941177;0.294117647058824
Control.SRR15539874;30;32;0.4;18;12;0.1;0.4
Control.SRR15539874;31;32;0.290322580645161;22;9;0.209677419354839;0.290322580645161
Control.SRR15539874;36;32;0.472222222222222;19;17;0.0277777777777778;0.472222222222222
Control.SRR15539874;33;32;0.606060606060606;13;20;0.106060606060606;0.393939393939394
Control.SRR15539874;37;32;0.459459459459459;20;17;0.0405405405405405;0.459459459459459
Control.SRR15539874;34;32;0.529411764705882;16;18;0.0294117647058824;0.470588235294118
Control.SRR15539874;31;32;0.483870967741935;16;15;0.0161290322580645;0.483870967741935
Control.SRR15539874;29;32;0.586206896551724;12;17;0.0862068965517241;0.413793103448276
Control.SRR15539874;32;32;0.65625;11;21;0.15625;0.34375
Control.SRR15539874;29;32;0.482758620689655;15;14;0.0172413793103448;0.482758620689655
Control.SRR15539874;32;32;0.46875;17;15;0.03125;0.46875
Control.SRR15539874;37;32;0.594594594594595;15;22;0.0945945945945946;0.405405405405405
Control.SRR15539874;29;32;0.344827586206897;19;10;0.155172413793103;0.344827586206897
Control.SRR15539874;36;32;0.555555555555556;16;20;0.0555555555555556;0.444444444444444
Control.SRR15539874;35;32;0.542857142857143;16;19;0.0428571428571428;0.457142857142857
Control.SRR15539874;33;32;0.424242424242424;19;14;0.0757575757575757;0.424242424242424
Control.SRR15539874;35;32;0.657142857142857;12;23;0.157142857142857;0.342857142857143
Control.SRR15539874;36;32;0.527777777777778;17;19;0.0277777777777778;0.472222222222222
Control.SRR15539874;35;32;0.485714285714286;18;17;0.0142857142857143;0.485714285714286
Control.SRR15539874;32;32;0.4375;18;14;0.0625;0.4375
Control.SRR15539874;35;32;0.485714285714286;18;17;0.0142857142857143;0.485714285714286
Control.SRR15539874;37;32;0.621621621621622;14;23;0.121621621621622;0.378378378378378
Control.SRR15539874;33;32;0.484848484848485;17;16;0.0151515151515151;0.484848484848485
Control.SRR15539874;29;32;0.586206896551724;12;17;0.0862068965517241;0.413793103448276
Control.SRR15539874;31;32;0.612903225806452;12;19;0.112903225806452;0.387096774193548
Control.SRR15539874;32;32;0.6875;10;22;0.1875;0.3125
Control.SRR15539874;30;32;0.533333333333333;14;16;0.0333333333333333;0.466666666666667
Control.SRR15539874;32;32;0.4375;18;14;0.0625;0.4375
Control.SRR15539874;31;32;0.516129032258065;15;16;0.0161290322580645;0.483870967741935
Control.SRR15539874;35;32;0.457142857142857;19;16;0.0428571428571429;0.457142857142857
Control.SRR15539874;36;32;0.527777777777778;17;19;0.0277777777777778;0.472222222222222
Control.SRR15539874;29;32;0.482758620689655;15;14;0.0172413793103448;0.482758620689655
Control.SRR15539874;36;32;0.444444444444444;20;16;0.0555555555555556;0.444444444444444
Control.SRR15539874;35;32;0.4;21;14;0.1;0.4
Control.SRR15539874;32;32;0.59375;13;19;0.09375;0.40625
Control.SRR15539874;33;32;0.484848484848485;17;16;0.0151515151515151;0.484848484848485
Control.SRR15539874;35;32;0.657142857142857;12;23;0.157142857142857;0.342857142857143
Control.SRR15539874;33;32;0.575757575757576;14;19;0.0757575757575758;0.424242424242424
Control.SRR15539874;33;32;0.363636363636364;21;12;0.136363636363636;0.363636363636364
Control.SRR15539874;32;32;0.6875;10;22;0.1875;0.3125
Control.SRR15539874;37;32;0.567567567567568;16;21;0.0675675675675675;0.432432432432432
Control.SRR15539874;29;32;0.551724137931034;13;16;0.0517241379310345;0.448275862068966
Control.SRR15539874;29;32;0.517241379310345;14;15;0.0172413793103449;0.482758620689655
Control.SRR15539874;31;32;0.548387096774194;14;17;0.0483870967741935;0.451612903225806
Control.SRR15539874;31;32;0.548387096774194;14;17;0.0483870967741935;0.451612903225806
Control.SRR15539874;31;32;0.580645161290323;13;18;0.0806451612903226;0.419354838709677
Control.SRR15539874;32;32;0.5;16;16;0;0.5
Control.SRR15539874;34;32;0.411764705882353;20;14;0.0882352941176471;0.411764705882353
Control.SRR15539874;31;32;0.580645161290323;13;18;0.0806451612903226;0.419354838709677
Control.SRR15539874;29;32;0.517241379310345;14;15;0.0172413793103449;0.482758620689655
Control.SRR15539874;29;32;0.448275862068966;16;13;0.0517241379310345;0.448275862068966
Control.SRR15539874;33;32;0.606060606060606;13;20;0.106060606060606;0.393939393939394
Control.SRR15539874;32;32;0.5625;14;18;0.0625;0.4375
Control.SRR15539874;32;32;0.53125;15;17;0.03125;0.46875
Control.SRR15539874;31;32;0.451612903225806;17;14;0.0483870967741936;0.451612903225806
Control.SRR15539874;33;32;0.333333333333333;22;11;0.166666666666667;0.333333333333333
Control.SRR15539874;34;32;0.441176470588235;19;15;0.0588235294117647;0.441176470588235
Control.SRR15539874;33;32;0.575757575757576;14;19;0.0757575757575758;0.424242424242424
Control.SRR15539874;29;32;0.448275862068966;16;13;0.0517241379310345;0.448275862068966
Control.SRR15539874;32;32;0.59375;13;19;0.09375;0.40625
Control.SRR15539874;36;32;0.555555555555556;16;20;0.0555555555555556;0.444444444444444
Control.SRR15539874;30;32;0.533333333333333;14;16;0.0333333333333333;0.466666666666667
Control.SRR15539874;34;32;0.441176470588235;19;15;0.0588235294117647;0.441176470588235
Control.SRR15539874;34;32;0.470588235294118;18;16;0.0294117647058824;0.470588235294118
Control.SRR15539874;34;32;0.5;17;17;0;0.5
Control.SRR15539874;32;32;0.5;16;16;0;0.5
Control.SRR15539874;37;32;0.540540540540541;17;20;0.0405405405405406;0.459459459459459
Control.SRR15539874;29;32;0.724137931034483;8;21;0.224137931034483;0.275862068965517
Control.SRR15539874;36;32;0.75;9;27;0.25;0.25
Control.SRR15539874;30;32;0.5;15;15;0;0.5
Control.SRR15539874;30;32;0.4;18;12;0.1;0.4
Control.SRR15539874;30;32;0.466666666666667;16;14;0.0333333333333333;0.466666666666667
Control.SRR15539874;34;32;0.441176470588235;19;15;0.0588235294117647;0.441176470588235
Control.SRR15539874;34;32;0.470588235294118;18;16;0.0294117647058824;0.470588235294118
Control.SRR15539874;31;32;0.612903225806452;12;19;0.112903225806452;0.387096774193548
Control.SRR15539874;29;32;0.379310344827586;18;11;0.120689655172414;0.379310344827586
Control.SRR15539874;32;32;0.5625;14;18;0.0625;0.4375
Control.SRR15539874;29;32;0.620689655172414;11;18;0.120689655172414;0.379310344827586
Control.SRR15539874;30;32;0.466666666666667;16;14;0.0333333333333333;0.466666666666667
Control.SRR15539874;36;32;0.611111111111111;14;22;0.111111111111111;0.388888888888889
Control.SRR15539874;29;32;0.413793103448276;17;12;0.0862068965517241;0.413793103448276
Control.SRR15539874;35;32;0.514285714285714;17;18;0.0142857142857142;0.485714285714286
Control.SRR15539874;35;32;0.457142857142857;19;16;0.0428571428571429;0.457142857142857
Control.SRR15539874;32;32;0.5;16;16;0;0.5
Control.SRR15539874;35;32;0.571428571428571;15;20;0.0714285714285714;0.428571428571429
Control.SRR15539874;31;32;0.354838709677419;20;11;0.145161290322581;0.354838709677419
Control.SRR15539874;31;32;0.548387096774194;14;17;0.0483870967741935;0.451612903225806
Control.SRR15539874;32;32;0.46875;17;15;0.03125;0.46875
Control.SRR15539874;33;32;0.606060606060606;13;20;0.106060606060606;0.393939393939394
Control.SRR15539874;32;32;0.53125;15;17;0.03125;0.46875
Control.SRR15539874;31;32;0.419354838709677;18;13;0.0806451612903226;0.419354838709677
Control.SRR15539874;32;32;0.34375;21;11;0.15625;0.34375
Control.SRR15539874;32;32;0.3125;22;10;0.1875;0.3125
Control.SRR15539874;37;32;0.513513513513513;18;19;0.0135135135135135;0.486486486486487
Control.SRR15539874;31;32;0.612903225806452;12;19;0.112903225806452;0.387096774193548
Control.SRR15539874;34;32;0.588235294117647;14;20;0.0882352941176471;0.411764705882353
Control.SRR15539874;29;32;0.551724137931034;13;16;0.0517241379310345;0.448275862068966
Control.SRR15539874;30;32;0.533333333333333;14;16;0.0333333333333333;0.466666666666667
Control.SRR15539874;29;32;0.448275862068966;16;13;0.0517241379310345;0.448275862068966
Control.SRR15539874;37;32;0.513513513513513;18;19;0.0135135135135135;0.486486486486487
Control.SRR15539874;30;32;0.533333333333333;14;16;0.0333333333333333;0.466666666666667
Control.SRR15539874;30;32;0.6;12;18;0.1;0.4
Control.SRR15539874;36;32;0.388888888888889;22;14;0.111111111111111;0.388888888888889
Control.SRR15539874;36;32;0.555555555555556;16;20;0.0555555555555556;0.444444444444444
Control.SRR15539874;33;32;0.424242424242424;19;14;0.0757575757575757;0.424242424242424
Control.SRR15539874;32;32;0.40625;19;13;0.09375;0.40625
Control.SRR15539874;34;32;0.441176470588235;19;15;0.0588235294117647;0.441176470588235
Control.SRR15539874;36;32;0.444444444444444;20;16;0.0555555555555556;0.444444444444444
Control.SRR15539874;32;32;0.5625;14;18;0.0625;0.4375
Control.SRR15539874;34;32;0.5;17;17;0;0.5
Control.SRR15539874;33;32;0.606060606060606;13;20;0.106060606060606;0.393939393939394
Control.SRR15539874;29;32;0.448275862068966;16;13;0.0517241379310345;0.448275862068966
Control.SRR15539874;31;32;0.32258064516129;21;10;0.17741935483871;0.32258064516129
Control.SRR15539874;34;32;0.588235294117647;14;20;0.0882352941176471;0.411764705882353
Control.SRR15539874;32;32;0.46875;17;15;0.03125;0.46875
Control.SRR15539874;33;32;0.393939393939394;20;13;0.106060606060606;0.393939393939394
Control.SRR15539874;29;32;0.448275862068966;16;13;0.0517241379310345;0.448275862068966
Control.SRR15539874;29;32;0.482758620689655;15;14;0.0172413793103448;0.482758620689655
Control.SRR15539874;35;32;0.371428571428571;22;13;0.128571428571429;0.371428571428571
Control.SRR15539874;36;32;0.444444444444444;20;16;0.0555555555555556;0.444444444444444
Control.SRR15539874;30;32;0.5;15;15;0;0.5
Control.SRR15539874;30;32;0.366666666666667;19;11;0.133333333333333;0.366666666666667
Control.SRR15539874;30;32;0.5;15;15;0;0.5
Control.SRR15539874;37;32;0.405405405405405;22;15;0.0945945945945946;0.405405405405405
Control.SRR15539874;30;32;0.466666666666667;16;14;0.0333333333333333;0.466666666666667
Control.SRR15539874;32;32;0.46875;17;15;0.03125;0.46875
Control.SRR15539874;32;32;0.625;12;20;0.125;0.375
Control.SRR15539874;30;32;0.533333333333333;14;16;0.0333333333333333;0.466666666666667
Control.SRR15539874;34;32;0.441176470588235;19;15;0.0588235294117647;0.441176470588235
Control.SRR15539874;30;32;0.6;12;18;0.1;0.4
Control.SRR15539874;34;32;0.441176470588235;19;15;0.0588235294117647;0.441176470588235
Control.SRR15539874;29;32;0.586206896551724;12;17;0.0862068965517241;0.413793103448276
Control.SRR15539874;30;32;0.666666666666667;10;20;0.166666666666667;0.333333333333333
Control.SRR15539874;34;32;0.382352941176471;21;13;0.117647058823529;0.382352941176471
Control.SRR15539874;32;32;0.6875;10;22;0.1875;0.3125
Control.SRR15539874;35;32;0.485714285714286;18;17;0.0142857142857143;0.485714285714286
Control.SRR15539874;30;32;0.566666666666667;13;17;0.0666666666666667;0.433333333333333
Control.SRR15539874;32;32;0.53125;15;17;0.03125;0.46875
Control.SRR15539874;33;32;0.484848484848485;17;16;0.0151515151515151;0.484848484848485
Control.SRR15539874;34;32;0.588235294117647;14;20;0.0882352941176471;0.411764705882353
Control.SRR15539874;31;32;0.451612903225806;17;14;0.0483870967741936;0.451612903225806
Control.SRR15539874;36;32;0.472222222222222;19;17;0.0277777777777778;0.472222222222222
Control.SRR15539874;37;32;0.459459459459459;20;17;0.0405405405405405;0.459459459459459
Control.SRR15539874;29;32;0.620689655172414;11;18;0.120689655172414;0.379310344827586
Control.SRR15539874;31;32;0.516129032258065;15;16;0.0161290322580645;0.483870967741935
Control.SRR15539874;31;32;0.516129032258065;15;16;0.0161290322580645;0.483870967741935
Control.SRR15539874;35;32;0.4;21;14;0.1;0.4
Control.SRR15539874;30;32;0.533333333333333;14;16;0.0333333333333333;0.466666666666667
Control.SRR15539874;35;32;0.457142857142857;19;16;0.0428571428571429;0.457142857142857
Control.SRR15539874;33;32;0.454545454545455;18;15;0.0454545454545455;0.454545454545455
Control.SRR15539874;31;32;0.645161290322581;11;20;0.145161290322581;0.354838709677419
Control.SRR15539874;37;32;0.378378378378378;23;14;0.121621621621622;0.378378378378378
Control.SRR15539874;31;32;0.419354838709677;18;13;0.0806451612903226;0.419354838709677
Control.SRR15539874;32;32;0.53125;15;17;0.03125;0.46875
Control.SRR15539874;31;32;0.516129032258065;15;16;0.0161290322580645;0.483870967741935
Control.SRR15539874;33;32;0.484848484848485;17;16;0.0151515151515151;0.484848484848485
Control.SRR15539874;36;32;0.416666666666667;21;15;0.0833333333333333;0.416666666666667
Control.SRR15539874;30;32;0.633333333333333;11;19;0.133333333333333;0.366666666666667
Control.SRR15539874;29;32;0.448275862068966;16;13;0.0517241379310345;0.448275862068966
Control.SRR15539874;32;32;0.375;20;12;0.125;0.375
Control.SRR15539874;32;32;0.625;12;20;0.125;0.375
Control.SRR15539874;33;32;0.636363636363636;12;21;0.136363636363636;0.363636363636364
Control.SRR15539874;33;32;0.515151515151515;16;17;0.0151515151515151;0.484848484848485
Control.SRR15539874;37;32;0.567567567567568;16;21;0.0675675675675675;0.432432432432432
Control.SRR15539874;32;32;0.4375;18;14;0.0625;0.4375
Control.SRR15539874;33;32;0.393939393939394;20;13;0.106060606060606;0.393939393939394
Control.SRR15539874;37;32;0.540540540540541;17;20;0.0405405405405406;0.459459459459459
Control.SRR15539874;33;32;0.515151515151515;16;17;0.0151515151515151;0.484848484848485
Control.SRR15539874;31;32;0.548387096774194;14;17;0.0483870967741935;0.451612903225806
Control.SRR15539874;31;32;0.516129032258065;15;16;0.0161290322580645;0.483870967741935
Control.SRR15539874;35;32;0.6;14;21;0.1;0.4
Control.SRR15539874;34;32;0.5;17;17;0;0.5
Control.SRR15539874;36;32;0.5;18;18;0;0.5
Control.SRR15539874;36;32;0.416666666666667;21;15;0.0833333333333333;0.416666666666667
Control.SRR15539874;31;32;0.580645161290323;13;18;0.0806451612903226;0.419354838709677
Control.SRR15539874;37;32;0.486486486486487;19;18;0.0135135135135135;0.486486486486487
Control.SRR15539874;29;32;0.551724137931034;13;16;0.0517241379310345;0.448275862068966
Control.SRR15539874;27;32;0.518518518518518;13;14;0.0185185185185185;0.481481481481481
Control.SRR15539874;28;32;0.678571428571429;9;19;0.178571428571429;0.321428571428571
Control.SRR15539874;29;32;0.724137931034483;8;21;0.224137931034483;0.275862068965517
Control.SRR15539874;33;32;0.545454545454545;15;18;0.0454545454545454;0.454545454545455
Control.SRR15539874;28;32;0.535714285714286;13;15;0.0357142857142857;0.464285714285714
Control.SRR15539874;27;32;0.62962962962963;10;17;0.12962962962963;0.37037037037037
Control.SRR15539874;31;32;0.645161290322581;11;20;0.145161290322581;0.354838709677419
Control.SRR15539874;27;32;0.518518518518518;13;14;0.0185185185185185;0.481481481481481
Control.SRR15539874;31;32;0.483870967741935;16;15;0.0161290322580645;0.483870967741935
Control.SRR15539874;27;32;0.592592592592593;11;16;0.0925925925925926;0.407407407407407
Control.SRR15539874;33;32;0.484848484848485;17;16;0.0151515151515151;0.484848484848485
Control.SRR15539874;28;32;0.607142857142857;11;17;0.107142857142857;0.392857142857143
Control.SRR15539874;33;32;0.424242424242424;19;14;0.0757575757575757;0.424242424242424
Control.SRR15539874;27;32;0.555555555555556;12;15;0.0555555555555556;0.444444444444444
Control.SRR15539874;35;32;0.428571428571429;20;15;0.0714285714285715;0.428571428571429
Control.SRR15539874;32;32;0.40625;19;13;0.09375;0.40625
Control.SRR15539874;30;32;0.366666666666667;19;11;0.133333333333333;0.366666666666667
Control.SRR15539874;31;32;0.612903225806452;12;19;0.112903225806452;0.387096774193548
Control.SRR15539874;33;32;0.424242424242424;19;14;0.0757575757575757;0.424242424242424
Control.SRR15539874;28;32;0.642857142857143;10;18;0.142857142857143;0.357142857142857
Control.SRR15539874;33;32;0.333333333333333;22;11;0.166666666666667;0.333333333333333
Control.SRR15539874;29;32;0.551724137931034;13;16;0.0517241379310345;0.448275862068966
Control.SRR15539874;35;32;0.514285714285714;17;18;0.0142857142857142;0.485714285714286
Control.SRR15539874;35;32;0.371428571428571;22;13;0.128571428571429;0.371428571428571
Control.SRR15539874;33;32;0.545454545454545;15;18;0.0454545454545454;0.454545454545455
Control.SRR15539874;35;32;0.571428571428571;15;20;0.0714285714285714;0.428571428571429
Control.SRR15539874;28;32;0.321428571428571;19;9;0.178571428571429;0.321428571428571
Control.SRR15539874;34;32;0.382352941176471;21;13;0.117647058823529;0.382352941176471
Control.SRR15539874;31;32;0.548387096774194;14;17;0.0483870967741935;0.451612903225806
Control.SRR15539874;32;32;0.53125;15;17;0.03125;0.46875
Control.SRR15539874;35;32;0.571428571428571;15;20;0.0714285714285714;0.428571428571429
Control.SRR15539874;31;32;0.548387096774194;14;17;0.0483870967741935;0.451612903225806
Control.SRR15539874;34;32;0.470588235294118;18;16;0.0294117647058824;0.470588235294118
Control.SRR15539874;28;32;0.642857142857143;10;18;0.142857142857143;0.357142857142857
Control.SRR15539874;30;32;0.5;15;15;0;0.5
Control.SRR15539874;35;32;0.428571428571429;20;15;0.0714285714285715;0.428571428571429
Control.SRR15539874;35;32;0.571428571428571;15;20;0.0714285714285714;0.428571428571429
Control.SRR15539874;34;32;0.558823529411765;15;19;0.0588235294117647;0.441176470588235
Control.SRR15539874;29;32;0.379310344827586;18;11;0.120689655172414;0.379310344827586
Control.SRR15539874;28;32;0.5;14;14;0;0.5
Control.SRR15539874;27;32;0.555555555555556;12;15;0.0555555555555556;0.444444444444444
Control.SRR15539874;31;32;0.451612903225806;17;14;0.0483870967741936;0.451612903225806
Control.SRR15539874;33;32;0.393939393939394;20;13;0.106060606060606;0.393939393939394
Control.SRR15539874;27;32;0.592592592592593;11;16;0.0925925925925926;0.407407407407407
Control.SRR15539874;29;32;0.413793103448276;17;12;0.0862068965517241;0.413793103448276
Control.SRR15539874;34;32;0.5;17;17;0;0.5
Control.SRR15539874;29;32;0.551724137931034;13;16;0.0517241379310345;0.448275862068966
Control.SRR15539874;33;32;0.515151515151515;16;17;0.0151515151515151;0.484848484848485
Control.SRR15539874;33;32;0.636363636363636;12;21;0.136363636363636;0.363636363636364
Control.SRR15539874;27;32;0.740740740740741;7;20;0.240740740740741;0.259259259259259
Control.SRR15539874;27;32;0.740740740740741;7;20;0.240740740740741;0.259259259259259
Control.SRR15539874;31;32;0.612903225806452;12;19;0.112903225806452;0.387096774193548
Control.SRR15539874;34;32;0.470588235294118;18;16;0.0294117647058824;0.470588235294118
Control.SRR15539874;31;32;0.354838709677419;20;11;0.145161290322581;0.354838709677419
Control.SRR15539874;34;32;0.382352941176471;21;13;0.117647058823529;0.382352941176471
Control.SRR15539874;32;32;0.625;12;20;0.125;0.375
Control.SRR15539874;34;32;0.588235294117647;14;20;0.0882352941176471;0.411764705882353
Control.SRR15539874;27;32;0.481481481481481;14;13;0.0185185185185185;0.481481481481481
Control.SRR15539874;32;32;0.3125;22;10;0.1875;0.3125
Control.SRR15539874;27;32;0.518518518518518;13;14;0.0185185185185185;0.481481481481481
Control.SRR15539874;32;32;0.5;16;16;0;0.5
Control.SRR15539874;27;32;0.444444444444444;15;12;0.0555555555555556;0.444444444444444
Control.SRR15539874;29;32;0.586206896551724;12;17;0.0862068965517241;0.413793103448276
Control.SRR15539874;28;32;0.464285714285714;15;13;0.0357142857142857;0.464285714285714
Control.SRR15539874;29;32;0.586206896551724;12;17;0.0862068965517241;0.413793103448276
Control.SRR15539874;31;32;0.548387096774194;14;17;0.0483870967741935;0.451612903225806
Control.SRR15539874;30;32;0.466666666666667;16;14;0.0333333333333333;0.466666666666667
Control.SRR15539874;34;32;0.588235294117647;14;20;0.0882352941176471;0.411764705882353
Control.SRR15539874;32;32;0.59375;13;19;0.09375;0.40625
Control.SRR15539874;28;32;0.428571428571429;16;12;0.0714285714285715;0.428571428571429
Control.SRR15539874;32;32;0.53125;15;17;0.03125;0.46875
Control.SRR15539874;33;32;0.515151515151515;16;17;0.0151515151515151;0.484848484848485
Control.SRR15539874;28;32;0.464285714285714;15;13;0.0357142857142857;0.464285714285714
Control.SRR15539874;28;32;0.464285714285714;15;13;0.0357142857142857;0.464285714285714
Control.SRR15539874;33;32;0.545454545454545;15;18;0.0454545454545454;0.454545454545455
Control.SRR15539874;29;32;0.448275862068966;16;13;0.0517241379310345;0.448275862068966
Control.SRR15539874;31;32;0.483870967741935;16;15;0.0161290322580645;0.483870967741935
Control.SRR15539874;33;32;0.575757575757576;14;19;0.0757575757575758;0.424242424242424
Control.SRR15539874;33;32;0.515151515151515;16;17;0.0151515151515151;0.484848484848485
Control.SRR15539874;28;32;0.571428571428571;12;16;0.0714285714285714;0.428571428571429
Control.SRR15539874;27;32;0.592592592592593;11;16;0.0925925925925926;0.407407407407407
Control.SRR15539874;27;32;0.37037037037037;17;10;0.12962962962963;0.37037037037037
Control.SRR15539874;31;32;0.483870967741935;16;15;0.0161290322580645;0.483870967741935
Control.SRR15539874;27;32;0.518518518518518;13;14;0.0185185185185185;0.481481481481481
Control.SRR15539874;34;32;0.411764705882353;20;14;0.0882352941176471;0.411764705882353
Control.SRR15539874;27;32;0.407407407407407;16;11;0.0925925925925926;0.407407407407407
Control.SRR15539874;32;32;0.5625;14;18;0.0625;0.4375
Control.SRR15539874;33;32;0.545454545454545;15;18;0.0454545454545454;0.454545454545455
Control.SRR15539874;34;32;0.411764705882353;20;14;0.0882352941176471;0.411764705882353
Control.SRR15539874;31;32;0.709677419354839;9;22;0.209677419354839;0.290322580645161
Control.SRR15539874;33;32;0.515151515151515;16;17;0.0151515151515151;0.484848484848485
Control.SRR15539874;28;32;0.464285714285714;15;13;0.0357142857142857;0.464285714285714
Control.SRR15539874;31;32;0.709677419354839;9;22;0.209677419354839;0.290322580645161
Control.SRR15539874;29;32;0.448275862068966;16;13;0.0517241379310345;0.448275862068966
Control.SRR15539874;30;32;0.466666666666667;16;14;0.0333333333333333;0.466666666666667
Control.SRR15539874;35;32;0.542857142857143;16;19;0.0428571428571428;0.457142857142857
Control.SRR15539874;29;32;0.689655172413793;9;20;0.189655172413793;0.310344827586207
Control.SRR15539874;30;32;0.6;12;18;0.1;0.4
Control.SRR15539874;30;32;0.466666666666667;16;14;0.0333333333333333;0.466666666666667
Control.SRR15539874;27;32;0.62962962962963;10;17;0.12962962962963;0.37037037037037
Control.SRR15539874;32;32;0.5;16;16;0;0.5
Control.SRR15539874;33;32;0.484848484848485;17;16;0.0151515151515151;0.484848484848485
Control.SRR15539874;33;32;0.484848484848485;17;16;0.0151515151515151;0.484848484848485
Control.SRR15539874;31;32;0.387096774193548;19;12;0.112903225806452;0.387096774193548
Control.SRR15539874;32;32;0.46875;17;15;0.03125;0.46875
Control.SRR15539874;31;32;0.290322580645161;22;9;0.209677419354839;0.290322580645161
Control.SRR15539874;33;32;0.424242424242424;19;14;0.0757575757575757;0.424242424242424
Control.SRR15539874;29;32;0.482758620689655;15;14;0.0172413793103448;0.482758620689655
Control.SRR15539874;34;32;0.441176470588235;19;15;0.0588235294117647;0.441176470588235
Control.SRR15539874;27;32;0.518518518518518;13;14;0.0185185185185185;0.481481481481481
Control.SRR15539874;27;32;0.592592592592593;11;16;0.0925925925925926;0.407407407407407
Control.SRR15539874;30;32;0.333333333333333;20;10;0.166666666666667;0.333333333333333
Control.SRR15539874;29;32;0.448275862068966;16;13;0.0517241379310345;0.448275862068966
Control.SRR15539874;31;32;0.419354838709677;18;13;0.0806451612903226;0.419354838709677
Control.SRR15539874;31;32;0.483870967741935;16;15;0.0161290322580645;0.483870967741935
Control.SRR15539874;28;32;0.535714285714286;13;15;0.0357142857142857;0.464285714285714
Control.SRR15539874;30;32;0.5;15;15;0;0.5
Control.SRR15539874;31;32;0.580645161290323;13;18;0.0806451612903226;0.419354838709677
Control.SRR15539874;35;32;0.542857142857143;16;19;0.0428571428571428;0.457142857142857
Control.SRR15539874;33;32;0.575757575757576;14;19;0.0757575757575758;0.424242424242424
Control.SRR15539874;32;32;0.53125;15;17;0.03125;0.46875
Control.SRR15539874;29;32;0.413793103448276;17;12;0.0862068965517241;0.413793103448276
Control.SRR15539874;27;32;0.518518518518518;13;14;0.0185185185185185;0.481481481481481
Control.SRR15539874;27;32;0.518518518518518;13;14;0.0185185185185185;0.481481481481481
Control.SRR15539874;32;32;0.53125;15;17;0.03125;0.46875
Control.SRR15539874;34;32;0.529411764705882;16;18;0.0294117647058824;0.470588235294118
Control.SRR15539874;32;32;0.5625;14;18;0.0625;0.4375
Control.SRR15539874;34;32;0.588235294117647;14;20;0.0882352941176471;0.411764705882353
Control.SRR15539874;30;32;0.566666666666667;13;17;0.0666666666666667;0.433333333333333
Control.SRR15539874;31;32;0.387096774193548;19;12;0.112903225806452;0.387096774193548
Control.SRR15539874;32;32;0.625;12;20;0.125;0.375
Control.SRR15539874;35;32;0.542857142857143;16;19;0.0428571428571428;0.457142857142857
Control.SRR15539874;30;32;0.566666666666667;13;17;0.0666666666666667;0.433333333333333
Control.SRR15539874;29;32;0.482758620689655;15;14;0.0172413793103448;0.482758620689655
Control.SRR15539874;30;32;0.533333333333333;14;16;0.0333333333333333;0.466666666666667
Control.SRR15539874;31;32;0.580645161290323;13;18;0.0806451612903226;0.419354838709677
Control.SRR15539874;28;32;0.428571428571429;16;12;0.0714285714285715;0.428571428571429
Control.SRR15539874;35;32;0.314285714285714;24;11;0.185714285714286;0.314285714285714
Control.SRR15539874;34;32;0.588235294117647;14;20;0.0882352941176471;0.411764705882353
Control.SRR15539874;30;32;0.5;15;15;0;0.5
Control.SRR15539874;27;32;0.592592592592593;11;16;0.0925925925925926;0.407407407407407
Control.SRR15539874;32;32;0.59375;13;19;0.09375;0.40625
Control.SRR15539874;30;32;0.5;15;15;0;0.5
Control.SRR15539874;31;32;0.451612903225806;17;14;0.0483870967741936;0.451612903225806
Control.SRR15539874;28;32;0.642857142857143;10;18;0.142857142857143;0.357142857142857
Control.SRR15539874;27;32;0.481481481481481;14;13;0.0185185185185185;0.481481481481481
Control.SRR15539874;29;32;0.482758620689655;15;14;0.0172413793103448;0.482758620689655
Control.SRR15539874;28;32;0.571428571428571;12;16;0.0714285714285714;0.428571428571429
Control.SRR15539874;27;32;0.444444444444444;15;12;0.0555555555555556;0.444444444444444
Control.SRR15539874;33;32;0.545454545454545;15;18;0.0454545454545454;0.454545454545455
Control.SRR15539874;31;32;0.516129032258065;15;16;0.0161290322580645;0.483870967741935
Control.SRR15539874;29;32;0.379310344827586;18;11;0.120689655172414;0.379310344827586
Control.SRR15539874;34;32;0.558823529411765;15;19;0.0588235294117647;0.441176470588235
Control.SRR15539874;32;32;0.53125;15;17;0.03125;0.46875
Control.SRR15539874;32;32;0.46875;17;15;0.03125;0.46875
Control.SRR15539874;32;32;0.53125;15;17;0.03125;0.46875
Control.SRR15539874;32;32;0.46875;17;15;0.03125;0.46875
Control.SRR15539874;34;32;0.441176470588235;19;15;0.0588235294117647;0.441176470588235
Control.SRR15539874;33;32;0.454545454545455;18;15;0.0454545454545455;0.454545454545455
Control.SRR15539874;35;32;0.571428571428571;15;20;0.0714285714285714;0.428571428571429
Control.SRR15539874;30;32;0.666666666666667;10;20;0.166666666666667;0.333333333333333
Control.SRR15539874;27;32;0.592592592592593;11;16;0.0925925925925926;0.407407407407407
Control.SRR15539874;35;32;0.485714285714286;18;17;0.0142857142857143;0.485714285714286
Control.SRR15539874;30;32;0.4;18;12;0.1;0.4
Control.SRR15539874;27;32;0.481481481481481;14;13;0.0185185185185185;0.481481481481481
Control.SRR15539874;30;32;0.566666666666667;13;17;0.0666666666666667;0.433333333333333
Control.SRR15539874;33;32;0.575757575757576;14;19;0.0757575757575758;0.424242424242424
Control.SRR15539874;27;32;0.592592592592593;11;16;0.0925925925925926;0.407407407407407
Control.SRR15539874;28;32;0.535714285714286;13;15;0.0357142857142857;0.464285714285714
Control.SRR15539874;31;32;0.580645161290323;13;18;0.0806451612903226;0.419354838709677
Control.SRR15539874;29;32;0.379310344827586;18;11;0.120689655172414;0.379310344827586
Control.SRR15539874;33;32;0.515151515151515;16;17;0.0151515151515151;0.484848484848485
Control.SRR15539874;33;32;0.484848484848485;17;16;0.0151515151515151;0.484848484848485
Control.SRR15539874;27;32;0.592592592592593;11;16;0.0925925925925926;0.407407407407407
Control.SRR15539874;32;32;0.4375;18;14;0.0625;0.4375
Control.SRR15539874;28;32;0.464285714285714;15;13;0.0357142857142857;0.464285714285714
Control.SRR15539874;28;32;0.535714285714286;13;15;0.0357142857142857;0.464285714285714
Control.SRR15539874;28;32;0.285714285714286;20;8;0.214285714285714;0.285714285714286
Control.SRR15539874;31;32;0.451612903225806;17;14;0.0483870967741936;0.451612903225806
Control.SRR15539874;30;32;0.566666666666667;13;17;0.0666666666666667;0.433333333333333
Control.SRR15539874;32;32;0.46875;17;15;0.03125;0.46875
Control.SRR15539874;32;32;0.5625;14;18;0.0625;0.4375
Control.SRR15539874;27;32;0.481481481481481;14;13;0.0185185185185185;0.481481481481481
Control.SRR15539874;29;32;0.482758620689655;15;14;0.0172413793103448;0.482758620689655
Control.SRR15539874;33;32;0.424242424242424;19;14;0.0757575757575757;0.424242424242424
Control.SRR15539874;33;32;0.606060606060606;13;20;0.106060606060606;0.393939393939394
Control.SRR15539874;29;32;0.620689655172414;11;18;0.120689655172414;0.379310344827586
Control.SRR15539874;28;32;0.428571428571429;16;12;0.0714285714285715;0.428571428571429
Control.SRR15539874;27;32;0.481481481481481;14;13;0.0185185185185185;0.481481481481481
Control.SRR15539874;27;32;0.703703703703704;8;19;0.203703703703704;0.296296296296296
Control.SRR15539874;31;32;0.612903225806452;12;19;0.112903225806452;0.387096774193548
Control.SRR15539874;35;32;0.457142857142857;19;16;0.0428571428571429;0.457142857142857
Control.SRR15539874;33;32;0.454545454545455;18;15;0.0454545454545455;0.454545454545455
Control.SRR15539874;29;32;0.689655172413793;9;20;0.189655172413793;0.310344827586207
Control.SRR15539874;31;32;0.483870967741935;16;15;0.0161290322580645;0.483870967741935
Control.SRR15539874;32;32;0.59375;13;19;0.09375;0.40625
Control.SRR15539874;27;32;0.666666666666667;9;18;0.166666666666667;0.333333333333333
Control.SRR15539874;30;32;0.466666666666667;16;14;0.0333333333333333;0.466666666666667
Control.SRR15539874;33;32;0.484848484848485;17;16;0.0151515151515151;0.484848484848485
Control.SRR15539874;34;32;0.5;17;17;0;0.5
Control.SRR15539874;33;32;0.515151515151515;16;17;0.0151515151515151;0.484848484848485
Control.SRR15539874;34;32;0.441176470588235;19;15;0.0588235294117647;0.441176470588235
Control.SRR15539874;30;32;0.466666666666667;16;14;0.0333333333333333;0.466666666666667
Control.SRR15539874;29;32;0.551724137931034;13;16;0.0517241379310345;0.448275862068966
Control.SRR15539874;31;32;0.483870967741935;16;15;0.0161290322580645;0.483870967741935
Control.SRR15539874;31;32;0.516129032258065;15;16;0.0161290322580645;0.483870967741935
Control.SRR15539874;33;32;0.454545454545455;18;15;0.0454545454545455;0.454545454545455
Control.SRR15539874;30;32;0.566666666666667;13;17;0.0666666666666667;0.433333333333333
Control.SRR15539874;27;32;0.37037037037037;17;10;0.12962962962963;0.37037037037037
Control.SRR15539874;33;32;0.454545454545455;18;15;0.0454545454545455;0.454545454545455
Control.SRR15539874;30;32;0.5;15;15;0;0.5
Control.SRR15539874;33;32;0.545454545454545;15;18;0.0454545454545454;0.454545454545455
Control.SRR15539874;30;32;0.333333333333333;20;10;0.166666666666667;0.333333333333333
Control.SRR15539874;31;32;0.580645161290323;13;18;0.0806451612903226;0.419354838709677
Control.SRR15539874;33;32;0.363636363636364;21;12;0.136363636363636;0.363636363636364
Control.SRR15539874;33;32;0.575757575757576;14;19;0.0757575757575758;0.424242424242424
Control.SRR15539874;29;32;0.413793103448276;17;12;0.0862068965517241;0.413793103448276
Control.SRR15539874;27;32;0.407407407407407;16;11;0.0925925925925926;0.407407407407407
Control.SRR15539874;30;32;0.533333333333333;14;16;0.0333333333333333;0.466666666666667
Control.SRR15539874;31;32;0.612903225806452;12;19;0.112903225806452;0.387096774193548
Control.SRR15539874;27;32;0.481481481481481;14;13;0.0185185185185185;0.481481481481481
Control.SRR15539874;33;32;0.575757575757576;14;19;0.0757575757575758;0.424242424242424
Control.SRR15539874;31;32;0.548387096774194;14;17;0.0483870967741935;0.451612903225806
Control.SRR15539874;31;32;0.483870967741935;16;15;0.0161290322580645;0.483870967741935
Control.SRR15539874;32;32;0.4375;18;14;0.0625;0.4375
Control.SRR15539874;34;32;0.617647058823529;13;21;0.117647058823529;0.382352941176471
Control.SRR15539874;33;32;0.636363636363636;12;21;0.136363636363636;0.363636363636364
Control.SRR15539874;32;32;0.5;16;16;0;0.5
Control.SRR15539874;30;32;0.566666666666667;13;17;0.0666666666666667;0.433333333333333
Control.SRR15539874;32;32;0.4375;18;14;0.0625;0.4375
Control.SRR15539874;27;32;0.481481481481481;14;13;0.0185185185185185;0.481481481481481
Control.SRR15539874;29;32;0.586206896551724;12;17;0.0862068965517241;0.413793103448276
Control.SRR15539874;32;32;0.375;20;12;0.125;0.375
Control.SRR15539874;35;32;0.714285714285714;10;25;0.214285714285714;0.285714285714286
Control.SRR15539874;33;32;0.454545454545455;18;15;0.0454545454545455;0.454545454545455
Control.SRR15539874;34;32;0.588235294117647;14;20;0.0882352941176471;0.411764705882353
Control.SRR15539874;27;32;0.481481481481481;14;13;0.0185185185185185;0.481481481481481
Control.SRR15539874;30;32;0.366666666666667;19;11;0.133333333333333;0.366666666666667
Control.SRR15539874;30;32;0.666666666666667;10;20;0.166666666666667;0.333333333333333
Control.SRR15539874;31;32;0.387096774193548;19;12;0.112903225806452;0.387096774193548
Control.SRR15539874;28;32;0.535714285714286;13;15;0.0357142857142857;0.464285714285714
Control.SRR15539874;28;32;0.464285714285714;15;13;0.0357142857142857;0.464285714285714
Control.SRR15539874;28;32;0.642857142857143;10;18;0.142857142857143;0.357142857142857
Control.SRR15539874;30;32;0.6;12;18;0.1;0.4
Control.SRR15539874;27;32;0.518518518518518;13;14;0.0185185185185185;0.481481481481481
Control.SRR15539874;33;32;0.454545454545455;18;15;0.0454545454545455;0.454545454545455
Control.SRR15539874;32;32;0.4375;18;14;0.0625;0.4375
Control.SRR15539874;34;32;0.735294117647059;9;25;0.235294117647059;0.264705882352941
Control.SRR15539874;33;32;0.606060606060606;13;20;0.106060606060606;0.393939393939394
Control.SRR15539874;29;32;0.517241379310345;14;15;0.0172413793103449;0.482758620689655
Control.SRR15539874;29;32;0.551724137931034;13;16;0.0517241379310345;0.448275862068966
Control.SRR15539874;33;32;0.393939393939394;20;13;0.106060606060606;0.393939393939394
Control.SRR15539874;34;32;0.588235294117647;14;20;0.0882352941176471;0.411764705882353
Control.SRR15539874;29;32;0.344827586206897;19;10;0.155172413793103;0.344827586206897
Control.SRR15539874;34;32;0.382352941176471;21;13;0.117647058823529;0.382352941176471
Control.SRR15539874;30;32;0.533333333333333;14;16;0.0333333333333333;0.466666666666667
Control.SRR15539874;32;32;0.375;20;12;0.125;0.375
Control.SRR15539874;34;32;0.588235294117647;14;20;0.0882352941176471;0.411764705882353
Control.SRR15539874;35;32;0.428571428571429;20;15;0.0714285714285715;0.428571428571429
Control.SRR15539874;31;32;0.451612903225806;17;14;0.0483870967741936;0.451612903225806
Control.SRR15539874;31;32;0.580645161290323;13;18;0.0806451612903226;0.419354838709677
Control.SRR15539874;34;32;0.588235294117647;14;20;0.0882352941176471;0.411764705882353
Control.SRR15539874;35;32;0.571428571428571;15;20;0.0714285714285714;0.428571428571429
Control.SRR15539874;35;32;0.457142857142857;19;16;0.0428571428571429;0.457142857142857
Control.SRR15539874;33;32;0.363636363636364;21;12;0.136363636363636;0.363636363636364
Control.SRR15539874;32;32;0.34375;21;11;0.15625;0.34375
Control.SRR15539874;32;32;0.59375;13;19;0.09375;0.40625
Control.SRR15539874;33;32;0.515151515151515;16;17;0.0151515151515151;0.484848484848485
Control.SRR15539874;31;32;0.419354838709677;18;13;0.0806451612903226;0.419354838709677
Control.SRR15539874;31;32;0.612903225806452;12;19;0.112903225806452;0.387096774193548
Control.SRR15539874;28;32;0.464285714285714;15;13;0.0357142857142857;0.464285714285714
Control.SRR15539874;28;32;0.642857142857143;10;18;0.142857142857143;0.357142857142857
Control.SRR15539874;29;32;0.413793103448276;17;12;0.0862068965517241;0.413793103448276
Control.SRR15539874;34;32;0.470588235294118;18;16;0.0294117647058824;0.470588235294118
Control.SRR15539874;29;32;0.448275862068966;16;13;0.0517241379310345;0.448275862068966
Control.SRR15539874;28;32;0.392857142857143;17;11;0.107142857142857;0.392857142857143
Control.SRR15539874;33;32;0.454545454545455;18;15;0.0454545454545455;0.454545454545455
Control.SRR15539874;32;32;0.5625;14;18;0.0625;0.4375
Control.SRR15539874;27;32;0.740740740740741;7;20;0.240740740740741;0.259259259259259
Control.SRR15539874;34;32;0.588235294117647;14;20;0.0882352941176471;0.411764705882353
Control.SRR15539874;32;32;0.4375;18;14;0.0625;0.4375
Control.SRR15539874;35;32;0.542857142857143;16;19;0.0428571428571428;0.457142857142857
Control.SRR15539874;33;32;0.484848484848485;17;16;0.0151515151515151;0.484848484848485
Control.SRR15539874;34;32;0.441176470588235;19;15;0.0588235294117647;0.441176470588235
Control.SRR15539874;35;32;0.571428571428571;15;20;0.0714285714285714;0.428571428571429
Control.SRR15539874;28;32;0.464285714285714;15;13;0.0357142857142857;0.464285714285714
Control.SRR15539874;28;32;0.642857142857143;10;18;0.142857142857143;0.357142857142857
Control.SRR15539874;33;32;0.545454545454545;15;18;0.0454545454545454;0.454545454545455
Control.SRR15539874;34;32;0.470588235294118;18;16;0.0294117647058824;0.470588235294118
Control.SRR15539874;29;32;0.586206896551724;12;17;0.0862068965517241;0.413793103448276
Control.SRR15539874;30;32;0.466666666666667;16;14;0.0333333333333333;0.466666666666667
Control.SRR15539874;35;32;0.6;14;21;0.1;0.4
Control.SRR15539874;34;32;0.411764705882353;20;14;0.0882352941176471;0.411764705882353
Control.SRR15539874;29;32;0.586206896551724;12;17;0.0862068965517241;0.413793103448276
Control.SRR15539874;30;32;0.633333333333333;11;19;0.133333333333333;0.366666666666667
Control.SRR15539874;35;32;0.6;14;21;0.1;0.4
Control.SRR15539874;32;32;0.46875;17;15;0.03125;0.46875
Control.SRR15539874;30;32;0.366666666666667;19;11;0.133333333333333;0.366666666666667
Control.SRR15539874;35;32;0.542857142857143;16;19;0.0428571428571428;0.457142857142857
Control.SRR15539874;33;32;0.454545454545455;18;15;0.0454545454545455;0.454545454545455
Control.SRR15539874;32;32;0.5625;14;18;0.0625;0.4375
Control.SRR15539874;31;32;0.548387096774194;14;17;0.0483870967741935;0.451612903225806
Control.SRR15539874;30;32;0.533333333333333;14;16;0.0333333333333333;0.466666666666667
Control.SRR15539874;27;32;0.518518518518518;13;14;0.0185185185185185;0.481481481481481
Control.SRR15539874;34;32;0.352941176470588;22;12;0.147058823529412;0.352941176470588
Control.SRR15539874;34;32;0.647058823529412;12;22;0.147058823529412;0.352941176470588
Control.SRR15539874;29;32;0.551724137931034;13;16;0.0517241379310345;0.448275862068966
Control.SRR15539874;34;32;0.558823529411765;15;19;0.0588235294117647;0.441176470588235
Control.SRR15539874;32;32;0.5625;14;18;0.0625;0.4375
Control.SRR15539874;35;32;0.628571428571429;13;22;0.128571428571429;0.371428571428571
Control.SRR15539874;35;32;0.6;14;21;0.1;0.4
Control.SRR15539874;31;32;0.612903225806452;12;19;0.112903225806452;0.387096774193548
Control.SRR15539874;35;32;0.514285714285714;17;18;0.0142857142857142;0.485714285714286
Control.SRR15539874;35;32;0.485714285714286;18;17;0.0142857142857143;0.485714285714286
Control.SRR15539874;34;32;0.382352941176471;21;13;0.117647058823529;0.382352941176471
Control.SRR15539874;27;32;0.481481481481481;14;13;0.0185185185185185;0.481481481481481
Control.SRR15539874;27;32;0.481481481481481;14;13;0.0185185185185185;0.481481481481481
Control.SRR15539874;28;32;0.428571428571429;16;12;0.0714285714285715;0.428571428571429
Control.SRR15539874;34;32;0.411764705882353;20;14;0.0882352941176471;0.411764705882353
Control.SRR15539874;32;32;0.375;20;12;0.125;0.375
Control.SRR15539874;34;32;0.235294117647059;26;8;0.264705882352941;0.235294117647059
Control.SRR15539874;32;32;0.5;16;16;0;0.5
Control.SRR15539874;27;32;0.518518518518518;13;14;0.0185185185185185;0.481481481481481
Control.SRR15539874;34;32;0.617647058823529;13;21;0.117647058823529;0.382352941176471
Control.SRR15539874;29;32;0.482758620689655;15;14;0.0172413793103448;0.482758620689655
Control.SRR15539874;35;32;0.457142857142857;19;16;0.0428571428571429;0.457142857142857
Control.SRR15539874;27;32;0.518518518518518;13;14;0.0185185185185185;0.481481481481481
Control.SRR15539874;34;32;0.470588235294118;18;16;0.0294117647058824;0.470588235294118
Control.SRR15539874;30;32;0.5;15;15;0;0.5
Control.SRR15539874;32;32;0.3125;22;10;0.1875;0.3125
Control.SRR15539874;27;32;0.444444444444444;15;12;0.0555555555555556;0.444444444444444
Control.SRR15539874;33;32;0.393939393939394;20;13;0.106060606060606;0.393939393939394
Control.SRR15539874;35;32;0.4;21;14;0.1;0.4
Control.SRR15539874;30;32;0.466666666666667;16;14;0.0333333333333333;0.466666666666667
Control.SRR15539874;31;32;0.451612903225806;17;14;0.0483870967741936;0.451612903225806
Control.SRR15539874;30;32;0.5;15;15;0;0.5
Control.SRR15539874;31;32;0.451612903225806;17;14;0.0483870967741936;0.451612903225806
Control.SRR15539874;32;32;0.5625;14;18;0.0625;0.4375
Control.SRR15539874;31;32;0.548387096774194;14;17;0.0483870967741935;0.451612903225806
Control.SRR15539874;27;32;0.518518518518518;13;14;0.0185185185185185;0.481481481481481
Control.SRR15539874;34;32;0.411764705882353;20;14;0.0882352941176471;0.411764705882353
Control.SRR15539874;27;32;0.555555555555556;12;15;0.0555555555555556;0.444444444444444
Control.SRR15539874;29;32;0.517241379310345;14;15;0.0172413793103449;0.482758620689655
Control.SRR15539874;30;32;0.5;15;15;0;0.5
Control.SRR15539874;34;32;0.352941176470588;22;12;0.147058823529412;0.352941176470588
Control.SRR15539874;34;32;0.588235294117647;14;20;0.0882352941176471;0.411764705882353
Control.SRR15539874;27;32;0.407407407407407;16;11;0.0925925925925926;0.407407407407407
Control.SRR15539874;31;32;0.419354838709677;18;13;0.0806451612903226;0.419354838709677
Control.SRR15539874;32;32;0.46875;17;15;0.03125;0.46875
Control.SRR15539874;30;32;0.633333333333333;11;19;0.133333333333333;0.366666666666667
Control.SRR15539874;30;32;0.4;18;12;0.1;0.4
Control.SRR15539874;34;32;0.617647058823529;13;21;0.117647058823529;0.382352941176471
Control.SRR15539874;35;32;0.428571428571429;20;15;0.0714285714285715;0.428571428571429
Control.SRR15539874;32;32;0.5;16;16;0;0.5
Control.SRR15539874;31;32;0.741935483870968;8;23;0.241935483870968;0.258064516129032
Control.SRR15539874;32;32;0.625;12;20;0.125;0.375
Control.SRR15539874;32;32;0.5625;14;18;0.0625;0.4375
Control.SRR15539874;34;32;0.588235294117647;14;20;0.0882352941176471;0.411764705882353
Control.SRR15539874;35;32;0.457142857142857;19;16;0.0428571428571429;0.457142857142857
Control.SRR15539874;35;32;0.371428571428571;22;13;0.128571428571429;0.371428571428571
Control.SRR15539874;34;32;0.5;17;17;0;0.5
Control.SRR15539874;33;32;0.545454545454545;15;18;0.0454545454545454;0.454545454545455
Control.SRR15539874;33;32;0.575757575757576;14;19;0.0757575757575758;0.424242424242424
Control.SRR15539874;30;32;0.566666666666667;13;17;0.0666666666666667;0.433333333333333
Control.SRR15539874;33;32;0.545454545454545;15;18;0.0454545454545454;0.454545454545455
Control.SRR15539874;32;32;0.53125;15;17;0.03125;0.46875
Control.SRR15539874;33;32;0.545454545454545;15;18;0.0454545454545454;0.454545454545455
Control.SRR15539874;35;32;0.342857142857143;23;12;0.157142857142857;0.342857142857143
Control.SRR15539874;31;32;0.612903225806452;12;19;0.112903225806452;0.387096774193548
Control.SRR15539874;28;32;0.392857142857143;17;11;0.107142857142857;0.392857142857143
Control.SRR15539874;34;32;0.352941176470588;22;12;0.147058823529412;0.352941176470588
Control.SRR15539874;33;32;0.484848484848485;17;16;0.0151515151515151;0.484848484848485
Control.SRR15539874;33;32;0.666666666666667;11;22;0.166666666666667;0.333333333333333
Control.SRR15539874;30;32;0.533333333333333;14;16;0.0333333333333333;0.466666666666667
Control.SRR15539874;34;32;0.264705882352941;25;9;0.235294117647059;0.264705882352941
Control.SRR15539874;29;32;0.448275862068966;16;13;0.0517241379310345;0.448275862068966
Control.SRR15539874;35;32;0.542857142857143;16;19;0.0428571428571428;0.457142857142857
Control.SRR15539874;33;32;0.515151515151515;16;17;0.0151515151515151;0.484848484848485
Control.SRR15539874;34;32;0.470588235294118;18;16;0.0294117647058824;0.470588235294118
Control.SRR15539874;29;32;0.551724137931034;13;16;0.0517241379310345;0.448275862068966
Control.SRR15539874;31;32;0.612903225806452;12;19;0.112903225806452;0.387096774193548
Control.SRR15539874;34;32;0.470588235294118;18;16;0.0294117647058824;0.470588235294118
Control.SRR15539874;35;32;0.428571428571429;20;15;0.0714285714285715;0.428571428571429
Control.SRR15539874;33;32;0.575757575757576;14;19;0.0757575757575758;0.424242424242424
Control.SRR15539874;31;32;0.483870967741935;16;15;0.0161290322580645;0.483870967741935
Control.SRR15539874;29;32;0.413793103448276;17;12;0.0862068965517241;0.413793103448276
Control.SRR15539874;29;32;0.344827586206897;19;10;0.155172413793103;0.344827586206897
Control.SRR15539874;30;32;0.466666666666667;16;14;0.0333333333333333;0.466666666666667
Control.SRR15539874;35;32;0.428571428571429;20;15;0.0714285714285715;0.428571428571429
Control.SRR15539874;27;32;0.37037037037037;17;10;0.12962962962963;0.37037037037037
Control.SRR15539874;30;32;0.5;15;15;0;0.5
Control.SRR15539874;27;32;0.555555555555556;12;15;0.0555555555555556;0.444444444444444
Control.SRR15539874;30;32;0.433333333333333;17;13;0.0666666666666667;0.433333333333333
Control.SRR15539874;29;32;0.655172413793103;10;19;0.155172413793103;0.344827586206897
Control.SRR15539874;32;32;0.5625;14;18;0.0625;0.4375
Control.SRR15539874;32;32;0.46875;17;15;0.03125;0.46875
Control.SRR15539874;34;32;0.411764705882353;20;14;0.0882352941176471;0.411764705882353
Control.SRR15539874;30;32;0.433333333333333;17;13;0.0666666666666667;0.433333333333333
Control.SRR15539874;35;32;0.514285714285714;17;18;0.0142857142857142;0.485714285714286
Control.SRR15539874;30;32;0.433333333333333;17;13;0.0666666666666667;0.433333333333333
Control.SRR15539874;30;32;0.4;18;12;0.1;0.4
Control.SRR15539874;30;32;0.533333333333333;14;16;0.0333333333333333;0.466666666666667
Control.SRR15539874;27;32;0.407407407407407;16;11;0.0925925925925926;0.407407407407407
Control.SRR15539874;32;32;0.59375;13;19;0.09375;0.40625
Control.SRR15539874;32;32;0.59375;13;19;0.09375;0.40625
Control.SRR15539874;32;32;0.625;12;20;0.125;0.375
Control.SRR15539874;31;32;0.483870967741935;16;15;0.0161290322580645;0.483870967741935
Control.SRR15539874;31;32;0.483870967741935;16;15;0.0161290322580645;0.483870967741935
Control.SRR15539874;31;32;0.483870967741935;16;15;0.0161290322580645;0.483870967741935
Control.SRR15539874;28;32;0.5;14;14;0;0.5
Control.SRR15539874;33;32;0.454545454545455;18;15;0.0454545454545455;0.454545454545455
Control.SRR15539874;29;32;0.620689655172414;11;18;0.120689655172414;0.379310344827586
Control.SRR15539874;32;32;0.5625;14;18;0.0625;0.4375
Control.SRR15539874;28;32;0.535714285714286;13;15;0.0357142857142857;0.464285714285714
Control.SRR15539874;31;32;0.516129032258065;15;16;0.0161290322580645;0.483870967741935
Control.SRR15539874;32;32;0.59375;13;19;0.09375;0.40625
Control.SRR15539874;34;32;0.5;17;17;0;0.5
Control.SRR15539874;34;32;0.558823529411765;15;19;0.0588235294117647;0.441176470588235
Control.SRR15539874;32;32;0.5;16;16;0;0.5
Control.SRR15539874;29;32;0.586206896551724;12;17;0.0862068965517241;0.413793103448276
Control.SRR15539874;30;32;0.5;15;15;0;0.5
Control.SRR15539874;35;32;0.371428571428571;22;13;0.128571428571429;0.371428571428571
Control.SRR15539874;33;32;0.545454545454545;15;18;0.0454545454545454;0.454545454545455
Control.SRR15539874;29;32;0.379310344827586;18;11;0.120689655172414;0.379310344827586
Control.SRR15539874;35;32;0.6;14;21;0.1;0.4
Control.SRR15539874;28;32;0.357142857142857;18;10;0.142857142857143;0.357142857142857
Control.SRR15539874;29;32;0.551724137931034;13;16;0.0517241379310345;0.448275862068966
Control.SRR15539874;29;32;0.413793103448276;17;12;0.0862068965517241;0.413793103448276
Control.SRR15539874;28;32;0.714285714285714;8;20;0.214285714285714;0.285714285714286
Control.SRR15539874;31;32;0.354838709677419;20;11;0.145161290322581;0.354838709677419
Control.SRR15539874;27;32;0.666666666666667;9;18;0.166666666666667;0.333333333333333
Control.SRR15539874;31;32;0.387096774193548;19;12;0.112903225806452;0.387096774193548
Control.SRR15539874;34;32;0.441176470588235;19;15;0.0588235294117647;0.441176470588235
Control.SRR15539874;34;32;0.558823529411765;15;19;0.0588235294117647;0.441176470588235
Control.SRR15539874;34;32;0.470588235294118;18;16;0.0294117647058824;0.470588235294118
Control.SRR15539874;28;32;0.607142857142857;11;17;0.107142857142857;0.392857142857143
Control.SRR15539874;32;32;0.53125;15;17;0.03125;0.46875
Control.SRR15539874;34;32;0.647058823529412;12;22;0.147058823529412;0.352941176470588
Control.SRR15539874;27;32;0.703703703703704;8;19;0.203703703703704;0.296296296296296
Control.SRR15539874;31;32;0.387096774193548;19;12;0.112903225806452;0.387096774193548
Control.SRR15539874;28;32;0.642857142857143;10;18;0.142857142857143;0.357142857142857
Control.SRR15539874;31;32;0.483870967741935;16;15;0.0161290322580645;0.483870967741935
Control.SRR15539874;34;32;0.529411764705882;16;18;0.0294117647058824;0.470588235294118
Control.SRR15539874;33;32;0.515151515151515;16;17;0.0151515151515151;0.484848484848485
Control.SRR15539874;30;32;0.533333333333333;14;16;0.0333333333333333;0.466666666666667
Control.SRR15539874;34;32;0.529411764705882;16;18;0.0294117647058824;0.470588235294118
Control.SRR15539874;33;32;0.545454545454545;15;18;0.0454545454545454;0.454545454545455
Control.SRR15539874;30;32;0.333333333333333;20;10;0.166666666666667;0.333333333333333
Control.SRR15539874;34;32;0.441176470588235;19;15;0.0588235294117647;0.441176470588235
Control.SRR15539874;31;32;0.516129032258065;15;16;0.0161290322580645;0.483870967741935
Control.SRR15539874;29;32;0.517241379310345;14;15;0.0172413793103449;0.482758620689655
Control.SRR15539874;30;32;0.5;15;15;0;0.5
Control.SRR15539874;30;32;0.633333333333333;11;19;0.133333333333333;0.366666666666667
Control.SRR15539874;30;32;0.433333333333333;17;13;0.0666666666666667;0.433333333333333
Control.SRR15539874;27;32;0.592592592592593;11;16;0.0925925925925926;0.407407407407407
Control.SRR15539874;34;32;0.470588235294118;18;16;0.0294117647058824;0.470588235294118
Control.SRR15539874;32;32;0.46875;17;15;0.03125;0.46875
Control.SRR15539874;33;32;0.606060606060606;13;20;0.106060606060606;0.393939393939394
Control.SRR15539874;32;32;0.53125;15;17;0.03125;0.46875
Control.SRR15539874;31;32;0.451612903225806;17;14;0.0483870967741936;0.451612903225806
Control.SRR15539874;32;32;0.40625;19;13;0.09375;0.40625
Control.SRR15539874;33;32;0.424242424242424;19;14;0.0757575757575757;0.424242424242424
Control.SRR15539874;30;32;0.333333333333333;20;10;0.166666666666667;0.333333333333333
Control.SRR15539874;33;32;0.424242424242424;19;14;0.0757575757575757;0.424242424242424
Control.SRR15539874;33;32;0.393939393939394;20;13;0.106060606060606;0.393939393939394
Control.SRR15539874;34;32;0.5;17;17;0;0.5
Control.SRR15539874;28;32;0.392857142857143;17;11;0.107142857142857;0.392857142857143
Control.SRR15539874;30;32;0.466666666666667;16;14;0.0333333333333333;0.466666666666667
Control.SRR15539874;27;32;0.518518518518518;13;14;0.0185185185185185;0.481481481481481
Control.SRR15539874;32;32;0.59375;13;19;0.09375;0.40625
Control.SRR15539874;33;32;0.575757575757576;14;19;0.0757575757575758;0.424242424242424
Control.SRR15539874;32;32;0.625;12;20;0.125;0.375
Control.SRR15539874;30;32;0.6;12;18;0.1;0.4
Control.SRR15539874;30;32;0.5;15;15;0;0.5
Control.SRR15539874;33;32;0.363636363636364;21;12;0.136363636363636;0.363636363636364
Control.SRR15539874;30;32;0.466666666666667;16;14;0.0333333333333333;0.466666666666667
Control.SRR15539874;35;32;0.371428571428571;22;13;0.128571428571429;0.371428571428571
Control.SRR15539874;27;32;0.37037037037037;17;10;0.12962962962963;0.37037037037037
Control.SRR15539874;32;32;0.625;12;20;0.125;0.375
Control.SRR15539874;31;32;0.548387096774194;14;17;0.0483870967741935;0.451612903225806
Control.SRR15539874;33;32;0.606060606060606;13;20;0.106060606060606;0.393939393939394
Control.SRR15539874;27;32;0.444444444444444;15;12;0.0555555555555556;0.444444444444444
Control.SRR15539874;32;32;0.46875;17;15;0.03125;0.46875
Control.SRR15539874;34;32;0.735294117647059;9;25;0.235294117647059;0.264705882352941
Control.SRR15539874;28;32;0.5;14;14;0;0.5
Control.SRR15539874;28;32;0.321428571428571;19;9;0.178571428571429;0.321428571428571
Control.SRR15539874;30;32;0.566666666666667;13;17;0.0666666666666667;0.433333333333333
Control.SRR15539874;34;32;0.529411764705882;16;18;0.0294117647058824;0.470588235294118
Control.SRR15539874;32;32;0.5;16;16;0;0.5
Control.SRR15539874;31;32;0.193548387096774;25;6;0.306451612903226;0.193548387096774
Control.SRR15539874;32;32;0.46875;17;15;0.03125;0.46875
Control.SRR15539874;29;32;0.379310344827586;18;11;0.120689655172414;0.379310344827586
Control.SRR15539874;30;32;0.566666666666667;13;17;0.0666666666666667;0.433333333333333
Control.SRR15539874;30;32;0.3;21;9;0.2;0.3
Control.SRR15539874;32;32;0.53125;15;17;0.03125;0.46875
Control.SRR15539874;33;32;0.454545454545455;18;15;0.0454545454545455;0.454545454545455
Control.SRR15539874;29;32;0.379310344827586;18;11;0.120689655172414;0.379310344827586
Control.SRR15539874;32;32;0.34375;21;11;0.15625;0.34375
Control.SRR15539874;28;32;0.464285714285714;15;13;0.0357142857142857;0.464285714285714
Control.SRR15539874;28;32;0.464285714285714;15;13;0.0357142857142857;0.464285714285714
Control.SRR15539874;31;32;0.258064516129032;23;8;0.241935483870968;0.258064516129032
Control.SRR15539874;31;32;0.451612903225806;17;14;0.0483870967741936;0.451612903225806
Control.SRR15539874;30;32;0.633333333333333;11;19;0.133333333333333;0.366666666666667
Control.SRR15539874;32;32;0.5;16;16;0;0.5
Control.SRR15539874;30;32;0.566666666666667;13;17;0.0666666666666667;0.433333333333333
Control.SRR15539874;29;32;0.448275862068966;16;13;0.0517241379310345;0.448275862068966
Control.SRR15539874;34;32;0.529411764705882;16;18;0.0294117647058824;0.470588235294118
Control.SRR15539874;29;32;0.448275862068966;16;13;0.0517241379310345;0.448275862068966
Control.SRR15539874;28;32;0.5;14;14;0;0.5
Control.SRR15539874;31;32;0.290322580645161;22;9;0.209677419354839;0.290322580645161
Control.SRR15539874;31;32;0.354838709677419;20;11;0.145161290322581;0.354838709677419
Control.SRR15539874;30;32;0.566666666666667;13;17;0.0666666666666667;0.433333333333333
Control.SRR15539874;34;32;0.382352941176471;21;13;0.117647058823529;0.382352941176471
Control.SRR15539874;27;32;0.62962962962963;10;17;0.12962962962963;0.37037037037037
Control.SRR15539874;32;32;0.46875;17;15;0.03125;0.46875
Control.SRR15539874;34;32;0.441176470588235;19;15;0.0588235294117647;0.441176470588235
Control.SRR15539874;32;32;0.46875;17;15;0.03125;0.46875
Control.SRR15539874;31;32;0.548387096774194;14;17;0.0483870967741935;0.451612903225806
Control.SRR15539874;27;32;0.481481481481481;14;13;0.0185185185185185;0.481481481481481
Control.SRR15539874;34;32;0.558823529411765;15;19;0.0588235294117647;0.441176470588235
Control.SRR15539874;33;32;0.515151515151515;16;17;0.0151515151515151;0.484848484848485
Control.SRR15539874;29;32;0.448275862068966;16;13;0.0517241379310345;0.448275862068966
Control.SRR15539874;31;32;0.67741935483871;10;21;0.17741935483871;0.32258064516129
Control.SRR15539874;31;32;0.548387096774194;14;17;0.0483870967741935;0.451612903225806
Control.SRR15539874;31;32;0.516129032258065;15;16;0.0161290322580645;0.483870967741935
Control.SRR15539874;30;32;0.533333333333333;14;16;0.0333333333333333;0.466666666666667
Control.SRR15539874;30;32;0.533333333333333;14;16;0.0333333333333333;0.466666666666667
Control.SRR15539874;32;32;0.5;16;16;0;0.5
Control.SRR15539874;29;32;0.344827586206897;19;10;0.155172413793103;0.344827586206897
Control.SRR15539874;28;32;0.428571428571429;16;12;0.0714285714285715;0.428571428571429
Control.SRR15539874;28;32;0.321428571428571;19;9;0.178571428571429;0.321428571428571
Control.SRR15539874;27;32;0.444444444444444;15;12;0.0555555555555556;0.444444444444444
Control.SRR15539874;31;32;0.580645161290323;13;18;0.0806451612903226;0.419354838709677
Control.SRR15539874;32;32;0.5;16;16;0;0.5
Control.SRR15539874;32;32;0.375;20;12;0.125;0.375
Control.SRR15539874;32;32;0.5;16;16;0;0.5
Control.SRR15539874;33;32;0.666666666666667;11;22;0.166666666666667;0.333333333333333
Control.SRR15539874;31;32;0.387096774193548;19;12;0.112903225806452;0.387096774193548
Control.SRR15539874;31;32;0.612903225806452;12;19;0.112903225806452;0.387096774193548
Control.SRR15539874;32;32;0.53125;15;17;0.03125;0.46875
Control.SRR15539874;31;32;0.419354838709677;18;13;0.0806451612903226;0.419354838709677
Control.SRR15539874;32;32;0.46875;17;15;0.03125;0.46875
Control.SRR15539874;30;32;0.466666666666667;16;14;0.0333333333333333;0.466666666666667
Control.SRR15539874;31;32;0.580645161290323;13;18;0.0806451612903226;0.419354838709677
Control.SRR15539874;28;32;0.535714285714286;13;15;0.0357142857142857;0.464285714285714
Control.SRR15539874;32;32;0.5625;14;18;0.0625;0.4375
Control.SRR15539874;34;32;0.411764705882353;20;14;0.0882352941176471;0.411764705882353
Control.SRR15539874;34;32;0.5;17;17;0;0.5
Control.SRR15539874;28;32;0.642857142857143;10;18;0.142857142857143;0.357142857142857
Control.SRR15539874;27;32;0.62962962962963;10;17;0.12962962962963;0.37037037037037
Control.SRR15539874;32;32;0.4375;18;14;0.0625;0.4375
Control.SRR15539874;34;32;0.470588235294118;18;16;0.0294117647058824;0.470588235294118
Control.SRR15539874;29;32;0.344827586206897;19;10;0.155172413793103;0.344827586206897
Control.SRR15539874;31;32;0.741935483870968;8;23;0.241935483870968;0.258064516129032
Control.SRR15539874;30;32;0.6;12;18;0.1;0.4
Control.SRR15539874;32;32;0.46875;17;15;0.03125;0.46875
Control.SRR15539874;29;32;0.551724137931034;13;16;0.0517241379310345;0.448275862068966
Control.SRR15539874;31;32;0.548387096774194;14;17;0.0483870967741935;0.451612903225806
Control.SRR15539874;31;32;0.290322580645161;22;9;0.209677419354839;0.290322580645161
Control.SRR15539874;35;32;0.428571428571429;20;15;0.0714285714285715;0.428571428571429
Control.SRR15539874;33;32;0.575757575757576;14;19;0.0757575757575758;0.424242424242424
Control.SRR15539874;32;32;0.40625;19;13;0.09375;0.40625
Control.SRR15539874;30;32;0.433333333333333;17;13;0.0666666666666667;0.433333333333333
Control.SRR15539874;27;32;0.407407407407407;16;11;0.0925925925925926;0.407407407407407
Control.SRR15539874;28;32;0.392857142857143;17;11;0.107142857142857;0.392857142857143
Control.SRR15539874;35;32;0.6;14;21;0.1;0.4
Control.SRR15539874;27;32;0.37037037037037;17;10;0.12962962962963;0.37037037037037
Control.SRR15539874;28;32;0.428571428571429;16;12;0.0714285714285715;0.428571428571429
Control.SRR15539874;32;32;0.5;16;16;0;0.5
Control.SRR15539874;33;32;0.666666666666667;11;22;0.166666666666667;0.333333333333333
Control.SRR15539874;35;32;0.457142857142857;19;16;0.0428571428571429;0.457142857142857
Control.SRR15539874;31;32;0.451612903225806;17;14;0.0483870967741936;0.451612903225806
Control.SRR15539874;30;32;0.533333333333333;14;16;0.0333333333333333;0.466666666666667
Control.SRR15539874;29;32;0.655172413793103;10;19;0.155172413793103;0.344827586206897
Control.SRR15539874;27;32;0.481481481481481;14;13;0.0185185185185185;0.481481481481481
Control.SRR15539874;35;32;0.542857142857143;16;19;0.0428571428571428;0.457142857142857
Control.SRR15539874;29;32;0.517241379310345;14;15;0.0172413793103449;0.482758620689655
Control.SRR15539874;33;32;0.333333333333333;22;11;0.166666666666667;0.333333333333333
Control.SRR15539874;29;32;0.344827586206897;19;10;0.155172413793103;0.344827586206897
Control.SRR15539874;28;32;0.428571428571429;16;12;0.0714285714285715;0.428571428571429
Control.SRR15539874;31;32;0.419354838709677;18;13;0.0806451612903226;0.419354838709677
Control.SRR15539874;30;32;0.7;9;21;0.2;0.3
Control.SRR15539874;31;32;0.419354838709677;18;13;0.0806451612903226;0.419354838709677
Control.SRR15539874;32;32;0.5625;14;18;0.0625;0.4375
Control.SRR15539874;30;32;0.7;9;21;0.2;0.3
Control.SRR15539874;28;32;0.571428571428571;12;16;0.0714285714285714;0.428571428571429
Control.SRR15539874;30;32;0.5;15;15;0;0.5
Control.SRR15539874;30;32;0.366666666666667;19;11;0.133333333333333;0.366666666666667
Control.SRR15539874;32;32;0.75;8;24;0.25;0.25
Control.SRR15539874;30;32;0.566666666666667;13;17;0.0666666666666667;0.433333333333333
Control.SRR15539874;30;32;0.533333333333333;14;16;0.0333333333333333;0.466666666666667
Control.SRR15539874;30;32;0.5;15;15;0;0.5
Control.SRR15539874;29;32;0.482758620689655;15;14;0.0172413793103448;0.482758620689655
Control.SRR15539874;32;32;0.5625;14;18;0.0625;0.4375
Control.SRR15539874;33;32;0.484848484848485;17;16;0.0151515151515151;0.484848484848485
Control.SRR15539874;33;32;0.545454545454545;15;18;0.0454545454545454;0.454545454545455
Control.SRR15539874;35;32;0.457142857142857;19;16;0.0428571428571429;0.457142857142857
Control.SRR15539874;34;32;0.529411764705882;16;18;0.0294117647058824;0.470588235294118
Control.SRR15539874;27;32;0.481481481481481;14;13;0.0185185185185185;0.481481481481481
Control.SRR15539874;28;32;0.642857142857143;10;18;0.142857142857143;0.357142857142857
Control.SRR15539874;32;32;0.4375;18;14;0.0625;0.4375
Control.SRR15539874;30;32;0.433333333333333;17;13;0.0666666666666667;0.433333333333333
Control.SRR15539874;35;32;0.457142857142857;19;16;0.0428571428571429;0.457142857142857
Control.SRR15539874;33;32;0.424242424242424;19;14;0.0757575757575757;0.424242424242424
Control.SRR15539874;30;32;0.433333333333333;17;13;0.0666666666666667;0.433333333333333
Control.SRR15539874;27;32;0.333333333333333;18;9;0.166666666666667;0.333333333333333
Control.SRR15539874;32;32;0.5625;14;18;0.0625;0.4375
Control.SRR15539874;31;32;0.709677419354839;9;22;0.209677419354839;0.290322580645161
Control.SRR15539874;28;32;0.5;14;14;0;0.5
Control.SRR15539874;27;32;0.592592592592593;11;16;0.0925925925925926;0.407407407407407
Control.SRR15539874;31;32;0.387096774193548;19;12;0.112903225806452;0.387096774193548
Control.SRR15539874;35;32;0.4;21;14;0.1;0.4
Control.SRR15539874;30;32;0.466666666666667;16;14;0.0333333333333333;0.466666666666667
Control.SRR15539874;32;32;0.5625;14;18;0.0625;0.4375
Control.SRR15539874;33;32;0.606060606060606;13;20;0.106060606060606;0.393939393939394
Control.SRR15539874;34;32;0.617647058823529;13;21;0.117647058823529;0.382352941176471
Control.SRR15539874;33;32;0.484848484848485;17;16;0.0151515151515151;0.484848484848485
Control.SRR15539874;34;32;0.441176470588235;19;15;0.0588235294117647;0.441176470588235
Control.SRR15539874;34;32;0.529411764705882;16;18;0.0294117647058824;0.470588235294118
Control.SRR15539874;27;32;0.518518518518518;13;14;0.0185185185185185;0.481481481481481
Control.SRR15539874;33;32;0.484848484848485;17;16;0.0151515151515151;0.484848484848485
Control.SRR15539874;28;32;0.535714285714286;13;15;0.0357142857142857;0.464285714285714
Control.SRR15539874;28;32;0.464285714285714;15;13;0.0357142857142857;0.464285714285714
Control.SRR15539874;34;32;0.529411764705882;16;18;0.0294117647058824;0.470588235294118
Control.SRR15539874;35;32;0.6;14;21;0.1;0.4
Control.SRR15539874;28;32;0.535714285714286;13;15;0.0357142857142857;0.464285714285714
Control.SRR15539874;34;32;0.294117647058824;24;10;0.205882352941176;0.294117647058824
Control.SRR15539874;27;32;0.518518518518518;13;14;0.0185185185185185;0.481481481481481
Control.SRR15539874;32;32;0.5;16;16;0;0.5
Control.SRR15539874;27;32;0.555555555555556;12;15;0.0555555555555556;0.444444444444444
Control.SRR15539874;31;32;0.548387096774194;14;17;0.0483870967741935;0.451612903225806
Control.SRR15539874;35;32;0.514285714285714;17;18;0.0142857142857142;0.485714285714286
Control.SRR15539874;28;32;0.535714285714286;13;15;0.0357142857142857;0.464285714285714
Control.SRR15539874;29;32;0.655172413793103;10;19;0.155172413793103;0.344827586206897
Control.SRR15539874;35;32;0.457142857142857;19;16;0.0428571428571429;0.457142857142857
Control.SRR15539874;27;32;0.518518518518518;13;14;0.0185185185185185;0.481481481481481
Control.SRR15539874;34;32;0.529411764705882;16;18;0.0294117647058824;0.470588235294118
Control.SRR15539874;32;32;0.75;8;24;0.25;0.25
Control.SRR15539874;29;32;0.517241379310345;14;15;0.0172413793103449;0.482758620689655
Control.SRR15539874;28;32;0.464285714285714;15;13;0.0357142857142857;0.464285714285714
Control.SRR15539874;33;32;0.575757575757576;14;19;0.0757575757575758;0.424242424242424
Control.SRR15539874;28;32;0.428571428571429;16;12;0.0714285714285715;0.428571428571429
Control.SRR15539874;35;32;0.742857142857143;9;26;0.242857142857143;0.257142857142857
Control.SRR15539874;33;32;0.393939393939394;20;13;0.106060606060606;0.393939393939394
Control.SRR15539874;33;32;0.393939393939394;20;13;0.106060606060606;0.393939393939394
Control.SRR15539874;27;32;0.407407407407407;16;11;0.0925925925925926;0.407407407407407
Control.SRR15539874;31;32;0.419354838709677;18;13;0.0806451612903226;0.419354838709677
Control.SRR15539874;33;32;0.545454545454545;15;18;0.0454545454545454;0.454545454545455
Control.SRR15539874;30;32;0.4;18;12;0.1;0.4
Control.SRR15539874;34;32;0.470588235294118;18;16;0.0294117647058824;0.470588235294118
Control.SRR15539874;28;32;0.571428571428571;12;16;0.0714285714285714;0.428571428571429
Control.SRR15539874;34;32;0.382352941176471;21;13;0.117647058823529;0.382352941176471
Control.SRR15539874;31;32;0.451612903225806;17;14;0.0483870967741936;0.451612903225806
Control.SRR15539874;34;32;0.470588235294118;18;16;0.0294117647058824;0.470588235294118
Control.SRR15539874;30;32;0.366666666666667;19;11;0.133333333333333;0.366666666666667
Control.SRR15539874;31;32;0.387096774193548;19;12;0.112903225806452;0.387096774193548
Control.SRR15539874;34;32;0.529411764705882;16;18;0.0294117647058824;0.470588235294118
Control.SRR15539874;28;32;0.285714285714286;20;8;0.214285714285714;0.285714285714286
Control.SRR15539874;31;32;0.548387096774194;14;17;0.0483870967741935;0.451612903225806
Control.SRR15539874;27;32;0.444444444444444;15;12;0.0555555555555556;0.444444444444444
Control.SRR15539874;29;32;0.413793103448276;17;12;0.0862068965517241;0.413793103448276
Control.SRR15539874;28;32;0.5;14;14;0;0.5
Control.SRR15539874;29;32;0.448275862068966;16;13;0.0517241379310345;0.448275862068966
Control.SRR15539874;35;32;0.514285714285714;17;18;0.0142857142857142;0.485714285714286
Control.SRR15539874;29;32;0.517241379310345;14;15;0.0172413793103449;0.482758620689655
Control.SRR15539874;32;32;0.65625;11;21;0.15625;0.34375
Control.SRR15539874;30;32;0.533333333333333;14;16;0.0333333333333333;0.466666666666667
Control.SRR15539874;28;32;0.642857142857143;10;18;0.142857142857143;0.357142857142857
Control.SRR15539874;29;32;0.344827586206897;19;10;0.155172413793103;0.344827586206897
Control.SRR15539874;31;32;0.516129032258065;15;16;0.0161290322580645;0.483870967741935
Control.SRR15539874;33;32;0.484848484848485;17;16;0.0151515151515151;0.484848484848485
Control.SRR15539874;27;32;0.444444444444444;15;12;0.0555555555555556;0.444444444444444
Control.SRR15539874;32;32;0.53125;15;17;0.03125;0.46875
Control.SRR15539874;29;32;0.482758620689655;15;14;0.0172413793103448;0.482758620689655
Control.SRR15539874;29;32;0.620689655172414;11;18;0.120689655172414;0.379310344827586
Control.SRR15539874;28;32;0.428571428571429;16;12;0.0714285714285715;0.428571428571429
Control.SRR15539874;32;32;0.3125;22;10;0.1875;0.3125
Control.SRR15539874;28;32;0.535714285714286;13;15;0.0357142857142857;0.464285714285714
Control.SRR15539874;28;32;0.535714285714286;13;15;0.0357142857142857;0.464285714285714
Control.SRR15539874;29;32;0.551724137931034;13;16;0.0517241379310345;0.448275862068966
Control.SRR15539874;28;32;0.642857142857143;10;18;0.142857142857143;0.357142857142857
Control.SRR15539874;32;32;0.5625;14;18;0.0625;0.4375
Control.SRR15539874;33;32;0.393939393939394;20;13;0.106060606060606;0.393939393939394
Control.SRR15539874;28;32;0.428571428571429;16;12;0.0714285714285715;0.428571428571429
Control.SRR15539874;27;32;0.444444444444444;15;12;0.0555555555555556;0.444444444444444
Control.SRR15539874;27;32;0.666666666666667;9;18;0.166666666666667;0.333333333333333
Control.SRR15539874;34;32;0.617647058823529;13;21;0.117647058823529;0.382352941176471
Control.SRR15539874;28;32;0.464285714285714;15;13;0.0357142857142857;0.464285714285714
Control.SRR15539874;32;32;0.46875;17;15;0.03125;0.46875
Control.SRR15539874;29;32;0.551724137931034;13;16;0.0517241379310345;0.448275862068966
Control.SRR15539874;31;32;0.483870967741935;16;15;0.0161290322580645;0.483870967741935
Control.SRR15539874;30;32;0.6;12;18;0.1;0.4
Control.SRR15539874;32;32;0.375;20;12;0.125;0.375
Control.SRR15539874;27;32;0.481481481481481;14;13;0.0185185185185185;0.481481481481481
Control.SRR15539874;28;32;0.5;14;14;0;0.5
Control.SRR15539874;33;32;0.424242424242424;19;14;0.0757575757575757;0.424242424242424
Control.SRR15539874;30;32;0.5;15;15;0;0.5
Control.SRR15539874;34;32;0.411764705882353;20;14;0.0882352941176471;0.411764705882353
Control.SRR15539874;35;32;0.514285714285714;17;18;0.0142857142857142;0.485714285714286
Control.SRR15539874;29;32;0.379310344827586;18;11;0.120689655172414;0.379310344827586
Control.SRR15539874;32;32;0.75;8;24;0.25;0.25
Control.SRR15539874;29;32;0.379310344827586;18;11;0.120689655172414;0.379310344827586
Control.SRR15539874;29;32;0.517241379310345;14;15;0.0172413793103449;0.482758620689655
Control.SRR15539874;27;32;0.481481481481481;14;13;0.0185185185185185;0.481481481481481
Control.SRR15539874;34;32;0.558823529411765;15;19;0.0588235294117647;0.441176470588235
Control.SRR15539874;34;32;0.323529411764706;23;11;0.176470588235294;0.323529411764706
Control.SRR15539874;30;32;0.4;18;12;0.1;0.4
Control.SRR15539874;27;32;0.518518518518518;13;14;0.0185185185185185;0.481481481481481
Control.SRR15539874;32;32;0.65625;11;21;0.15625;0.34375
Control.SRR15539874;29;32;0.413793103448276;17;12;0.0862068965517241;0.413793103448276
Control.SRR15539874;27;32;0.555555555555556;12;15;0.0555555555555556;0.444444444444444
Control.SRR15539874;28;32;0.321428571428571;19;9;0.178571428571429;0.321428571428571
Control.SRR15539874;30;32;0.433333333333333;17;13;0.0666666666666667;0.433333333333333
Control.SRR15539874;30;32;0.533333333333333;14;16;0.0333333333333333;0.466666666666667
Control.SRR15539874;29;32;0.517241379310345;14;15;0.0172413793103449;0.482758620689655
Control.SRR15539874;30;32;0.466666666666667;16;14;0.0333333333333333;0.466666666666667
Control.SRR15539874;32;32;0.71875;9;23;0.21875;0.28125
Control.SRR15539874;31;32;0.451612903225806;17;14;0.0483870967741936;0.451612903225806
Control.SRR15539874;33;32;0.575757575757576;14;19;0.0757575757575758;0.424242424242424
Control.SRR15539874;33;32;0.484848484848485;17;16;0.0151515151515151;0.484848484848485
Control.SRR15539874;32;32;0.375;20;12;0.125;0.375
Control.SRR15539874;29;32;0.620689655172414;11;18;0.120689655172414;0.379310344827586
Control.SRR15539874;31;32;0.483870967741935;16;15;0.0161290322580645;0.483870967741935
Control.SRR15539874;33;32;0.393939393939394;20;13;0.106060606060606;0.393939393939394
Control.SRR15539874;27;32;0.518518518518518;13;14;0.0185185185185185;0.481481481481481
Control.SRR15539874;33;32;0.424242424242424;19;14;0.0757575757575757;0.424242424242424
Control.SRR15539874;30;32;0.366666666666667;19;11;0.133333333333333;0.366666666666667
Control.SRR15539874;33;32;0.454545454545455;18;15;0.0454545454545455;0.454545454545455
Control.SRR15539874;35;32;0.457142857142857;19;16;0.0428571428571429;0.457142857142857
Control.SRR15539874;32;32;0.5;16;16;0;0.5
Control.SRR15539874;27;32;0.555555555555556;12;15;0.0555555555555556;0.444444444444444
Control.SRR15539874;29;32;0.551724137931034;13;16;0.0517241379310345;0.448275862068966
Control.SRR15539874;34;32;0.5;17;17;0;0.5
Control.SRR15539874;31;32;0.516129032258065;15;16;0.0161290322580645;0.483870967741935
Control.SRR15539874;31;32;0.483870967741935;16;15;0.0161290322580645;0.483870967741935
Control.SRR15539874;33;32;0.333333333333333;22;11;0.166666666666667;0.333333333333333
Control.SRR15539874;32;32;0.375;20;12;0.125;0.375
Control.SRR15539874;32;32;0.5625;14;18;0.0625;0.4375
Control.SRR15539874;32;32;0.53125;15;17;0.03125;0.46875
Control.SRR15539874;30;32;0.5;15;15;0;0.5
Control.SRR15539874;28;32;0.571428571428571;12;16;0.0714285714285714;0.428571428571429
Control.SRR15539874;30;32;0.633333333333333;11;19;0.133333333333333;0.366666666666667
Control.SRR15539874;29;32;0.517241379310345;14;15;0.0172413793103449;0.482758620689655
Control.SRR15539874;29;32;0.517241379310345;14;15;0.0172413793103449;0.482758620689655
Control.SRR15539874;27;32;0.592592592592593;11;16;0.0925925925925926;0.407407407407407
Control.SRR15539874;31;32;0.387096774193548;19;12;0.112903225806452;0.387096774193548
Control.SRR15539874;31;32;0.516129032258065;15;16;0.0161290322580645;0.483870967741935
Control.SRR15539874;28;32;0.464285714285714;15;13;0.0357142857142857;0.464285714285714
Control.SRR15539874;29;32;0.655172413793103;10;19;0.155172413793103;0.344827586206897
Control.SRR15539874;32;32;0.46875;17;15;0.03125;0.46875
Control.SRR15539874;33;32;0.454545454545455;18;15;0.0454545454545455;0.454545454545455
Control.SRR15539874;31;32;0.387096774193548;19;12;0.112903225806452;0.387096774193548
Control.SRR15539874;32;32;0.53125;15;17;0.03125;0.46875
Control.SRR15539874;30;32;0.5;15;15;0;0.5
Control.SRR15539874;28;32;0.464285714285714;15;13;0.0357142857142857;0.464285714285714
Control.SRR15539874;30;32;0.466666666666667;16;14;0.0333333333333333;0.466666666666667
Control.SRR15539874;31;32;0.612903225806452;12;19;0.112903225806452;0.387096774193548
Control.SRR15539874;33;32;0.606060606060606;13;20;0.106060606060606;0.393939393939394
Control.SRR15539874;34;32;0.617647058823529;13;21;0.117647058823529;0.382352941176471
Control.SRR15539874;29;32;0.586206896551724;12;17;0.0862068965517241;0.413793103448276
Control.SRR15539874;33;32;0.545454545454545;15;18;0.0454545454545454;0.454545454545455
Control.SRR15539874;27;32;0.37037037037037;17;10;0.12962962962963;0.37037037037037
Control.SRR15539874;27;32;0.518518518518518;13;14;0.0185185185185185;0.481481481481481
Control.SRR15539874;28;32;0.642857142857143;10;18;0.142857142857143;0.357142857142857
Control.SRR15539874;28;32;0.392857142857143;17;11;0.107142857142857;0.392857142857143
Control.SRR15539874;32;32;0.53125;15;17;0.03125;0.46875
Control.SRR15539874;32;32;0.46875;17;15;0.03125;0.46875
Control.SRR15539874;32;32;0.40625;19;13;0.09375;0.40625
Control.SRR15539874;35;32;0.428571428571429;20;15;0.0714285714285715;0.428571428571429
Control.SRR15539874;32;32;0.5625;14;18;0.0625;0.4375
Control.SRR15539874;33;32;0.606060606060606;13;20;0.106060606060606;0.393939393939394
Control.SRR15539874;33;32;0.606060606060606;13;20;0.106060606060606;0.393939393939394
Control.SRR15539874;31;32;0.483870967741935;16;15;0.0161290322580645;0.483870967741935
Control.SRR15539874;31;32;0.67741935483871;10;21;0.17741935483871;0.32258064516129
Control.SRR15539874;30;32;0.566666666666667;13;17;0.0666666666666667;0.433333333333333
Control.SRR15539874;34;32;0.558823529411765;15;19;0.0588235294117647;0.441176470588235
Control.SRR15539874;29;32;0.344827586206897;19;10;0.155172413793103;0.344827586206897
Control.SRR15539874;27;32;0.777777777777778;6;21;0.277777777777778;0.222222222222222
Control.SRR15539874;35;32;0.485714285714286;18;17;0.0142857142857143;0.485714285714286
Control.SRR15539874;27;32;0.555555555555556;12;15;0.0555555555555556;0.444444444444444
Control.SRR15539874;32;32;0.5;16;16;0;0.5
Control.SRR15539874;28;32;0.357142857142857;18;10;0.142857142857143;0.357142857142857
Control.SRR15539874;35;32;0.4;21;14;0.1;0.4
Control.SRR15539874;35;32;0.542857142857143;16;19;0.0428571428571428;0.457142857142857
Control.SRR15539874;29;32;0.482758620689655;15;14;0.0172413793103448;0.482758620689655
Control.SRR15539874;31;32;0.387096774193548;19;12;0.112903225806452;0.387096774193548
Control.SRR15539874;28;32;0.5;14;14;0;0.5
Control.SRR15539874;30;32;0.433333333333333;17;13;0.0666666666666667;0.433333333333333
Control.SRR15539874;30;32;0.533333333333333;14;16;0.0333333333333333;0.466666666666667
Control.SRR15539874;28;32;0.571428571428571;12;16;0.0714285714285714;0.428571428571429
Control.SRR15539874;28;32;0.464285714285714;15;13;0.0357142857142857;0.464285714285714
Control.SRR15539874;28;32;0.535714285714286;13;15;0.0357142857142857;0.464285714285714
Control.SRR15539874;34;32;0.588235294117647;14;20;0.0882352941176471;0.411764705882353
Control.SRR15539874;27;32;0.259259259259259;20;7;0.240740740740741;0.259259259259259
Control.SRR15539874;27;32;0.518518518518518;13;14;0.0185185185185185;0.481481481481481
Control.SRR15539874;28;32;0.428571428571429;16;12;0.0714285714285715;0.428571428571429
Control.SRR15539874;32;32;0.53125;15;17;0.03125;0.46875
Control.SRR15539874;29;32;0.482758620689655;15;14;0.0172413793103448;0.482758620689655
Control.SRR15539874;33;32;0.424242424242424;19;14;0.0757575757575757;0.424242424242424
Control.SRR15539874;32;32;0.375;20;12;0.125;0.375
Control.SRR15539874;27;32;0.444444444444444;15;12;0.0555555555555556;0.444444444444444
Control.SRR15539874;29;32;0.482758620689655;15;14;0.0172413793103448;0.482758620689655
Control.SRR15539874;27;32;0.592592592592593;11;16;0.0925925925925926;0.407407407407407
Control.SRR15539874;29;32;0.413793103448276;17;12;0.0862068965517241;0.413793103448276
Control.SRR15539874;29;32;0.413793103448276;17;12;0.0862068965517241;0.413793103448276
Control.SRR15539874;30;32;0.466666666666667;16;14;0.0333333333333333;0.466666666666667
Control.SRR15539874;31;32;0.419354838709677;18;13;0.0806451612903226;0.419354838709677
Control.SRR15539874;31;32;0.483870967741935;16;15;0.0161290322580645;0.483870967741935
Control.SRR15539874;27;32;0.407407407407407;16;11;0.0925925925925926;0.407407407407407
Control.SRR15539874;33;32;0.545454545454545;15;18;0.0454545454545454;0.454545454545455
Control.SRR15539874;32;32;0.5;16;16;0;0.5
Control.SRR15539874;30;32;0.633333333333333;11;19;0.133333333333333;0.366666666666667
Control.SRR15539874;33;32;0.545454545454545;15;18;0.0454545454545454;0.454545454545455
Control.SRR15539874;29;32;0.448275862068966;16;13;0.0517241379310345;0.448275862068966
Control.SRR15539874;27;32;0.444444444444444;15;12;0.0555555555555556;0.444444444444444
Control.SRR15539874;28;32;0.535714285714286;13;15;0.0357142857142857;0.464285714285714
Control.SRR15539874;31;32;0.612903225806452;12;19;0.112903225806452;0.387096774193548
Control.SRR15539874;35;32;0.628571428571429;13;22;0.128571428571429;0.371428571428571
Control.SRR15539874;30;32;0.466666666666667;16;14;0.0333333333333333;0.466666666666667
Control.SRR15539874;31;32;0.483870967741935;16;15;0.0161290322580645;0.483870967741935
Control.SRR15539874;30;32;0.533333333333333;14;16;0.0333333333333333;0.466666666666667
Control.SRR15539874;35;32;0.571428571428571;15;20;0.0714285714285714;0.428571428571429
Control.SRR15539874;33;32;0.545454545454545;15;18;0.0454545454545454;0.454545454545455
Control.SRR15539874;31;32;0.580645161290323;13;18;0.0806451612903226;0.419354838709677
Control.SRR15539874;31;32;0.483870967741935;16;15;0.0161290322580645;0.483870967741935
Control.SRR15539874;34;32;0.588235294117647;14;20;0.0882352941176471;0.411764705882353
Control.SRR15539874;32;32;0.46875;17;15;0.03125;0.46875
Control.SRR15539874;34;32;0.558823529411765;15;19;0.0588235294117647;0.441176470588235
Control.SRR15539874;30;32;0.4;18;12;0.1;0.4
Control.SRR15539874;30;32;0.533333333333333;14;16;0.0333333333333333;0.466666666666667
Control.SRR15539874;28;32;0.535714285714286;13;15;0.0357142857142857;0.464285714285714
Control.SRR15539874;34;32;0.529411764705882;16;18;0.0294117647058824;0.470588235294118
Control.SRR15539874;32;32;0.59375;13;19;0.09375;0.40625
Control.SRR15539874;27;32;0.62962962962963;10;17;0.12962962962963;0.37037037037037
Control.SRR15539874;29;32;0.586206896551724;12;17;0.0862068965517241;0.413793103448276
Control.SRR15539874;34;32;0.470588235294118;18;16;0.0294117647058824;0.470588235294118
Control.SRR15539874;30;32;0.4;18;12;0.1;0.4
Control.SRR15539874;33;32;0.515151515151515;16;17;0.0151515151515151;0.484848484848485
Control.SRR15539874;34;32;0.558823529411765;15;19;0.0588235294117647;0.441176470588235
Control.SRR15539874;29;32;0.275862068965517;21;8;0.224137931034483;0.275862068965517
Control.SRR15539874;28;32;0.464285714285714;15;13;0.0357142857142857;0.464285714285714
Control.SRR15539874;29;32;0.551724137931034;13;16;0.0517241379310345;0.448275862068966
Control.SRR15539874;33;32;0.606060606060606;13;20;0.106060606060606;0.393939393939394
Control.SRR15539874;27;32;0.555555555555556;12;15;0.0555555555555556;0.444444444444444
Control.SRR15539874;29;32;0.344827586206897;19;10;0.155172413793103;0.344827586206897
Control.SRR15539874;35;32;0.514285714285714;17;18;0.0142857142857142;0.485714285714286
Control.SRR15539874;30;32;0.666666666666667;10;20;0.166666666666667;0.333333333333333
Control.SRR15539874;27;32;0.481481481481481;14;13;0.0185185185185185;0.481481481481481
Control.SRR15539874;35;32;0.6;14;21;0.1;0.4
Control.SRR15539874;35;32;0.485714285714286;18;17;0.0142857142857143;0.485714285714286
Control.SRR15539874;32;32;0.53125;15;17;0.03125;0.46875
Control.SRR15539874;31;32;0.387096774193548;19;12;0.112903225806452;0.387096774193548
Control.SRR15539874;28;32;0.678571428571429;9;19;0.178571428571429;0.321428571428571
Control.SRR15539874;30;32;0.5;15;15;0;0.5
Control.SRR15539874;29;32;0.413793103448276;17;12;0.0862068965517241;0.413793103448276
Control.SRR15539874;34;32;0.5;17;17;0;0.5
Control.SRR15539874;31;32;0.451612903225806;17;14;0.0483870967741936;0.451612903225806
Control.SRR15539874;34;32;0.5;17;17;0;0.5
Control.SRR15539874;32;32;0.4375;18;14;0.0625;0.4375
Control.SRR15539874;35;32;0.571428571428571;15;20;0.0714285714285714;0.428571428571429
Control.SRR15539874;33;32;0.484848484848485;17;16;0.0151515151515151;0.484848484848485
Control.SRR15539874;29;32;0.344827586206897;19;10;0.155172413793103;0.344827586206897
Control.SRR15539874;32;32;0.4375;18;14;0.0625;0.4375
Control.SRR15539874;31;32;0.645161290322581;11;20;0.145161290322581;0.354838709677419
Control.SRR15539874;32;32;0.375;20;12;0.125;0.375
Control.SRR15539874;31;32;0.419354838709677;18;13;0.0806451612903226;0.419354838709677
Control.SRR15539874;30;32;0.466666666666667;16;14;0.0333333333333333;0.466666666666667
Control.SRR15539874;34;32;0.382352941176471;21;13;0.117647058823529;0.382352941176471
Control.SRR15539874;34;32;0.558823529411765;15;19;0.0588235294117647;0.441176470588235
Control.SRR15539874;31;32;0.548387096774194;14;17;0.0483870967741935;0.451612903225806
Control.SRR15539874;34;32;0.411764705882353;20;14;0.0882352941176471;0.411764705882353
Control.SRR15539874;29;32;0.379310344827586;18;11;0.120689655172414;0.379310344827586
Control.SRR15539874;28;32;0.535714285714286;13;15;0.0357142857142857;0.464285714285714
Control.SRR15539874;31;32;0.419354838709677;18;13;0.0806451612903226;0.419354838709677
Control.SRR15539874;32;32;0.53125;15;17;0.03125;0.46875
Control.SRR15539874;27;32;0.444444444444444;15;12;0.0555555555555556;0.444444444444444
Control.SRR15539874;27;32;0.518518518518518;13;14;0.0185185185185185;0.481481481481481
Control.SRR15539874;30;32;0.566666666666667;13;17;0.0666666666666667;0.433333333333333
Control.SRR15539874;30;32;0.433333333333333;17;13;0.0666666666666667;0.433333333333333
Control.SRR15539874;34;32;0.647058823529412;12;22;0.147058823529412;0.352941176470588
Control.SRR15539874;33;32;0.606060606060606;13;20;0.106060606060606;0.393939393939394
Control.SRR15539874;34;32;0.558823529411765;15;19;0.0588235294117647;0.441176470588235
Control.SRR15539874;34;32;0.647058823529412;12;22;0.147058823529412;0.352941176470588
Control.SRR15539874;30;32;0.6;12;18;0.1;0.4
Control.SRR15539874;35;32;0.514285714285714;17;18;0.0142857142857142;0.485714285714286
Control.SRR15539874;30;32;0.533333333333333;14;16;0.0333333333333333;0.466666666666667
Control.SRR15539874;32;32;0.53125;15;17;0.03125;0.46875
Control.SRR15539874;27;32;0.62962962962963;10;17;0.12962962962963;0.37037037037037
Control.SRR15539874;27;32;0.481481481481481;14;13;0.0185185185185185;0.481481481481481
Control.SRR15539874;28;32;0.5;14;14;0;0.5
Control.SRR15539874;28;32;0.464285714285714;15;13;0.0357142857142857;0.464285714285714
Control.SRR15539874;34;32;0.352941176470588;22;12;0.147058823529412;0.352941176470588
Control.SRR15539874;30;32;0.566666666666667;13;17;0.0666666666666667;0.433333333333333
Control.SRR15539874;29;32;0.517241379310345;14;15;0.0172413793103449;0.482758620689655
Control.SRR15539874;28;32;0.642857142857143;10;18;0.142857142857143;0.357142857142857
Control.SRR15539874;35;32;0.6;14;21;0.1;0.4
Control.SRR15539874;29;32;0.655172413793103;10;19;0.155172413793103;0.344827586206897
Control.SRR15539874;28;32;0.678571428571429;9;19;0.178571428571429;0.321428571428571
Control.SRR15539874;35;32;0.457142857142857;19;16;0.0428571428571429;0.457142857142857
Control.SRR15539874;29;32;0.448275862068966;16;13;0.0517241379310345;0.448275862068966
Control.SRR15539874;32;32;0.53125;15;17;0.03125;0.46875
Control.SRR15539874;35;32;0.628571428571429;13;22;0.128571428571429;0.371428571428571
Control.SRR15539874;28;32;0.392857142857143;17;11;0.107142857142857;0.392857142857143
Control.SRR15539874;27;32;0.518518518518518;13;14;0.0185185185185185;0.481481481481481
Control.SRR15539874;35;32;0.428571428571429;20;15;0.0714285714285715;0.428571428571429
Control.SRR15539874;32;32;0.59375;13;19;0.09375;0.40625
Control.SRR15539874;32;32;0.53125;15;17;0.03125;0.46875
Control.SRR15539874;33;32;0.515151515151515;16;17;0.0151515151515151;0.484848484848485
Control.SRR15539874;34;32;0.411764705882353;20;14;0.0882352941176471;0.411764705882353
Control.SRR15539874;33;32;0.606060606060606;13;20;0.106060606060606;0.393939393939394
Control.SRR15539874;31;32;0.548387096774194;14;17;0.0483870967741935;0.451612903225806
Control.SRR15539874;29;32;0.689655172413793;9;20;0.189655172413793;0.310344827586207
Control.SRR15539874;31;32;0.451612903225806;17;14;0.0483870967741936;0.451612903225806
Control.SRR15539874;31;32;0.419354838709677;18;13;0.0806451612903226;0.419354838709677
Control.SRR15539874;29;32;0.517241379310345;14;15;0.0172413793103449;0.482758620689655
Control.SRR15539874;27;32;0.444444444444444;15;12;0.0555555555555556;0.444444444444444
Control.SRR15539874;33;32;0.545454545454545;15;18;0.0454545454545454;0.454545454545455
Control.SRR15539874;30;32;0.666666666666667;10;20;0.166666666666667;0.333333333333333
Control.SRR15539874;31;32;0.483870967741935;16;15;0.0161290322580645;0.483870967741935
Control.SRR15539874;34;32;0.529411764705882;16;18;0.0294117647058824;0.470588235294118
Control.SRR15539874;33;32;0.515151515151515;16;17;0.0151515151515151;0.484848484848485
Control.SRR15539874;30;32;0.533333333333333;14;16;0.0333333333333333;0.466666666666667
Control.SRR15539874;35;32;0.514285714285714;17;18;0.0142857142857142;0.485714285714286
Control.SRR15539874;33;32;0.272727272727273;24;9;0.227272727272727;0.272727272727273
Control.SRR15539874;32;32;0.40625;19;13;0.09375;0.40625
Control.SRR15539874;33;32;0.484848484848485;17;16;0.0151515151515151;0.484848484848485
Control.SRR15539874;31;32;0.419354838709677;18;13;0.0806451612903226;0.419354838709677
Control.SRR15539874;27;32;0.555555555555556;12;15;0.0555555555555556;0.444444444444444
Control.SRR15539874;34;32;0.411764705882353;20;14;0.0882352941176471;0.411764705882353
Control.SRR15539874;27;32;0.333333333333333;18;9;0.166666666666667;0.333333333333333
Control.SRR15539874;27;32;0.62962962962963;10;17;0.12962962962963;0.37037037037037
Control.SRR15539874;32;32;0.46875;17;15;0.03125;0.46875
Control.SRR15539874;27;32;0.555555555555556;12;15;0.0555555555555556;0.444444444444444
Control.SRR15539874;32;32;0.53125;15;17;0.03125;0.46875
Control.SRR15539874;30;32;0.666666666666667;10;20;0.166666666666667;0.333333333333333
Control.SRR15539874;33;32;0.515151515151515;16;17;0.0151515151515151;0.484848484848485
Control.SRR15539874;27;32;0.407407407407407;16;11;0.0925925925925926;0.407407407407407
Control.SRR15539874;28;32;0.357142857142857;18;10;0.142857142857143;0.357142857142857
Control.SRR15539874;31;32;0.354838709677419;20;11;0.145161290322581;0.354838709677419
Control.SRR15539874;34;32;0.441176470588235;19;15;0.0588235294117647;0.441176470588235
Control.SRR15539874;28;32;0.428571428571429;16;12;0.0714285714285715;0.428571428571429
Control.SRR15539874;30;32;0.533333333333333;14;16;0.0333333333333333;0.466666666666667
Control.SRR15539874;33;32;0.575757575757576;14;19;0.0757575757575758;0.424242424242424
Control.SRR15539874;30;32;0.6;12;18;0.1;0.4
Control.SRR15539874;32;32;0.5;16;16;0;0.5
Control.SRR15539874;32;32;0.46875;17;15;0.03125;0.46875
Control.SRR15539874;28;32;0.571428571428571;12;16;0.0714285714285714;0.428571428571429
Control.SRR15539874;31;32;0.419354838709677;18;13;0.0806451612903226;0.419354838709677
Control.SRR15539874;28;32;0.25;21;7;0.25;0.25
Control.SRR15539874;30;32;0.6;12;18;0.1;0.4
Control.SRR15539874;31;32;0.419354838709677;18;13;0.0806451612903226;0.419354838709677
Control.SRR15539874;29;32;0.379310344827586;18;11;0.120689655172414;0.379310344827586
Control.SRR15539874;32;32;0.5625;14;18;0.0625;0.4375
Control.SRR15539874;34;32;0.558823529411765;15;19;0.0588235294117647;0.441176470588235
Control.SRR15539874;32;32;0.5625;14;18;0.0625;0.4375
Control.SRR15539874;31;32;0.580645161290323;13;18;0.0806451612903226;0.419354838709677
Control.SRR15539874;35;32;0.4;21;14;0.1;0.4
Control.SRR15539874;35;32;0.6;14;21;0.1;0.4
Control.SRR15539874;35;32;0.4;21;14;0.1;0.4
Control.SRR15539874;34;32;0.411764705882353;20;14;0.0882352941176471;0.411764705882353
Control.SRR15539874;32;32;0.5;16;16;0;0.5
Control.SRR15539874;29;32;0.517241379310345;14;15;0.0172413793103449;0.482758620689655
Control.SRR15539874;27;32;0.333333333333333;18;9;0.166666666666667;0.333333333333333
Control.SRR15539874;31;32;0.387096774193548;19;12;0.112903225806452;0.387096774193548
Control.SRR15539874;31;32;0.580645161290323;13;18;0.0806451612903226;0.419354838709677
Control.SRR15539874;30;32;0.433333333333333;17;13;0.0666666666666667;0.433333333333333
Control.SRR15539874;31;32;0.612903225806452;12;19;0.112903225806452;0.387096774193548
Control.SRR15539874;34;32;0.441176470588235;19;15;0.0588235294117647;0.441176470588235
Control.SRR15539874;34;32;0.5;17;17;0;0.5
Control.SRR15539874;34;32;0.411764705882353;20;14;0.0882352941176471;0.411764705882353
Control.SRR15539874;32;32;0.46875;17;15;0.03125;0.46875
Control.SRR15539874;35;32;0.371428571428571;22;13;0.128571428571429;0.371428571428571
Control.SRR15539874;33;32;0.484848484848485;17;16;0.0151515151515151;0.484848484848485
Control.SRR15539874;31;32;0.419354838709677;18;13;0.0806451612903226;0.419354838709677
Control.SRR15539874;27;32;0.555555555555556;12;15;0.0555555555555556;0.444444444444444
Control.SRR15539874;28;32;0.464285714285714;15;13;0.0357142857142857;0.464285714285714
Control.SRR15539874;31;32;0.580645161290323;13;18;0.0806451612903226;0.419354838709677
Control.SRR15539874;30;32;0.566666666666667;13;17;0.0666666666666667;0.433333333333333
Control.SRR15539874;31;32;0.516129032258065;15;16;0.0161290322580645;0.483870967741935
Control.SRR15539874;30;32;0.566666666666667;13;17;0.0666666666666667;0.433333333333333
Control.SRR15539874;28;32;0.607142857142857;11;17;0.107142857142857;0.392857142857143
Control.SRR15539874;31;32;0.580645161290323;13;18;0.0806451612903226;0.419354838709677
Control.SRR15539874;28;32;0.535714285714286;13;15;0.0357142857142857;0.464285714285714
Control.SRR15539874;31;32;0.516129032258065;15;16;0.0161290322580645;0.483870967741935
Control.SRR15539874;27;32;0.518518518518518;13;14;0.0185185185185185;0.481481481481481
Control.SRR15539874;30;32;0.433333333333333;17;13;0.0666666666666667;0.433333333333333
Control.SRR15539874;27;32;0.518518518518518;13;14;0.0185185185185185;0.481481481481481
Control.SRR15539874;31;32;0.483870967741935;16;15;0.0161290322580645;0.483870967741935
Control.SRR15539874;33;32;0.515151515151515;16;17;0.0151515151515151;0.484848484848485
Control.SRR15539874;35;32;0.514285714285714;17;18;0.0142857142857142;0.485714285714286
Control.SRR15539874;29;32;0.482758620689655;15;14;0.0172413793103448;0.482758620689655
Control.SRR15539874;30;32;0.466666666666667;16;14;0.0333333333333333;0.466666666666667
Control.SRR15539874;32;32;0.46875;17;15;0.03125;0.46875
Control.SRR15539874;27;32;0.592592592592593;11;16;0.0925925925925926;0.407407407407407
Control.SRR15539874;35;32;0.485714285714286;18;17;0.0142857142857143;0.485714285714286
Control.SRR15539874;34;32;0.470588235294118;18;16;0.0294117647058824;0.470588235294118
Control.SRR15539874;28;32;0.535714285714286;13;15;0.0357142857142857;0.464285714285714
Control.SRR15539874;31;32;0.548387096774194;14;17;0.0483870967741935;0.451612903225806
Control.SRR15539874;31;32;0.612903225806452;12;19;0.112903225806452;0.387096774193548
Control.SRR15539874;32;32;0.53125;15;17;0.03125;0.46875
Control.SRR15539874;32;32;0.40625;19;13;0.09375;0.40625
Control.SRR15539874;29;32;0.482758620689655;15;14;0.0172413793103448;0.482758620689655
Control.SRR15539874;32;32;0.5;16;16;0;0.5
Control.SRR15539874;32;32;0.4375;18;14;0.0625;0.4375
Control.SRR15539874;33;32;0.515151515151515;16;17;0.0151515151515151;0.484848484848485
Control.SRR15539874;32;32;0.5625;14;18;0.0625;0.4375
Control.SRR15539874;31;32;0.67741935483871;10;21;0.17741935483871;0.32258064516129
Control.SRR15539874;30;32;0.366666666666667;19;11;0.133333333333333;0.366666666666667
Control.SRR15539874;31;32;0.516129032258065;15;16;0.0161290322580645;0.483870967741935
Control.SRR15539874;29;32;0.517241379310345;14;15;0.0172413793103449;0.482758620689655
Control.SRR15539874;27;32;0.444444444444444;15;12;0.0555555555555556;0.444444444444444
Control.SRR15539874;28;32;0.464285714285714;15;13;0.0357142857142857;0.464285714285714
Control.SRR15539874;33;32;0.333333333333333;22;11;0.166666666666667;0.333333333333333
Control.SRR15539874;32;32;0.53125;15;17;0.03125;0.46875
Control.SRR15539874;31;32;0.451612903225806;17;14;0.0483870967741936;0.451612903225806
Control.SRR15539874;27;32;0.37037037037037;17;10;0.12962962962963;0.37037037037037
Control.SRR15539874;32;32;0.46875;17;15;0.03125;0.46875
Control.SRR15539874;29;32;0.551724137931034;13;16;0.0517241379310345;0.448275862068966
Control.SRR15539874;29;32;0.413793103448276;17;12;0.0862068965517241;0.413793103448276
Control.SRR15539874;34;32;0.529411764705882;16;18;0.0294117647058824;0.470588235294118
Control.SRR15539874;28;32;0.571428571428571;12;16;0.0714285714285714;0.428571428571429
Control.SRR15539874;34;32;0.588235294117647;14;20;0.0882352941176471;0.411764705882353
Control.SRR15539874;35;32;0.628571428571429;13;22;0.128571428571429;0.371428571428571
Control.SRR15539874;34;32;0.441176470588235;19;15;0.0588235294117647;0.441176470588235
Control.SRR15539874;32;32;0.4375;18;14;0.0625;0.4375
Control.SRR15539874;34;32;0.470588235294118;18;16;0.0294117647058824;0.470588235294118
Control.SRR15539874;30;32;0.633333333333333;11;19;0.133333333333333;0.366666666666667
Control.SRR15539874;35;32;0.742857142857143;9;26;0.242857142857143;0.257142857142857
Control.SRR15539874;29;32;0.482758620689655;15;14;0.0172413793103448;0.482758620689655
Control.SRR15539874;32;32;0.4375;18;14;0.0625;0.4375
Control.SRR15539874;33;32;0.333333333333333;22;11;0.166666666666667;0.333333333333333
Control.SRR15539874;33;32;0.424242424242424;19;14;0.0757575757575757;0.424242424242424
Control.SRR15539874;30;32;0.466666666666667;16;14;0.0333333333333333;0.466666666666667
Control.SRR15539874;30;32;0.7;9;21;0.2;0.3
Control.SRR15539874;31;32;0.387096774193548;19;12;0.112903225806452;0.387096774193548
Control.SRR15539874;34;32;0.411764705882353;20;14;0.0882352941176471;0.411764705882353
Control.SRR15539874;34;32;0.382352941176471;21;13;0.117647058823529;0.382352941176471
Control.SRR15539874;31;32;0.580645161290323;13;18;0.0806451612903226;0.419354838709677
Control.SRR15539874;31;32;0.580645161290323;13;18;0.0806451612903226;0.419354838709677
Control.SRR15539874;35;32;0.485714285714286;18;17;0.0142857142857143;0.485714285714286
Control.SRR15539874;33;32;0.606060606060606;13;20;0.106060606060606;0.393939393939394
Control.SRR15539874;32;32;0.5;16;16;0;0.5
Control.SRR15539874;27;32;0.555555555555556;12;15;0.0555555555555556;0.444444444444444
Control.SRR15539874;28;32;0.321428571428571;19;9;0.178571428571429;0.321428571428571
Control.SRR15539874;33;32;0.636363636363636;12;21;0.136363636363636;0.363636363636364
Control.SRR15539874;35;32;0.514285714285714;17;18;0.0142857142857142;0.485714285714286
Control.SRR15539874;31;32;0.290322580645161;22;9;0.209677419354839;0.290322580645161
Control.SRR15539874;27;32;0.666666666666667;9;18;0.166666666666667;0.333333333333333
Control.SRR15539874;30;32;0.466666666666667;16;14;0.0333333333333333;0.466666666666667
Control.SRR15539874;32;32;0.53125;15;17;0.03125;0.46875
Control.SRR15539874;33;32;0.545454545454545;15;18;0.0454545454545454;0.454545454545455
Control.SRR15539874;27;32;0.333333333333333;18;9;0.166666666666667;0.333333333333333
Control.SRR15539874;29;32;0.551724137931034;13;16;0.0517241379310345;0.448275862068966
Control.SRR15539874;29;32;0.517241379310345;14;15;0.0172413793103449;0.482758620689655
Control.SRR15539874;35;32;0.542857142857143;16;19;0.0428571428571428;0.457142857142857
Control.SRR15539874;34;32;0.529411764705882;16;18;0.0294117647058824;0.470588235294118
Control.SRR15539874;27;32;0.481481481481481;14;13;0.0185185185185185;0.481481481481481
Control.SRR15539874;29;32;0.620689655172414;11;18;0.120689655172414;0.379310344827586
Control.SRR15539874;28;32;0.535714285714286;13;15;0.0357142857142857;0.464285714285714
Control.SRR15539874;27;32;0.407407407407407;16;11;0.0925925925925926;0.407407407407407
Control.SRR15539874;27;32;0.518518518518518;13;14;0.0185185185185185;0.481481481481481
Control.SRR15539874;34;32;0.558823529411765;15;19;0.0588235294117647;0.441176470588235
Control.SRR15539874;30;32;0.4;18;12;0.1;0.4
Control.SRR15539874;30;32;0.533333333333333;14;16;0.0333333333333333;0.466666666666667
Control.SRR15539874;31;32;0.451612903225806;17;14;0.0483870967741936;0.451612903225806
Control.SRR15539874;27;32;0.555555555555556;12;15;0.0555555555555556;0.444444444444444
Control.SRR15539874;31;32;0.580645161290323;13;18;0.0806451612903226;0.419354838709677
Control.SRR15539874;35;32;0.4;21;14;0.1;0.4
Control.SRR15539874;30;32;0.666666666666667;10;20;0.166666666666667;0.333333333333333
Control.SRR15539874;29;32;0.586206896551724;12;17;0.0862068965517241;0.413793103448276
Control.SRR15539874;34;32;0.411764705882353;20;14;0.0882352941176471;0.411764705882353
Control.SRR15539874;30;32;0.566666666666667;13;17;0.0666666666666667;0.433333333333333
Control.SRR15539874;28;32;0.464285714285714;15;13;0.0357142857142857;0.464285714285714
Control.SRR15539874;27;32;0.555555555555556;12;15;0.0555555555555556;0.444444444444444
Control.SRR15539874;30;32;0.433333333333333;17;13;0.0666666666666667;0.433333333333333
Control.SRR15539874;33;32;0.454545454545455;18;15;0.0454545454545455;0.454545454545455
Control.SRR15539874;29;32;0.655172413793103;10;19;0.155172413793103;0.344827586206897
Control.SRR15539874;31;32;0.451612903225806;17;14;0.0483870967741936;0.451612903225806
Control.SRR15539874;28;32;0.428571428571429;16;12;0.0714285714285715;0.428571428571429
Control.SRR15539874;27;32;0.444444444444444;15;12;0.0555555555555556;0.444444444444444
Control.SRR15539874;29;32;0.379310344827586;18;11;0.120689655172414;0.379310344827586
Control.SRR15539874;27;32;0.518518518518518;13;14;0.0185185185185185;0.481481481481481
Control.SRR15539874;27;32;0.444444444444444;15;12;0.0555555555555556;0.444444444444444
Control.SRR15539874;35;32;0.371428571428571;22;13;0.128571428571429;0.371428571428571
Control.SRR15539874;32;32;0.59375;13;19;0.09375;0.40625
Control.SRR15539874;29;32;0.551724137931034;13;16;0.0517241379310345;0.448275862068966
Control.SRR15539874;30;32;0.666666666666667;10;20;0.166666666666667;0.333333333333333
Control.SRR15539874;29;32;0.413793103448276;17;12;0.0862068965517241;0.413793103448276
Control.SRR15539874;33;32;0.575757575757576;14;19;0.0757575757575758;0.424242424242424
Control.SRR15539874;29;32;0.379310344827586;18;11;0.120689655172414;0.379310344827586
Control.SRR15539874;33;32;0.515151515151515;16;17;0.0151515151515151;0.484848484848485
Control.SRR15539874;35;32;0.657142857142857;12;23;0.157142857142857;0.342857142857143
Control.SRR15539874;35;32;0.6;14;21;0.1;0.4
Control.SRR15539874;35;32;0.542857142857143;16;19;0.0428571428571428;0.457142857142857
Control.SRR15539874;28;32;0.535714285714286;13;15;0.0357142857142857;0.464285714285714
Control.SRR15539874;31;32;0.516129032258065;15;16;0.0161290322580645;0.483870967741935
Control.SRR15539874;29;32;0.586206896551724;12;17;0.0862068965517241;0.413793103448276
Control.SRR15539874;35;32;0.485714285714286;18;17;0.0142857142857143;0.485714285714286
Control.SRR15539874;33;32;0.545454545454545;15;18;0.0454545454545454;0.454545454545455
Control.SRR15539874;34;32;0.588235294117647;14;20;0.0882352941176471;0.411764705882353
Control.SRR15539874;30;32;0.466666666666667;16;14;0.0333333333333333;0.466666666666667
Control.SRR15539874;28;32;0.5;14;14;0;0.5
Control.SRR15539874;30;32;0.533333333333333;14;16;0.0333333333333333;0.466666666666667
Control.SRR15539874;33;32;0.575757575757576;14;19;0.0757575757575758;0.424242424242424
Control.SRR15539874;27;32;0.407407407407407;16;11;0.0925925925925926;0.407407407407407
Control.SRR15539874;27;32;0.444444444444444;15;12;0.0555555555555556;0.444444444444444
Control.SRR15539874;30;32;0.733333333333333;8;22;0.233333333333333;0.266666666666667
Control.SRR15539874;34;32;0.647058823529412;12;22;0.147058823529412;0.352941176470588
Control.SRR15539874;33;32;0.575757575757576;14;19;0.0757575757575758;0.424242424242424
Control.SRR15539874;33;32;0.515151515151515;16;17;0.0151515151515151;0.484848484848485
Control.SRR15539874;29;32;0.448275862068966;16;13;0.0517241379310345;0.448275862068966
Control.SRR15539874;28;32;0.535714285714286;13;15;0.0357142857142857;0.464285714285714
Control.SRR15539874;27;32;0.481481481481481;14;13;0.0185185185185185;0.481481481481481
Control.SRR15539874;32;32;0.5;16;16;0;0.5
Control.SRR15539874;29;32;0.448275862068966;16;13;0.0517241379310345;0.448275862068966
Control.SRR15539874;32;32;0.46875;17;15;0.03125;0.46875
Control.SRR15539874;31;32;0.580645161290323;13;18;0.0806451612903226;0.419354838709677
Control.SRR15539874;32;32;0.46875;17;15;0.03125;0.46875
Control.SRR15539874;28;32;0.5;14;14;0;0.5
Control.SRR15539874;34;32;0.558823529411765;15;19;0.0588235294117647;0.441176470588235
Control.SRR15539874;32;32;0.53125;15;17;0.03125;0.46875
Control.SRR15539874;31;32;0.387096774193548;19;12;0.112903225806452;0.387096774193548
Control.SRR15539874;28;32;0.5;14;14;0;0.5
Control.SRR15539874;31;32;0.483870967741935;16;15;0.0161290322580645;0.483870967741935
Control.SRR15539874;33;32;0.484848484848485;17;16;0.0151515151515151;0.484848484848485
Control.SRR15539874;32;32;0.53125;15;17;0.03125;0.46875
Control.SRR15539874;27;32;0.592592592592593;11;16;0.0925925925925926;0.407407407407407
Control.SRR15539874;34;32;0.323529411764706;23;11;0.176470588235294;0.323529411764706
Control.SRR15539874;27;32;0.333333333333333;18;9;0.166666666666667;0.333333333333333
Control.SRR15539874;29;32;0.551724137931034;13;16;0.0517241379310345;0.448275862068966
Control.SRR15539874;27;32;0.37037037037037;17;10;0.12962962962963;0.37037037037037
Control.SRR15539874;28;32;0.428571428571429;16;12;0.0714285714285715;0.428571428571429
Control.SRR15539874;29;32;0.551724137931034;13;16;0.0517241379310345;0.448275862068966
Control.SRR15539874;29;32;0.586206896551724;12;17;0.0862068965517241;0.413793103448276
Control.SRR15539874;28;32;0.464285714285714;15;13;0.0357142857142857;0.464285714285714
Control.SRR15539874;28;32;0.357142857142857;18;10;0.142857142857143;0.357142857142857
Control.SRR15539874;35;32;0.457142857142857;19;16;0.0428571428571429;0.457142857142857
Control.SRR15539874;34;32;0.5;17;17;0;0.5
Control.SRR15539874;27;32;0.444444444444444;15;12;0.0555555555555556;0.444444444444444
Control.SRR15539874;29;32;0.482758620689655;15;14;0.0172413793103448;0.482758620689655
Control.SRR15539874;31;32;0.483870967741935;16;15;0.0161290322580645;0.483870967741935
Control.SRR15539874;29;32;0.413793103448276;17;12;0.0862068965517241;0.413793103448276
Control.SRR15539874;30;32;0.5;15;15;0;0.5
Control.SRR15539874;31;32;0.67741935483871;10;21;0.17741935483871;0.32258064516129
Control.SRR15539874;32;32;0.59375;13;19;0.09375;0.40625
Control.SRR15539874;32;32;0.46875;17;15;0.03125;0.46875
Control.SRR15539874;32;32;0.59375;13;19;0.09375;0.40625
Control.SRR15539874;28;32;0.607142857142857;11;17;0.107142857142857;0.392857142857143
Control.SRR15539874;31;32;0.516129032258065;15;16;0.0161290322580645;0.483870967741935
Control.SRR15539874;32;32;0.53125;15;17;0.03125;0.46875
Control.SRR15539874;34;32;0.647058823529412;12;22;0.147058823529412;0.352941176470588
Control.SRR15539874;28;32;0.642857142857143;10;18;0.142857142857143;0.357142857142857
Control.SRR15539874;35;32;0.628571428571429;13;22;0.128571428571429;0.371428571428571
Control.SRR15539874;35;32;0.457142857142857;19;16;0.0428571428571429;0.457142857142857
Control.SRR15539874;35;32;0.457142857142857;19;16;0.0428571428571429;0.457142857142857
Control.SRR15539874;34;32;0.352941176470588;22;12;0.147058823529412;0.352941176470588
Control.SRR15539874;28;32;0.5;14;14;0;0.5
Control.SRR15539874;28;32;0.428571428571429;16;12;0.0714285714285715;0.428571428571429
Control.SRR15539874;31;32;0.354838709677419;20;11;0.145161290322581;0.354838709677419
Control.SRR15539874;29;32;0.448275862068966;16;13;0.0517241379310345;0.448275862068966
Control.SRR15539874;31;32;0.548387096774194;14;17;0.0483870967741935;0.451612903225806
Control.SRR15539874;32;32;0.59375;13;19;0.09375;0.40625
Control.SRR15539874;31;32;0.451612903225806;17;14;0.0483870967741936;0.451612903225806
Control.SRR15539874;28;32;0.428571428571429;16;12;0.0714285714285715;0.428571428571429
Control.SRR15539874;35;32;0.4;21;14;0.1;0.4
Control.SRR15539874;29;32;0.655172413793103;10;19;0.155172413793103;0.344827586206897
Control.SRR15539874;30;32;0.533333333333333;14;16;0.0333333333333333;0.466666666666667
Control.SRR15539874;31;32;0.451612903225806;17;14;0.0483870967741936;0.451612903225806
Control.SRR15539874;31;32;0.451612903225806;17;14;0.0483870967741936;0.451612903225806
Control.SRR15539874;31;32;0.645161290322581;11;20;0.145161290322581;0.354838709677419
Control.SRR15539874;30;32;0.6;12;18;0.1;0.4
Control.SRR15539874;31;32;0.645161290322581;11;20;0.145161290322581;0.354838709677419
Control.SRR15539874;33;32;0.515151515151515;16;17;0.0151515151515151;0.484848484848485
Control.SRR15539874;31;32;0.612903225806452;12;19;0.112903225806452;0.387096774193548
Control.SRR15539874;33;32;0.393939393939394;20;13;0.106060606060606;0.393939393939394
Control.SRR15539874;28;32;0.392857142857143;17;11;0.107142857142857;0.392857142857143
Control.SRR15539874;31;32;0.354838709677419;20;11;0.145161290322581;0.354838709677419
Control.SRR15539874;32;32;0.46875;17;15;0.03125;0.46875
Control.SRR15539874;29;32;0.517241379310345;14;15;0.0172413793103449;0.482758620689655
Control.SRR15539874;33;32;0.333333333333333;22;11;0.166666666666667;0.333333333333333
Control.SRR15539874;35;32;0.685714285714286;11;24;0.185714285714286;0.314285714285714
Control.SRR15539874;28;32;0.571428571428571;12;16;0.0714285714285714;0.428571428571429
Control.SRR15539874;27;32;0.703703703703704;8;19;0.203703703703704;0.296296296296296
Control.SRR15539874;31;32;0.516129032258065;15;16;0.0161290322580645;0.483870967741935
Control.SRR15539874;31;32;0.612903225806452;12;19;0.112903225806452;0.387096774193548
Control.SRR15539874;28;32;0.571428571428571;12;16;0.0714285714285714;0.428571428571429
Control.SRR15539874;33;32;0.424242424242424;19;14;0.0757575757575757;0.424242424242424
Control.SRR15539874;31;32;0.548387096774194;14;17;0.0483870967741935;0.451612903225806
Control.SRR15539874;33;32;0.454545454545455;18;15;0.0454545454545455;0.454545454545455
Control.SRR15539874;31;32;0.354838709677419;20;11;0.145161290322581;0.354838709677419
Control.SRR15539874;33;32;0.575757575757576;14;19;0.0757575757575758;0.424242424242424
Control.SRR15539874;28;32;0.464285714285714;15;13;0.0357142857142857;0.464285714285714
Control.SRR15539874;35;32;0.6;14;21;0.1;0.4
Control.SRR15539874;27;32;0.555555555555556;12;15;0.0555555555555556;0.444444444444444
Control.SRR15539874;35;32;0.628571428571429;13;22;0.128571428571429;0.371428571428571
Control.SRR15539874;34;32;0.5;17;17;0;0.5
Control.SRR15539874;33;32;0.424242424242424;19;14;0.0757575757575757;0.424242424242424
Control.SRR15539874;28;32;0.392857142857143;17;11;0.107142857142857;0.392857142857143
Control.SRR15539874;30;32;0.466666666666667;16;14;0.0333333333333333;0.466666666666667
Control.SRR15539874;30;32;0.4;18;12;0.1;0.4
Control.SRR15539874;29;32;0.586206896551724;12;17;0.0862068965517241;0.413793103448276
Control.SRR15539874;27;32;0.481481481481481;14;13;0.0185185185185185;0.481481481481481
Control.SRR15539874;33;32;0.454545454545455;18;15;0.0454545454545455;0.454545454545455
Control.SRR15539874;32;32;0.59375;13;19;0.09375;0.40625
Control.SRR15539874;30;32;0.433333333333333;17;13;0.0666666666666667;0.433333333333333
Control.SRR15539874;29;32;0.448275862068966;16;13;0.0517241379310345;0.448275862068966
Control.SRR15539874;29;32;0.310344827586207;20;9;0.189655172413793;0.310344827586207
Control.SRR15539874;31;32;0.516129032258065;15;16;0.0161290322580645;0.483870967741935
Control.SRR15539874;27;32;0.37037037037037;17;10;0.12962962962963;0.37037037037037
Control.SRR15539874;30;32;0.466666666666667;16;14;0.0333333333333333;0.466666666666667
Control.SRR15539874;31;32;0.387096774193548;19;12;0.112903225806452;0.387096774193548
Control.SRR15539874;30;32;0.6;12;18;0.1;0.4
Control.SRR15539874;32;32;0.375;20;12;0.125;0.375
Control.SRR15539874;27;32;0.407407407407407;16;11;0.0925925925925926;0.407407407407407
Control.SRR15539874;35;32;0.628571428571429;13;22;0.128571428571429;0.371428571428571
Control.SRR15539874;27;32;0.444444444444444;15;12;0.0555555555555556;0.444444444444444
Control.SRR15539874;29;32;0.551724137931034;13;16;0.0517241379310345;0.448275862068966
Control.SRR15539874;27;32;0.444444444444444;15;12;0.0555555555555556;0.444444444444444
Control.SRR15539874;32;32;0.5625;14;18;0.0625;0.4375
Control.SRR15539874;30;32;0.6;12;18;0.1;0.4
Control.SRR15539874;27;32;0.62962962962963;10;17;0.12962962962963;0.37037037037037
Control.SRR15539874;27;32;0.444444444444444;15;12;0.0555555555555556;0.444444444444444
Control.SRR15539874;29;32;0.413793103448276;17;12;0.0862068965517241;0.413793103448276
Control.SRR15539874;31;32;0.32258064516129;21;10;0.17741935483871;0.32258064516129
Control.SRR15539874;32;32;0.5;16;16;0;0.5
Control.SRR15539874;32;32;0.375;20;12;0.125;0.375
Control.SRR15539874;30;32;0.466666666666667;16;14;0.0333333333333333;0.466666666666667
Control.SRR15539874;30;32;0.533333333333333;14;16;0.0333333333333333;0.466666666666667
Control.SRR15539874;34;32;0.558823529411765;15;19;0.0588235294117647;0.441176470588235
Control.SRR15539874;30;32;0.633333333333333;11;19;0.133333333333333;0.366666666666667
Control.SRR15539874;35;32;0.485714285714286;18;17;0.0142857142857143;0.485714285714286
Control.SRR15539874;31;32;0.548387096774194;14;17;0.0483870967741935;0.451612903225806
Control.SRR15539874;32;32;0.5625;14;18;0.0625;0.4375
Control.SRR15539874;28;32;0.392857142857143;17;11;0.107142857142857;0.392857142857143
Control.SRR15539874;29;32;0.379310344827586;18;11;0.120689655172414;0.379310344827586
Control.SRR15539874;27;32;0.444444444444444;15;12;0.0555555555555556;0.444444444444444
Control.SRR15539874;29;32;0.482758620689655;15;14;0.0172413793103448;0.482758620689655
Control.SRR15539874;27;32;0.518518518518518;13;14;0.0185185185185185;0.481481481481481
Control.SRR15539874;35;32;0.514285714285714;17;18;0.0142857142857142;0.485714285714286
Control.SRR15539874;29;32;0.551724137931034;13;16;0.0517241379310345;0.448275862068966
Control.SRR15539874;33;32;0.575757575757576;14;19;0.0757575757575758;0.424242424242424
Control.SRR15539874;35;32;0.542857142857143;16;19;0.0428571428571428;0.457142857142857
Control.SRR15539874;29;32;0.620689655172414;11;18;0.120689655172414;0.379310344827586
Control.SRR15539874;33;32;0.363636363636364;21;12;0.136363636363636;0.363636363636364
Control.SRR15539874;29;32;0.413793103448276;17;12;0.0862068965517241;0.413793103448276
Control.SRR15539874;29;32;0.586206896551724;12;17;0.0862068965517241;0.413793103448276
Control.SRR15539874;28;32;0.571428571428571;12;16;0.0714285714285714;0.428571428571429
Control.SRR15539874;32;32;0.5;16;16;0;0.5
Control.SRR15539874;30;32;0.533333333333333;14;16;0.0333333333333333;0.466666666666667
Control.SRR15539874;32;32;0.53125;15;17;0.03125;0.46875
Control.SRR15539874;30;32;0.466666666666667;16;14;0.0333333333333333;0.466666666666667
Control.SRR15539874;28;32;0.392857142857143;17;11;0.107142857142857;0.392857142857143
Control.SRR15539874;31;32;0.580645161290323;13;18;0.0806451612903226;0.419354838709677
Control.SRR15539874;32;32;0.4375;18;14;0.0625;0.4375
Control.SRR15539874;35;32;0.514285714285714;17;18;0.0142857142857142;0.485714285714286
Control.SRR15539874;34;32;0.5;17;17;0;0.5
Control.SRR15539874;31;32;0.580645161290323;13;18;0.0806451612903226;0.419354838709677
Control.SRR15539874;35;32;0.514285714285714;17;18;0.0142857142857142;0.485714285714286
Control.SRR15539874;31;32;0.548387096774194;14;17;0.0483870967741935;0.451612903225806
Control.SRR15539874;35;32;0.485714285714286;18;17;0.0142857142857143;0.485714285714286
Control.SRR15539874;29;32;0.724137931034483;8;21;0.224137931034483;0.275862068965517
Control.SRR15539874;27;32;0.407407407407407;16;11;0.0925925925925926;0.407407407407407
Control.SRR15539874;31;32;0.548387096774194;14;17;0.0483870967741935;0.451612903225806
Control.SRR15539874;30;32;0.566666666666667;13;17;0.0666666666666667;0.433333333333333
Control.SRR15539874;31;32;0.516129032258065;15;16;0.0161290322580645;0.483870967741935
Control.SRR15539874;28;32;0.321428571428571;19;9;0.178571428571429;0.321428571428571
Control.SRR15539874;27;32;0.62962962962963;10;17;0.12962962962963;0.37037037037037
Control.SRR15539874;33;32;0.424242424242424;19;14;0.0757575757575757;0.424242424242424
Control.SRR15539874;33;32;0.666666666666667;11;22;0.166666666666667;0.333333333333333
Control.SRR15539874;31;32;0.580645161290323;13;18;0.0806451612903226;0.419354838709677
Control.SRR15539874;30;32;0.4;18;12;0.1;0.4
Control.SRR15539874;27;32;0.62962962962963;10;17;0.12962962962963;0.37037037037037
Control.SRR15539874;31;32;0.612903225806452;12;19;0.112903225806452;0.387096774193548
Control.SRR15539874;33;32;0.545454545454545;15;18;0.0454545454545454;0.454545454545455
Control.SRR15539874;29;32;0.586206896551724;12;17;0.0862068965517241;0.413793103448276
Control.SRR15539874;29;32;0.517241379310345;14;15;0.0172413793103449;0.482758620689655
Control.SRR15539874;28;32;0.607142857142857;11;17;0.107142857142857;0.392857142857143
Control.SRR15539874;33;32;0.545454545454545;15;18;0.0454545454545454;0.454545454545455
Control.SRR15539874;29;32;0.551724137931034;13;16;0.0517241379310345;0.448275862068966
Control.SRR15539874;28;32;0.607142857142857;11;17;0.107142857142857;0.392857142857143
Control.SRR15539874;31;32;0.516129032258065;15;16;0.0161290322580645;0.483870967741935
Control.SRR15539874;31;32;0.516129032258065;15;16;0.0161290322580645;0.483870967741935
Control.SRR15539874;28;32;0.642857142857143;10;18;0.142857142857143;0.357142857142857
Control.SRR15539874;29;32;0.620689655172414;11;18;0.120689655172414;0.379310344827586
Control.SRR15539874;32;32;0.4375;18;14;0.0625;0.4375
Control.SRR15539874;34;32;0.529411764705882;16;18;0.0294117647058824;0.470588235294118
Control.SRR15539874;29;32;0.482758620689655;15;14;0.0172413793103448;0.482758620689655
Control.SRR15539874;29;32;0.482758620689655;15;14;0.0172413793103448;0.482758620689655
Control.SRR15539874;27;32;0.444444444444444;15;12;0.0555555555555556;0.444444444444444
Control.SRR15539874;33;32;0.393939393939394;20;13;0.106060606060606;0.393939393939394
Control.SRR15539874;33;32;0.393939393939394;20;13;0.106060606060606;0.393939393939394
Control.SRR15539874;34;32;0.352941176470588;22;12;0.147058823529412;0.352941176470588
Control.SRR15539874;30;32;0.366666666666667;19;11;0.133333333333333;0.366666666666667
Control.SRR15539874;32;32;0.46875;17;15;0.03125;0.46875
Control.SRR15539874;30;32;0.7;9;21;0.2;0.3
Control.SRR15539874;27;32;0.518518518518518;13;14;0.0185185185185185;0.481481481481481
Control.SRR15539874;29;32;0.448275862068966;16;13;0.0517241379310345;0.448275862068966
Control.SRR15539874;28;32;0.464285714285714;15;13;0.0357142857142857;0.464285714285714
Control.SRR15539874;32;32;0.59375;13;19;0.09375;0.40625
Control.SRR15539874;29;32;0.448275862068966;16;13;0.0517241379310345;0.448275862068966
Control.SRR15539874;34;32;0.529411764705882;16;18;0.0294117647058824;0.470588235294118
Control.SRR15539874;29;32;0.448275862068966;16;13;0.0517241379310345;0.448275862068966
Control.SRR15539874;28;32;0.571428571428571;12;16;0.0714285714285714;0.428571428571429
Control.SRR15539874;29;32;0.448275862068966;16;13;0.0517241379310345;0.448275862068966
Control.SRR15539874;34;32;0.764705882352941;8;26;0.264705882352941;0.235294117647059
Control.SRR15539874;33;32;0.363636363636364;21;12;0.136363636363636;0.363636363636364
Control.SRR15539874;27;32;0.444444444444444;15;12;0.0555555555555556;0.444444444444444
Control.SRR15539874;27;32;0.592592592592593;11;16;0.0925925925925926;0.407407407407407
Control.SRR15539874;34;32;0.411764705882353;20;14;0.0882352941176471;0.411764705882353
Control.SRR15539874;33;32;0.515151515151515;16;17;0.0151515151515151;0.484848484848485
Control.SRR15539874;27;32;0.333333333333333;18;9;0.166666666666667;0.333333333333333
Control.SRR15539874;32;32;0.625;12;20;0.125;0.375
Control.SRR15539874;33;32;0.666666666666667;11;22;0.166666666666667;0.333333333333333
Control.SRR15539874;29;32;0.586206896551724;12;17;0.0862068965517241;0.413793103448276
Control.SRR15539874;27;32;0.481481481481481;14;13;0.0185185185185185;0.481481481481481
Control.SRR15539874;27;32;0.444444444444444;15;12;0.0555555555555556;0.444444444444444
Control.SRR15539874;29;32;0.586206896551724;12;17;0.0862068965517241;0.413793103448276
Control.SRR15539874;30;32;0.366666666666667;19;11;0.133333333333333;0.366666666666667
Control.SRR15539874;30;32;0.533333333333333;14;16;0.0333333333333333;0.466666666666667
Control.SRR15539874;29;32;0.379310344827586;18;11;0.120689655172414;0.379310344827586
Control.SRR15539874;30;32;0.466666666666667;16;14;0.0333333333333333;0.466666666666667
Control.SRR15539874;27;32;0.555555555555556;12;15;0.0555555555555556;0.444444444444444
Control.SRR15539874;30;32;0.566666666666667;13;17;0.0666666666666667;0.433333333333333
Control.SRR15539874;29;32;0.413793103448276;17;12;0.0862068965517241;0.413793103448276
Control.SRR15539874;29;32;0.586206896551724;12;17;0.0862068965517241;0.413793103448276
Control.SRR15539874;28;32;0.535714285714286;13;15;0.0357142857142857;0.464285714285714
Control.SRR15539874;30;32;0.7;9;21;0.2;0.3
Control.SRR15539874;29;32;0.482758620689655;15;14;0.0172413793103448;0.482758620689655
Control.SRR15539874;28;32;0.607142857142857;11;17;0.107142857142857;0.392857142857143
Control.SRR15539874;35;32;0.457142857142857;19;16;0.0428571428571429;0.457142857142857
Control.SRR15539874;28;32;0.642857142857143;10;18;0.142857142857143;0.357142857142857
Control.SRR15539874;33;32;0.424242424242424;19;14;0.0757575757575757;0.424242424242424
Control.SRR15539874;27;32;0.555555555555556;12;15;0.0555555555555556;0.444444444444444
Control.SRR15539874;29;32;0.448275862068966;16;13;0.0517241379310345;0.448275862068966
Control.SRR15539874;33;32;0.636363636363636;12;21;0.136363636363636;0.363636363636364
Control.SRR15539874;29;32;0.586206896551724;12;17;0.0862068965517241;0.413793103448276
Control.SRR15539874;34;32;0.529411764705882;16;18;0.0294117647058824;0.470588235294118
Control.SRR15539874;34;32;0.5;17;17;0;0.5
Control.SRR15539874;35;32;0.6;14;21;0.1;0.4
Control.SRR15539874;35;32;0.6;14;21;0.1;0.4
Control.SRR15539874;32;32;0.5625;14;18;0.0625;0.4375
Control.SRR15539874;28;32;0.571428571428571;12;16;0.0714285714285714;0.428571428571429
Control.SRR15539874;30;32;0.4;18;12;0.1;0.4
Control.SRR15539874;35;32;0.342857142857143;23;12;0.157142857142857;0.342857142857143
Control.SRR15539874;30;32;0.566666666666667;13;17;0.0666666666666667;0.433333333333333
Control.SRR15539874;28;32;0.571428571428571;12;16;0.0714285714285714;0.428571428571429
Control.SRR15539874;30;32;0.666666666666667;10;20;0.166666666666667;0.333333333333333
Control.SRR15539874;31;32;0.483870967741935;16;15;0.0161290322580645;0.483870967741935
Control.SRR15539874;32;32;0.46875;17;15;0.03125;0.46875
Control.SRR15539874;30;32;0.733333333333333;8;22;0.233333333333333;0.266666666666667
Control.SRR15539874;32;32;0.46875;17;15;0.03125;0.46875
Control.SRR15539874;29;32;0.482758620689655;15;14;0.0172413793103448;0.482758620689655
Control.SRR15539874;33;32;0.515151515151515;16;17;0.0151515151515151;0.484848484848485
Control.SRR15539874;34;32;0.558823529411765;15;19;0.0588235294117647;0.441176470588235
Control.SRR15539874;32;32;0.46875;17;15;0.03125;0.46875
Control.SRR15539874;27;32;0.481481481481481;14;13;0.0185185185185185;0.481481481481481
Control.SRR15539874;35;32;0.457142857142857;19;16;0.0428571428571429;0.457142857142857
Control.SRR15539874;28;32;0.357142857142857;18;10;0.142857142857143;0.357142857142857
Control.SRR15539874;29;32;0.448275862068966;16;13;0.0517241379310345;0.448275862068966
Control.SRR15539874;30;32;0.566666666666667;13;17;0.0666666666666667;0.433333333333333
Control.SRR15539874;29;32;0.310344827586207;20;9;0.189655172413793;0.310344827586207
Control.SRR15539874;34;32;0.411764705882353;20;14;0.0882352941176471;0.411764705882353
Control.SRR15539874;35;32;0.571428571428571;15;20;0.0714285714285714;0.428571428571429
Control.SRR15539874;34;32;0.411764705882353;20;14;0.0882352941176471;0.411764705882353
Control.SRR15539874;34;32;0.588235294117647;14;20;0.0882352941176471;0.411764705882353
Control.SRR15539874;35;32;0.457142857142857;19;16;0.0428571428571429;0.457142857142857
Control.SRR15539874;33;32;0.606060606060606;13;20;0.106060606060606;0.393939393939394
Control.SRR15539874;32;32;0.46875;17;15;0.03125;0.46875
Control.SRR15539874;35;32;0.457142857142857;19;16;0.0428571428571429;0.457142857142857
Control.SRR15539874;28;32;0.392857142857143;17;11;0.107142857142857;0.392857142857143
Control.SRR15539874;29;32;0.482758620689655;15;14;0.0172413793103448;0.482758620689655
Control.SRR15539874;33;32;0.575757575757576;14;19;0.0757575757575758;0.424242424242424
Control.SRR15539874;33;32;0.333333333333333;22;11;0.166666666666667;0.333333333333333
Control.SRR15539874;34;32;0.411764705882353;20;14;0.0882352941176471;0.411764705882353
Control.SRR15539874;32;32;0.46875;17;15;0.03125;0.46875
Control.SRR15539874;31;32;0.516129032258065;15;16;0.0161290322580645;0.483870967741935
Control.SRR15539874;30;32;0.366666666666667;19;11;0.133333333333333;0.366666666666667
Control.SRR15539874;29;32;0.586206896551724;12;17;0.0862068965517241;0.413793103448276
Control.SRR15539874;28;32;0.607142857142857;11;17;0.107142857142857;0.392857142857143
Control.SRR15539874;36;32;0.361111111111111;23;13;0.138888888888889;0.361111111111111
Control.SRR15539874;28;32;0.5;14;14;0;0.5
Control.SRR15539874;30;32;0.4;18;12;0.1;0.4
Control.SRR15539874;30;32;0.333333333333333;20;10;0.166666666666667;0.333333333333333
Control.SRR15539874;32;32;0.40625;19;13;0.09375;0.40625
Control.SRR15539874;33;32;0.454545454545455;18;15;0.0454545454545455;0.454545454545455
Control.SRR15539874;29;32;0.413793103448276;17;12;0.0862068965517241;0.413793103448276
Control.SRR15539874;28;32;0.571428571428571;12;16;0.0714285714285714;0.428571428571429
Control.SRR15539874;32;32;0.40625;19;13;0.09375;0.40625
Control.SRR15539874;28;32;0.464285714285714;15;13;0.0357142857142857;0.464285714285714
Control.SRR15539874;36;32;0.555555555555556;16;20;0.0555555555555556;0.444444444444444
Control.SRR15539874;35;32;0.571428571428571;15;20;0.0714285714285714;0.428571428571429
Control.SRR15539874;29;32;0.655172413793103;10;19;0.155172413793103;0.344827586206897
Control.SRR15539874;31;32;0.354838709677419;20;11;0.145161290322581;0.354838709677419
Control.SRR15539874;30;32;0.566666666666667;13;17;0.0666666666666667;0.433333333333333
Control.SRR15539874;29;32;0.344827586206897;19;10;0.155172413793103;0.344827586206897
Control.SRR15539874;30;32;0.5;15;15;0;0.5
Control.SRR15539874;32;32;0.53125;15;17;0.03125;0.46875
Control.SRR15539874;30;32;0.5;15;15;0;0.5
Control.SRR15539874;28;32;0.5;14;14;0;0.5
Control.SRR15539874;30;32;0.366666666666667;19;11;0.133333333333333;0.366666666666667
Control.SRR15539874;35;32;0.685714285714286;11;24;0.185714285714286;0.314285714285714
Control.SRR15539874;32;32;0.75;8;24;0.25;0.25
Control.SRR15539874;32;32;0.53125;15;17;0.03125;0.46875
Control.SRR15539874;29;32;0.517241379310345;14;15;0.0172413793103449;0.482758620689655
Control.SRR15539874;34;32;0.441176470588235;19;15;0.0588235294117647;0.441176470588235
Control.SRR15539874;34;32;0.529411764705882;16;18;0.0294117647058824;0.470588235294118
Control.SRR15539874;31;32;0.387096774193548;19;12;0.112903225806452;0.387096774193548
Control.SRR15539874;30;32;0.466666666666667;16;14;0.0333333333333333;0.466666666666667
Control.SRR15539874;36;32;0.444444444444444;20;16;0.0555555555555556;0.444444444444444
Control.SRR15539874;34;32;0.470588235294118;18;16;0.0294117647058824;0.470588235294118
Control.SRR15539874;31;32;0.32258064516129;21;10;0.17741935483871;0.32258064516129
Control.SRR15539874;29;32;0.655172413793103;10;19;0.155172413793103;0.344827586206897
Control.SRR15539874;34;32;0.558823529411765;15;19;0.0588235294117647;0.441176470588235
Control.SRR15539874;34;32;0.588235294117647;14;20;0.0882352941176471;0.411764705882353
Control.SRR15539874;31;32;0.580645161290323;13;18;0.0806451612903226;0.419354838709677
Control.SRR15539874;28;32;0.464285714285714;15;13;0.0357142857142857;0.464285714285714
Control.SRR15539874;33;32;0.606060606060606;13;20;0.106060606060606;0.393939393939394
Control.SRR15539874;34;32;0.529411764705882;16;18;0.0294117647058824;0.470588235294118
Control.SRR15539874;33;32;0.545454545454545;15;18;0.0454545454545454;0.454545454545455
Control.SRR15539874;32;32;0.53125;15;17;0.03125;0.46875
Control.SRR15539874;29;32;0.655172413793103;10;19;0.155172413793103;0.344827586206897
Control.SRR15539874;35;32;0.542857142857143;16;19;0.0428571428571428;0.457142857142857
Control.SRR15539874;29;32;0.620689655172414;11;18;0.120689655172414;0.379310344827586
Control.SRR15539874;30;32;0.333333333333333;20;10;0.166666666666667;0.333333333333333
Control.SRR15539874;30;32;0.7;9;21;0.2;0.3
Control.SRR15539874;29;32;0.620689655172414;11;18;0.120689655172414;0.379310344827586
Control.SRR15539874;33;32;0.575757575757576;14;19;0.0757575757575758;0.424242424242424
Control.SRR15539874;28;32;0.678571428571429;9;19;0.178571428571429;0.321428571428571
Control.SRR15539874;32;32;0.40625;19;13;0.09375;0.40625
Control.SRR15539874;34;32;0.441176470588235;19;15;0.0588235294117647;0.441176470588235
Control.SRR15539874;28;32;0.535714285714286;13;15;0.0357142857142857;0.464285714285714
Control.SRR15539874;31;32;0.483870967741935;16;15;0.0161290322580645;0.483870967741935
Control.SRR15539874;34;32;0.647058823529412;12;22;0.147058823529412;0.352941176470588
Control.SRR15539874;35;32;0.4;21;14;0.1;0.4
Control.SRR15539874;35;32;0.542857142857143;16;19;0.0428571428571428;0.457142857142857
Control.SRR15539874;30;32;0.533333333333333;14;16;0.0333333333333333;0.466666666666667
Control.SRR15539874;33;32;0.545454545454545;15;18;0.0454545454545454;0.454545454545455
Control.SRR15539874;32;32;0.5625;14;18;0.0625;0.4375
Control.SRR15539874;34;32;0.352941176470588;22;12;0.147058823529412;0.352941176470588
Control.SRR15539874;34;32;0.352941176470588;22;12;0.147058823529412;0.352941176470588
Control.SRR15539874;31;32;0.419354838709677;18;13;0.0806451612903226;0.419354838709677
Control.SRR15539874;31;32;0.548387096774194;14;17;0.0483870967741935;0.451612903225806
Control.SRR15539874;32;32;0.28125;23;9;0.21875;0.28125
Control.SRR15539874;34;32;0.647058823529412;12;22;0.147058823529412;0.352941176470588
Control.SRR15539874;36;32;0.388888888888889;22;14;0.111111111111111;0.388888888888889
Control.SRR15539874;35;32;0.4;21;14;0.1;0.4
Control.SRR15539874;30;32;0.533333333333333;14;16;0.0333333333333333;0.466666666666667
Control.SRR15539874;36;32;0.416666666666667;21;15;0.0833333333333333;0.416666666666667
Control.SRR15539874;35;32;0.571428571428571;15;20;0.0714285714285714;0.428571428571429
Control.SRR15539874;36;32;0.555555555555556;16;20;0.0555555555555556;0.444444444444444
Control.SRR15539874;28;32;0.571428571428571;12;16;0.0714285714285714;0.428571428571429
Control.SRR15539874;34;32;0.5;17;17;0;0.5
Control.SRR15539874;31;32;0.516129032258065;15;16;0.0161290322580645;0.483870967741935
Control.SRR15539874;34;32;0.558823529411765;15;19;0.0588235294117647;0.441176470588235
Control.SRR15539874;28;32;0.5;14;14;0;0.5
Control.SRR15539874;32;32;0.5625;14;18;0.0625;0.4375
Control.SRR15539874;35;32;0.485714285714286;18;17;0.0142857142857143;0.485714285714286
Control.SRR15539874;31;32;0.580645161290323;13;18;0.0806451612903226;0.419354838709677
Control.SRR15539874;29;32;0.517241379310345;14;15;0.0172413793103449;0.482758620689655
Control.SRR15539874;31;32;0.548387096774194;14;17;0.0483870967741935;0.451612903225806
Control.SRR15539874;34;32;0.588235294117647;14;20;0.0882352941176471;0.411764705882353
Control.SRR15539874;33;32;0.454545454545455;18;15;0.0454545454545455;0.454545454545455
Control.SRR15539874;30;32;0.5;15;15;0;0.5
Control.SRR15539874;29;32;0.482758620689655;15;14;0.0172413793103448;0.482758620689655
Control.SRR15539874;28;32;0.357142857142857;18;10;0.142857142857143;0.357142857142857
Control.SRR15539874;31;32;0.516129032258065;15;16;0.0161290322580645;0.483870967741935
Control.SRR15539874;29;32;0.620689655172414;11;18;0.120689655172414;0.379310344827586
Control.SRR15539874;34;32;0.323529411764706;23;11;0.176470588235294;0.323529411764706
Control.SRR15539874;32;32;0.5;16;16;0;0.5
Control.SRR15539874;33;32;0.424242424242424;19;14;0.0757575757575757;0.424242424242424
Control.SRR15539874;34;32;0.323529411764706;23;11;0.176470588235294;0.323529411764706
Control.SRR15539874;30;32;0.533333333333333;14;16;0.0333333333333333;0.466666666666667
Control.SRR15539874;31;32;0.516129032258065;15;16;0.0161290322580645;0.483870967741935
Control.SRR15539874;28;32;0.428571428571429;16;12;0.0714285714285715;0.428571428571429
Control.SRR15539874;29;32;0.379310344827586;18;11;0.120689655172414;0.379310344827586
Control.SRR15539874;35;32;0.514285714285714;17;18;0.0142857142857142;0.485714285714286
Control.SRR15539874;34;32;0.558823529411765;15;19;0.0588235294117647;0.441176470588235
Control.SRR15539874;35;32;0.4;21;14;0.1;0.4
Control.SRR15539874;34;32;0.588235294117647;14;20;0.0882352941176471;0.411764705882353
Control.SRR15539874;32;32;0.53125;15;17;0.03125;0.46875
Control.SRR15539874;34;32;0.588235294117647;14;20;0.0882352941176471;0.411764705882353
Control.SRR15539874;36;32;0.555555555555556;16;20;0.0555555555555556;0.444444444444444
Control.SRR15539874;35;32;0.685714285714286;11;24;0.185714285714286;0.314285714285714
Control.SRR15539874;32;32;0.53125;15;17;0.03125;0.46875
Control.SRR15539874;28;32;0.392857142857143;17;11;0.107142857142857;0.392857142857143
Control.SRR15539874;28;32;0.392857142857143;17;11;0.107142857142857;0.392857142857143
Control.SRR15539874;30;32;0.633333333333333;11;19;0.133333333333333;0.366666666666667
Control.SRR15539874;30;32;0.433333333333333;17;13;0.0666666666666667;0.433333333333333
Control.SRR15539874;29;32;0.413793103448276;17;12;0.0862068965517241;0.413793103448276
Control.SRR15539874;32;32;0.5;16;16;0;0.5
Control.SRR15539874;33;32;0.636363636363636;12;21;0.136363636363636;0.363636363636364
Control.SRR15539874;28;32;0.428571428571429;16;12;0.0714285714285715;0.428571428571429
Control.SRR15539874;30;32;0.433333333333333;17;13;0.0666666666666667;0.433333333333333
Control.SRR15539874;31;32;0.516129032258065;15;16;0.0161290322580645;0.483870967741935
Control.SRR15539874;34;32;0.617647058823529;13;21;0.117647058823529;0.382352941176471
Control.SRR15539874;29;32;0.448275862068966;16;13;0.0517241379310345;0.448275862068966
Control.SRR15539874;28;32;0.5;14;14;0;0.5
Control.SRR15539874;36;32;0.444444444444444;20;16;0.0555555555555556;0.444444444444444
Control.SRR15539874;36;32;0.5;18;18;0;0.5
Control.SRR15539874;32;32;0.4375;18;14;0.0625;0.4375
Control.SRR15539874;30;32;0.5;15;15;0;0.5
Control.SRR15539874;32;32;0.5;16;16;0;0.5
Control.SRR15539874;34;32;0.470588235294118;18;16;0.0294117647058824;0.470588235294118
Control.SRR15539874;28;32;0.535714285714286;13;15;0.0357142857142857;0.464285714285714
Control.SRR15539874;32;32;0.5;16;16;0;0.5
Control.SRR15539874;29;32;0.448275862068966;16;13;0.0517241379310345;0.448275862068966
Control.SRR15539874;28;32;0.535714285714286;13;15;0.0357142857142857;0.464285714285714
Control.SRR15539874;34;32;0.529411764705882;16;18;0.0294117647058824;0.470588235294118
Control.SRR15539874;35;32;0.514285714285714;17;18;0.0142857142857142;0.485714285714286
Control.SRR15539874;31;32;0.451612903225806;17;14;0.0483870967741936;0.451612903225806
Control.SRR15539874;36;32;0.611111111111111;14;22;0.111111111111111;0.388888888888889
Control.SRR15539874;31;32;0.548387096774194;14;17;0.0483870967741935;0.451612903225806
Control.SRR15539874;28;32;0.535714285714286;13;15;0.0357142857142857;0.464285714285714
Control.SRR15539874;32;32;0.5625;14;18;0.0625;0.4375
Control.SRR15539874;35;32;0.685714285714286;11;24;0.185714285714286;0.314285714285714
Control.SRR15539874;28;32;0.464285714285714;15;13;0.0357142857142857;0.464285714285714
Control.SRR15539874;32;32;0.46875;17;15;0.03125;0.46875
Control.SRR15539874;36;32;0.5;18;18;0;0.5
Control.SRR15539874;28;32;0.5;14;14;0;0.5
Control.SRR15539874;34;32;0.617647058823529;13;21;0.117647058823529;0.382352941176471
Control.SRR15539874;28;32;0.392857142857143;17;11;0.107142857142857;0.392857142857143
Control.SRR15539874;30;32;0.566666666666667;13;17;0.0666666666666667;0.433333333333333
Control.SRR15539874;31;32;0.387096774193548;19;12;0.112903225806452;0.387096774193548
Control.SRR15539874;29;32;0.482758620689655;15;14;0.0172413793103448;0.482758620689655
Control.SRR15539874;28;32;0.464285714285714;15;13;0.0357142857142857;0.464285714285714
Control.SRR15539874;35;32;0.514285714285714;17;18;0.0142857142857142;0.485714285714286
Control.SRR15539874;34;32;0.352941176470588;22;12;0.147058823529412;0.352941176470588
Control.SRR15539874;34;32;0.382352941176471;21;13;0.117647058823529;0.382352941176471
Control.SRR15539874;30;32;0.4;18;12;0.1;0.4
Control.SRR15539874;30;32;0.466666666666667;16;14;0.0333333333333333;0.466666666666667
Control.SRR15539874;31;32;0.419354838709677;18;13;0.0806451612903226;0.419354838709677
Control.SRR15539874;35;32;0.6;14;21;0.1;0.4
Control.SRR15539874;29;32;0.344827586206897;19;10;0.155172413793103;0.344827586206897
Control.SRR15539874;33;32;0.545454545454545;15;18;0.0454545454545454;0.454545454545455
Control.SRR15539874;30;32;0.4;18;12;0.1;0.4
Control.SRR15539874;30;32;0.733333333333333;8;22;0.233333333333333;0.266666666666667
Control.SRR15539874;31;32;0.580645161290323;13;18;0.0806451612903226;0.419354838709677
Control.SRR15539874;34;32;0.294117647058824;24;10;0.205882352941176;0.294117647058824
Control.SRR15539874;36;32;0.444444444444444;20;16;0.0555555555555556;0.444444444444444
Control.SRR15539874;28;32;0.571428571428571;12;16;0.0714285714285714;0.428571428571429
Control.SRR15539874;36;32;0.583333333333333;15;21;0.0833333333333334;0.416666666666667
Control.SRR15539874;32;32;0.375;20;12;0.125;0.375
Control.SRR15539874;28;32;0.321428571428571;19;9;0.178571428571429;0.321428571428571
Control.SRR15539874;31;32;0.645161290322581;11;20;0.145161290322581;0.354838709677419
Control.SRR15539874;32;32;0.5;16;16;0;0.5
Control.SRR15539874;33;32;0.484848484848485;17;16;0.0151515151515151;0.484848484848485
Control.SRR15539874;32;32;0.5625;14;18;0.0625;0.4375
Control.SRR15539874;31;32;0.354838709677419;20;11;0.145161290322581;0.354838709677419
Control.SRR15539874;34;32;0.647058823529412;12;22;0.147058823529412;0.352941176470588
Control.SRR15539874;33;32;0.424242424242424;19;14;0.0757575757575757;0.424242424242424
Control.SRR15539874;34;32;0.5;17;17;0;0.5
Control.SRR15539874;32;32;0.5;16;16;0;0.5
Control.SRR15539874;32;32;0.46875;17;15;0.03125;0.46875
Control.SRR15539874;29;32;0.517241379310345;14;15;0.0172413793103449;0.482758620689655
Control.SRR15539874;33;32;0.333333333333333;22;11;0.166666666666667;0.333333333333333
Control.SRR15539874;30;32;0.4;18;12;0.1;0.4
Control.SRR15539874;35;32;0.457142857142857;19;16;0.0428571428571429;0.457142857142857
Control.SRR15539874;35;32;0.457142857142857;19;16;0.0428571428571429;0.457142857142857
Control.SRR15539874;34;32;0.705882352941177;10;24;0.205882352941177;0.294117647058824
Control.SRR15539874;33;32;0.515151515151515;16;17;0.0151515151515151;0.484848484848485
Control.SRR15539874;28;32;0.571428571428571;12;16;0.0714285714285714;0.428571428571429
Control.SRR15539874;35;32;0.6;14;21;0.1;0.4
Control.SRR15539874;30;32;0.6;12;18;0.1;0.4
Control.SRR15539874;36;32;0.472222222222222;19;17;0.0277777777777778;0.472222222222222
Control.SRR15539874;36;32;0.361111111111111;23;13;0.138888888888889;0.361111111111111
Control.SRR15539874;30;32;0.466666666666667;16;14;0.0333333333333333;0.466666666666667
Control.SRR15539874;31;32;0.548387096774194;14;17;0.0483870967741935;0.451612903225806
Control.SRR15539874;35;32;0.571428571428571;15;20;0.0714285714285714;0.428571428571429
Control.SRR15539874;35;32;0.514285714285714;17;18;0.0142857142857142;0.485714285714286
Control.SRR15539874;32;32;0.46875;17;15;0.03125;0.46875
Control.SRR15539874;32;32;0.65625;11;21;0.15625;0.34375
Control.SRR15539874;28;32;0.392857142857143;17;11;0.107142857142857;0.392857142857143
Control.SRR15539874;34;32;0.441176470588235;19;15;0.0588235294117647;0.441176470588235
Control.SRR15539874;29;32;0.448275862068966;16;13;0.0517241379310345;0.448275862068966
Control.SRR15539874;29;32;0.344827586206897;19;10;0.155172413793103;0.344827586206897
Control.SRR15539874;35;32;0.514285714285714;17;18;0.0142857142857142;0.485714285714286
Control.SRR15539874;30;32;0.366666666666667;19;11;0.133333333333333;0.366666666666667
Control.SRR15539874;30;32;0.666666666666667;10;20;0.166666666666667;0.333333333333333
Control.SRR15539874;32;32;0.4375;18;14;0.0625;0.4375
Control.SRR15539874;30;32;0.566666666666667;13;17;0.0666666666666667;0.433333333333333
Control.SRR15539874;35;32;0.514285714285714;17;18;0.0142857142857142;0.485714285714286
Control.SRR15539874;34;32;0.588235294117647;14;20;0.0882352941176471;0.411764705882353
Control.SRR15539874;32;32;0.6875;10;22;0.1875;0.3125
Control.SRR15539874;33;32;0.545454545454545;15;18;0.0454545454545454;0.454545454545455
Control.SRR15539874;34;32;0.617647058823529;13;21;0.117647058823529;0.382352941176471
Control.SRR15539874;34;32;0.441176470588235;19;15;0.0588235294117647;0.441176470588235
Control.SRR15539874;34;32;0.558823529411765;15;19;0.0588235294117647;0.441176470588235
Control.SRR15539874;33;32;0.393939393939394;20;13;0.106060606060606;0.393939393939394
Control.SRR15539874;30;32;0.5;15;15;0;0.5
Control.SRR15539874;29;32;0.482758620689655;15;14;0.0172413793103448;0.482758620689655
Control.SRR15539874;30;32;0.533333333333333;14;16;0.0333333333333333;0.466666666666667
Control.SRR15539874;29;32;0.482758620689655;15;14;0.0172413793103448;0.482758620689655
Control.SRR15539874;29;32;0.551724137931034;13;16;0.0517241379310345;0.448275862068966
Control.SRR15539874;33;32;0.363636363636364;21;12;0.136363636363636;0.363636363636364
Control.SRR15539874;34;32;0.411764705882353;20;14;0.0882352941176471;0.411764705882353
Control.SRR15539874;33;32;0.484848484848485;17;16;0.0151515151515151;0.484848484848485
Control.SRR15539874;34;32;0.411764705882353;20;14;0.0882352941176471;0.411764705882353
Control.SRR15539874;34;32;0.470588235294118;18;16;0.0294117647058824;0.470588235294118
Control.SRR15539874;28;32;0.607142857142857;11;17;0.107142857142857;0.392857142857143
Control.SRR15539874;32;32;0.53125;15;17;0.03125;0.46875
Control.SRR15539874;31;32;0.387096774193548;19;12;0.112903225806452;0.387096774193548
Control.SRR15539874;29;32;0.448275862068966;16;13;0.0517241379310345;0.448275862068966
Control.SRR15539874;29;32;0.517241379310345;14;15;0.0172413793103449;0.482758620689655
Control.SRR15539874;28;32;0.5;14;14;0;0.5
Control.SRR15539874;33;32;0.545454545454545;15;18;0.0454545454545454;0.454545454545455
Control.SRR15539874;28;32;0.535714285714286;13;15;0.0357142857142857;0.464285714285714
Control.SRR15539874;28;32;0.571428571428571;12;16;0.0714285714285714;0.428571428571429
Control.SRR15539874;30;32;0.466666666666667;16;14;0.0333333333333333;0.466666666666667
Control.SRR15539874;34;32;0.647058823529412;12;22;0.147058823529412;0.352941176470588
Control.SRR15539874;29;32;0.482758620689655;15;14;0.0172413793103448;0.482758620689655
Control.SRR15539874;29;32;0.413793103448276;17;12;0.0862068965517241;0.413793103448276
Control.SRR15539874;28;32;0.392857142857143;17;11;0.107142857142857;0.392857142857143
Control.SRR15539874;28;32;0.392857142857143;17;11;0.107142857142857;0.392857142857143
Control.SRR15539874;29;32;0.310344827586207;20;9;0.189655172413793;0.310344827586207
Control.SRR15539874;30;32;0.5;15;15;0;0.5
Control.SRR15539874;34;32;0.205882352941176;27;7;0.294117647058824;0.205882352941176
Control.SRR15539874;28;32;0.571428571428571;12;16;0.0714285714285714;0.428571428571429
Control.SRR15539874;29;32;0.413793103448276;17;12;0.0862068965517241;0.413793103448276
Control.SRR15539874;30;32;0.533333333333333;14;16;0.0333333333333333;0.466666666666667
Control.SRR15539874;33;32;0.363636363636364;21;12;0.136363636363636;0.363636363636364
Control.SRR15539874;30;32;0.666666666666667;10;20;0.166666666666667;0.333333333333333
Control.SRR15539874;29;32;0.586206896551724;12;17;0.0862068965517241;0.413793103448276
Control.SRR15539874;35;32;0.4;21;14;0.1;0.4
Control.SRR15539874;29;32;0.586206896551724;12;17;0.0862068965517241;0.413793103448276
Control.SRR15539874;31;32;0.548387096774194;14;17;0.0483870967741935;0.451612903225806
Control.SRR15539874;29;32;0.379310344827586;18;11;0.120689655172414;0.379310344827586
Control.SRR15539874;35;32;0.542857142857143;16;19;0.0428571428571428;0.457142857142857
Control.SRR15539874;28;32;0.5;14;14;0;0.5
Control.SRR15539874;32;32;0.40625;19;13;0.09375;0.40625
Control.SRR15539874;30;32;0.5;15;15;0;0.5
Control.SRR15539874;34;32;0.323529411764706;23;11;0.176470588235294;0.323529411764706
Control.SRR15539874;30;32;0.5;15;15;0;0.5
Control.SRR15539874;29;32;0.551724137931034;13;16;0.0517241379310345;0.448275862068966
Control.SRR15539874;29;32;0.655172413793103;10;19;0.155172413793103;0.344827586206897
Control.SRR15539874;31;32;0.580645161290323;13;18;0.0806451612903226;0.419354838709677
Control.SRR15539874;33;32;0.575757575757576;14;19;0.0757575757575758;0.424242424242424
Control.SRR15539874;32;32;0.5625;14;18;0.0625;0.4375
Control.SRR15539874;36;32;0.444444444444444;20;16;0.0555555555555556;0.444444444444444
Control.SRR15539874;29;32;0.344827586206897;19;10;0.155172413793103;0.344827586206897
Control.SRR15539874;30;32;0.433333333333333;17;13;0.0666666666666667;0.433333333333333
Control.SRR15539874;31;32;0.451612903225806;17;14;0.0483870967741936;0.451612903225806
Control.SRR15539874;30;32;0.6;12;18;0.1;0.4
Control.SRR15539874;29;32;0.413793103448276;17;12;0.0862068965517241;0.413793103448276
Control.SRR15539874;35;32;0.6;14;21;0.1;0.4
Control.SRR15539874;30;32;0.4;18;12;0.1;0.4
Control.SRR15539874;29;32;0.379310344827586;18;11;0.120689655172414;0.379310344827586
Control.SRR15539874;32;32;0.53125;15;17;0.03125;0.46875
Control.SRR15539874;30;32;0.533333333333333;14;16;0.0333333333333333;0.466666666666667
Control.SRR15539874;32;32;0.5;16;16;0;0.5
Control.SRR15539874;30;32;0.633333333333333;11;19;0.133333333333333;0.366666666666667
Control.SRR15539874;34;32;0.441176470588235;19;15;0.0588235294117647;0.441176470588235
Control.SRR15539874;32;32;0.59375;13;19;0.09375;0.40625
Control.SRR15539874;32;32;0.6875;10;22;0.1875;0.3125
Control.SRR15539874;30;32;0.7;9;21;0.2;0.3
Control.SRR15539874;33;32;0.575757575757576;14;19;0.0757575757575758;0.424242424242424
Control.SRR15539874;30;32;0.433333333333333;17;13;0.0666666666666667;0.433333333333333
Control.SRR15539874;31;32;0.612903225806452;12;19;0.112903225806452;0.387096774193548
Control.SRR15539874;29;32;0.517241379310345;14;15;0.0172413793103449;0.482758620689655
Control.SRR15539874;34;32;0.5;17;17;0;0.5
Control.SRR15539874;32;32;0.5;16;16;0;0.5
Control.SRR15539874;32;32;0.46875;17;15;0.03125;0.46875
Control.SRR15539874;33;32;0.454545454545455;18;15;0.0454545454545455;0.454545454545455
Control.SRR15539874;36;32;0.555555555555556;16;20;0.0555555555555556;0.444444444444444
Control.SRR15539874;29;32;0.517241379310345;14;15;0.0172413793103449;0.482758620689655
Control.SRR15539874;31;32;0.516129032258065;15;16;0.0161290322580645;0.483870967741935
Control.SRR15539874;30;32;0.533333333333333;14;16;0.0333333333333333;0.466666666666667
Control.SRR15539874;33;32;0.484848484848485;17;16;0.0151515151515151;0.484848484848485
Control.SRR15539874;28;32;0.5;14;14;0;0.5
Control.SRR15539874;31;32;0.612903225806452;12;19;0.112903225806452;0.387096774193548
Control.SRR15539874;30;32;0.633333333333333;11;19;0.133333333333333;0.366666666666667
Control.SRR15539874;31;32;0.516129032258065;15;16;0.0161290322580645;0.483870967741935
Control.SRR15539874;28;32;0.5;14;14;0;0.5
Control.SRR15539874;34;32;0.617647058823529;13;21;0.117647058823529;0.382352941176471
Control.SRR15539874;36;32;0.638888888888889;13;23;0.138888888888889;0.361111111111111
Control.SRR15539874;32;32;0.40625;19;13;0.09375;0.40625
Control.SRR15539874;29;32;0.379310344827586;18;11;0.120689655172414;0.379310344827586
Control.SRR15539874;35;32;0.514285714285714;17;18;0.0142857142857142;0.485714285714286
Control.SRR15539874;32;32;0.59375;13;19;0.09375;0.40625
Control.SRR15539874;33;32;0.454545454545455;18;15;0.0454545454545455;0.454545454545455
Control.SRR15539874;30;32;0.566666666666667;13;17;0.0666666666666667;0.433333333333333
Control.SRR15539874;28;32;0.607142857142857;11;17;0.107142857142857;0.392857142857143
Control.SRR15539874;32;32;0.53125;15;17;0.03125;0.46875
Control.SRR15539874;32;32;0.34375;21;11;0.15625;0.34375
Control.SRR15539874;34;32;0.323529411764706;23;11;0.176470588235294;0.323529411764706
Control.SRR15539874;33;32;0.575757575757576;14;19;0.0757575757575758;0.424242424242424
Control.SRR15539874;30;32;0.5;15;15;0;0.5
Control.SRR15539874;34;32;0.5;17;17;0;0.5
Control.SRR15539874;36;32;0.444444444444444;20;16;0.0555555555555556;0.444444444444444
Control.SRR15539874;35;32;0.514285714285714;17;18;0.0142857142857142;0.485714285714286
Control.SRR15539874;33;32;0.484848484848485;17;16;0.0151515151515151;0.484848484848485
Control.SRR15539874;33;32;0.484848484848485;17;16;0.0151515151515151;0.484848484848485
Control.SRR15539874;34;32;0.588235294117647;14;20;0.0882352941176471;0.411764705882353
Control.SRR15539874;30;32;0.333333333333333;20;10;0.166666666666667;0.333333333333333
Control.SRR15539874;31;32;0.483870967741935;16;15;0.0161290322580645;0.483870967741935
Control.SRR15539874;31;32;0.516129032258065;15;16;0.0161290322580645;0.483870967741935
Control.SRR15539874;28;32;0.392857142857143;17;11;0.107142857142857;0.392857142857143
Control.SRR15539874;28;32;0.607142857142857;11;17;0.107142857142857;0.392857142857143
Control.SRR15539874;35;32;0.628571428571429;13;22;0.128571428571429;0.371428571428571
Control.SRR15539874;30;32;0.633333333333333;11;19;0.133333333333333;0.366666666666667
Control.SRR15539874;28;32;0.607142857142857;11;17;0.107142857142857;0.392857142857143
Control.SRR15539874;35;32;0.6;14;21;0.1;0.4
Control.SRR15539874;34;32;0.470588235294118;18;16;0.0294117647058824;0.470588235294118
Control.SRR15539874;31;32;0.419354838709677;18;13;0.0806451612903226;0.419354838709677
Control.SRR15539874;35;32;0.428571428571429;20;15;0.0714285714285715;0.428571428571429
Control.SRR15539874;32;32;0.59375;13;19;0.09375;0.40625
Control.SRR15539874;30;32;0.5;15;15;0;0.5
Control.SRR15539874;32;32;0.6875;10;22;0.1875;0.3125
Control.SRR15539874;34;32;0.323529411764706;23;11;0.176470588235294;0.323529411764706
Control.SRR15539874;33;32;0.545454545454545;15;18;0.0454545454545454;0.454545454545455
Control.SRR15539874;29;32;0.448275862068966;16;13;0.0517241379310345;0.448275862068966
Control.SRR15539874;33;32;0.363636363636364;21;12;0.136363636363636;0.363636363636364
Control.SRR15539874;29;32;0.620689655172414;11;18;0.120689655172414;0.379310344827586
Control.SRR15539874;32;32;0.46875;17;15;0.03125;0.46875
Control.SRR15539874;36;32;0.638888888888889;13;23;0.138888888888889;0.361111111111111
Control.SRR15539874;33;32;0.393939393939394;20;13;0.106060606060606;0.393939393939394
Control.SRR15539874;30;32;0.5;15;15;0;0.5
Control.SRR15539874;30;32;0.633333333333333;11;19;0.133333333333333;0.366666666666667
Control.SRR15539874;29;32;0.724137931034483;8;21;0.224137931034483;0.275862068965517
Control.SRR15539874;35;32;0.4;21;14;0.1;0.4
Control.SRR15539874;29;32;0.448275862068966;16;13;0.0517241379310345;0.448275862068966
Control.SRR15539874;31;32;0.516129032258065;15;16;0.0161290322580645;0.483870967741935
Control.SRR15539874;28;32;0.535714285714286;13;15;0.0357142857142857;0.464285714285714
Control.SRR15539874;32;32;0.53125;15;17;0.03125;0.46875
Control.SRR15539874;35;32;0.4;21;14;0.1;0.4
Control.SRR15539874;28;32;0.392857142857143;17;11;0.107142857142857;0.392857142857143
Control.SRR15539874;35;32;0.514285714285714;17;18;0.0142857142857142;0.485714285714286
Control.SRR15539874;32;32;0.5625;14;18;0.0625;0.4375
Control.SRR15539874;30;32;0.6;12;18;0.1;0.4
Control.SRR15539874;31;32;0.516129032258065;15;16;0.0161290322580645;0.483870967741935
Control.SRR15539874;36;32;0.361111111111111;23;13;0.138888888888889;0.361111111111111
Control.SRR15539874;32;32;0.46875;17;15;0.03125;0.46875
Control.SRR15539874;29;32;0.517241379310345;14;15;0.0172413793103449;0.482758620689655
Control.SRR15539874;33;32;0.424242424242424;19;14;0.0757575757575757;0.424242424242424
Control.SRR15539874;31;32;0.580645161290323;13;18;0.0806451612903226;0.419354838709677
Control.SRR15539874;32;32;0.59375;13;19;0.09375;0.40625
Control.SRR15539874;33;32;0.363636363636364;21;12;0.136363636363636;0.363636363636364
Control.SRR15539874;36;32;0.583333333333333;15;21;0.0833333333333334;0.416666666666667
Control.SRR15539874;34;32;0.441176470588235;19;15;0.0588235294117647;0.441176470588235
Control.SRR15539874;32;32;0.34375;21;11;0.15625;0.34375
Control.SRR15539874;32;32;0.53125;15;17;0.03125;0.46875
Control.SRR15539874;31;32;0.483870967741935;16;15;0.0161290322580645;0.483870967741935
Control.SRR15539874;31;32;0.387096774193548;19;12;0.112903225806452;0.387096774193548
Control.SRR15539874;32;32;0.4375;18;14;0.0625;0.4375
Control.SRR15539874;30;32;0.5;15;15;0;0.5
Control.SRR15539874;35;32;0.4;21;14;0.1;0.4
Control.SRR15539874;32;32;0.71875;9;23;0.21875;0.28125
Control.SRR15539874;31;32;0.451612903225806;17;14;0.0483870967741936;0.451612903225806
Control.SRR15539874;29;32;0.655172413793103;10;19;0.155172413793103;0.344827586206897
Control.SRR15539874;36;32;0.472222222222222;19;17;0.0277777777777778;0.472222222222222
Control.SRR15539874;34;32;0.294117647058824;24;10;0.205882352941176;0.294117647058824
Control.SRR15539874;28;32;0.428571428571429;16;12;0.0714285714285715;0.428571428571429
Control.SRR15539874;30;32;0.566666666666667;13;17;0.0666666666666667;0.433333333333333
Control.SRR15539874;30;32;0.533333333333333;14;16;0.0333333333333333;0.466666666666667
Control.SRR15539874;28;32;0.5;14;14;0;0.5
Control.SRR15539874;30;32;0.6;12;18;0.1;0.4
Control.SRR15539874;28;32;0.428571428571429;16;12;0.0714285714285715;0.428571428571429
Control.SRR15539874;34;32;0.558823529411765;15;19;0.0588235294117647;0.441176470588235
Control.SRR15539874;32;32;0.59375;13;19;0.09375;0.40625
Control.SRR15539874;32;32;0.5;16;16;0;0.5
Control.SRR15539874;29;32;0.482758620689655;15;14;0.0172413793103448;0.482758620689655
Control.SRR15539874;35;32;0.514285714285714;17;18;0.0142857142857142;0.485714285714286
Control.SRR15539874;28;32;0.428571428571429;16;12;0.0714285714285715;0.428571428571429
Control.SRR15539874;31;32;0.387096774193548;19;12;0.112903225806452;0.387096774193548
Control.SRR15539874;33;32;0.636363636363636;12;21;0.136363636363636;0.363636363636364
Control.SRR15539874;34;32;0.470588235294118;18;16;0.0294117647058824;0.470588235294118
Control.SRR15539874;30;32;0.466666666666667;16;14;0.0333333333333333;0.466666666666667
Control.SRR15539874;32;32;0.53125;15;17;0.03125;0.46875
Control.SRR15539874;30;32;0.366666666666667;19;11;0.133333333333333;0.366666666666667
Control.SRR15539874;28;32;0.428571428571429;16;12;0.0714285714285715;0.428571428571429
Control.SRR15539874;33;32;0.666666666666667;11;22;0.166666666666667;0.333333333333333
Control.SRR15539874;31;32;0.483870967741935;16;15;0.0161290322580645;0.483870967741935
Control.SRR15539874;29;32;0.482758620689655;15;14;0.0172413793103448;0.482758620689655
Control.SRR15539874;29;32;0.482758620689655;15;14;0.0172413793103448;0.482758620689655
Control.SRR15539874;30;32;0.533333333333333;14;16;0.0333333333333333;0.466666666666667
Control.SRR15539874;30;32;0.4;18;12;0.1;0.4
Control.SRR15539874;32;32;0.5625;14;18;0.0625;0.4375
Control.SRR15539874;36;32;0.444444444444444;20;16;0.0555555555555556;0.444444444444444
Control.SRR15539874;29;32;0.448275862068966;16;13;0.0517241379310345;0.448275862068966
Control.SRR15539874;33;32;0.575757575757576;14;19;0.0757575757575758;0.424242424242424
Control.SRR15539874;28;32;0.535714285714286;13;15;0.0357142857142857;0.464285714285714
Control.SRR15539874;30;32;0.5;15;15;0;0.5
Control.SRR15539874;30;32;0.433333333333333;17;13;0.0666666666666667;0.433333333333333
Control.SRR15539874;29;32;0.482758620689655;15;14;0.0172413793103448;0.482758620689655
Control.SRR15539874;32;32;0.5;16;16;0;0.5
Control.SRR15539874;28;32;0.428571428571429;16;12;0.0714285714285715;0.428571428571429
Control.SRR15539874;32;32;0.6875;10;22;0.1875;0.3125
Control.SRR15539874;29;32;0.379310344827586;18;11;0.120689655172414;0.379310344827586
Control.SRR15539874;33;32;0.606060606060606;13;20;0.106060606060606;0.393939393939394
Control.SRR15539874;31;32;0.483870967741935;16;15;0.0161290322580645;0.483870967741935
Control.SRR15539874;31;32;0.612903225806452;12;19;0.112903225806452;0.387096774193548
Control.SRR15539874;31;32;0.516129032258065;15;16;0.0161290322580645;0.483870967741935
Control.SRR15539874;33;32;0.575757575757576;14;19;0.0757575757575758;0.424242424242424
Control.SRR15539874;28;32;0.535714285714286;13;15;0.0357142857142857;0.464285714285714
Control.SRR15539874;29;32;0.482758620689655;15;14;0.0172413793103448;0.482758620689655
Control.SRR15539874;28;32;0.464285714285714;15;13;0.0357142857142857;0.464285714285714
Control.SRR15539874;28;32;0.535714285714286;13;15;0.0357142857142857;0.464285714285714
Control.SRR15539874;33;32;0.484848484848485;17;16;0.0151515151515151;0.484848484848485
Control.SRR15539874;31;32;0.516129032258065;15;16;0.0161290322580645;0.483870967741935
Control.SRR15539874;32;32;0.375;20;12;0.125;0.375
Control.SRR15539874;34;32;0.529411764705882;16;18;0.0294117647058824;0.470588235294118
Control.SRR15539874;33;32;0.545454545454545;15;18;0.0454545454545454;0.454545454545455
Control.SRR15539874;31;32;0.548387096774194;14;17;0.0483870967741935;0.451612903225806
Control.SRR15539874;35;32;0.628571428571429;13;22;0.128571428571429;0.371428571428571
Control.SRR15539874;28;32;0.464285714285714;15;13;0.0357142857142857;0.464285714285714
Control.SRR15539874;32;32;0.5625;14;18;0.0625;0.4375
Control.SRR15539874;29;32;0.517241379310345;14;15;0.0172413793103449;0.482758620689655
Control.SRR15539874;35;32;0.542857142857143;16;19;0.0428571428571428;0.457142857142857
Control.SRR15539874;28;32;0.5;14;14;0;0.5
Control.SRR15539874;33;32;0.484848484848485;17;16;0.0151515151515151;0.484848484848485
Control.SRR15539874;31;32;0.548387096774194;14;17;0.0483870967741935;0.451612903225806
Control.SRR15539874;29;32;0.482758620689655;15;14;0.0172413793103448;0.482758620689655
Control.SRR15539874;29;32;0.413793103448276;17;12;0.0862068965517241;0.413793103448276
Control.SRR15539874;28;32;0.571428571428571;12;16;0.0714285714285714;0.428571428571429
Control.SRR15539874;29;32;0.482758620689655;15;14;0.0172413793103448;0.482758620689655
Control.SRR15539874;28;32;0.535714285714286;13;15;0.0357142857142857;0.464285714285714
Control.SRR15539874;30;32;0.533333333333333;14;16;0.0333333333333333;0.466666666666667
Control.SRR15539874;33;32;0.363636363636364;21;12;0.136363636363636;0.363636363636364
Control.SRR15539874;36;32;0.638888888888889;13;23;0.138888888888889;0.361111111111111
Control.SRR15539874;30;32;0.633333333333333;11;19;0.133333333333333;0.366666666666667
Control.SRR15539874;33;32;0.333333333333333;22;11;0.166666666666667;0.333333333333333
Control.SRR15539874;30;32;0.466666666666667;16;14;0.0333333333333333;0.466666666666667
Control.SRR15539874;30;32;0.466666666666667;16;14;0.0333333333333333;0.466666666666667
Control.SRR15539874;29;32;0.413793103448276;17;12;0.0862068965517241;0.413793103448276
Control.SRR15539874;32;32;0.4375;18;14;0.0625;0.4375
Control.SRR15539874;34;32;0.529411764705882;16;18;0.0294117647058824;0.470588235294118
Control.SRR15539874;31;32;0.612903225806452;12;19;0.112903225806452;0.387096774193548
Control.SRR15539874;31;32;0.419354838709677;18;13;0.0806451612903226;0.419354838709677
Control.SRR15539874;29;32;0.448275862068966;16;13;0.0517241379310345;0.448275862068966
Control.SRR15539874;30;32;0.4;18;12;0.1;0.4
Control.SRR15539874;33;32;0.606060606060606;13;20;0.106060606060606;0.393939393939394
Control.SRR15539874;32;32;0.40625;19;13;0.09375;0.40625
Control.SRR15539874;28;32;0.392857142857143;17;11;0.107142857142857;0.392857142857143
Control.SRR15539874;32;32;0.4375;18;14;0.0625;0.4375
Control.SRR15539874;36;32;0.388888888888889;22;14;0.111111111111111;0.388888888888889
Control.SRR15539874;30;32;0.433333333333333;17;13;0.0666666666666667;0.433333333333333
Control.SRR15539874;32;32;0.375;20;12;0.125;0.375
Control.SRR15539874;28;32;0.464285714285714;15;13;0.0357142857142857;0.464285714285714
Control.SRR15539874;29;32;0.517241379310345;14;15;0.0172413793103449;0.482758620689655
Control.SRR15539874;31;32;0.67741935483871;10;21;0.17741935483871;0.32258064516129
Control.SRR15539874;31;32;0.612903225806452;12;19;0.112903225806452;0.387096774193548
Control.SRR15539874;33;32;0.575757575757576;14;19;0.0757575757575758;0.424242424242424
Control.SRR15539874;36;32;0.638888888888889;13;23;0.138888888888889;0.361111111111111
Control.SRR15539874;32;32;0.5625;14;18;0.0625;0.4375
Control.SRR15539874;31;32;0.516129032258065;15;16;0.0161290322580645;0.483870967741935
Control.SRR15539874;28;32;0.464285714285714;15;13;0.0357142857142857;0.464285714285714
Control.SRR15539874;33;32;0.545454545454545;15;18;0.0454545454545454;0.454545454545455
Control.SRR15539874;35;32;0.514285714285714;17;18;0.0142857142857142;0.485714285714286
Control.SRR15539874;29;32;0.551724137931034;13;16;0.0517241379310345;0.448275862068966
Control.SRR15539874;34;32;0.441176470588235;19;15;0.0588235294117647;0.441176470588235
Control.SRR15539874;32;32;0.46875;17;15;0.03125;0.46875
Control.SRR15539874;33;32;0.454545454545455;18;15;0.0454545454545455;0.454545454545455
Control.SRR15539874;34;32;0.5;17;17;0;0.5
Control.SRR15539874;33;32;0.575757575757576;14;19;0.0757575757575758;0.424242424242424
Control.SRR15539874;29;32;0.448275862068966;16;13;0.0517241379310345;0.448275862068966
Control.SRR15539874;33;32;0.484848484848485;17;16;0.0151515151515151;0.484848484848485
Control.SRR15539874;35;32;0.4;21;14;0.1;0.4
Control.SRR15539874;31;32;0.516129032258065;15;16;0.0161290322580645;0.483870967741935
Control.SRR15539874;34;32;0.470588235294118;18;16;0.0294117647058824;0.470588235294118
Control.SRR15539874;32;32;0.625;12;20;0.125;0.375
Control.SRR15539874;36;32;0.416666666666667;21;15;0.0833333333333333;0.416666666666667
Control.SRR15539874;30;32;0.4;18;12;0.1;0.4
Control.SRR15539874;30;32;0.666666666666667;10;20;0.166666666666667;0.333333333333333
Control.SRR15539874;33;32;0.454545454545455;18;15;0.0454545454545455;0.454545454545455
Control.SRR15539874;31;32;0.483870967741935;16;15;0.0161290322580645;0.483870967741935
Control.SRR15539874;28;32;0.607142857142857;11;17;0.107142857142857;0.392857142857143
Control.SRR15539874;34;32;0.411764705882353;20;14;0.0882352941176471;0.411764705882353
Control.SRR15539874;28;32;0.642857142857143;10;18;0.142857142857143;0.357142857142857
Control.SRR15539874;28;32;0.392857142857143;17;11;0.107142857142857;0.392857142857143
Control.SRR15539874;29;32;0.482758620689655;15;14;0.0172413793103448;0.482758620689655
Control.SRR15539874;30;32;0.433333333333333;17;13;0.0666666666666667;0.433333333333333
Control.SRR15539874;34;32;0.441176470588235;19;15;0.0588235294117647;0.441176470588235
Control.SRR15539874;33;32;0.696969696969697;10;23;0.196969696969697;0.303030303030303
Control.SRR15539874;34;32;0.382352941176471;21;13;0.117647058823529;0.382352941176471
Control.SRR15539874;29;32;0.724137931034483;8;21;0.224137931034483;0.275862068965517
Control.SRR15539874;29;32;0.586206896551724;12;17;0.0862068965517241;0.413793103448276
Control.SRR15539874;32;32;0.53125;15;17;0.03125;0.46875
Control.SRR15539874;34;32;0.529411764705882;16;18;0.0294117647058824;0.470588235294118
Control.SRR15539874;34;32;0.441176470588235;19;15;0.0588235294117647;0.441176470588235
Control.SRR15539874;34;32;0.5;17;17;0;0.5
Control.SRR15539874;29;32;0.413793103448276;17;12;0.0862068965517241;0.413793103448276
Control.SRR15539874;30;32;0.366666666666667;19;11;0.133333333333333;0.366666666666667
Control.SRR15539874;30;32;0.5;15;15;0;0.5
Control.SRR15539874;31;32;0.419354838709677;18;13;0.0806451612903226;0.419354838709677
Control.SRR15539874;30;32;0.533333333333333;14;16;0.0333333333333333;0.466666666666667
Control.SRR15539874;33;32;0.484848484848485;17;16;0.0151515151515151;0.484848484848485
Control.SRR15539874;36;32;0.5;18;18;0;0.5
Control.SRR15539874;36;32;0.388888888888889;22;14;0.111111111111111;0.388888888888889
Control.SRR15539874;32;32;0.59375;13;19;0.09375;0.40625
Control.SRR15539874;30;32;0.433333333333333;17;13;0.0666666666666667;0.433333333333333
Control.SRR15539874;35;32;0.542857142857143;16;19;0.0428571428571428;0.457142857142857
Control.SRR15539874;35;32;0.542857142857143;16;19;0.0428571428571428;0.457142857142857
Control.SRR15539874;33;32;0.636363636363636;12;21;0.136363636363636;0.363636363636364
Control.SRR15539874;31;32;0.483870967741935;16;15;0.0161290322580645;0.483870967741935
Control.SRR15539874;35;32;0.371428571428571;22;13;0.128571428571429;0.371428571428571
Control.SRR15539874;35;32;0.4;21;14;0.1;0.4
Control.SRR15539874;32;32;0.625;12;20;0.125;0.375
Control.SRR15539874;36;32;0.388888888888889;22;14;0.111111111111111;0.388888888888889
Control.SRR15539874;34;32;0.558823529411765;15;19;0.0588235294117647;0.441176470588235
Control.SRR15539874;36;32;0.472222222222222;19;17;0.0277777777777778;0.472222222222222
Control.SRR15539874;31;32;0.645161290322581;11;20;0.145161290322581;0.354838709677419
Control.SRR15539874;33;32;0.484848484848485;17;16;0.0151515151515151;0.484848484848485
Control.SRR15539874;31;32;0.516129032258065;15;16;0.0161290322580645;0.483870967741935
Control.SRR15539874;33;32;0.545454545454545;15;18;0.0454545454545454;0.454545454545455
Control.SRR15539874;31;32;0.580645161290323;13;18;0.0806451612903226;0.419354838709677
Control.SRR15539874;31;32;0.548387096774194;14;17;0.0483870967741935;0.451612903225806
Control.SRR15539874;36;32;0.583333333333333;15;21;0.0833333333333334;0.416666666666667
Control.SRR15539874;29;32;0.586206896551724;12;17;0.0862068965517241;0.413793103448276
Control.SRR15539874;30;32;0.533333333333333;14;16;0.0333333333333333;0.466666666666667
Control.SRR15539874;30;32;0.533333333333333;14;16;0.0333333333333333;0.466666666666667
Control.SRR15539874;29;32;0.551724137931034;13;16;0.0517241379310345;0.448275862068966
Control.SRR15539874;30;32;0.533333333333333;14;16;0.0333333333333333;0.466666666666667
Control.SRR15539874;32;32;0.375;20;12;0.125;0.375
Control.SRR15539874;32;32;0.5;16;16;0;0.5
Control.SRR15539874;30;32;0.466666666666667;16;14;0.0333333333333333;0.466666666666667
Control.SRR15539874;28;32;0.571428571428571;12;16;0.0714285714285714;0.428571428571429
Control.SRR15539874;36;32;0.555555555555556;16;20;0.0555555555555556;0.444444444444444
Control.SRR15539874;35;32;0.542857142857143;16;19;0.0428571428571428;0.457142857142857
Control.SRR15539874;28;32;0.357142857142857;18;10;0.142857142857143;0.357142857142857
Control.SRR15539874;30;32;0.466666666666667;16;14;0.0333333333333333;0.466666666666667
Control.SRR15539874;35;32;0.6;14;21;0.1;0.4
Control.SRR15539874;28;32;0.428571428571429;16;12;0.0714285714285715;0.428571428571429
Control.SRR15539874;36;32;0.611111111111111;14;22;0.111111111111111;0.388888888888889
Control.SRR15539874;34;32;0.441176470588235;19;15;0.0588235294117647;0.441176470588235
Control.SRR15539874;30;32;0.6;12;18;0.1;0.4
Control.SRR15539874;29;32;0.448275862068966;16;13;0.0517241379310345;0.448275862068966
Control.SRR15539874;29;32;0.517241379310345;14;15;0.0172413793103449;0.482758620689655
Control.SRR15539874;28;32;0.642857142857143;10;18;0.142857142857143;0.357142857142857
Control.SRR15539874;28;32;0.428571428571429;16;12;0.0714285714285715;0.428571428571429
Control.SRR15539874;33;32;0.424242424242424;19;14;0.0757575757575757;0.424242424242424
Control.SRR15539874;34;32;0.5;17;17;0;0.5
Control.SRR15539874;31;32;0.451612903225806;17;14;0.0483870967741936;0.451612903225806
Control.SRR15539874;31;32;0.516129032258065;15;16;0.0161290322580645;0.483870967741935
Control.SRR15539874;35;32;0.428571428571429;20;15;0.0714285714285715;0.428571428571429
Control.SRR15539874;34;32;0.470588235294118;18;16;0.0294117647058824;0.470588235294118
Control.SRR15539874;34;32;0.5;17;17;0;0.5
Control.SRR15539874;34;32;0.617647058823529;13;21;0.117647058823529;0.382352941176471
Control.SRR15539874;28;32;0.428571428571429;16;12;0.0714285714285715;0.428571428571429
Control.SRR15539874;31;32;0.548387096774194;14;17;0.0483870967741935;0.451612903225806
Control.SRR15539874;33;32;0.606060606060606;13;20;0.106060606060606;0.393939393939394
Control.SRR15539874;30;32;0.5;15;15;0;0.5
Control.SRR15539874;28;32;0.285714285714286;20;8;0.214285714285714;0.285714285714286
Control.SRR15539874;29;32;0.482758620689655;15;14;0.0172413793103448;0.482758620689655
Control.SRR15539874;31;32;0.419354838709677;18;13;0.0806451612903226;0.419354838709677
Control.SRR15539874;31;32;0.645161290322581;11;20;0.145161290322581;0.354838709677419
Control.SRR15539874;28;32;0.464285714285714;15;13;0.0357142857142857;0.464285714285714
Control.SRR15539874;33;32;0.545454545454545;15;18;0.0454545454545454;0.454545454545455
Control.SRR15539874;35;32;0.542857142857143;16;19;0.0428571428571428;0.457142857142857
Control.SRR15539874;29;32;0.655172413793103;10;19;0.155172413793103;0.344827586206897
Control.SRR15539874;30;32;0.6;12;18;0.1;0.4
Control.SRR15539874;32;32;0.375;20;12;0.125;0.375
Control.SRR15539874;34;32;0.470588235294118;18;16;0.0294117647058824;0.470588235294118
Control.SRR15539874;35;32;0.342857142857143;23;12;0.157142857142857;0.342857142857143
Control.SRR15539874;28;32;0.392857142857143;17;11;0.107142857142857;0.392857142857143
Control.SRR15539874;32;32;0.46875;17;15;0.03125;0.46875
Control.SRR15539874;33;32;0.454545454545455;18;15;0.0454545454545455;0.454545454545455
Control.SRR15539874;36;32;0.416666666666667;21;15;0.0833333333333333;0.416666666666667
Control.SRR15539874;30;32;0.433333333333333;17;13;0.0666666666666667;0.433333333333333
Control.SRR15539874;32;32;0.53125;15;17;0.03125;0.46875
Control.SRR15539874;29;32;0.586206896551724;12;17;0.0862068965517241;0.413793103448276
Control.SRR15539874;31;32;0.548387096774194;14;17;0.0483870967741935;0.451612903225806
Control.SRR15539874;29;32;0.551724137931034;13;16;0.0517241379310345;0.448275862068966
Control.SRR15539874;35;32;0.485714285714286;18;17;0.0142857142857143;0.485714285714286
Control.SRR15539874;30;32;0.433333333333333;17;13;0.0666666666666667;0.433333333333333
Control.SRR15539874;32;32;0.4375;18;14;0.0625;0.4375
Control.SRR15539874;32;32;0.46875;17;15;0.03125;0.46875
Control.SRR15539874;33;32;0.424242424242424;19;14;0.0757575757575757;0.424242424242424
Control.SRR15539874;34;32;0.529411764705882;16;18;0.0294117647058824;0.470588235294118
Control.SRR15539874;29;32;0.413793103448276;17;12;0.0862068965517241;0.413793103448276
Control.SRR15539874;31;32;0.548387096774194;14;17;0.0483870967741935;0.451612903225806
Control.SRR15539874;28;32;0.75;7;21;0.25;0.25
Control.SRR15539874;31;32;0.548387096774194;14;17;0.0483870967741935;0.451612903225806
Control.SRR15539874;33;32;0.303030303030303;23;10;0.196969696969697;0.303030303030303
Control.SRR15539874;31;32;0.516129032258065;15;16;0.0161290322580645;0.483870967741935
Control.SRR15539874;33;32;0.606060606060606;13;20;0.106060606060606;0.393939393939394
Control.SRR15539874;30;32;0.433333333333333;17;13;0.0666666666666667;0.433333333333333
Control.SRR15539874;28;32;0.5;14;14;0;0.5
Control.SRR15539874;28;32;0.678571428571429;9;19;0.178571428571429;0.321428571428571
Control.SRR15539874;29;32;0.448275862068966;16;13;0.0517241379310345;0.448275862068966
Control.SRR15539874;30;32;0.433333333333333;17;13;0.0666666666666667;0.433333333333333
Control.SRR15539874;28;32;0.642857142857143;10;18;0.142857142857143;0.357142857142857
Control.SRR15539874;36;32;0.361111111111111;23;13;0.138888888888889;0.361111111111111
Control.SRR15539874;29;32;0.482758620689655;15;14;0.0172413793103448;0.482758620689655
Control.SRR15539874;33;32;0.606060606060606;13;20;0.106060606060606;0.393939393939394
Control.SRR15539874;30;32;0.433333333333333;17;13;0.0666666666666667;0.433333333333333
Control.SRR15539874;34;32;0.382352941176471;21;13;0.117647058823529;0.382352941176471
Control.SRR15539874;31;32;0.387096774193548;19;12;0.112903225806452;0.387096774193548
Control.SRR15539874;30;32;0.3;21;9;0.2;0.3
Control.SRR15539874;35;32;0.6;14;21;0.1;0.4
Control.SRR15539874;29;32;0.448275862068966;16;13;0.0517241379310345;0.448275862068966
Control.SRR15539874;35;32;0.514285714285714;17;18;0.0142857142857142;0.485714285714286
Control.SRR15539874;33;32;0.515151515151515;16;17;0.0151515151515151;0.484848484848485
Control.SRR15539874;28;32;0.607142857142857;11;17;0.107142857142857;0.392857142857143
Control.SRR15539874;35;32;0.571428571428571;15;20;0.0714285714285714;0.428571428571429
Control.SRR15539874;31;32;0.548387096774194;14;17;0.0483870967741935;0.451612903225806
Control.SRR15539874;28;32;0.5;14;14;0;0.5
Control.SRR15539874;31;32;0.483870967741935;16;15;0.0161290322580645;0.483870967741935
Control.SRR15539874;30;32;0.366666666666667;19;11;0.133333333333333;0.366666666666667
Control.SRR15539874;34;32;0.529411764705882;16;18;0.0294117647058824;0.470588235294118
Control.SRR15539874;33;32;0.575757575757576;14;19;0.0757575757575758;0.424242424242424
Control.SRR15539874;32;32;0.5625;14;18;0.0625;0.4375
Control.SRR15539874;36;32;0.444444444444444;20;16;0.0555555555555556;0.444444444444444
Control.SRR15539874;30;32;0.533333333333333;14;16;0.0333333333333333;0.466666666666667
Control.SRR15539874;31;32;0.483870967741935;16;15;0.0161290322580645;0.483870967741935
Control.SRR15539874;34;32;0.529411764705882;16;18;0.0294117647058824;0.470588235294118
Control.SRR15539874;32;32;0.3125;22;10;0.1875;0.3125
Control.SRR15539874;33;32;0.575757575757576;14;19;0.0757575757575758;0.424242424242424
Control.SRR15539874;32;32;0.59375;13;19;0.09375;0.40625
Control.SRR15539874;34;32;0.382352941176471;21;13;0.117647058823529;0.382352941176471
Control.SRR15539874;31;32;0.387096774193548;19;12;0.112903225806452;0.387096774193548
Control.SRR15539874;33;32;0.545454545454545;15;18;0.0454545454545454;0.454545454545455
Control.SRR15539874;35;32;0.6;14;21;0.1;0.4
Control.SRR15539874;29;32;0.620689655172414;11;18;0.120689655172414;0.379310344827586
Control.SRR15539874;34;32;0.617647058823529;13;21;0.117647058823529;0.382352941176471
Control.SRR15539874;30;32;0.433333333333333;17;13;0.0666666666666667;0.433333333333333
Control.SRR15539874;32;32;0.5;16;16;0;0.5
Control.SRR15539874;32;32;0.4375;18;14;0.0625;0.4375
Control.SRR15539874;35;32;0.571428571428571;15;20;0.0714285714285714;0.428571428571429
Control.SRR15539874;35;32;0.485714285714286;18;17;0.0142857142857143;0.485714285714286
Control.SRR15539874;33;32;0.606060606060606;13;20;0.106060606060606;0.393939393939394
Control.SRR15539874;31;32;0.580645161290323;13;18;0.0806451612903226;0.419354838709677
Control.SRR15539874;35;32;0.571428571428571;15;20;0.0714285714285714;0.428571428571429
Control.SRR15539874;36;32;0.416666666666667;21;15;0.0833333333333333;0.416666666666667
Control.SRR15539874;32;32;0.4375;18;14;0.0625;0.4375
Control.SRR15539874;32;32;0.40625;19;13;0.09375;0.40625
Control.SRR15539874;34;32;0.470588235294118;18;16;0.0294117647058824;0.470588235294118
Control.SRR15539874;36;32;0.333333333333333;24;12;0.166666666666667;0.333333333333333
Control.SRR15539874;35;32;0.428571428571429;20;15;0.0714285714285715;0.428571428571429
Control.SRR15539874;31;32;0.645161290322581;11;20;0.145161290322581;0.354838709677419
Control.SRR15539874;36;32;0.472222222222222;19;17;0.0277777777777778;0.472222222222222
Control.SRR15539874;31;32;0.516129032258065;15;16;0.0161290322580645;0.483870967741935
Control.SRR15539874;32;32;0.4375;18;14;0.0625;0.4375
Control.SRR15539874;35;32;0.457142857142857;19;16;0.0428571428571429;0.457142857142857
Control.SRR15539874;33;32;0.393939393939394;20;13;0.106060606060606;0.393939393939394
Control.SRR15539874;33;32;0.424242424242424;19;14;0.0757575757575757;0.424242424242424
Control.SRR15539874;29;32;0.551724137931034;13;16;0.0517241379310345;0.448275862068966
Control.SRR15539874;33;32;0.575757575757576;14;19;0.0757575757575758;0.424242424242424
Control.SRR15539874;28;32;0.357142857142857;18;10;0.142857142857143;0.357142857142857
Control.SRR15539874;28;32;0.678571428571429;9;19;0.178571428571429;0.321428571428571
Control.SRR15539874;32;32;0.34375;21;11;0.15625;0.34375
Control.SRR15539874;29;32;0.413793103448276;17;12;0.0862068965517241;0.413793103448276
Control.SRR15539874;30;32;0.533333333333333;14;16;0.0333333333333333;0.466666666666667
Control.SRR15539874;28;32;0.5;14;14;0;0.5
Control.SRR15539874;30;32;0.333333333333333;20;10;0.166666666666667;0.333333333333333
Control.SRR15539874;35;32;0.428571428571429;20;15;0.0714285714285715;0.428571428571429
Control.SRR15539874;32;32;0.5;16;16;0;0.5
Control.SRR15539874;32;32;0.6875;10;22;0.1875;0.3125
Control.SRR15539874;31;32;0.580645161290323;13;18;0.0806451612903226;0.419354838709677
Control.SRR15539874;33;32;0.545454545454545;15;18;0.0454545454545454;0.454545454545455
Control.SRR15539874;36;32;0.472222222222222;19;17;0.0277777777777778;0.472222222222222
Control.SRR15539874;34;32;0.617647058823529;13;21;0.117647058823529;0.382352941176471
Control.SRR15539874;29;32;0.413793103448276;17;12;0.0862068965517241;0.413793103448276
Control.SRR15539874;30;32;0.5;15;15;0;0.5
Control.SRR15539874;34;32;0.558823529411765;15;19;0.0588235294117647;0.441176470588235
Control.SRR15539874;34;32;0.5;17;17;0;0.5
Control.SRR15539874;33;32;0.454545454545455;18;15;0.0454545454545455;0.454545454545455
Control.SRR15539874;34;32;0.5;17;17;0;0.5
Control.SRR15539874;32;32;0.34375;21;11;0.15625;0.34375
Control.SRR15539874;30;32;0.666666666666667;10;20;0.166666666666667;0.333333333333333
Control.SRR15539874;31;32;0.516129032258065;15;16;0.0161290322580645;0.483870967741935
Control.SRR15539874;35;32;0.485714285714286;18;17;0.0142857142857143;0.485714285714286
Control.SRR15539874;33;32;0.606060606060606;13;20;0.106060606060606;0.393939393939394
Control.SRR15539874;35;32;0.657142857142857;12;23;0.157142857142857;0.342857142857143
Control.SRR15539874;33;32;0.515151515151515;16;17;0.0151515151515151;0.484848484848485
Control.SRR15539874;30;32;0.4;18;12;0.1;0.4
Control.SRR15539874;36;32;0.527777777777778;17;19;0.0277777777777778;0.472222222222222
Control.SRR15539874;32;32;0.375;20;12;0.125;0.375
Control.SRR15539874;32;32;0.4375;18;14;0.0625;0.4375
Control.SRR15539874;35;32;0.342857142857143;23;12;0.157142857142857;0.342857142857143
Control.SRR15539874;28;32;0.571428571428571;12;16;0.0714285714285714;0.428571428571429
Control.SRR15539874;36;32;0.416666666666667;21;15;0.0833333333333333;0.416666666666667
Control.SRR15539874;35;32;0.428571428571429;20;15;0.0714285714285715;0.428571428571429
Control.SRR15539874;32;32;0.46875;17;15;0.03125;0.46875
Control.SRR15539874;33;32;0.545454545454545;15;18;0.0454545454545454;0.454545454545455
Control.SRR15539874;33;32;0.545454545454545;15;18;0.0454545454545454;0.454545454545455
Control.SRR15539874;34;32;0.588235294117647;14;20;0.0882352941176471;0.411764705882353
Control.SRR15539874;33;32;0.636363636363636;12;21;0.136363636363636;0.363636363636364
Control.SRR15539874;35;32;0.514285714285714;17;18;0.0142857142857142;0.485714285714286
Control.SRR15539874;32;32;0.5625;14;18;0.0625;0.4375
Control.SRR15539874;28;32;0.678571428571429;9;19;0.178571428571429;0.321428571428571
Control.SRR15539874;32;32;0.59375;13;19;0.09375;0.40625
Control.SRR15539874;33;32;0.515151515151515;16;17;0.0151515151515151;0.484848484848485
Control.SRR15539874;34;32;0.470588235294118;18;16;0.0294117647058824;0.470588235294118
Control.SRR15539874;31;32;0.483870967741935;16;15;0.0161290322580645;0.483870967741935
Control.SRR15539874;33;32;0.727272727272727;9;24;0.227272727272727;0.272727272727273
Control.SRR15539874;29;32;0.482758620689655;15;14;0.0172413793103448;0.482758620689655
Control.SRR15539874;35;32;0.514285714285714;17;18;0.0142857142857142;0.485714285714286
Control.SRR15539874;31;32;0.580645161290323;13;18;0.0806451612903226;0.419354838709677
Control.SRR15539874;31;32;0.451612903225806;17;14;0.0483870967741936;0.451612903225806
Control.SRR15539874;32;32;0.65625;11;21;0.15625;0.34375
Control.SRR15539874;28;32;0.535714285714286;13;15;0.0357142857142857;0.464285714285714
Control.SRR15539874;32;32;0.5625;14;18;0.0625;0.4375
Control.SRR15539874;34;32;0.676470588235294;11;23;0.176470588235294;0.323529411764706
Control.SRR15539874;32;32;0.46875;17;15;0.03125;0.46875
Control.SRR15539874;31;32;0.483870967741935;16;15;0.0161290322580645;0.483870967741935
Control.SRR15539874;33;32;0.454545454545455;18;15;0.0454545454545455;0.454545454545455
Control.SRR15539874;28;32;0.321428571428571;19;9;0.178571428571429;0.321428571428571
Control.SRR15539874;32;32;0.34375;21;11;0.15625;0.34375
Control.SRR15539874;32;32;0.53125;15;17;0.03125;0.46875
Control.SRR15539874;29;32;0.413793103448276;17;12;0.0862068965517241;0.413793103448276
Control.SRR15539874;32;32;0.28125;23;9;0.21875;0.28125
Control.SRR15539874;32;32;0.5;16;16;0;0.5
Control.SRR15539874;33;32;0.515151515151515;16;17;0.0151515151515151;0.484848484848485
Control.SRR15539874;34;32;0.352941176470588;22;12;0.147058823529412;0.352941176470588
Control.SRR15539874;35;32;0.457142857142857;19;16;0.0428571428571429;0.457142857142857
Control.SRR15539874;30;32;0.5;15;15;0;0.5
Control.SRR15539874;30;32;0.633333333333333;11;19;0.133333333333333;0.366666666666667
Control.SRR15539874;34;32;0.5;17;17;0;0.5
Control.SRR15539874;28;32;0.392857142857143;17;11;0.107142857142857;0.392857142857143
Control.SRR15539874;34;32;0.470588235294118;18;16;0.0294117647058824;0.470588235294118
Control.SRR15539874;36;32;0.611111111111111;14;22;0.111111111111111;0.388888888888889
Control.SRR15539874;32;32;0.375;20;12;0.125;0.375
Control.SRR15539874;35;32;0.571428571428571;15;20;0.0714285714285714;0.428571428571429
Control.SRR15539874;36;32;0.527777777777778;17;19;0.0277777777777778;0.472222222222222
Control.SRR15539874;28;32;0.5;14;14;0;0.5
Control.SRR15539874;36;32;0.444444444444444;20;16;0.0555555555555556;0.444444444444444
Control.SRR15539874;30;32;0.433333333333333;17;13;0.0666666666666667;0.433333333333333
Control.SRR15539874;35;32;0.571428571428571;15;20;0.0714285714285714;0.428571428571429
Control.SRR15539874;36;32;0.638888888888889;13;23;0.138888888888889;0.361111111111111
Control.SRR15539874;33;32;0.272727272727273;24;9;0.227272727272727;0.272727272727273
Control.SRR15539874;28;32;0.678571428571429;9;19;0.178571428571429;0.321428571428571
Control.SRR15539874;32;32;0.375;20;12;0.125;0.375
Control.SRR15539874;35;32;0.457142857142857;19;16;0.0428571428571429;0.457142857142857
Control.SRR15539874;33;32;0.575757575757576;14;19;0.0757575757575758;0.424242424242424
Control.SRR15539874;35;32;0.514285714285714;17;18;0.0142857142857142;0.485714285714286
Control.SRR15539874;36;32;0.277777777777778;26;10;0.222222222222222;0.277777777777778
Control.SRR15539874;34;32;0.529411764705882;16;18;0.0294117647058824;0.470588235294118
Control.SRR15539874;33;32;0.484848484848485;17;16;0.0151515151515151;0.484848484848485
Control.SRR15539874;33;32;0.424242424242424;19;14;0.0757575757575757;0.424242424242424
Control.SRR15539874;30;32;0.533333333333333;14;16;0.0333333333333333;0.466666666666667
Control.SRR15539874;33;32;0.454545454545455;18;15;0.0454545454545455;0.454545454545455
Control.SRR15539874;35;32;0.628571428571429;13;22;0.128571428571429;0.371428571428571
Control.SRR15539874;30;32;0.6;12;18;0.1;0.4
Control.SRR15539874;31;32;0.387096774193548;19;12;0.112903225806452;0.387096774193548
Control.SRR15539874;35;32;0.6;14;21;0.1;0.4
Control.SRR15539874;34;32;0.382352941176471;21;13;0.117647058823529;0.382352941176471
Control.SRR15539874;34;32;0.617647058823529;13;21;0.117647058823529;0.382352941176471
Control.SRR15539874;31;32;0.451612903225806;17;14;0.0483870967741936;0.451612903225806
Control.SRR15539874;35;32;0.457142857142857;19;16;0.0428571428571429;0.457142857142857
Control.SRR15539874;29;32;0.482758620689655;15;14;0.0172413793103448;0.482758620689655
Control.SRR15539874;31;32;0.67741935483871;10;21;0.17741935483871;0.32258064516129
Control.SRR15539874;33;32;0.545454545454545;15;18;0.0454545454545454;0.454545454545455
Control.SRR15539874;30;32;0.466666666666667;16;14;0.0333333333333333;0.466666666666667
Control.SRR15539874;32;32;0.53125;15;17;0.03125;0.46875
Control.SRR15539874;30;32;0.433333333333333;17;13;0.0666666666666667;0.433333333333333
Control.SRR15539874;35;32;0.657142857142857;12;23;0.157142857142857;0.342857142857143
Control.SRR15539874;33;32;0.333333333333333;22;11;0.166666666666667;0.333333333333333
Control.SRR15539874;35;32;0.485714285714286;18;17;0.0142857142857143;0.485714285714286
Control.SRR15539874;31;32;0.548387096774194;14;17;0.0483870967741935;0.451612903225806
Control.SRR15539874;29;32;0.551724137931034;13;16;0.0517241379310345;0.448275862068966
Control.SRR15539874;32;32;0.5625;14;18;0.0625;0.4375
Control.SRR15539874;34;32;0.529411764705882;16;18;0.0294117647058824;0.470588235294118
Control.SRR15539874;35;32;0.457142857142857;19;16;0.0428571428571429;0.457142857142857
Control.SRR15539874;36;32;0.611111111111111;14;22;0.111111111111111;0.388888888888889
Control.SRR15539874;34;32;0.5;17;17;0;0.5
Control.SRR15539874;30;32;0.7;9;21;0.2;0.3
Control.SRR15539874;31;32;0.451612903225806;17;14;0.0483870967741936;0.451612903225806
Control.SRR15539874;29;32;0.448275862068966;16;13;0.0517241379310345;0.448275862068966
Control.SRR15539874;34;32;0.558823529411765;15;19;0.0588235294117647;0.441176470588235
Control.SRR15539874;29;32;0.448275862068966;16;13;0.0517241379310345;0.448275862068966
Control.SRR15539874;30;32;0.466666666666667;16;14;0.0333333333333333;0.466666666666667
Control.SRR15539874;28;32;0.357142857142857;18;10;0.142857142857143;0.357142857142857
Control.SRR15539874;35;32;0.428571428571429;20;15;0.0714285714285715;0.428571428571429
Control.SRR15539874;33;32;0.454545454545455;18;15;0.0454545454545455;0.454545454545455
Control.SRR15539874;32;32;0.46875;17;15;0.03125;0.46875
Control.SRR15539874;32;32;0.40625;19;13;0.09375;0.40625
Control.SRR15539874;36;32;0.444444444444444;20;16;0.0555555555555556;0.444444444444444
Control.SRR15539874;33;32;0.515151515151515;16;17;0.0151515151515151;0.484848484848485
Control.SRR15539874;36;32;0.472222222222222;19;17;0.0277777777777778;0.472222222222222
Control.SRR15539874;33;32;0.393939393939394;20;13;0.106060606060606;0.393939393939394
Control.SRR15539874;36;32;0.583333333333333;15;21;0.0833333333333334;0.416666666666667
Control.SRR15539874;34;32;0.588235294117647;14;20;0.0882352941176471;0.411764705882353
Control.SRR15539874;32;32;0.59375;13;19;0.09375;0.40625
Control.SRR15539874;32;32;0.5625;14;18;0.0625;0.4375
Control.SRR15539874;30;32;0.533333333333333;14;16;0.0333333333333333;0.466666666666667
Control.SRR15539874;36;32;0.361111111111111;23;13;0.138888888888889;0.361111111111111
Control.SRR15539874;36;32;0.472222222222222;19;17;0.0277777777777778;0.472222222222222
Control.SRR15539874;34;32;0.441176470588235;19;15;0.0588235294117647;0.441176470588235
Control.SRR15539874;36;32;0.611111111111111;14;22;0.111111111111111;0.388888888888889
Control.SRR15539874;32;32;0.375;20;12;0.125;0.375
Control.SRR15539874;35;32;0.714285714285714;10;25;0.214285714285714;0.285714285714286
Control.SRR15539874;31;32;0.548387096774194;14;17;0.0483870967741935;0.451612903225806
Control.SRR15539874;29;32;0.551724137931034;13;16;0.0517241379310345;0.448275862068966
Control.SRR15539874;36;32;0.388888888888889;22;14;0.111111111111111;0.388888888888889
Control.SRR15539874;31;32;0.612903225806452;12;19;0.112903225806452;0.387096774193548
Control.SRR15539874;29;32;0.344827586206897;19;10;0.155172413793103;0.344827586206897
Control.SRR15539874;32;32;0.4375;18;14;0.0625;0.4375
Control.SRR15539874;29;32;0.482758620689655;15;14;0.0172413793103448;0.482758620689655
Control.SRR15539874;33;32;0.666666666666667;11;22;0.166666666666667;0.333333333333333
Control.SRR15539874;33;32;0.484848484848485;17;16;0.0151515151515151;0.484848484848485
Control.SRR15539874;35;32;0.457142857142857;19;16;0.0428571428571429;0.457142857142857
Control.SRR15539874;32;32;0.46875;17;15;0.03125;0.46875
Control.SRR15539874;31;32;0.451612903225806;17;14;0.0483870967741936;0.451612903225806
Control.SRR15539874;32;32;0.4375;18;14;0.0625;0.4375
Control.SRR15539874;32;32;0.53125;15;17;0.03125;0.46875
Control.SRR15539874;35;32;0.485714285714286;18;17;0.0142857142857143;0.485714285714286
Control.SRR15539874;34;32;0.470588235294118;18;16;0.0294117647058824;0.470588235294118
Control.SRR15539874;29;32;0.448275862068966;16;13;0.0517241379310345;0.448275862068966
Control.SRR15539874;29;32;0.551724137931034;13;16;0.0517241379310345;0.448275862068966
Control.SRR15539874;33;32;0.606060606060606;13;20;0.106060606060606;0.393939393939394
Control.SRR15539874;32;32;0.40625;19;13;0.09375;0.40625
Control.SRR15539874;28;32;0.5;14;14;0;0.5
Control.SRR15539874;30;32;0.566666666666667;13;17;0.0666666666666667;0.433333333333333
Control.SRR15539874;33;32;0.545454545454545;15;18;0.0454545454545454;0.454545454545455
Control.SRR15539874;33;32;0.545454545454545;15;18;0.0454545454545454;0.454545454545455
Control.SRR15539874;35;32;0.628571428571429;13;22;0.128571428571429;0.371428571428571
Control.SRR15539874;34;32;0.5;17;17;0;0.5
Control.SRR15539874;33;32;0.454545454545455;18;15;0.0454545454545455;0.454545454545455
Control.SRR15539874;36;32;0.527777777777778;17;19;0.0277777777777778;0.472222222222222
Control.SRR15539874;35;32;0.714285714285714;10;25;0.214285714285714;0.285714285714286
Control.SRR15539874;32;32;0.53125;15;17;0.03125;0.46875
Control.SRR15539874;30;32;0.533333333333333;14;16;0.0333333333333333;0.466666666666667
Control.SRR15539874;33;32;0.515151515151515;16;17;0.0151515151515151;0.484848484848485
Control.SRR15539874;35;32;0.571428571428571;15;20;0.0714285714285714;0.428571428571429
Control.SRR15539874;35;32;0.657142857142857;12;23;0.157142857142857;0.342857142857143
Control.SRR15539874;28;32;0.535714285714286;13;15;0.0357142857142857;0.464285714285714
Control.SRR15539874;29;32;0.551724137931034;13;16;0.0517241379310345;0.448275862068966
Control.SRR15539874;28;32;0.392857142857143;17;11;0.107142857142857;0.392857142857143
Control.SRR15539874;30;32;0.6;12;18;0.1;0.4
Control.SRR15539874;34;32;0.529411764705882;16;18;0.0294117647058824;0.470588235294118
Control.SRR15539874;36;32;0.527777777777778;17;19;0.0277777777777778;0.472222222222222
Control.SRR15539874;36;32;0.555555555555556;16;20;0.0555555555555556;0.444444444444444
Control.SRR15539874;35;32;0.542857142857143;16;19;0.0428571428571428;0.457142857142857
Control.SRR15539874;36;32;0.472222222222222;19;17;0.0277777777777778;0.472222222222222
Control.SRR15539874;33;32;0.424242424242424;19;14;0.0757575757575757;0.424242424242424
Control.SRR15539874;31;32;0.548387096774194;14;17;0.0483870967741935;0.451612903225806
Control.SRR15539874;29;32;0.379310344827586;18;11;0.120689655172414;0.379310344827586
Control.SRR15539874;29;32;0.482758620689655;15;14;0.0172413793103448;0.482758620689655
Control.SRR15539874;32;32;0.5625;14;18;0.0625;0.4375
Control.SRR15539874;36;32;0.527777777777778;17;19;0.0277777777777778;0.472222222222222
Control.SRR15539874;33;32;0.515151515151515;16;17;0.0151515151515151;0.484848484848485
Control.SRR15539874;32;32;0.625;12;20;0.125;0.375
Control.SRR15539874;34;32;0.5;17;17;0;0.5
Control.SRR15539874;35;32;0.485714285714286;18;17;0.0142857142857143;0.485714285714286
Control.SRR15539874;31;32;0.548387096774194;14;17;0.0483870967741935;0.451612903225806
Control.SRR15539874;34;32;0.470588235294118;18;16;0.0294117647058824;0.470588235294118
Control.SRR15539874;31;32;0.548387096774194;14;17;0.0483870967741935;0.451612903225806
Control.SRR15539874;32;32;0.59375;13;19;0.09375;0.40625
Control.SRR15539874;32;32;0.5;16;16;0;0.5
Control.SRR15539874;34;32;0.529411764705882;16;18;0.0294117647058824;0.470588235294118
Control.SRR15539874;34;32;0.529411764705882;16;18;0.0294117647058824;0.470588235294118
Control.SRR15539874;35;32;0.571428571428571;15;20;0.0714285714285714;0.428571428571429
Control.SRR15539874;36;32;0.5;18;18;0;0.5
Control.SRR15539874;30;32;0.533333333333333;14;16;0.0333333333333333;0.466666666666667
Control.SRR15539874;36;32;0.611111111111111;14;22;0.111111111111111;0.388888888888889
Control.SRR15539874;30;32;0.533333333333333;14;16;0.0333333333333333;0.466666666666667
Control.SRR15539874;33;32;0.484848484848485;17;16;0.0151515151515151;0.484848484848485
Control.SRR15539874;35;32;0.514285714285714;17;18;0.0142857142857142;0.485714285714286
Control.SRR15539874;36;32;0.666666666666667;12;24;0.166666666666667;0.333333333333333
Control.SRR15539874;31;32;0.354838709677419;20;11;0.145161290322581;0.354838709677419
Control.SRR15539874;32;32;0.375;20;12;0.125;0.375
Control.SRR15539874;32;32;0.46875;17;15;0.03125;0.46875
Control.SRR15539874;30;32;0.466666666666667;16;14;0.0333333333333333;0.466666666666667
Control.SRR15539874;33;32;0.606060606060606;13;20;0.106060606060606;0.393939393939394
Control.SRR15539874;35;32;0.4;21;14;0.1;0.4
Control.SRR15539874;31;32;0.354838709677419;20;11;0.145161290322581;0.354838709677419
Control.SRR15539874;33;32;0.363636363636364;21;12;0.136363636363636;0.363636363636364
Control.SRR15539874;28;32;0.357142857142857;18;10;0.142857142857143;0.357142857142857
Control.SRR15539874;34;32;0.470588235294118;18;16;0.0294117647058824;0.470588235294118
Control.SRR15539874;35;32;0.485714285714286;18;17;0.0142857142857143;0.485714285714286
Control.SRR15539874;33;32;0.454545454545455;18;15;0.0454545454545455;0.454545454545455
Control.SRR15539874;35;32;0.542857142857143;16;19;0.0428571428571428;0.457142857142857
Control.SRR15539874;31;32;0.548387096774194;14;17;0.0483870967741935;0.451612903225806
Control.SRR15539874;32;32;0.625;12;20;0.125;0.375
Control.SRR15539874;34;32;0.558823529411765;15;19;0.0588235294117647;0.441176470588235
Control.SRR15539874;30;32;0.433333333333333;17;13;0.0666666666666667;0.433333333333333
Control.SRR15539874;36;32;0.388888888888889;22;14;0.111111111111111;0.388888888888889
Control.SRR15539874;28;32;0.571428571428571;12;16;0.0714285714285714;0.428571428571429
Control.SRR15539874;34;32;0.617647058823529;13;21;0.117647058823529;0.382352941176471
Control.SRR15539874;30;32;0.6;12;18;0.1;0.4
Control.SRR15539874;33;32;0.606060606060606;13;20;0.106060606060606;0.393939393939394
Control.SRR15539874;31;32;0.483870967741935;16;15;0.0161290322580645;0.483870967741935
Control.SRR15539874;35;32;0.485714285714286;18;17;0.0142857142857143;0.485714285714286
Control.SRR15539874;35;32;0.542857142857143;16;19;0.0428571428571428;0.457142857142857
Control.SRR15539874;28;32;0.607142857142857;11;17;0.107142857142857;0.392857142857143
Control.SRR15539874;34;32;0.529411764705882;16;18;0.0294117647058824;0.470588235294118
Control.SRR15539874;36;32;0.527777777777778;17;19;0.0277777777777778;0.472222222222222
Control.SRR15539874;33;32;0.363636363636364;21;12;0.136363636363636;0.363636363636364
Control.SRR15539874;36;32;0.555555555555556;16;20;0.0555555555555556;0.444444444444444
Control.SRR15539874;36;32;0.611111111111111;14;22;0.111111111111111;0.388888888888889
Control.SRR15539874;34;32;0.470588235294118;18;16;0.0294117647058824;0.470588235294118
Control.SRR15539874;34;32;0.352941176470588;22;12;0.147058823529412;0.352941176470588
Control.SRR15539874;30;32;0.533333333333333;14;16;0.0333333333333333;0.466666666666667
Control.SRR15539874;30;32;0.533333333333333;14;16;0.0333333333333333;0.466666666666667
Control.SRR15539874;36;32;0.583333333333333;15;21;0.0833333333333334;0.416666666666667
Control.SRR15539874;33;32;0.393939393939394;20;13;0.106060606060606;0.393939393939394
Control.SRR15539874;36;32;0.5;18;18;0;0.5
Control.SRR15539874;34;32;0.441176470588235;19;15;0.0588235294117647;0.441176470588235
Control.SRR15539874;35;32;0.457142857142857;19;16;0.0428571428571429;0.457142857142857
Control.SRR15539874;28;32;0.642857142857143;10;18;0.142857142857143;0.357142857142857
Control.SRR15539874;31;32;0.258064516129032;23;8;0.241935483870968;0.258064516129032
Control.SRR15539874;35;32;0.514285714285714;17;18;0.0142857142857142;0.485714285714286
Control.SRR15539874;36;32;0.388888888888889;22;14;0.111111111111111;0.388888888888889
Control.SRR15539874;30;32;0.533333333333333;14;16;0.0333333333333333;0.466666666666667
Control.SRR15539874;32;32;0.4375;18;14;0.0625;0.4375
Control.SRR15539874;36;32;0.444444444444444;20;16;0.0555555555555556;0.444444444444444
Control.SRR15539874;34;32;0.529411764705882;16;18;0.0294117647058824;0.470588235294118
Control.SRR15539874;28;32;0.5;14;14;0;0.5
Control.SRR15539874;35;32;0.514285714285714;17;18;0.0142857142857142;0.485714285714286
Control.SRR15539874;33;32;0.545454545454545;15;18;0.0454545454545454;0.454545454545455
Control.SRR15539874;31;32;0.548387096774194;14;17;0.0483870967741935;0.451612903225806
Control.SRR15539874;29;32;0.517241379310345;14;15;0.0172413793103449;0.482758620689655
Control.SRR15539874;30;32;0.5;15;15;0;0.5
Control.SRR15539874;32;32;0.625;12;20;0.125;0.375
Control.SRR15539874;36;32;0.444444444444444;20;16;0.0555555555555556;0.444444444444444
Control.SRR15539874;31;32;0.580645161290323;13;18;0.0806451612903226;0.419354838709677
Control.SRR15539874;35;32;0.428571428571429;20;15;0.0714285714285715;0.428571428571429
Control.SRR15539874;36;32;0.472222222222222;19;17;0.0277777777777778;0.472222222222222
Control.SRR15539874;30;32;0.6;12;18;0.1;0.4
Control.SRR15539874;32;32;0.46875;17;15;0.03125;0.46875
Control.SRR15539874;29;32;0.344827586206897;19;10;0.155172413793103;0.344827586206897
Control.SRR15539874;34;32;0.411764705882353;20;14;0.0882352941176471;0.411764705882353
Control.SRR15539874;30;32;0.5;15;15;0;0.5
Control.SRR15539874;29;32;0.517241379310345;14;15;0.0172413793103449;0.482758620689655
Control.SRR15539874;35;32;0.514285714285714;17;18;0.0142857142857142;0.485714285714286
Control.SRR15539874;34;32;0.647058823529412;12;22;0.147058823529412;0.352941176470588
Control.SRR15539874;35;32;0.542857142857143;16;19;0.0428571428571428;0.457142857142857
Control.SRR15539874;32;32;0.53125;15;17;0.03125;0.46875
Control.SRR15539874;32;32;0.4375;18;14;0.0625;0.4375
Control.SRR15539874;28;32;0.535714285714286;13;15;0.0357142857142857;0.464285714285714
Control.SRR15539874;32;32;0.46875;17;15;0.03125;0.46875
Control.SRR15539874;32;32;0.59375;13;19;0.09375;0.40625
Control.SRR15539874;35;32;0.571428571428571;15;20;0.0714285714285714;0.428571428571429
Control.SRR15539874;33;32;0.424242424242424;19;14;0.0757575757575757;0.424242424242424
Control.SRR15539874;35;32;0.542857142857143;16;19;0.0428571428571428;0.457142857142857
Control.SRR15539874;35;32;0.628571428571429;13;22;0.128571428571429;0.371428571428571
Control.SRR15539874;31;32;0.548387096774194;14;17;0.0483870967741935;0.451612903225806
Control.SRR15539874;33;32;0.575757575757576;14;19;0.0757575757575758;0.424242424242424
Control.SRR15539874;31;32;0.516129032258065;15;16;0.0161290322580645;0.483870967741935
Control.SRR15539874;35;32;0.4;21;14;0.1;0.4
Control.SRR15539874;35;32;0.542857142857143;16;19;0.0428571428571428;0.457142857142857
Control.SRR15539874;34;32;0.5;17;17;0;0.5
Control.SRR15539874;32;32;0.59375;13;19;0.09375;0.40625
Control.SRR15539874;29;32;0.551724137931034;13;16;0.0517241379310345;0.448275862068966
Control.SRR15539874;36;32;0.388888888888889;22;14;0.111111111111111;0.388888888888889
Control.SRR15539874;32;32;0.5;16;16;0;0.5
Control.SRR15539874;34;32;0.5;17;17;0;0.5
Control.SRR15539874;29;32;0.724137931034483;8;21;0.224137931034483;0.275862068965517
Control.SRR15539874;32;32;0.625;12;20;0.125;0.375
Control.SRR15539874;36;32;0.722222222222222;10;26;0.222222222222222;0.277777777777778
Control.SRR15539874;32;32;0.28125;23;9;0.21875;0.28125
Control.SRR15539874;28;32;0.571428571428571;12;16;0.0714285714285714;0.428571428571429
Control.SRR15539874;31;32;0.483870967741935;16;15;0.0161290322580645;0.483870967741935
Control.SRR15539874;30;32;0.533333333333333;14;16;0.0333333333333333;0.466666666666667
Control.SRR15539874;29;32;0.448275862068966;16;13;0.0517241379310345;0.448275862068966
Control.SRR15539874;30;32;0.4;18;12;0.1;0.4
Control.SRR15539874;28;32;0.428571428571429;16;12;0.0714285714285715;0.428571428571429
Control.SRR15539874;33;32;0.545454545454545;15;18;0.0454545454545454;0.454545454545455
Control.SRR15539874;33;32;0.424242424242424;19;14;0.0757575757575757;0.424242424242424
Control.SRR15539874;28;32;0.5;14;14;0;0.5
Control.SRR15539874;36;32;0.388888888888889;22;14;0.111111111111111;0.388888888888889
Control.SRR15539874;29;32;0.482758620689655;15;14;0.0172413793103448;0.482758620689655
Control.SRR15539874;30;32;0.533333333333333;14;16;0.0333333333333333;0.466666666666667
Control.SRR15539874;32;32;0.5;16;16;0;0.5
Control.SRR15539874;36;32;0.527777777777778;17;19;0.0277777777777778;0.472222222222222
Control.SRR15539874;34;32;0.5;17;17;0;0.5
Control.SRR15539874;33;32;0.454545454545455;18;15;0.0454545454545455;0.454545454545455
Control.SRR15539874;36;32;0.527777777777778;17;19;0.0277777777777778;0.472222222222222
Control.SRR15539874;36;32;0.388888888888889;22;14;0.111111111111111;0.388888888888889
Control.SRR15539874;35;32;0.6;14;21;0.1;0.4
Control.SRR15539874;34;32;0.352941176470588;22;12;0.147058823529412;0.352941176470588
Control.SRR15539874;33;32;0.484848484848485;17;16;0.0151515151515151;0.484848484848485
Control.SRR15539874;35;32;0.657142857142857;12;23;0.157142857142857;0.342857142857143
Control.SRR15539874;28;32;0.571428571428571;12;16;0.0714285714285714;0.428571428571429
Control.SRR15539874;30;32;0.533333333333333;14;16;0.0333333333333333;0.466666666666667
Control.SRR15539874;28;32;0.428571428571429;16;12;0.0714285714285715;0.428571428571429
Control.SRR15539874;32;32;0.53125;15;17;0.03125;0.46875
Control.SRR15539874;31;32;0.32258064516129;21;10;0.17741935483871;0.32258064516129
Control.SRR15539874;34;32;0.5;17;17;0;0.5
Control.SRR15539874;34;32;0.470588235294118;18;16;0.0294117647058824;0.470588235294118
Control.SRR15539874;36;32;0.583333333333333;15;21;0.0833333333333334;0.416666666666667
Control.SRR15539874;35;32;0.4;21;14;0.1;0.4
Control.SRR15539874;36;32;0.555555555555556;16;20;0.0555555555555556;0.444444444444444
Control.SRR15539874;31;32;0.580645161290323;13;18;0.0806451612903226;0.419354838709677
Control.SRR15539874;28;32;0.535714285714286;13;15;0.0357142857142857;0.464285714285714
Control.SRR15539874;33;32;0.515151515151515;16;17;0.0151515151515151;0.484848484848485
Control.SRR15539874;31;32;0.612903225806452;12;19;0.112903225806452;0.387096774193548
Control.SRR15539874;34;32;0.5;17;17;0;0.5
Control.SRR15539874;36;32;0.416666666666667;21;15;0.0833333333333333;0.416666666666667
Control.SRR15539874;30;32;0.433333333333333;17;13;0.0666666666666667;0.433333333333333
Control.SRR15539874;29;32;0.482758620689655;15;14;0.0172413793103448;0.482758620689655
Control.SRR15539874;29;32;0.379310344827586;18;11;0.120689655172414;0.379310344827586
Control.SRR15539874;29;32;0.586206896551724;12;17;0.0862068965517241;0.413793103448276
Control.SRR15539874;34;32;0.470588235294118;18;16;0.0294117647058824;0.470588235294118
Control.SRR15539874;31;32;0.645161290322581;11;20;0.145161290322581;0.354838709677419
Control.SRR15539874;34;32;0.441176470588235;19;15;0.0588235294117647;0.441176470588235
Control.SRR15539874;30;32;0.633333333333333;11;19;0.133333333333333;0.366666666666667
Control.SRR15539874;31;32;0.290322580645161;22;9;0.209677419354839;0.290322580645161
Control.SRR15539874;35;32;0.542857142857143;16;19;0.0428571428571428;0.457142857142857
Control.SRR15539874;33;32;0.333333333333333;22;11;0.166666666666667;0.333333333333333
Control.SRR15539874;33;32;0.575757575757576;14;19;0.0757575757575758;0.424242424242424
Control.SRR15539874;35;32;0.371428571428571;22;13;0.128571428571429;0.371428571428571
Control.SRR15539874;32;32;0.5;16;16;0;0.5
Control.SRR15539874;36;32;0.527777777777778;17;19;0.0277777777777778;0.472222222222222
Control.SRR15539874;29;32;0.482758620689655;15;14;0.0172413793103448;0.482758620689655
Control.SRR15539874;29;32;0.517241379310345;14;15;0.0172413793103449;0.482758620689655
Control.SRR15539874;32;32;0.5;16;16;0;0.5
Control.SRR15539874;34;32;0.352941176470588;22;12;0.147058823529412;0.352941176470588
Control.SRR15539874;32;32;0.4375;18;14;0.0625;0.4375
Control.SRR15539874;33;32;0.515151515151515;16;17;0.0151515151515151;0.484848484848485
Control.SRR15539874;36;32;0.583333333333333;15;21;0.0833333333333334;0.416666666666667
Control.SRR15539874;31;32;0.387096774193548;19;12;0.112903225806452;0.387096774193548
Control.SRR15539874;35;32;0.514285714285714;17;18;0.0142857142857142;0.485714285714286
Control.SRR15539874;36;32;0.472222222222222;19;17;0.0277777777777778;0.472222222222222
Control.SRR15539874;35;32;0.657142857142857;12;23;0.157142857142857;0.342857142857143
Control.SRR15539874;33;32;0.393939393939394;20;13;0.106060606060606;0.393939393939394
Control.SRR15539874;31;32;0.516129032258065;15;16;0.0161290322580645;0.483870967741935
Control.SRR15539874;30;32;0.566666666666667;13;17;0.0666666666666667;0.433333333333333
Control.SRR15539874;33;32;0.606060606060606;13;20;0.106060606060606;0.393939393939394
Control.SRR15539874;33;32;0.636363636363636;12;21;0.136363636363636;0.363636363636364
Control.SRR15539874;34;32;0.5;17;17;0;0.5
Control.SRR15539874;35;32;0.542857142857143;16;19;0.0428571428571428;0.457142857142857
Control.SRR15539874;32;32;0.59375;13;19;0.09375;0.40625
Control.SRR15539874;33;32;0.424242424242424;19;14;0.0757575757575757;0.424242424242424
Control.SRR15539874;35;32;0.571428571428571;15;20;0.0714285714285714;0.428571428571429
Control.SRR15539874;33;32;0.484848484848485;17;16;0.0151515151515151;0.484848484848485
Control.SRR15539874;29;32;0.448275862068966;16;13;0.0517241379310345;0.448275862068966
Control.SRR15539874;33;32;0.575757575757576;14;19;0.0757575757575758;0.424242424242424
Control.SRR15539874;35;32;0.571428571428571;15;20;0.0714285714285714;0.428571428571429
Control.SRR15539874;35;32;0.4;21;14;0.1;0.4
Control.SRR15539874;29;32;0.517241379310345;14;15;0.0172413793103449;0.482758620689655
Control.SRR15539874;33;32;0.363636363636364;21;12;0.136363636363636;0.363636363636364
Control.SRR15539874;31;32;0.451612903225806;17;14;0.0483870967741936;0.451612903225806
Control.SRR15539874;36;32;0.583333333333333;15;21;0.0833333333333334;0.416666666666667
Control.SRR15539874;35;32;0.514285714285714;17;18;0.0142857142857142;0.485714285714286
Control.SRR15539874;35;32;0.628571428571429;13;22;0.128571428571429;0.371428571428571
Control.SRR15539874;28;32;0.714285714285714;8;20;0.214285714285714;0.285714285714286
Control.SRR15539874;36;32;0.472222222222222;19;17;0.0277777777777778;0.472222222222222
Control.SRR15539874;30;32;0.533333333333333;14;16;0.0333333333333333;0.466666666666667
Control.SRR15539874;31;32;0.516129032258065;15;16;0.0161290322580645;0.483870967741935
Control.SRR15539874;33;32;0.515151515151515;16;17;0.0151515151515151;0.484848484848485
Control.SRR15539874;32;32;0.53125;15;17;0.03125;0.46875
Control.SRR15539874;36;32;0.444444444444444;20;16;0.0555555555555556;0.444444444444444
Control.SRR15539874;35;32;0.542857142857143;16;19;0.0428571428571428;0.457142857142857
Control.SRR15539874;31;32;0.419354838709677;18;13;0.0806451612903226;0.419354838709677
Control.SRR15539874;34;32;0.617647058823529;13;21;0.117647058823529;0.382352941176471
Control.SRR15539874;31;32;0.612903225806452;12;19;0.112903225806452;0.387096774193548
Control.SRR15539874;31;32;0.548387096774194;14;17;0.0483870967741935;0.451612903225806
Control.SRR15539874;31;32;0.419354838709677;18;13;0.0806451612903226;0.419354838709677
Control.SRR15539874;32;32;0.5625;14;18;0.0625;0.4375
Control.SRR15539874;30;32;0.6;12;18;0.1;0.4
Control.SRR15539874;34;32;0.529411764705882;16;18;0.0294117647058824;0.470588235294118
Control.SRR15539874;35;32;0.485714285714286;18;17;0.0142857142857143;0.485714285714286
Control.SRR15539874;34;32;0.441176470588235;19;15;0.0588235294117647;0.441176470588235
Control.SRR15539874;28;32;0.571428571428571;12;16;0.0714285714285714;0.428571428571429
Control.SRR15539874;34;32;0.441176470588235;19;15;0.0588235294117647;0.441176470588235
Control.SRR15539874;36;32;0.444444444444444;20;16;0.0555555555555556;0.444444444444444
Control.SRR15539874;31;32;0.645161290322581;11;20;0.145161290322581;0.354838709677419
Control.SRR15539874;28;32;0.571428571428571;12;16;0.0714285714285714;0.428571428571429
Control.SRR15539874;29;32;0.310344827586207;20;9;0.189655172413793;0.310344827586207
Control.SRR15539874;34;32;0.588235294117647;14;20;0.0882352941176471;0.411764705882353
Control.SRR15539874;29;32;0.551724137931034;13;16;0.0517241379310345;0.448275862068966
Control.SRR15539874;34;32;0.647058823529412;12;22;0.147058823529412;0.352941176470588
Control.SRR15539874;30;32;0.5;15;15;0;0.5
Control.SRR15539874;30;32;0.366666666666667;19;11;0.133333333333333;0.366666666666667
Control.SRR15539874;36;32;0.5;18;18;0;0.5
Control.SRR15539874;36;32;0.472222222222222;19;17;0.0277777777777778;0.472222222222222
Control.SRR15539874;33;32;0.393939393939394;20;13;0.106060606060606;0.393939393939394
Control.SRR15539874;29;32;0.275862068965517;21;8;0.224137931034483;0.275862068965517
Control.SRR15539874;28;32;0.428571428571429;16;12;0.0714285714285715;0.428571428571429
Control.SRR15539874;36;32;0.555555555555556;16;20;0.0555555555555556;0.444444444444444
Control.SRR15539874;36;32;0.555555555555556;16;20;0.0555555555555556;0.444444444444444
Control.SRR15539874;36;32;0.527777777777778;17;19;0.0277777777777778;0.472222222222222
Control.SRR15539874;36;32;0.472222222222222;19;17;0.0277777777777778;0.472222222222222
Control.SRR15539874;28;32;0.5;14;14;0;0.5
Control.SRR15539874;30;32;0.466666666666667;16;14;0.0333333333333333;0.466666666666667
Control.SRR15539874;34;32;0.558823529411765;15;19;0.0588235294117647;0.441176470588235
Control.SRR15539874;32;32;0.53125;15;17;0.03125;0.46875
Control.SRR15539874;35;32;0.428571428571429;20;15;0.0714285714285715;0.428571428571429
Control.SRR15539874;31;32;0.67741935483871;10;21;0.17741935483871;0.32258064516129
Control.SRR15539874;30;32;0.566666666666667;13;17;0.0666666666666667;0.433333333333333
Control.SRR15539874;31;32;0.548387096774194;14;17;0.0483870967741935;0.451612903225806
Control.SRR15539874;35;32;0.342857142857143;23;12;0.157142857142857;0.342857142857143
Control.SRR15539874;35;32;0.628571428571429;13;22;0.128571428571429;0.371428571428571
Control.SRR15539874;32;32;0.4375;18;14;0.0625;0.4375
Control.SRR15539874;31;32;0.580645161290323;13;18;0.0806451612903226;0.419354838709677
Control.SRR15539874;28;32;0.535714285714286;13;15;0.0357142857142857;0.464285714285714
Control.SRR15539874;31;32;0.612903225806452;12;19;0.112903225806452;0.387096774193548
Control.SRR15539874;35;32;0.514285714285714;17;18;0.0142857142857142;0.485714285714286
Control.SRR15539874;34;32;0.588235294117647;14;20;0.0882352941176471;0.411764705882353
Control.SRR15539874;30;32;0.4;18;12;0.1;0.4
Control.SRR15539874;32;32;0.5;16;16;0;0.5
Control.SRR15539874;31;32;0.419354838709677;18;13;0.0806451612903226;0.419354838709677
Control.SRR15539874;36;32;0.416666666666667;21;15;0.0833333333333333;0.416666666666667
Control.SRR15539874;34;32;0.529411764705882;16;18;0.0294117647058824;0.470588235294118
Control.SRR15539874;31;32;0.580645161290323;13;18;0.0806451612903226;0.419354838709677
Control.SRR15539874;31;32;0.645161290322581;11;20;0.145161290322581;0.354838709677419
Control.SRR15539874;31;32;0.580645161290323;13;18;0.0806451612903226;0.419354838709677
Control.SRR15539874;28;32;0.535714285714286;13;15;0.0357142857142857;0.464285714285714
Control.SRR15539874;35;32;0.371428571428571;22;13;0.128571428571429;0.371428571428571
Control.SRR15539874;31;32;0.580645161290323;13;18;0.0806451612903226;0.419354838709677
Control.SRR15539874;32;32;0.5625;14;18;0.0625;0.4375
Control.SRR15539874;33;32;0.454545454545455;18;15;0.0454545454545455;0.454545454545455
Control.SRR15539874;30;32;0.366666666666667;19;11;0.133333333333333;0.366666666666667
Control.SRR15539874;28;32;0.464285714285714;15;13;0.0357142857142857;0.464285714285714
Control.SRR15539874;32;32;0.46875;17;15;0.03125;0.46875
Control.SRR15539874;29;32;0.310344827586207;20;9;0.189655172413793;0.310344827586207
Control.SRR15539874;36;32;0.472222222222222;19;17;0.0277777777777778;0.472222222222222
Control.SRR15539874;31;32;0.451612903225806;17;14;0.0483870967741936;0.451612903225806
Control.SRR15539874;32;32;0.4375;18;14;0.0625;0.4375
Control.SRR15539874;33;32;0.303030303030303;23;10;0.196969696969697;0.303030303030303
Control.SRR15539874;33;32;0.333333333333333;22;11;0.166666666666667;0.333333333333333
Control.SRR15539874;34;32;0.411764705882353;20;14;0.0882352941176471;0.411764705882353
Control.SRR15539874;31;32;0.387096774193548;19;12;0.112903225806452;0.387096774193548
Control.SRR15539874;29;32;0.586206896551724;12;17;0.0862068965517241;0.413793103448276
Control.SRR15539874;33;32;0.606060606060606;13;20;0.106060606060606;0.393939393939394
Control.SRR15539874;29;32;0.275862068965517;21;8;0.224137931034483;0.275862068965517
Control.SRR15539874;34;32;0.5;17;17;0;0.5
Control.SRR15539874;28;32;0.464285714285714;15;13;0.0357142857142857;0.464285714285714
Control.SRR15539874;35;32;0.485714285714286;18;17;0.0142857142857143;0.485714285714286
Control.SRR15539874;30;32;0.533333333333333;14;16;0.0333333333333333;0.466666666666667
Control.SRR15539874;34;32;0.470588235294118;18;16;0.0294117647058824;0.470588235294118
Control.SRR15539874;35;32;0.457142857142857;19;16;0.0428571428571429;0.457142857142857
Control.SRR15539874;31;32;0.483870967741935;16;15;0.0161290322580645;0.483870967741935
Control.SRR15539874;29;32;0.620689655172414;11;18;0.120689655172414;0.379310344827586
Control.SRR15539874;30;32;0.533333333333333;14;16;0.0333333333333333;0.466666666666667
Control.SRR15539874;32;32;0.5;16;16;0;0.5
Control.SRR15539874;29;32;0.517241379310345;14;15;0.0172413793103449;0.482758620689655
Control.SRR15539874;33;32;0.424242424242424;19;14;0.0757575757575757;0.424242424242424
Control.SRR15539874;36;32;0.583333333333333;15;21;0.0833333333333334;0.416666666666667
Control.SRR15539874;30;32;0.366666666666667;19;11;0.133333333333333;0.366666666666667
Control.SRR15539874;28;32;0.535714285714286;13;15;0.0357142857142857;0.464285714285714
Control.SRR15539874;31;32;0.483870967741935;16;15;0.0161290322580645;0.483870967741935
Control.SRR15539874;36;32;0.611111111111111;14;22;0.111111111111111;0.388888888888889
Control.SRR15539874;33;32;0.424242424242424;19;14;0.0757575757575757;0.424242424242424
Control.SRR15539874;32;32;0.5625;14;18;0.0625;0.4375
Control.SRR15539874;32;32;0.46875;17;15;0.03125;0.46875
Control.SRR15539874;30;32;0.5;15;15;0;0.5
Control.SRR15539874;30;32;0.433333333333333;17;13;0.0666666666666667;0.433333333333333
Control.SRR15539874;29;32;0.413793103448276;17;12;0.0862068965517241;0.413793103448276
Control.SRR15539874;31;32;0.387096774193548;19;12;0.112903225806452;0.387096774193548
Control.SRR15539874;28;32;0.642857142857143;10;18;0.142857142857143;0.357142857142857
Control.SRR15539874;29;32;0.482758620689655;15;14;0.0172413793103448;0.482758620689655
Control.SRR15539874;30;32;0.5;15;15;0;0.5
Control.SRR15539874;30;32;0.6;12;18;0.1;0.4
Control.SRR15539874;30;32;0.366666666666667;19;11;0.133333333333333;0.366666666666667
Control.SRR15539874;31;32;0.580645161290323;13;18;0.0806451612903226;0.419354838709677
Control.SRR15539874;33;32;0.484848484848485;17;16;0.0151515151515151;0.484848484848485
Control.SRR15539874;33;32;0.636363636363636;12;21;0.136363636363636;0.363636363636364
Control.SRR15539874;35;32;0.428571428571429;20;15;0.0714285714285715;0.428571428571429
Control.SRR15539874;31;32;0.483870967741935;16;15;0.0161290322580645;0.483870967741935
Control.SRR15539874;28;32;0.428571428571429;16;12;0.0714285714285715;0.428571428571429
Control.SRR15539874;32;32;0.375;20;12;0.125;0.375
Control.SRR15539874;29;32;0.310344827586207;20;9;0.189655172413793;0.310344827586207
Control.SRR15539874;34;32;0.617647058823529;13;21;0.117647058823529;0.382352941176471
Control.SRR15539874;36;32;0.5;18;18;0;0.5
Control.SRR15539874;35;32;0.314285714285714;24;11;0.185714285714286;0.314285714285714
Control.SRR15539874;33;32;0.484848484848485;17;16;0.0151515151515151;0.484848484848485
Control.SRR15539874;29;32;0.379310344827586;18;11;0.120689655172414;0.379310344827586
Control.SRR15539874;28;32;0.607142857142857;11;17;0.107142857142857;0.392857142857143
Control.SRR15539874;30;32;0.433333333333333;17;13;0.0666666666666667;0.433333333333333
Control.SRR15539874;34;32;0.5;17;17;0;0.5
Control.SRR15539874;31;32;0.612903225806452;12;19;0.112903225806452;0.387096774193548
Control.SRR15539874;35;32;0.485714285714286;18;17;0.0142857142857143;0.485714285714286
Control.SRR15539874;30;32;0.5;15;15;0;0.5
Control.SRR15539874;32;32;0.4375;18;14;0.0625;0.4375
Control.SRR15539874;29;32;0.517241379310345;14;15;0.0172413793103449;0.482758620689655
Control.SRR15539874;33;32;0.484848484848485;17;16;0.0151515151515151;0.484848484848485
Control.SRR15539874;36;32;0.666666666666667;12;24;0.166666666666667;0.333333333333333
Control.SRR15539874;35;32;0.542857142857143;16;19;0.0428571428571428;0.457142857142857
Control.SRR15539874;33;32;0.424242424242424;19;14;0.0757575757575757;0.424242424242424
Control.SRR15539874;29;32;0.413793103448276;17;12;0.0862068965517241;0.413793103448276
Control.SRR15539874;36;32;0.472222222222222;19;17;0.0277777777777778;0.472222222222222
Control.SRR15539874;36;32;0.416666666666667;21;15;0.0833333333333333;0.416666666666667
Control.SRR15539874;31;32;0.580645161290323;13;18;0.0806451612903226;0.419354838709677
Control.SRR15539874;28;32;0.392857142857143;17;11;0.107142857142857;0.392857142857143
Control.SRR15539874;32;32;0.5;16;16;0;0.5
Control.SRR15539874;34;32;0.558823529411765;15;19;0.0588235294117647;0.441176470588235
Control.SRR15539874;29;32;0.448275862068966;16;13;0.0517241379310345;0.448275862068966
Control.SRR15539874;28;32;0.357142857142857;18;10;0.142857142857143;0.357142857142857
Control.SRR15539874;36;32;0.583333333333333;15;21;0.0833333333333334;0.416666666666667
Control.SRR15539874;34;32;0.558823529411765;15;19;0.0588235294117647;0.441176470588235
Control.SRR15539874;33;32;0.424242424242424;19;14;0.0757575757575757;0.424242424242424
Control.SRR15539874;36;32;0.416666666666667;21;15;0.0833333333333333;0.416666666666667
Control.SRR15539874;36;32;0.444444444444444;20;16;0.0555555555555556;0.444444444444444
Control.SRR15539874;30;32;0.466666666666667;16;14;0.0333333333333333;0.466666666666667
Control.SRR15539874;34;32;0.470588235294118;18;16;0.0294117647058824;0.470588235294118
Control.SRR15539874;36;32;0.444444444444444;20;16;0.0555555555555556;0.444444444444444
Control.SRR15539874;36;32;0.444444444444444;20;16;0.0555555555555556;0.444444444444444
Control.SRR15539874;32;32;0.5625;14;18;0.0625;0.4375
Control.SRR15539874;28;32;0.464285714285714;15;13;0.0357142857142857;0.464285714285714
Control.SRR15539874;29;32;0.344827586206897;19;10;0.155172413793103;0.344827586206897
Control.SRR15539874;34;32;0.441176470588235;19;15;0.0588235294117647;0.441176470588235
Control.SRR15539874;36;32;0.611111111111111;14;22;0.111111111111111;0.388888888888889
Control.SRR15539874;31;32;0.548387096774194;14;17;0.0483870967741935;0.451612903225806
Control.SRR15539874;32;32;0.4375;18;14;0.0625;0.4375
Control.SRR15539874;28;32;0.607142857142857;11;17;0.107142857142857;0.392857142857143
Control.SRR15539874;30;32;0.5;15;15;0;0.5
Control.SRR15539874;32;32;0.46875;17;15;0.03125;0.46875
Control.SRR15539874;35;32;0.514285714285714;17;18;0.0142857142857142;0.485714285714286
Control.SRR15539874;31;32;0.580645161290323;13;18;0.0806451612903226;0.419354838709677
Control.SRR15539874;34;32;0.441176470588235;19;15;0.0588235294117647;0.441176470588235
Control.SRR15539874;33;32;0.696969696969697;10;23;0.196969696969697;0.303030303030303
Control.SRR15539874;32;32;0.34375;21;11;0.15625;0.34375
Control.SRR15539874;33;32;0.515151515151515;16;17;0.0151515151515151;0.484848484848485
Control.SRR15539874;35;32;0.428571428571429;20;15;0.0714285714285715;0.428571428571429
Control.SRR15539874;33;32;0.333333333333333;22;11;0.166666666666667;0.333333333333333
Control.SRR15539874;31;32;0.419354838709677;18;13;0.0806451612903226;0.419354838709677
Control.SRR15539874;30;32;0.566666666666667;13;17;0.0666666666666667;0.433333333333333
Control.SRR15539874;33;32;0.545454545454545;15;18;0.0454545454545454;0.454545454545455
Control.SRR15539874;36;32;0.583333333333333;15;21;0.0833333333333334;0.416666666666667
Control.SRR15539874;36;32;0.361111111111111;23;13;0.138888888888889;0.361111111111111
Control.SRR15539874;36;32;0.444444444444444;20;16;0.0555555555555556;0.444444444444444
Control.SRR15539874;33;32;0.484848484848485;17;16;0.0151515151515151;0.484848484848485
Control.SRR15539874;28;32;0.392857142857143;17;11;0.107142857142857;0.392857142857143
Control.SRR15539874;33;32;0.454545454545455;18;15;0.0454545454545455;0.454545454545455
Control.SRR15539874;36;32;0.555555555555556;16;20;0.0555555555555556;0.444444444444444
Control.SRR15539874;35;32;0.485714285714286;18;17;0.0142857142857143;0.485714285714286
Control.SRR15539874;31;32;0.483870967741935;16;15;0.0161290322580645;0.483870967741935
Control.SRR15539874;34;32;0.382352941176471;21;13;0.117647058823529;0.382352941176471
Control.SRR15539874;31;32;0.451612903225806;17;14;0.0483870967741936;0.451612903225806
Control.SRR15539874;31;32;0.451612903225806;17;14;0.0483870967741936;0.451612903225806
Control.SRR15539874;28;32;0.571428571428571;12;16;0.0714285714285714;0.428571428571429
Control.SRR15539874;28;32;0.428571428571429;16;12;0.0714285714285715;0.428571428571429
Control.SRR15539874;32;32;0.59375;13;19;0.09375;0.40625
Control.SRR15539874;33;32;0.575757575757576;14;19;0.0757575757575758;0.424242424242424
Control.SRR15539874;33;32;0.424242424242424;19;14;0.0757575757575757;0.424242424242424
Control.SRR15539874;28;32;0.607142857142857;11;17;0.107142857142857;0.392857142857143
Control.SRR15539874;28;32;0.678571428571429;9;19;0.178571428571429;0.321428571428571
Control.SRR15539874;31;32;0.451612903225806;17;14;0.0483870967741936;0.451612903225806
Control.SRR15539874;31;32;0.483870967741935;16;15;0.0161290322580645;0.483870967741935
Control.SRR15539874;35;32;0.428571428571429;20;15;0.0714285714285715;0.428571428571429
Control.SRR15539874;33;32;0.454545454545455;18;15;0.0454545454545455;0.454545454545455
Control.SRR15539874;30;32;0.433333333333333;17;13;0.0666666666666667;0.433333333333333
Control.SRR15539874;35;32;0.542857142857143;16;19;0.0428571428571428;0.457142857142857
Control.SRR15539874;31;32;0.548387096774194;14;17;0.0483870967741935;0.451612903225806
Control.SRR15539874;32;32;0.59375;13;19;0.09375;0.40625
Control.SRR15539874;34;32;0.5;17;17;0;0.5
Control.SRR15539874;35;32;0.571428571428571;15;20;0.0714285714285714;0.428571428571429
Control.SRR15539874;36;32;0.5;18;18;0;0.5
Control.SRR15539874;31;32;0.483870967741935;16;15;0.0161290322580645;0.483870967741935
Control.SRR15539874;31;32;0.516129032258065;15;16;0.0161290322580645;0.483870967741935
Control.SRR15539874;32;32;0.4375;18;14;0.0625;0.4375
Control.SRR15539874;30;32;0.6;12;18;0.1;0.4
Control.SRR15539874;36;32;0.472222222222222;19;17;0.0277777777777778;0.472222222222222
Control.SRR15539874;35;32;0.628571428571429;13;22;0.128571428571429;0.371428571428571
Control.SRR15539874;30;32;0.566666666666667;13;17;0.0666666666666667;0.433333333333333
Control.SRR15539874;35;32;0.457142857142857;19;16;0.0428571428571429;0.457142857142857
Control.SRR15539874;35;32;0.485714285714286;18;17;0.0142857142857143;0.485714285714286
Control.SRR15539874;31;32;0.548387096774194;14;17;0.0483870967741935;0.451612903225806
Control.SRR15539874;32;32;0.5;16;16;0;0.5
Control.SRR15539874;34;32;0.411764705882353;20;14;0.0882352941176471;0.411764705882353
Control.SRR15539874;36;32;0.527777777777778;17;19;0.0277777777777778;0.472222222222222
Control.SRR15539874;31;32;0.516129032258065;15;16;0.0161290322580645;0.483870967741935
Control.SRR15539874;33;32;0.484848484848485;17;16;0.0151515151515151;0.484848484848485
Control.SRR15539874;29;32;0.206896551724138;23;6;0.293103448275862;0.206896551724138
Control.SRR15539874;29;32;0.482758620689655;15;14;0.0172413793103448;0.482758620689655
Control.SRR15539874;32;32;0.65625;11;21;0.15625;0.34375
Control.SRR15539874;34;32;0.411764705882353;20;14;0.0882352941176471;0.411764705882353
Control.SRR15539874;36;32;0.361111111111111;23;13;0.138888888888889;0.361111111111111
Control.SRR15539874;35;32;0.371428571428571;22;13;0.128571428571429;0.371428571428571
Control.SRR15539874;31;32;0.516129032258065;15;16;0.0161290322580645;0.483870967741935
Control.SRR15539874;32;32;0.5;16;16;0;0.5
Control.SRR15539874;29;32;0.586206896551724;12;17;0.0862068965517241;0.413793103448276
Control.SRR15539874;33;32;0.424242424242424;19;14;0.0757575757575757;0.424242424242424
Control.SRR15539874;36;32;0.555555555555556;16;20;0.0555555555555556;0.444444444444444
Control.SRR15539874;34;32;0.5;17;17;0;0.5
Control.SRR15539874;36;32;0.388888888888889;22;14;0.111111111111111;0.388888888888889
Control.SRR15539874;30;32;0.6;12;18;0.1;0.4
Control.SRR15539874;33;32;0.545454545454545;15;18;0.0454545454545454;0.454545454545455
Control.SRR15539874;33;32;0.606060606060606;13;20;0.106060606060606;0.393939393939394
Control.SRR15539874;31;32;0.516129032258065;15;16;0.0161290322580645;0.483870967741935
Control.SRR15539874;28;32;0.357142857142857;18;10;0.142857142857143;0.357142857142857
Control.SRR15539874;33;32;0.606060606060606;13;20;0.106060606060606;0.393939393939394
Control.SRR15539874;28;32;0.464285714285714;15;13;0.0357142857142857;0.464285714285714
Control.SRR15539874;28;32;0.678571428571429;9;19;0.178571428571429;0.321428571428571
Control.SRR15539874;36;32;0.472222222222222;19;17;0.0277777777777778;0.472222222222222
Control.SRR15539874;28;32;0.25;21;7;0.25;0.25
Control.SRR15539874;35;32;0.485714285714286;18;17;0.0142857142857143;0.485714285714286
Control.SRR15539874;36;32;0.527777777777778;17;19;0.0277777777777778;0.472222222222222
Control.SRR15539874;29;32;0.724137931034483;8;21;0.224137931034483;0.275862068965517
Control.SRR15539874;33;32;0.636363636363636;12;21;0.136363636363636;0.363636363636364
Control.SRR15539874;32;32;0.46875;17;15;0.03125;0.46875
Control.SRR15539874;32;32;0.3125;22;10;0.1875;0.3125
Control.SRR15539874;35;32;0.457142857142857;19;16;0.0428571428571429;0.457142857142857
Control.SRR15539874;29;32;0.586206896551724;12;17;0.0862068965517241;0.413793103448276
Control.SRR15539874;29;32;0.517241379310345;14;15;0.0172413793103449;0.482758620689655
Control.SRR15539874;28;32;0.571428571428571;12;16;0.0714285714285714;0.428571428571429
Control.SRR15539874;30;32;0.433333333333333;17;13;0.0666666666666667;0.433333333333333
Control.SRR15539874;29;32;0.517241379310345;14;15;0.0172413793103449;0.482758620689655
Control.SRR15539874;30;32;0.5;15;15;0;0.5
Control.SRR15539874;32;32;0.34375;21;11;0.15625;0.34375
Control.SRR15539874;33;32;0.545454545454545;15;18;0.0454545454545454;0.454545454545455
Control.SRR15539874;29;32;0.551724137931034;13;16;0.0517241379310345;0.448275862068966
Control.SRR15539874;33;32;0.515151515151515;16;17;0.0151515151515151;0.484848484848485
Control.SRR15539874;33;32;0.484848484848485;17;16;0.0151515151515151;0.484848484848485
Control.SRR15539874;33;32;0.454545454545455;18;15;0.0454545454545455;0.454545454545455
Control.SRR15539874;34;32;0.529411764705882;16;18;0.0294117647058824;0.470588235294118
Control.SRR15539874;29;32;0.586206896551724;12;17;0.0862068965517241;0.413793103448276
Control.SRR15539874;33;32;0.515151515151515;16;17;0.0151515151515151;0.484848484848485
Control.SRR15539874;35;32;0.571428571428571;15;20;0.0714285714285714;0.428571428571429
Control.SRR15539874;36;32;0.583333333333333;15;21;0.0833333333333334;0.416666666666667
Control.SRR15539874;33;32;0.424242424242424;19;14;0.0757575757575757;0.424242424242424
Control.SRR15539874;33;32;0.454545454545455;18;15;0.0454545454545455;0.454545454545455
Control.SRR15539874;35;32;0.571428571428571;15;20;0.0714285714285714;0.428571428571429
Control.SRR15539874;32;32;0.46875;17;15;0.03125;0.46875
Control.SRR15539874;35;32;0.4;21;14;0.1;0.4
Control.SRR15539874;28;32;0.392857142857143;17;11;0.107142857142857;0.392857142857143
Control.SRR15539874;32;32;0.5;16;16;0;0.5
Control.SRR15539874;32;32;0.625;12;20;0.125;0.375
Control.SRR15539874;32;32;0.40625;19;13;0.09375;0.40625
Control.SRR15539874;35;32;0.514285714285714;17;18;0.0142857142857142;0.485714285714286
Control.SRR15539874;32;32;0.34375;21;11;0.15625;0.34375
Control.SRR15539874;31;32;0.645161290322581;11;20;0.145161290322581;0.354838709677419
Control.SRR15539874;36;32;0.555555555555556;16;20;0.0555555555555556;0.444444444444444
Control.SRR15539874;29;32;0.689655172413793;9;20;0.189655172413793;0.310344827586207
Control.SRR15539874;32;32;0.5;16;16;0;0.5
Control.SRR15539874;30;32;0.466666666666667;16;14;0.0333333333333333;0.466666666666667
Control.SRR15539874;33;32;0.575757575757576;14;19;0.0757575757575758;0.424242424242424
Control.SRR15539874;34;32;0.529411764705882;16;18;0.0294117647058824;0.470588235294118
Control.SRR15539874;31;32;0.516129032258065;15;16;0.0161290322580645;0.483870967741935
Control.SRR15539874;34;32;0.470588235294118;18;16;0.0294117647058824;0.470588235294118
Control.SRR15539874;31;32;0.548387096774194;14;17;0.0483870967741935;0.451612903225806
Control.SRR15539874;34;32;0.529411764705882;16;18;0.0294117647058824;0.470588235294118
Control.SRR15539874;30;32;0.4;18;12;0.1;0.4
Control.SRR15539874;34;32;0.5;17;17;0;0.5
Control.SRR15539874;33;32;0.787878787878788;7;26;0.287878787878788;0.212121212121212
Control.SRR15539874;31;32;0.580645161290323;13;18;0.0806451612903226;0.419354838709677
Control.SRR15539874;35;32;0.428571428571429;20;15;0.0714285714285715;0.428571428571429
Control.SRR15539874;35;32;0.542857142857143;16;19;0.0428571428571428;0.457142857142857
Control.SRR15539874;30;32;0.433333333333333;17;13;0.0666666666666667;0.433333333333333
Control.SRR15539874;36;32;0.416666666666667;21;15;0.0833333333333333;0.416666666666667
Control.SRR15539874;28;32;0.678571428571429;9;19;0.178571428571429;0.321428571428571
Control.SRR15539874;29;32;0.517241379310345;14;15;0.0172413793103449;0.482758620689655
Control.SRR15539874;30;32;0.233333333333333;23;7;0.266666666666667;0.233333333333333
Control.SRR15539874;31;32;0.548387096774194;14;17;0.0483870967741935;0.451612903225806
Control.SRR15539874;31;32;0.548387096774194;14;17;0.0483870967741935;0.451612903225806
Control.SRR15539874;34;32;0.588235294117647;14;20;0.0882352941176471;0.411764705882353
Control.SRR15539874;30;32;0.466666666666667;16;14;0.0333333333333333;0.466666666666667
Control.SRR15539874;33;32;0.575757575757576;14;19;0.0757575757575758;0.424242424242424
Control.SRR15539874;32;32;0.5625;14;18;0.0625;0.4375
Control.SRR15539874;32;32;0.59375;13;19;0.09375;0.40625
Control.SRR15539874;29;32;0.413793103448276;17;12;0.0862068965517241;0.413793103448276
Control.SRR15539874;30;32;0.6;12;18;0.1;0.4
Control.SRR15539874;28;32;0.5;14;14;0;0.5
Control.SRR15539874;36;32;0.444444444444444;20;16;0.0555555555555556;0.444444444444444
Control.SRR15539874;33;32;0.575757575757576;14;19;0.0757575757575758;0.424242424242424
Control.SRR15539874;34;32;0.529411764705882;16;18;0.0294117647058824;0.470588235294118
Control.SRR15539874;30;32;0.566666666666667;13;17;0.0666666666666667;0.433333333333333
Control.SRR15539874;29;32;0.448275862068966;16;13;0.0517241379310345;0.448275862068966
Control.SRR15539874;29;32;0.448275862068966;16;13;0.0517241379310345;0.448275862068966
Control.SRR15539874;33;32;0.454545454545455;18;15;0.0454545454545455;0.454545454545455
Control.SRR15539874;29;32;0.448275862068966;16;13;0.0517241379310345;0.448275862068966
Control.SRR15539874;31;32;0.483870967741935;16;15;0.0161290322580645;0.483870967741935
Control.SRR15539874;32;32;0.46875;17;15;0.03125;0.46875
Control.SRR15539874;28;32;0.464285714285714;15;13;0.0357142857142857;0.464285714285714
Control.SRR15539874;29;32;0.551724137931034;13;16;0.0517241379310345;0.448275862068966
Control.SRR15539874;30;32;0.433333333333333;17;13;0.0666666666666667;0.433333333333333
Control.SRR15539874;32;32;0.625;12;20;0.125;0.375
Control.SRR15539874;30;32;0.4;18;12;0.1;0.4
Control.SRR15539874;32;32;0.375;20;12;0.125;0.375
Control.SRR15539874;32;32;0.5625;14;18;0.0625;0.4375
Control.SRR15539874;32;32;0.46875;17;15;0.03125;0.46875
Control.SRR15539874;32;32;0.375;20;12;0.125;0.375
Control.SRR15539874;33;32;0.484848484848485;17;16;0.0151515151515151;0.484848484848485
Control.SRR15539874;34;32;0.470588235294118;18;16;0.0294117647058824;0.470588235294118
Control.SRR15539874;30;32;0.533333333333333;14;16;0.0333333333333333;0.466666666666667
Control.SRR15539874;31;32;0.548387096774194;14;17;0.0483870967741935;0.451612903225806
Control.SRR15539874;30;32;0.5;15;15;0;0.5
Control.SRR15539874;31;32;0.354838709677419;20;11;0.145161290322581;0.354838709677419
Control.SRR15539874;36;32;0.611111111111111;14;22;0.111111111111111;0.388888888888889
Control.SRR15539874;32;32;0.5625;14;18;0.0625;0.4375
Control.SRR15539874;31;32;0.645161290322581;11;20;0.145161290322581;0.354838709677419
Control.SRR15539874;32;32;0.40625;19;13;0.09375;0.40625
Control.SRR15539874;28;32;0.464285714285714;15;13;0.0357142857142857;0.464285714285714
Control.SRR15539874;36;32;0.722222222222222;10;26;0.222222222222222;0.277777777777778
Control.SRR15539874;33;32;0.242424242424242;25;8;0.257575757575758;0.242424242424242
Control.SRR15539874;30;32;0.533333333333333;14;16;0.0333333333333333;0.466666666666667
Control.SRR15539874;32;32;0.46875;17;15;0.03125;0.46875
Control.SRR15539874;30;32;0.533333333333333;14;16;0.0333333333333333;0.466666666666667
Control.SRR15539874;29;32;0.655172413793103;10;19;0.155172413793103;0.344827586206897
Control.SRR15539874;31;32;0.354838709677419;20;11;0.145161290322581;0.354838709677419
Control.SRR15539874;28;32;0.428571428571429;16;12;0.0714285714285715;0.428571428571429
Control.SRR15539874;32;32;0.40625;19;13;0.09375;0.40625
Control.SRR15539874;36;32;0.527777777777778;17;19;0.0277777777777778;0.472222222222222
Control.SRR15539874;35;32;0.342857142857143;23;12;0.157142857142857;0.342857142857143
Control.SRR15539874;32;32;0.5;16;16;0;0.5
Control.SRR15539874;32;32;0.46875;17;15;0.03125;0.46875
Control.SRR15539874;33;32;0.484848484848485;17;16;0.0151515151515151;0.484848484848485
Control.SRR15539874;35;32;0.542857142857143;16;19;0.0428571428571428;0.457142857142857
Control.SRR15539874;33;32;0.515151515151515;16;17;0.0151515151515151;0.484848484848485
Control.SRR15539874;36;32;0.361111111111111;23;13;0.138888888888889;0.361111111111111
Control.SRR15539874;35;32;0.485714285714286;18;17;0.0142857142857143;0.485714285714286
Control.SRR15539874;32;32;0.375;20;12;0.125;0.375
Control.SRR15539874;32;32;0.59375;13;19;0.09375;0.40625
Control.SRR15539874;36;32;0.527777777777778;17;19;0.0277777777777778;0.472222222222222
Control.SRR15539874;28;32;0.464285714285714;15;13;0.0357142857142857;0.464285714285714
Control.SRR15539874;36;32;0.5;18;18;0;0.5
Control.SRR15539874;29;32;0.482758620689655;15;14;0.0172413793103448;0.482758620689655
Control.SRR15539874;34;32;0.411764705882353;20;14;0.0882352941176471;0.411764705882353
Control.SRR15539874;32;32;0.4375;18;14;0.0625;0.4375
Control.SRR15539874;35;32;0.4;21;14;0.1;0.4
Control.SRR15539874;34;32;0.558823529411765;15;19;0.0588235294117647;0.441176470588235
Control.SRR15539874;30;32;0.433333333333333;17;13;0.0666666666666667;0.433333333333333
Control.SRR15539874;30;32;0.6;12;18;0.1;0.4
Control.SRR15539874;32;32;0.40625;19;13;0.09375;0.40625
Control.SRR15539874;29;32;0.586206896551724;12;17;0.0862068965517241;0.413793103448276
Control.SRR15539874;35;32;0.514285714285714;17;18;0.0142857142857142;0.485714285714286
Control.SRR15539874;36;32;0.694444444444444;11;25;0.194444444444444;0.305555555555556
Control.SRR15539874;36;32;0.638888888888889;13;23;0.138888888888889;0.361111111111111
Control.SRR15539874;33;32;0.606060606060606;13;20;0.106060606060606;0.393939393939394
Control.SRR15539874;33;32;0.545454545454545;15;18;0.0454545454545454;0.454545454545455
Control.SRR15539874;33;32;0.363636363636364;21;12;0.136363636363636;0.363636363636364
Control.SRR15539874;31;32;0.419354838709677;18;13;0.0806451612903226;0.419354838709677
Control.SRR15539874;36;32;0.583333333333333;15;21;0.0833333333333334;0.416666666666667
Control.SRR15539874;28;32;0.642857142857143;10;18;0.142857142857143;0.357142857142857
Control.SRR15539874;32;32;0.46875;17;15;0.03125;0.46875
Control.SRR15539874;30;32;0.433333333333333;17;13;0.0666666666666667;0.433333333333333
Control.SRR15539874;36;32;0.666666666666667;12;24;0.166666666666667;0.333333333333333
Control.SRR15539874;29;32;0.517241379310345;14;15;0.0172413793103449;0.482758620689655
Control.SRR15539874;33;32;0.424242424242424;19;14;0.0757575757575757;0.424242424242424
Control.SRR15539874;29;32;0.344827586206897;19;10;0.155172413793103;0.344827586206897
Control.SRR15539874;30;32;0.533333333333333;14;16;0.0333333333333333;0.466666666666667
Control.SRR15539874;29;32;0.482758620689655;15;14;0.0172413793103448;0.482758620689655
Control.SRR15539874;35;32;0.371428571428571;22;13;0.128571428571429;0.371428571428571
Control.SRR15539874;32;32;0.46875;17;15;0.03125;0.46875
Control.SRR15539874;31;32;0.612903225806452;12;19;0.112903225806452;0.387096774193548
Control.SRR15539874;33;32;0.454545454545455;18;15;0.0454545454545455;0.454545454545455
Control.SRR15539874;32;32;0.40625;19;13;0.09375;0.40625
Control.SRR15539874;35;32;0.6;14;21;0.1;0.4
Control.SRR15539874;28;32;0.5;14;14;0;0.5
Control.SRR15539874;28;32;0.571428571428571;12;16;0.0714285714285714;0.428571428571429
Control.SRR15539874;28;32;0.571428571428571;12;16;0.0714285714285714;0.428571428571429
Control.SRR15539874;29;32;0.413793103448276;17;12;0.0862068965517241;0.413793103448276
Control.SRR15539874;35;32;0.6;14;21;0.1;0.4
Control.SRR15539874;29;32;0.586206896551724;12;17;0.0862068965517241;0.413793103448276
Control.SRR15539874;34;32;0.352941176470588;22;12;0.147058823529412;0.352941176470588
Control.SRR15539874;31;32;0.483870967741935;16;15;0.0161290322580645;0.483870967741935
Control.SRR15539874;36;32;0.5;18;18;0;0.5
Control.SRR15539874;35;32;0.485714285714286;18;17;0.0142857142857143;0.485714285714286
Control.SRR15539874;29;32;0.517241379310345;14;15;0.0172413793103449;0.482758620689655
Control.SRR15539874;28;32;0.464285714285714;15;13;0.0357142857142857;0.464285714285714
Control.SRR15539874;34;32;0.5;17;17;0;0.5
Control.SRR15539874;32;32;0.4375;18;14;0.0625;0.4375
Control.SRR15539874;30;32;0.566666666666667;13;17;0.0666666666666667;0.433333333333333
Control.SRR15539874;31;32;0.580645161290323;13;18;0.0806451612903226;0.419354838709677
Control.SRR15539874;32;32;0.3125;22;10;0.1875;0.3125
Control.SRR15539874;31;32;0.548387096774194;14;17;0.0483870967741935;0.451612903225806
Control.SRR15539874;30;32;0.466666666666667;16;14;0.0333333333333333;0.466666666666667
Control.SRR15539874;30;32;0.5;15;15;0;0.5
Control.SRR15539874;31;32;0.580645161290323;13;18;0.0806451612903226;0.419354838709677
Control.SRR15539874;30;32;0.466666666666667;16;14;0.0333333333333333;0.466666666666667
Control.SRR15539874;33;32;0.454545454545455;18;15;0.0454545454545455;0.454545454545455
Control.SRR15539874;30;32;0.566666666666667;13;17;0.0666666666666667;0.433333333333333
Control.SRR15539874;28;32;0.642857142857143;10;18;0.142857142857143;0.357142857142857
Control.SRR15539874;28;32;0.392857142857143;17;11;0.107142857142857;0.392857142857143
Control.SRR15539874;30;32;0.5;15;15;0;0.5
Control.SRR15539874;32;32;0.46875;17;15;0.03125;0.46875
Control.SRR15539874;33;32;0.363636363636364;21;12;0.136363636363636;0.363636363636364
Control.SRR15539874;34;32;0.647058823529412;12;22;0.147058823529412;0.352941176470588
Control.SRR15539874;32;32;0.46875;17;15;0.03125;0.46875
Control.SRR15539874;29;32;0.517241379310345;14;15;0.0172413793103449;0.482758620689655
Control.SRR15539874;29;32;0.482758620689655;15;14;0.0172413793103448;0.482758620689655
Control.SRR15539874;33;32;0.393939393939394;20;13;0.106060606060606;0.393939393939394
Control.SRR15539874;33;32;0.454545454545455;18;15;0.0454545454545455;0.454545454545455
Control.SRR15539874;29;32;0.482758620689655;15;14;0.0172413793103448;0.482758620689655
Control.SRR15539874;30;32;0.466666666666667;16;14;0.0333333333333333;0.466666666666667
Control.SRR15539874;32;32;0.59375;13;19;0.09375;0.40625
Control.SRR15539874;32;32;0.53125;15;17;0.03125;0.46875
Control.SRR15539874;28;32;0.571428571428571;12;16;0.0714285714285714;0.428571428571429
Control.SRR15539874;34;32;0.470588235294118;18;16;0.0294117647058824;0.470588235294118
Control.SRR15539874;30;32;0.433333333333333;17;13;0.0666666666666667;0.433333333333333
Control.SRR15539874;31;32;0.483870967741935;16;15;0.0161290322580645;0.483870967741935
Control.SRR15539874;29;32;0.517241379310345;14;15;0.0172413793103449;0.482758620689655
Control.SRR15539874;32;32;0.59375;13;19;0.09375;0.40625
Control.SRR15539874;31;32;0.419354838709677;18;13;0.0806451612903226;0.419354838709677
Control.SRR15539874;31;32;0.548387096774194;14;17;0.0483870967741935;0.451612903225806
Control.SRR15539874;32;32;0.59375;13;19;0.09375;0.40625
Control.SRR15539874;28;32;0.571428571428571;12;16;0.0714285714285714;0.428571428571429
Control.SRR15539874;28;32;0.607142857142857;11;17;0.107142857142857;0.392857142857143
Control.SRR15539874;31;32;0.387096774193548;19;12;0.112903225806452;0.387096774193548
Control.SRR15539874;33;32;0.454545454545455;18;15;0.0454545454545455;0.454545454545455
Control.SRR15539874;31;32;0.387096774193548;19;12;0.112903225806452;0.387096774193548
Control.SRR15539874;31;32;0.612903225806452;12;19;0.112903225806452;0.387096774193548
Control.SRR15539874;31;32;0.451612903225806;17;14;0.0483870967741936;0.451612903225806
Control.SRR15539874;30;32;0.366666666666667;19;11;0.133333333333333;0.366666666666667
Control.SRR15539874;34;32;0.5;17;17;0;0.5
Control.SRR15539874;31;32;0.451612903225806;17;14;0.0483870967741936;0.451612903225806
Control.SRR15539874;32;32;0.53125;15;17;0.03125;0.46875
Control.SRR15539874;28;32;0.5;14;14;0;0.5
Control.SRR15539874;29;32;0.620689655172414;11;18;0.120689655172414;0.379310344827586
Control.SRR15539874;33;32;0.393939393939394;20;13;0.106060606060606;0.393939393939394
Control.SRR15539874;35;32;0.514285714285714;17;18;0.0142857142857142;0.485714285714286
Control.SRR15539874;33;32;0.484848484848485;17;16;0.0151515151515151;0.484848484848485
Control.SRR15539874;29;32;0.517241379310345;14;15;0.0172413793103449;0.482758620689655
Control.SRR15539874;30;32;0.666666666666667;10;20;0.166666666666667;0.333333333333333
Control.SRR15539874;34;32;0.411764705882353;20;14;0.0882352941176471;0.411764705882353
Control.SRR15539874;33;32;0.545454545454545;15;18;0.0454545454545454;0.454545454545455
Control.SRR15539874;36;32;0.472222222222222;19;17;0.0277777777777778;0.472222222222222
Control.SRR15539874;32;32;0.28125;23;9;0.21875;0.28125
Control.SRR15539874;30;32;0.533333333333333;14;16;0.0333333333333333;0.466666666666667
Control.SRR15539874;36;32;0.222222222222222;28;8;0.277777777777778;0.222222222222222
Control.SRR15539874;32;32;0.46875;17;15;0.03125;0.46875
Control.SRR15539874;33;32;0.606060606060606;13;20;0.106060606060606;0.393939393939394
Control.SRR15539874;30;32;0.6;12;18;0.1;0.4
Control.SRR15539874;36;32;0.555555555555556;16;20;0.0555555555555556;0.444444444444444
Control.SRR15539874;36;32;0.527777777777778;17;19;0.0277777777777778;0.472222222222222
Control.SRR15539874;29;32;0.586206896551724;12;17;0.0862068965517241;0.413793103448276
Control.SRR15539874;35;32;0.428571428571429;20;15;0.0714285714285715;0.428571428571429
Control.SRR15539874;29;32;0.586206896551724;12;17;0.0862068965517241;0.413793103448276
Control.SRR15539874;31;32;0.419354838709677;18;13;0.0806451612903226;0.419354838709677
Control.SRR15539874;28;32;0.464285714285714;15;13;0.0357142857142857;0.464285714285714
Control.SRR15539874;29;32;0.482758620689655;15;14;0.0172413793103448;0.482758620689655
Control.SRR15539874;31;32;0.548387096774194;14;17;0.0483870967741935;0.451612903225806
Control.SRR15539874;34;32;0.558823529411765;15;19;0.0588235294117647;0.441176470588235
Control.SRR15539874;32;32;0.46875;17;15;0.03125;0.46875
Control.SRR15539874;32;32;0.625;12;20;0.125;0.375
Control.SRR15539874;34;32;0.441176470588235;19;15;0.0588235294117647;0.441176470588235
Control.SRR15539874;35;32;0.342857142857143;23;12;0.157142857142857;0.342857142857143
Control.SRR15539874;30;32;0.466666666666667;16;14;0.0333333333333333;0.466666666666667
Control.SRR15539874;32;32;0.40625;19;13;0.09375;0.40625
Control.SRR15539874;31;32;0.548387096774194;14;17;0.0483870967741935;0.451612903225806
Control.SRR15539874;28;32;0.464285714285714;15;13;0.0357142857142857;0.464285714285714
Control.SRR15539874;34;32;0.470588235294118;18;16;0.0294117647058824;0.470588235294118
Control.SRR15539874;35;32;0.314285714285714;24;11;0.185714285714286;0.314285714285714
Control.SRR15539874;31;32;0.451612903225806;17;14;0.0483870967741936;0.451612903225806
Control.SRR15539874;30;32;0.533333333333333;14;16;0.0333333333333333;0.466666666666667
Control.SRR15539874;29;32;0.379310344827586;18;11;0.120689655172414;0.379310344827586
Control.SRR15539874;29;32;0.655172413793103;10;19;0.155172413793103;0.344827586206897
Control.SRR15539874;29;32;0.482758620689655;15;14;0.0172413793103448;0.482758620689655
Control.SRR15539874;36;32;0.333333333333333;24;12;0.166666666666667;0.333333333333333
Control.SRR15539874;34;32;0.558823529411765;15;19;0.0588235294117647;0.441176470588235
Control.SRR15539874;36;32;0.305555555555556;25;11;0.194444444444444;0.305555555555556
Control.SRR15539874;31;32;0.451612903225806;17;14;0.0483870967741936;0.451612903225806
Control.SRR15539874;33;32;0.575757575757576;14;19;0.0757575757575758;0.424242424242424
Control.SRR15539874;35;32;0.514285714285714;17;18;0.0142857142857142;0.485714285714286
Control.SRR15539874;35;32;0.514285714285714;17;18;0.0142857142857142;0.485714285714286
Control.SRR15539874;31;32;0.419354838709677;18;13;0.0806451612903226;0.419354838709677
Control.SRR15539874;31;32;0.548387096774194;14;17;0.0483870967741935;0.451612903225806
Control.SRR15539874;29;32;0.482758620689655;15;14;0.0172413793103448;0.482758620689655
Control.SRR15539874;35;32;0.4;21;14;0.1;0.4
Control.SRR15539874;30;32;0.533333333333333;14;16;0.0333333333333333;0.466666666666667
Control.SRR15539874;29;32;0.482758620689655;15;14;0.0172413793103448;0.482758620689655
Control.SRR15539874;36;32;0.527777777777778;17;19;0.0277777777777778;0.472222222222222
Control.SRR15539874;30;32;0.566666666666667;13;17;0.0666666666666667;0.433333333333333
Control.SRR15539874;30;32;0.4;18;12;0.1;0.4
Control.SRR15539874;30;32;0.433333333333333;17;13;0.0666666666666667;0.433333333333333
Control.SRR15539874;30;32;0.5;15;15;0;0.5
Control.SRR15539874;33;32;0.515151515151515;16;17;0.0151515151515151;0.484848484848485
Control.SRR15539874;33;32;0.606060606060606;13;20;0.106060606060606;0.393939393939394
Control.SRR15539874;35;32;0.514285714285714;17;18;0.0142857142857142;0.485714285714286
Control.SRR15539874;30;32;0.5;15;15;0;0.5
Control.SRR15539874;30;32;0.566666666666667;13;17;0.0666666666666667;0.433333333333333
Control.SRR15539874;36;32;0.527777777777778;17;19;0.0277777777777778;0.472222222222222
Control.SRR15539874;35;32;0.6;14;21;0.1;0.4
Control.SRR15539874;28;32;0.357142857142857;18;10;0.142857142857143;0.357142857142857
Control.SRR15539874;32;32;0.4375;18;14;0.0625;0.4375
Control.SRR15539874;31;32;0.516129032258065;15;16;0.0161290322580645;0.483870967741935
Control.SRR15539874;33;32;0.424242424242424;19;14;0.0757575757575757;0.424242424242424
Control.SRR15539874;29;32;0.344827586206897;19;10;0.155172413793103;0.344827586206897
Control.SRR15539874;34;32;0.382352941176471;21;13;0.117647058823529;0.382352941176471
Control.SRR15539874;31;32;0.516129032258065;15;16;0.0161290322580645;0.483870967741935
Control.SRR15539874;35;32;0.428571428571429;20;15;0.0714285714285715;0.428571428571429
Control.SRR15539874;32;32;0.625;12;20;0.125;0.375
Control.SRR15539874;32;32;0.59375;13;19;0.09375;0.40625
Control.SRR15539874;31;32;0.612903225806452;12;19;0.112903225806452;0.387096774193548
Control.SRR15539874;32;32;0.625;12;20;0.125;0.375
Control.SRR15539874;30;32;0.466666666666667;16;14;0.0333333333333333;0.466666666666667
Control.SRR15539874;29;32;0.344827586206897;19;10;0.155172413793103;0.344827586206897
Control.SRR15539874;33;32;0.454545454545455;18;15;0.0454545454545455;0.454545454545455
Control.SRR15539874;30;32;0.433333333333333;17;13;0.0666666666666667;0.433333333333333
Control.SRR15539874;33;32;0.545454545454545;15;18;0.0454545454545454;0.454545454545455
Control.SRR15539874;30;32;0.4;18;12;0.1;0.4
Control.SRR15539874;29;32;0.448275862068966;16;13;0.0517241379310345;0.448275862068966
Control.SRR15539874;35;32;0.571428571428571;15;20;0.0714285714285714;0.428571428571429
Control.SRR15539874;28;32;0.642857142857143;10;18;0.142857142857143;0.357142857142857
Control.SRR15539874;32;32;0.5625;14;18;0.0625;0.4375
Control.SRR15539874;33;32;0.484848484848485;17;16;0.0151515151515151;0.484848484848485
Control.SRR15539874;35;32;0.428571428571429;20;15;0.0714285714285715;0.428571428571429
Control.SRR15539874;31;32;0.451612903225806;17;14;0.0483870967741936;0.451612903225806
Control.SRR15539874;30;32;0.5;15;15;0;0.5
Control.SRR15539874;34;32;0.617647058823529;13;21;0.117647058823529;0.382352941176471
Control.SRR15539874;28;32;0.428571428571429;16;12;0.0714285714285715;0.428571428571429
Control.SRR15539874;28;32;0.392857142857143;17;11;0.107142857142857;0.392857142857143
Control.SRR15539874;29;32;0.517241379310345;14;15;0.0172413793103449;0.482758620689655
Control.SRR15539874;34;32;0.382352941176471;21;13;0.117647058823529;0.382352941176471
Control.SRR15539874;32;32;0.375;20;12;0.125;0.375
Control.SRR15539874;34;32;0.529411764705882;16;18;0.0294117647058824;0.470588235294118
Control.SRR15539874;32;32;0.28125;23;9;0.21875;0.28125
Control.SRR15539874;30;32;0.566666666666667;13;17;0.0666666666666667;0.433333333333333
Control.SRR15539874;36;32;0.444444444444444;20;16;0.0555555555555556;0.444444444444444
Control.SRR15539874;29;32;0.551724137931034;13;16;0.0517241379310345;0.448275862068966
Control.SRR15539874;35;32;0.485714285714286;18;17;0.0142857142857143;0.485714285714286
Control.SRR15539874;32;32;0.5625;14;18;0.0625;0.4375
Control.SRR15539874;33;32;0.515151515151515;16;17;0.0151515151515151;0.484848484848485
Control.SRR15539874;32;32;0.59375;13;19;0.09375;0.40625
Control.SRR15539874;28;32;0.428571428571429;16;12;0.0714285714285715;0.428571428571429
Control.SRR15539874;30;32;0.7;9;21;0.2;0.3
Control.SRR15539874;28;32;0.464285714285714;15;13;0.0357142857142857;0.464285714285714
Control.SRR15539874;33;32;0.545454545454545;15;18;0.0454545454545454;0.454545454545455
Control.SRR15539874;29;32;0.379310344827586;18;11;0.120689655172414;0.379310344827586
Control.SRR15539874;35;32;0.485714285714286;18;17;0.0142857142857143;0.485714285714286
Control.SRR15539874;30;32;0.566666666666667;13;17;0.0666666666666667;0.433333333333333
Control.SRR15539874;30;32;0.466666666666667;16;14;0.0333333333333333;0.466666666666667
Control.SRR15539874;30;32;0.4;18;12;0.1;0.4
Control.SRR15539874;31;32;0.612903225806452;12;19;0.112903225806452;0.387096774193548
Control.SRR15539874;29;32;0.517241379310345;14;15;0.0172413793103449;0.482758620689655
Control.SRR15539874;31;32;0.451612903225806;17;14;0.0483870967741936;0.451612903225806
Control.SRR15539874;33;32;0.545454545454545;15;18;0.0454545454545454;0.454545454545455
Control.SRR15539874;32;32;0.5;16;16;0;0.5
Control.SRR15539874;34;32;0.588235294117647;14;20;0.0882352941176471;0.411764705882353
Control.SRR15539874;29;32;0.620689655172414;11;18;0.120689655172414;0.379310344827586
Control.SRR15539874;35;32;0.485714285714286;18;17;0.0142857142857143;0.485714285714286
Control.SRR15539874;30;32;0.633333333333333;11;19;0.133333333333333;0.366666666666667
Control.SRR15539874;28;32;0.428571428571429;16;12;0.0714285714285715;0.428571428571429
Control.SRR15539874;30;32;0.433333333333333;17;13;0.0666666666666667;0.433333333333333
Control.SRR15539874;36;32;0.444444444444444;20;16;0.0555555555555556;0.444444444444444
Control.SRR15539874;30;32;0.433333333333333;17;13;0.0666666666666667;0.433333333333333
Control.SRR15539874;31;32;0.612903225806452;12;19;0.112903225806452;0.387096774193548
Control.SRR15539874;30;32;0.4;18;12;0.1;0.4
Control.SRR15539874;36;32;0.361111111111111;23;13;0.138888888888889;0.361111111111111
Control.SRR15539874;33;32;0.393939393939394;20;13;0.106060606060606;0.393939393939394
Control.SRR15539874;28;32;0.392857142857143;17;11;0.107142857142857;0.392857142857143
Control.SRR15539874;36;32;0.611111111111111;14;22;0.111111111111111;0.388888888888889
Control.SRR15539874;31;32;0.451612903225806;17;14;0.0483870967741936;0.451612903225806
Control.SRR15539874;36;32;0.444444444444444;20;16;0.0555555555555556;0.444444444444444
Control.SRR15539874;36;32;0.472222222222222;19;17;0.0277777777777778;0.472222222222222
Control.SRR15539874;34;32;0.382352941176471;21;13;0.117647058823529;0.382352941176471
Control.SRR15539874;34;32;0.470588235294118;18;16;0.0294117647058824;0.470588235294118
Control.SRR15539874;33;32;0.545454545454545;15;18;0.0454545454545454;0.454545454545455
Control.SRR15539874;31;32;0.483870967741935;16;15;0.0161290322580645;0.483870967741935
Control.SRR15539874;32;32;0.40625;19;13;0.09375;0.40625
Control.SRR15539874;28;32;0.214285714285714;22;6;0.285714285714286;0.214285714285714
Control.SRR15539874;33;32;0.424242424242424;19;14;0.0757575757575757;0.424242424242424
Control.SRR15539874;30;32;0.366666666666667;19;11;0.133333333333333;0.366666666666667
Control.SRR15539874;34;32;0.382352941176471;21;13;0.117647058823529;0.382352941176471
Control.SRR15539874;32;32;0.28125;23;9;0.21875;0.28125
Control.SRR15539874;31;32;0.451612903225806;17;14;0.0483870967741936;0.451612903225806
Control.SRR15539874;31;32;0.548387096774194;14;17;0.0483870967741935;0.451612903225806
Control.SRR15539874;32;32;0.46875;17;15;0.03125;0.46875
Control.SRR15539874;30;32;0.433333333333333;17;13;0.0666666666666667;0.433333333333333
Control.SRR15539874;28;32;0.428571428571429;16;12;0.0714285714285715;0.428571428571429
Control.SRR15539874;30;32;0.633333333333333;11;19;0.133333333333333;0.366666666666667
Control.SRR15539874;29;32;0.620689655172414;11;18;0.120689655172414;0.379310344827586
Control.SRR15539874;34;32;0.558823529411765;15;19;0.0588235294117647;0.441176470588235
Control.SRR15539874;31;32;0.580645161290323;13;18;0.0806451612903226;0.419354838709677
Control.SRR15539874;33;32;0.484848484848485;17;16;0.0151515151515151;0.484848484848485
Control.SRR15539874;35;32;0.685714285714286;11;24;0.185714285714286;0.314285714285714
Control.SRR15539874;36;32;0.5;18;18;0;0.5
Control.SRR15539874;30;32;0.633333333333333;11;19;0.133333333333333;0.366666666666667
Control.SRR15539874;32;32;0.40625;19;13;0.09375;0.40625
Control.SRR15539874;35;32;0.4;21;14;0.1;0.4
Control.SRR15539874;36;32;0.583333333333333;15;21;0.0833333333333334;0.416666666666667
Control.SRR15539874;30;32;0.433333333333333;17;13;0.0666666666666667;0.433333333333333
Control.SRR15539874;32;32;0.46875;17;15;0.03125;0.46875
Control.SRR15539874;30;32;0.5;15;15;0;0.5
Control.SRR15539874;35;32;0.457142857142857;19;16;0.0428571428571429;0.457142857142857
Control.SRR15539874;33;32;0.515151515151515;16;17;0.0151515151515151;0.484848484848485
Control.SRR15539874;32;32;0.65625;11;21;0.15625;0.34375
Control.SRR15539874;34;32;0.411764705882353;20;14;0.0882352941176471;0.411764705882353
Control.SRR15539874;31;32;0.451612903225806;17;14;0.0483870967741936;0.451612903225806
Control.SRR15539874;32;32;0.65625;11;21;0.15625;0.34375
Control.SRR15539874;31;32;0.354838709677419;20;11;0.145161290322581;0.354838709677419
Control.SRR15539874;34;32;0.529411764705882;16;18;0.0294117647058824;0.470588235294118
Control.SRR15539874;35;32;0.428571428571429;20;15;0.0714285714285715;0.428571428571429
Control.SRR15539874;33;32;0.515151515151515;16;17;0.0151515151515151;0.484848484848485
Control.SRR15539874;32;32;0.34375;21;11;0.15625;0.34375
Control.SRR15539874;32;32;0.65625;11;21;0.15625;0.34375
Control.SRR15539874;30;32;0.433333333333333;17;13;0.0666666666666667;0.433333333333333
Control.SRR15539874;28;32;0.392857142857143;17;11;0.107142857142857;0.392857142857143
Control.SRR15539874;29;32;0.551724137931034;13;16;0.0517241379310345;0.448275862068966
Control.SRR15539874;31;32;0.612903225806452;12;19;0.112903225806452;0.387096774193548
Control.SRR15539874;29;32;0.344827586206897;19;10;0.155172413793103;0.344827586206897
Control.SRR15539874;28;32;0.464285714285714;15;13;0.0357142857142857;0.464285714285714
Control.SRR15539874;36;32;0.472222222222222;19;17;0.0277777777777778;0.472222222222222
Control.SRR15539874;32;32;0.53125;15;17;0.03125;0.46875
Control.SRR15539874;31;32;0.483870967741935;16;15;0.0161290322580645;0.483870967741935
Control.SRR15539874;31;32;0.580645161290323;13;18;0.0806451612903226;0.419354838709677
Control.SRR15539874;28;32;0.535714285714286;13;15;0.0357142857142857;0.464285714285714
Control.SRR15539874;31;32;0.483870967741935;16;15;0.0161290322580645;0.483870967741935
Control.SRR15539874;34;32;0.588235294117647;14;20;0.0882352941176471;0.411764705882353
Control.SRR15539874;30;32;0.5;15;15;0;0.5
Control.SRR15539874;30;32;0.533333333333333;14;16;0.0333333333333333;0.466666666666667
Control.SRR15539874;29;32;0.586206896551724;12;17;0.0862068965517241;0.413793103448276
Control.SRR15539874;35;32;0.628571428571429;13;22;0.128571428571429;0.371428571428571
Control.SRR15539874;35;32;0.542857142857143;16;19;0.0428571428571428;0.457142857142857
Control.SRR15539874;30;32;0.466666666666667;16;14;0.0333333333333333;0.466666666666667
Control.SRR15539874;30;32;0.6;12;18;0.1;0.4
Control.SRR15539874;31;32;0.548387096774194;14;17;0.0483870967741935;0.451612903225806
Control.SRR15539874;29;32;0.344827586206897;19;10;0.155172413793103;0.344827586206897
Control.SRR15539874;31;32;0.483870967741935;16;15;0.0161290322580645;0.483870967741935
Control.SRR15539874;31;32;0.612903225806452;12;19;0.112903225806452;0.387096774193548
Control.SRR15539874;34;32;0.676470588235294;11;23;0.176470588235294;0.323529411764706
Control.SRR15539874;35;32;0.514285714285714;17;18;0.0142857142857142;0.485714285714286
Control.SRR15539874;33;32;0.545454545454545;15;18;0.0454545454545454;0.454545454545455
Control.SRR15539874;33;32;0.484848484848485;17;16;0.0151515151515151;0.484848484848485
Control.SRR15539874;36;32;0.416666666666667;21;15;0.0833333333333333;0.416666666666667
Control.SRR15539874;35;32;0.657142857142857;12;23;0.157142857142857;0.342857142857143
Control.SRR15539874;29;32;0.586206896551724;12;17;0.0862068965517241;0.413793103448276
Control.SRR15539874;33;32;0.515151515151515;16;17;0.0151515151515151;0.484848484848485
Control.SRR15539874;30;32;0.6;12;18;0.1;0.4
Control.SRR15539874;31;32;0.483870967741935;16;15;0.0161290322580645;0.483870967741935
Control.SRR15539874;29;32;0.413793103448276;17;12;0.0862068965517241;0.413793103448276
Control.SRR15539874;32;32;0.46875;17;15;0.03125;0.46875
Control.SRR15539874;33;32;0.393939393939394;20;13;0.106060606060606;0.393939393939394
Control.SRR15539874;36;32;0.416666666666667;21;15;0.0833333333333333;0.416666666666667
Control.SRR15539874;29;32;0.655172413793103;10;19;0.155172413793103;0.344827586206897
Control.SRR15539874;31;32;0.451612903225806;17;14;0.0483870967741936;0.451612903225806
Control.SRR15539874;28;32;0.5;14;14;0;0.5
Control.SRR15539874;30;32;0.333333333333333;20;10;0.166666666666667;0.333333333333333
Control.SRR15539874;35;32;0.514285714285714;17;18;0.0142857142857142;0.485714285714286
Control.SRR15539874;35;32;0.485714285714286;18;17;0.0142857142857143;0.485714285714286
Control.SRR15539874;31;32;0.645161290322581;11;20;0.145161290322581;0.354838709677419
Control.SRR15539874;36;32;0.472222222222222;19;17;0.0277777777777778;0.472222222222222
Control.SRR15539874;35;32;0.514285714285714;17;18;0.0142857142857142;0.485714285714286
Control.SRR15539874;36;32;0.472222222222222;19;17;0.0277777777777778;0.472222222222222
Control.SRR15539874;32;32;0.53125;15;17;0.03125;0.46875
Control.SRR15539874;28;32;0.5;14;14;0;0.5
Control.SRR15539874;34;32;0.617647058823529;13;21;0.117647058823529;0.382352941176471
Control.SRR15539874;34;32;0.558823529411765;15;19;0.0588235294117647;0.441176470588235
Control.SRR15539874;30;32;0.433333333333333;17;13;0.0666666666666667;0.433333333333333
Control.SRR15539874;33;32;0.484848484848485;17;16;0.0151515151515151;0.484848484848485
Control.SRR15539874;31;32;0.548387096774194;14;17;0.0483870967741935;0.451612903225806
Control.SRR15539874;28;32;0.392857142857143;17;11;0.107142857142857;0.392857142857143
Control.SRR15539874;30;32;0.533333333333333;14;16;0.0333333333333333;0.466666666666667
Control.SRR15539874;32;32;0.59375;13;19;0.09375;0.40625
Control.SRR15539874;30;32;0.566666666666667;13;17;0.0666666666666667;0.433333333333333
Control.SRR15539874;30;32;0.4;18;12;0.1;0.4
Control.SRR15539874;29;32;0.310344827586207;20;9;0.189655172413793;0.310344827586207
Control.SRR15539874;34;32;0.5;17;17;0;0.5
Control.SRR15539874;33;32;0.515151515151515;16;17;0.0151515151515151;0.484848484848485
Control.SRR15539874;29;32;0.551724137931034;13;16;0.0517241379310345;0.448275862068966
Control.SRR15539874;31;32;0.580645161290323;13;18;0.0806451612903226;0.419354838709677
Control.SRR15539874;32;32;0.4375;18;14;0.0625;0.4375
Control.SRR15539874;31;32;0.419354838709677;18;13;0.0806451612903226;0.419354838709677
Control.SRR15539874;29;32;0.482758620689655;15;14;0.0172413793103448;0.482758620689655
Control.SRR15539874;32;32;0.4375;18;14;0.0625;0.4375
Control.SRR15539874;36;32;0.666666666666667;12;24;0.166666666666667;0.333333333333333
Control.SRR15539874;29;32;0.482758620689655;15;14;0.0172413793103448;0.482758620689655
Control.SRR15539874;29;32;0.517241379310345;14;15;0.0172413793103449;0.482758620689655
Control.SRR15539874;29;32;0.551724137931034;13;16;0.0517241379310345;0.448275862068966
Control.SRR15539874;35;32;0.628571428571429;13;22;0.128571428571429;0.371428571428571
Control.SRR15539874;34;32;0.529411764705882;16;18;0.0294117647058824;0.470588235294118
Control.SRR15539874;36;32;0.444444444444444;20;16;0.0555555555555556;0.444444444444444
Control.SRR15539874;36;32;0.5;18;18;0;0.5
Control.SRR15539874;34;32;0.264705882352941;25;9;0.235294117647059;0.264705882352941
Control.SRR15539874;36;32;0.527777777777778;17;19;0.0277777777777778;0.472222222222222
Control.SRR15539874;34;32;0.558823529411765;15;19;0.0588235294117647;0.441176470588235
Control.SRR15539874;28;32;0.357142857142857;18;10;0.142857142857143;0.357142857142857
Control.SRR15539874;34;32;0.470588235294118;18;16;0.0294117647058824;0.470588235294118
Control.SRR15539874;30;32;0.333333333333333;20;10;0.166666666666667;0.333333333333333
Control.SRR15539874;33;32;0.454545454545455;18;15;0.0454545454545455;0.454545454545455
Control.SRR15539874;32;32;0.4375;18;14;0.0625;0.4375
Control.SRR15539874;29;32;0.655172413793103;10;19;0.155172413793103;0.344827586206897
Control.SRR15539874;28;32;0.535714285714286;13;15;0.0357142857142857;0.464285714285714
Control.SRR15539874;30;32;0.533333333333333;14;16;0.0333333333333333;0.466666666666667
Control.SRR15539874;28;32;0.428571428571429;16;12;0.0714285714285715;0.428571428571429
Control.SRR15539874;31;32;0.548387096774194;14;17;0.0483870967741935;0.451612903225806
Control.SRR15539874;33;32;0.272727272727273;24;9;0.227272727272727;0.272727272727273
Control.SRR15539874;34;32;0.382352941176471;21;13;0.117647058823529;0.382352941176471
Control.SRR15539874;29;32;0.517241379310345;14;15;0.0172413793103449;0.482758620689655
Control.SRR15539874;32;32;0.4375;18;14;0.0625;0.4375
Control.SRR15539874;36;32;0.416666666666667;21;15;0.0833333333333333;0.416666666666667
Control.SRR15539874;28;32;0.464285714285714;15;13;0.0357142857142857;0.464285714285714
Control.SRR15539874;30;32;0.433333333333333;17;13;0.0666666666666667;0.433333333333333
Control.SRR15539874;30;32;0.366666666666667;19;11;0.133333333333333;0.366666666666667
Control.SRR15539874;35;32;0.514285714285714;17;18;0.0142857142857142;0.485714285714286
Control.SRR15539874;33;32;0.333333333333333;22;11;0.166666666666667;0.333333333333333
Control.SRR15539874;35;32;0.485714285714286;18;17;0.0142857142857143;0.485714285714286
Control.SRR15539874;30;32;0.5;15;15;0;0.5
Control.SRR15539874;30;32;0.433333333333333;17;13;0.0666666666666667;0.433333333333333
Control.SRR15539874;36;32;0.583333333333333;15;21;0.0833333333333334;0.416666666666667
Control.SRR15539874;32;32;0.59375;13;19;0.09375;0.40625
Control.SRR15539874;34;32;0.529411764705882;16;18;0.0294117647058824;0.470588235294118
Control.SRR15539874;34;32;0.382352941176471;21;13;0.117647058823529;0.382352941176471
Control.SRR15539874;30;32;0.666666666666667;10;20;0.166666666666667;0.333333333333333
Control.SRR15539874;31;32;0.483870967741935;16;15;0.0161290322580645;0.483870967741935
Control.SRR15539874;32;32;0.53125;15;17;0.03125;0.46875
Control.SRR15539874;30;32;0.433333333333333;17;13;0.0666666666666667;0.433333333333333
Control.SRR15539874;32;32;0.5;16;16;0;0.5
Control.SRR15539874;35;32;0.514285714285714;17;18;0.0142857142857142;0.485714285714286
Control.SRR15539874;31;32;0.387096774193548;19;12;0.112903225806452;0.387096774193548
Control.SRR15539874;32;32;0.4375;18;14;0.0625;0.4375
Control.SRR15539874;29;32;0.448275862068966;16;13;0.0517241379310345;0.448275862068966
Control.SRR15539874;28;32;0.285714285714286;20;8;0.214285714285714;0.285714285714286
Control.SRR15539874;30;32;0.533333333333333;14;16;0.0333333333333333;0.466666666666667
Control.SRR15539874;34;32;0.558823529411765;15;19;0.0588235294117647;0.441176470588235
Control.SRR15539874;29;32;0.586206896551724;12;17;0.0862068965517241;0.413793103448276
Control.SRR15539874;34;32;0.558823529411765;15;19;0.0588235294117647;0.441176470588235
Control.SRR15539874;35;32;0.742857142857143;9;26;0.242857142857143;0.257142857142857
Control.SRR15539874;29;32;0.413793103448276;17;12;0.0862068965517241;0.413793103448276
Control.SRR15539874;28;32;0.642857142857143;10;18;0.142857142857143;0.357142857142857
Control.SRR15539874;34;32;0.382352941176471;21;13;0.117647058823529;0.382352941176471
Control.SRR15539874;36;32;0.583333333333333;15;21;0.0833333333333334;0.416666666666667
Control.SRR15539874;35;32;0.485714285714286;18;17;0.0142857142857143;0.485714285714286
Control.SRR15539874;36;32;0.444444444444444;20;16;0.0555555555555556;0.444444444444444
Control.SRR15539874;32;32;0.53125;15;17;0.03125;0.46875
Control.SRR15539874;36;32;0.416666666666667;21;15;0.0833333333333333;0.416666666666667
Control.SRR15539874;36;32;0.611111111111111;14;22;0.111111111111111;0.388888888888889
Control.SRR15539874;31;32;0.483870967741935;16;15;0.0161290322580645;0.483870967741935
Control.SRR15539874;28;32;0.571428571428571;12;16;0.0714285714285714;0.428571428571429
Control.SRR15539874;33;32;0.515151515151515;16;17;0.0151515151515151;0.484848484848485
Control.SRR15539874;32;32;0.5;16;16;0;0.5
Control.SRR15539874;30;32;0.533333333333333;14;16;0.0333333333333333;0.466666666666667
Control.SRR15539874;36;32;0.527777777777778;17;19;0.0277777777777778;0.472222222222222
Control.SRR15539874;30;32;0.466666666666667;16;14;0.0333333333333333;0.466666666666667
Control.SRR15539874;29;32;0.586206896551724;12;17;0.0862068965517241;0.413793103448276
Control.SRR15539874;28;32;0.357142857142857;18;10;0.142857142857143;0.357142857142857
Control.SRR15539874;34;32;0.5;17;17;0;0.5
Control.SRR15539874;31;32;0.290322580645161;22;9;0.209677419354839;0.290322580645161
Control.SRR15539874;29;32;0.448275862068966;16;13;0.0517241379310345;0.448275862068966
Control.SRR15539874;33;32;0.333333333333333;22;11;0.166666666666667;0.333333333333333
Control.SRR15539874;28;32;0.464285714285714;15;13;0.0357142857142857;0.464285714285714
Control.SRR15539874;28;32;0.464285714285714;15;13;0.0357142857142857;0.464285714285714
Control.SRR15539874;33;32;0.484848484848485;17;16;0.0151515151515151;0.484848484848485
Control.SRR15539874;28;32;0.571428571428571;12;16;0.0714285714285714;0.428571428571429
Control.SRR15539874;31;32;0.548387096774194;14;17;0.0483870967741935;0.451612903225806
Control.SRR15539874;29;32;0.448275862068966;16;13;0.0517241379310345;0.448275862068966
Control.SRR15539874;35;32;0.542857142857143;16;19;0.0428571428571428;0.457142857142857
Control.SRR15539874;29;32;0.448275862068966;16;13;0.0517241379310345;0.448275862068966
Control.SRR15539874;29;32;0.482758620689655;15;14;0.0172413793103448;0.482758620689655
Control.SRR15539874;32;32;0.34375;21;11;0.15625;0.34375
Control.SRR15539874;33;32;0.545454545454545;15;18;0.0454545454545454;0.454545454545455
Control.SRR15539874;35;32;0.6;14;21;0.1;0.4
Control.SRR15539874;32;32;0.5;16;16;0;0.5
Control.SRR15539874;35;32;0.485714285714286;18;17;0.0142857142857143;0.485714285714286
Control.SRR15539874;36;32;0.472222222222222;19;17;0.0277777777777778;0.472222222222222
Control.SRR15539874;30;32;0.466666666666667;16;14;0.0333333333333333;0.466666666666667
Control.SRR15539874;28;32;0.607142857142857;11;17;0.107142857142857;0.392857142857143
Control.SRR15539874;31;32;0.419354838709677;18;13;0.0806451612903226;0.419354838709677
Control.SRR15539874;32;32;0.40625;19;13;0.09375;0.40625
Control.SRR15539874;30;32;0.433333333333333;17;13;0.0666666666666667;0.433333333333333
Control.SRR15539874;29;32;0.413793103448276;17;12;0.0862068965517241;0.413793103448276
Control.SRR15539874;34;32;0.441176470588235;19;15;0.0588235294117647;0.441176470588235
Control.SRR15539874;33;32;0.424242424242424;19;14;0.0757575757575757;0.424242424242424
Control.SRR15539874;36;32;0.472222222222222;19;17;0.0277777777777778;0.472222222222222
Control.SRR15539874;32;32;0.46875;17;15;0.03125;0.46875
Control.SRR15539874;30;32;0.4;18;12;0.1;0.4
Control.SRR15539874;30;32;0.566666666666667;13;17;0.0666666666666667;0.433333333333333
Control.SRR15539874;30;32;0.566666666666667;13;17;0.0666666666666667;0.433333333333333
Control.SRR15539874;29;32;0.275862068965517;21;8;0.224137931034483;0.275862068965517
Control.SRR15539874;28;32;0.535714285714286;13;15;0.0357142857142857;0.464285714285714
Control.SRR15539874;34;32;0.529411764705882;16;18;0.0294117647058824;0.470588235294118
Control.SRR15539874;35;32;0.428571428571429;20;15;0.0714285714285715;0.428571428571429
Control.SRR15539874;32;32;0.625;12;20;0.125;0.375
Control.SRR15539874;35;32;0.485714285714286;18;17;0.0142857142857143;0.485714285714286
Control.SRR15539874;31;32;0.483870967741935;16;15;0.0161290322580645;0.483870967741935
Control.SRR15539874;35;32;0.628571428571429;13;22;0.128571428571429;0.371428571428571
Control.SRR15539874;28;32;0.5;14;14;0;0.5
Control.SRR15539874;30;32;0.566666666666667;13;17;0.0666666666666667;0.433333333333333
Control.SRR15539874;28;32;0.464285714285714;15;13;0.0357142857142857;0.464285714285714
Control.SRR15539874;33;32;0.575757575757576;14;19;0.0757575757575758;0.424242424242424
Control.SRR15539874;32;32;0.46875;17;15;0.03125;0.46875
Control.SRR15539874;35;32;0.457142857142857;19;16;0.0428571428571429;0.457142857142857
Control.SRR15539874;32;32;0.5625;14;18;0.0625;0.4375
Control.SRR15539874;31;32;0.612903225806452;12;19;0.112903225806452;0.387096774193548
Control.SRR15539874;31;32;0.483870967741935;16;15;0.0161290322580645;0.483870967741935
Control.SRR15539874;30;32;0.666666666666667;10;20;0.166666666666667;0.333333333333333
Control.SRR15539874;35;32;0.514285714285714;17;18;0.0142857142857142;0.485714285714286
Control.SRR15539874;34;32;0.558823529411765;15;19;0.0588235294117647;0.441176470588235
Control.SRR15539874;34;32;0.558823529411765;15;19;0.0588235294117647;0.441176470588235
Control.SRR15539874;32;32;0.53125;15;17;0.03125;0.46875
Control.SRR15539874;36;32;0.388888888888889;22;14;0.111111111111111;0.388888888888889
Control.SRR15539874;31;32;0.548387096774194;14;17;0.0483870967741935;0.451612903225806
Control.SRR15539874;29;32;0.586206896551724;12;17;0.0862068965517241;0.413793103448276
Control.SRR15539874;31;32;0.483870967741935;16;15;0.0161290322580645;0.483870967741935
Control.SRR15539874;28;32;0.357142857142857;18;10;0.142857142857143;0.357142857142857
Control.SRR15539874;35;32;0.4;21;14;0.1;0.4
Control.SRR15539874;36;32;0.444444444444444;20;16;0.0555555555555556;0.444444444444444
Control.SRR15539874;34;32;0.558823529411765;15;19;0.0588235294117647;0.441176470588235
Control.SRR15539874;30;32;0.533333333333333;14;16;0.0333333333333333;0.466666666666667
Control.SRR15539874;34;32;0.558823529411765;15;19;0.0588235294117647;0.441176470588235
Control.SRR15539874;32;32;0.34375;21;11;0.15625;0.34375
Control.SRR15539874;30;32;0.533333333333333;14;16;0.0333333333333333;0.466666666666667
Control.SRR15539874;35;32;0.685714285714286;11;24;0.185714285714286;0.314285714285714
Control.SRR15539874;31;32;0.483870967741935;16;15;0.0161290322580645;0.483870967741935
Control.SRR15539874;29;32;0.586206896551724;12;17;0.0862068965517241;0.413793103448276
Control.SRR15539874;28;32;0.5;14;14;0;0.5
Control.SRR15539874;35;32;0.485714285714286;18;17;0.0142857142857143;0.485714285714286
Control.SRR15539874;32;32;0.5;16;16;0;0.5
Control.SRR15539874;28;32;0.464285714285714;15;13;0.0357142857142857;0.464285714285714
Control.SRR15539874;33;32;0.424242424242424;19;14;0.0757575757575757;0.424242424242424
Control.SRR15539874;33;32;0.575757575757576;14;19;0.0757575757575758;0.424242424242424
Control.SRR15539874;32;32;0.53125;15;17;0.03125;0.46875
Control.SRR15539874;28;32;0.607142857142857;11;17;0.107142857142857;0.392857142857143
Control.SRR15539874;28;32;0.321428571428571;19;9;0.178571428571429;0.321428571428571
Control.SRR15539874;29;32;0.586206896551724;12;17;0.0862068965517241;0.413793103448276
Control.SRR15539874;33;32;0.545454545454545;15;18;0.0454545454545454;0.454545454545455
Control.SRR15539874;29;32;0.413793103448276;17;12;0.0862068965517241;0.413793103448276
Control.SRR15539874;34;32;0.470588235294118;18;16;0.0294117647058824;0.470588235294118
Control.SRR15539874;33;32;0.545454545454545;15;18;0.0454545454545454;0.454545454545455
Control.SRR15539874;31;32;0.354838709677419;20;11;0.145161290322581;0.354838709677419
Control.SRR15539874;33;32;0.666666666666667;11;22;0.166666666666667;0.333333333333333
Control.SRR15539874;29;32;0.448275862068966;16;13;0.0517241379310345;0.448275862068966
Control.SRR15539874;28;32;0.357142857142857;18;10;0.142857142857143;0.357142857142857
Control.SRR15539874;35;32;0.4;21;14;0.1;0.4
Control.SRR15539874;35;32;0.485714285714286;18;17;0.0142857142857143;0.485714285714286
Control.SRR15539874;30;32;0.333333333333333;20;10;0.166666666666667;0.333333333333333
Control.SRR15539874;32;32;0.53125;15;17;0.03125;0.46875
Control.SRR15539874;32;32;0.5;16;16;0;0.5
Control.SRR15539874;30;32;0.7;9;21;0.2;0.3
Control.SRR15539874;36;32;0.638888888888889;13;23;0.138888888888889;0.361111111111111
Control.SRR15539874;30;32;0.566666666666667;13;17;0.0666666666666667;0.433333333333333
Control.SRR15539874;31;32;0.32258064516129;21;10;0.17741935483871;0.32258064516129
Control.SRR15539874;35;32;0.371428571428571;22;13;0.128571428571429;0.371428571428571
Control.SRR15539874;29;32;0.482758620689655;15;14;0.0172413793103448;0.482758620689655
Control.SRR15539874;29;32;0.517241379310345;14;15;0.0172413793103449;0.482758620689655
Control.SRR15539874;28;32;0.642857142857143;10;18;0.142857142857143;0.357142857142857
Control.SRR15539874;28;32;0.535714285714286;13;15;0.0357142857142857;0.464285714285714
Control.SRR15539874;31;32;0.483870967741935;16;15;0.0161290322580645;0.483870967741935
Control.SRR15539874;36;32;0.555555555555556;16;20;0.0555555555555556;0.444444444444444
Control.SRR15539874;34;32;0.676470588235294;11;23;0.176470588235294;0.323529411764706
Control.SRR15539874;31;32;0.451612903225806;17;14;0.0483870967741936;0.451612903225806
Control.SRR15539874;33;32;0.454545454545455;18;15;0.0454545454545455;0.454545454545455
Control.SRR15539874;29;32;0.517241379310345;14;15;0.0172413793103449;0.482758620689655
Control.SRR15539874;28;32;0.464285714285714;15;13;0.0357142857142857;0.464285714285714
Control.SRR15539874;35;32;0.542857142857143;16;19;0.0428571428571428;0.457142857142857
Control.SRR15539874;28;32;0.571428571428571;12;16;0.0714285714285714;0.428571428571429
Control.SRR15539874;32;32;0.46875;17;15;0.03125;0.46875
Control.SRR15539874;28;32;0.214285714285714;22;6;0.285714285714286;0.214285714285714
Control.SRR15539874;33;32;0.575757575757576;14;19;0.0757575757575758;0.424242424242424
Control.SRR15539874;33;32;0.454545454545455;18;15;0.0454545454545455;0.454545454545455
Control.SRR15539874;32;32;0.5;16;16;0;0.5
Control.SRR15539874;36;32;0.583333333333333;15;21;0.0833333333333334;0.416666666666667
Control.SRR15539874;32;32;0.625;12;20;0.125;0.375
Control.SRR15539874;33;32;0.515151515151515;16;17;0.0151515151515151;0.484848484848485
Control.SRR15539874;35;32;0.457142857142857;19;16;0.0428571428571429;0.457142857142857
Control.SRR15539874;33;32;0.484848484848485;17;16;0.0151515151515151;0.484848484848485
Control.SRR15539874;35;32;0.514285714285714;17;18;0.0142857142857142;0.485714285714286
Control.SRR15539874;30;32;0.433333333333333;17;13;0.0666666666666667;0.433333333333333
Control.SRR15539874;30;32;0.4;18;12;0.1;0.4
Control.SRR15539874;33;32;0.484848484848485;17;16;0.0151515151515151;0.484848484848485
Control.SRR15539874;30;32;0.533333333333333;14;16;0.0333333333333333;0.466666666666667
Control.SRR15539874;31;32;0.451612903225806;17;14;0.0483870967741936;0.451612903225806
Control.SRR15539874;28;32;0.5;14;14;0;0.5
Control.SRR15539874;32;32;0.5;16;16;0;0.5
Control.SRR15539874;30;32;0.566666666666667;13;17;0.0666666666666667;0.433333333333333
Control.SRR15539874;30;32;0.466666666666667;16;14;0.0333333333333333;0.466666666666667
Control.SRR15539874;31;32;0.419354838709677;18;13;0.0806451612903226;0.419354838709677
Control.SRR15539874;35;32;0.4;21;14;0.1;0.4
Control.SRR15539874;29;32;0.517241379310345;14;15;0.0172413793103449;0.482758620689655
Control.SRR15539874;29;32;0.482758620689655;15;14;0.0172413793103448;0.482758620689655
Control.SRR15539874;30;32;0.466666666666667;16;14;0.0333333333333333;0.466666666666667
Control.SRR15539874;32;32;0.4375;18;14;0.0625;0.4375
Control.SRR15539874;30;32;0.533333333333333;14;16;0.0333333333333333;0.466666666666667
Control.SRR15539874;35;32;0.714285714285714;10;25;0.214285714285714;0.285714285714286
Control.SRR15539874;31;32;0.548387096774194;14;17;0.0483870967741935;0.451612903225806
Control.SRR15539874;30;32;0.533333333333333;14;16;0.0333333333333333;0.466666666666667
Control.SRR15539874;33;32;0.575757575757576;14;19;0.0757575757575758;0.424242424242424
Control.SRR15539874;34;32;0.588235294117647;14;20;0.0882352941176471;0.411764705882353
Control.SRR15539874;31;32;0.354838709677419;20;11;0.145161290322581;0.354838709677419
Control.SRR15539874;33;32;0.454545454545455;18;15;0.0454545454545455;0.454545454545455
Control.SRR15539874;36;32;0.472222222222222;19;17;0.0277777777777778;0.472222222222222
Control.SRR15539874;29;32;0.379310344827586;18;11;0.120689655172414;0.379310344827586
Control.SRR15539874;32;32;0.46875;17;15;0.03125;0.46875
Control.SRR15539874;31;32;0.419354838709677;18;13;0.0806451612903226;0.419354838709677
Control.SRR15539874;34;32;0.323529411764706;23;11;0.176470588235294;0.323529411764706
Control.SRR15539874;35;32;0.4;21;14;0.1;0.4
Control.SRR15539874;33;32;0.606060606060606;13;20;0.106060606060606;0.393939393939394
Control.SRR15539874;32;32;0.40625;19;13;0.09375;0.40625
Control.SRR15539874;34;32;0.5;17;17;0;0.5
Control.SRR15539874;33;32;0.515151515151515;16;17;0.0151515151515151;0.484848484848485
Control.SRR15539874;31;32;0.483870967741935;16;15;0.0161290322580645;0.483870967741935
Control.SRR15539874;32;32;0.5625;14;18;0.0625;0.4375
Control.SRR15539874;28;32;0.5;14;14;0;0.5
Control.SRR15539874;33;32;0.333333333333333;22;11;0.166666666666667;0.333333333333333
Control.SRR15539874;36;32;0.527777777777778;17;19;0.0277777777777778;0.472222222222222
Control.SRR15539874;35;32;0.628571428571429;13;22;0.128571428571429;0.371428571428571
Control.SRR15539874;30;32;0.6;12;18;0.1;0.4
Control.SRR15539874;29;32;0.448275862068966;16;13;0.0517241379310345;0.448275862068966
Control.SRR15539874;36;32;0.611111111111111;14;22;0.111111111111111;0.388888888888889
Control.SRR15539874;34;32;0.5;17;17;0;0.5
Control.SRR15539874;34;32;0.5;17;17;0;0.5
Control.SRR15539874;33;32;0.454545454545455;18;15;0.0454545454545455;0.454545454545455
Control.SRR15539874;33;32;0.606060606060606;13;20;0.106060606060606;0.393939393939394
Control.SRR15539874;36;32;0.333333333333333;24;12;0.166666666666667;0.333333333333333
Control.SRR15539874;34;32;0.294117647058824;24;10;0.205882352941176;0.294117647058824
Control.SRR15539874;30;32;0.433333333333333;17;13;0.0666666666666667;0.433333333333333
Control.SRR15539874;29;32;0.275862068965517;21;8;0.224137931034483;0.275862068965517
Control.SRR15539874;36;32;0.583333333333333;15;21;0.0833333333333334;0.416666666666667
Control.SRR15539874;29;32;0.655172413793103;10;19;0.155172413793103;0.344827586206897
Control.SRR15539874;32;32;0.40625;19;13;0.09375;0.40625
Control.SRR15539874;30;32;0.633333333333333;11;19;0.133333333333333;0.366666666666667
Control.SRR15539874;35;32;0.571428571428571;15;20;0.0714285714285714;0.428571428571429
Control.SRR15539874;34;32;0.5;17;17;0;0.5
Control.SRR15539874;30;32;0.466666666666667;16;14;0.0333333333333333;0.466666666666667
Control.SRR15539874;28;32;0.392857142857143;17;11;0.107142857142857;0.392857142857143
Control.SRR15539874;31;32;0.516129032258065;15;16;0.0161290322580645;0.483870967741935
Control.SRR15539874;29;32;0.551724137931034;13;16;0.0517241379310345;0.448275862068966
Control.SRR15539874;32;32;0.5;16;16;0;0.5
Control.SRR15539874;32;32;0.65625;11;21;0.15625;0.34375
Control.SRR15539874;28;32;0.5;14;14;0;0.5
Control.SRR15539874;33;32;0.515151515151515;16;17;0.0151515151515151;0.484848484848485
Control.SRR15539874;29;32;0.482758620689655;15;14;0.0172413793103448;0.482758620689655
Control.SRR15539874;30;32;0.466666666666667;16;14;0.0333333333333333;0.466666666666667
Control.SRR15539874;28;32;0.428571428571429;16;12;0.0714285714285715;0.428571428571429
Control.SRR15539874;36;32;0.527777777777778;17;19;0.0277777777777778;0.472222222222222
Control.SRR15539874;31;32;0.387096774193548;19;12;0.112903225806452;0.387096774193548
Control.SRR15539874;29;32;0.620689655172414;11;18;0.120689655172414;0.379310344827586
Control.SRR15539874;32;32;0.40625;19;13;0.09375;0.40625
Control.SRR15539874;30;32;0.466666666666667;16;14;0.0333333333333333;0.466666666666667
Control.SRR15539874;36;32;0.222222222222222;28;8;0.277777777777778;0.222222222222222
Control.SRR15539874;36;32;0.416666666666667;21;15;0.0833333333333333;0.416666666666667
Control.SRR15539874;29;32;0.586206896551724;12;17;0.0862068965517241;0.413793103448276
Control.SRR15539874;36;32;0.555555555555556;16;20;0.0555555555555556;0.444444444444444
Control.SRR15539874;34;32;0.647058823529412;12;22;0.147058823529412;0.352941176470588
Control.SRR15539874;32;32;0.46875;17;15;0.03125;0.46875
Control.SRR15539874;36;32;0.527777777777778;17;19;0.0277777777777778;0.472222222222222
Control.SRR15539874;36;32;0.583333333333333;15;21;0.0833333333333334;0.416666666666667
Control.SRR15539874;33;32;0.424242424242424;19;14;0.0757575757575757;0.424242424242424
Control.SRR15539874;30;32;0.366666666666667;19;11;0.133333333333333;0.366666666666667
Control.SRR15539874;34;32;0.558823529411765;15;19;0.0588235294117647;0.441176470588235
Control.SRR15539874;32;32;0.59375;13;19;0.09375;0.40625
Control.SRR15539874;30;32;0.566666666666667;13;17;0.0666666666666667;0.433333333333333
Control.SRR15539874;31;32;0.419354838709677;18;13;0.0806451612903226;0.419354838709677
Control.SRR15539874;30;32;0.6;12;18;0.1;0.4
Control.SRR15539874;28;32;0.464285714285714;15;13;0.0357142857142857;0.464285714285714
Control.SRR15539874;31;32;0.580645161290323;13;18;0.0806451612903226;0.419354838709677
Control.SRR15539874;33;32;0.666666666666667;11;22;0.166666666666667;0.333333333333333
Control.SRR15539874;31;32;0.483870967741935;16;15;0.0161290322580645;0.483870967741935
Control.SRR15539874;32;32;0.46875;17;15;0.03125;0.46875
Control.SRR15539874;31;32;0.483870967741935;16;15;0.0161290322580645;0.483870967741935
Control.SRR15539874;31;32;0.709677419354839;9;22;0.209677419354839;0.290322580645161
Control.SRR15539874;35;32;0.457142857142857;19;16;0.0428571428571429;0.457142857142857
Control.SRR15539874;32;32;0.375;20;12;0.125;0.375
Control.SRR15539874;34;32;0.382352941176471;21;13;0.117647058823529;0.382352941176471
Control.SRR15539874;28;32;0.428571428571429;16;12;0.0714285714285715;0.428571428571429
Control.SRR15539874;36;32;0.583333333333333;15;21;0.0833333333333334;0.416666666666667
Control.SRR15539874;32;32;0.46875;17;15;0.03125;0.46875
Control.SRR15539874;34;32;0.617647058823529;13;21;0.117647058823529;0.382352941176471
Control.SRR15539874;33;32;0.363636363636364;21;12;0.136363636363636;0.363636363636364
Control.SRR15539874;33;32;0.575757575757576;14;19;0.0757575757575758;0.424242424242424
Control.SRR15539874;30;32;0.466666666666667;16;14;0.0333333333333333;0.466666666666667
Control.SRR15539874;35;32;0.485714285714286;18;17;0.0142857142857143;0.485714285714286
Control.SRR15539874;30;32;0.433333333333333;17;13;0.0666666666666667;0.433333333333333
Control.SRR15539874;33;32;0.484848484848485;17;16;0.0151515151515151;0.484848484848485
Control.SRR15539874;33;32;0.515151515151515;16;17;0.0151515151515151;0.484848484848485
Control.SRR15539874;33;32;0.545454545454545;15;18;0.0454545454545454;0.454545454545455
Control.SRR15539874;33;32;0.484848484848485;17;16;0.0151515151515151;0.484848484848485
Control.SRR15539874;29;32;0.551724137931034;13;16;0.0517241379310345;0.448275862068966
Control.SRR15539874;33;32;0.515151515151515;16;17;0.0151515151515151;0.484848484848485
Control.SRR15539874;31;32;0.290322580645161;22;9;0.209677419354839;0.290322580645161
Control.SRR15539874;28;32;0.571428571428571;12;16;0.0714285714285714;0.428571428571429
Control.SRR15539874;32;32;0.75;8;24;0.25;0.25
Control.SRR15539874;28;32;0.607142857142857;11;17;0.107142857142857;0.392857142857143
Control.SRR15539874;34;32;0.470588235294118;18;16;0.0294117647058824;0.470588235294118
Control.SRR15539874;29;32;0.344827586206897;19;10;0.155172413793103;0.344827586206897
Control.SRR15539874;29;32;0.517241379310345;14;15;0.0172413793103449;0.482758620689655
Control.SRR15539874;32;32;0.34375;21;11;0.15625;0.34375
Control.SRR15539874;28;32;0.392857142857143;17;11;0.107142857142857;0.392857142857143
Control.SRR15539874;33;32;0.484848484848485;17;16;0.0151515151515151;0.484848484848485
Control.SRR15539874;31;32;0.516129032258065;15;16;0.0161290322580645;0.483870967741935
Control.SRR15539874;34;32;0.588235294117647;14;20;0.0882352941176471;0.411764705882353
Control.SRR15539874;29;32;0.620689655172414;11;18;0.120689655172414;0.379310344827586
Control.SRR15539874;30;32;0.633333333333333;11;19;0.133333333333333;0.366666666666667
Control.SRR15539874;34;32;0.411764705882353;20;14;0.0882352941176471;0.411764705882353
Control.SRR15539874;29;32;0.551724137931034;13;16;0.0517241379310345;0.448275862068966
Control.SRR15539874;33;32;0.606060606060606;13;20;0.106060606060606;0.393939393939394
Control.SRR15539874;32;32;0.46875;17;15;0.03125;0.46875
Control.SRR15539874;29;32;0.724137931034483;8;21;0.224137931034483;0.275862068965517
Control.SRR15539874;32;32;0.53125;15;17;0.03125;0.46875
Control.SRR15539874;30;32;0.466666666666667;16;14;0.0333333333333333;0.466666666666667
Control.SRR15539874;29;32;0.551724137931034;13;16;0.0517241379310345;0.448275862068966
Control.SRR15539874;29;32;0.482758620689655;15;14;0.0172413793103448;0.482758620689655
Control.SRR15539874;29;32;0.655172413793103;10;19;0.155172413793103;0.344827586206897
Control.SRR15539874;29;32;0.551724137931034;13;16;0.0517241379310345;0.448275862068966
Control.SRR15539874;29;32;0.413793103448276;17;12;0.0862068965517241;0.413793103448276
Control.SRR15539874;35;32;0.628571428571429;13;22;0.128571428571429;0.371428571428571
Control.SRR15539874;35;32;0.571428571428571;15;20;0.0714285714285714;0.428571428571429
Control.SRR15539874;28;32;0.321428571428571;19;9;0.178571428571429;0.321428571428571
Control.SRR15539874;34;32;0.647058823529412;12;22;0.147058823529412;0.352941176470588
Control.SRR15539874;35;32;0.657142857142857;12;23;0.157142857142857;0.342857142857143
Control.SRR15539874;32;32;0.625;12;20;0.125;0.375
Control.SRR15539874;29;32;0.482758620689655;15;14;0.0172413793103448;0.482758620689655
Control.SRR15539874;30;32;0.533333333333333;14;16;0.0333333333333333;0.466666666666667
Control.SRR15539874;36;32;0.722222222222222;10;26;0.222222222222222;0.277777777777778
Control.SRR15539874;31;32;0.451612903225806;17;14;0.0483870967741936;0.451612903225806
Control.SRR15539874;33;32;0.575757575757576;14;19;0.0757575757575758;0.424242424242424
Control.SRR15539874;32;32;0.59375;13;19;0.09375;0.40625
Control.SRR15539874;28;32;0.357142857142857;18;10;0.142857142857143;0.357142857142857
Control.SRR15539874;31;32;0.258064516129032;23;8;0.241935483870968;0.258064516129032
Control.SRR15539874;28;32;0.535714285714286;13;15;0.0357142857142857;0.464285714285714
Control.SRR15539874;32;32;0.59375;13;19;0.09375;0.40625
Control.SRR15539874;35;32;0.4;21;14;0.1;0.4
Control.SRR15539874;35;32;0.485714285714286;18;17;0.0142857142857143;0.485714285714286
Control.SRR15539874;31;32;0.516129032258065;15;16;0.0161290322580645;0.483870967741935
Control.SRR15539874;29;32;0.586206896551724;12;17;0.0862068965517241;0.413793103448276
Control.SRR15539874;33;32;0.454545454545455;18;15;0.0454545454545455;0.454545454545455
Control.SRR15539874;30;32;0.6;12;18;0.1;0.4
Control.SRR15539874;33;32;0.545454545454545;15;18;0.0454545454545454;0.454545454545455
Control.SRR15539874;32;32;0.46875;17;15;0.03125;0.46875
Control.SRR15539874;28;32;0.5;14;14;0;0.5
Control.SRR15539874;28;32;0.321428571428571;19;9;0.178571428571429;0.321428571428571
Control.SRR15539874;29;32;0.379310344827586;18;11;0.120689655172414;0.379310344827586
Control.SRR15539874;29;32;0.482758620689655;15;14;0.0172413793103448;0.482758620689655
Control.SRR15539874;29;32;0.551724137931034;13;16;0.0517241379310345;0.448275862068966
Control.SRR15539874;31;32;0.387096774193548;19;12;0.112903225806452;0.387096774193548
Control.SRR15539874;31;32;0.612903225806452;12;19;0.112903225806452;0.387096774193548
Control.SRR15539874;31;32;0.483870967741935;16;15;0.0161290322580645;0.483870967741935
Control.SRR15539874;33;32;0.575757575757576;14;19;0.0757575757575758;0.424242424242424
Control.SRR15539874;35;32;0.514285714285714;17;18;0.0142857142857142;0.485714285714286
Control.SRR15539874;28;32;0.428571428571429;16;12;0.0714285714285715;0.428571428571429
Control.SRR15539874;30;32;0.466666666666667;16;14;0.0333333333333333;0.466666666666667
Control.SRR15539874;36;32;0.361111111111111;23;13;0.138888888888889;0.361111111111111
Control.SRR15539874;28;32;0.428571428571429;16;12;0.0714285714285715;0.428571428571429
Control.SRR15539874;35;32;0.571428571428571;15;20;0.0714285714285714;0.428571428571429
Control.SRR15539874;30;32;0.466666666666667;16;14;0.0333333333333333;0.466666666666667
Control.SRR15539874;33;32;0.515151515151515;16;17;0.0151515151515151;0.484848484848485
Control.SRR15539874;28;32;0.535714285714286;13;15;0.0357142857142857;0.464285714285714
Control.SRR15539874;36;32;0.472222222222222;19;17;0.0277777777777778;0.472222222222222
Control.SRR15539874;32;32;0.53125;15;17;0.03125;0.46875
Control.SRR15539874;35;32;0.571428571428571;15;20;0.0714285714285714;0.428571428571429
Control.SRR15539874;31;32;0.451612903225806;17;14;0.0483870967741936;0.451612903225806
Control.SRR15539874;36;32;0.583333333333333;15;21;0.0833333333333334;0.416666666666667
Control.SRR15539874;33;32;0.454545454545455;18;15;0.0454545454545455;0.454545454545455
Control.SRR15539874;31;32;0.612903225806452;12;19;0.112903225806452;0.387096774193548
Control.SRR15539874;31;32;0.580645161290323;13;18;0.0806451612903226;0.419354838709677
Control.SRR15539874;33;32;0.575757575757576;14;19;0.0757575757575758;0.424242424242424
Control.SRR15539874;28;32;0.5;14;14;0;0.5
Control.SRR15539874;33;32;0.454545454545455;18;15;0.0454545454545455;0.454545454545455
Control.SRR15539874;31;32;0.516129032258065;15;16;0.0161290322580645;0.483870967741935
Control.SRR15539874;34;32;0.441176470588235;19;15;0.0588235294117647;0.441176470588235
Control.SRR15539874;31;32;0.419354838709677;18;13;0.0806451612903226;0.419354838709677
Control.SRR15539874;28;32;0.5;14;14;0;0.5
Control.SRR15539874;31;32;0.483870967741935;16;15;0.0161290322580645;0.483870967741935
Control.SRR15539874;36;32;0.611111111111111;14;22;0.111111111111111;0.388888888888889
Control.SRR15539874;30;32;0.566666666666667;13;17;0.0666666666666667;0.433333333333333
Control.SRR15539874;29;32;0.448275862068966;16;13;0.0517241379310345;0.448275862068966
Control.SRR15539874;29;32;0.482758620689655;15;14;0.0172413793103448;0.482758620689655
Control.SRR15539874;32;32;0.5;16;16;0;0.5
Control.SRR15539874;29;32;0.241379310344828;22;7;0.258620689655172;0.241379310344828
Control.SRR15539874;31;32;0.612903225806452;12;19;0.112903225806452;0.387096774193548
Control.SRR15539874;34;32;0.588235294117647;14;20;0.0882352941176471;0.411764705882353
Control.SRR15539874;33;32;0.454545454545455;18;15;0.0454545454545455;0.454545454545455
Control.SRR15539874;34;32;0.470588235294118;18;16;0.0294117647058824;0.470588235294118
Control.SRR15539874;32;32;0.6875;10;22;0.1875;0.3125
Control.SRR15539874;36;32;0.527777777777778;17;19;0.0277777777777778;0.472222222222222
Control.SRR15539874;35;32;0.542857142857143;16;19;0.0428571428571428;0.457142857142857
Control.SRR15539874;36;32;0.527777777777778;17;19;0.0277777777777778;0.472222222222222
Control.SRR15539874;30;32;0.633333333333333;11;19;0.133333333333333;0.366666666666667
Control.SRR15539874;32;32;0.4375;18;14;0.0625;0.4375
Control.SRR15539874;30;32;0.5;15;15;0;0.5
Control.SRR15539874;31;32;0.548387096774194;14;17;0.0483870967741935;0.451612903225806
Control.SRR15539874;36;32;0.444444444444444;20;16;0.0555555555555556;0.444444444444444
Control.SRR15539874;35;32;0.4;21;14;0.1;0.4
Control.SRR15539874;33;32;0.515151515151515;16;17;0.0151515151515151;0.484848484848485
Control.SRR15539874;33;32;0.484848484848485;17;16;0.0151515151515151;0.484848484848485
Control.SRR15539874;34;32;0.529411764705882;16;18;0.0294117647058824;0.470588235294118
Control.SRR15539874;28;32;0.464285714285714;15;13;0.0357142857142857;0.464285714285714
Control.SRR15539874;31;32;0.516129032258065;15;16;0.0161290322580645;0.483870967741935
Control.SRR15539874;35;32;0.514285714285714;17;18;0.0142857142857142;0.485714285714286
Control.SRR15539874;32;32;0.28125;23;9;0.21875;0.28125
Control.SRR15539874;29;32;0.551724137931034;13;16;0.0517241379310345;0.448275862068966
Control.SRR15539874;36;32;0.527777777777778;17;19;0.0277777777777778;0.472222222222222
Control.SRR15539874;31;32;0.290322580645161;22;9;0.209677419354839;0.290322580645161
Control.SRR15539874;30;32;0.433333333333333;17;13;0.0666666666666667;0.433333333333333
Control.SRR15539874;30;32;0.566666666666667;13;17;0.0666666666666667;0.433333333333333
Control.SRR15539874;31;32;0.709677419354839;9;22;0.209677419354839;0.290322580645161
Control.SRR15539874;34;32;0.470588235294118;18;16;0.0294117647058824;0.470588235294118
Control.SRR15539874;36;32;0.444444444444444;20;16;0.0555555555555556;0.444444444444444
Control.SRR15539874;28;32;0.642857142857143;10;18;0.142857142857143;0.357142857142857
Control.SRR15539874;30;32;0.433333333333333;17;13;0.0666666666666667;0.433333333333333
Control.SRR15539874;30;32;0.5;15;15;0;0.5
Control.SRR15539874;31;32;0.483870967741935;16;15;0.0161290322580645;0.483870967741935
Control.SRR15539874;32;32;0.40625;19;13;0.09375;0.40625
Control.SRR15539874;33;32;0.424242424242424;19;14;0.0757575757575757;0.424242424242424
