Sample;coverage;median_coverage;ALTF;RDR;RDA;Complexity;MAF
Control.SRR15539832;49;38;0.489795918367347;25;24;0.0102040816326531;0.489795918367347
Control.SRR15539832;45;38;0.6;18;27;0.1;0.4
Control.SRR15539832;38;38;0.526315789473684;18;20;0.0263157894736842;0.473684210526316
Control.SRR15539832;47;38;0.595744680851064;19;28;0.0957446808510638;0.404255319148936
Control.SRR15539832;38;38;0.552631578947368;17;21;0.0526315789473685;0.447368421052632
Control.SRR15539832;41;38;0.48780487804878;21;20;0.0121951219512195;0.48780487804878
Control.SRR15539832;42;38;0.380952380952381;26;16;0.119047619047619;0.380952380952381
Control.SRR15539832;37;38;0.594594594594595;15;22;0.0945945945945946;0.405405405405405
Control.SRR15539832;39;38;0.487179487179487;20;19;0.0128205128205128;0.487179487179487
Control.SRR15539832;42;38;0.523809523809524;20;22;0.0238095238095238;0.476190476190476
Control.SRR15539832;46;38;0.5;23;23;0;0.5
Control.SRR15539832;40;38;0.575;17;23;0.075;0.425
Control.SRR15539832;41;38;0.585365853658537;17;24;0.0853658536585366;0.414634146341463
Control.SRR15539832;46;38;0.434782608695652;26;20;0.0652173913043478;0.434782608695652
Control.SRR15539832;47;38;0.531914893617021;22;25;0.0319148936170213;0.468085106382979
Control.SRR15539832;49;38;0.469387755102041;26;23;0.0306122448979592;0.469387755102041
Control.SRR15539832;38;38;0.473684210526316;20;18;0.0263157894736842;0.473684210526316
Control.SRR15539832;38;38;0.447368421052632;21;17;0.0526315789473684;0.447368421052632
Control.SRR15539832;43;38;0.465116279069767;23;20;0.0348837209302326;0.465116279069767
Control.SRR15539832;45;38;0.577777777777778;19;26;0.0777777777777777;0.422222222222222
Control.SRR15539832;49;38;0.612244897959184;19;30;0.112244897959184;0.387755102040816
Control.SRR15539832;47;38;0.51063829787234;23;24;0.0106382978723404;0.48936170212766
Control.SRR15539832;40;38;0.55;18;22;0.05;0.45
Control.SRR15539832;38;38;0.5;19;19;0;0.5
Control.SRR15539832;41;38;0.536585365853659;19;22;0.0365853658536586;0.463414634146341
Control.SRR15539832;47;38;0.404255319148936;28;19;0.0957446808510639;0.404255319148936
Control.SRR15539832;46;38;0.565217391304348;20;26;0.0652173913043478;0.434782608695652
Control.SRR15539832;45;38;0.466666666666667;24;21;0.0333333333333333;0.466666666666667
Control.SRR15539832;38;38;0.605263157894737;15;23;0.105263157894737;0.394736842105263
Control.SRR15539832;42;38;0.357142857142857;27;15;0.142857142857143;0.357142857142857
Control.SRR15539832;48;38;0.458333333333333;26;22;0.0416666666666667;0.458333333333333
Control.SRR15539832;39;38;0.641025641025641;14;25;0.141025641025641;0.358974358974359
Control.SRR15539832;39;38;0.358974358974359;25;14;0.141025641025641;0.358974358974359
Control.SRR15539832;43;38;0.418604651162791;25;18;0.0813953488372093;0.418604651162791
Control.SRR15539832;47;38;0.574468085106383;20;27;0.074468085106383;0.425531914893617
Control.SRR15539832;41;38;0.439024390243902;23;18;0.0609756097560976;0.439024390243902
Control.SRR15539832;47;38;0.446808510638298;26;21;0.0531914893617021;0.446808510638298
Control.SRR15539832;43;38;0.534883720930233;20;23;0.0348837209302325;0.465116279069767
Control.SRR15539832;39;38;0.641025641025641;14;25;0.141025641025641;0.358974358974359
Control.SRR15539832;41;38;0.560975609756098;18;23;0.0609756097560976;0.439024390243902
Control.SRR15539832;46;38;0.456521739130435;25;21;0.0434782608695652;0.456521739130435
Control.SRR15539832;47;38;0.468085106382979;25;22;0.0319148936170213;0.468085106382979
Control.SRR15539832;46;38;0.391304347826087;28;18;0.108695652173913;0.391304347826087
Control.SRR15539832;45;38;0.4;27;18;0.1;0.4
Control.SRR15539832;38;38;0.421052631578947;22;16;0.0789473684210527;0.421052631578947
Control.SRR15539832;40;38;0.5;20;20;0;0.5
Control.SRR15539832;41;38;0.439024390243902;23;18;0.0609756097560976;0.439024390243902
Control.SRR15539832;43;38;0.395348837209302;26;17;0.104651162790698;0.395348837209302
Control.SRR15539832;49;38;0.428571428571429;28;21;0.0714285714285715;0.428571428571429
Control.SRR15539832;45;38;0.333333333333333;30;15;0.166666666666667;0.333333333333333
Control.SRR15539832;40;38;0.375;25;15;0.125;0.375
Control.SRR15539832;45;38;0.422222222222222;26;19;0.0777777777777778;0.422222222222222
Control.SRR15539832;38;38;0.447368421052632;21;17;0.0526315789473684;0.447368421052632
Control.SRR15539832;43;38;0.558139534883721;19;24;0.0581395348837209;0.441860465116279
Control.SRR15539832;40;38;0.525;19;21;0.025;0.475
Control.SRR15539832;41;38;0.51219512195122;20;21;0.0121951219512195;0.48780487804878
Control.SRR15539832;48;38;0.395833333333333;29;19;0.104166666666667;0.395833333333333
Control.SRR15539832;49;38;0.469387755102041;26;23;0.0306122448979592;0.469387755102041
Control.SRR15539832;40;38;0.6;16;24;0.1;0.4
Control.SRR15539832;38;38;0.5;19;19;0;0.5
Control.SRR15539832;47;38;0.553191489361702;21;26;0.0531914893617021;0.446808510638298
Control.SRR15539832;39;38;0.538461538461538;18;21;0.0384615384615384;0.461538461538462
Control.SRR15539832;46;38;0.391304347826087;28;18;0.108695652173913;0.391304347826087
Control.SRR15539832;42;38;0.476190476190476;22;20;0.0238095238095238;0.476190476190476
Control.SRR15539832;41;38;0.560975609756098;18;23;0.0609756097560976;0.439024390243902
Control.SRR15539832;40;38;0.55;18;22;0.05;0.45
Control.SRR15539832;45;38;0.466666666666667;24;21;0.0333333333333333;0.466666666666667
Control.SRR15539832;46;38;0.58695652173913;19;27;0.0869565217391305;0.41304347826087
Control.SRR15539832;47;38;0.659574468085106;16;31;0.159574468085106;0.340425531914894
Control.SRR15539832;41;38;0.585365853658537;17;24;0.0853658536585366;0.414634146341463
Control.SRR15539832;47;38;0.617021276595745;18;29;0.117021276595745;0.382978723404255
Control.SRR15539832;38;38;0.526315789473684;18;20;0.0263157894736842;0.473684210526316
Control.SRR15539832;45;38;0.466666666666667;24;21;0.0333333333333333;0.466666666666667
Control.SRR15539832;42;38;0.476190476190476;22;20;0.0238095238095238;0.476190476190476
Control.SRR15539832;46;38;0.41304347826087;27;19;0.0869565217391304;0.41304347826087
Control.SRR15539832;41;38;0.365853658536585;26;15;0.134146341463415;0.365853658536585
Control.SRR15539832;37;38;0.459459459459459;20;17;0.0405405405405405;0.459459459459459
Control.SRR15539832;41;38;0.560975609756098;18;23;0.0609756097560976;0.439024390243902
Control.SRR15539832;40;38;0.4;24;16;0.1;0.4
Control.SRR15539832;40;38;0.425;23;17;0.075;0.425
Control.SRR15539832;45;38;0.511111111111111;22;23;0.0111111111111111;0.488888888888889
Control.SRR15539832;44;38;0.5;22;22;0;0.5
Control.SRR15539832;43;38;0.441860465116279;24;19;0.0581395348837209;0.441860465116279
Control.SRR15539832;37;38;0.594594594594595;15;22;0.0945945945945946;0.405405405405405
Control.SRR15539832;49;38;0.448979591836735;27;22;0.0510204081632653;0.448979591836735
Control.SRR15539832;48;38;0.5;24;24;0;0.5
Control.SRR15539832;44;38;0.5;22;22;0;0.5
Control.SRR15539832;48;38;0.520833333333333;23;25;0.0208333333333334;0.479166666666667
Control.SRR15539832;39;38;0.487179487179487;20;19;0.0128205128205128;0.487179487179487
Control.SRR15539832;45;38;0.577777777777778;19;26;0.0777777777777777;0.422222222222222
Control.SRR15539832;44;38;0.590909090909091;18;26;0.0909090909090909;0.409090909090909
Control.SRR15539832;41;38;0.48780487804878;21;20;0.0121951219512195;0.48780487804878
Control.SRR15539832;44;38;0.522727272727273;21;23;0.0227272727272727;0.477272727272727
Control.SRR15539832;45;38;0.555555555555556;20;25;0.0555555555555556;0.444444444444444
Control.SRR15539832;37;38;0.432432432432432;21;16;0.0675675675675675;0.432432432432432
Control.SRR15539832;38;38;0.5;19;19;0;0.5
Control.SRR15539832;39;38;0.487179487179487;20;19;0.0128205128205128;0.487179487179487
Control.SRR15539832;45;38;0.533333333333333;21;24;0.0333333333333333;0.466666666666667
Control.SRR15539832;45;38;0.511111111111111;22;23;0.0111111111111111;0.488888888888889
Control.SRR15539832;43;38;0.627906976744186;16;27;0.127906976744186;0.372093023255814
Control.SRR15539832;43;38;0.558139534883721;19;24;0.0581395348837209;0.441860465116279
Control.SRR15539832;37;38;0.459459459459459;20;17;0.0405405405405405;0.459459459459459
Control.SRR15539832;47;38;0.382978723404255;29;18;0.117021276595745;0.382978723404255
Control.SRR15539832;39;38;0.435897435897436;22;17;0.0641025641025641;0.435897435897436
Control.SRR15539832;39;38;0.435897435897436;22;17;0.0641025641025641;0.435897435897436
Control.SRR15539832;43;38;0.558139534883721;19;24;0.0581395348837209;0.441860465116279
Control.SRR15539832;49;38;0.530612244897959;23;26;0.0306122448979592;0.469387755102041
Control.SRR15539832;45;38;0.466666666666667;24;21;0.0333333333333333;0.466666666666667
Control.SRR15539832;42;38;0.404761904761905;25;17;0.0952380952380952;0.404761904761905
Control.SRR15539832;39;38;0.487179487179487;20;19;0.0128205128205128;0.487179487179487
Control.SRR15539832;37;38;0.540540540540541;17;20;0.0405405405405406;0.459459459459459
Control.SRR15539832;45;38;0.488888888888889;23;22;0.0111111111111111;0.488888888888889
Control.SRR15539832;45;38;0.4;27;18;0.1;0.4
Control.SRR15539832;42;38;0.523809523809524;20;22;0.0238095238095238;0.476190476190476
Control.SRR15539832;41;38;0.585365853658537;17;24;0.0853658536585366;0.414634146341463
Control.SRR15539832;45;38;0.555555555555556;20;25;0.0555555555555556;0.444444444444444
Control.SRR15539832;37;38;0.459459459459459;20;17;0.0405405405405405;0.459459459459459
Control.SRR15539832;39;38;0.564102564102564;17;22;0.0641025641025641;0.435897435897436
Control.SRR15539832;38;38;0.605263157894737;15;23;0.105263157894737;0.394736842105263
Control.SRR15539832;46;38;0.434782608695652;26;20;0.0652173913043478;0.434782608695652
Control.SRR15539832;43;38;0.465116279069767;23;20;0.0348837209302326;0.465116279069767
Control.SRR15539832;45;38;0.288888888888889;32;13;0.211111111111111;0.288888888888889
Control.SRR15539832;42;38;0.571428571428571;18;24;0.0714285714285714;0.428571428571429
Control.SRR15539832;41;38;0.390243902439024;25;16;0.109756097560976;0.390243902439024
Control.SRR15539832;48;38;0.625;18;30;0.125;0.375
Control.SRR15539832;37;38;0.432432432432432;21;16;0.0675675675675675;0.432432432432432
Control.SRR15539832;38;38;0.5;19;19;0;0.5
Control.SRR15539832;44;38;0.522727272727273;21;23;0.0227272727272727;0.477272727272727
Control.SRR15539832;41;38;0.536585365853659;19;22;0.0365853658536586;0.463414634146341
Control.SRR15539832;39;38;0.487179487179487;20;19;0.0128205128205128;0.487179487179487
Control.SRR15539832;40;38;0.375;25;15;0.125;0.375
Control.SRR15539832;41;38;0.439024390243902;23;18;0.0609756097560976;0.439024390243902
Control.SRR15539832;45;38;0.666666666666667;15;30;0.166666666666667;0.333333333333333
Control.SRR15539832;47;38;0.382978723404255;29;18;0.117021276595745;0.382978723404255
Control.SRR15539832;40;38;0.55;18;22;0.05;0.45
Control.SRR15539832;38;38;0.552631578947368;17;21;0.0526315789473685;0.447368421052632
Control.SRR15539832;47;38;0.48936170212766;24;23;0.0106382978723404;0.48936170212766
Control.SRR15539832;43;38;0.558139534883721;19;24;0.0581395348837209;0.441860465116279
Control.SRR15539832;42;38;0.666666666666667;14;28;0.166666666666667;0.333333333333333
Control.SRR15539832;41;38;0.51219512195122;20;21;0.0121951219512195;0.48780487804878
Control.SRR15539832;40;38;0.6;16;24;0.1;0.4
Control.SRR15539832;40;38;0.5;20;20;0;0.5
Control.SRR15539832;40;38;0.475;21;19;0.025;0.475
Control.SRR15539832;48;38;0.604166666666667;19;29;0.104166666666667;0.395833333333333
Control.SRR15539832;42;38;0.5;21;21;0;0.5
Control.SRR15539832;46;38;0.630434782608696;17;29;0.130434782608696;0.369565217391304
Control.SRR15539832;44;38;0.477272727272727;23;21;0.0227272727272727;0.477272727272727
Control.SRR15539832;39;38;0.538461538461538;18;21;0.0384615384615384;0.461538461538462
Control.SRR15539832;44;38;0.386363636363636;27;17;0.113636363636364;0.386363636363636
Control.SRR15539832;43;38;0.418604651162791;25;18;0.0813953488372093;0.418604651162791
Control.SRR15539832;38;38;0.684210526315789;12;26;0.184210526315789;0.315789473684211
Control.SRR15539832;48;38;0.5;24;24;0;0.5
Control.SRR15539832;39;38;0.538461538461538;18;21;0.0384615384615384;0.461538461538462
Control.SRR15539832;38;38;0.5;19;19;0;0.5
Control.SRR15539832;44;38;0.386363636363636;27;17;0.113636363636364;0.386363636363636
Control.SRR15539832;45;38;0.511111111111111;22;23;0.0111111111111111;0.488888888888889
Control.SRR15539832;39;38;0.564102564102564;17;22;0.0641025641025641;0.435897435897436
Control.SRR15539832;46;38;0.608695652173913;18;28;0.108695652173913;0.391304347826087
Control.SRR15539832;44;38;0.454545454545455;24;20;0.0454545454545455;0.454545454545455
Control.SRR15539832;37;38;0.405405405405405;22;15;0.0945945945945946;0.405405405405405
Control.SRR15539832;40;38;0.4;24;16;0.1;0.4
Control.SRR15539832;46;38;0.521739130434783;22;24;0.0217391304347826;0.478260869565217
Control.SRR15539832;38;38;0.5;19;19;0;0.5
Control.SRR15539832;40;38;0.525;19;21;0.025;0.475
Control.SRR15539832;37;38;0.540540540540541;17;20;0.0405405405405406;0.459459459459459
Control.SRR15539832;42;38;0.5;21;21;0;0.5
Control.SRR15539832;41;38;0.585365853658537;17;24;0.0853658536585366;0.414634146341463
Control.SRR15539832;43;38;0.581395348837209;18;25;0.0813953488372093;0.418604651162791
Control.SRR15539832;37;38;0.513513513513513;18;19;0.0135135135135135;0.486486486486487
Control.SRR15539832;48;38;0.541666666666667;22;26;0.0416666666666666;0.458333333333333
Control.SRR15539832;37;38;0.594594594594595;15;22;0.0945945945945946;0.405405405405405
Control.SRR15539832;41;38;0.634146341463415;15;26;0.134146341463415;0.365853658536585
Control.SRR15539832;41;38;0.585365853658537;17;24;0.0853658536585366;0.414634146341463
Control.SRR15539832;41;38;0.536585365853659;19;22;0.0365853658536586;0.463414634146341
Control.SRR15539832;45;38;0.488888888888889;23;22;0.0111111111111111;0.488888888888889
Control.SRR15539832;49;38;0.428571428571429;28;21;0.0714285714285715;0.428571428571429
Control.SRR15539832;41;38;0.390243902439024;25;16;0.109756097560976;0.390243902439024
Control.SRR15539832;47;38;0.617021276595745;18;29;0.117021276595745;0.382978723404255
Control.SRR15539832;47;38;0.574468085106383;20;27;0.074468085106383;0.425531914893617
Control.SRR15539832;47;38;0.425531914893617;27;20;0.074468085106383;0.425531914893617
Control.SRR15539832;38;38;0.447368421052632;21;17;0.0526315789473684;0.447368421052632
Control.SRR15539832;45;38;0.666666666666667;15;30;0.166666666666667;0.333333333333333
Control.SRR15539832;43;38;0.511627906976744;21;22;0.0116279069767442;0.488372093023256
Control.SRR15539832;38;38;0.447368421052632;21;17;0.0526315789473684;0.447368421052632
Control.SRR15539832;45;38;0.533333333333333;21;24;0.0333333333333333;0.466666666666667
Control.SRR15539832;46;38;0.543478260869565;21;25;0.0434782608695652;0.456521739130435
Control.SRR15539832;42;38;0.547619047619048;19;23;0.0476190476190477;0.452380952380952
Control.SRR15539832;44;38;0.590909090909091;18;26;0.0909090909090909;0.409090909090909
Control.SRR15539832;46;38;0.369565217391304;29;17;0.130434782608696;0.369565217391304
Control.SRR15539832;43;38;0.418604651162791;25;18;0.0813953488372093;0.418604651162791
Control.SRR15539832;46;38;0.608695652173913;18;28;0.108695652173913;0.391304347826087
Control.SRR15539832;43;38;0.581395348837209;18;25;0.0813953488372093;0.418604651162791
Control.SRR15539832;44;38;0.409090909090909;26;18;0.0909090909090909;0.409090909090909
Control.SRR15539832;46;38;0.456521739130435;25;21;0.0434782608695652;0.456521739130435
Control.SRR15539832;44;38;0.545454545454545;20;24;0.0454545454545454;0.454545454545455
Control.SRR15539832;47;38;0.553191489361702;21;26;0.0531914893617021;0.446808510638298
Control.SRR15539832;40;38;0.475;21;19;0.025;0.475
Control.SRR15539832;46;38;0.521739130434783;22;24;0.0217391304347826;0.478260869565217
Control.SRR15539832;40;38;0.575;17;23;0.075;0.425
Control.SRR15539832;39;38;0.333333333333333;26;13;0.166666666666667;0.333333333333333
Control.SRR15539832;41;38;0.634146341463415;15;26;0.134146341463415;0.365853658536585
Control.SRR15539832;38;38;0.552631578947368;17;21;0.0526315789473685;0.447368421052632
Control.SRR15539832;47;38;0.425531914893617;27;20;0.074468085106383;0.425531914893617
Control.SRR15539832;44;38;0.431818181818182;25;19;0.0681818181818182;0.431818181818182
Control.SRR15539832;44;38;0.5;22;22;0;0.5
Control.SRR15539832;48;38;0.458333333333333;26;22;0.0416666666666667;0.458333333333333
Control.SRR15539832;48;38;0.4375;27;21;0.0625;0.4375
Control.SRR15539832;45;38;0.533333333333333;21;24;0.0333333333333333;0.466666666666667
Control.SRR15539832;31;38;0.516129032258065;15;16;0.0161290322580645;0.483870967741935
Control.SRR15539832;32;38;0.40625;19;13;0.09375;0.40625
Control.SRR15539832;34;38;0.647058823529412;12;22;0.147058823529412;0.352941176470588
Control.SRR15539832;30;38;0.5;15;15;0;0.5
Control.SRR15539832;37;38;0.459459459459459;20;17;0.0405405405405405;0.459459459459459
Control.SRR15539832;32;38;0.5625;14;18;0.0625;0.4375
Control.SRR15539832;34;38;0.588235294117647;14;20;0.0882352941176471;0.411764705882353
Control.SRR15539832;34;38;0.382352941176471;21;13;0.117647058823529;0.382352941176471
Control.SRR15539832;32;38;0.375;20;12;0.125;0.375
Control.SRR15539832;32;38;0.4375;18;14;0.0625;0.4375
Control.SRR15539832;34;38;0.441176470588235;19;15;0.0588235294117647;0.441176470588235
Control.SRR15539832;29;38;0.379310344827586;18;11;0.120689655172414;0.379310344827586
Control.SRR15539832;32;38;0.46875;17;15;0.03125;0.46875
Control.SRR15539832;31;38;0.419354838709677;18;13;0.0806451612903226;0.419354838709677
Control.SRR15539832;32;38;0.5625;14;18;0.0625;0.4375
Control.SRR15539832;37;38;0.459459459459459;20;17;0.0405405405405405;0.459459459459459
Control.SRR15539832;29;38;0.413793103448276;17;12;0.0862068965517241;0.413793103448276
Control.SRR15539832;31;38;0.67741935483871;10;21;0.17741935483871;0.32258064516129
Control.SRR15539832;32;38;0.4375;18;14;0.0625;0.4375
Control.SRR15539832;31;38;0.580645161290323;13;18;0.0806451612903226;0.419354838709677
Control.SRR15539832;33;38;0.363636363636364;21;12;0.136363636363636;0.363636363636364
Control.SRR15539832;29;38;0.586206896551724;12;17;0.0862068965517241;0.413793103448276
Control.SRR15539832;34;38;0.588235294117647;14;20;0.0882352941176471;0.411764705882353
Control.SRR15539832;31;38;0.645161290322581;11;20;0.145161290322581;0.354838709677419
Control.SRR15539832;37;38;0.459459459459459;20;17;0.0405405405405405;0.459459459459459
Control.SRR15539832;30;38;0.5;15;15;0;0.5
Control.SRR15539832;30;38;0.5;15;15;0;0.5
Control.SRR15539832;29;38;0.310344827586207;20;9;0.189655172413793;0.310344827586207
Control.SRR15539832;31;38;0.387096774193548;19;12;0.112903225806452;0.387096774193548
Control.SRR15539832;32;38;0.5;16;16;0;0.5
Control.SRR15539832;32;38;0.53125;15;17;0.03125;0.46875
Control.SRR15539832;35;38;0.428571428571429;20;15;0.0714285714285715;0.428571428571429
Control.SRR15539832;29;38;0.379310344827586;18;11;0.120689655172414;0.379310344827586
Control.SRR15539832;33;38;0.454545454545455;18;15;0.0454545454545455;0.454545454545455
Control.SRR15539832;29;38;0.517241379310345;14;15;0.0172413793103449;0.482758620689655
Control.SRR15539832;37;38;0.540540540540541;17;20;0.0405405405405406;0.459459459459459
Control.SRR15539832;36;38;0.555555555555556;16;20;0.0555555555555556;0.444444444444444
Control.SRR15539832;35;38;0.457142857142857;19;16;0.0428571428571429;0.457142857142857
Control.SRR15539832;33;38;0.424242424242424;19;14;0.0757575757575757;0.424242424242424
Control.SRR15539832;31;38;0.483870967741935;16;15;0.0161290322580645;0.483870967741935
Control.SRR15539832;36;38;0.527777777777778;17;19;0.0277777777777778;0.472222222222222
Control.SRR15539832;31;38;0.67741935483871;10;21;0.17741935483871;0.32258064516129
Control.SRR15539832;30;38;0.366666666666667;19;11;0.133333333333333;0.366666666666667
Control.SRR15539832;36;38;0.583333333333333;15;21;0.0833333333333334;0.416666666666667
Control.SRR15539832;33;38;0.575757575757576;14;19;0.0757575757575758;0.424242424242424
Control.SRR15539832;37;38;0.594594594594595;15;22;0.0945945945945946;0.405405405405405
Control.SRR15539832;36;38;0.527777777777778;17;19;0.0277777777777778;0.472222222222222
Control.SRR15539832;31;38;0.387096774193548;19;12;0.112903225806452;0.387096774193548
Control.SRR15539832;29;38;0.379310344827586;18;11;0.120689655172414;0.379310344827586
Control.SRR15539832;34;38;0.617647058823529;13;21;0.117647058823529;0.382352941176471
Control.SRR15539832;32;38;0.5625;14;18;0.0625;0.4375
Control.SRR15539832;29;38;0.586206896551724;12;17;0.0862068965517241;0.413793103448276
Control.SRR15539832;36;38;0.472222222222222;19;17;0.0277777777777778;0.472222222222222
Control.SRR15539832;32;38;0.5;16;16;0;0.5
Control.SRR15539832;29;38;0.310344827586207;20;9;0.189655172413793;0.310344827586207
Control.SRR15539832;34;38;0.470588235294118;18;16;0.0294117647058824;0.470588235294118
Control.SRR15539832;29;38;0.620689655172414;11;18;0.120689655172414;0.379310344827586
Control.SRR15539832;36;38;0.361111111111111;23;13;0.138888888888889;0.361111111111111
Control.SRR15539832;35;38;0.542857142857143;16;19;0.0428571428571428;0.457142857142857
Control.SRR15539832;30;38;0.4;18;12;0.1;0.4
Control.SRR15539832;32;38;0.5;16;16;0;0.5
Control.SRR15539832;33;38;0.515151515151515;16;17;0.0151515151515151;0.484848484848485
Control.SRR15539832;29;38;0.413793103448276;17;12;0.0862068965517241;0.413793103448276
Control.SRR15539832;30;38;0.533333333333333;14;16;0.0333333333333333;0.466666666666667
Control.SRR15539832;36;38;0.666666666666667;12;24;0.166666666666667;0.333333333333333
Control.SRR15539832;34;38;0.647058823529412;12;22;0.147058823529412;0.352941176470588
Control.SRR15539832;36;38;0.583333333333333;15;21;0.0833333333333334;0.416666666666667
Control.SRR15539832;36;38;0.611111111111111;14;22;0.111111111111111;0.388888888888889
Control.SRR15539832;33;38;0.606060606060606;13;20;0.106060606060606;0.393939393939394
Control.SRR15539832;29;38;0.655172413793103;10;19;0.155172413793103;0.344827586206897
Control.SRR15539832;35;38;0.514285714285714;17;18;0.0142857142857142;0.485714285714286
Control.SRR15539832;36;38;0.472222222222222;19;17;0.0277777777777778;0.472222222222222
Control.SRR15539832;29;38;0.758620689655172;7;22;0.258620689655172;0.241379310344828
Control.SRR15539832;37;38;0.486486486486487;19;18;0.0135135135135135;0.486486486486487
Control.SRR15539832;37;38;0.621621621621622;14;23;0.121621621621622;0.378378378378378
Control.SRR15539832;34;38;0.647058823529412;12;22;0.147058823529412;0.352941176470588
Control.SRR15539832;30;38;0.6;12;18;0.1;0.4
Control.SRR15539832;32;38;0.625;12;20;0.125;0.375
Control.SRR15539832;36;38;0.472222222222222;19;17;0.0277777777777778;0.472222222222222
Control.SRR15539832;31;38;0.419354838709677;18;13;0.0806451612903226;0.419354838709677
Control.SRR15539832;36;38;0.527777777777778;17;19;0.0277777777777778;0.472222222222222
Control.SRR15539832;37;38;0.513513513513513;18;19;0.0135135135135135;0.486486486486487
Control.SRR15539832;31;38;0.451612903225806;17;14;0.0483870967741936;0.451612903225806
Control.SRR15539832;33;38;0.454545454545455;18;15;0.0454545454545455;0.454545454545455
Control.SRR15539832;33;38;0.545454545454545;15;18;0.0454545454545454;0.454545454545455
Control.SRR15539832;31;38;0.516129032258065;15;16;0.0161290322580645;0.483870967741935
Control.SRR15539832;32;38;0.4375;18;14;0.0625;0.4375
Control.SRR15539832;37;38;0.486486486486487;19;18;0.0135135135135135;0.486486486486487
Control.SRR15539832;37;38;0.405405405405405;22;15;0.0945945945945946;0.405405405405405
Control.SRR15539832;35;38;0.514285714285714;17;18;0.0142857142857142;0.485714285714286
Control.SRR15539832;30;38;0.433333333333333;17;13;0.0666666666666667;0.433333333333333
Control.SRR15539832;33;38;0.363636363636364;21;12;0.136363636363636;0.363636363636364
Control.SRR15539832;34;38;0.352941176470588;22;12;0.147058823529412;0.352941176470588
Control.SRR15539832;31;38;0.516129032258065;15;16;0.0161290322580645;0.483870967741935
Control.SRR15539832;34;38;0.735294117647059;9;25;0.235294117647059;0.264705882352941
Control.SRR15539832;34;38;0.558823529411765;15;19;0.0588235294117647;0.441176470588235
Control.SRR15539832;35;38;0.342857142857143;23;12;0.157142857142857;0.342857142857143
Control.SRR15539832;36;38;0.5;18;18;0;0.5
Control.SRR15539832;32;38;0.5;16;16;0;0.5
Control.SRR15539832;32;38;0.40625;19;13;0.09375;0.40625
Control.SRR15539832;36;38;0.388888888888889;22;14;0.111111111111111;0.388888888888889
Control.SRR15539832;34;38;0.647058823529412;12;22;0.147058823529412;0.352941176470588
Control.SRR15539832;35;38;0.514285714285714;17;18;0.0142857142857142;0.485714285714286
Control.SRR15539832;30;38;0.566666666666667;13;17;0.0666666666666667;0.433333333333333
Control.SRR15539832;32;38;0.25;24;8;0.25;0.25
Control.SRR15539832;37;38;0.486486486486487;19;18;0.0135135135135135;0.486486486486487
Control.SRR15539832;30;38;0.5;15;15;0;0.5
Control.SRR15539832;32;38;0.46875;17;15;0.03125;0.46875
Control.SRR15539832;37;38;0.405405405405405;22;15;0.0945945945945946;0.405405405405405
Control.SRR15539832;32;38;0.375;20;12;0.125;0.375
Control.SRR15539832;30;38;0.466666666666667;16;14;0.0333333333333333;0.466666666666667
Control.SRR15539832;37;38;0.459459459459459;20;17;0.0405405405405405;0.459459459459459
Control.SRR15539832;37;38;0.405405405405405;22;15;0.0945945945945946;0.405405405405405
Control.SRR15539832;32;38;0.5625;14;18;0.0625;0.4375
Control.SRR15539832;33;38;0.454545454545455;18;15;0.0454545454545455;0.454545454545455
Control.SRR15539832;34;38;0.558823529411765;15;19;0.0588235294117647;0.441176470588235
Control.SRR15539832;33;38;0.575757575757576;14;19;0.0757575757575758;0.424242424242424
Control.SRR15539832;36;38;0.5;18;18;0;0.5
Control.SRR15539832;30;38;0.433333333333333;17;13;0.0666666666666667;0.433333333333333
Control.SRR15539832;34;38;0.617647058823529;13;21;0.117647058823529;0.382352941176471
Control.SRR15539832;34;38;0.558823529411765;15;19;0.0588235294117647;0.441176470588235
Control.SRR15539832;29;38;0.655172413793103;10;19;0.155172413793103;0.344827586206897
Control.SRR15539832;29;38;0.517241379310345;14;15;0.0172413793103449;0.482758620689655
Control.SRR15539832;31;38;0.612903225806452;12;19;0.112903225806452;0.387096774193548
Control.SRR15539832;32;38;0.5;16;16;0;0.5
Control.SRR15539832;35;38;0.514285714285714;17;18;0.0142857142857142;0.485714285714286
Control.SRR15539832;36;38;0.5;18;18;0;0.5
Control.SRR15539832;34;38;0.588235294117647;14;20;0.0882352941176471;0.411764705882353
Control.SRR15539832;35;38;0.485714285714286;18;17;0.0142857142857143;0.485714285714286
Control.SRR15539832;32;38;0.53125;15;17;0.03125;0.46875
Control.SRR15539832;29;38;0.586206896551724;12;17;0.0862068965517241;0.413793103448276
Control.SRR15539832;30;38;0.566666666666667;13;17;0.0666666666666667;0.433333333333333
Control.SRR15539832;37;38;0.405405405405405;22;15;0.0945945945945946;0.405405405405405
Control.SRR15539832;30;38;0.566666666666667;13;17;0.0666666666666667;0.433333333333333
Control.SRR15539832;34;38;0.588235294117647;14;20;0.0882352941176471;0.411764705882353
Control.SRR15539832;33;38;0.606060606060606;13;20;0.106060606060606;0.393939393939394
Control.SRR15539832;32;38;0.5625;14;18;0.0625;0.4375
Control.SRR15539832;32;38;0.46875;17;15;0.03125;0.46875
Control.SRR15539832;34;38;0.411764705882353;20;14;0.0882352941176471;0.411764705882353
Control.SRR15539832;29;38;0.379310344827586;18;11;0.120689655172414;0.379310344827586
Control.SRR15539832;30;38;0.466666666666667;16;14;0.0333333333333333;0.466666666666667
Control.SRR15539832;30;38;0.4;18;12;0.1;0.4
Control.SRR15539832;31;38;0.483870967741935;16;15;0.0161290322580645;0.483870967741935
Control.SRR15539832;31;38;0.516129032258065;15;16;0.0161290322580645;0.483870967741935
Control.SRR15539832;31;38;0.612903225806452;12;19;0.112903225806452;0.387096774193548
Control.SRR15539832;33;38;0.606060606060606;13;20;0.106060606060606;0.393939393939394
Control.SRR15539832;36;38;0.5;18;18;0;0.5
Control.SRR15539832;34;38;0.352941176470588;22;12;0.147058823529412;0.352941176470588
Control.SRR15539832;35;38;0.542857142857143;16;19;0.0428571428571428;0.457142857142857
Control.SRR15539832;33;38;0.454545454545455;18;15;0.0454545454545455;0.454545454545455
Control.SRR15539832;33;38;0.575757575757576;14;19;0.0757575757575758;0.424242424242424
Control.SRR15539832;29;38;0.482758620689655;15;14;0.0172413793103448;0.482758620689655
Control.SRR15539832;32;38;0.375;20;12;0.125;0.375
Control.SRR15539832;35;38;0.371428571428571;22;13;0.128571428571429;0.371428571428571
Control.SRR15539832;33;38;0.363636363636364;21;12;0.136363636363636;0.363636363636364
Control.SRR15539832;32;38;0.5;16;16;0;0.5
Control.SRR15539832;32;38;0.5;16;16;0;0.5
Control.SRR15539832;32;38;0.5;16;16;0;0.5
Control.SRR15539832;29;38;0.655172413793103;10;19;0.155172413793103;0.344827586206897
Control.SRR15539832;34;38;0.352941176470588;22;12;0.147058823529412;0.352941176470588
Control.SRR15539832;31;38;0.451612903225806;17;14;0.0483870967741936;0.451612903225806
Control.SRR15539832;36;38;0.333333333333333;24;12;0.166666666666667;0.333333333333333
Control.SRR15539832;34;38;0.558823529411765;15;19;0.0588235294117647;0.441176470588235
Control.SRR15539832;29;38;0.517241379310345;14;15;0.0172413793103449;0.482758620689655
Control.SRR15539832;30;38;0.366666666666667;19;11;0.133333333333333;0.366666666666667
Control.SRR15539832;32;38;0.53125;15;17;0.03125;0.46875
Control.SRR15539832;30;38;0.533333333333333;14;16;0.0333333333333333;0.466666666666667
Control.SRR15539832;37;38;0.486486486486487;19;18;0.0135135135135135;0.486486486486487
Control.SRR15539832;36;38;0.472222222222222;19;17;0.0277777777777778;0.472222222222222
Control.SRR15539832;29;38;0.586206896551724;12;17;0.0862068965517241;0.413793103448276
Control.SRR15539832;34;38;0.588235294117647;14;20;0.0882352941176471;0.411764705882353
Control.SRR15539832;31;38;0.483870967741935;16;15;0.0161290322580645;0.483870967741935
Control.SRR15539832;32;38;0.46875;17;15;0.03125;0.46875
Control.SRR15539832;34;38;0.529411764705882;16;18;0.0294117647058824;0.470588235294118
Control.SRR15539832;30;38;0.433333333333333;17;13;0.0666666666666667;0.433333333333333
Control.SRR15539832;29;38;0.551724137931034;13;16;0.0517241379310345;0.448275862068966
Control.SRR15539832;35;38;0.514285714285714;17;18;0.0142857142857142;0.485714285714286
Control.SRR15539832;37;38;0.351351351351351;24;13;0.148648648648649;0.351351351351351
Control.SRR15539832;33;38;0.545454545454545;15;18;0.0454545454545454;0.454545454545455
Control.SRR15539832;36;38;0.5;18;18;0;0.5
Control.SRR15539832;29;38;0.517241379310345;14;15;0.0172413793103449;0.482758620689655
Control.SRR15539832;33;38;0.424242424242424;19;14;0.0757575757575757;0.424242424242424
Control.SRR15539832;31;38;0.645161290322581;11;20;0.145161290322581;0.354838709677419
Control.SRR15539832;34;38;0.352941176470588;22;12;0.147058823529412;0.352941176470588
Control.SRR15539832;33;38;0.454545454545455;18;15;0.0454545454545455;0.454545454545455
Control.SRR15539832;32;38;0.40625;19;13;0.09375;0.40625
Control.SRR15539832;31;38;0.516129032258065;15;16;0.0161290322580645;0.483870967741935
Control.SRR15539832;37;38;0.459459459459459;20;17;0.0405405405405405;0.459459459459459
Control.SRR15539832;32;38;0.5;16;16;0;0.5
Control.SRR15539832;32;38;0.53125;15;17;0.03125;0.46875
Control.SRR15539832;37;38;0.297297297297297;26;11;0.202702702702703;0.297297297297297
Control.SRR15539832;35;38;0.428571428571429;20;15;0.0714285714285715;0.428571428571429
Control.SRR15539832;35;38;0.542857142857143;16;19;0.0428571428571428;0.457142857142857
Control.SRR15539832;32;38;0.4375;18;14;0.0625;0.4375
Control.SRR15539832;34;38;0.617647058823529;13;21;0.117647058823529;0.382352941176471
Control.SRR15539832;31;38;0.580645161290323;13;18;0.0806451612903226;0.419354838709677
Control.SRR15539832;31;38;0.483870967741935;16;15;0.0161290322580645;0.483870967741935
Control.SRR15539832;34;38;0.676470588235294;11;23;0.176470588235294;0.323529411764706
Control.SRR15539832;36;38;0.638888888888889;13;23;0.138888888888889;0.361111111111111
Control.SRR15539832;34;38;0.382352941176471;21;13;0.117647058823529;0.382352941176471
Control.SRR15539832;31;38;0.483870967741935;16;15;0.0161290322580645;0.483870967741935
Control.SRR15539832;31;38;0.419354838709677;18;13;0.0806451612903226;0.419354838709677
Control.SRR15539832;30;38;0.466666666666667;16;14;0.0333333333333333;0.466666666666667
Control.SRR15539832;33;38;0.515151515151515;16;17;0.0151515151515151;0.484848484848485
Control.SRR15539832;34;38;0.529411764705882;16;18;0.0294117647058824;0.470588235294118
Control.SRR15539832;36;38;0.583333333333333;15;21;0.0833333333333334;0.416666666666667
Control.SRR15539832;35;38;0.485714285714286;18;17;0.0142857142857143;0.485714285714286
Control.SRR15539832;33;38;0.515151515151515;16;17;0.0151515151515151;0.484848484848485
Control.SRR15539832;34;38;0.558823529411765;15;19;0.0588235294117647;0.441176470588235
Control.SRR15539832;37;38;0.513513513513513;18;19;0.0135135135135135;0.486486486486487
Control.SRR15539832;35;38;0.428571428571429;20;15;0.0714285714285715;0.428571428571429
Control.SRR15539832;37;38;0.459459459459459;20;17;0.0405405405405405;0.459459459459459
Control.SRR15539832;31;38;0.548387096774194;14;17;0.0483870967741935;0.451612903225806
Control.SRR15539832;31;38;0.483870967741935;16;15;0.0161290322580645;0.483870967741935
Control.SRR15539832;37;38;0.540540540540541;17;20;0.0405405405405406;0.459459459459459
Control.SRR15539832;35;38;0.571428571428571;15;20;0.0714285714285714;0.428571428571429
Control.SRR15539832;36;38;0.444444444444444;20;16;0.0555555555555556;0.444444444444444
Control.SRR15539832;31;38;0.451612903225806;17;14;0.0483870967741936;0.451612903225806
Control.SRR15539832;37;38;0.405405405405405;22;15;0.0945945945945946;0.405405405405405
Control.SRR15539832;31;38;0.580645161290323;13;18;0.0806451612903226;0.419354838709677
Control.SRR15539832;35;38;0.4;21;14;0.1;0.4
Control.SRR15539832;29;38;0.448275862068966;16;13;0.0517241379310345;0.448275862068966
Control.SRR15539832;37;38;0.324324324324324;25;12;0.175675675675676;0.324324324324324
Control.SRR15539832;36;38;0.583333333333333;15;21;0.0833333333333334;0.416666666666667
Control.SRR15539832;30;38;0.333333333333333;20;10;0.166666666666667;0.333333333333333
Control.SRR15539832;29;38;0.689655172413793;9;20;0.189655172413793;0.310344827586207
Control.SRR15539832;34;38;0.470588235294118;18;16;0.0294117647058824;0.470588235294118
Control.SRR15539832;34;38;0.470588235294118;18;16;0.0294117647058824;0.470588235294118
Control.SRR15539832;31;38;0.451612903225806;17;14;0.0483870967741936;0.451612903225806
Control.SRR15539832;32;38;0.4375;18;14;0.0625;0.4375
Control.SRR15539832;35;38;0.6;14;21;0.1;0.4
Control.SRR15539832;31;38;0.451612903225806;17;14;0.0483870967741936;0.451612903225806
Control.SRR15539832;32;38;0.5625;14;18;0.0625;0.4375
Control.SRR15539832;35;38;0.4;21;14;0.1;0.4
Control.SRR15539832;36;38;0.472222222222222;19;17;0.0277777777777778;0.472222222222222
Control.SRR15539832;34;38;0.558823529411765;15;19;0.0588235294117647;0.441176470588235
Control.SRR15539832;32;38;0.46875;17;15;0.03125;0.46875
Control.SRR15539832;36;38;0.555555555555556;16;20;0.0555555555555556;0.444444444444444
Control.SRR15539832;36;38;0.388888888888889;22;14;0.111111111111111;0.388888888888889
Control.SRR15539832;33;38;0.515151515151515;16;17;0.0151515151515151;0.484848484848485
Control.SRR15539832;37;38;0.351351351351351;24;13;0.148648648648649;0.351351351351351
Control.SRR15539832;35;38;0.428571428571429;20;15;0.0714285714285715;0.428571428571429
Control.SRR15539832;32;38;0.46875;17;15;0.03125;0.46875
Control.SRR15539832;34;38;0.441176470588235;19;15;0.0588235294117647;0.441176470588235
Control.SRR15539832;37;38;0.432432432432432;21;16;0.0675675675675675;0.432432432432432
Control.SRR15539832;36;38;0.444444444444444;20;16;0.0555555555555556;0.444444444444444
Control.SRR15539832;33;38;0.575757575757576;14;19;0.0757575757575758;0.424242424242424
Control.SRR15539832;37;38;0.432432432432432;21;16;0.0675675675675675;0.432432432432432
Control.SRR15539832;37;38;0.459459459459459;20;17;0.0405405405405405;0.459459459459459
Control.SRR15539832;34;38;0.676470588235294;11;23;0.176470588235294;0.323529411764706
Control.SRR15539832;34;38;0.529411764705882;16;18;0.0294117647058824;0.470588235294118
Control.SRR15539832;29;38;0.448275862068966;16;13;0.0517241379310345;0.448275862068966
Control.SRR15539832;35;38;0.485714285714286;18;17;0.0142857142857143;0.485714285714286
Control.SRR15539832;33;38;0.363636363636364;21;12;0.136363636363636;0.363636363636364
Control.SRR15539832;33;38;0.515151515151515;16;17;0.0151515151515151;0.484848484848485
Control.SRR15539832;36;38;0.416666666666667;21;15;0.0833333333333333;0.416666666666667
Control.SRR15539832;33;38;0.454545454545455;18;15;0.0454545454545455;0.454545454545455
Control.SRR15539832;32;38;0.53125;15;17;0.03125;0.46875
Control.SRR15539832;29;38;0.344827586206897;19;10;0.155172413793103;0.344827586206897
Control.SRR15539832;30;38;0.5;15;15;0;0.5
Control.SRR15539832;31;38;0.451612903225806;17;14;0.0483870967741936;0.451612903225806
Control.SRR15539832;37;38;0.432432432432432;21;16;0.0675675675675675;0.432432432432432
Control.SRR15539832;32;38;0.375;20;12;0.125;0.375
Control.SRR15539832;35;38;0.514285714285714;17;18;0.0142857142857142;0.485714285714286
Control.SRR15539832;37;38;0.621621621621622;14;23;0.121621621621622;0.378378378378378
Control.SRR15539832;32;38;0.5;16;16;0;0.5
Control.SRR15539832;31;38;0.612903225806452;12;19;0.112903225806452;0.387096774193548
Control.SRR15539832;30;38;0.5;15;15;0;0.5
Control.SRR15539832;32;38;0.5;16;16;0;0.5
Control.SRR15539832;37;38;0.459459459459459;20;17;0.0405405405405405;0.459459459459459
Control.SRR15539832;33;38;0.363636363636364;21;12;0.136363636363636;0.363636363636364
Control.SRR15539832;35;38;0.6;14;21;0.1;0.4
Control.SRR15539832;35;38;0.457142857142857;19;16;0.0428571428571429;0.457142857142857
Control.SRR15539832;36;38;0.472222222222222;19;17;0.0277777777777778;0.472222222222222
Control.SRR15539832;36;38;0.444444444444444;20;16;0.0555555555555556;0.444444444444444
Control.SRR15539832;33;38;0.424242424242424;19;14;0.0757575757575757;0.424242424242424
Control.SRR15539832;31;38;0.451612903225806;17;14;0.0483870967741936;0.451612903225806
Control.SRR15539832;35;38;0.428571428571429;20;15;0.0714285714285715;0.428571428571429
Control.SRR15539832;32;38;0.4375;18;14;0.0625;0.4375
Control.SRR15539832;32;38;0.59375;13;19;0.09375;0.40625
Control.SRR15539832;29;38;0.344827586206897;19;10;0.155172413793103;0.344827586206897
Control.SRR15539832;35;38;0.4;21;14;0.1;0.4
Control.SRR15539832;33;38;0.515151515151515;16;17;0.0151515151515151;0.484848484848485
Control.SRR15539832;36;38;0.611111111111111;14;22;0.111111111111111;0.388888888888889
Control.SRR15539832;29;38;0.655172413793103;10;19;0.155172413793103;0.344827586206897
Control.SRR15539832;33;38;0.545454545454545;15;18;0.0454545454545454;0.454545454545455
Control.SRR15539832;33;38;0.454545454545455;18;15;0.0454545454545455;0.454545454545455
Control.SRR15539832;32;38;0.3125;22;10;0.1875;0.3125
Control.SRR15539832;35;38;0.457142857142857;19;16;0.0428571428571429;0.457142857142857
Control.SRR15539832;31;38;0.290322580645161;22;9;0.209677419354839;0.290322580645161
Control.SRR15539832;37;38;0.459459459459459;20;17;0.0405405405405405;0.459459459459459
Control.SRR15539832;33;38;0.606060606060606;13;20;0.106060606060606;0.393939393939394
Control.SRR15539832;37;38;0.459459459459459;20;17;0.0405405405405405;0.459459459459459
Control.SRR15539832;36;38;0.472222222222222;19;17;0.0277777777777778;0.472222222222222
Control.SRR15539832;33;38;0.606060606060606;13;20;0.106060606060606;0.393939393939394
Control.SRR15539832;35;38;0.457142857142857;19;16;0.0428571428571429;0.457142857142857
Control.SRR15539832;36;38;0.333333333333333;24;12;0.166666666666667;0.333333333333333
Control.SRR15539832;34;38;0.676470588235294;11;23;0.176470588235294;0.323529411764706
Control.SRR15539832;31;38;0.516129032258065;15;16;0.0161290322580645;0.483870967741935
Control.SRR15539832;35;38;0.4;21;14;0.1;0.4
Control.SRR15539832;34;38;0.617647058823529;13;21;0.117647058823529;0.382352941176471
Control.SRR15539832;32;38;0.46875;17;15;0.03125;0.46875
Control.SRR15539832;34;38;0.470588235294118;18;16;0.0294117647058824;0.470588235294118
Control.SRR15539832;37;38;0.486486486486487;19;18;0.0135135135135135;0.486486486486487
Control.SRR15539832;34;38;0.588235294117647;14;20;0.0882352941176471;0.411764705882353
Control.SRR15539832;34;38;0.470588235294118;18;16;0.0294117647058824;0.470588235294118
Control.SRR15539832;34;38;0.5;17;17;0;0.5
Control.SRR15539832;33;38;0.454545454545455;18;15;0.0454545454545455;0.454545454545455
Control.SRR15539832;29;38;0.655172413793103;10;19;0.155172413793103;0.344827586206897
Control.SRR15539832;33;38;0.515151515151515;16;17;0.0151515151515151;0.484848484848485
Control.SRR15539832;33;38;0.515151515151515;16;17;0.0151515151515151;0.484848484848485
Control.SRR15539832;31;38;0.580645161290323;13;18;0.0806451612903226;0.419354838709677
Control.SRR15539832;32;38;0.375;20;12;0.125;0.375
Control.SRR15539832;32;38;0.53125;15;17;0.03125;0.46875
Control.SRR15539832;36;38;0.388888888888889;22;14;0.111111111111111;0.388888888888889
Control.SRR15539832;30;38;0.366666666666667;19;11;0.133333333333333;0.366666666666667
Control.SRR15539832;37;38;0.567567567567568;16;21;0.0675675675675675;0.432432432432432
Control.SRR15539832;35;38;0.542857142857143;16;19;0.0428571428571428;0.457142857142857
Control.SRR15539832;32;38;0.4375;18;14;0.0625;0.4375
Control.SRR15539832;36;38;0.555555555555556;16;20;0.0555555555555556;0.444444444444444
Control.SRR15539832;36;38;0.555555555555556;16;20;0.0555555555555556;0.444444444444444
Control.SRR15539832;29;38;0.655172413793103;10;19;0.155172413793103;0.344827586206897
Control.SRR15539832;33;38;0.545454545454545;15;18;0.0454545454545454;0.454545454545455
Control.SRR15539832;33;38;0.363636363636364;21;12;0.136363636363636;0.363636363636364
Control.SRR15539832;29;38;0.551724137931034;13;16;0.0517241379310345;0.448275862068966
Control.SRR15539832;31;38;0.32258064516129;21;10;0.17741935483871;0.32258064516129
Control.SRR15539832;35;38;0.428571428571429;20;15;0.0714285714285715;0.428571428571429
Control.SRR15539832;35;38;0.628571428571429;13;22;0.128571428571429;0.371428571428571
Control.SRR15539832;34;38;0.529411764705882;16;18;0.0294117647058824;0.470588235294118
Control.SRR15539832;35;38;0.542857142857143;16;19;0.0428571428571428;0.457142857142857
Control.SRR15539832;36;38;0.583333333333333;15;21;0.0833333333333334;0.416666666666667
Control.SRR15539832;37;38;0.513513513513513;18;19;0.0135135135135135;0.486486486486487
Control.SRR15539832;34;38;0.382352941176471;21;13;0.117647058823529;0.382352941176471
Control.SRR15539832;32;38;0.375;20;12;0.125;0.375
Control.SRR15539832;33;38;0.545454545454545;15;18;0.0454545454545454;0.454545454545455
Control.SRR15539832;35;38;0.6;14;21;0.1;0.4
Control.SRR15539832;31;38;0.580645161290323;13;18;0.0806451612903226;0.419354838709677
Control.SRR15539832;31;38;0.419354838709677;18;13;0.0806451612903226;0.419354838709677
Control.SRR15539832;31;38;0.483870967741935;16;15;0.0161290322580645;0.483870967741935
Control.SRR15539832;36;38;0.583333333333333;15;21;0.0833333333333334;0.416666666666667
Control.SRR15539832;36;38;0.388888888888889;22;14;0.111111111111111;0.388888888888889
Control.SRR15539832;30;38;0.433333333333333;17;13;0.0666666666666667;0.433333333333333
Control.SRR15539832;36;38;0.416666666666667;21;15;0.0833333333333333;0.416666666666667
Control.SRR15539832;32;38;0.6875;10;22;0.1875;0.3125
Control.SRR15539832;31;38;0.580645161290323;13;18;0.0806451612903226;0.419354838709677
Control.SRR15539832;32;38;0.75;8;24;0.25;0.25
Control.SRR15539832;35;38;0.514285714285714;17;18;0.0142857142857142;0.485714285714286
Control.SRR15539832;37;38;0.675675675675676;12;25;0.175675675675676;0.324324324324324
Control.SRR15539832;34;38;0.382352941176471;21;13;0.117647058823529;0.382352941176471
Control.SRR15539832;32;38;0.46875;17;15;0.03125;0.46875
Control.SRR15539832;36;38;0.611111111111111;14;22;0.111111111111111;0.388888888888889
Control.SRR15539832;32;38;0.53125;15;17;0.03125;0.46875
Control.SRR15539832;30;38;0.433333333333333;17;13;0.0666666666666667;0.433333333333333
Control.SRR15539832;36;38;0.5;18;18;0;0.5
Control.SRR15539832;34;38;0.441176470588235;19;15;0.0588235294117647;0.441176470588235
Control.SRR15539832;33;38;0.363636363636364;21;12;0.136363636363636;0.363636363636364
Control.SRR15539832;31;38;0.354838709677419;20;11;0.145161290322581;0.354838709677419
Control.SRR15539832;36;38;0.472222222222222;19;17;0.0277777777777778;0.472222222222222
Control.SRR15539832;29;38;0.620689655172414;11;18;0.120689655172414;0.379310344827586
Control.SRR15539832;35;38;0.542857142857143;16;19;0.0428571428571428;0.457142857142857
Control.SRR15539832;31;38;0.483870967741935;16;15;0.0161290322580645;0.483870967741935
Control.SRR15539832;37;38;0.540540540540541;17;20;0.0405405405405406;0.459459459459459
Control.SRR15539832;37;38;0.594594594594595;15;22;0.0945945945945946;0.405405405405405
Control.SRR15539832;35;38;0.6;14;21;0.1;0.4
Control.SRR15539832;36;38;0.583333333333333;15;21;0.0833333333333334;0.416666666666667
Control.SRR15539832;34;38;0.470588235294118;18;16;0.0294117647058824;0.470588235294118
Control.SRR15539832;30;38;0.6;12;18;0.1;0.4
Control.SRR15539832;33;38;0.484848484848485;17;16;0.0151515151515151;0.484848484848485
Control.SRR15539832;34;38;0.558823529411765;15;19;0.0588235294117647;0.441176470588235
Control.SRR15539832;35;38;0.285714285714286;25;10;0.214285714285714;0.285714285714286
Control.SRR15539832;30;38;0.5;15;15;0;0.5
Control.SRR15539832;29;38;0.551724137931034;13;16;0.0517241379310345;0.448275862068966
Control.SRR15539832;32;38;0.5625;14;18;0.0625;0.4375
Control.SRR15539832;31;38;0.483870967741935;16;15;0.0161290322580645;0.483870967741935
Control.SRR15539832;29;38;0.482758620689655;15;14;0.0172413793103448;0.482758620689655
Control.SRR15539832;35;38;0.571428571428571;15;20;0.0714285714285714;0.428571428571429
Control.SRR15539832;34;38;0.441176470588235;19;15;0.0588235294117647;0.441176470588235
Control.SRR15539832;35;38;0.542857142857143;16;19;0.0428571428571428;0.457142857142857
Control.SRR15539832;30;38;0.466666666666667;16;14;0.0333333333333333;0.466666666666667
Control.SRR15539832;36;38;0.305555555555556;25;11;0.194444444444444;0.305555555555556
Control.SRR15539832;35;38;0.428571428571429;20;15;0.0714285714285715;0.428571428571429
Control.SRR15539832;31;38;0.580645161290323;13;18;0.0806451612903226;0.419354838709677
Control.SRR15539832;32;38;0.53125;15;17;0.03125;0.46875
Control.SRR15539832;30;38;0.5;15;15;0;0.5
Control.SRR15539832;29;38;0.620689655172414;11;18;0.120689655172414;0.379310344827586
Control.SRR15539832;37;38;0.513513513513513;18;19;0.0135135135135135;0.486486486486487
Control.SRR15539832;33;38;0.545454545454545;15;18;0.0454545454545454;0.454545454545455
Control.SRR15539832;37;38;0.405405405405405;22;15;0.0945945945945946;0.405405405405405
Control.SRR15539832;32;38;0.4375;18;14;0.0625;0.4375
Control.SRR15539832;31;38;0.290322580645161;22;9;0.209677419354839;0.290322580645161
Control.SRR15539832;33;38;0.393939393939394;20;13;0.106060606060606;0.393939393939394
Control.SRR15539832;30;38;0.5;15;15;0;0.5
Control.SRR15539832;35;38;0.6;14;21;0.1;0.4
Control.SRR15539832;37;38;0.567567567567568;16;21;0.0675675675675675;0.432432432432432
Control.SRR15539832;36;38;0.5;18;18;0;0.5
Control.SRR15539832;31;38;0.419354838709677;18;13;0.0806451612903226;0.419354838709677
Control.SRR15539832;29;38;0.655172413793103;10;19;0.155172413793103;0.344827586206897
Control.SRR15539832;33;38;0.484848484848485;17;16;0.0151515151515151;0.484848484848485
Control.SRR15539832;33;38;0.636363636363636;12;21;0.136363636363636;0.363636363636364
Control.SRR15539832;37;38;0.486486486486487;19;18;0.0135135135135135;0.486486486486487
Control.SRR15539832;31;38;0.451612903225806;17;14;0.0483870967741936;0.451612903225806
Control.SRR15539832;33;38;0.333333333333333;22;11;0.166666666666667;0.333333333333333
Control.SRR15539832;30;38;0.466666666666667;16;14;0.0333333333333333;0.466666666666667
Control.SRR15539832;29;38;0.482758620689655;15;14;0.0172413793103448;0.482758620689655
Control.SRR15539832;31;38;0.548387096774194;14;17;0.0483870967741935;0.451612903225806
Control.SRR15539832;33;38;0.454545454545455;18;15;0.0454545454545455;0.454545454545455
Control.SRR15539832;37;38;0.378378378378378;23;14;0.121621621621622;0.378378378378378
Control.SRR15539832;37;38;0.702702702702703;11;26;0.202702702702703;0.297297297297297
Control.SRR15539832;31;38;0.451612903225806;17;14;0.0483870967741936;0.451612903225806
Control.SRR15539832;30;38;0.466666666666667;16;14;0.0333333333333333;0.466666666666667
Control.SRR15539832;33;38;0.424242424242424;19;14;0.0757575757575757;0.424242424242424
Control.SRR15539832;33;38;0.636363636363636;12;21;0.136363636363636;0.363636363636364
Control.SRR15539832;32;38;0.46875;17;15;0.03125;0.46875
Control.SRR15539832;32;38;0.4375;18;14;0.0625;0.4375
Control.SRR15539832;32;38;0.46875;17;15;0.03125;0.46875
Control.SRR15539832;34;38;0.558823529411765;15;19;0.0588235294117647;0.441176470588235
Control.SRR15539832;29;38;0.551724137931034;13;16;0.0517241379310345;0.448275862068966
Control.SRR15539832;34;38;0.470588235294118;18;16;0.0294117647058824;0.470588235294118
Control.SRR15539832;33;38;0.424242424242424;19;14;0.0757575757575757;0.424242424242424
Control.SRR15539832;29;38;0.310344827586207;20;9;0.189655172413793;0.310344827586207
Control.SRR15539832;37;38;0.621621621621622;14;23;0.121621621621622;0.378378378378378
Control.SRR15539832;34;38;0.529411764705882;16;18;0.0294117647058824;0.470588235294118
Control.SRR15539832;36;38;0.555555555555556;16;20;0.0555555555555556;0.444444444444444
Control.SRR15539832;34;38;0.705882352941177;10;24;0.205882352941177;0.294117647058824
Control.SRR15539832;33;38;0.545454545454545;15;18;0.0454545454545454;0.454545454545455
Control.SRR15539832;32;38;0.4375;18;14;0.0625;0.4375
Control.SRR15539832;32;38;0.53125;15;17;0.03125;0.46875
Control.SRR15539832;36;38;0.5;18;18;0;0.5
Control.SRR15539832;29;38;0.482758620689655;15;14;0.0172413793103448;0.482758620689655
Control.SRR15539832;33;38;0.636363636363636;12;21;0.136363636363636;0.363636363636364
Control.SRR15539832;37;38;0.513513513513513;18;19;0.0135135135135135;0.486486486486487
Control.SRR15539832;35;38;0.4;21;14;0.1;0.4
Control.SRR15539832;32;38;0.53125;15;17;0.03125;0.46875
Control.SRR15539832;32;38;0.59375;13;19;0.09375;0.40625
Control.SRR15539832;30;38;0.366666666666667;19;11;0.133333333333333;0.366666666666667
Control.SRR15539832;34;38;0.352941176470588;22;12;0.147058823529412;0.352941176470588
Control.SRR15539832;32;38;0.5625;14;18;0.0625;0.4375
Control.SRR15539832;37;38;0.540540540540541;17;20;0.0405405405405406;0.459459459459459
Control.SRR15539832;36;38;0.611111111111111;14;22;0.111111111111111;0.388888888888889
Control.SRR15539832;34;38;0.5;17;17;0;0.5
Control.SRR15539832;33;38;0.575757575757576;14;19;0.0757575757575758;0.424242424242424
Control.SRR15539832;30;38;0.6;12;18;0.1;0.4
Control.SRR15539832;31;38;0.645161290322581;11;20;0.145161290322581;0.354838709677419
Control.SRR15539832;33;38;0.424242424242424;19;14;0.0757575757575757;0.424242424242424
Control.SRR15539832;32;38;0.5625;14;18;0.0625;0.4375
Control.SRR15539832;29;38;0.551724137931034;13;16;0.0517241379310345;0.448275862068966
Control.SRR15539832;36;38;0.555555555555556;16;20;0.0555555555555556;0.444444444444444
Control.SRR15539832;36;38;0.472222222222222;19;17;0.0277777777777778;0.472222222222222
Control.SRR15539832;33;38;0.363636363636364;21;12;0.136363636363636;0.363636363636364
Control.SRR15539832;30;38;0.366666666666667;19;11;0.133333333333333;0.366666666666667
Control.SRR15539832;30;38;0.433333333333333;17;13;0.0666666666666667;0.433333333333333
Control.SRR15539832;36;38;0.611111111111111;14;22;0.111111111111111;0.388888888888889
Control.SRR15539832;35;38;0.485714285714286;18;17;0.0142857142857143;0.485714285714286
Control.SRR15539832;32;38;0.4375;18;14;0.0625;0.4375
Control.SRR15539832;31;38;0.419354838709677;18;13;0.0806451612903226;0.419354838709677
Control.SRR15539832;31;38;0.483870967741935;16;15;0.0161290322580645;0.483870967741935
Control.SRR15539832;36;38;0.472222222222222;19;17;0.0277777777777778;0.472222222222222
Control.SRR15539832;36;38;0.416666666666667;21;15;0.0833333333333333;0.416666666666667
Control.SRR15539832;30;38;0.5;15;15;0;0.5
Control.SRR15539832;31;38;0.387096774193548;19;12;0.112903225806452;0.387096774193548
Control.SRR15539832;36;38;0.5;18;18;0;0.5
Control.SRR15539832;29;38;0.517241379310345;14;15;0.0172413793103449;0.482758620689655
Control.SRR15539832;32;38;0.40625;19;13;0.09375;0.40625
Control.SRR15539832;34;38;0.352941176470588;22;12;0.147058823529412;0.352941176470588
Control.SRR15539832;29;38;0.448275862068966;16;13;0.0517241379310345;0.448275862068966
Control.SRR15539832;31;38;0.451612903225806;17;14;0.0483870967741936;0.451612903225806
Control.SRR15539832;33;38;0.484848484848485;17;16;0.0151515151515151;0.484848484848485
Control.SRR15539832;34;38;0.5;17;17;0;0.5
Control.SRR15539832;36;38;0.444444444444444;20;16;0.0555555555555556;0.444444444444444
Control.SRR15539832;34;38;0.529411764705882;16;18;0.0294117647058824;0.470588235294118
Control.SRR15539832;37;38;0.432432432432432;21;16;0.0675675675675675;0.432432432432432
Control.SRR15539832;31;38;0.419354838709677;18;13;0.0806451612903226;0.419354838709677
Control.SRR15539832;29;38;0.482758620689655;15;14;0.0172413793103448;0.482758620689655
Control.SRR15539832;31;38;0.483870967741935;16;15;0.0161290322580645;0.483870967741935
Control.SRR15539832;35;38;0.514285714285714;17;18;0.0142857142857142;0.485714285714286
Control.SRR15539832;31;38;0.483870967741935;16;15;0.0161290322580645;0.483870967741935
Control.SRR15539832;32;38;0.4375;18;14;0.0625;0.4375
Control.SRR15539832;31;38;0.354838709677419;20;11;0.145161290322581;0.354838709677419
Control.SRR15539832;30;38;0.633333333333333;11;19;0.133333333333333;0.366666666666667
Control.SRR15539832;34;38;0.411764705882353;20;14;0.0882352941176471;0.411764705882353
Control.SRR15539832;30;38;0.533333333333333;14;16;0.0333333333333333;0.466666666666667
Control.SRR15539832;31;38;0.451612903225806;17;14;0.0483870967741936;0.451612903225806
Control.SRR15539832;36;38;0.444444444444444;20;16;0.0555555555555556;0.444444444444444
Control.SRR15539832;29;38;0.448275862068966;16;13;0.0517241379310345;0.448275862068966
Control.SRR15539832;32;38;0.65625;11;21;0.15625;0.34375
Control.SRR15539832;33;38;0.545454545454545;15;18;0.0454545454545454;0.454545454545455
Control.SRR15539832;33;38;0.515151515151515;16;17;0.0151515151515151;0.484848484848485
Control.SRR15539832;34;38;0.676470588235294;11;23;0.176470588235294;0.323529411764706
Control.SRR15539832;32;38;0.46875;17;15;0.03125;0.46875
Control.SRR15539832;31;38;0.32258064516129;21;10;0.17741935483871;0.32258064516129
Control.SRR15539832;29;38;0.517241379310345;14;15;0.0172413793103449;0.482758620689655
Control.SRR15539832;35;38;0.485714285714286;18;17;0.0142857142857143;0.485714285714286
Control.SRR15539832;37;38;0.432432432432432;21;16;0.0675675675675675;0.432432432432432
Control.SRR15539832;30;38;0.2;24;6;0.3;0.2
Control.SRR15539832;31;38;0.483870967741935;16;15;0.0161290322580645;0.483870967741935
Control.SRR15539832;33;38;0.575757575757576;14;19;0.0757575757575758;0.424242424242424
Control.SRR15539832;33;38;0.515151515151515;16;17;0.0151515151515151;0.484848484848485
Control.SRR15539832;33;38;0.515151515151515;16;17;0.0151515151515151;0.484848484848485
Control.SRR15539832;36;38;0.416666666666667;21;15;0.0833333333333333;0.416666666666667
Control.SRR15539832;33;38;0.484848484848485;17;16;0.0151515151515151;0.484848484848485
Control.SRR15539832;34;38;0.352941176470588;22;12;0.147058823529412;0.352941176470588
Control.SRR15539832;35;38;0.342857142857143;23;12;0.157142857142857;0.342857142857143
Control.SRR15539832;31;38;0.451612903225806;17;14;0.0483870967741936;0.451612903225806
Control.SRR15539832;37;38;0.594594594594595;15;22;0.0945945945945946;0.405405405405405
Control.SRR15539832;35;38;0.542857142857143;16;19;0.0428571428571428;0.457142857142857
Control.SRR15539832;29;38;0.413793103448276;17;12;0.0862068965517241;0.413793103448276
Control.SRR15539832;37;38;0.459459459459459;20;17;0.0405405405405405;0.459459459459459
Control.SRR15539832;35;38;0.514285714285714;17;18;0.0142857142857142;0.485714285714286
Control.SRR15539832;30;38;0.466666666666667;16;14;0.0333333333333333;0.466666666666667
Control.SRR15539832;36;38;0.638888888888889;13;23;0.138888888888889;0.361111111111111
Control.SRR15539832;31;38;0.67741935483871;10;21;0.17741935483871;0.32258064516129
Control.SRR15539832;32;38;0.53125;15;17;0.03125;0.46875
Control.SRR15539832;32;38;0.5625;14;18;0.0625;0.4375
Control.SRR15539832;32;38;0.4375;18;14;0.0625;0.4375
Control.SRR15539832;37;38;0.567567567567568;16;21;0.0675675675675675;0.432432432432432
Control.SRR15539832;33;38;0.515151515151515;16;17;0.0151515151515151;0.484848484848485
Control.SRR15539832;29;38;0.586206896551724;12;17;0.0862068965517241;0.413793103448276
Control.SRR15539832;37;38;0.513513513513513;18;19;0.0135135135135135;0.486486486486487
Control.SRR15539832;30;38;0.466666666666667;16;14;0.0333333333333333;0.466666666666667
Control.SRR15539832;37;38;0.486486486486487;19;18;0.0135135135135135;0.486486486486487
Control.SRR15539832;29;38;0.482758620689655;15;14;0.0172413793103448;0.482758620689655
Control.SRR15539832;33;38;0.393939393939394;20;13;0.106060606060606;0.393939393939394
Control.SRR15539832;32;38;0.59375;13;19;0.09375;0.40625
Control.SRR15539832;32;38;0.53125;15;17;0.03125;0.46875
Control.SRR15539832;32;38;0.59375;13;19;0.09375;0.40625
Control.SRR15539832;35;38;0.571428571428571;15;20;0.0714285714285714;0.428571428571429
Control.SRR15539832;31;38;0.483870967741935;16;15;0.0161290322580645;0.483870967741935
Control.SRR15539832;31;38;0.483870967741935;16;15;0.0161290322580645;0.483870967741935
Control.SRR15539832;31;38;0.387096774193548;19;12;0.112903225806452;0.387096774193548
Control.SRR15539832;29;38;0.482758620689655;15;14;0.0172413793103448;0.482758620689655
Control.SRR15539832;33;38;0.303030303030303;23;10;0.196969696969697;0.303030303030303
Control.SRR15539832;37;38;0.459459459459459;20;17;0.0405405405405405;0.459459459459459
Control.SRR15539832;35;38;0.514285714285714;17;18;0.0142857142857142;0.485714285714286
Control.SRR15539832;31;38;0.580645161290323;13;18;0.0806451612903226;0.419354838709677
Control.SRR15539832;37;38;0.621621621621622;14;23;0.121621621621622;0.378378378378378
Control.SRR15539832;30;38;0.5;15;15;0;0.5
Control.SRR15539832;31;38;0.451612903225806;17;14;0.0483870967741936;0.451612903225806
Control.SRR15539832;34;38;0.441176470588235;19;15;0.0588235294117647;0.441176470588235
Control.SRR15539832;34;38;0.617647058823529;13;21;0.117647058823529;0.382352941176471
Control.SRR15539832;29;38;0.379310344827586;18;11;0.120689655172414;0.379310344827586
Control.SRR15539832;35;38;0.485714285714286;18;17;0.0142857142857143;0.485714285714286
Control.SRR15539832;29;38;0.586206896551724;12;17;0.0862068965517241;0.413793103448276
Control.SRR15539832;36;38;0.555555555555556;16;20;0.0555555555555556;0.444444444444444
Control.SRR15539832;32;38;0.4375;18;14;0.0625;0.4375
Control.SRR15539832;34;38;0.676470588235294;11;23;0.176470588235294;0.323529411764706
Control.SRR15539832;31;38;0.580645161290323;13;18;0.0806451612903226;0.419354838709677
Control.SRR15539832;31;38;0.516129032258065;15;16;0.0161290322580645;0.483870967741935
Control.SRR15539832;34;38;0.323529411764706;23;11;0.176470588235294;0.323529411764706
Control.SRR15539832;36;38;0.388888888888889;22;14;0.111111111111111;0.388888888888889
Control.SRR15539832;34;38;0.558823529411765;15;19;0.0588235294117647;0.441176470588235
Control.SRR15539832;34;38;0.5;17;17;0;0.5
Control.SRR15539832;33;38;0.606060606060606;13;20;0.106060606060606;0.393939393939394
Control.SRR15539832;34;38;0.352941176470588;22;12;0.147058823529412;0.352941176470588
Control.SRR15539832;32;38;0.53125;15;17;0.03125;0.46875
Control.SRR15539832;37;38;0.459459459459459;20;17;0.0405405405405405;0.459459459459459
Control.SRR15539832;33;38;0.393939393939394;20;13;0.106060606060606;0.393939393939394
Control.SRR15539832;33;38;0.545454545454545;15;18;0.0454545454545454;0.454545454545455
Control.SRR15539832;35;38;0.371428571428571;22;13;0.128571428571429;0.371428571428571
Control.SRR15539832;33;38;0.515151515151515;16;17;0.0151515151515151;0.484848484848485
Control.SRR15539832;32;38;0.25;24;8;0.25;0.25
Control.SRR15539832;37;38;0.405405405405405;22;15;0.0945945945945946;0.405405405405405
Control.SRR15539832;33;38;0.575757575757576;14;19;0.0757575757575758;0.424242424242424
Control.SRR15539832;32;38;0.40625;19;13;0.09375;0.40625
Control.SRR15539832;34;38;0.470588235294118;18;16;0.0294117647058824;0.470588235294118
Control.SRR15539832;32;38;0.59375;13;19;0.09375;0.40625
Control.SRR15539832;35;38;0.4;21;14;0.1;0.4
Control.SRR15539832;29;38;0.448275862068966;16;13;0.0517241379310345;0.448275862068966
Control.SRR15539832;35;38;0.485714285714286;18;17;0.0142857142857143;0.485714285714286
Control.SRR15539832;30;38;0.433333333333333;17;13;0.0666666666666667;0.433333333333333
Control.SRR15539832;33;38;0.636363636363636;12;21;0.136363636363636;0.363636363636364
Control.SRR15539832;34;38;0.382352941176471;21;13;0.117647058823529;0.382352941176471
Control.SRR15539832;44;38;0.431818181818182;25;19;0.0681818181818182;0.431818181818182
Control.SRR15539832;42;38;0.476190476190476;22;20;0.0238095238095238;0.476190476190476
Control.SRR15539832;35;38;0.4;21;14;0.1;0.4
Control.SRR15539832;40;38;0.525;19;21;0.025;0.475
Control.SRR15539832;39;38;0.58974358974359;16;23;0.0897435897435898;0.41025641025641
Control.SRR15539832;43;38;0.581395348837209;18;25;0.0813953488372093;0.418604651162791
Control.SRR15539832;40;38;0.6;16;24;0.1;0.4
Control.SRR15539832;44;38;0.454545454545455;24;20;0.0454545454545455;0.454545454545455
Control.SRR15539832;37;38;0.405405405405405;22;15;0.0945945945945946;0.405405405405405
Control.SRR15539832;34;38;0.558823529411765;15;19;0.0588235294117647;0.441176470588235
Control.SRR15539832;43;38;0.465116279069767;23;20;0.0348837209302326;0.465116279069767
Control.SRR15539832;41;38;0.634146341463415;15;26;0.134146341463415;0.365853658536585
Control.SRR15539832;40;38;0.5;20;20;0;0.5
Control.SRR15539832;38;38;0.552631578947368;17;21;0.0526315789473685;0.447368421052632
Control.SRR15539832;41;38;0.390243902439024;25;16;0.109756097560976;0.390243902439024
Control.SRR15539832;40;38;0.575;17;23;0.075;0.425
Control.SRR15539832;42;38;0.357142857142857;27;15;0.142857142857143;0.357142857142857
Control.SRR15539832;43;38;0.441860465116279;24;19;0.0581395348837209;0.441860465116279
Control.SRR15539832;41;38;0.390243902439024;25;16;0.109756097560976;0.390243902439024
Control.SRR15539832;39;38;0.666666666666667;13;26;0.166666666666667;0.333333333333333
Control.SRR15539832;43;38;0.604651162790698;17;26;0.104651162790698;0.395348837209302
Control.SRR15539832;43;38;0.627906976744186;16;27;0.127906976744186;0.372093023255814
Control.SRR15539832;36;38;0.416666666666667;21;15;0.0833333333333333;0.416666666666667
Control.SRR15539832;36;38;0.416666666666667;21;15;0.0833333333333333;0.416666666666667
Control.SRR15539832;40;38;0.5;20;20;0;0.5
Control.SRR15539832;36;38;0.583333333333333;15;21;0.0833333333333334;0.416666666666667
Control.SRR15539832;36;38;0.472222222222222;19;17;0.0277777777777778;0.472222222222222
Control.SRR15539832;39;38;0.564102564102564;17;22;0.0641025641025641;0.435897435897436
Control.SRR15539832;42;38;0.523809523809524;20;22;0.0238095238095238;0.476190476190476
Control.SRR15539832;43;38;0.674418604651163;14;29;0.174418604651163;0.325581395348837
Control.SRR15539832;40;38;0.45;22;18;0.05;0.45
Control.SRR15539832;36;38;0.5;18;18;0;0.5
Control.SRR15539832;34;38;0.470588235294118;18;16;0.0294117647058824;0.470588235294118
Control.SRR15539832;35;38;0.514285714285714;17;18;0.0142857142857142;0.485714285714286
Control.SRR15539832;39;38;0.461538461538462;21;18;0.0384615384615384;0.461538461538462
Control.SRR15539832;40;38;0.55;18;22;0.05;0.45
Control.SRR15539832;35;38;0.4;21;14;0.1;0.4
Control.SRR15539832;44;38;0.454545454545455;24;20;0.0454545454545455;0.454545454545455
Control.SRR15539832;41;38;0.609756097560976;16;25;0.109756097560976;0.390243902439024
Control.SRR15539832;42;38;0.523809523809524;20;22;0.0238095238095238;0.476190476190476
Control.SRR15539832;43;38;0.604651162790698;17;26;0.104651162790698;0.395348837209302
Control.SRR15539832;44;38;0.386363636363636;27;17;0.113636363636364;0.386363636363636
Control.SRR15539832;40;38;0.55;18;22;0.05;0.45
Control.SRR15539832;40;38;0.525;19;21;0.025;0.475
Control.SRR15539832;35;38;0.571428571428571;15;20;0.0714285714285714;0.428571428571429
Control.SRR15539832;34;38;0.588235294117647;14;20;0.0882352941176471;0.411764705882353
Control.SRR15539832;40;38;0.425;23;17;0.075;0.425
Control.SRR15539832;44;38;0.454545454545455;24;20;0.0454545454545455;0.454545454545455
Control.SRR15539832;39;38;0.512820512820513;19;20;0.0128205128205128;0.487179487179487
Control.SRR15539832;37;38;0.540540540540541;17;20;0.0405405405405406;0.459459459459459
Control.SRR15539832;40;38;0.375;25;15;0.125;0.375
Control.SRR15539832;36;38;0.638888888888889;13;23;0.138888888888889;0.361111111111111
Control.SRR15539832;39;38;0.512820512820513;19;20;0.0128205128205128;0.487179487179487
Control.SRR15539832;44;38;0.522727272727273;21;23;0.0227272727272727;0.477272727272727
Control.SRR15539832;38;38;0.394736842105263;23;15;0.105263157894737;0.394736842105263
Control.SRR15539832;43;38;0.465116279069767;23;20;0.0348837209302326;0.465116279069767
Control.SRR15539832;38;38;0.552631578947368;17;21;0.0526315789473685;0.447368421052632
Control.SRR15539832;34;38;0.558823529411765;15;19;0.0588235294117647;0.441176470588235
Control.SRR15539832;37;38;0.540540540540541;17;20;0.0405405405405406;0.459459459459459
Control.SRR15539832;36;38;0.361111111111111;23;13;0.138888888888889;0.361111111111111
Control.SRR15539832;42;38;0.523809523809524;20;22;0.0238095238095238;0.476190476190476
Control.SRR15539832;42;38;0.571428571428571;18;24;0.0714285714285714;0.428571428571429
Control.SRR15539832;38;38;0.5;19;19;0;0.5
Control.SRR15539832;38;38;0.447368421052632;21;17;0.0526315789473684;0.447368421052632
Control.SRR15539832;40;38;0.55;18;22;0.05;0.45
Control.SRR15539832;39;38;0.538461538461538;18;21;0.0384615384615384;0.461538461538462
Control.SRR15539832;38;38;0.394736842105263;23;15;0.105263157894737;0.394736842105263
Control.SRR15539832;36;38;0.694444444444444;11;25;0.194444444444444;0.305555555555556
Control.SRR15539832;36;38;0.555555555555556;16;20;0.0555555555555556;0.444444444444444
Control.SRR15539832;34;38;0.5;17;17;0;0.5
Control.SRR15539832;37;38;0.486486486486487;19;18;0.0135135135135135;0.486486486486487
Control.SRR15539832;44;38;0.545454545454545;20;24;0.0454545454545454;0.454545454545455
Control.SRR15539832;38;38;0.578947368421053;16;22;0.0789473684210527;0.421052631578947
Control.SRR15539832;35;38;0.371428571428571;22;13;0.128571428571429;0.371428571428571
Control.SRR15539832;35;38;0.457142857142857;19;16;0.0428571428571429;0.457142857142857
Control.SRR15539832;44;38;0.568181818181818;19;25;0.0681818181818182;0.431818181818182
Control.SRR15539832;35;38;0.485714285714286;18;17;0.0142857142857143;0.485714285714286
Control.SRR15539832;38;38;0.526315789473684;18;20;0.0263157894736842;0.473684210526316
Control.SRR15539832;35;38;0.628571428571429;13;22;0.128571428571429;0.371428571428571
Control.SRR15539832;37;38;0.513513513513513;18;19;0.0135135135135135;0.486486486486487
Control.SRR15539832;44;38;0.477272727272727;23;21;0.0227272727272727;0.477272727272727
Control.SRR15539832;41;38;0.439024390243902;23;18;0.0609756097560976;0.439024390243902
Control.SRR15539832;36;38;0.583333333333333;15;21;0.0833333333333334;0.416666666666667
Control.SRR15539832;35;38;0.428571428571429;20;15;0.0714285714285715;0.428571428571429
Control.SRR15539832;35;38;0.542857142857143;16;19;0.0428571428571428;0.457142857142857
Control.SRR15539832;43;38;0.511627906976744;21;22;0.0116279069767442;0.488372093023256
Control.SRR15539832;44;38;0.590909090909091;18;26;0.0909090909090909;0.409090909090909
Control.SRR15539832;44;38;0.318181818181818;30;14;0.181818181818182;0.318181818181818
Control.SRR15539832;38;38;0.5;19;19;0;0.5
Control.SRR15539832;43;38;0.348837209302326;28;15;0.151162790697674;0.348837209302326
Control.SRR15539832;38;38;0.447368421052632;21;17;0.0526315789473684;0.447368421052632
Control.SRR15539832;35;38;0.514285714285714;17;18;0.0142857142857142;0.485714285714286
Control.SRR15539832;35;38;0.4;21;14;0.1;0.4
Control.SRR15539832;35;38;0.542857142857143;16;19;0.0428571428571428;0.457142857142857
Control.SRR15539832;35;38;0.571428571428571;15;20;0.0714285714285714;0.428571428571429
Control.SRR15539832;35;38;0.285714285714286;25;10;0.214285714285714;0.285714285714286
Control.SRR15539832;36;38;0.472222222222222;19;17;0.0277777777777778;0.472222222222222
Control.SRR15539832;38;38;0.447368421052632;21;17;0.0526315789473684;0.447368421052632
Control.SRR15539832;40;38;0.475;21;19;0.025;0.475
Control.SRR15539832;42;38;0.547619047619048;19;23;0.0476190476190477;0.452380952380952
Control.SRR15539832;43;38;0.511627906976744;21;22;0.0116279069767442;0.488372093023256
Control.SRR15539832;36;38;0.583333333333333;15;21;0.0833333333333334;0.416666666666667
Control.SRR15539832;37;38;0.459459459459459;20;17;0.0405405405405405;0.459459459459459
Control.SRR15539832;35;38;0.542857142857143;16;19;0.0428571428571428;0.457142857142857
Control.SRR15539832;34;38;0.588235294117647;14;20;0.0882352941176471;0.411764705882353
Control.SRR15539832;36;38;0.527777777777778;17;19;0.0277777777777778;0.472222222222222
Control.SRR15539832;42;38;0.523809523809524;20;22;0.0238095238095238;0.476190476190476
Control.SRR15539832;41;38;0.439024390243902;23;18;0.0609756097560976;0.439024390243902
Control.SRR15539832;37;38;0.432432432432432;21;16;0.0675675675675675;0.432432432432432
Control.SRR15539832;34;38;0.441176470588235;19;15;0.0588235294117647;0.441176470588235
Control.SRR15539832;34;38;0.5;17;17;0;0.5
Control.SRR15539832;40;38;0.45;22;18;0.05;0.45
Control.SRR15539832;39;38;0.564102564102564;17;22;0.0641025641025641;0.435897435897436
Control.SRR15539832;42;38;0.523809523809524;20;22;0.0238095238095238;0.476190476190476
Control.SRR15539832;37;38;0.324324324324324;25;12;0.175675675675676;0.324324324324324
Control.SRR15539832;37;38;0.432432432432432;21;16;0.0675675675675675;0.432432432432432
Control.SRR15539832;36;38;0.416666666666667;21;15;0.0833333333333333;0.416666666666667
Control.SRR15539832;37;38;0.486486486486487;19;18;0.0135135135135135;0.486486486486487
Control.SRR15539832;38;38;0.552631578947368;17;21;0.0526315789473685;0.447368421052632
Control.SRR15539832;38;38;0.473684210526316;20;18;0.0263157894736842;0.473684210526316
Control.SRR15539832;44;38;0.454545454545455;24;20;0.0454545454545455;0.454545454545455
Control.SRR15539832;36;38;0.5;18;18;0;0.5
Control.SRR15539832;40;38;0.55;18;22;0.05;0.45
Control.SRR15539832;41;38;0.51219512195122;20;21;0.0121951219512195;0.48780487804878
Control.SRR15539832;39;38;0.461538461538462;21;18;0.0384615384615384;0.461538461538462
Control.SRR15539832;41;38;0.51219512195122;20;21;0.0121951219512195;0.48780487804878
Control.SRR15539832;44;38;0.522727272727273;21;23;0.0227272727272727;0.477272727272727
Control.SRR15539832;38;38;0.605263157894737;15;23;0.105263157894737;0.394736842105263
Control.SRR15539832;39;38;0.384615384615385;24;15;0.115384615384615;0.384615384615385
Control.SRR15539832;39;38;0.538461538461538;18;21;0.0384615384615384;0.461538461538462
Control.SRR15539832;39;38;0.384615384615385;24;15;0.115384615384615;0.384615384615385
Control.SRR15539832;36;38;0.583333333333333;15;21;0.0833333333333334;0.416666666666667
Control.SRR15539832;34;38;0.558823529411765;15;19;0.0588235294117647;0.441176470588235
Control.SRR15539832;38;38;0.447368421052632;21;17;0.0526315789473684;0.447368421052632
Control.SRR15539832;39;38;0.538461538461538;18;21;0.0384615384615384;0.461538461538462
Control.SRR15539832;37;38;0.486486486486487;19;18;0.0135135135135135;0.486486486486487
Control.SRR15539832;41;38;0.414634146341463;24;17;0.0853658536585366;0.414634146341463
Control.SRR15539832;35;38;0.628571428571429;13;22;0.128571428571429;0.371428571428571
Control.SRR15539832;41;38;0.51219512195122;20;21;0.0121951219512195;0.48780487804878
Control.SRR15539832;39;38;0.58974358974359;16;23;0.0897435897435898;0.41025641025641
Control.SRR15539832;40;38;0.45;22;18;0.05;0.45
Control.SRR15539832;41;38;0.560975609756098;18;23;0.0609756097560976;0.439024390243902
Control.SRR15539832;40;38;0.525;19;21;0.025;0.475
Control.SRR15539832;43;38;0.441860465116279;24;19;0.0581395348837209;0.441860465116279
Control.SRR15539832;44;38;0.477272727272727;23;21;0.0227272727272727;0.477272727272727
Control.SRR15539832;41;38;0.390243902439024;25;16;0.109756097560976;0.390243902439024
Control.SRR15539832;38;38;0.394736842105263;23;15;0.105263157894737;0.394736842105263
Control.SRR15539832;36;38;0.305555555555556;25;11;0.194444444444444;0.305555555555556
Control.SRR15539832;40;38;0.5;20;20;0;0.5
Control.SRR15539832;40;38;0.425;23;17;0.075;0.425
Control.SRR15539832;38;38;0.447368421052632;21;17;0.0526315789473684;0.447368421052632
Control.SRR15539832;42;38;0.5;21;21;0;0.5
Control.SRR15539832;37;38;0.486486486486487;19;18;0.0135135135135135;0.486486486486487
Control.SRR15539832;34;38;0.352941176470588;22;12;0.147058823529412;0.352941176470588
Control.SRR15539832;36;38;0.611111111111111;14;22;0.111111111111111;0.388888888888889
Control.SRR15539832;44;38;0.454545454545455;24;20;0.0454545454545455;0.454545454545455
Control.SRR15539832;35;38;0.571428571428571;15;20;0.0714285714285714;0.428571428571429
Control.SRR15539832;35;38;0.4;21;14;0.1;0.4
Control.SRR15539832;34;38;0.5;17;17;0;0.5
Control.SRR15539832;35;38;0.485714285714286;18;17;0.0142857142857143;0.485714285714286
Control.SRR15539832;37;38;0.405405405405405;22;15;0.0945945945945946;0.405405405405405
Control.SRR15539832;36;38;0.555555555555556;16;20;0.0555555555555556;0.444444444444444
Control.SRR15539832;37;38;0.432432432432432;21;16;0.0675675675675675;0.432432432432432
Control.SRR15539832;37;38;0.567567567567568;16;21;0.0675675675675675;0.432432432432432
Control.SRR15539832;34;38;0.470588235294118;18;16;0.0294117647058824;0.470588235294118
Control.SRR15539832;37;38;0.540540540540541;17;20;0.0405405405405406;0.459459459459459
Control.SRR15539832;37;38;0.378378378378378;23;14;0.121621621621622;0.378378378378378
Control.SRR15539832;41;38;0.634146341463415;15;26;0.134146341463415;0.365853658536585
Control.SRR15539832;42;38;0.452380952380952;23;19;0.0476190476190476;0.452380952380952
Control.SRR15539832;39;38;0.538461538461538;18;21;0.0384615384615384;0.461538461538462
Control.SRR15539832;36;38;0.388888888888889;22;14;0.111111111111111;0.388888888888889
Control.SRR15539832;34;38;0.382352941176471;21;13;0.117647058823529;0.382352941176471
Control.SRR15539832;38;38;0.605263157894737;15;23;0.105263157894737;0.394736842105263
Control.SRR15539832;38;38;0.552631578947368;17;21;0.0526315789473685;0.447368421052632
Control.SRR15539832;41;38;0.51219512195122;20;21;0.0121951219512195;0.48780487804878
Control.SRR15539832;37;38;0.540540540540541;17;20;0.0405405405405406;0.459459459459459
Control.SRR15539832;35;38;0.514285714285714;17;18;0.0142857142857142;0.485714285714286
Control.SRR15539832;42;38;0.452380952380952;23;19;0.0476190476190476;0.452380952380952
Control.SRR15539832;43;38;0.488372093023256;22;21;0.0116279069767442;0.488372093023256
Control.SRR15539832;41;38;0.439024390243902;23;18;0.0609756097560976;0.439024390243902
Control.SRR15539832;39;38;0.512820512820513;19;20;0.0128205128205128;0.487179487179487
Control.SRR15539832;39;38;0.564102564102564;17;22;0.0641025641025641;0.435897435897436
Control.SRR15539832;35;38;0.428571428571429;20;15;0.0714285714285715;0.428571428571429
Control.SRR15539832;34;38;0.558823529411765;15;19;0.0588235294117647;0.441176470588235
Control.SRR15539832;42;38;0.523809523809524;20;22;0.0238095238095238;0.476190476190476
Control.SRR15539832;34;38;0.558823529411765;15;19;0.0588235294117647;0.441176470588235
Control.SRR15539832;36;38;0.416666666666667;21;15;0.0833333333333333;0.416666666666667
Control.SRR15539832;38;38;0.421052631578947;22;16;0.0789473684210527;0.421052631578947
Control.SRR15539832;43;38;0.627906976744186;16;27;0.127906976744186;0.372093023255814
Control.SRR15539832;41;38;0.609756097560976;16;25;0.109756097560976;0.390243902439024
Control.SRR15539832;40;38;0.6;16;24;0.1;0.4
Control.SRR15539832;37;38;0.567567567567568;16;21;0.0675675675675675;0.432432432432432
Control.SRR15539832;37;38;0.594594594594595;15;22;0.0945945945945946;0.405405405405405
Control.SRR15539832;44;38;0.454545454545455;24;20;0.0454545454545455;0.454545454545455
Control.SRR15539832;37;38;0.432432432432432;21;16;0.0675675675675675;0.432432432432432
Control.SRR15539832;40;38;0.525;19;21;0.025;0.475
Control.SRR15539832;39;38;0.538461538461538;18;21;0.0384615384615384;0.461538461538462
Control.SRR15539832;35;38;0.485714285714286;18;17;0.0142857142857143;0.485714285714286
Control.SRR15539832;42;38;0.571428571428571;18;24;0.0714285714285714;0.428571428571429
Control.SRR15539832;37;38;0.459459459459459;20;17;0.0405405405405405;0.459459459459459
Control.SRR15539832;36;38;0.444444444444444;20;16;0.0555555555555556;0.444444444444444
Control.SRR15539832;36;38;0.5;18;18;0;0.5
Control.SRR15539832;44;38;0.477272727272727;23;21;0.0227272727272727;0.477272727272727
Control.SRR15539832;44;38;0.568181818181818;19;25;0.0681818181818182;0.431818181818182
Control.SRR15539832;36;38;0.527777777777778;17;19;0.0277777777777778;0.472222222222222
Control.SRR15539832;42;38;0.571428571428571;18;24;0.0714285714285714;0.428571428571429
Control.SRR15539832;36;38;0.527777777777778;17;19;0.0277777777777778;0.472222222222222
Control.SRR15539832;38;38;0.605263157894737;15;23;0.105263157894737;0.394736842105263
Control.SRR15539832;38;38;0.394736842105263;23;15;0.105263157894737;0.394736842105263
Control.SRR15539832;44;38;0.568181818181818;19;25;0.0681818181818182;0.431818181818182
Control.SRR15539832;39;38;0.41025641025641;23;16;0.0897435897435898;0.41025641025641
Control.SRR15539832;34;38;0.617647058823529;13;21;0.117647058823529;0.382352941176471
Control.SRR15539832;38;38;0.5;19;19;0;0.5
Control.SRR15539832;36;38;0.5;18;18;0;0.5
Control.SRR15539832;41;38;0.536585365853659;19;22;0.0365853658536586;0.463414634146341
Control.SRR15539832;41;38;0.560975609756098;18;23;0.0609756097560976;0.439024390243902
Control.SRR15539832;37;38;0.540540540540541;17;20;0.0405405405405406;0.459459459459459
Control.SRR15539832;42;38;0.523809523809524;20;22;0.0238095238095238;0.476190476190476
Control.SRR15539832;44;38;0.363636363636364;28;16;0.136363636363636;0.363636363636364
Control.SRR15539832;38;38;0.447368421052632;21;17;0.0526315789473684;0.447368421052632
Control.SRR15539832;40;38;0.5;20;20;0;0.5
Control.SRR15539832;42;38;0.69047619047619;13;29;0.19047619047619;0.30952380952381
Control.SRR15539832;42;38;0.452380952380952;23;19;0.0476190476190476;0.452380952380952
Control.SRR15539832;43;38;0.441860465116279;24;19;0.0581395348837209;0.441860465116279
Control.SRR15539832;39;38;0.512820512820513;19;20;0.0128205128205128;0.487179487179487
Control.SRR15539832;41;38;0.365853658536585;26;15;0.134146341463415;0.365853658536585
Control.SRR15539832;36;38;0.5;18;18;0;0.5
Control.SRR15539832;34;38;0.441176470588235;19;15;0.0588235294117647;0.441176470588235
Control.SRR15539832;38;38;0.447368421052632;21;17;0.0526315789473684;0.447368421052632
Control.SRR15539832;34;38;0.529411764705882;16;18;0.0294117647058824;0.470588235294118
Control.SRR15539832;43;38;0.441860465116279;24;19;0.0581395348837209;0.441860465116279
Control.SRR15539832;38;38;0.394736842105263;23;15;0.105263157894737;0.394736842105263
Control.SRR15539832;40;38;0.525;19;21;0.025;0.475
Control.SRR15539832;40;38;0.525;19;21;0.025;0.475
Control.SRR15539832;34;38;0.5;17;17;0;0.5
Control.SRR15539832;36;38;0.416666666666667;21;15;0.0833333333333333;0.416666666666667
Control.SRR15539832;34;38;0.441176470588235;19;15;0.0588235294117647;0.441176470588235
Control.SRR15539832;34;38;0.411764705882353;20;14;0.0882352941176471;0.411764705882353
Control.SRR15539832;37;38;0.513513513513513;18;19;0.0135135135135135;0.486486486486487
Control.SRR15539832;38;38;0.289473684210526;27;11;0.210526315789474;0.289473684210526
Control.SRR15539832;43;38;0.511627906976744;21;22;0.0116279069767442;0.488372093023256
Control.SRR15539832;39;38;0.41025641025641;23;16;0.0897435897435898;0.41025641025641
Control.SRR15539832;39;38;0.538461538461538;18;21;0.0384615384615384;0.461538461538462
Control.SRR15539832;36;38;0.555555555555556;16;20;0.0555555555555556;0.444444444444444
Control.SRR15539832;40;38;0.45;22;18;0.05;0.45
Control.SRR15539832;36;38;0.472222222222222;19;17;0.0277777777777778;0.472222222222222
Control.SRR15539832;42;38;0.404761904761905;25;17;0.0952380952380952;0.404761904761905
Control.SRR15539832;40;38;0.625;15;25;0.125;0.375
Control.SRR15539832;42;38;0.404761904761905;25;17;0.0952380952380952;0.404761904761905
Control.SRR15539832;34;38;0.441176470588235;19;15;0.0588235294117647;0.441176470588235
Control.SRR15539832;40;38;0.375;25;15;0.125;0.375
Control.SRR15539832;42;38;0.476190476190476;22;20;0.0238095238095238;0.476190476190476
Control.SRR15539832;34;38;0.617647058823529;13;21;0.117647058823529;0.382352941176471
Control.SRR15539832;37;38;0.378378378378378;23;14;0.121621621621622;0.378378378378378
Control.SRR15539832;36;38;0.444444444444444;20;16;0.0555555555555556;0.444444444444444
Control.SRR15539832;34;38;0.470588235294118;18;16;0.0294117647058824;0.470588235294118
Control.SRR15539832;39;38;0.564102564102564;17;22;0.0641025641025641;0.435897435897436
Control.SRR15539832;37;38;0.513513513513513;18;19;0.0135135135135135;0.486486486486487
Control.SRR15539832;34;38;0.382352941176471;21;13;0.117647058823529;0.382352941176471
Control.SRR15539832;37;38;0.513513513513513;18;19;0.0135135135135135;0.486486486486487
Control.SRR15539832;43;38;0.395348837209302;26;17;0.104651162790698;0.395348837209302
Control.SRR15539832;43;38;0.558139534883721;19;24;0.0581395348837209;0.441860465116279
Control.SRR15539832;34;38;0.5;17;17;0;0.5
Control.SRR15539832;35;38;0.657142857142857;12;23;0.157142857142857;0.342857142857143
Control.SRR15539832;39;38;0.384615384615385;24;15;0.115384615384615;0.384615384615385
Control.SRR15539832;35;38;0.628571428571429;13;22;0.128571428571429;0.371428571428571
Control.SRR15539832;34;38;0.558823529411765;15;19;0.0588235294117647;0.441176470588235
Control.SRR15539832;34;38;0.529411764705882;16;18;0.0294117647058824;0.470588235294118
Control.SRR15539832;38;38;0.5;19;19;0;0.5
Control.SRR15539832;37;38;0.405405405405405;22;15;0.0945945945945946;0.405405405405405
Control.SRR15539832;34;38;0.411764705882353;20;14;0.0882352941176471;0.411764705882353
Control.SRR15539832;37;38;0.405405405405405;22;15;0.0945945945945946;0.405405405405405
Control.SRR15539832;44;38;0.522727272727273;21;23;0.0227272727272727;0.477272727272727
Control.SRR15539832;34;38;0.441176470588235;19;15;0.0588235294117647;0.441176470588235
Control.SRR15539832;43;38;0.581395348837209;18;25;0.0813953488372093;0.418604651162791
Control.SRR15539832;36;38;0.472222222222222;19;17;0.0277777777777778;0.472222222222222
Control.SRR15539832;40;38;0.5;20;20;0;0.5
Control.SRR15539832;42;38;0.666666666666667;14;28;0.166666666666667;0.333333333333333
Control.SRR15539832;36;38;0.444444444444444;20;16;0.0555555555555556;0.444444444444444
Control.SRR15539832;42;38;0.333333333333333;28;14;0.166666666666667;0.333333333333333
Control.SRR15539832;39;38;0.41025641025641;23;16;0.0897435897435898;0.41025641025641
Control.SRR15539832;41;38;0.560975609756098;18;23;0.0609756097560976;0.439024390243902
Control.SRR15539832;35;38;0.628571428571429;13;22;0.128571428571429;0.371428571428571
Control.SRR15539832;37;38;0.486486486486487;19;18;0.0135135135135135;0.486486486486487
Control.SRR15539832;36;38;0.444444444444444;20;16;0.0555555555555556;0.444444444444444
Control.SRR15539832;41;38;0.560975609756098;18;23;0.0609756097560976;0.439024390243902
Control.SRR15539832;43;38;0.465116279069767;23;20;0.0348837209302326;0.465116279069767
Control.SRR15539832;38;38;0.342105263157895;25;13;0.157894736842105;0.342105263157895
Control.SRR15539832;37;38;0.567567567567568;16;21;0.0675675675675675;0.432432432432432
Control.SRR15539832;34;38;0.441176470588235;19;15;0.0588235294117647;0.441176470588235
Control.SRR15539832;40;38;0.325;27;13;0.175;0.325
Control.SRR15539832;36;38;0.555555555555556;16;20;0.0555555555555556;0.444444444444444
Control.SRR15539832;42;38;0.547619047619048;19;23;0.0476190476190477;0.452380952380952
Control.SRR15539832;35;38;0.457142857142857;19;16;0.0428571428571429;0.457142857142857
Control.SRR15539832;38;38;0.552631578947368;17;21;0.0526315789473685;0.447368421052632
Control.SRR15539832;39;38;0.487179487179487;20;19;0.0128205128205128;0.487179487179487
Control.SRR15539832;38;38;0.605263157894737;15;23;0.105263157894737;0.394736842105263
Control.SRR15539832;43;38;0.465116279069767;23;20;0.0348837209302326;0.465116279069767
Control.SRR15539832;39;38;0.564102564102564;17;22;0.0641025641025641;0.435897435897436
Control.SRR15539832;42;38;0.571428571428571;18;24;0.0714285714285714;0.428571428571429
Control.SRR15539832;36;38;0.527777777777778;17;19;0.0277777777777778;0.472222222222222
Control.SRR15539832;44;38;0.659090909090909;15;29;0.159090909090909;0.340909090909091
Control.SRR15539832;40;38;0.475;21;19;0.025;0.475
Control.SRR15539832;44;38;0.636363636363636;16;28;0.136363636363636;0.363636363636364
Control.SRR15539832;40;38;0.475;21;19;0.025;0.475
Control.SRR15539832;40;38;0.575;17;23;0.075;0.425
Control.SRR15539832;40;38;0.375;25;15;0.125;0.375
Control.SRR15539832;43;38;0.534883720930233;20;23;0.0348837209302325;0.465116279069767
Control.SRR15539832;41;38;0.463414634146341;22;19;0.0365853658536585;0.463414634146341
Control.SRR15539832;37;38;0.459459459459459;20;17;0.0405405405405405;0.459459459459459
Control.SRR15539832;42;38;0.547619047619048;19;23;0.0476190476190477;0.452380952380952
Control.SRR15539832;34;38;0.529411764705882;16;18;0.0294117647058824;0.470588235294118
Control.SRR15539832;34;38;0.441176470588235;19;15;0.0588235294117647;0.441176470588235
Control.SRR15539832;42;38;0.452380952380952;23;19;0.0476190476190476;0.452380952380952
Control.SRR15539832;43;38;0.674418604651163;14;29;0.174418604651163;0.325581395348837
Control.SRR15539832;40;38;0.525;19;21;0.025;0.475
Control.SRR15539832;35;38;0.485714285714286;18;17;0.0142857142857143;0.485714285714286
Control.SRR15539832;42;38;0.547619047619048;19;23;0.0476190476190477;0.452380952380952
Control.SRR15539832;43;38;0.441860465116279;24;19;0.0581395348837209;0.441860465116279
Control.SRR15539832;38;38;0.526315789473684;18;20;0.0263157894736842;0.473684210526316
Control.SRR15539832;36;38;0.416666666666667;21;15;0.0833333333333333;0.416666666666667
Control.SRR15539832;35;38;0.514285714285714;17;18;0.0142857142857142;0.485714285714286
Control.SRR15539832;38;38;0.473684210526316;20;18;0.0263157894736842;0.473684210526316
Control.SRR15539832;41;38;0.51219512195122;20;21;0.0121951219512195;0.48780487804878
Control.SRR15539832;38;38;0.394736842105263;23;15;0.105263157894737;0.394736842105263
Control.SRR15539832;37;38;0.486486486486487;19;18;0.0135135135135135;0.486486486486487
Control.SRR15539832;37;38;0.486486486486487;19;18;0.0135135135135135;0.486486486486487
Control.SRR15539832;40;38;0.425;23;17;0.075;0.425
Control.SRR15539832;44;38;0.545454545454545;20;24;0.0454545454545454;0.454545454545455
Control.SRR15539832;42;38;0.428571428571429;24;18;0.0714285714285715;0.428571428571429
Control.SRR15539832;35;38;0.571428571428571;15;20;0.0714285714285714;0.428571428571429
Control.SRR15539832;40;38;0.475;21;19;0.025;0.475
Control.SRR15539832;40;38;0.7;12;28;0.2;0.3
Control.SRR15539832;40;38;0.425;23;17;0.075;0.425
Control.SRR15539832;34;38;0.411764705882353;20;14;0.0882352941176471;0.411764705882353
Control.SRR15539832;35;38;0.542857142857143;16;19;0.0428571428571428;0.457142857142857
Control.SRR15539832;41;38;0.585365853658537;17;24;0.0853658536585366;0.414634146341463
Control.SRR15539832;38;38;0.578947368421053;16;22;0.0789473684210527;0.421052631578947
Control.SRR15539832;40;38;0.6;16;24;0.1;0.4
Control.SRR15539832;40;38;0.475;21;19;0.025;0.475
Control.SRR15539832;39;38;0.461538461538462;21;18;0.0384615384615384;0.461538461538462
Control.SRR15539832;38;38;0.473684210526316;20;18;0.0263157894736842;0.473684210526316
Control.SRR15539832;35;38;0.371428571428571;22;13;0.128571428571429;0.371428571428571
Control.SRR15539832;43;38;0.441860465116279;24;19;0.0581395348837209;0.441860465116279
Control.SRR15539832;41;38;0.536585365853659;19;22;0.0365853658536586;0.463414634146341
Control.SRR15539832;37;38;0.378378378378378;23;14;0.121621621621622;0.378378378378378
Control.SRR15539832;38;38;0.473684210526316;20;18;0.0263157894736842;0.473684210526316
Control.SRR15539832;34;38;0.382352941176471;21;13;0.117647058823529;0.382352941176471
Control.SRR15539832;35;38;0.428571428571429;20;15;0.0714285714285715;0.428571428571429
Control.SRR15539832;37;38;0.432432432432432;21;16;0.0675675675675675;0.432432432432432
Control.SRR15539832;44;38;0.545454545454545;20;24;0.0454545454545454;0.454545454545455
Control.SRR15539832;38;38;0.710526315789474;11;27;0.210526315789474;0.289473684210526
Control.SRR15539832;39;38;0.487179487179487;20;19;0.0128205128205128;0.487179487179487
Control.SRR15539832;42;38;0.547619047619048;19;23;0.0476190476190477;0.452380952380952
Control.SRR15539832;35;38;0.6;14;21;0.1;0.4
Control.SRR15539832;40;38;0.6;16;24;0.1;0.4
Control.SRR15539832;43;38;0.418604651162791;25;18;0.0813953488372093;0.418604651162791
Control.SRR15539832;41;38;0.48780487804878;21;20;0.0121951219512195;0.48780487804878
Control.SRR15539832;38;38;0.473684210526316;20;18;0.0263157894736842;0.473684210526316
Control.SRR15539832;34;38;0.470588235294118;18;16;0.0294117647058824;0.470588235294118
Control.SRR15539832;36;38;0.583333333333333;15;21;0.0833333333333334;0.416666666666667
Control.SRR15539832;44;38;0.545454545454545;20;24;0.0454545454545454;0.454545454545455
Control.SRR15539832;44;38;0.681818181818182;14;30;0.181818181818182;0.318181818181818
Control.SRR15539832;44;38;0.454545454545455;24;20;0.0454545454545455;0.454545454545455
Control.SRR15539832;35;38;0.6;14;21;0.1;0.4
Control.SRR15539832;35;38;0.542857142857143;16;19;0.0428571428571428;0.457142857142857
Control.SRR15539832;34;38;0.5;17;17;0;0.5
Control.SRR15539832;44;38;0.568181818181818;19;25;0.0681818181818182;0.431818181818182
Control.SRR15539832;40;38;0.425;23;17;0.075;0.425
Control.SRR15539832;39;38;0.538461538461538;18;21;0.0384615384615384;0.461538461538462
Control.SRR15539832;43;38;0.418604651162791;25;18;0.0813953488372093;0.418604651162791
Control.SRR15539832;34;38;0.470588235294118;18;16;0.0294117647058824;0.470588235294118
Control.SRR15539832;34;38;0.529411764705882;16;18;0.0294117647058824;0.470588235294118
Control.SRR15539832;38;38;0.447368421052632;21;17;0.0526315789473684;0.447368421052632
Control.SRR15539832;38;38;0.5;19;19;0;0.5
Control.SRR15539832;41;38;0.536585365853659;19;22;0.0365853658536586;0.463414634146341
Control.SRR15539832;43;38;0.418604651162791;25;18;0.0813953488372093;0.418604651162791
Control.SRR15539832;44;38;0.522727272727273;21;23;0.0227272727272727;0.477272727272727
Control.SRR15539832;39;38;0.435897435897436;22;17;0.0641025641025641;0.435897435897436
Control.SRR15539832;38;38;0.552631578947368;17;21;0.0526315789473685;0.447368421052632
Control.SRR15539832;41;38;0.48780487804878;21;20;0.0121951219512195;0.48780487804878
Control.SRR15539832;38;38;0.526315789473684;18;20;0.0263157894736842;0.473684210526316
Control.SRR15539832;39;38;0.58974358974359;16;23;0.0897435897435898;0.41025641025641
Control.SRR15539832;43;38;0.488372093023256;22;21;0.0116279069767442;0.488372093023256
Control.SRR15539832;42;38;0.380952380952381;26;16;0.119047619047619;0.380952380952381
Control.SRR15539832;37;38;0.540540540540541;17;20;0.0405405405405406;0.459459459459459
Control.SRR15539832;34;38;0.5;17;17;0;0.5
Control.SRR15539832;37;38;0.621621621621622;14;23;0.121621621621622;0.378378378378378
Control.SRR15539832;37;38;0.378378378378378;23;14;0.121621621621622;0.378378378378378
Control.SRR15539832;34;38;0.617647058823529;13;21;0.117647058823529;0.382352941176471
Control.SRR15539832;37;38;0.540540540540541;17;20;0.0405405405405406;0.459459459459459
Control.SRR15539832;38;38;0.552631578947368;17;21;0.0526315789473685;0.447368421052632
Control.SRR15539832;36;38;0.527777777777778;17;19;0.0277777777777778;0.472222222222222
Control.SRR15539832;40;38;0.55;18;22;0.05;0.45
Control.SRR15539832;39;38;0.487179487179487;20;19;0.0128205128205128;0.487179487179487
Control.SRR15539832;36;38;0.583333333333333;15;21;0.0833333333333334;0.416666666666667
Control.SRR15539832;38;38;0.605263157894737;15;23;0.105263157894737;0.394736842105263
Control.SRR15539832;37;38;0.324324324324324;25;12;0.175675675675676;0.324324324324324
Control.SRR15539832;43;38;0.418604651162791;25;18;0.0813953488372093;0.418604651162791
Control.SRR15539832;38;38;0.552631578947368;17;21;0.0526315789473685;0.447368421052632
Control.SRR15539832;41;38;0.51219512195122;20;21;0.0121951219512195;0.48780487804878
Control.SRR15539832;35;38;0.571428571428571;15;20;0.0714285714285714;0.428571428571429
Control.SRR15539832;35;38;0.457142857142857;19;16;0.0428571428571429;0.457142857142857
Control.SRR15539832;41;38;0.439024390243902;23;18;0.0609756097560976;0.439024390243902
Control.SRR15539832;38;38;0.552631578947368;17;21;0.0526315789473685;0.447368421052632
Control.SRR15539832;37;38;0.432432432432432;21;16;0.0675675675675675;0.432432432432432
Control.SRR15539832;43;38;0.465116279069767;23;20;0.0348837209302326;0.465116279069767
Control.SRR15539832;42;38;0.404761904761905;25;17;0.0952380952380952;0.404761904761905
Control.SRR15539832;43;38;0.534883720930233;20;23;0.0348837209302325;0.465116279069767
Control.SRR15539832;34;38;0.470588235294118;18;16;0.0294117647058824;0.470588235294118
Control.SRR15539832;44;38;0.568181818181818;19;25;0.0681818181818182;0.431818181818182
Control.SRR15539832;36;38;0.666666666666667;12;24;0.166666666666667;0.333333333333333
Control.SRR15539832;41;38;0.585365853658537;17;24;0.0853658536585366;0.414634146341463
Control.SRR15539832;44;38;0.5;22;22;0;0.5
Control.SRR15539832;35;38;0.542857142857143;16;19;0.0428571428571428;0.457142857142857
Control.SRR15539832;37;38;0.432432432432432;21;16;0.0675675675675675;0.432432432432432
Control.SRR15539832;37;38;0.324324324324324;25;12;0.175675675675676;0.324324324324324
Control.SRR15539832;39;38;0.487179487179487;20;19;0.0128205128205128;0.487179487179487
Control.SRR15539832;38;38;0.5;19;19;0;0.5
Control.SRR15539832;39;38;0.41025641025641;23;16;0.0897435897435898;0.41025641025641
Control.SRR15539832;42;38;0.452380952380952;23;19;0.0476190476190476;0.452380952380952
Control.SRR15539832;43;38;0.395348837209302;26;17;0.104651162790698;0.395348837209302
Control.SRR15539832;38;38;0.394736842105263;23;15;0.105263157894737;0.394736842105263
Control.SRR15539832;42;38;0.547619047619048;19;23;0.0476190476190477;0.452380952380952
Control.SRR15539832;43;38;0.441860465116279;24;19;0.0581395348837209;0.441860465116279
Control.SRR15539832;37;38;0.513513513513513;18;19;0.0135135135135135;0.486486486486487
Control.SRR15539832;42;38;0.476190476190476;22;20;0.0238095238095238;0.476190476190476
Control.SRR15539832;40;38;0.525;19;21;0.025;0.475
Control.SRR15539832;39;38;0.461538461538462;21;18;0.0384615384615384;0.461538461538462
Control.SRR15539832;40;38;0.4;24;16;0.1;0.4
Control.SRR15539832;42;38;0.380952380952381;26;16;0.119047619047619;0.380952380952381
Control.SRR15539832;39;38;0.666666666666667;13;26;0.166666666666667;0.333333333333333
Control.SRR15539832;34;38;0.470588235294118;18;16;0.0294117647058824;0.470588235294118
Control.SRR15539832;38;38;0.5;19;19;0;0.5
Control.SRR15539832;36;38;0.416666666666667;21;15;0.0833333333333333;0.416666666666667
Control.SRR15539832;37;38;0.540540540540541;17;20;0.0405405405405406;0.459459459459459
Control.SRR15539832;41;38;0.463414634146341;22;19;0.0365853658536585;0.463414634146341
Control.SRR15539832;35;38;0.428571428571429;20;15;0.0714285714285715;0.428571428571429
Control.SRR15539832;35;38;0.485714285714286;18;17;0.0142857142857143;0.485714285714286
Control.SRR15539832;34;38;0.441176470588235;19;15;0.0588235294117647;0.441176470588235
Control.SRR15539832;37;38;0.594594594594595;15;22;0.0945945945945946;0.405405405405405
Control.SRR15539832;39;38;0.487179487179487;20;19;0.0128205128205128;0.487179487179487
Control.SRR15539832;39;38;0.564102564102564;17;22;0.0641025641025641;0.435897435897436
Control.SRR15539832;43;38;0.511627906976744;21;22;0.0116279069767442;0.488372093023256
Control.SRR15539832;34;38;0.441176470588235;19;15;0.0588235294117647;0.441176470588235
Control.SRR15539832;34;38;0.558823529411765;15;19;0.0588235294117647;0.441176470588235
Control.SRR15539832;38;38;0.421052631578947;22;16;0.0789473684210527;0.421052631578947
Control.SRR15539832;41;38;0.390243902439024;25;16;0.109756097560976;0.390243902439024
Control.SRR15539832;40;38;0.4;24;16;0.1;0.4
Control.SRR15539832;42;38;0.619047619047619;16;26;0.119047619047619;0.380952380952381
Control.SRR15539832;39;38;0.692307692307692;12;27;0.192307692307692;0.307692307692308
Control.SRR15539832;36;38;0.527777777777778;17;19;0.0277777777777778;0.472222222222222
Control.SRR15539832;36;38;0.388888888888889;22;14;0.111111111111111;0.388888888888889
Control.SRR15539832;34;38;0.529411764705882;16;18;0.0294117647058824;0.470588235294118
Control.SRR15539832;34;38;0.382352941176471;21;13;0.117647058823529;0.382352941176471
Control.SRR15539832;42;38;0.595238095238095;17;25;0.0952380952380952;0.404761904761905
Control.SRR15539832;36;38;0.472222222222222;19;17;0.0277777777777778;0.472222222222222
Control.SRR15539832;38;38;0.394736842105263;23;15;0.105263157894737;0.394736842105263
Control.SRR15539832;37;38;0.567567567567568;16;21;0.0675675675675675;0.432432432432432
Control.SRR15539832;43;38;0.465116279069767;23;20;0.0348837209302326;0.465116279069767
Control.SRR15539832;40;38;0.5;20;20;0;0.5
Control.SRR15539832;35;38;0.428571428571429;20;15;0.0714285714285715;0.428571428571429
Control.SRR15539832;41;38;0.51219512195122;20;21;0.0121951219512195;0.48780487804878
Control.SRR15539832;42;38;0.476190476190476;22;20;0.0238095238095238;0.476190476190476
Control.SRR15539832;35;38;0.514285714285714;17;18;0.0142857142857142;0.485714285714286
Control.SRR15539832;35;38;0.485714285714286;18;17;0.0142857142857143;0.485714285714286
Control.SRR15539832;38;38;0.526315789473684;18;20;0.0263157894736842;0.473684210526316
Control.SRR15539832;43;38;0.534883720930233;20;23;0.0348837209302325;0.465116279069767
Control.SRR15539832;43;38;0.395348837209302;26;17;0.104651162790698;0.395348837209302
Control.SRR15539832;36;38;0.5;18;18;0;0.5
Control.SRR15539832;40;38;0.6;16;24;0.1;0.4
Control.SRR15539832;37;38;0.513513513513513;18;19;0.0135135135135135;0.486486486486487
Control.SRR15539832;35;38;0.571428571428571;15;20;0.0714285714285714;0.428571428571429
Control.SRR15539832;43;38;0.348837209302326;28;15;0.151162790697674;0.348837209302326
Control.SRR15539832;28;38;0.5;14;14;0;0.5
Control.SRR15539832;35;38;0.4;21;14;0.1;0.4
Control.SRR15539832;34;38;0.470588235294118;18;16;0.0294117647058824;0.470588235294118
Control.SRR15539832;36;38;0.361111111111111;23;13;0.138888888888889;0.361111111111111
Control.SRR15539832;33;38;0.606060606060606;13;20;0.106060606060606;0.393939393939394
Control.SRR15539832;34;38;0.647058823529412;12;22;0.147058823529412;0.352941176470588
Control.SRR15539832;37;38;0.594594594594595;15;22;0.0945945945945946;0.405405405405405
Control.SRR15539832;35;38;0.457142857142857;19;16;0.0428571428571429;0.457142857142857
Control.SRR15539832;31;38;0.451612903225806;17;14;0.0483870967741936;0.451612903225806
Control.SRR15539832;37;38;0.594594594594595;15;22;0.0945945945945946;0.405405405405405
Control.SRR15539832;35;38;0.514285714285714;17;18;0.0142857142857142;0.485714285714286
Control.SRR15539832;28;38;0.571428571428571;12;16;0.0714285714285714;0.428571428571429
Control.SRR15539832;32;38;0.5;16;16;0;0.5
Control.SRR15539832;36;38;0.527777777777778;17;19;0.0277777777777778;0.472222222222222
Control.SRR15539832;30;38;0.5;15;15;0;0.5
Control.SRR15539832;29;38;0.482758620689655;15;14;0.0172413793103448;0.482758620689655
Control.SRR15539832;35;38;0.371428571428571;22;13;0.128571428571429;0.371428571428571
Control.SRR15539832;28;38;0.5;14;14;0;0.5
Control.SRR15539832;34;38;0.588235294117647;14;20;0.0882352941176471;0.411764705882353
Control.SRR15539832;36;38;0.5;18;18;0;0.5
Control.SRR15539832;29;38;0.448275862068966;16;13;0.0517241379310345;0.448275862068966
Control.SRR15539832;34;38;0.352941176470588;22;12;0.147058823529412;0.352941176470588
Control.SRR15539832;28;38;0.464285714285714;15;13;0.0357142857142857;0.464285714285714
Control.SRR15539832;31;38;0.451612903225806;17;14;0.0483870967741936;0.451612903225806
Control.SRR15539832;33;38;0.424242424242424;19;14;0.0757575757575757;0.424242424242424
Control.SRR15539832;36;38;0.611111111111111;14;22;0.111111111111111;0.388888888888889
Control.SRR15539832;32;38;0.3125;22;10;0.1875;0.3125
Control.SRR15539832;30;38;0.633333333333333;11;19;0.133333333333333;0.366666666666667
Control.SRR15539832;28;38;0.535714285714286;13;15;0.0357142857142857;0.464285714285714
Control.SRR15539832;37;38;0.567567567567568;16;21;0.0675675675675675;0.432432432432432
Control.SRR15539832;28;38;0.714285714285714;8;20;0.214285714285714;0.285714285714286
Control.SRR15539832;34;38;0.558823529411765;15;19;0.0588235294117647;0.441176470588235
Control.SRR15539832;30;38;0.466666666666667;16;14;0.0333333333333333;0.466666666666667
Control.SRR15539832;31;38;0.483870967741935;16;15;0.0161290322580645;0.483870967741935
Control.SRR15539832;28;38;0.535714285714286;13;15;0.0357142857142857;0.464285714285714
Control.SRR15539832;31;38;0.451612903225806;17;14;0.0483870967741936;0.451612903225806
Control.SRR15539832;33;38;0.515151515151515;16;17;0.0151515151515151;0.484848484848485
Control.SRR15539832;29;38;0.413793103448276;17;12;0.0862068965517241;0.413793103448276
Control.SRR15539832;30;38;0.533333333333333;14;16;0.0333333333333333;0.466666666666667
Control.SRR15539832;32;38;0.53125;15;17;0.03125;0.46875
Control.SRR15539832;32;38;0.59375;13;19;0.09375;0.40625
Control.SRR15539832;32;38;0.5;16;16;0;0.5
Control.SRR15539832;28;38;0.5;14;14;0;0.5
Control.SRR15539832;31;38;0.419354838709677;18;13;0.0806451612903226;0.419354838709677
Control.SRR15539832;30;38;0.5;15;15;0;0.5
Control.SRR15539832;37;38;0.621621621621622;14;23;0.121621621621622;0.378378378378378
Control.SRR15539832;35;38;0.571428571428571;15;20;0.0714285714285714;0.428571428571429
Control.SRR15539832;37;38;0.540540540540541;17;20;0.0405405405405406;0.459459459459459
Control.SRR15539832;36;38;0.722222222222222;10;26;0.222222222222222;0.277777777777778
Control.SRR15539832;32;38;0.46875;17;15;0.03125;0.46875
Control.SRR15539832;35;38;0.657142857142857;12;23;0.157142857142857;0.342857142857143
Control.SRR15539832;35;38;0.6;14;21;0.1;0.4
Control.SRR15539832;32;38;0.5625;14;18;0.0625;0.4375
Control.SRR15539832;36;38;0.611111111111111;14;22;0.111111111111111;0.388888888888889
Control.SRR15539832;32;38;0.625;12;20;0.125;0.375
Control.SRR15539832;37;38;0.675675675675676;12;25;0.175675675675676;0.324324324324324
Control.SRR15539832;36;38;0.5;18;18;0;0.5
Control.SRR15539832;31;38;0.419354838709677;18;13;0.0806451612903226;0.419354838709677
Control.SRR15539832;33;38;0.484848484848485;17;16;0.0151515151515151;0.484848484848485
Control.SRR15539832;31;38;0.516129032258065;15;16;0.0161290322580645;0.483870967741935
Control.SRR15539832;32;38;0.5;16;16;0;0.5
Control.SRR15539832;34;38;0.529411764705882;16;18;0.0294117647058824;0.470588235294118
Control.SRR15539832;32;38;0.5625;14;18;0.0625;0.4375
Control.SRR15539832;33;38;0.454545454545455;18;15;0.0454545454545455;0.454545454545455
Control.SRR15539832;36;38;0.527777777777778;17;19;0.0277777777777778;0.472222222222222
Control.SRR15539832;31;38;0.548387096774194;14;17;0.0483870967741935;0.451612903225806
Control.SRR15539832;32;38;0.46875;17;15;0.03125;0.46875
Control.SRR15539832;30;38;0.466666666666667;16;14;0.0333333333333333;0.466666666666667
Control.SRR15539832;28;38;0.392857142857143;17;11;0.107142857142857;0.392857142857143
Control.SRR15539832;34;38;0.588235294117647;14;20;0.0882352941176471;0.411764705882353
Control.SRR15539832;31;38;0.612903225806452;12;19;0.112903225806452;0.387096774193548
Control.SRR15539832;31;38;0.516129032258065;15;16;0.0161290322580645;0.483870967741935
Control.SRR15539832;31;38;0.387096774193548;19;12;0.112903225806452;0.387096774193548
Control.SRR15539832;35;38;0.485714285714286;18;17;0.0142857142857143;0.485714285714286
Control.SRR15539832;34;38;0.529411764705882;16;18;0.0294117647058824;0.470588235294118
Control.SRR15539832;35;38;0.457142857142857;19;16;0.0428571428571429;0.457142857142857
Control.SRR15539832;34;38;0.588235294117647;14;20;0.0882352941176471;0.411764705882353
Control.SRR15539832;36;38;0.472222222222222;19;17;0.0277777777777778;0.472222222222222
Control.SRR15539832;33;38;0.484848484848485;17;16;0.0151515151515151;0.484848484848485
Control.SRR15539832;37;38;0.567567567567568;16;21;0.0675675675675675;0.432432432432432
Control.SRR15539832;32;38;0.5625;14;18;0.0625;0.4375
Control.SRR15539832;28;38;0.535714285714286;13;15;0.0357142857142857;0.464285714285714
Control.SRR15539832;28;38;0.535714285714286;13;15;0.0357142857142857;0.464285714285714
Control.SRR15539832;32;38;0.4375;18;14;0.0625;0.4375
Control.SRR15539832;31;38;0.580645161290323;13;18;0.0806451612903226;0.419354838709677
Control.SRR15539832;33;38;0.545454545454545;15;18;0.0454545454545454;0.454545454545455
Control.SRR15539832;29;38;0.482758620689655;15;14;0.0172413793103448;0.482758620689655
Control.SRR15539832;35;38;0.485714285714286;18;17;0.0142857142857143;0.485714285714286
Control.SRR15539832;32;38;0.5;16;16;0;0.5
Control.SRR15539832;30;38;0.2;24;6;0.3;0.2
Control.SRR15539832;29;38;0.551724137931034;13;16;0.0517241379310345;0.448275862068966
Control.SRR15539832;30;38;0.533333333333333;14;16;0.0333333333333333;0.466666666666667
Control.SRR15539832;29;38;0.482758620689655;15;14;0.0172413793103448;0.482758620689655
Control.SRR15539832;31;38;0.709677419354839;9;22;0.209677419354839;0.290322580645161
Control.SRR15539832;34;38;0.529411764705882;16;18;0.0294117647058824;0.470588235294118
Control.SRR15539832;29;38;0.482758620689655;15;14;0.0172413793103448;0.482758620689655
Control.SRR15539832;36;38;0.555555555555556;16;20;0.0555555555555556;0.444444444444444
Control.SRR15539832;36;38;0.527777777777778;17;19;0.0277777777777778;0.472222222222222
Control.SRR15539832;30;38;0.533333333333333;14;16;0.0333333333333333;0.466666666666667
Control.SRR15539832;37;38;0.540540540540541;17;20;0.0405405405405406;0.459459459459459
Control.SRR15539832;35;38;0.428571428571429;20;15;0.0714285714285715;0.428571428571429
Control.SRR15539832;28;38;0.642857142857143;10;18;0.142857142857143;0.357142857142857
Control.SRR15539832;31;38;0.612903225806452;12;19;0.112903225806452;0.387096774193548
Control.SRR15539832;30;38;0.5;15;15;0;0.5
Control.SRR15539832;31;38;0.548387096774194;14;17;0.0483870967741935;0.451612903225806
Control.SRR15539832;37;38;0.378378378378378;23;14;0.121621621621622;0.378378378378378
Control.SRR15539832;33;38;0.393939393939394;20;13;0.106060606060606;0.393939393939394
Control.SRR15539832;35;38;0.542857142857143;16;19;0.0428571428571428;0.457142857142857
Control.SRR15539832;30;38;0.5;15;15;0;0.5
Control.SRR15539832;31;38;0.451612903225806;17;14;0.0483870967741936;0.451612903225806
Control.SRR15539832;37;38;0.513513513513513;18;19;0.0135135135135135;0.486486486486487
Control.SRR15539832;36;38;0.527777777777778;17;19;0.0277777777777778;0.472222222222222
Control.SRR15539832;35;38;0.571428571428571;15;20;0.0714285714285714;0.428571428571429
Control.SRR15539832;34;38;0.323529411764706;23;11;0.176470588235294;0.323529411764706
Control.SRR15539832;31;38;0.387096774193548;19;12;0.112903225806452;0.387096774193548
Control.SRR15539832;30;38;0.5;15;15;0;0.5
Control.SRR15539832;31;38;0.451612903225806;17;14;0.0483870967741936;0.451612903225806
Control.SRR15539832;30;38;0.366666666666667;19;11;0.133333333333333;0.366666666666667
Control.SRR15539832;36;38;0.388888888888889;22;14;0.111111111111111;0.388888888888889
Control.SRR15539832;32;38;0.375;20;12;0.125;0.375
Control.SRR15539832;32;38;0.5;16;16;0;0.5
Control.SRR15539832;29;38;0.482758620689655;15;14;0.0172413793103448;0.482758620689655
Control.SRR15539832;37;38;0.513513513513513;18;19;0.0135135135135135;0.486486486486487
Control.SRR15539832;28;38;0.428571428571429;16;12;0.0714285714285715;0.428571428571429
Control.SRR15539832;28;38;0.428571428571429;16;12;0.0714285714285715;0.428571428571429
Control.SRR15539832;34;38;0.558823529411765;15;19;0.0588235294117647;0.441176470588235
Control.SRR15539832;29;38;0.620689655172414;11;18;0.120689655172414;0.379310344827586
Control.SRR15539832;30;38;0.666666666666667;10;20;0.166666666666667;0.333333333333333
Control.SRR15539832;37;38;0.432432432432432;21;16;0.0675675675675675;0.432432432432432
Control.SRR15539832;30;38;0.566666666666667;13;17;0.0666666666666667;0.433333333333333
Control.SRR15539832;29;38;0.413793103448276;17;12;0.0862068965517241;0.413793103448276
Control.SRR15539832;35;38;0.571428571428571;15;20;0.0714285714285714;0.428571428571429
Control.SRR15539832;34;38;0.441176470588235;19;15;0.0588235294117647;0.441176470588235
Control.SRR15539832;36;38;0.444444444444444;20;16;0.0555555555555556;0.444444444444444
Control.SRR15539832;30;38;0.466666666666667;16;14;0.0333333333333333;0.466666666666667
Control.SRR15539832;28;38;0.678571428571429;9;19;0.178571428571429;0.321428571428571
Control.SRR15539832;35;38;0.6;14;21;0.1;0.4
Control.SRR15539832;33;38;0.515151515151515;16;17;0.0151515151515151;0.484848484848485
Control.SRR15539832;32;38;0.59375;13;19;0.09375;0.40625
Control.SRR15539832;37;38;0.513513513513513;18;19;0.0135135135135135;0.486486486486487
Control.SRR15539832;37;38;0.486486486486487;19;18;0.0135135135135135;0.486486486486487
Control.SRR15539832;29;38;0.586206896551724;12;17;0.0862068965517241;0.413793103448276
Control.SRR15539832;31;38;0.612903225806452;12;19;0.112903225806452;0.387096774193548
Control.SRR15539832;28;38;0.607142857142857;11;17;0.107142857142857;0.392857142857143
Control.SRR15539832;29;38;0.482758620689655;15;14;0.0172413793103448;0.482758620689655
Control.SRR15539832;32;38;0.5625;14;18;0.0625;0.4375
Control.SRR15539832;28;38;0.357142857142857;18;10;0.142857142857143;0.357142857142857
Control.SRR15539832;30;38;0.566666666666667;13;17;0.0666666666666667;0.433333333333333
Control.SRR15539832;37;38;0.567567567567568;16;21;0.0675675675675675;0.432432432432432
Control.SRR15539832;29;38;0.517241379310345;14;15;0.0172413793103449;0.482758620689655
Control.SRR15539832;31;38;0.548387096774194;14;17;0.0483870967741935;0.451612903225806
Control.SRR15539832;35;38;0.542857142857143;16;19;0.0428571428571428;0.457142857142857
Control.SRR15539832;33;38;0.636363636363636;12;21;0.136363636363636;0.363636363636364
Control.SRR15539832;35;38;0.285714285714286;25;10;0.214285714285714;0.285714285714286
Control.SRR15539832;36;38;0.583333333333333;15;21;0.0833333333333334;0.416666666666667
Control.SRR15539832;36;38;0.555555555555556;16;20;0.0555555555555556;0.444444444444444
Control.SRR15539832;32;38;0.5;16;16;0;0.5
Control.SRR15539832;34;38;0.588235294117647;14;20;0.0882352941176471;0.411764705882353
Control.SRR15539832;37;38;0.405405405405405;22;15;0.0945945945945946;0.405405405405405
Control.SRR15539832;32;38;0.4375;18;14;0.0625;0.4375
Control.SRR15539832;30;38;0.5;15;15;0;0.5
Control.SRR15539832;30;38;0.433333333333333;17;13;0.0666666666666667;0.433333333333333
Control.SRR15539832;33;38;0.575757575757576;14;19;0.0757575757575758;0.424242424242424
Control.SRR15539832;35;38;0.542857142857143;16;19;0.0428571428571428;0.457142857142857
Control.SRR15539832;30;38;0.466666666666667;16;14;0.0333333333333333;0.466666666666667
Control.SRR15539832;33;38;0.515151515151515;16;17;0.0151515151515151;0.484848484848485
Control.SRR15539832;37;38;0.459459459459459;20;17;0.0405405405405405;0.459459459459459
Control.SRR15539832;30;38;0.5;15;15;0;0.5
Control.SRR15539832;28;38;0.25;21;7;0.25;0.25
Control.SRR15539832;35;38;0.457142857142857;19;16;0.0428571428571429;0.457142857142857
Control.SRR15539832;35;38;0.428571428571429;20;15;0.0714285714285715;0.428571428571429
Control.SRR15539832;34;38;0.411764705882353;20;14;0.0882352941176471;0.411764705882353
Control.SRR15539832;28;38;0.392857142857143;17;11;0.107142857142857;0.392857142857143
Control.SRR15539832;29;38;0.379310344827586;18;11;0.120689655172414;0.379310344827586
Control.SRR15539832;32;38;0.46875;17;15;0.03125;0.46875
Control.SRR15539832;34;38;0.558823529411765;15;19;0.0588235294117647;0.441176470588235
Control.SRR15539832;30;38;0.566666666666667;13;17;0.0666666666666667;0.433333333333333
Control.SRR15539832;35;38;0.571428571428571;15;20;0.0714285714285714;0.428571428571429
Control.SRR15539832;32;38;0.5;16;16;0;0.5
Control.SRR15539832;32;38;0.46875;17;15;0.03125;0.46875
Control.SRR15539832;30;38;0.466666666666667;16;14;0.0333333333333333;0.466666666666667
Control.SRR15539832;34;38;0.470588235294118;18;16;0.0294117647058824;0.470588235294118
Control.SRR15539832;35;38;0.4;21;14;0.1;0.4
Control.SRR15539832;28;38;0.75;7;21;0.25;0.25
Control.SRR15539832;29;38;0.413793103448276;17;12;0.0862068965517241;0.413793103448276
Control.SRR15539832;29;38;0.517241379310345;14;15;0.0172413793103449;0.482758620689655
Control.SRR15539832;31;38;0.32258064516129;21;10;0.17741935483871;0.32258064516129
Control.SRR15539832;37;38;0.486486486486487;19;18;0.0135135135135135;0.486486486486487
Control.SRR15539832;34;38;0.617647058823529;13;21;0.117647058823529;0.382352941176471
Control.SRR15539832;35;38;0.457142857142857;19;16;0.0428571428571429;0.457142857142857
Control.SRR15539832;36;38;0.555555555555556;16;20;0.0555555555555556;0.444444444444444
Control.SRR15539832;36;38;0.472222222222222;19;17;0.0277777777777778;0.472222222222222
Control.SRR15539832;32;38;0.5;16;16;0;0.5
Control.SRR15539832;34;38;0.411764705882353;20;14;0.0882352941176471;0.411764705882353
Control.SRR15539832;34;38;0.617647058823529;13;21;0.117647058823529;0.382352941176471
Control.SRR15539832;30;38;0.5;15;15;0;0.5
Control.SRR15539832;29;38;0.551724137931034;13;16;0.0517241379310345;0.448275862068966
Control.SRR15539832;28;38;0.535714285714286;13;15;0.0357142857142857;0.464285714285714
Control.SRR15539832;31;38;0.451612903225806;17;14;0.0483870967741936;0.451612903225806
Control.SRR15539832;28;38;0.535714285714286;13;15;0.0357142857142857;0.464285714285714
Control.SRR15539832;32;38;0.53125;15;17;0.03125;0.46875
Control.SRR15539832;34;38;0.5;17;17;0;0.5
Control.SRR15539832;35;38;0.542857142857143;16;19;0.0428571428571428;0.457142857142857
Control.SRR15539832;32;38;0.5;16;16;0;0.5
Control.SRR15539832;36;38;0.5;18;18;0;0.5
Control.SRR15539832;31;38;0.580645161290323;13;18;0.0806451612903226;0.419354838709677
Control.SRR15539832;34;38;0.441176470588235;19;15;0.0588235294117647;0.441176470588235
Control.SRR15539832;35;38;0.428571428571429;20;15;0.0714285714285715;0.428571428571429
Control.SRR15539832;35;38;0.6;14;21;0.1;0.4
Control.SRR15539832;31;38;0.548387096774194;14;17;0.0483870967741935;0.451612903225806
Control.SRR15539832;33;38;0.575757575757576;14;19;0.0757575757575758;0.424242424242424
Control.SRR15539832;37;38;0.432432432432432;21;16;0.0675675675675675;0.432432432432432
Control.SRR15539832;33;38;0.606060606060606;13;20;0.106060606060606;0.393939393939394
Control.SRR15539832;33;38;0.424242424242424;19;14;0.0757575757575757;0.424242424242424
Control.SRR15539832;31;38;0.612903225806452;12;19;0.112903225806452;0.387096774193548
Control.SRR15539832;30;38;0.566666666666667;13;17;0.0666666666666667;0.433333333333333
Control.SRR15539832;35;38;0.6;14;21;0.1;0.4
Control.SRR15539832;30;38;0.466666666666667;16;14;0.0333333333333333;0.466666666666667
Control.SRR15539832;32;38;0.40625;19;13;0.09375;0.40625
Control.SRR15539832;28;38;0.5;14;14;0;0.5
Control.SRR15539832;37;38;0.540540540540541;17;20;0.0405405405405406;0.459459459459459
Control.SRR15539832;34;38;0.558823529411765;15;19;0.0588235294117647;0.441176470588235
Control.SRR15539832;37;38;0.432432432432432;21;16;0.0675675675675675;0.432432432432432
Control.SRR15539832;36;38;0.555555555555556;16;20;0.0555555555555556;0.444444444444444
Control.SRR15539832;28;38;0.535714285714286;13;15;0.0357142857142857;0.464285714285714
Control.SRR15539832;28;38;0.642857142857143;10;18;0.142857142857143;0.357142857142857
Control.SRR15539832;30;38;0.733333333333333;8;22;0.233333333333333;0.266666666666667
Control.SRR15539832;30;38;0.566666666666667;13;17;0.0666666666666667;0.433333333333333
Control.SRR15539832;36;38;0.444444444444444;20;16;0.0555555555555556;0.444444444444444
Control.SRR15539832;34;38;0.588235294117647;14;20;0.0882352941176471;0.411764705882353
Control.SRR15539832;33;38;0.454545454545455;18;15;0.0454545454545455;0.454545454545455
Control.SRR15539832;36;38;0.388888888888889;22;14;0.111111111111111;0.388888888888889
Control.SRR15539832;37;38;0.378378378378378;23;14;0.121621621621622;0.378378378378378
Control.SRR15539832;29;38;0.517241379310345;14;15;0.0172413793103449;0.482758620689655
Control.SRR15539832;35;38;0.314285714285714;24;11;0.185714285714286;0.314285714285714
Control.SRR15539832;34;38;0.382352941176471;21;13;0.117647058823529;0.382352941176471
Control.SRR15539832;30;38;0.433333333333333;17;13;0.0666666666666667;0.433333333333333
Control.SRR15539832;29;38;0.448275862068966;16;13;0.0517241379310345;0.448275862068966
Control.SRR15539832;32;38;0.59375;13;19;0.09375;0.40625
Control.SRR15539832;28;38;0.464285714285714;15;13;0.0357142857142857;0.464285714285714
Control.SRR15539832;33;38;0.575757575757576;14;19;0.0757575757575758;0.424242424242424
Control.SRR15539832;37;38;0.594594594594595;15;22;0.0945945945945946;0.405405405405405
Control.SRR15539832;33;38;0.606060606060606;13;20;0.106060606060606;0.393939393939394
Control.SRR15539832;36;38;0.666666666666667;12;24;0.166666666666667;0.333333333333333
Control.SRR15539832;32;38;0.4375;18;14;0.0625;0.4375
Control.SRR15539832;31;38;0.548387096774194;14;17;0.0483870967741935;0.451612903225806
Control.SRR15539832;30;38;0.4;18;12;0.1;0.4
Control.SRR15539832;35;38;0.342857142857143;23;12;0.157142857142857;0.342857142857143
Control.SRR15539832;31;38;0.580645161290323;13;18;0.0806451612903226;0.419354838709677
Control.SRR15539832;34;38;0.529411764705882;16;18;0.0294117647058824;0.470588235294118
Control.SRR15539832;31;38;0.451612903225806;17;14;0.0483870967741936;0.451612903225806
Control.SRR15539832;34;38;0.529411764705882;16;18;0.0294117647058824;0.470588235294118
Control.SRR15539832;34;38;0.617647058823529;13;21;0.117647058823529;0.382352941176471
Control.SRR15539832;31;38;0.419354838709677;18;13;0.0806451612903226;0.419354838709677
Control.SRR15539832;33;38;0.393939393939394;20;13;0.106060606060606;0.393939393939394
Control.SRR15539832;31;38;0.645161290322581;11;20;0.145161290322581;0.354838709677419
Control.SRR15539832;33;38;0.636363636363636;12;21;0.136363636363636;0.363636363636364
Control.SRR15539832;34;38;0.5;17;17;0;0.5
Control.SRR15539832;33;38;0.424242424242424;19;14;0.0757575757575757;0.424242424242424
Control.SRR15539832;31;38;0.451612903225806;17;14;0.0483870967741936;0.451612903225806
Control.SRR15539832;30;38;0.533333333333333;14;16;0.0333333333333333;0.466666666666667
Control.SRR15539832;29;38;0.344827586206897;19;10;0.155172413793103;0.344827586206897
Control.SRR15539832;33;38;0.606060606060606;13;20;0.106060606060606;0.393939393939394
Control.SRR15539832;32;38;0.5625;14;18;0.0625;0.4375
Control.SRR15539832;28;38;0.571428571428571;12;16;0.0714285714285714;0.428571428571429
Control.SRR15539832;29;38;0.517241379310345;14;15;0.0172413793103449;0.482758620689655
Control.SRR15539832;30;38;0.466666666666667;16;14;0.0333333333333333;0.466666666666667
Control.SRR15539832;35;38;0.485714285714286;18;17;0.0142857142857143;0.485714285714286
Control.SRR15539832;33;38;0.575757575757576;14;19;0.0757575757575758;0.424242424242424
Control.SRR15539832;28;38;0.428571428571429;16;12;0.0714285714285715;0.428571428571429
Control.SRR15539832;30;38;0.666666666666667;10;20;0.166666666666667;0.333333333333333
Control.SRR15539832;29;38;0.448275862068966;16;13;0.0517241379310345;0.448275862068966
Control.SRR15539832;36;38;0.638888888888889;13;23;0.138888888888889;0.361111111111111
Control.SRR15539832;34;38;0.382352941176471;21;13;0.117647058823529;0.382352941176471
Control.SRR15539832;33;38;0.575757575757576;14;19;0.0757575757575758;0.424242424242424
Control.SRR15539832;33;38;0.454545454545455;18;15;0.0454545454545455;0.454545454545455
Control.SRR15539832;35;38;0.542857142857143;16;19;0.0428571428571428;0.457142857142857
Control.SRR15539832;33;38;0.454545454545455;18;15;0.0454545454545455;0.454545454545455
Control.SRR15539832;33;38;0.454545454545455;18;15;0.0454545454545455;0.454545454545455
Control.SRR15539832;35;38;0.6;14;21;0.1;0.4
Control.SRR15539832;29;38;0.448275862068966;16;13;0.0517241379310345;0.448275862068966
Control.SRR15539832;34;38;0.5;17;17;0;0.5
Control.SRR15539832;28;38;0.535714285714286;13;15;0.0357142857142857;0.464285714285714
Control.SRR15539832;34;38;0.5;17;17;0;0.5
Control.SRR15539832;28;38;0.571428571428571;12;16;0.0714285714285714;0.428571428571429
Control.SRR15539832;34;38;0.470588235294118;18;16;0.0294117647058824;0.470588235294118
Control.SRR15539832;29;38;0.379310344827586;18;11;0.120689655172414;0.379310344827586
Control.SRR15539832;29;38;0.310344827586207;20;9;0.189655172413793;0.310344827586207
Control.SRR15539832;29;38;0.586206896551724;12;17;0.0862068965517241;0.413793103448276
Control.SRR15539832;32;38;0.34375;21;11;0.15625;0.34375
Control.SRR15539832;34;38;0.382352941176471;21;13;0.117647058823529;0.382352941176471
Control.SRR15539832;37;38;0.486486486486487;19;18;0.0135135135135135;0.486486486486487
Control.SRR15539832;35;38;0.428571428571429;20;15;0.0714285714285715;0.428571428571429
Control.SRR15539832;29;38;0.551724137931034;13;16;0.0517241379310345;0.448275862068966
Control.SRR15539832;29;38;0.413793103448276;17;12;0.0862068965517241;0.413793103448276
Control.SRR15539832;29;38;0.551724137931034;13;16;0.0517241379310345;0.448275862068966
Control.SRR15539832;31;38;0.612903225806452;12;19;0.112903225806452;0.387096774193548
Control.SRR15539832;36;38;0.444444444444444;20;16;0.0555555555555556;0.444444444444444
Control.SRR15539832;31;38;0.387096774193548;19;12;0.112903225806452;0.387096774193548
Control.SRR15539832;34;38;0.676470588235294;11;23;0.176470588235294;0.323529411764706
Control.SRR15539832;34;38;0.411764705882353;20;14;0.0882352941176471;0.411764705882353
Control.SRR15539832;35;38;0.514285714285714;17;18;0.0142857142857142;0.485714285714286
Control.SRR15539832;31;38;0.548387096774194;14;17;0.0483870967741935;0.451612903225806
Control.SRR15539832;29;38;0.448275862068966;16;13;0.0517241379310345;0.448275862068966
Control.SRR15539832;28;38;0.392857142857143;17;11;0.107142857142857;0.392857142857143
Control.SRR15539832;37;38;0.594594594594595;15;22;0.0945945945945946;0.405405405405405
Control.SRR15539832;34;38;0.441176470588235;19;15;0.0588235294117647;0.441176470588235
Control.SRR15539832;30;38;0.4;18;12;0.1;0.4
Control.SRR15539832;28;38;0.5;14;14;0;0.5
Control.SRR15539832;30;38;0.533333333333333;14;16;0.0333333333333333;0.466666666666667
Control.SRR15539832;31;38;0.612903225806452;12;19;0.112903225806452;0.387096774193548
Control.SRR15539832;35;38;0.542857142857143;16;19;0.0428571428571428;0.457142857142857
Control.SRR15539832;29;38;0.517241379310345;14;15;0.0172413793103449;0.482758620689655
Control.SRR15539832;30;38;0.533333333333333;14;16;0.0333333333333333;0.466666666666667
Control.SRR15539832;29;38;0.655172413793103;10;19;0.155172413793103;0.344827586206897
Control.SRR15539832;31;38;0.32258064516129;21;10;0.17741935483871;0.32258064516129
Control.SRR15539832;30;38;0.6;12;18;0.1;0.4
Control.SRR15539832;37;38;0.675675675675676;12;25;0.175675675675676;0.324324324324324
Control.SRR15539832;30;38;0.6;12;18;0.1;0.4
Control.SRR15539832;32;38;0.4375;18;14;0.0625;0.4375
Control.SRR15539832;31;38;0.516129032258065;15;16;0.0161290322580645;0.483870967741935
Control.SRR15539832;29;38;0.517241379310345;14;15;0.0172413793103449;0.482758620689655
Control.SRR15539832;29;38;0.586206896551724;12;17;0.0862068965517241;0.413793103448276
Control.SRR15539832;36;38;0.5;18;18;0;0.5
Control.SRR15539832;29;38;0.586206896551724;12;17;0.0862068965517241;0.413793103448276
Control.SRR15539832;35;38;0.571428571428571;15;20;0.0714285714285714;0.428571428571429
Control.SRR15539832;32;38;0.40625;19;13;0.09375;0.40625
Control.SRR15539832;35;38;0.485714285714286;18;17;0.0142857142857143;0.485714285714286
Control.SRR15539832;36;38;0.638888888888889;13;23;0.138888888888889;0.361111111111111
Control.SRR15539832;30;38;0.433333333333333;17;13;0.0666666666666667;0.433333333333333
Control.SRR15539832;36;38;0.5;18;18;0;0.5
Control.SRR15539832;36;38;0.583333333333333;15;21;0.0833333333333334;0.416666666666667
Control.SRR15539832;33;38;0.454545454545455;18;15;0.0454545454545455;0.454545454545455
Control.SRR15539832;32;38;0.59375;13;19;0.09375;0.40625
Control.SRR15539832;37;38;0.594594594594595;15;22;0.0945945945945946;0.405405405405405
Control.SRR15539832;35;38;0.628571428571429;13;22;0.128571428571429;0.371428571428571
Control.SRR15539832;32;38;0.5625;14;18;0.0625;0.4375
Control.SRR15539832;29;38;0.413793103448276;17;12;0.0862068965517241;0.413793103448276
Control.SRR15539832;37;38;0.486486486486487;19;18;0.0135135135135135;0.486486486486487
Control.SRR15539832;33;38;0.484848484848485;17;16;0.0151515151515151;0.484848484848485
Control.SRR15539832;32;38;0.46875;17;15;0.03125;0.46875
Control.SRR15539832;37;38;0.432432432432432;21;16;0.0675675675675675;0.432432432432432
Control.SRR15539832;33;38;0.484848484848485;17;16;0.0151515151515151;0.484848484848485
Control.SRR15539832;43;38;0.558139534883721;19;24;0.0581395348837209;0.441860465116279
Control.SRR15539832;43;38;0.511627906976744;21;22;0.0116279069767442;0.488372093023256
Control.SRR15539832;39;38;0.58974358974359;16;23;0.0897435897435898;0.41025641025641
Control.SRR15539832;35;38;0.485714285714286;18;17;0.0142857142857143;0.485714285714286
Control.SRR15539832;41;38;0.609756097560976;16;25;0.109756097560976;0.390243902439024
Control.SRR15539832;37;38;0.702702702702703;11;26;0.202702702702703;0.297297297297297
Control.SRR15539832;38;38;0.394736842105263;23;15;0.105263157894737;0.394736842105263
Control.SRR15539832;36;38;0.5;18;18;0;0.5
Control.SRR15539832;42;38;0.5;21;21;0;0.5
Control.SRR15539832;36;38;0.5;18;18;0;0.5
Control.SRR15539832;42;38;0.404761904761905;25;17;0.0952380952380952;0.404761904761905
Control.SRR15539832;42;38;0.571428571428571;18;24;0.0714285714285714;0.428571428571429
Control.SRR15539832;37;38;0.405405405405405;22;15;0.0945945945945946;0.405405405405405
Control.SRR15539832;39;38;0.512820512820513;19;20;0.0128205128205128;0.487179487179487
Control.SRR15539832;41;38;0.439024390243902;23;18;0.0609756097560976;0.439024390243902
Control.SRR15539832;41;38;0.414634146341463;24;17;0.0853658536585366;0.414634146341463
Control.SRR15539832;36;38;0.666666666666667;12;24;0.166666666666667;0.333333333333333
Control.SRR15539832;38;38;0.315789473684211;26;12;0.184210526315789;0.315789473684211
Control.SRR15539832;38;38;0.447368421052632;21;17;0.0526315789473684;0.447368421052632
Control.SRR15539832;37;38;0.486486486486487;19;18;0.0135135135135135;0.486486486486487
Control.SRR15539832;36;38;0.472222222222222;19;17;0.0277777777777778;0.472222222222222
Control.SRR15539832;39;38;0.435897435897436;22;17;0.0641025641025641;0.435897435897436
Control.SRR15539832;33;38;0.393939393939394;20;13;0.106060606060606;0.393939393939394
Control.SRR15539832;33;38;0.606060606060606;13;20;0.106060606060606;0.393939393939394
Control.SRR15539832;35;38;0.428571428571429;20;15;0.0714285714285715;0.428571428571429
Control.SRR15539832;33;38;0.454545454545455;18;15;0.0454545454545455;0.454545454545455
Control.SRR15539832;38;38;0.605263157894737;15;23;0.105263157894737;0.394736842105263
Control.SRR15539832;40;38;0.45;22;18;0.05;0.45
Control.SRR15539832;34;38;0.5;17;17;0;0.5
Control.SRR15539832;34;38;0.529411764705882;16;18;0.0294117647058824;0.470588235294118
Control.SRR15539832;43;38;0.441860465116279;24;19;0.0581395348837209;0.441860465116279
Control.SRR15539832;42;38;0.380952380952381;26;16;0.119047619047619;0.380952380952381
Control.SRR15539832;42;38;0.523809523809524;20;22;0.0238095238095238;0.476190476190476
Control.SRR15539832;36;38;0.361111111111111;23;13;0.138888888888889;0.361111111111111
Control.SRR15539832;38;38;0.526315789473684;18;20;0.0263157894736842;0.473684210526316
Control.SRR15539832;38;38;0.421052631578947;22;16;0.0789473684210527;0.421052631578947
Control.SRR15539832;39;38;0.58974358974359;16;23;0.0897435897435898;0.41025641025641
Control.SRR15539832;37;38;0.351351351351351;24;13;0.148648648648649;0.351351351351351
Control.SRR15539832;40;38;0.475;21;19;0.025;0.475
Control.SRR15539832;38;38;0.526315789473684;18;20;0.0263157894736842;0.473684210526316
Control.SRR15539832;34;38;0.5;17;17;0;0.5
Control.SRR15539832;35;38;0.457142857142857;19;16;0.0428571428571429;0.457142857142857
Control.SRR15539832;34;38;0.382352941176471;21;13;0.117647058823529;0.382352941176471
Control.SRR15539832;35;38;0.485714285714286;18;17;0.0142857142857143;0.485714285714286
Control.SRR15539832;39;38;0.41025641025641;23;16;0.0897435897435898;0.41025641025641
Control.SRR15539832;33;38;0.393939393939394;20;13;0.106060606060606;0.393939393939394
Control.SRR15539832;38;38;0.526315789473684;18;20;0.0263157894736842;0.473684210526316
Control.SRR15539832;33;38;0.606060606060606;13;20;0.106060606060606;0.393939393939394
Control.SRR15539832;40;38;0.425;23;17;0.075;0.425
Control.SRR15539832;43;38;0.488372093023256;22;21;0.0116279069767442;0.488372093023256
Control.SRR15539832;34;38;0.588235294117647;14;20;0.0882352941176471;0.411764705882353
Control.SRR15539832;33;38;0.484848484848485;17;16;0.0151515151515151;0.484848484848485
Control.SRR15539832;34;38;0.323529411764706;23;11;0.176470588235294;0.323529411764706
Control.SRR15539832;37;38;0.486486486486487;19;18;0.0135135135135135;0.486486486486487
Control.SRR15539832;38;38;0.578947368421053;16;22;0.0789473684210527;0.421052631578947
Control.SRR15539832;37;38;0.513513513513513;18;19;0.0135135135135135;0.486486486486487
Control.SRR15539832;40;38;0.575;17;23;0.075;0.425
Control.SRR15539832;36;38;0.472222222222222;19;17;0.0277777777777778;0.472222222222222
Control.SRR15539832;38;38;0.473684210526316;20;18;0.0263157894736842;0.473684210526316
Control.SRR15539832;34;38;0.441176470588235;19;15;0.0588235294117647;0.441176470588235
Control.SRR15539832;37;38;0.540540540540541;17;20;0.0405405405405406;0.459459459459459
Control.SRR15539832;38;38;0.394736842105263;23;15;0.105263157894737;0.394736842105263
Control.SRR15539832;39;38;0.512820512820513;19;20;0.0128205128205128;0.487179487179487
Control.SRR15539832;38;38;0.526315789473684;18;20;0.0263157894736842;0.473684210526316
Control.SRR15539832;37;38;0.459459459459459;20;17;0.0405405405405405;0.459459459459459
Control.SRR15539832;34;38;0.352941176470588;22;12;0.147058823529412;0.352941176470588
Control.SRR15539832;33;38;0.484848484848485;17;16;0.0151515151515151;0.484848484848485
Control.SRR15539832;36;38;0.416666666666667;21;15;0.0833333333333333;0.416666666666667
Control.SRR15539832;34;38;0.470588235294118;18;16;0.0294117647058824;0.470588235294118
Control.SRR15539832;40;38;0.475;21;19;0.025;0.475
Control.SRR15539832;34;38;0.617647058823529;13;21;0.117647058823529;0.382352941176471
Control.SRR15539832;34;38;0.441176470588235;19;15;0.0588235294117647;0.441176470588235
Control.SRR15539832;41;38;0.51219512195122;20;21;0.0121951219512195;0.48780487804878
Control.SRR15539832;33;38;0.515151515151515;16;17;0.0151515151515151;0.484848484848485
Control.SRR15539832;40;38;0.475;21;19;0.025;0.475
Control.SRR15539832;40;38;0.6;16;24;0.1;0.4
Control.SRR15539832;38;38;0.5;19;19;0;0.5
Control.SRR15539832;36;38;0.444444444444444;20;16;0.0555555555555556;0.444444444444444
Control.SRR15539832;33;38;0.393939393939394;20;13;0.106060606060606;0.393939393939394
Control.SRR15539832;34;38;0.705882352941177;10;24;0.205882352941177;0.294117647058824
Control.SRR15539832;38;38;0.526315789473684;18;20;0.0263157894736842;0.473684210526316
Control.SRR15539832;37;38;0.324324324324324;25;12;0.175675675675676;0.324324324324324
Control.SRR15539832;35;38;0.542857142857143;16;19;0.0428571428571428;0.457142857142857
Control.SRR15539832;37;38;0.540540540540541;17;20;0.0405405405405406;0.459459459459459
Control.SRR15539832;39;38;0.282051282051282;28;11;0.217948717948718;0.282051282051282
Control.SRR15539832;33;38;0.515151515151515;16;17;0.0151515151515151;0.484848484848485
Control.SRR15539832;41;38;0.48780487804878;21;20;0.0121951219512195;0.48780487804878
Control.SRR15539832;40;38;0.425;23;17;0.075;0.425
Control.SRR15539832;36;38;0.583333333333333;15;21;0.0833333333333334;0.416666666666667
Control.SRR15539832;38;38;0.421052631578947;22;16;0.0789473684210527;0.421052631578947
Control.SRR15539832;36;38;0.527777777777778;17;19;0.0277777777777778;0.472222222222222
Control.SRR15539832;40;38;0.45;22;18;0.05;0.45
Control.SRR15539832;34;38;0.647058823529412;12;22;0.147058823529412;0.352941176470588
Control.SRR15539832;33;38;0.606060606060606;13;20;0.106060606060606;0.393939393939394
Control.SRR15539832;41;38;0.51219512195122;20;21;0.0121951219512195;0.48780487804878
Control.SRR15539832;37;38;0.432432432432432;21;16;0.0675675675675675;0.432432432432432
Control.SRR15539832;33;38;0.575757575757576;14;19;0.0757575757575758;0.424242424242424
Control.SRR15539832;42;38;0.476190476190476;22;20;0.0238095238095238;0.476190476190476
Control.SRR15539832;35;38;0.485714285714286;18;17;0.0142857142857143;0.485714285714286
Control.SRR15539832;38;38;0.578947368421053;16;22;0.0789473684210527;0.421052631578947
Control.SRR15539832;34;38;0.5;17;17;0;0.5
Control.SRR15539832;39;38;0.435897435897436;22;17;0.0641025641025641;0.435897435897436
Control.SRR15539832;37;38;0.378378378378378;23;14;0.121621621621622;0.378378378378378
Control.SRR15539832;38;38;0.473684210526316;20;18;0.0263157894736842;0.473684210526316
Control.SRR15539832;38;38;0.368421052631579;24;14;0.131578947368421;0.368421052631579
Control.SRR15539832;43;38;0.441860465116279;24;19;0.0581395348837209;0.441860465116279
Control.SRR15539832;38;38;0.5;19;19;0;0.5
Control.SRR15539832;39;38;0.461538461538462;21;18;0.0384615384615384;0.461538461538462
Control.SRR15539832;39;38;0.461538461538462;21;18;0.0384615384615384;0.461538461538462
Control.SRR15539832;39;38;0.564102564102564;17;22;0.0641025641025641;0.435897435897436
Control.SRR15539832;36;38;0.527777777777778;17;19;0.0277777777777778;0.472222222222222
Control.SRR15539832;40;38;0.425;23;17;0.075;0.425
Control.SRR15539832;35;38;0.514285714285714;17;18;0.0142857142857142;0.485714285714286
Control.SRR15539832;34;38;0.5;17;17;0;0.5
Control.SRR15539832;35;38;0.4;21;14;0.1;0.4
Control.SRR15539832;38;38;0.5;19;19;0;0.5
Control.SRR15539832;33;38;0.515151515151515;16;17;0.0151515151515151;0.484848484848485
Control.SRR15539832;37;38;0.459459459459459;20;17;0.0405405405405405;0.459459459459459
Control.SRR15539832;37;38;0.351351351351351;24;13;0.148648648648649;0.351351351351351
Control.SRR15539832;40;38;0.55;18;22;0.05;0.45
Control.SRR15539832;43;38;0.395348837209302;26;17;0.104651162790698;0.395348837209302
Control.SRR15539832;36;38;0.527777777777778;17;19;0.0277777777777778;0.472222222222222
Control.SRR15539832;42;38;0.547619047619048;19;23;0.0476190476190477;0.452380952380952
Control.SRR15539832;39;38;0.461538461538462;21;18;0.0384615384615384;0.461538461538462
Control.SRR15539832;34;38;0.5;17;17;0;0.5
Control.SRR15539832;38;38;0.447368421052632;21;17;0.0526315789473684;0.447368421052632
Control.SRR15539832;33;38;0.545454545454545;15;18;0.0454545454545454;0.454545454545455
Control.SRR15539832;38;38;0.473684210526316;20;18;0.0263157894736842;0.473684210526316
Control.SRR15539832;40;38;0.55;18;22;0.05;0.45
Control.SRR15539832;41;38;0.560975609756098;18;23;0.0609756097560976;0.439024390243902
Control.SRR15539832;36;38;0.444444444444444;20;16;0.0555555555555556;0.444444444444444
Control.SRR15539832;38;38;0.605263157894737;15;23;0.105263157894737;0.394736842105263
Control.SRR15539832;41;38;0.560975609756098;18;23;0.0609756097560976;0.439024390243902
Control.SRR15539832;37;38;0.594594594594595;15;22;0.0945945945945946;0.405405405405405
Control.SRR15539832;36;38;0.583333333333333;15;21;0.0833333333333334;0.416666666666667
Control.SRR15539832;36;38;0.472222222222222;19;17;0.0277777777777778;0.472222222222222
Control.SRR15539832;38;38;0.526315789473684;18;20;0.0263157894736842;0.473684210526316
Control.SRR15539832;42;38;0.523809523809524;20;22;0.0238095238095238;0.476190476190476
Control.SRR15539832;39;38;0.564102564102564;17;22;0.0641025641025641;0.435897435897436
Control.SRR15539832;42;38;0.452380952380952;23;19;0.0476190476190476;0.452380952380952
Control.SRR15539832;33;38;0.545454545454545;15;18;0.0454545454545454;0.454545454545455
Control.SRR15539832;35;38;0.457142857142857;19;16;0.0428571428571429;0.457142857142857
Control.SRR15539832;36;38;0.416666666666667;21;15;0.0833333333333333;0.416666666666667
Control.SRR15539832;34;38;0.588235294117647;14;20;0.0882352941176471;0.411764705882353
Control.SRR15539832;42;38;0.595238095238095;17;25;0.0952380952380952;0.404761904761905
Control.SRR15539832;38;38;0.526315789473684;18;20;0.0263157894736842;0.473684210526316
Control.SRR15539832;40;38;0.425;23;17;0.075;0.425
Control.SRR15539832;35;38;0.457142857142857;19;16;0.0428571428571429;0.457142857142857
Control.SRR15539832;42;38;0.571428571428571;18;24;0.0714285714285714;0.428571428571429
Control.SRR15539832;39;38;0.41025641025641;23;16;0.0897435897435898;0.41025641025641
Control.SRR15539832;33;38;0.515151515151515;16;17;0.0151515151515151;0.484848484848485
Control.SRR15539832;35;38;0.371428571428571;22;13;0.128571428571429;0.371428571428571
Control.SRR15539832;39;38;0.512820512820513;19;20;0.0128205128205128;0.487179487179487
Control.SRR15539832;33;38;0.393939393939394;20;13;0.106060606060606;0.393939393939394
Control.SRR15539832;39;38;0.512820512820513;19;20;0.0128205128205128;0.487179487179487
Control.SRR15539832;40;38;0.5;20;20;0;0.5
Control.SRR15539832;33;38;0.575757575757576;14;19;0.0757575757575758;0.424242424242424
Control.SRR15539832;40;38;0.625;15;25;0.125;0.375
Control.SRR15539832;38;38;0.631578947368421;14;24;0.131578947368421;0.368421052631579
Control.SRR15539832;41;38;0.560975609756098;18;23;0.0609756097560976;0.439024390243902
Control.SRR15539832;33;38;0.424242424242424;19;14;0.0757575757575757;0.424242424242424
Control.SRR15539832;41;38;0.536585365853659;19;22;0.0365853658536586;0.463414634146341
Control.SRR15539832;42;38;0.571428571428571;18;24;0.0714285714285714;0.428571428571429
Control.SRR15539832;33;38;0.393939393939394;20;13;0.106060606060606;0.393939393939394
Control.SRR15539832;36;38;0.472222222222222;19;17;0.0277777777777778;0.472222222222222
Control.SRR15539832;42;38;0.642857142857143;15;27;0.142857142857143;0.357142857142857
Control.SRR15539832;37;38;0.648648648648649;13;24;0.148648648648649;0.351351351351351
Control.SRR15539832;40;38;0.55;18;22;0.05;0.45
Control.SRR15539832;34;38;0.558823529411765;15;19;0.0588235294117647;0.441176470588235
Control.SRR15539832;38;38;0.657894736842105;13;25;0.157894736842105;0.342105263157895
Control.SRR15539832;41;38;0.585365853658537;17;24;0.0853658536585366;0.414634146341463
Control.SRR15539832;39;38;0.435897435897436;22;17;0.0641025641025641;0.435897435897436
Control.SRR15539832;40;38;0.525;19;21;0.025;0.475
Control.SRR15539832;39;38;0.435897435897436;22;17;0.0641025641025641;0.435897435897436
Control.SRR15539832;37;38;0.702702702702703;11;26;0.202702702702703;0.297297297297297
Control.SRR15539832;41;38;0.585365853658537;17;24;0.0853658536585366;0.414634146341463
Control.SRR15539832;42;38;0.5;21;21;0;0.5
Control.SRR15539832;43;38;0.488372093023256;22;21;0.0116279069767442;0.488372093023256
Control.SRR15539832;40;38;0.425;23;17;0.075;0.425
Control.SRR15539832;33;38;0.515151515151515;16;17;0.0151515151515151;0.484848484848485
Control.SRR15539832;39;38;0.41025641025641;23;16;0.0897435897435898;0.41025641025641
Control.SRR15539832;33;38;0.484848484848485;17;16;0.0151515151515151;0.484848484848485
Control.SRR15539832;38;38;0.473684210526316;20;18;0.0263157894736842;0.473684210526316
Control.SRR15539832;42;38;0.619047619047619;16;26;0.119047619047619;0.380952380952381
Control.SRR15539832;38;38;0.447368421052632;21;17;0.0526315789473684;0.447368421052632
Control.SRR15539832;36;38;0.444444444444444;20;16;0.0555555555555556;0.444444444444444
Control.SRR15539832;36;38;0.416666666666667;21;15;0.0833333333333333;0.416666666666667
Control.SRR15539832;40;38;0.325;27;13;0.175;0.325
Control.SRR15539832;33;38;0.606060606060606;13;20;0.106060606060606;0.393939393939394
Control.SRR15539832;37;38;0.540540540540541;17;20;0.0405405405405406;0.459459459459459
Control.SRR15539832;39;38;0.358974358974359;25;14;0.141025641025641;0.358974358974359
Control.SRR15539832;41;38;0.536585365853659;19;22;0.0365853658536586;0.463414634146341
Control.SRR15539832;40;38;0.425;23;17;0.075;0.425
Control.SRR15539832;39;38;0.564102564102564;17;22;0.0641025641025641;0.435897435897436
Control.SRR15539832;42;38;0.476190476190476;22;20;0.0238095238095238;0.476190476190476
Control.SRR15539832;39;38;0.461538461538462;21;18;0.0384615384615384;0.461538461538462
Control.SRR15539832;35;38;0.628571428571429;13;22;0.128571428571429;0.371428571428571
Control.SRR15539832;41;38;0.560975609756098;18;23;0.0609756097560976;0.439024390243902
Control.SRR15539832;36;38;0.5;18;18;0;0.5
Control.SRR15539832;34;38;0.5;17;17;0;0.5
Control.SRR15539832;33;38;0.393939393939394;20;13;0.106060606060606;0.393939393939394
Control.SRR15539832;36;38;0.5;18;18;0;0.5
Control.SRR15539832;38;38;0.578947368421053;16;22;0.0789473684210527;0.421052631578947
Control.SRR15539832;42;38;0.357142857142857;27;15;0.142857142857143;0.357142857142857
Control.SRR15539832;41;38;0.48780487804878;21;20;0.0121951219512195;0.48780487804878
Control.SRR15539832;40;38;0.425;23;17;0.075;0.425
Control.SRR15539832;35;38;0.428571428571429;20;15;0.0714285714285715;0.428571428571429
Control.SRR15539832;34;38;0.617647058823529;13;21;0.117647058823529;0.382352941176471
Control.SRR15539832;43;38;0.488372093023256;22;21;0.0116279069767442;0.488372093023256
Control.SRR15539832;34;38;0.617647058823529;13;21;0.117647058823529;0.382352941176471
Control.SRR15539832;36;38;0.694444444444444;11;25;0.194444444444444;0.305555555555556
Control.SRR15539832;38;38;0.526315789473684;18;20;0.0263157894736842;0.473684210526316
Control.SRR15539832;43;38;0.441860465116279;24;19;0.0581395348837209;0.441860465116279
Control.SRR15539832;33;38;0.515151515151515;16;17;0.0151515151515151;0.484848484848485
Control.SRR15539832;38;38;0.5;19;19;0;0.5
Control.SRR15539832;39;38;0.564102564102564;17;22;0.0641025641025641;0.435897435897436
Control.SRR15539832;33;38;0.575757575757576;14;19;0.0757575757575758;0.424242424242424
Control.SRR15539832;33;38;0.545454545454545;15;18;0.0454545454545454;0.454545454545455
Control.SRR15539832;37;38;0.648648648648649;13;24;0.148648648648649;0.351351351351351
Control.SRR15539832;33;38;0.515151515151515;16;17;0.0151515151515151;0.484848484848485
Control.SRR15539832;36;38;0.555555555555556;16;20;0.0555555555555556;0.444444444444444
Control.SRR15539832;36;38;0.472222222222222;19;17;0.0277777777777778;0.472222222222222
Control.SRR15539832;37;38;0.459459459459459;20;17;0.0405405405405405;0.459459459459459
Control.SRR15539832;42;38;0.476190476190476;22;20;0.0238095238095238;0.476190476190476
Control.SRR15539832;43;38;0.488372093023256;22;21;0.0116279069767442;0.488372093023256
Control.SRR15539832;36;38;0.555555555555556;16;20;0.0555555555555556;0.444444444444444
Control.SRR15539832;37;38;0.459459459459459;20;17;0.0405405405405405;0.459459459459459
Control.SRR15539832;33;38;0.454545454545455;18;15;0.0454545454545455;0.454545454545455
Control.SRR15539832;41;38;0.51219512195122;20;21;0.0121951219512195;0.48780487804878
Control.SRR15539832;39;38;0.538461538461538;18;21;0.0384615384615384;0.461538461538462
Control.SRR15539832;34;38;0.470588235294118;18;16;0.0294117647058824;0.470588235294118
Control.SRR15539832;33;38;0.606060606060606;13;20;0.106060606060606;0.393939393939394
Control.SRR15539832;33;38;0.484848484848485;17;16;0.0151515151515151;0.484848484848485
Control.SRR15539832;34;38;0.617647058823529;13;21;0.117647058823529;0.382352941176471
Control.SRR15539832;42;38;0.666666666666667;14;28;0.166666666666667;0.333333333333333
Control.SRR15539832;35;38;0.571428571428571;15;20;0.0714285714285714;0.428571428571429
Control.SRR15539832;33;38;0.545454545454545;15;18;0.0454545454545454;0.454545454545455
Control.SRR15539832;39;38;0.692307692307692;12;27;0.192307692307692;0.307692307692308
Control.SRR15539832;43;38;0.534883720930233;20;23;0.0348837209302325;0.465116279069767
Control.SRR15539832;38;38;0.578947368421053;16;22;0.0789473684210527;0.421052631578947
Control.SRR15539832;35;38;0.457142857142857;19;16;0.0428571428571429;0.457142857142857
Control.SRR15539832;35;38;0.457142857142857;19;16;0.0428571428571429;0.457142857142857
Control.SRR15539832;37;38;0.432432432432432;21;16;0.0675675675675675;0.432432432432432
Control.SRR15539832;37;38;0.567567567567568;16;21;0.0675675675675675;0.432432432432432
Control.SRR15539832;34;38;0.5;17;17;0;0.5
Control.SRR15539832;38;38;0.5;19;19;0;0.5
Control.SRR15539832;35;38;0.571428571428571;15;20;0.0714285714285714;0.428571428571429
Control.SRR15539832;34;38;0.558823529411765;15;19;0.0588235294117647;0.441176470588235
Control.SRR15539832;35;38;0.628571428571429;13;22;0.128571428571429;0.371428571428571
Control.SRR15539832;39;38;0.41025641025641;23;16;0.0897435897435898;0.41025641025641
Control.SRR15539832;42;38;0.547619047619048;19;23;0.0476190476190477;0.452380952380952
Control.SRR15539832;42;38;0.5;21;21;0;0.5
Control.SRR15539832;36;38;0.638888888888889;13;23;0.138888888888889;0.361111111111111
Control.SRR15539832;43;38;0.581395348837209;18;25;0.0813953488372093;0.418604651162791
Control.SRR15539832;40;38;0.375;25;15;0.125;0.375
Control.SRR15539832;40;38;0.55;18;22;0.05;0.45
Control.SRR15539832;38;38;0.5;19;19;0;0.5
Control.SRR15539832;38;38;0.552631578947368;17;21;0.0526315789473685;0.447368421052632
Control.SRR15539832;37;38;0.540540540540541;17;20;0.0405405405405406;0.459459459459459
Control.SRR15539832;38;38;0.473684210526316;20;18;0.0263157894736842;0.473684210526316
Control.SRR15539832;34;38;0.558823529411765;15;19;0.0588235294117647;0.441176470588235
Control.SRR15539832;40;38;0.525;19;21;0.025;0.475
Control.SRR15539832;43;38;0.534883720930233;20;23;0.0348837209302325;0.465116279069767
Control.SRR15539832;38;38;0.447368421052632;21;17;0.0526315789473684;0.447368421052632
Control.SRR15539832;37;38;0.459459459459459;20;17;0.0405405405405405;0.459459459459459
Control.SRR15539832;34;38;0.323529411764706;23;11;0.176470588235294;0.323529411764706
Control.SRR15539832;36;38;0.527777777777778;17;19;0.0277777777777778;0.472222222222222
Control.SRR15539832;33;38;0.454545454545455;18;15;0.0454545454545455;0.454545454545455
Control.SRR15539832;38;38;0.552631578947368;17;21;0.0526315789473685;0.447368421052632
Control.SRR15539832;37;38;0.594594594594595;15;22;0.0945945945945946;0.405405405405405
Control.SRR15539832;34;38;0.5;17;17;0;0.5
Control.SRR15539832;37;38;0.594594594594595;15;22;0.0945945945945946;0.405405405405405
Control.SRR15539832;43;38;0.534883720930233;20;23;0.0348837209302325;0.465116279069767
Control.SRR15539832;39;38;0.512820512820513;19;20;0.0128205128205128;0.487179487179487
Control.SRR15539832;37;38;0.513513513513513;18;19;0.0135135135135135;0.486486486486487
Control.SRR15539832;43;38;0.488372093023256;22;21;0.0116279069767442;0.488372093023256
Control.SRR15539832;34;38;0.529411764705882;16;18;0.0294117647058824;0.470588235294118
Control.SRR15539832;35;38;0.4;21;14;0.1;0.4
Control.SRR15539832;43;38;0.581395348837209;18;25;0.0813953488372093;0.418604651162791
Control.SRR15539832;41;38;0.463414634146341;22;19;0.0365853658536585;0.463414634146341
Control.SRR15539832;37;38;0.567567567567568;16;21;0.0675675675675675;0.432432432432432
Control.SRR15539832;36;38;0.527777777777778;17;19;0.0277777777777778;0.472222222222222
Control.SRR15539832;35;38;0.342857142857143;23;12;0.157142857142857;0.342857142857143
Control.SRR15539832;36;38;0.416666666666667;21;15;0.0833333333333333;0.416666666666667
Control.SRR15539832;34;38;0.5;17;17;0;0.5
Control.SRR15539832;39;38;0.538461538461538;18;21;0.0384615384615384;0.461538461538462
Control.SRR15539832;36;38;0.416666666666667;21;15;0.0833333333333333;0.416666666666667
Control.SRR15539832;36;38;0.472222222222222;19;17;0.0277777777777778;0.472222222222222
Control.SRR15539832;39;38;0.538461538461538;18;21;0.0384615384615384;0.461538461538462
Control.SRR15539832;35;38;0.485714285714286;18;17;0.0142857142857143;0.485714285714286
Control.SRR15539832;41;38;0.560975609756098;18;23;0.0609756097560976;0.439024390243902
Control.SRR15539832;39;38;0.58974358974359;16;23;0.0897435897435898;0.41025641025641
Control.SRR15539832;33;38;0.333333333333333;22;11;0.166666666666667;0.333333333333333
Control.SRR15539832;36;38;0.444444444444444;20;16;0.0555555555555556;0.444444444444444
Control.SRR15539832;42;38;0.571428571428571;18;24;0.0714285714285714;0.428571428571429
Control.SRR15539832;35;38;0.571428571428571;15;20;0.0714285714285714;0.428571428571429
Control.SRR15539832;33;38;0.575757575757576;14;19;0.0757575757575758;0.424242424242424
Control.SRR15539832;34;38;0.411764705882353;20;14;0.0882352941176471;0.411764705882353
Control.SRR15539832;39;38;0.487179487179487;20;19;0.0128205128205128;0.487179487179487
Control.SRR15539832;33;38;0.606060606060606;13;20;0.106060606060606;0.393939393939394
Control.SRR15539832;36;38;0.416666666666667;21;15;0.0833333333333333;0.416666666666667
Control.SRR15539832;35;38;0.571428571428571;15;20;0.0714285714285714;0.428571428571429
Control.SRR15539832;34;38;0.470588235294118;18;16;0.0294117647058824;0.470588235294118
Control.SRR15539832;36;38;0.416666666666667;21;15;0.0833333333333333;0.416666666666667
Control.SRR15539832;36;38;0.5;18;18;0;0.5
Control.SRR15539832;43;38;0.534883720930233;20;23;0.0348837209302325;0.465116279069767
Control.SRR15539832;43;38;0.441860465116279;24;19;0.0581395348837209;0.441860465116279
Control.SRR15539832;38;38;0.447368421052632;21;17;0.0526315789473684;0.447368421052632
Control.SRR15539832;40;38;0.45;22;18;0.05;0.45
Control.SRR15539832;38;38;0.526315789473684;18;20;0.0263157894736842;0.473684210526316
Control.SRR15539832;37;38;0.405405405405405;22;15;0.0945945945945946;0.405405405405405
Control.SRR15539832;39;38;0.487179487179487;20;19;0.0128205128205128;0.487179487179487
Control.SRR15539832;37;38;0.513513513513513;18;19;0.0135135135135135;0.486486486486487
Control.SRR15539832;40;38;0.475;21;19;0.025;0.475
Control.SRR15539832;43;38;0.604651162790698;17;26;0.104651162790698;0.395348837209302
Control.SRR15539832;37;38;0.405405405405405;22;15;0.0945945945945946;0.405405405405405
Control.SRR15539832;34;38;0.617647058823529;13;21;0.117647058823529;0.382352941176471
Control.SRR15539832;36;38;0.555555555555556;16;20;0.0555555555555556;0.444444444444444
Control.SRR15539832;33;38;0.484848484848485;17;16;0.0151515151515151;0.484848484848485
Control.SRR15539832;36;38;0.638888888888889;13;23;0.138888888888889;0.361111111111111
Control.SRR15539832;40;38;0.475;21;19;0.025;0.475
Control.SRR15539832;40;38;0.375;25;15;0.125;0.375
Control.SRR15539832;41;38;0.463414634146341;22;19;0.0365853658536585;0.463414634146341
Control.SRR15539832;37;38;0.432432432432432;21;16;0.0675675675675675;0.432432432432432
Control.SRR15539832;42;38;0.523809523809524;20;22;0.0238095238095238;0.476190476190476
Control.SRR15539832;43;38;0.418604651162791;25;18;0.0813953488372093;0.418604651162791
Control.SRR15539832;37;38;0.405405405405405;22;15;0.0945945945945946;0.405405405405405
Control.SRR15539832;35;38;0.6;14;21;0.1;0.4
Control.SRR15539832;42;38;0.238095238095238;32;10;0.261904761904762;0.238095238095238
Control.SRR15539832;36;38;0.583333333333333;15;21;0.0833333333333334;0.416666666666667
Control.SRR15539832;42;38;0.452380952380952;23;19;0.0476190476190476;0.452380952380952
Control.SRR15539832;34;38;0.558823529411765;15;19;0.0588235294117647;0.441176470588235
Control.SRR15539832;40;38;0.45;22;18;0.05;0.45
Control.SRR15539832;37;38;0.486486486486487;19;18;0.0135135135135135;0.486486486486487
Control.SRR15539832;38;38;0.5;19;19;0;0.5
Control.SRR15539832;35;38;0.485714285714286;18;17;0.0142857142857143;0.485714285714286
Control.SRR15539832;36;38;0.444444444444444;20;16;0.0555555555555556;0.444444444444444
Control.SRR15539832;41;38;0.463414634146341;22;19;0.0365853658536585;0.463414634146341
Control.SRR15539832;42;38;0.523809523809524;20;22;0.0238095238095238;0.476190476190476
Control.SRR15539832;34;38;0.529411764705882;16;18;0.0294117647058824;0.470588235294118
Control.SRR15539832;33;38;0.363636363636364;21;12;0.136363636363636;0.363636363636364
Control.SRR15539832;42;38;0.523809523809524;20;22;0.0238095238095238;0.476190476190476
Control.SRR15539832;41;38;0.48780487804878;21;20;0.0121951219512195;0.48780487804878
Control.SRR15539832;41;38;0.585365853658537;17;24;0.0853658536585366;0.414634146341463
Control.SRR15539832;42;38;0.357142857142857;27;15;0.142857142857143;0.357142857142857
Control.SRR15539832;38;38;0.473684210526316;20;18;0.0263157894736842;0.473684210526316
Control.SRR15539832;43;38;0.534883720930233;20;23;0.0348837209302325;0.465116279069767
Control.SRR15539832;35;38;0.342857142857143;23;12;0.157142857142857;0.342857142857143
Control.SRR15539832;33;38;0.333333333333333;22;11;0.166666666666667;0.333333333333333
Control.SRR15539832;33;38;0.515151515151515;16;17;0.0151515151515151;0.484848484848485
Control.SRR15539832;42;38;0.428571428571429;24;18;0.0714285714285715;0.428571428571429
Control.SRR15539832;39;38;0.358974358974359;25;14;0.141025641025641;0.358974358974359
Control.SRR15539832;35;38;0.542857142857143;16;19;0.0428571428571428;0.457142857142857
Control.SRR15539832;38;38;0.631578947368421;14;24;0.131578947368421;0.368421052631579
Control.SRR15539832;43;38;0.465116279069767;23;20;0.0348837209302326;0.465116279069767
Control.SRR15539832;37;38;0.540540540540541;17;20;0.0405405405405406;0.459459459459459
Control.SRR15539832;34;38;0.588235294117647;14;20;0.0882352941176471;0.411764705882353
Control.SRR15539832;43;38;0.534883720930233;20;23;0.0348837209302325;0.465116279069767
Control.SRR15539832;42;38;0.547619047619048;19;23;0.0476190476190477;0.452380952380952
Control.SRR15539832;42;38;0.5;21;21;0;0.5
Control.SRR15539832;33;38;0.333333333333333;22;11;0.166666666666667;0.333333333333333
Control.SRR15539832;40;38;0.5;20;20;0;0.5
Control.SRR15539832;33;38;0.484848484848485;17;16;0.0151515151515151;0.484848484848485
Control.SRR15539832;40;38;0.625;15;25;0.125;0.375
Control.SRR15539832;42;38;0.428571428571429;24;18;0.0714285714285715;0.428571428571429
Control.SRR15539832;39;38;0.692307692307692;12;27;0.192307692307692;0.307692307692308
Control.SRR15539832;41;38;0.560975609756098;18;23;0.0609756097560976;0.439024390243902
Control.SRR15539832;40;38;0.6;16;24;0.1;0.4
Control.SRR15539832;33;38;0.484848484848485;17;16;0.0151515151515151;0.484848484848485
Control.SRR15539832;40;38;0.55;18;22;0.05;0.45
Control.SRR15539832;40;38;0.5;20;20;0;0.5
Control.SRR15539832;35;38;0.514285714285714;17;18;0.0142857142857142;0.485714285714286
Control.SRR15539832;41;38;0.536585365853659;19;22;0.0365853658536586;0.463414634146341
Control.SRR15539832;37;38;0.459459459459459;20;17;0.0405405405405405;0.459459459459459
Control.SRR15539832;36;38;0.388888888888889;22;14;0.111111111111111;0.388888888888889
Control.SRR15539832;38;38;0.473684210526316;20;18;0.0263157894736842;0.473684210526316
Control.SRR15539832;39;38;0.564102564102564;17;22;0.0641025641025641;0.435897435897436
Control.SRR15539832;41;38;0.51219512195122;20;21;0.0121951219512195;0.48780487804878
Control.SRR15539832;41;38;0.414634146341463;24;17;0.0853658536585366;0.414634146341463
Control.SRR15539832;38;38;0.578947368421053;16;22;0.0789473684210527;0.421052631578947
Control.SRR15539832;36;38;0.527777777777778;17;19;0.0277777777777778;0.472222222222222
Control.SRR15539832;34;38;0.558823529411765;15;19;0.0588235294117647;0.441176470588235
Control.SRR15539832;33;38;0.575757575757576;14;19;0.0757575757575758;0.424242424242424
Control.SRR15539832;37;38;0.540540540540541;17;20;0.0405405405405406;0.459459459459459
Control.SRR15539832;39;38;0.435897435897436;22;17;0.0641025641025641;0.435897435897436
Control.SRR15539832;36;38;0.527777777777778;17;19;0.0277777777777778;0.472222222222222
Control.SRR15539832;42;38;0.523809523809524;20;22;0.0238095238095238;0.476190476190476
Control.SRR15539832;40;38;0.475;21;19;0.025;0.475
Control.SRR15539832;41;38;0.439024390243902;23;18;0.0609756097560976;0.439024390243902
Control.SRR15539832;42;38;0.380952380952381;26;16;0.119047619047619;0.380952380952381
Control.SRR15539832;36;38;0.361111111111111;23;13;0.138888888888889;0.361111111111111
Control.SRR15539832;33;38;0.484848484848485;17;16;0.0151515151515151;0.484848484848485
Control.SRR15539832;37;38;0.378378378378378;23;14;0.121621621621622;0.378378378378378
Control.SRR15539832;35;38;0.542857142857143;16;19;0.0428571428571428;0.457142857142857
Control.SRR15539832;37;38;0.513513513513513;18;19;0.0135135135135135;0.486486486486487
Control.SRR15539832;42;38;0.5;21;21;0;0.5
Control.SRR15539832;37;38;0.459459459459459;20;17;0.0405405405405405;0.459459459459459
Control.SRR15539832;41;38;0.463414634146341;22;19;0.0365853658536585;0.463414634146341
Control.SRR15539832;43;38;0.488372093023256;22;21;0.0116279069767442;0.488372093023256
Control.SRR15539832;40;38;0.4;24;16;0.1;0.4
Control.SRR15539832;33;38;0.515151515151515;16;17;0.0151515151515151;0.484848484848485
Control.SRR15539832;42;38;0.476190476190476;22;20;0.0238095238095238;0.476190476190476
Control.SRR15539832;33;38;0.575757575757576;14;19;0.0757575757575758;0.424242424242424
Control.SRR15539832;43;38;0.511627906976744;21;22;0.0116279069767442;0.488372093023256
Control.SRR15539832;36;38;0.416666666666667;21;15;0.0833333333333333;0.416666666666667
Control.SRR15539832;41;38;0.51219512195122;20;21;0.0121951219512195;0.48780487804878
Control.SRR15539832;36;38;0.694444444444444;11;25;0.194444444444444;0.305555555555556
Control.SRR15539832;37;38;0.432432432432432;21;16;0.0675675675675675;0.432432432432432
Control.SRR15539832;42;38;0.380952380952381;26;16;0.119047619047619;0.380952380952381
Control.SRR15539832;37;38;0.675675675675676;12;25;0.175675675675676;0.324324324324324
Control.SRR15539832;39;38;0.512820512820513;19;20;0.0128205128205128;0.487179487179487
Control.SRR15539832;43;38;0.558139534883721;19;24;0.0581395348837209;0.441860465116279
Control.SRR15539832;36;38;0.444444444444444;20;16;0.0555555555555556;0.444444444444444
Control.SRR15539832;43;38;0.651162790697674;15;28;0.151162790697674;0.348837209302326
Control.SRR15539832;35;38;0.571428571428571;15;20;0.0714285714285714;0.428571428571429
Control.SRR15539832;36;38;0.5;18;18;0;0.5
Control.SRR15539832;33;38;0.484848484848485;17;16;0.0151515151515151;0.484848484848485
Control.SRR15539832;41;38;0.51219512195122;20;21;0.0121951219512195;0.48780487804878
Control.SRR15539832;43;38;0.511627906976744;21;22;0.0116279069767442;0.488372093023256
Control.SRR15539832;43;38;0.441860465116279;24;19;0.0581395348837209;0.441860465116279
Control.SRR15539832;41;38;0.48780487804878;21;20;0.0121951219512195;0.48780487804878
Control.SRR15539832;33;38;0.272727272727273;24;9;0.227272727272727;0.272727272727273
Control.SRR15539832;33;38;0.575757575757576;14;19;0.0757575757575758;0.424242424242424
Control.SRR15539832;38;38;0.526315789473684;18;20;0.0263157894736842;0.473684210526316
Control.SRR15539832;38;38;0.394736842105263;23;15;0.105263157894737;0.394736842105263
Control.SRR15539832;43;38;0.581395348837209;18;25;0.0813953488372093;0.418604651162791
Control.SRR15539832;35;38;0.6;14;21;0.1;0.4
Control.SRR15539832;41;38;0.536585365853659;19;22;0.0365853658536586;0.463414634146341
Control.SRR15539832;34;38;0.529411764705882;16;18;0.0294117647058824;0.470588235294118
Control.SRR15539832;38;38;0.447368421052632;21;17;0.0526315789473684;0.447368421052632
Control.SRR15539832;34;38;0.558823529411765;15;19;0.0588235294117647;0.441176470588235
Control.SRR15539832;40;38;0.4;24;16;0.1;0.4
Control.SRR15539832;38;38;0.447368421052632;21;17;0.0526315789473684;0.447368421052632
Control.SRR15539832;41;38;0.439024390243902;23;18;0.0609756097560976;0.439024390243902
Control.SRR15539832;37;38;0.567567567567568;16;21;0.0675675675675675;0.432432432432432
Control.SRR15539832;35;38;0.685714285714286;11;24;0.185714285714286;0.314285714285714
Control.SRR15539832;42;38;0.571428571428571;18;24;0.0714285714285714;0.428571428571429
Control.SRR15539832;37;38;0.648648648648649;13;24;0.148648648648649;0.351351351351351
Control.SRR15539832;36;38;0.444444444444444;20;16;0.0555555555555556;0.444444444444444
Control.SRR15539832;42;38;0.571428571428571;18;24;0.0714285714285714;0.428571428571429
Control.SRR15539832;35;38;0.4;21;14;0.1;0.4
Control.SRR15539832;41;38;0.341463414634146;27;14;0.158536585365854;0.341463414634146
Control.SRR15539832;41;38;0.536585365853659;19;22;0.0365853658536586;0.463414634146341
Control.SRR15539832;39;38;0.41025641025641;23;16;0.0897435897435898;0.41025641025641
Control.SRR15539832;38;38;0.447368421052632;21;17;0.0526315789473684;0.447368421052632
Control.SRR15539832;36;38;0.416666666666667;21;15;0.0833333333333333;0.416666666666667
Control.SRR15539832;39;38;0.435897435897436;22;17;0.0641025641025641;0.435897435897436
Control.SRR15539832;38;38;0.605263157894737;15;23;0.105263157894737;0.394736842105263
Control.SRR15539832;37;38;0.513513513513513;18;19;0.0135135135135135;0.486486486486487
Control.SRR15539832;39;38;0.41025641025641;23;16;0.0897435897435898;0.41025641025641
Control.SRR15539832;33;38;0.363636363636364;21;12;0.136363636363636;0.363636363636364
Control.SRR15539832;35;38;0.628571428571429;13;22;0.128571428571429;0.371428571428571
Control.SRR15539832;37;38;0.594594594594595;15;22;0.0945945945945946;0.405405405405405
Control.SRR15539832;34;38;0.470588235294118;18;16;0.0294117647058824;0.470588235294118
Control.SRR15539832;38;38;0.552631578947368;17;21;0.0526315789473685;0.447368421052632
Control.SRR15539832;34;38;0.323529411764706;23;11;0.176470588235294;0.323529411764706
Control.SRR15539832;38;38;0.631578947368421;14;24;0.131578947368421;0.368421052631579
Control.SRR15539832;35;38;0.371428571428571;22;13;0.128571428571429;0.371428571428571
Control.SRR15539832;40;38;0.475;21;19;0.025;0.475
Control.SRR15539832;38;38;0.526315789473684;18;20;0.0263157894736842;0.473684210526316
Control.SRR15539832;41;38;0.585365853658537;17;24;0.0853658536585366;0.414634146341463
Control.SRR15539832;42;38;0.452380952380952;23;19;0.0476190476190476;0.452380952380952
Control.SRR15539832;35;38;0.514285714285714;17;18;0.0142857142857142;0.485714285714286
Control.SRR15539832;40;38;0.625;15;25;0.125;0.375
Control.SRR15539832;40;38;0.425;23;17;0.075;0.425
Control.SRR15539832;43;38;0.511627906976744;21;22;0.0116279069767442;0.488372093023256
Control.SRR15539832;43;38;0.511627906976744;21;22;0.0116279069767442;0.488372093023256
Control.SRR15539832;37;38;0.432432432432432;21;16;0.0675675675675675;0.432432432432432
Control.SRR15539832;42;38;0.523809523809524;20;22;0.0238095238095238;0.476190476190476
Control.SRR15539832;38;38;0.526315789473684;18;20;0.0263157894736842;0.473684210526316
Control.SRR15539832;36;38;0.416666666666667;21;15;0.0833333333333333;0.416666666666667
Control.SRR15539832;33;38;0.454545454545455;18;15;0.0454545454545455;0.454545454545455
Control.SRR15539832;43;38;0.511627906976744;21;22;0.0116279069767442;0.488372093023256
Control.SRR15539832;40;38;0.375;25;15;0.125;0.375
Control.SRR15539832;39;38;0.564102564102564;17;22;0.0641025641025641;0.435897435897436
Control.SRR15539832;39;38;0.615384615384615;15;24;0.115384615384615;0.384615384615385
Control.SRR15539832;37;38;0.432432432432432;21;16;0.0675675675675675;0.432432432432432
Control.SRR15539832;35;38;0.457142857142857;19;16;0.0428571428571429;0.457142857142857
Control.SRR15539832;40;38;0.5;20;20;0;0.5
Control.SRR15539832;36;38;0.472222222222222;19;17;0.0277777777777778;0.472222222222222
Control.SRR15539832;35;38;0.571428571428571;15;20;0.0714285714285714;0.428571428571429
Control.SRR15539832;33;38;0.454545454545455;18;15;0.0454545454545455;0.454545454545455
Control.SRR15539832;36;38;0.777777777777778;8;28;0.277777777777778;0.222222222222222
Control.SRR15539832;39;38;0.564102564102564;17;22;0.0641025641025641;0.435897435897436
Control.SRR15539832;42;38;0.476190476190476;22;20;0.0238095238095238;0.476190476190476
Control.SRR15539832;34;38;0.529411764705882;16;18;0.0294117647058824;0.470588235294118
Control.SRR15539832;42;38;0.595238095238095;17;25;0.0952380952380952;0.404761904761905
Control.SRR15539832;38;38;0.447368421052632;21;17;0.0526315789473684;0.447368421052632
Control.SRR15539832;42;38;0.452380952380952;23;19;0.0476190476190476;0.452380952380952
Control.SRR15539832;33;38;0.424242424242424;19;14;0.0757575757575757;0.424242424242424
Control.SRR15539832;37;38;0.621621621621622;14;23;0.121621621621622;0.378378378378378
Control.SRR15539832;37;38;0.405405405405405;22;15;0.0945945945945946;0.405405405405405
Control.SRR15539832;37;38;0.540540540540541;17;20;0.0405405405405406;0.459459459459459
Control.SRR15539832;37;38;0.567567567567568;16;21;0.0675675675675675;0.432432432432432
Control.SRR15539832;38;38;0.578947368421053;16;22;0.0789473684210527;0.421052631578947
Control.SRR15539832;33;38;0.545454545454545;15;18;0.0454545454545454;0.454545454545455
Control.SRR15539832;35;38;0.514285714285714;17;18;0.0142857142857142;0.485714285714286
Control.SRR15539832;37;38;0.540540540540541;17;20;0.0405405405405406;0.459459459459459
Control.SRR15539832;37;38;0.540540540540541;17;20;0.0405405405405406;0.459459459459459
Control.SRR15539832;35;38;0.571428571428571;15;20;0.0714285714285714;0.428571428571429
Control.SRR15539832;38;38;0.710526315789474;11;27;0.210526315789474;0.289473684210526
Control.SRR15539832;35;38;0.4;21;14;0.1;0.4
Control.SRR15539832;41;38;0.585365853658537;17;24;0.0853658536585366;0.414634146341463
Control.SRR15539832;38;38;0.289473684210526;27;11;0.210526315789474;0.289473684210526
Control.SRR15539832;41;38;0.390243902439024;25;16;0.109756097560976;0.390243902439024
Control.SRR15539832;40;38;0.625;15;25;0.125;0.375
Control.SRR15539832;36;38;0.527777777777778;17;19;0.0277777777777778;0.472222222222222
Control.SRR15539832;42;38;0.428571428571429;24;18;0.0714285714285715;0.428571428571429
Control.SRR15539832;41;38;0.51219512195122;20;21;0.0121951219512195;0.48780487804878
Control.SRR15539832;33;38;0.575757575757576;14;19;0.0757575757575758;0.424242424242424
Control.SRR15539832;34;38;0.470588235294118;18;16;0.0294117647058824;0.470588235294118
Control.SRR15539832;38;38;0.394736842105263;23;15;0.105263157894737;0.394736842105263
Control.SRR15539832;42;38;0.571428571428571;18;24;0.0714285714285714;0.428571428571429
Control.SRR15539832;42;38;0.547619047619048;19;23;0.0476190476190477;0.452380952380952
Control.SRR15539832;33;38;0.363636363636364;21;12;0.136363636363636;0.363636363636364
Control.SRR15539832;43;38;0.255813953488372;32;11;0.244186046511628;0.255813953488372
Control.SRR15539832;40;38;0.55;18;22;0.05;0.45
Control.SRR15539832;35;38;0.514285714285714;17;18;0.0142857142857142;0.485714285714286
Control.SRR15539832;41;38;0.463414634146341;22;19;0.0365853658536585;0.463414634146341
Control.SRR15539832;43;38;0.395348837209302;26;17;0.104651162790698;0.395348837209302
Control.SRR15539832;39;38;0.512820512820513;19;20;0.0128205128205128;0.487179487179487
Control.SRR15539832;33;38;0.363636363636364;21;12;0.136363636363636;0.363636363636364
Control.SRR15539832;35;38;0.514285714285714;17;18;0.0142857142857142;0.485714285714286
Control.SRR15539832;33;38;0.666666666666667;11;22;0.166666666666667;0.333333333333333
Control.SRR15539832;36;38;0.583333333333333;15;21;0.0833333333333334;0.416666666666667
Control.SRR15539832;41;38;0.682926829268293;13;28;0.182926829268293;0.317073170731707
Control.SRR15539832;38;38;0.526315789473684;18;20;0.0263157894736842;0.473684210526316
Control.SRR15539832;35;38;0.4;21;14;0.1;0.4
Control.SRR15539832;41;38;0.536585365853659;19;22;0.0365853658536586;0.463414634146341
Control.SRR15539832;37;38;0.540540540540541;17;20;0.0405405405405406;0.459459459459459
Control.SRR15539832;38;38;0.447368421052632;21;17;0.0526315789473684;0.447368421052632
Control.SRR15539832;38;38;0.526315789473684;18;20;0.0263157894736842;0.473684210526316
Control.SRR15539832;41;38;0.585365853658537;17;24;0.0853658536585366;0.414634146341463
Control.SRR15539832;36;38;0.472222222222222;19;17;0.0277777777777778;0.472222222222222
Control.SRR15539832;37;38;0.459459459459459;20;17;0.0405405405405405;0.459459459459459
Control.SRR15539832;39;38;0.564102564102564;17;22;0.0641025641025641;0.435897435897436
Control.SRR15539832;35;38;0.4;21;14;0.1;0.4
Control.SRR15539832;36;38;0.5;18;18;0;0.5
Control.SRR15539832;40;38;0.475;21;19;0.025;0.475
Control.SRR15539832;35;38;0.514285714285714;17;18;0.0142857142857142;0.485714285714286
Control.SRR15539832;42;38;0.619047619047619;16;26;0.119047619047619;0.380952380952381
Control.SRR15539832;38;38;0.526315789473684;18;20;0.0263157894736842;0.473684210526316
Control.SRR15539832;37;38;0.513513513513513;18;19;0.0135135135135135;0.486486486486487
Control.SRR15539832;33;38;0.666666666666667;11;22;0.166666666666667;0.333333333333333
Control.SRR15539832;39;38;0.564102564102564;17;22;0.0641025641025641;0.435897435897436
Control.SRR15539832;36;38;0.5;18;18;0;0.5
Control.SRR15539832;40;38;0.4;24;16;0.1;0.4
Control.SRR15539832;39;38;0.461538461538462;21;18;0.0384615384615384;0.461538461538462
Control.SRR15539832;40;38;0.55;18;22;0.05;0.45
Control.SRR15539832;42;38;0.5;21;21;0;0.5
Control.SRR15539832;42;38;0.5;21;21;0;0.5
Control.SRR15539832;41;38;0.48780487804878;21;20;0.0121951219512195;0.48780487804878
Control.SRR15539832;33;38;0.545454545454545;15;18;0.0454545454545454;0.454545454545455
Control.SRR15539832;36;38;0.416666666666667;21;15;0.0833333333333333;0.416666666666667
Control.SRR15539832;42;38;0.5;21;21;0;0.5
Control.SRR15539832;43;38;0.488372093023256;22;21;0.0116279069767442;0.488372093023256
Control.SRR15539832;41;38;0.560975609756098;18;23;0.0609756097560976;0.439024390243902
Control.SRR15539832;40;38;0.65;14;26;0.15;0.35
Control.SRR15539832;35;38;0.514285714285714;17;18;0.0142857142857142;0.485714285714286
Control.SRR15539832;33;38;0.484848484848485;17;16;0.0151515151515151;0.484848484848485
Control.SRR15539832;34;38;0.470588235294118;18;16;0.0294117647058824;0.470588235294118
Control.SRR15539832;40;38;0.475;21;19;0.025;0.475
Control.SRR15539832;38;38;0.5;19;19;0;0.5
Control.SRR15539832;36;38;0.388888888888889;22;14;0.111111111111111;0.388888888888889
Control.SRR15539832;36;38;0.527777777777778;17;19;0.0277777777777778;0.472222222222222
Control.SRR15539832;35;38;0.457142857142857;19;16;0.0428571428571429;0.457142857142857
Control.SRR15539832;39;38;0.487179487179487;20;19;0.0128205128205128;0.487179487179487
Control.SRR15539832;38;38;0.5;19;19;0;0.5
Control.SRR15539832;33;38;0.363636363636364;21;12;0.136363636363636;0.363636363636364
Control.SRR15539832;39;38;0.461538461538462;21;18;0.0384615384615384;0.461538461538462
Control.SRR15539832;42;38;0.571428571428571;18;24;0.0714285714285714;0.428571428571429
Control.SRR15539832;40;38;0.45;22;18;0.05;0.45
Control.SRR15539832;36;38;0.555555555555556;16;20;0.0555555555555556;0.444444444444444
Control.SRR15539832;33;38;0.606060606060606;13;20;0.106060606060606;0.393939393939394
Control.SRR15539832;41;38;0.609756097560976;16;25;0.109756097560976;0.390243902439024
Control.SRR15539832;42;38;0.547619047619048;19;23;0.0476190476190477;0.452380952380952
Control.SRR15539832;43;38;0.651162790697674;15;28;0.151162790697674;0.348837209302326
Control.SRR15539832;35;38;0.428571428571429;20;15;0.0714285714285715;0.428571428571429
Control.SRR15539832;41;38;0.341463414634146;27;14;0.158536585365854;0.341463414634146
Control.SRR15539832;43;38;0.465116279069767;23;20;0.0348837209302326;0.465116279069767
Control.SRR15539832;35;38;0.371428571428571;22;13;0.128571428571429;0.371428571428571
Control.SRR15539832;39;38;0.487179487179487;20;19;0.0128205128205128;0.487179487179487
Control.SRR15539832;40;38;0.475;21;19;0.025;0.475
Control.SRR15539832;42;38;0.547619047619048;19;23;0.0476190476190477;0.452380952380952
Control.SRR15539832;38;38;0.473684210526316;20;18;0.0263157894736842;0.473684210526316
Control.SRR15539832;38;38;0.5;19;19;0;0.5
Control.SRR15539832;43;38;0.651162790697674;15;28;0.151162790697674;0.348837209302326
Control.SRR15539832;43;38;0.348837209302326;28;15;0.151162790697674;0.348837209302326
Control.SRR15539832;41;38;0.463414634146341;22;19;0.0365853658536585;0.463414634146341
Control.SRR15539832;42;38;0.523809523809524;20;22;0.0238095238095238;0.476190476190476
Control.SRR15539832;34;38;0.588235294117647;14;20;0.0882352941176471;0.411764705882353
Control.SRR15539832;37;38;0.540540540540541;17;20;0.0405405405405406;0.459459459459459
Control.SRR15539832;36;38;0.472222222222222;19;17;0.0277777777777778;0.472222222222222
Control.SRR15539832;41;38;0.609756097560976;16;25;0.109756097560976;0.390243902439024
Control.SRR15539832;33;38;0.363636363636364;21;12;0.136363636363636;0.363636363636364
Control.SRR15539832;41;38;0.463414634146341;22;19;0.0365853658536585;0.463414634146341
Control.SRR15539832;41;38;0.463414634146341;22;19;0.0365853658536585;0.463414634146341
Control.SRR15539832;40;38;0.45;22;18;0.05;0.45
Control.SRR15539832;41;38;0.48780487804878;21;20;0.0121951219512195;0.48780487804878
Control.SRR15539832;36;38;0.555555555555556;16;20;0.0555555555555556;0.444444444444444
Control.SRR15539832;37;38;0.459459459459459;20;17;0.0405405405405405;0.459459459459459
Control.SRR15539832;41;38;0.463414634146341;22;19;0.0365853658536585;0.463414634146341
Control.SRR15539832;43;38;0.651162790697674;15;28;0.151162790697674;0.348837209302326
Control.SRR15539832;36;38;0.666666666666667;12;24;0.166666666666667;0.333333333333333
Control.SRR15539832;33;38;0.545454545454545;15;18;0.0454545454545454;0.454545454545455
Control.SRR15539832;38;38;0.473684210526316;20;18;0.0263157894736842;0.473684210526316
Control.SRR15539832;42;38;0.595238095238095;17;25;0.0952380952380952;0.404761904761905
Control.SRR15539832;39;38;0.564102564102564;17;22;0.0641025641025641;0.435897435897436
Control.SRR15539832;41;38;0.536585365853659;19;22;0.0365853658536586;0.463414634146341
Control.SRR15539832;37;38;0.621621621621622;14;23;0.121621621621622;0.378378378378378
Control.SRR15539832;33;38;0.515151515151515;16;17;0.0151515151515151;0.484848484848485
Control.SRR15539832;41;38;0.51219512195122;20;21;0.0121951219512195;0.48780487804878
Control.SRR15539832;43;38;0.441860465116279;24;19;0.0581395348837209;0.441860465116279
Control.SRR15539832;33;38;0.575757575757576;14;19;0.0757575757575758;0.424242424242424
Control.SRR15539832;44;38;0.477272727272727;23;21;0.0227272727272727;0.477272727272727
Control.SRR15539832;46;38;0.41304347826087;27;19;0.0869565217391304;0.41304347826087
Control.SRR15539832;41;38;0.48780487804878;21;20;0.0121951219512195;0.48780487804878
Control.SRR15539832;38;38;0.605263157894737;15;23;0.105263157894737;0.394736842105263
Control.SRR15539832;35;38;0.371428571428571;22;13;0.128571428571429;0.371428571428571
Control.SRR15539832;39;38;0.564102564102564;17;22;0.0641025641025641;0.435897435897436
Control.SRR15539832;43;38;0.534883720930233;20;23;0.0348837209302325;0.465116279069767
Control.SRR15539832;38;38;0.552631578947368;17;21;0.0526315789473685;0.447368421052632
Control.SRR15539832;45;38;0.422222222222222;26;19;0.0777777777777778;0.422222222222222
Control.SRR15539832;44;38;0.5;22;22;0;0.5
Control.SRR15539832;44;38;0.409090909090909;26;18;0.0909090909090909;0.409090909090909
Control.SRR15539832;44;38;0.272727272727273;32;12;0.227272727272727;0.272727272727273
Control.SRR15539832;36;38;0.611111111111111;14;22;0.111111111111111;0.388888888888889
Control.SRR15539832;43;38;0.418604651162791;25;18;0.0813953488372093;0.418604651162791
Control.SRR15539832;39;38;0.692307692307692;12;27;0.192307692307692;0.307692307692308
Control.SRR15539832;45;38;0.466666666666667;24;21;0.0333333333333333;0.466666666666667
Control.SRR15539832;41;38;0.560975609756098;18;23;0.0609756097560976;0.439024390243902
Control.SRR15539832;47;38;0.617021276595745;18;29;0.117021276595745;0.382978723404255
Control.SRR15539832;39;38;0.358974358974359;25;14;0.141025641025641;0.358974358974359
Control.SRR15539832;37;38;0.648648648648649;13;24;0.148648648648649;0.351351351351351
Control.SRR15539832;44;38;0.5;22;22;0;0.5
Control.SRR15539832;42;38;0.523809523809524;20;22;0.0238095238095238;0.476190476190476
Control.SRR15539832;44;38;0.613636363636364;17;27;0.113636363636364;0.386363636363636
Control.SRR15539832;42;38;0.571428571428571;18;24;0.0714285714285714;0.428571428571429
Control.SRR15539832;40;38;0.4;24;16;0.1;0.4
Control.SRR15539832;44;38;0.522727272727273;21;23;0.0227272727272727;0.477272727272727
Control.SRR15539832;41;38;0.390243902439024;25;16;0.109756097560976;0.390243902439024
Control.SRR15539832;39;38;0.512820512820513;19;20;0.0128205128205128;0.487179487179487
Control.SRR15539832;40;38;0.55;18;22;0.05;0.45
Control.SRR15539832;41;38;0.48780487804878;21;20;0.0121951219512195;0.48780487804878
Control.SRR15539832;41;38;0.414634146341463;24;17;0.0853658536585366;0.414634146341463
Control.SRR15539832;45;38;0.466666666666667;24;21;0.0333333333333333;0.466666666666667
Control.SRR15539832;35;38;0.428571428571429;20;15;0.0714285714285715;0.428571428571429
Control.SRR15539832;44;38;0.568181818181818;19;25;0.0681818181818182;0.431818181818182
Control.SRR15539832;45;38;0.622222222222222;17;28;0.122222222222222;0.377777777777778
Control.SRR15539832;43;38;0.581395348837209;18;25;0.0813953488372093;0.418604651162791
Control.SRR15539832;38;38;0.368421052631579;24;14;0.131578947368421;0.368421052631579
Control.SRR15539832;36;38;0.444444444444444;20;16;0.0555555555555556;0.444444444444444
Control.SRR15539832;41;38;0.585365853658537;17;24;0.0853658536585366;0.414634146341463
Control.SRR15539832;42;38;0.523809523809524;20;22;0.0238095238095238;0.476190476190476
Control.SRR15539832;40;38;0.525;19;21;0.025;0.475
Control.SRR15539832;41;38;0.536585365853659;19;22;0.0365853658536586;0.463414634146341
Control.SRR15539832;39;38;0.461538461538462;21;18;0.0384615384615384;0.461538461538462
Control.SRR15539832;35;38;0.514285714285714;17;18;0.0142857142857142;0.485714285714286
Control.SRR15539832;35;38;0.514285714285714;17;18;0.0142857142857142;0.485714285714286
Control.SRR15539832;47;38;0.446808510638298;26;21;0.0531914893617021;0.446808510638298
Control.SRR15539832;42;38;0.5;21;21;0;0.5
Control.SRR15539832;35;38;0.542857142857143;16;19;0.0428571428571428;0.457142857142857
Control.SRR15539832;36;38;0.527777777777778;17;19;0.0277777777777778;0.472222222222222
Control.SRR15539832;35;38;0.514285714285714;17;18;0.0142857142857142;0.485714285714286
Control.SRR15539832;43;38;0.534883720930233;20;23;0.0348837209302325;0.465116279069767
Control.SRR15539832;47;38;0.468085106382979;25;22;0.0319148936170213;0.468085106382979
Control.SRR15539832;46;38;0.41304347826087;27;19;0.0869565217391304;0.41304347826087
Control.SRR15539832;41;38;0.463414634146341;22;19;0.0365853658536585;0.463414634146341
Control.SRR15539832;43;38;0.627906976744186;16;27;0.127906976744186;0.372093023255814
Control.SRR15539832;35;38;0.542857142857143;16;19;0.0428571428571428;0.457142857142857
Control.SRR15539832;41;38;0.536585365853659;19;22;0.0365853658536586;0.463414634146341
Control.SRR15539832;39;38;0.512820512820513;19;20;0.0128205128205128;0.487179487179487
Control.SRR15539832;38;38;0.552631578947368;17;21;0.0526315789473685;0.447368421052632
Control.SRR15539832;46;38;0.5;23;23;0;0.5
Control.SRR15539832;42;38;0.30952380952381;29;13;0.19047619047619;0.30952380952381
Control.SRR15539832;41;38;0.390243902439024;25;16;0.109756097560976;0.390243902439024
Control.SRR15539832;37;38;0.459459459459459;20;17;0.0405405405405405;0.459459459459459
Control.SRR15539832;38;38;0.552631578947368;17;21;0.0526315789473685;0.447368421052632
Control.SRR15539832;40;38;0.575;17;23;0.075;0.425
Control.SRR15539832;44;38;0.477272727272727;23;21;0.0227272727272727;0.477272727272727
Control.SRR15539832;36;38;0.555555555555556;16;20;0.0555555555555556;0.444444444444444
Control.SRR15539832;40;38;0.375;25;15;0.125;0.375
Control.SRR15539832;35;38;0.485714285714286;18;17;0.0142857142857143;0.485714285714286
Control.SRR15539832;44;38;0.431818181818182;25;19;0.0681818181818182;0.431818181818182
Control.SRR15539832;43;38;0.418604651162791;25;18;0.0813953488372093;0.418604651162791
Control.SRR15539832;45;38;0.622222222222222;17;28;0.122222222222222;0.377777777777778
Control.SRR15539832;45;38;0.466666666666667;24;21;0.0333333333333333;0.466666666666667
Control.SRR15539832;44;38;0.545454545454545;20;24;0.0454545454545454;0.454545454545455
Control.SRR15539832;46;38;0.58695652173913;19;27;0.0869565217391305;0.41304347826087
Control.SRR15539832;41;38;0.585365853658537;17;24;0.0853658536585366;0.414634146341463
Control.SRR15539832;38;38;0.526315789473684;18;20;0.0263157894736842;0.473684210526316
Control.SRR15539832;41;38;0.609756097560976;16;25;0.109756097560976;0.390243902439024
Control.SRR15539832;36;38;0.555555555555556;16;20;0.0555555555555556;0.444444444444444
Control.SRR15539832;37;38;0.432432432432432;21;16;0.0675675675675675;0.432432432432432
Control.SRR15539832;40;38;0.6;16;24;0.1;0.4
Control.SRR15539832;43;38;0.558139534883721;19;24;0.0581395348837209;0.441860465116279
Control.SRR15539832;47;38;0.617021276595745;18;29;0.117021276595745;0.382978723404255
Control.SRR15539832;38;38;0.473684210526316;20;18;0.0263157894736842;0.473684210526316
Control.SRR15539832;41;38;0.390243902439024;25;16;0.109756097560976;0.390243902439024
Control.SRR15539832;35;38;0.457142857142857;19;16;0.0428571428571429;0.457142857142857
Control.SRR15539832;40;38;0.45;22;18;0.05;0.45
Control.SRR15539832;40;38;0.4;24;16;0.1;0.4
Control.SRR15539832;37;38;0.378378378378378;23;14;0.121621621621622;0.378378378378378
Control.SRR15539832;36;38;0.444444444444444;20;16;0.0555555555555556;0.444444444444444
Control.SRR15539832;43;38;0.581395348837209;18;25;0.0813953488372093;0.418604651162791
Control.SRR15539832;38;38;0.552631578947368;17;21;0.0526315789473685;0.447368421052632
Control.SRR15539832;35;38;0.571428571428571;15;20;0.0714285714285714;0.428571428571429
Control.SRR15539832;44;38;0.431818181818182;25;19;0.0681818181818182;0.431818181818182
Control.SRR15539832;38;38;0.473684210526316;20;18;0.0263157894736842;0.473684210526316
Control.SRR15539832;37;38;0.567567567567568;16;21;0.0675675675675675;0.432432432432432
Control.SRR15539832;38;38;0.552631578947368;17;21;0.0526315789473685;0.447368421052632
Control.SRR15539832;42;38;0.5;21;21;0;0.5
Control.SRR15539832;41;38;0.48780487804878;21;20;0.0121951219512195;0.48780487804878
Control.SRR15539832;40;38;0.4;24;16;0.1;0.4
Control.SRR15539832;42;38;0.619047619047619;16;26;0.119047619047619;0.380952380952381
Control.SRR15539832;39;38;0.564102564102564;17;22;0.0641025641025641;0.435897435897436
Control.SRR15539832;41;38;0.48780487804878;21;20;0.0121951219512195;0.48780487804878
Control.SRR15539832;35;38;0.457142857142857;19;16;0.0428571428571429;0.457142857142857
Control.SRR15539832;42;38;0.547619047619048;19;23;0.0476190476190477;0.452380952380952
Control.SRR15539832;39;38;0.564102564102564;17;22;0.0641025641025641;0.435897435897436
Control.SRR15539832;46;38;0.478260869565217;24;22;0.0217391304347826;0.478260869565217
Control.SRR15539832;42;38;0.452380952380952;23;19;0.0476190476190476;0.452380952380952
Control.SRR15539832;42;38;0.547619047619048;19;23;0.0476190476190477;0.452380952380952
Control.SRR15539832;44;38;0.545454545454545;20;24;0.0454545454545454;0.454545454545455
Control.SRR15539832;46;38;0.456521739130435;25;21;0.0434782608695652;0.456521739130435
Control.SRR15539832;45;38;0.533333333333333;21;24;0.0333333333333333;0.466666666666667
Control.SRR15539832;41;38;0.463414634146341;22;19;0.0365853658536585;0.463414634146341
Control.SRR15539832;43;38;0.488372093023256;22;21;0.0116279069767442;0.488372093023256
Control.SRR15539832;41;38;0.48780487804878;21;20;0.0121951219512195;0.48780487804878
Control.SRR15539832;40;38;0.55;18;22;0.05;0.45
Control.SRR15539832;47;38;0.382978723404255;29;18;0.117021276595745;0.382978723404255
Control.SRR15539832;42;38;0.523809523809524;20;22;0.0238095238095238;0.476190476190476
Control.SRR15539832;44;38;0.431818181818182;25;19;0.0681818181818182;0.431818181818182
Control.SRR15539832;35;38;0.457142857142857;19;16;0.0428571428571429;0.457142857142857
Control.SRR15539832;37;38;0.486486486486487;19;18;0.0135135135135135;0.486486486486487
Control.SRR15539832;39;38;0.41025641025641;23;16;0.0897435897435898;0.41025641025641
Control.SRR15539832;37;38;0.540540540540541;17;20;0.0405405405405406;0.459459459459459
Control.SRR15539832;40;38;0.5;20;20;0;0.5
Control.SRR15539832;42;38;0.5;21;21;0;0.5
Control.SRR15539832;37;38;0.540540540540541;17;20;0.0405405405405406;0.459459459459459
Control.SRR15539832;42;38;0.666666666666667;14;28;0.166666666666667;0.333333333333333
Control.SRR15539832;37;38;0.486486486486487;19;18;0.0135135135135135;0.486486486486487
Control.SRR15539832;43;38;0.511627906976744;21;22;0.0116279069767442;0.488372093023256
Control.SRR15539832;40;38;0.625;15;25;0.125;0.375
Control.SRR15539832;45;38;0.466666666666667;24;21;0.0333333333333333;0.466666666666667
Control.SRR15539832;41;38;0.585365853658537;17;24;0.0853658536585366;0.414634146341463
Control.SRR15539832;36;38;0.5;18;18;0;0.5
Control.SRR15539832;44;38;0.454545454545455;24;20;0.0454545454545455;0.454545454545455
Control.SRR15539832;35;38;0.485714285714286;18;17;0.0142857142857143;0.485714285714286
Control.SRR15539832;47;38;0.51063829787234;23;24;0.0106382978723404;0.48936170212766
Control.SRR15539832;42;38;0.380952380952381;26;16;0.119047619047619;0.380952380952381
Control.SRR15539832;44;38;0.477272727272727;23;21;0.0227272727272727;0.477272727272727
Control.SRR15539832;41;38;0.439024390243902;23;18;0.0609756097560976;0.439024390243902
Control.SRR15539832;45;38;0.422222222222222;26;19;0.0777777777777778;0.422222222222222
Control.SRR15539832;42;38;0.523809523809524;20;22;0.0238095238095238;0.476190476190476
Control.SRR15539832;40;38;0.425;23;17;0.075;0.425
Control.SRR15539832;35;38;0.514285714285714;17;18;0.0142857142857142;0.485714285714286
Control.SRR15539832;43;38;0.558139534883721;19;24;0.0581395348837209;0.441860465116279
Control.SRR15539832;44;38;0.386363636363636;27;17;0.113636363636364;0.386363636363636
Control.SRR15539832;42;38;0.404761904761905;25;17;0.0952380952380952;0.404761904761905
Control.SRR15539832;43;38;0.488372093023256;22;21;0.0116279069767442;0.488372093023256
Control.SRR15539832;38;38;0.526315789473684;18;20;0.0263157894736842;0.473684210526316
Control.SRR15539832;36;38;0.527777777777778;17;19;0.0277777777777778;0.472222222222222
Control.SRR15539832;45;38;0.422222222222222;26;19;0.0777777777777778;0.422222222222222
Control.SRR15539832;37;38;0.486486486486487;19;18;0.0135135135135135;0.486486486486487
Control.SRR15539832;44;38;0.477272727272727;23;21;0.0227272727272727;0.477272727272727
Control.SRR15539832;45;38;0.444444444444444;25;20;0.0555555555555556;0.444444444444444
Control.SRR15539832;38;38;0.5;19;19;0;0.5
Control.SRR15539832;43;38;0.418604651162791;25;18;0.0813953488372093;0.418604651162791
Control.SRR15539832;42;38;0.547619047619048;19;23;0.0476190476190477;0.452380952380952
Control.SRR15539832;43;38;0.581395348837209;18;25;0.0813953488372093;0.418604651162791
Control.SRR15539832;43;38;0.604651162790698;17;26;0.104651162790698;0.395348837209302
Control.SRR15539832;39;38;0.512820512820513;19;20;0.0128205128205128;0.487179487179487
Control.SRR15539832;35;38;0.457142857142857;19;16;0.0428571428571429;0.457142857142857
Control.SRR15539832;41;38;0.439024390243902;23;18;0.0609756097560976;0.439024390243902
Control.SRR15539832;42;38;0.547619047619048;19;23;0.0476190476190477;0.452380952380952
Control.SRR15539832;42;38;0.404761904761905;25;17;0.0952380952380952;0.404761904761905
Control.SRR15539832;44;38;0.613636363636364;17;27;0.113636363636364;0.386363636363636
Control.SRR15539832;46;38;0.5;23;23;0;0.5
Control.SRR15539832;42;38;0.428571428571429;24;18;0.0714285714285715;0.428571428571429
Control.SRR15539832;42;38;0.595238095238095;17;25;0.0952380952380952;0.404761904761905
Control.SRR15539832;42;38;0.619047619047619;16;26;0.119047619047619;0.380952380952381
Control.SRR15539832;46;38;0.58695652173913;19;27;0.0869565217391305;0.41304347826087
Control.SRR15539832;46;38;0.456521739130435;25;21;0.0434782608695652;0.456521739130435
Control.SRR15539832;40;38;0.525;19;21;0.025;0.475
Control.SRR15539832;39;38;0.538461538461538;18;21;0.0384615384615384;0.461538461538462
Control.SRR15539832;41;38;0.439024390243902;23;18;0.0609756097560976;0.439024390243902
Control.SRR15539832;38;38;0.5;19;19;0;0.5
Control.SRR15539832;35;38;0.485714285714286;18;17;0.0142857142857143;0.485714285714286
Control.SRR15539832;38;38;0.5;19;19;0;0.5
Control.SRR15539832;40;38;0.5;20;20;0;0.5
Control.SRR15539832;35;38;0.6;14;21;0.1;0.4
Control.SRR15539832;37;38;0.513513513513513;18;19;0.0135135135135135;0.486486486486487
Control.SRR15539832;44;38;0.545454545454545;20;24;0.0454545454545454;0.454545454545455
Control.SRR15539832;38;38;0.631578947368421;14;24;0.131578947368421;0.368421052631579
Control.SRR15539832;41;38;0.463414634146341;22;19;0.0365853658536585;0.463414634146341
Control.SRR15539832;39;38;0.58974358974359;16;23;0.0897435897435898;0.41025641025641
Control.SRR15539832;39;38;0.487179487179487;20;19;0.0128205128205128;0.487179487179487
Control.SRR15539832;45;38;0.511111111111111;22;23;0.0111111111111111;0.488888888888889
Control.SRR15539832;46;38;0.41304347826087;27;19;0.0869565217391304;0.41304347826087
Control.SRR15539832;42;38;0.5;21;21;0;0.5
Control.SRR15539832;42;38;0.452380952380952;23;19;0.0476190476190476;0.452380952380952
Control.SRR15539832;35;38;0.485714285714286;18;17;0.0142857142857143;0.485714285714286
Control.SRR15539832;39;38;0.333333333333333;26;13;0.166666666666667;0.333333333333333
Control.SRR15539832;39;38;0.512820512820513;19;20;0.0128205128205128;0.487179487179487
Control.SRR15539832;37;38;0.459459459459459;20;17;0.0405405405405405;0.459459459459459
Control.SRR15539832;42;38;0.428571428571429;24;18;0.0714285714285715;0.428571428571429
Control.SRR15539832;38;38;0.421052631578947;22;16;0.0789473684210527;0.421052631578947
Control.SRR15539832;39;38;0.512820512820513;19;20;0.0128205128205128;0.487179487179487
Control.SRR15539832;35;38;0.428571428571429;20;15;0.0714285714285715;0.428571428571429
Control.SRR15539832;45;38;0.555555555555556;20;25;0.0555555555555556;0.444444444444444
Control.SRR15539832;37;38;0.567567567567568;16;21;0.0675675675675675;0.432432432432432
Control.SRR15539832;40;38;0.6;16;24;0.1;0.4
Control.SRR15539832;46;38;0.630434782608696;17;29;0.130434782608696;0.369565217391304
Control.SRR15539832;45;38;0.488888888888889;23;22;0.0111111111111111;0.488888888888889
Control.SRR15539832;37;38;0.540540540540541;17;20;0.0405405405405406;0.459459459459459
Control.SRR15539832;40;38;0.475;21;19;0.025;0.475
Control.SRR15539832;39;38;0.538461538461538;18;21;0.0384615384615384;0.461538461538462
Control.SRR15539832;41;38;0.414634146341463;24;17;0.0853658536585366;0.414634146341463
Control.SRR15539832;40;38;0.5;20;20;0;0.5
Control.SRR15539832;37;38;0.459459459459459;20;17;0.0405405405405405;0.459459459459459
Control.SRR15539832;37;38;0.486486486486487;19;18;0.0135135135135135;0.486486486486487
Control.SRR15539832;37;38;0.432432432432432;21;16;0.0675675675675675;0.432432432432432
Control.SRR15539832;39;38;0.487179487179487;20;19;0.0128205128205128;0.487179487179487
Control.SRR15539832;44;38;0.409090909090909;26;18;0.0909090909090909;0.409090909090909
Control.SRR15539832;43;38;0.465116279069767;23;20;0.0348837209302326;0.465116279069767
Control.SRR15539832;46;38;0.58695652173913;19;27;0.0869565217391305;0.41304347826087
Control.SRR15539832;47;38;0.446808510638298;26;21;0.0531914893617021;0.446808510638298
Control.SRR15539832;47;38;0.425531914893617;27;20;0.074468085106383;0.425531914893617
Control.SRR15539832;40;38;0.6;16;24;0.1;0.4
Control.SRR15539832;44;38;0.522727272727273;21;23;0.0227272727272727;0.477272727272727
Control.SRR15539832;36;38;0.555555555555556;16;20;0.0555555555555556;0.444444444444444
Control.SRR15539832;43;38;0.488372093023256;22;21;0.0116279069767442;0.488372093023256
Control.SRR15539832;41;38;0.536585365853659;19;22;0.0365853658536586;0.463414634146341
Control.SRR15539832;35;38;0.485714285714286;18;17;0.0142857142857143;0.485714285714286
Control.SRR15539832;46;38;0.565217391304348;20;26;0.0652173913043478;0.434782608695652
Control.SRR15539832;39;38;0.615384615384615;15;24;0.115384615384615;0.384615384615385
Control.SRR15539832;40;38;0.55;18;22;0.05;0.45
Control.SRR15539832;35;38;0.457142857142857;19;16;0.0428571428571429;0.457142857142857
Control.SRR15539832;41;38;0.585365853658537;17;24;0.0853658536585366;0.414634146341463
Control.SRR15539832;46;38;0.369565217391304;29;17;0.130434782608696;0.369565217391304
Control.SRR15539832;46;38;0.5;23;23;0;0.5
Control.SRR15539832;44;38;0.568181818181818;19;25;0.0681818181818182;0.431818181818182
Control.SRR15539832;37;38;0.675675675675676;12;25;0.175675675675676;0.324324324324324
Control.SRR15539832;44;38;0.522727272727273;21;23;0.0227272727272727;0.477272727272727
Control.SRR15539832;42;38;0.452380952380952;23;19;0.0476190476190476;0.452380952380952
Control.SRR15539832;44;38;0.431818181818182;25;19;0.0681818181818182;0.431818181818182
Control.SRR15539832;41;38;0.48780487804878;21;20;0.0121951219512195;0.48780487804878
Control.SRR15539832;35;38;0.514285714285714;17;18;0.0142857142857142;0.485714285714286
Control.SRR15539832;43;38;0.581395348837209;18;25;0.0813953488372093;0.418604651162791
Control.SRR15539832;39;38;0.461538461538462;21;18;0.0384615384615384;0.461538461538462
Control.SRR15539832;42;38;0.428571428571429;24;18;0.0714285714285715;0.428571428571429
Control.SRR15539832;42;38;0.523809523809524;20;22;0.0238095238095238;0.476190476190476
Control.SRR15539832;46;38;0.456521739130435;25;21;0.0434782608695652;0.456521739130435
Control.SRR15539832;36;38;0.333333333333333;24;12;0.166666666666667;0.333333333333333
Control.SRR15539832;46;38;0.41304347826087;27;19;0.0869565217391304;0.41304347826087
Control.SRR15539832;39;38;0.487179487179487;20;19;0.0128205128205128;0.487179487179487
Control.SRR15539832;36;38;0.555555555555556;16;20;0.0555555555555556;0.444444444444444
Control.SRR15539832;47;38;0.553191489361702;21;26;0.0531914893617021;0.446808510638298
Control.SRR15539832;39;38;0.435897435897436;22;17;0.0641025641025641;0.435897435897436
Control.SRR15539832;44;38;0.431818181818182;25;19;0.0681818181818182;0.431818181818182
Control.SRR15539832;43;38;0.627906976744186;16;27;0.127906976744186;0.372093023255814
Control.SRR15539832;46;38;0.434782608695652;26;20;0.0652173913043478;0.434782608695652
Control.SRR15539832;42;38;0.547619047619048;19;23;0.0476190476190477;0.452380952380952
Control.SRR15539832;42;38;0.571428571428571;18;24;0.0714285714285714;0.428571428571429
Control.SRR15539832;38;38;0.368421052631579;24;14;0.131578947368421;0.368421052631579
Control.SRR15539832;43;38;0.441860465116279;24;19;0.0581395348837209;0.441860465116279
Control.SRR15539832;40;38;0.55;18;22;0.05;0.45
Control.SRR15539832;46;38;0.5;23;23;0;0.5
Control.SRR15539832;42;38;0.571428571428571;18;24;0.0714285714285714;0.428571428571429
Control.SRR15539832;45;38;0.511111111111111;22;23;0.0111111111111111;0.488888888888889
Control.SRR15539832;44;38;0.477272727272727;23;21;0.0227272727272727;0.477272727272727
Control.SRR15539832;46;38;0.478260869565217;24;22;0.0217391304347826;0.478260869565217
Control.SRR15539832;43;38;0.558139534883721;19;24;0.0581395348837209;0.441860465116279
Control.SRR15539832;39;38;0.461538461538462;21;18;0.0384615384615384;0.461538461538462
Control.SRR15539832;42;38;0.476190476190476;22;20;0.0238095238095238;0.476190476190476
Control.SRR15539832;43;38;0.465116279069767;23;20;0.0348837209302326;0.465116279069767
Control.SRR15539832;38;38;0.342105263157895;25;13;0.157894736842105;0.342105263157895
Control.SRR15539832;45;38;0.488888888888889;23;22;0.0111111111111111;0.488888888888889
Control.SRR15539832;45;38;0.577777777777778;19;26;0.0777777777777777;0.422222222222222
Control.SRR15539832;36;38;0.527777777777778;17;19;0.0277777777777778;0.472222222222222
Control.SRR15539832;44;38;0.613636363636364;17;27;0.113636363636364;0.386363636363636
Control.SRR15539832;40;38;0.55;18;22;0.05;0.45
Control.SRR15539832;39;38;0.538461538461538;18;21;0.0384615384615384;0.461538461538462
Control.SRR15539832;35;38;0.542857142857143;16;19;0.0428571428571428;0.457142857142857
Control.SRR15539832;40;38;0.325;27;13;0.175;0.325
Control.SRR15539832;44;38;0.477272727272727;23;21;0.0227272727272727;0.477272727272727
Control.SRR15539832;41;38;0.463414634146341;22;19;0.0365853658536585;0.463414634146341
Control.SRR15539832;44;38;0.568181818181818;19;25;0.0681818181818182;0.431818181818182
Control.SRR15539832;45;38;0.622222222222222;17;28;0.122222222222222;0.377777777777778
Control.SRR15539832;45;38;0.4;27;18;0.1;0.4
Control.SRR15539832;42;38;0.357142857142857;27;15;0.142857142857143;0.357142857142857
Control.SRR15539832;47;38;0.468085106382979;25;22;0.0319148936170213;0.468085106382979
Control.SRR15539832;43;38;0.511627906976744;21;22;0.0116279069767442;0.488372093023256
Control.SRR15539832;36;38;0.527777777777778;17;19;0.0277777777777778;0.472222222222222
Control.SRR15539832;35;38;0.428571428571429;20;15;0.0714285714285715;0.428571428571429
Control.SRR15539832;42;38;0.404761904761905;25;17;0.0952380952380952;0.404761904761905
Control.SRR15539832;40;38;0.55;18;22;0.05;0.45
Control.SRR15539832;40;38;0.625;15;25;0.125;0.375
Control.SRR15539832;45;38;0.422222222222222;26;19;0.0777777777777778;0.422222222222222
Control.SRR15539832;43;38;0.418604651162791;25;18;0.0813953488372093;0.418604651162791
Control.SRR15539832;44;38;0.545454545454545;20;24;0.0454545454545454;0.454545454545455
Control.SRR15539832;47;38;0.382978723404255;29;18;0.117021276595745;0.382978723404255
Control.SRR15539832;44;38;0.522727272727273;21;23;0.0227272727272727;0.477272727272727
Control.SRR15539832;44;38;0.477272727272727;23;21;0.0227272727272727;0.477272727272727
Control.SRR15539832;47;38;0.425531914893617;27;20;0.074468085106383;0.425531914893617
Control.SRR15539832;44;38;0.477272727272727;23;21;0.0227272727272727;0.477272727272727
Control.SRR15539832;40;38;0.475;21;19;0.025;0.475
Control.SRR15539832;39;38;0.435897435897436;22;17;0.0641025641025641;0.435897435897436
Control.SRR15539832;47;38;0.617021276595745;18;29;0.117021276595745;0.382978723404255
Control.SRR15539832;42;38;0.571428571428571;18;24;0.0714285714285714;0.428571428571429
Control.SRR15539832;39;38;0.564102564102564;17;22;0.0641025641025641;0.435897435897436
Control.SRR15539832;36;38;0.388888888888889;22;14;0.111111111111111;0.388888888888889
Control.SRR15539832;41;38;0.51219512195122;20;21;0.0121951219512195;0.48780487804878
Control.SRR15539832;35;38;0.6;14;21;0.1;0.4
Control.SRR15539832;40;38;0.4;24;16;0.1;0.4
Control.SRR15539832;42;38;0.595238095238095;17;25;0.0952380952380952;0.404761904761905
Control.SRR15539832;36;38;0.5;18;18;0;0.5
Control.SRR15539832;36;38;0.444444444444444;20;16;0.0555555555555556;0.444444444444444
Control.SRR15539832;34;38;0.411764705882353;20;14;0.0882352941176471;0.411764705882353
Control.SRR15539832;37;38;0.594594594594595;15;22;0.0945945945945946;0.405405405405405
Control.SRR15539832;41;38;0.51219512195122;20;21;0.0121951219512195;0.48780487804878
Control.SRR15539832;40;38;0.575;17;23;0.075;0.425
Control.SRR15539832;42;38;0.666666666666667;14;28;0.166666666666667;0.333333333333333
Control.SRR15539832;34;38;0.676470588235294;11;23;0.176470588235294;0.323529411764706
Control.SRR15539832;35;38;0.6;14;21;0.1;0.4
Control.SRR15539832;34;38;0.470588235294118;18;16;0.0294117647058824;0.470588235294118
Control.SRR15539832;39;38;0.58974358974359;16;23;0.0897435897435898;0.41025641025641
Control.SRR15539832;42;38;0.476190476190476;22;20;0.0238095238095238;0.476190476190476
Control.SRR15539832;35;38;0.571428571428571;15;20;0.0714285714285714;0.428571428571429
Control.SRR15539832;39;38;0.615384615384615;15;24;0.115384615384615;0.384615384615385
Control.SRR15539832;42;38;0.404761904761905;25;17;0.0952380952380952;0.404761904761905
Control.SRR15539832;41;38;0.51219512195122;20;21;0.0121951219512195;0.48780487804878
Control.SRR15539832;33;38;0.545454545454545;15;18;0.0454545454545454;0.454545454545455
Control.SRR15539832;35;38;0.542857142857143;16;19;0.0428571428571428;0.457142857142857
Control.SRR15539832;33;38;0.575757575757576;14;19;0.0757575757575758;0.424242424242424
Control.SRR15539832;40;38;0.425;23;17;0.075;0.425
Control.SRR15539832;34;38;0.735294117647059;9;25;0.235294117647059;0.264705882352941
Control.SRR15539832;38;38;0.526315789473684;18;20;0.0263157894736842;0.473684210526316
Control.SRR15539832;32;38;0.40625;19;13;0.09375;0.40625
Control.SRR15539832;40;38;0.4;24;16;0.1;0.4
Control.SRR15539832;33;38;0.484848484848485;17;16;0.0151515151515151;0.484848484848485
Control.SRR15539832;42;38;0.595238095238095;17;25;0.0952380952380952;0.404761904761905
Control.SRR15539832;35;38;0.514285714285714;17;18;0.0142857142857142;0.485714285714286
Control.SRR15539832;35;38;0.542857142857143;16;19;0.0428571428571428;0.457142857142857
Control.SRR15539832;41;38;0.463414634146341;22;19;0.0365853658536585;0.463414634146341
Control.SRR15539832;37;38;0.540540540540541;17;20;0.0405405405405406;0.459459459459459
Control.SRR15539832;37;38;0.594594594594595;15;22;0.0945945945945946;0.405405405405405
Control.SRR15539832;37;38;0.567567567567568;16;21;0.0675675675675675;0.432432432432432
Control.SRR15539832;33;38;0.515151515151515;16;17;0.0151515151515151;0.484848484848485
Control.SRR15539832;32;38;0.5;16;16;0;0.5
Control.SRR15539832;41;38;0.439024390243902;23;18;0.0609756097560976;0.439024390243902
Control.SRR15539832;36;38;0.416666666666667;21;15;0.0833333333333333;0.416666666666667
Control.SRR15539832;37;38;0.540540540540541;17;20;0.0405405405405406;0.459459459459459
Control.SRR15539832;41;38;0.51219512195122;20;21;0.0121951219512195;0.48780487804878
Control.SRR15539832;33;38;0.484848484848485;17;16;0.0151515151515151;0.484848484848485
Control.SRR15539832;32;38;0.4375;18;14;0.0625;0.4375
Control.SRR15539832;38;38;0.473684210526316;20;18;0.0263157894736842;0.473684210526316
Control.SRR15539832;40;38;0.625;15;25;0.125;0.375
Control.SRR15539832;37;38;0.567567567567568;16;21;0.0675675675675675;0.432432432432432
Control.SRR15539832;32;38;0.625;12;20;0.125;0.375
Control.SRR15539832;38;38;0.473684210526316;20;18;0.0263157894736842;0.473684210526316
Control.SRR15539832;33;38;0.515151515151515;16;17;0.0151515151515151;0.484848484848485
Control.SRR15539832;41;38;0.560975609756098;18;23;0.0609756097560976;0.439024390243902
Control.SRR15539832;41;38;0.560975609756098;18;23;0.0609756097560976;0.439024390243902
Control.SRR15539832;37;38;0.459459459459459;20;17;0.0405405405405405;0.459459459459459
Control.SRR15539832;33;38;0.454545454545455;18;15;0.0454545454545455;0.454545454545455
Control.SRR15539832;37;38;0.486486486486487;19;18;0.0135135135135135;0.486486486486487
Control.SRR15539832;42;38;0.452380952380952;23;19;0.0476190476190476;0.452380952380952
Control.SRR15539832;34;38;0.441176470588235;19;15;0.0588235294117647;0.441176470588235
Control.SRR15539832;32;38;0.28125;23;9;0.21875;0.28125
Control.SRR15539832;32;38;0.5625;14;18;0.0625;0.4375
Control.SRR15539832;35;38;0.485714285714286;18;17;0.0142857142857143;0.485714285714286
Control.SRR15539832;41;38;0.609756097560976;16;25;0.109756097560976;0.390243902439024
Control.SRR15539832;33;38;0.454545454545455;18;15;0.0454545454545455;0.454545454545455
Control.SRR15539832;32;38;0.40625;19;13;0.09375;0.40625
Control.SRR15539832;42;38;0.238095238095238;32;10;0.261904761904762;0.238095238095238
Control.SRR15539832;38;38;0.447368421052632;21;17;0.0526315789473684;0.447368421052632
Control.SRR15539832;38;38;0.552631578947368;17;21;0.0526315789473685;0.447368421052632
Control.SRR15539832;42;38;0.571428571428571;18;24;0.0714285714285714;0.428571428571429
Control.SRR15539832;42;38;0.5;21;21;0;0.5
Control.SRR15539832;33;38;0.484848484848485;17;16;0.0151515151515151;0.484848484848485
Control.SRR15539832;37;38;0.459459459459459;20;17;0.0405405405405405;0.459459459459459
Control.SRR15539832;40;38;0.425;23;17;0.075;0.425
Control.SRR15539832;32;38;0.375;20;12;0.125;0.375
Control.SRR15539832;37;38;0.459459459459459;20;17;0.0405405405405405;0.459459459459459
Control.SRR15539832;40;38;0.6;16;24;0.1;0.4
Control.SRR15539832;37;38;0.405405405405405;22;15;0.0945945945945946;0.405405405405405
Control.SRR15539832;42;38;0.285714285714286;30;12;0.214285714285714;0.285714285714286
Control.SRR15539832;33;38;0.545454545454545;15;18;0.0454545454545454;0.454545454545455
Control.SRR15539832;42;38;0.357142857142857;27;15;0.142857142857143;0.357142857142857
Control.SRR15539832;42;38;0.428571428571429;24;18;0.0714285714285715;0.428571428571429
Control.SRR15539832;34;38;0.382352941176471;21;13;0.117647058823529;0.382352941176471
Control.SRR15539832;34;38;0.411764705882353;20;14;0.0882352941176471;0.411764705882353
Control.SRR15539832;35;38;0.485714285714286;18;17;0.0142857142857143;0.485714285714286
Control.SRR15539832;37;38;0.351351351351351;24;13;0.148648648648649;0.351351351351351
Control.SRR15539832;34;38;0.529411764705882;16;18;0.0294117647058824;0.470588235294118
Control.SRR15539832;33;38;0.515151515151515;16;17;0.0151515151515151;0.484848484848485
Control.SRR15539832;42;38;0.452380952380952;23;19;0.0476190476190476;0.452380952380952
Control.SRR15539832;33;38;0.606060606060606;13;20;0.106060606060606;0.393939393939394
Control.SRR15539832;35;38;0.6;14;21;0.1;0.4
Control.SRR15539832;35;38;0.371428571428571;22;13;0.128571428571429;0.371428571428571
Control.SRR15539832;32;38;0.34375;21;11;0.15625;0.34375
Control.SRR15539832;39;38;0.358974358974359;25;14;0.141025641025641;0.358974358974359
Control.SRR15539832;34;38;0.529411764705882;16;18;0.0294117647058824;0.470588235294118
Control.SRR15539832;34;38;0.352941176470588;22;12;0.147058823529412;0.352941176470588
Control.SRR15539832;35;38;0.571428571428571;15;20;0.0714285714285714;0.428571428571429
Control.SRR15539832;39;38;0.564102564102564;17;22;0.0641025641025641;0.435897435897436
Control.SRR15539832;38;38;0.447368421052632;21;17;0.0526315789473684;0.447368421052632
Control.SRR15539832;37;38;0.594594594594595;15;22;0.0945945945945946;0.405405405405405
Control.SRR15539832;42;38;0.547619047619048;19;23;0.0476190476190477;0.452380952380952
Control.SRR15539832;36;38;0.527777777777778;17;19;0.0277777777777778;0.472222222222222
Control.SRR15539832;38;38;0.289473684210526;27;11;0.210526315789474;0.289473684210526
Control.SRR15539832;33;38;0.545454545454545;15;18;0.0454545454545454;0.454545454545455
Control.SRR15539832;38;38;0.552631578947368;17;21;0.0526315789473685;0.447368421052632
Control.SRR15539832;36;38;0.5;18;18;0;0.5
Control.SRR15539832;33;38;0.515151515151515;16;17;0.0151515151515151;0.484848484848485
Control.SRR15539832;32;38;0.25;24;8;0.25;0.25
Control.SRR15539832;32;38;0.53125;15;17;0.03125;0.46875
Control.SRR15539832;40;38;0.675;13;27;0.175;0.325
Control.SRR15539832;39;38;0.512820512820513;19;20;0.0128205128205128;0.487179487179487
Control.SRR15539832;42;38;0.5;21;21;0;0.5
Control.SRR15539832;36;38;0.444444444444444;20;16;0.0555555555555556;0.444444444444444
Control.SRR15539832;38;38;0.605263157894737;15;23;0.105263157894737;0.394736842105263
Control.SRR15539832;32;38;0.5;16;16;0;0.5
Control.SRR15539832;35;38;0.485714285714286;18;17;0.0142857142857143;0.485714285714286
Control.SRR15539832;41;38;0.536585365853659;19;22;0.0365853658536586;0.463414634146341
Control.SRR15539832;35;38;0.542857142857143;16;19;0.0428571428571428;0.457142857142857
Control.SRR15539832;40;38;0.55;18;22;0.05;0.45
Control.SRR15539832;41;38;0.51219512195122;20;21;0.0121951219512195;0.48780487804878
Control.SRR15539832;39;38;0.512820512820513;19;20;0.0128205128205128;0.487179487179487
Control.SRR15539832;35;38;0.457142857142857;19;16;0.0428571428571429;0.457142857142857
Control.SRR15539832;36;38;0.527777777777778;17;19;0.0277777777777778;0.472222222222222
Control.SRR15539832;40;38;0.425;23;17;0.075;0.425
Control.SRR15539832;42;38;0.547619047619048;19;23;0.0476190476190477;0.452380952380952
Control.SRR15539832;41;38;0.51219512195122;20;21;0.0121951219512195;0.48780487804878
Control.SRR15539832;42;38;0.547619047619048;19;23;0.0476190476190477;0.452380952380952
Control.SRR15539832;38;38;0.473684210526316;20;18;0.0263157894736842;0.473684210526316
Control.SRR15539832;40;38;0.625;15;25;0.125;0.375
Control.SRR15539832;42;38;0.5;21;21;0;0.5
Control.SRR15539832;35;38;0.428571428571429;20;15;0.0714285714285715;0.428571428571429
Control.SRR15539832;39;38;0.41025641025641;23;16;0.0897435897435898;0.41025641025641
Control.SRR15539832;38;38;0.5;19;19;0;0.5
Control.SRR15539832;33;38;0.696969696969697;10;23;0.196969696969697;0.303030303030303
Control.SRR15539832;41;38;0.51219512195122;20;21;0.0121951219512195;0.48780487804878
Control.SRR15539832;37;38;0.540540540540541;17;20;0.0405405405405406;0.459459459459459
Control.SRR15539832;39;38;0.487179487179487;20;19;0.0128205128205128;0.487179487179487
Control.SRR15539832;41;38;0.365853658536585;26;15;0.134146341463415;0.365853658536585
Control.SRR15539832;41;38;0.585365853658537;17;24;0.0853658536585366;0.414634146341463
Control.SRR15539832;35;38;0.342857142857143;23;12;0.157142857142857;0.342857142857143
Control.SRR15539832;38;38;0.631578947368421;14;24;0.131578947368421;0.368421052631579
Control.SRR15539832;36;38;0.666666666666667;12;24;0.166666666666667;0.333333333333333
Control.SRR15539832;32;38;0.5625;14;18;0.0625;0.4375
Control.SRR15539832;39;38;0.487179487179487;20;19;0.0128205128205128;0.487179487179487
Control.SRR15539832;35;38;0.428571428571429;20;15;0.0714285714285715;0.428571428571429
Control.SRR15539832;34;38;0.411764705882353;20;14;0.0882352941176471;0.411764705882353
Control.SRR15539832;41;38;0.414634146341463;24;17;0.0853658536585366;0.414634146341463
Control.SRR15539832;32;38;0.375;20;12;0.125;0.375
Control.SRR15539832;38;38;0.5;19;19;0;0.5
Control.SRR15539832;34;38;0.411764705882353;20;14;0.0882352941176471;0.411764705882353
Control.SRR15539832;33;38;0.606060606060606;13;20;0.106060606060606;0.393939393939394
Control.SRR15539832;36;38;0.472222222222222;19;17;0.0277777777777778;0.472222222222222
Control.SRR15539832;40;38;0.55;18;22;0.05;0.45
Control.SRR15539832;36;38;0.555555555555556;16;20;0.0555555555555556;0.444444444444444
Control.SRR15539832;35;38;0.457142857142857;19;16;0.0428571428571429;0.457142857142857
Control.SRR15539832;33;38;0.393939393939394;20;13;0.106060606060606;0.393939393939394
Control.SRR15539832;37;38;0.540540540540541;17;20;0.0405405405405406;0.459459459459459
Control.SRR15539832;35;38;0.514285714285714;17;18;0.0142857142857142;0.485714285714286
Control.SRR15539832;35;38;0.514285714285714;17;18;0.0142857142857142;0.485714285714286
Control.SRR15539832;33;38;0.424242424242424;19;14;0.0757575757575757;0.424242424242424
Control.SRR15539832;37;38;0.351351351351351;24;13;0.148648648648649;0.351351351351351
Control.SRR15539832;40;38;0.55;18;22;0.05;0.45
Control.SRR15539832;32;38;0.5625;14;18;0.0625;0.4375
Control.SRR15539832;36;38;0.527777777777778;17;19;0.0277777777777778;0.472222222222222
Control.SRR15539832;37;38;0.567567567567568;16;21;0.0675675675675675;0.432432432432432
Control.SRR15539832;42;38;0.619047619047619;16;26;0.119047619047619;0.380952380952381
Control.SRR15539832;37;38;0.378378378378378;23;14;0.121621621621622;0.378378378378378
Control.SRR15539832;32;38;0.375;20;12;0.125;0.375
Control.SRR15539832;37;38;0.459459459459459;20;17;0.0405405405405405;0.459459459459459
Control.SRR15539832;37;38;0.513513513513513;18;19;0.0135135135135135;0.486486486486487
Control.SRR15539832;37;38;0.621621621621622;14;23;0.121621621621622;0.378378378378378
Control.SRR15539832;38;38;0.684210526315789;12;26;0.184210526315789;0.315789473684211
Control.SRR15539832;39;38;0.333333333333333;26;13;0.166666666666667;0.333333333333333
Control.SRR15539832;40;38;0.35;26;14;0.15;0.35
Control.SRR15539832;39;38;0.282051282051282;28;11;0.217948717948718;0.282051282051282
Control.SRR15539832;42;38;0.523809523809524;20;22;0.0238095238095238;0.476190476190476
Control.SRR15539832;42;38;0.333333333333333;28;14;0.166666666666667;0.333333333333333
Control.SRR15539832;38;38;0.578947368421053;16;22;0.0789473684210527;0.421052631578947
Control.SRR15539832;37;38;0.594594594594595;15;22;0.0945945945945946;0.405405405405405
Control.SRR15539832;34;38;0.5;17;17;0;0.5
Control.SRR15539832;38;38;0.552631578947368;17;21;0.0526315789473685;0.447368421052632
Control.SRR15539832;32;38;0.65625;11;21;0.15625;0.34375
Control.SRR15539832;36;38;0.527777777777778;17;19;0.0277777777777778;0.472222222222222
Control.SRR15539832;42;38;0.619047619047619;16;26;0.119047619047619;0.380952380952381
Control.SRR15539832;40;38;0.425;23;17;0.075;0.425
Control.SRR15539832;39;38;0.461538461538462;21;18;0.0384615384615384;0.461538461538462
Control.SRR15539832;35;38;0.371428571428571;22;13;0.128571428571429;0.371428571428571
Control.SRR15539832;38;38;0.447368421052632;21;17;0.0526315789473684;0.447368421052632
Control.SRR15539832;40;38;0.4;24;16;0.1;0.4
Control.SRR15539832;40;38;0.4;24;16;0.1;0.4
Control.SRR15539832;35;38;0.485714285714286;18;17;0.0142857142857143;0.485714285714286
Control.SRR15539832;32;38;0.5625;14;18;0.0625;0.4375
Control.SRR15539832;35;38;0.742857142857143;9;26;0.242857142857143;0.257142857142857
Control.SRR15539832;38;38;0.526315789473684;18;20;0.0263157894736842;0.473684210526316
Control.SRR15539832;34;38;0.441176470588235;19;15;0.0588235294117647;0.441176470588235
Control.SRR15539832;32;38;0.625;12;20;0.125;0.375
Control.SRR15539832;41;38;0.658536585365854;14;27;0.158536585365854;0.341463414634146
Control.SRR15539832;35;38;0.514285714285714;17;18;0.0142857142857142;0.485714285714286
Control.SRR15539832;37;38;0.486486486486487;19;18;0.0135135135135135;0.486486486486487
Control.SRR15539832;34;38;0.352941176470588;22;12;0.147058823529412;0.352941176470588
Control.SRR15539832;38;38;0.5;19;19;0;0.5
Control.SRR15539832;42;38;0.571428571428571;18;24;0.0714285714285714;0.428571428571429
Control.SRR15539832;34;38;0.411764705882353;20;14;0.0882352941176471;0.411764705882353
Control.SRR15539832;36;38;0.5;18;18;0;0.5
Control.SRR15539832;32;38;0.59375;13;19;0.09375;0.40625
Control.SRR15539832;40;38;0.45;22;18;0.05;0.45
Control.SRR15539832;38;38;0.526315789473684;18;20;0.0263157894736842;0.473684210526316
Control.SRR15539832;33;38;0.454545454545455;18;15;0.0454545454545455;0.454545454545455
Control.SRR15539832;35;38;0.485714285714286;18;17;0.0142857142857143;0.485714285714286
Control.SRR15539832;42;38;0.571428571428571;18;24;0.0714285714285714;0.428571428571429
Control.SRR15539832;35;38;0.6;14;21;0.1;0.4
Control.SRR15539832;42;38;0.404761904761905;25;17;0.0952380952380952;0.404761904761905
Control.SRR15539832;39;38;0.435897435897436;22;17;0.0641025641025641;0.435897435897436
Control.SRR15539832;38;38;0.447368421052632;21;17;0.0526315789473684;0.447368421052632
Control.SRR15539832;34;38;0.647058823529412;12;22;0.147058823529412;0.352941176470588
Control.SRR15539832;42;38;0.523809523809524;20;22;0.0238095238095238;0.476190476190476
Control.SRR15539832;35;38;0.428571428571429;20;15;0.0714285714285715;0.428571428571429
Control.SRR15539832;37;38;0.432432432432432;21;16;0.0675675675675675;0.432432432432432
Control.SRR15539832;34;38;0.441176470588235;19;15;0.0588235294117647;0.441176470588235
Control.SRR15539832;34;38;0.470588235294118;18;16;0.0294117647058824;0.470588235294118
Control.SRR15539832;39;38;0.512820512820513;19;20;0.0128205128205128;0.487179487179487
Control.SRR15539832;42;38;0.523809523809524;20;22;0.0238095238095238;0.476190476190476
Control.SRR15539832;41;38;0.414634146341463;24;17;0.0853658536585366;0.414634146341463
Control.SRR15539832;42;38;0.547619047619048;19;23;0.0476190476190477;0.452380952380952
Control.SRR15539832;42;38;0.523809523809524;20;22;0.0238095238095238;0.476190476190476
Control.SRR15539832;42;38;0.5;21;21;0;0.5
Control.SRR15539832;39;38;0.384615384615385;24;15;0.115384615384615;0.384615384615385
Control.SRR15539832;39;38;0.461538461538462;21;18;0.0384615384615384;0.461538461538462
Control.SRR15539832;40;38;0.475;21;19;0.025;0.475
Control.SRR15539832;40;38;0.625;15;25;0.125;0.375
Control.SRR15539832;34;38;0.441176470588235;19;15;0.0588235294117647;0.441176470588235
Control.SRR15539832;37;38;0.486486486486487;19;18;0.0135135135135135;0.486486486486487
Control.SRR15539832;36;38;0.472222222222222;19;17;0.0277777777777778;0.472222222222222
Control.SRR15539832;38;38;0.394736842105263;23;15;0.105263157894737;0.394736842105263
Control.SRR15539832;38;38;0.684210526315789;12;26;0.184210526315789;0.315789473684211
Control.SRR15539832;37;38;0.486486486486487;19;18;0.0135135135135135;0.486486486486487
Control.SRR15539832;36;38;0.666666666666667;12;24;0.166666666666667;0.333333333333333
Control.SRR15539832;34;38;0.529411764705882;16;18;0.0294117647058824;0.470588235294118
Control.SRR15539832;38;38;0.421052631578947;22;16;0.0789473684210527;0.421052631578947
Control.SRR15539832;42;38;0.547619047619048;19;23;0.0476190476190477;0.452380952380952
Control.SRR15539832;34;38;0.470588235294118;18;16;0.0294117647058824;0.470588235294118
Control.SRR15539832;34;38;0.5;17;17;0;0.5
Control.SRR15539832;38;38;0.631578947368421;14;24;0.131578947368421;0.368421052631579
Control.SRR15539832;35;38;0.485714285714286;18;17;0.0142857142857143;0.485714285714286
Control.SRR15539832;41;38;0.560975609756098;18;23;0.0609756097560976;0.439024390243902
Control.SRR15539832;39;38;0.58974358974359;16;23;0.0897435897435898;0.41025641025641
Control.SRR15539832;34;38;0.470588235294118;18;16;0.0294117647058824;0.470588235294118
Control.SRR15539832;37;38;0.513513513513513;18;19;0.0135135135135135;0.486486486486487
Control.SRR15539832;42;38;0.476190476190476;22;20;0.0238095238095238;0.476190476190476
Control.SRR15539832;34;38;0.705882352941177;10;24;0.205882352941177;0.294117647058824
Control.SRR15539832;33;38;0.454545454545455;18;15;0.0454545454545455;0.454545454545455
Control.SRR15539832;38;38;0.5;19;19;0;0.5
Control.SRR15539832;37;38;0.351351351351351;24;13;0.148648648648649;0.351351351351351
Control.SRR15539832;32;38;0.53125;15;17;0.03125;0.46875
Control.SRR15539832;39;38;0.461538461538462;21;18;0.0384615384615384;0.461538461538462
Control.SRR15539832;33;38;0.545454545454545;15;18;0.0454545454545454;0.454545454545455
Control.SRR15539832;41;38;0.536585365853659;19;22;0.0365853658536586;0.463414634146341
Control.SRR15539832;32;38;0.65625;11;21;0.15625;0.34375
Control.SRR15539832;32;38;0.4375;18;14;0.0625;0.4375
Control.SRR15539832;40;38;0.35;26;14;0.15;0.35
Control.SRR15539832;34;38;0.647058823529412;12;22;0.147058823529412;0.352941176470588
Control.SRR15539832;38;38;0.368421052631579;24;14;0.131578947368421;0.368421052631579
Control.SRR15539832;42;38;0.523809523809524;20;22;0.0238095238095238;0.476190476190476
Control.SRR15539832;37;38;0.540540540540541;17;20;0.0405405405405406;0.459459459459459
Control.SRR15539832;33;38;0.484848484848485;17;16;0.0151515151515151;0.484848484848485
Control.SRR15539832;34;38;0.441176470588235;19;15;0.0588235294117647;0.441176470588235
Control.SRR15539832;36;38;0.583333333333333;15;21;0.0833333333333334;0.416666666666667
Control.SRR15539832;42;38;0.476190476190476;22;20;0.0238095238095238;0.476190476190476
Control.SRR15539832;39;38;0.461538461538462;21;18;0.0384615384615384;0.461538461538462
Control.SRR15539832;39;38;0.41025641025641;23;16;0.0897435897435898;0.41025641025641
Control.SRR15539832;34;38;0.588235294117647;14;20;0.0882352941176471;0.411764705882353
Control.SRR15539832;39;38;0.435897435897436;22;17;0.0641025641025641;0.435897435897436
Control.SRR15539832;34;38;0.529411764705882;16;18;0.0294117647058824;0.470588235294118
Control.SRR15539832;36;38;0.416666666666667;21;15;0.0833333333333333;0.416666666666667
Control.SRR15539832;40;38;0.6;16;24;0.1;0.4
Control.SRR15539832;33;38;0.636363636363636;12;21;0.136363636363636;0.363636363636364
Control.SRR15539832;34;38;0.588235294117647;14;20;0.0882352941176471;0.411764705882353
Control.SRR15539832;32;38;0.65625;11;21;0.15625;0.34375
Control.SRR15539832;32;38;0.46875;17;15;0.03125;0.46875
Control.SRR15539832;40;38;0.475;21;19;0.025;0.475
Control.SRR15539832;33;38;0.515151515151515;16;17;0.0151515151515151;0.484848484848485
Control.SRR15539832;38;38;0.552631578947368;17;21;0.0526315789473685;0.447368421052632
Control.SRR15539832;33;38;0.515151515151515;16;17;0.0151515151515151;0.484848484848485
Control.SRR15539832;40;38;0.45;22;18;0.05;0.45
Control.SRR15539832;37;38;0.432432432432432;21;16;0.0675675675675675;0.432432432432432
Control.SRR15539832;42;38;0.428571428571429;24;18;0.0714285714285715;0.428571428571429
Control.SRR15539832;42;38;0.523809523809524;20;22;0.0238095238095238;0.476190476190476
Control.SRR15539832;38;38;0.473684210526316;20;18;0.0263157894736842;0.473684210526316
Control.SRR15539832;35;38;0.428571428571429;20;15;0.0714285714285715;0.428571428571429
Control.SRR15539832;40;38;0.55;18;22;0.05;0.45
Control.SRR15539832;42;38;0.428571428571429;24;18;0.0714285714285715;0.428571428571429
Control.SRR15539832;40;38;0.45;22;18;0.05;0.45
Control.SRR15539832;39;38;0.487179487179487;20;19;0.0128205128205128;0.487179487179487
Control.SRR15539832;36;38;0.444444444444444;20;16;0.0555555555555556;0.444444444444444
Control.SRR15539832;32;38;0.46875;17;15;0.03125;0.46875
Control.SRR15539832;41;38;0.51219512195122;20;21;0.0121951219512195;0.48780487804878
Control.SRR15539832;33;38;0.575757575757576;14;19;0.0757575757575758;0.424242424242424
Control.SRR15539832;42;38;0.285714285714286;30;12;0.214285714285714;0.285714285714286
Control.SRR15539832;35;38;0.6;14;21;0.1;0.4
Control.SRR15539832;41;38;0.439024390243902;23;18;0.0609756097560976;0.439024390243902
Control.SRR15539832;33;38;0.666666666666667;11;22;0.166666666666667;0.333333333333333
Control.SRR15539832;34;38;0.588235294117647;14;20;0.0882352941176471;0.411764705882353
Control.SRR15539832;42;38;0.452380952380952;23;19;0.0476190476190476;0.452380952380952
Control.SRR15539832;33;38;0.575757575757576;14;19;0.0757575757575758;0.424242424242424
Control.SRR15539832;34;38;0.705882352941177;10;24;0.205882352941177;0.294117647058824
Control.SRR15539832;39;38;0.58974358974359;16;23;0.0897435897435898;0.41025641025641
Control.SRR15539832;39;38;0.487179487179487;20;19;0.0128205128205128;0.487179487179487
Control.SRR15539832;38;38;0.605263157894737;15;23;0.105263157894737;0.394736842105263
Control.SRR15539832;39;38;0.487179487179487;20;19;0.0128205128205128;0.487179487179487
Control.SRR15539832;34;38;0.529411764705882;16;18;0.0294117647058824;0.470588235294118
Control.SRR15539832;34;38;0.352941176470588;22;12;0.147058823529412;0.352941176470588
Control.SRR15539832;38;38;0.447368421052632;21;17;0.0526315789473684;0.447368421052632
Control.SRR15539832;41;38;0.51219512195122;20;21;0.0121951219512195;0.48780487804878
Control.SRR15539832;41;38;0.536585365853659;19;22;0.0365853658536586;0.463414634146341
Control.SRR15539832;36;38;0.611111111111111;14;22;0.111111111111111;0.388888888888889
Control.SRR15539832;40;38;0.425;23;17;0.075;0.425
Control.SRR15539832;32;38;0.625;12;20;0.125;0.375
Control.SRR15539832;36;38;0.611111111111111;14;22;0.111111111111111;0.388888888888889
Control.SRR15539832;37;38;0.540540540540541;17;20;0.0405405405405406;0.459459459459459
Control.SRR15539832;42;38;0.619047619047619;16;26;0.119047619047619;0.380952380952381
Control.SRR15539832;35;38;0.457142857142857;19;16;0.0428571428571429;0.457142857142857
Control.SRR15539832;33;38;0.696969696969697;10;23;0.196969696969697;0.303030303030303
Control.SRR15539832;41;38;0.560975609756098;18;23;0.0609756097560976;0.439024390243902
Control.SRR15539832;39;38;0.538461538461538;18;21;0.0384615384615384;0.461538461538462
Control.SRR15539832;37;38;0.567567567567568;16;21;0.0675675675675675;0.432432432432432
Control.SRR15539832;42;38;0.595238095238095;17;25;0.0952380952380952;0.404761904761905
Control.SRR15539832;38;38;0.5;19;19;0;0.5
Control.SRR15539832;34;38;0.617647058823529;13;21;0.117647058823529;0.382352941176471
Control.SRR15539832;38;38;0.578947368421053;16;22;0.0789473684210527;0.421052631578947
Control.SRR15539832;38;38;0.421052631578947;22;16;0.0789473684210527;0.421052631578947
Control.SRR15539832;39;38;0.461538461538462;21;18;0.0384615384615384;0.461538461538462
Control.SRR15539832;40;38;0.525;19;21;0.025;0.475
Control.SRR15539832;37;38;0.405405405405405;22;15;0.0945945945945946;0.405405405405405
Control.SRR15539832;40;38;0.55;18;22;0.05;0.45
Control.SRR15539832;43;38;0.534883720930233;20;23;0.0348837209302325;0.465116279069767
Control.SRR15539832;46;38;0.521739130434783;22;24;0.0217391304347826;0.478260869565217
Control.SRR15539832;43;38;0.534883720930233;20;23;0.0348837209302325;0.465116279069767
Control.SRR15539832;41;38;0.51219512195122;20;21;0.0121951219512195;0.48780487804878
Control.SRR15539832;39;38;0.538461538461538;18;21;0.0384615384615384;0.461538461538462
Control.SRR15539832;38;38;0.473684210526316;20;18;0.0263157894736842;0.473684210526316
Control.SRR15539832;45;38;0.355555555555556;29;16;0.144444444444444;0.355555555555556
Control.SRR15539832;45;38;0.644444444444444;16;29;0.144444444444444;0.355555555555556
Control.SRR15539832;45;38;0.466666666666667;24;21;0.0333333333333333;0.466666666666667
Control.SRR15539832;37;38;0.540540540540541;17;20;0.0405405405405406;0.459459459459459
Control.SRR15539832;46;38;0.478260869565217;24;22;0.0217391304347826;0.478260869565217
Control.SRR15539832;45;38;0.511111111111111;22;23;0.0111111111111111;0.488888888888889
Control.SRR15539832;42;38;0.404761904761905;25;17;0.0952380952380952;0.404761904761905
Control.SRR15539832;41;38;0.317073170731707;28;13;0.182926829268293;0.317073170731707
Control.SRR15539832;42;38;0.523809523809524;20;22;0.0238095238095238;0.476190476190476
Control.SRR15539832;39;38;0.512820512820513;19;20;0.0128205128205128;0.487179487179487
Control.SRR15539832;36;38;0.583333333333333;15;21;0.0833333333333334;0.416666666666667
Control.SRR15539832;41;38;0.48780487804878;21;20;0.0121951219512195;0.48780487804878
Control.SRR15539832;42;38;0.476190476190476;22;20;0.0238095238095238;0.476190476190476
Control.SRR15539832;38;38;0.447368421052632;21;17;0.0526315789473684;0.447368421052632
Control.SRR15539832;39;38;0.58974358974359;16;23;0.0897435897435898;0.41025641025641
Control.SRR15539832;39;38;0.435897435897436;22;17;0.0641025641025641;0.435897435897436
Control.SRR15539832;41;38;0.463414634146341;22;19;0.0365853658536585;0.463414634146341
Control.SRR15539832;37;38;0.405405405405405;22;15;0.0945945945945946;0.405405405405405
Control.SRR15539832;38;38;0.473684210526316;20;18;0.0263157894736842;0.473684210526316
Control.SRR15539832;37;38;0.594594594594595;15;22;0.0945945945945946;0.405405405405405
Control.SRR15539832;37;38;0.378378378378378;23;14;0.121621621621622;0.378378378378378
Control.SRR15539832;39;38;0.538461538461538;18;21;0.0384615384615384;0.461538461538462
Control.SRR15539832;35;38;0.371428571428571;22;13;0.128571428571429;0.371428571428571
Control.SRR15539832;43;38;0.651162790697674;15;28;0.151162790697674;0.348837209302326
Control.SRR15539832;41;38;0.634146341463415;15;26;0.134146341463415;0.365853658536585
Control.SRR15539832;46;38;0.456521739130435;25;21;0.0434782608695652;0.456521739130435
Control.SRR15539832;41;38;0.414634146341463;24;17;0.0853658536585366;0.414634146341463
Control.SRR15539832;38;38;0.368421052631579;24;14;0.131578947368421;0.368421052631579
Control.SRR15539832;36;38;0.472222222222222;19;17;0.0277777777777778;0.472222222222222
Control.SRR15539832;36;38;0.666666666666667;12;24;0.166666666666667;0.333333333333333
Control.SRR15539832;41;38;0.585365853658537;17;24;0.0853658536585366;0.414634146341463
Control.SRR15539832;40;38;0.475;21;19;0.025;0.475
Control.SRR15539832;36;38;0.472222222222222;19;17;0.0277777777777778;0.472222222222222
Control.SRR15539832;43;38;0.581395348837209;18;25;0.0813953488372093;0.418604651162791
Control.SRR15539832;44;38;0.477272727272727;23;21;0.0227272727272727;0.477272727272727
Control.SRR15539832;35;38;0.571428571428571;15;20;0.0714285714285714;0.428571428571429
Control.SRR15539832;37;38;0.486486486486487;19;18;0.0135135135135135;0.486486486486487
Control.SRR15539832;35;38;0.571428571428571;15;20;0.0714285714285714;0.428571428571429
Control.SRR15539832;37;38;0.567567567567568;16;21;0.0675675675675675;0.432432432432432
Control.SRR15539832;44;38;0.454545454545455;24;20;0.0454545454545455;0.454545454545455
Control.SRR15539832;39;38;0.615384615384615;15;24;0.115384615384615;0.384615384615385
Control.SRR15539832;36;38;0.472222222222222;19;17;0.0277777777777778;0.472222222222222
Control.SRR15539832;36;38;0.638888888888889;13;23;0.138888888888889;0.361111111111111
Control.SRR15539832;36;38;0.611111111111111;14;22;0.111111111111111;0.388888888888889
Control.SRR15539832;42;38;0.5;21;21;0;0.5
Control.SRR15539832;44;38;0.545454545454545;20;24;0.0454545454545454;0.454545454545455
Control.SRR15539832;41;38;0.609756097560976;16;25;0.109756097560976;0.390243902439024
Control.SRR15539832;36;38;0.638888888888889;13;23;0.138888888888889;0.361111111111111
Control.SRR15539832;41;38;0.560975609756098;18;23;0.0609756097560976;0.439024390243902
Control.SRR15539832;37;38;0.459459459459459;20;17;0.0405405405405405;0.459459459459459
Control.SRR15539832;36;38;0.388888888888889;22;14;0.111111111111111;0.388888888888889
Control.SRR15539832;35;38;0.542857142857143;16;19;0.0428571428571428;0.457142857142857
Control.SRR15539832;41;38;0.560975609756098;18;23;0.0609756097560976;0.439024390243902
Control.SRR15539832;42;38;0.595238095238095;17;25;0.0952380952380952;0.404761904761905
Control.SRR15539832;39;38;0.435897435897436;22;17;0.0641025641025641;0.435897435897436
Control.SRR15539832;43;38;0.651162790697674;15;28;0.151162790697674;0.348837209302326
Control.SRR15539832;46;38;0.521739130434783;22;24;0.0217391304347826;0.478260869565217
Control.SRR15539832;46;38;0.543478260869565;21;25;0.0434782608695652;0.456521739130435
Control.SRR15539832;38;38;0.473684210526316;20;18;0.0263157894736842;0.473684210526316
Control.SRR15539832;35;38;0.457142857142857;19;16;0.0428571428571429;0.457142857142857
Control.SRR15539832;38;38;0.526315789473684;18;20;0.0263157894736842;0.473684210526316
Control.SRR15539832;38;38;0.552631578947368;17;21;0.0526315789473685;0.447368421052632
Control.SRR15539832;35;38;0.514285714285714;17;18;0.0142857142857142;0.485714285714286
Control.SRR15539832;43;38;0.581395348837209;18;25;0.0813953488372093;0.418604651162791
Control.SRR15539832;35;38;0.542857142857143;16;19;0.0428571428571428;0.457142857142857
Control.SRR15539832;38;38;0.552631578947368;17;21;0.0526315789473685;0.447368421052632
Control.SRR15539832;38;38;0.473684210526316;20;18;0.0263157894736842;0.473684210526316
Control.SRR15539832;40;38;0.45;22;18;0.05;0.45
Control.SRR15539832;43;38;0.372093023255814;27;16;0.127906976744186;0.372093023255814
Control.SRR15539832;39;38;0.487179487179487;20;19;0.0128205128205128;0.487179487179487
Control.SRR15539832;46;38;0.543478260869565;21;25;0.0434782608695652;0.456521739130435
Control.SRR15539832;39;38;0.435897435897436;22;17;0.0641025641025641;0.435897435897436
Control.SRR15539832;43;38;0.418604651162791;25;18;0.0813953488372093;0.418604651162791
Control.SRR15539832;35;38;0.657142857142857;12;23;0.157142857142857;0.342857142857143
Control.SRR15539832;37;38;0.513513513513513;18;19;0.0135135135135135;0.486486486486487
Control.SRR15539832;37;38;0.513513513513513;18;19;0.0135135135135135;0.486486486486487
Control.SRR15539832;36;38;0.611111111111111;14;22;0.111111111111111;0.388888888888889
Control.SRR15539832;37;38;0.432432432432432;21;16;0.0675675675675675;0.432432432432432
Control.SRR15539832;40;38;0.5;20;20;0;0.5
Control.SRR15539832;39;38;0.41025641025641;23;16;0.0897435897435898;0.41025641025641
Control.SRR15539832;41;38;0.536585365853659;19;22;0.0365853658536586;0.463414634146341
Control.SRR15539832;37;38;0.459459459459459;20;17;0.0405405405405405;0.459459459459459
Control.SRR15539832;42;38;0.523809523809524;20;22;0.0238095238095238;0.476190476190476
Control.SRR15539832;36;38;0.472222222222222;19;17;0.0277777777777778;0.472222222222222
Control.SRR15539832;46;38;0.5;23;23;0;0.5
Control.SRR15539832;43;38;0.604651162790698;17;26;0.104651162790698;0.395348837209302
Control.SRR15539832;41;38;0.414634146341463;24;17;0.0853658536585366;0.414634146341463
Control.SRR15539832;46;38;0.434782608695652;26;20;0.0652173913043478;0.434782608695652
Control.SRR15539832;46;38;0.543478260869565;21;25;0.0434782608695652;0.456521739130435
Control.SRR15539832;39;38;0.512820512820513;19;20;0.0128205128205128;0.487179487179487
Control.SRR15539832;39;38;0.41025641025641;23;16;0.0897435897435898;0.41025641025641
Control.SRR15539832;39;38;0.512820512820513;19;20;0.0128205128205128;0.487179487179487
Control.SRR15539832;42;38;0.452380952380952;23;19;0.0476190476190476;0.452380952380952
Control.SRR15539832;40;38;0.35;26;14;0.15;0.35
Control.SRR15539832;36;38;0.527777777777778;17;19;0.0277777777777778;0.472222222222222
Control.SRR15539832;46;38;0.565217391304348;20;26;0.0652173913043478;0.434782608695652
Control.SRR15539832;39;38;0.538461538461538;18;21;0.0384615384615384;0.461538461538462
Control.SRR15539832;37;38;0.567567567567568;16;21;0.0675675675675675;0.432432432432432
Control.SRR15539832;36;38;0.444444444444444;20;16;0.0555555555555556;0.444444444444444
Control.SRR15539832;36;38;0.555555555555556;16;20;0.0555555555555556;0.444444444444444
Control.SRR15539832;38;38;0.5;19;19;0;0.5
Control.SRR15539832;39;38;0.435897435897436;22;17;0.0641025641025641;0.435897435897436
Control.SRR15539832;42;38;0.619047619047619;16;26;0.119047619047619;0.380952380952381
Control.SRR15539832;41;38;0.560975609756098;18;23;0.0609756097560976;0.439024390243902
Control.SRR15539832;39;38;0.487179487179487;20;19;0.0128205128205128;0.487179487179487
Control.SRR15539832;39;38;0.41025641025641;23;16;0.0897435897435898;0.41025641025641
Control.SRR15539832;42;38;0.452380952380952;23;19;0.0476190476190476;0.452380952380952
Control.SRR15539832;35;38;0.6;14;21;0.1;0.4
Control.SRR15539832;44;38;0.613636363636364;17;27;0.113636363636364;0.386363636363636
Control.SRR15539832;37;38;0.432432432432432;21;16;0.0675675675675675;0.432432432432432
Control.SRR15539832;40;38;0.5;20;20;0;0.5
Control.SRR15539832;37;38;0.432432432432432;21;16;0.0675675675675675;0.432432432432432
Control.SRR15539832;36;38;0.444444444444444;20;16;0.0555555555555556;0.444444444444444
Control.SRR15539832;42;38;0.380952380952381;26;16;0.119047619047619;0.380952380952381
Control.SRR15539832;40;38;0.475;21;19;0.025;0.475
Control.SRR15539832;44;38;0.409090909090909;26;18;0.0909090909090909;0.409090909090909
Control.SRR15539832;35;38;0.514285714285714;17;18;0.0142857142857142;0.485714285714286
Control.SRR15539832;36;38;0.555555555555556;16;20;0.0555555555555556;0.444444444444444
Control.SRR15539832;46;38;0.543478260869565;21;25;0.0434782608695652;0.456521739130435
Control.SRR15539832;43;38;0.558139534883721;19;24;0.0581395348837209;0.441860465116279
Control.SRR15539832;44;38;0.409090909090909;26;18;0.0909090909090909;0.409090909090909
Control.SRR15539832;37;38;0.648648648648649;13;24;0.148648648648649;0.351351351351351
Control.SRR15539832;37;38;0.594594594594595;15;22;0.0945945945945946;0.405405405405405
Control.SRR15539832;45;38;0.466666666666667;24;21;0.0333333333333333;0.466666666666667
Control.SRR15539832;38;38;0.5;19;19;0;0.5
Control.SRR15539832;43;38;0.372093023255814;27;16;0.127906976744186;0.372093023255814
Control.SRR15539832;36;38;0.583333333333333;15;21;0.0833333333333334;0.416666666666667
Control.SRR15539832;40;38;0.5;20;20;0;0.5
Control.SRR15539832;40;38;0.5;20;20;0;0.5
Control.SRR15539832;41;38;0.365853658536585;26;15;0.134146341463415;0.365853658536585
Control.SRR15539832;40;38;0.575;17;23;0.075;0.425
Control.SRR15539832;40;38;0.675;13;27;0.175;0.325
Control.SRR15539832;40;38;0.475;21;19;0.025;0.475
Control.SRR15539832;37;38;0.513513513513513;18;19;0.0135135135135135;0.486486486486487
Control.SRR15539832;36;38;0.305555555555556;25;11;0.194444444444444;0.305555555555556
Control.SRR15539832;38;38;0.552631578947368;17;21;0.0526315789473685;0.447368421052632
Control.SRR15539832;36;38;0.555555555555556;16;20;0.0555555555555556;0.444444444444444
Control.SRR15539832;43;38;0.465116279069767;23;20;0.0348837209302326;0.465116279069767
Control.SRR15539832;42;38;0.404761904761905;25;17;0.0952380952380952;0.404761904761905
Control.SRR15539832;38;38;0.605263157894737;15;23;0.105263157894737;0.394736842105263
Control.SRR15539832;41;38;0.48780487804878;21;20;0.0121951219512195;0.48780487804878
Control.SRR15539832;40;38;0.5;20;20;0;0.5
Control.SRR15539832;39;38;0.41025641025641;23;16;0.0897435897435898;0.41025641025641
Control.SRR15539832;35;38;0.628571428571429;13;22;0.128571428571429;0.371428571428571
Control.SRR15539832;40;38;0.5;20;20;0;0.5
Control.SRR15539832;43;38;0.395348837209302;26;17;0.104651162790698;0.395348837209302
Control.SRR15539832;44;38;0.5;22;22;0;0.5
Control.SRR15539832;44;38;0.522727272727273;21;23;0.0227272727272727;0.477272727272727
Control.SRR15539832;46;38;0.478260869565217;24;22;0.0217391304347826;0.478260869565217
Control.SRR15539832;38;38;0.447368421052632;21;17;0.0526315789473684;0.447368421052632
Control.SRR15539832;45;38;0.466666666666667;24;21;0.0333333333333333;0.466666666666667
Control.SRR15539832;41;38;0.585365853658537;17;24;0.0853658536585366;0.414634146341463
Control.SRR15539832;36;38;0.361111111111111;23;13;0.138888888888889;0.361111111111111
Control.SRR15539832;41;38;0.536585365853659;19;22;0.0365853658536586;0.463414634146341
Control.SRR15539832;41;38;0.439024390243902;23;18;0.0609756097560976;0.439024390243902
Control.SRR15539832;40;38;0.5;20;20;0;0.5
Control.SRR15539832;44;38;0.454545454545455;24;20;0.0454545454545455;0.454545454545455
Control.SRR15539832;42;38;0.595238095238095;17;25;0.0952380952380952;0.404761904761905
Control.SRR15539832;35;38;0.542857142857143;16;19;0.0428571428571428;0.457142857142857
Control.SRR15539832;44;38;0.522727272727273;21;23;0.0227272727272727;0.477272727272727
Control.SRR15539832;46;38;0.630434782608696;17;29;0.130434782608696;0.369565217391304
Control.SRR15539832;36;38;0.5;18;18;0;0.5
Control.SRR15539832;38;38;0.473684210526316;20;18;0.0263157894736842;0.473684210526316
Control.SRR15539832;36;38;0.416666666666667;21;15;0.0833333333333333;0.416666666666667
Control.SRR15539832;35;38;0.542857142857143;16;19;0.0428571428571428;0.457142857142857
Control.SRR15539832;41;38;0.341463414634146;27;14;0.158536585365854;0.341463414634146
Control.SRR15539832;40;38;0.525;19;21;0.025;0.475
Control.SRR15539832;44;38;0.431818181818182;25;19;0.0681818181818182;0.431818181818182
Control.SRR15539832;40;38;0.45;22;18;0.05;0.45
Control.SRR15539832;37;38;0.513513513513513;18;19;0.0135135135135135;0.486486486486487
Control.SRR15539832;45;38;0.533333333333333;21;24;0.0333333333333333;0.466666666666667
Control.SRR15539832;44;38;0.477272727272727;23;21;0.0227272727272727;0.477272727272727
Control.SRR15539832;44;38;0.431818181818182;25;19;0.0681818181818182;0.431818181818182
Control.SRR15539832;45;38;0.577777777777778;19;26;0.0777777777777777;0.422222222222222
Control.SRR15539832;37;38;0.513513513513513;18;19;0.0135135135135135;0.486486486486487
Control.SRR15539832;41;38;0.463414634146341;22;19;0.0365853658536585;0.463414634146341
Control.SRR15539832;38;38;0.526315789473684;18;20;0.0263157894736842;0.473684210526316
Control.SRR15539832;46;38;0.434782608695652;26;20;0.0652173913043478;0.434782608695652
Control.SRR15539832;37;38;0.459459459459459;20;17;0.0405405405405405;0.459459459459459
Control.SRR15539832;40;38;0.475;21;19;0.025;0.475
Control.SRR15539832;45;38;0.577777777777778;19;26;0.0777777777777777;0.422222222222222
Control.SRR15539832;45;38;0.511111111111111;22;23;0.0111111111111111;0.488888888888889
Control.SRR15539832;45;38;0.511111111111111;22;23;0.0111111111111111;0.488888888888889
Control.SRR15539832;44;38;0.477272727272727;23;21;0.0227272727272727;0.477272727272727
Control.SRR15539832;43;38;0.418604651162791;25;18;0.0813953488372093;0.418604651162791
Control.SRR15539832;36;38;0.5;18;18;0;0.5
Control.SRR15539832;40;38;0.475;21;19;0.025;0.475
Control.SRR15539832;38;38;0.526315789473684;18;20;0.0263157894736842;0.473684210526316
Control.SRR15539832;44;38;0.340909090909091;29;15;0.159090909090909;0.340909090909091
Control.SRR15539832;40;38;0.65;14;26;0.15;0.35
Control.SRR15539832;35;38;0.4;21;14;0.1;0.4
Control.SRR15539832;37;38;0.513513513513513;18;19;0.0135135135135135;0.486486486486487
Control.SRR15539832;36;38;0.472222222222222;19;17;0.0277777777777778;0.472222222222222
Control.SRR15539832;38;38;0.421052631578947;22;16;0.0789473684210527;0.421052631578947
Control.SRR15539832;39;38;0.333333333333333;26;13;0.166666666666667;0.333333333333333
Control.SRR15539832;40;38;0.5;20;20;0;0.5
Control.SRR15539832;40;38;0.55;18;22;0.05;0.45
Control.SRR15539832;44;38;0.477272727272727;23;21;0.0227272727272727;0.477272727272727
Control.SRR15539832;38;38;0.578947368421053;16;22;0.0789473684210527;0.421052631578947
Control.SRR15539832;35;38;0.6;14;21;0.1;0.4
Control.SRR15539832;40;38;0.5;20;20;0;0.5
Control.SRR15539832;45;38;0.644444444444444;16;29;0.144444444444444;0.355555555555556
Control.SRR15539832;43;38;0.441860465116279;24;19;0.0581395348837209;0.441860465116279
Control.SRR15539832;37;38;0.459459459459459;20;17;0.0405405405405405;0.459459459459459
Control.SRR15539832;37;38;0.486486486486487;19;18;0.0135135135135135;0.486486486486487
Control.SRR15539832;38;38;0.394736842105263;23;15;0.105263157894737;0.394736842105263
Control.SRR15539832;44;38;0.477272727272727;23;21;0.0227272727272727;0.477272727272727
Control.SRR15539832;38;38;0.447368421052632;21;17;0.0526315789473684;0.447368421052632
Control.SRR15539832;41;38;0.585365853658537;17;24;0.0853658536585366;0.414634146341463
Control.SRR15539832;42;38;0.428571428571429;24;18;0.0714285714285715;0.428571428571429
Control.SRR15539832;38;38;0.473684210526316;20;18;0.0263157894736842;0.473684210526316
Control.SRR15539832;38;38;0.421052631578947;22;16;0.0789473684210527;0.421052631578947
Control.SRR15539832;41;38;0.536585365853659;19;22;0.0365853658536586;0.463414634146341
Control.SRR15539832;43;38;0.441860465116279;24;19;0.0581395348837209;0.441860465116279
Control.SRR15539832;41;38;0.463414634146341;22;19;0.0365853658536585;0.463414634146341
Control.SRR15539832;42;38;0.476190476190476;22;20;0.0238095238095238;0.476190476190476
Control.SRR15539832;43;38;0.604651162790698;17;26;0.104651162790698;0.395348837209302
Control.SRR15539832;44;38;0.477272727272727;23;21;0.0227272727272727;0.477272727272727
Control.SRR15539832;45;38;0.533333333333333;21;24;0.0333333333333333;0.466666666666667
Control.SRR15539832;42;38;0.452380952380952;23;19;0.0476190476190476;0.452380952380952
Control.SRR15539832;40;38;0.75;10;30;0.25;0.25
Control.SRR15539832;46;38;0.543478260869565;21;25;0.0434782608695652;0.456521739130435
Control.SRR15539832;45;38;0.622222222222222;17;28;0.122222222222222;0.377777777777778
Control.SRR15539832;41;38;0.585365853658537;17;24;0.0853658536585366;0.414634146341463
Control.SRR15539832;40;38;0.525;19;21;0.025;0.475
Control.SRR15539832;41;38;0.439024390243902;23;18;0.0609756097560976;0.439024390243902
Control.SRR15539832;39;38;0.538461538461538;18;21;0.0384615384615384;0.461538461538462
Control.SRR15539832;36;38;0.444444444444444;20;16;0.0555555555555556;0.444444444444444
Control.SRR15539832;42;38;0.642857142857143;15;27;0.142857142857143;0.357142857142857
Control.SRR15539832;43;38;0.488372093023256;22;21;0.0116279069767442;0.488372093023256
Control.SRR15539832;41;38;0.463414634146341;22;19;0.0365853658536585;0.463414634146341
Control.SRR15539832;40;38;0.6;16;24;0.1;0.4
Control.SRR15539832;42;38;0.571428571428571;18;24;0.0714285714285714;0.428571428571429
Control.SRR15539832;43;38;0.418604651162791;25;18;0.0813953488372093;0.418604651162791
Control.SRR15539832;36;38;0.472222222222222;19;17;0.0277777777777778;0.472222222222222
Control.SRR15539832;36;38;0.583333333333333;15;21;0.0833333333333334;0.416666666666667
Control.SRR15539832;44;38;0.590909090909091;18;26;0.0909090909090909;0.409090909090909
Control.SRR15539832;40;38;0.4;24;16;0.1;0.4
Control.SRR15539832;39;38;0.538461538461538;18;21;0.0384615384615384;0.461538461538462
Control.SRR15539832;37;38;0.513513513513513;18;19;0.0135135135135135;0.486486486486487
Control.SRR15539832;42;38;0.452380952380952;23;19;0.0476190476190476;0.452380952380952
Control.SRR15539832;46;38;0.630434782608696;17;29;0.130434782608696;0.369565217391304
Control.SRR15539832;36;38;0.444444444444444;20;16;0.0555555555555556;0.444444444444444
Control.SRR15539832;35;38;0.6;14;21;0.1;0.4
Control.SRR15539832;44;38;0.454545454545455;24;20;0.0454545454545455;0.454545454545455
Control.SRR15539832;42;38;0.571428571428571;18;24;0.0714285714285714;0.428571428571429
Control.SRR15539832;37;38;0.540540540540541;17;20;0.0405405405405406;0.459459459459459
Control.SRR15539832;38;38;0.605263157894737;15;23;0.105263157894737;0.394736842105263
Control.SRR15539832;45;38;0.466666666666667;24;21;0.0333333333333333;0.466666666666667
Control.SRR15539832;46;38;0.434782608695652;26;20;0.0652173913043478;0.434782608695652
Control.SRR15539832;37;38;0.486486486486487;19;18;0.0135135135135135;0.486486486486487
Control.SRR15539832;38;38;0.421052631578947;22;16;0.0789473684210527;0.421052631578947
Control.SRR15539832;39;38;0.461538461538462;21;18;0.0384615384615384;0.461538461538462
Control.SRR15539832;42;38;0.595238095238095;17;25;0.0952380952380952;0.404761904761905
Control.SRR15539832;38;38;0.421052631578947;22;16;0.0789473684210527;0.421052631578947
Control.SRR15539832;42;38;0.333333333333333;28;14;0.166666666666667;0.333333333333333
Control.SRR15539832;41;38;0.658536585365854;14;27;0.158536585365854;0.341463414634146
Control.SRR15539832;45;38;0.488888888888889;23;22;0.0111111111111111;0.488888888888889
Control.SRR15539832;39;38;0.58974358974359;16;23;0.0897435897435898;0.41025641025641
Control.SRR15539832;41;38;0.439024390243902;23;18;0.0609756097560976;0.439024390243902
Control.SRR15539832;41;38;0.51219512195122;20;21;0.0121951219512195;0.48780487804878
Control.SRR15539832;44;38;0.522727272727273;21;23;0.0227272727272727;0.477272727272727
Control.SRR15539832;35;38;0.714285714285714;10;25;0.214285714285714;0.285714285714286
Control.SRR15539832;36;38;0.472222222222222;19;17;0.0277777777777778;0.472222222222222
Control.SRR15539832;35;38;0.628571428571429;13;22;0.128571428571429;0.371428571428571
Control.SRR15539832;38;38;0.473684210526316;20;18;0.0263157894736842;0.473684210526316
Control.SRR15539832;36;38;0.555555555555556;16;20;0.0555555555555556;0.444444444444444
Control.SRR15539832;46;38;0.456521739130435;25;21;0.0434782608695652;0.456521739130435
Control.SRR15539832;36;38;0.5;18;18;0;0.5
Control.SRR15539832;37;38;0.648648648648649;13;24;0.148648648648649;0.351351351351351
Control.SRR15539832;41;38;0.48780487804878;21;20;0.0121951219512195;0.48780487804878
Control.SRR15539832;38;38;0.447368421052632;21;17;0.0526315789473684;0.447368421052632
Control.SRR15539832;43;38;0.441860465116279;24;19;0.0581395348837209;0.441860465116279
Control.SRR15539832;35;38;0.657142857142857;12;23;0.157142857142857;0.342857142857143
Control.SRR15539832;42;38;0.523809523809524;20;22;0.0238095238095238;0.476190476190476
Control.SRR15539832;37;38;0.351351351351351;24;13;0.148648648648649;0.351351351351351
Control.SRR15539832;36;38;0.416666666666667;21;15;0.0833333333333333;0.416666666666667
Control.SRR15539832;39;38;0.487179487179487;20;19;0.0128205128205128;0.487179487179487
Control.SRR15539832;35;38;0.514285714285714;17;18;0.0142857142857142;0.485714285714286
Control.SRR15539832;42;38;0.595238095238095;17;25;0.0952380952380952;0.404761904761905
Control.SRR15539832;45;38;0.533333333333333;21;24;0.0333333333333333;0.466666666666667
Control.SRR15539832;42;38;0.571428571428571;18;24;0.0714285714285714;0.428571428571429
Control.SRR15539832;46;38;0.434782608695652;26;20;0.0652173913043478;0.434782608695652
Control.SRR15539832;38;38;0.5;19;19;0;0.5
Control.SRR15539832;37;38;0.432432432432432;21;16;0.0675675675675675;0.432432432432432
Control.SRR15539832;35;38;0.314285714285714;24;11;0.185714285714286;0.314285714285714
Control.SRR15539832;41;38;0.48780487804878;21;20;0.0121951219512195;0.48780487804878
Control.SRR15539832;44;38;0.477272727272727;23;21;0.0227272727272727;0.477272727272727
Control.SRR15539832;36;38;0.555555555555556;16;20;0.0555555555555556;0.444444444444444
Control.SRR15539832;40;38;0.525;19;21;0.025;0.475
Control.SRR15539832;39;38;0.41025641025641;23;16;0.0897435897435898;0.41025641025641
Control.SRR15539832;42;38;0.452380952380952;23;19;0.0476190476190476;0.452380952380952
Control.SRR15539832;38;38;0.342105263157895;25;13;0.157894736842105;0.342105263157895
Control.SRR15539832;41;38;0.51219512195122;20;21;0.0121951219512195;0.48780487804878
Control.SRR15539832;36;38;0.416666666666667;21;15;0.0833333333333333;0.416666666666667
Control.SRR15539832;38;38;0.578947368421053;16;22;0.0789473684210527;0.421052631578947
Control.SRR15539832;46;38;0.521739130434783;22;24;0.0217391304347826;0.478260869565217
Control.SRR15539832;36;38;0.472222222222222;19;17;0.0277777777777778;0.472222222222222
Control.SRR15539832;43;38;0.465116279069767;23;20;0.0348837209302326;0.465116279069767
Control.SRR15539832;44;38;0.477272727272727;23;21;0.0227272727272727;0.477272727272727
Control.SRR15539832;41;38;0.51219512195122;20;21;0.0121951219512195;0.48780487804878
Control.SRR15539832;41;38;0.536585365853659;19;22;0.0365853658536586;0.463414634146341
Control.SRR15539832;36;38;0.638888888888889;13;23;0.138888888888889;0.361111111111111
Control.SRR15539832;44;38;0.477272727272727;23;21;0.0227272727272727;0.477272727272727
Control.SRR15539832;39;38;0.461538461538462;21;18;0.0384615384615384;0.461538461538462
Control.SRR15539832;39;38;0.538461538461538;18;21;0.0384615384615384;0.461538461538462
Control.SRR15539832;37;38;0.351351351351351;24;13;0.148648648648649;0.351351351351351
Control.SRR15539832;37;38;0.594594594594595;15;22;0.0945945945945946;0.405405405405405
Control.SRR15539832;43;38;0.418604651162791;25;18;0.0813953488372093;0.418604651162791
Control.SRR15539832;39;38;0.461538461538462;21;18;0.0384615384615384;0.461538461538462
Control.SRR15539832;39;38;0.538461538461538;18;21;0.0384615384615384;0.461538461538462
Control.SRR15539832;43;38;0.558139534883721;19;24;0.0581395348837209;0.441860465116279
Control.SRR15539832;41;38;0.365853658536585;26;15;0.134146341463415;0.365853658536585
Control.SRR15539832;36;38;0.416666666666667;21;15;0.0833333333333333;0.416666666666667
Control.SRR15539832;42;38;0.5;21;21;0;0.5
Control.SRR15539832;46;38;0.58695652173913;19;27;0.0869565217391305;0.41304347826087
Control.SRR15539832;40;38;0.475;21;19;0.025;0.475
Control.SRR15539832;35;38;0.714285714285714;10;25;0.214285714285714;0.285714285714286
Control.SRR15539832;40;38;0.575;17;23;0.075;0.425
Control.SRR15539832;40;38;0.475;21;19;0.025;0.475
Control.SRR15539832;41;38;0.51219512195122;20;21;0.0121951219512195;0.48780487804878
Control.SRR15539832;36;38;0.527777777777778;17;19;0.0277777777777778;0.472222222222222
Control.SRR15539832;38;38;0.526315789473684;18;20;0.0263157894736842;0.473684210526316
Control.SRR15539832;44;38;0.545454545454545;20;24;0.0454545454545454;0.454545454545455
Control.SRR15539832;45;38;0.6;18;27;0.1;0.4
Control.SRR15539832;37;38;0.486486486486487;19;18;0.0135135135135135;0.486486486486487
Control.SRR15539832;39;38;0.538461538461538;18;21;0.0384615384615384;0.461538461538462
Control.SRR15539832;42;38;0.571428571428571;18;24;0.0714285714285714;0.428571428571429
Control.SRR15539832;36;38;0.472222222222222;19;17;0.0277777777777778;0.472222222222222
Control.SRR15539832;38;38;0.5;19;19;0;0.5
Control.SRR15539832;44;38;0.590909090909091;18;26;0.0909090909090909;0.409090909090909
Control.SRR15539832;44;38;0.477272727272727;23;21;0.0227272727272727;0.477272727272727
Control.SRR15539832;45;38;0.466666666666667;24;21;0.0333333333333333;0.466666666666667
Control.SRR15539832;45;38;0.422222222222222;26;19;0.0777777777777778;0.422222222222222
Control.SRR15539832;44;38;0.545454545454545;20;24;0.0454545454545454;0.454545454545455
Control.SRR15539832;42;38;0.523809523809524;20;22;0.0238095238095238;0.476190476190476
Control.SRR15539832;44;38;0.431818181818182;25;19;0.0681818181818182;0.431818181818182
Control.SRR15539832;37;38;0.459459459459459;20;17;0.0405405405405405;0.459459459459459
Control.SRR15539832;39;38;0.384615384615385;24;15;0.115384615384615;0.384615384615385
Control.SRR15539832;45;38;0.533333333333333;21;24;0.0333333333333333;0.466666666666667
Control.SRR15539832;43;38;0.488372093023256;22;21;0.0116279069767442;0.488372093023256
Control.SRR15539832;36;38;0.555555555555556;16;20;0.0555555555555556;0.444444444444444
Control.SRR15539832;41;38;0.439024390243902;23;18;0.0609756097560976;0.439024390243902
Control.SRR15539832;43;38;0.441860465116279;24;19;0.0581395348837209;0.441860465116279
Control.SRR15539832;41;38;0.51219512195122;20;21;0.0121951219512195;0.48780487804878
Control.SRR15539832;36;38;0.638888888888889;13;23;0.138888888888889;0.361111111111111
Control.SRR15539832;43;38;0.395348837209302;26;17;0.104651162790698;0.395348837209302
Control.SRR15539832;42;38;0.5;21;21;0;0.5
Control.SRR15539832;40;38;0.425;23;17;0.075;0.425
Control.SRR15539832;42;38;0.476190476190476;22;20;0.0238095238095238;0.476190476190476
Control.SRR15539832;36;38;0.5;18;18;0;0.5
Control.SRR15539832;39;38;0.512820512820513;19;20;0.0128205128205128;0.487179487179487
Control.SRR15539832;36;38;0.555555555555556;16;20;0.0555555555555556;0.444444444444444
Control.SRR15539832;39;38;0.333333333333333;26;13;0.166666666666667;0.333333333333333
Control.SRR15539832;35;38;0.457142857142857;19;16;0.0428571428571429;0.457142857142857
Control.SRR15539832;36;38;0.527777777777778;17;19;0.0277777777777778;0.472222222222222
Control.SRR15539832;35;38;0.485714285714286;18;17;0.0142857142857143;0.485714285714286
Control.SRR15539832;45;38;0.488888888888889;23;22;0.0111111111111111;0.488888888888889
Control.SRR15539832;35;38;0.257142857142857;26;9;0.242857142857143;0.257142857142857
Control.SRR15539832;36;38;0.444444444444444;20;16;0.0555555555555556;0.444444444444444
Control.SRR15539832;42;38;0.476190476190476;22;20;0.0238095238095238;0.476190476190476
Control.SRR15539832;38;38;0.526315789473684;18;20;0.0263157894736842;0.473684210526316
Control.SRR15539832;39;38;0.538461538461538;18;21;0.0384615384615384;0.461538461538462
Control.SRR15539832;41;38;0.560975609756098;18;23;0.0609756097560976;0.439024390243902
Control.SRR15539832;38;38;0.394736842105263;23;15;0.105263157894737;0.394736842105263
Control.SRR15539832;37;38;0.432432432432432;21;16;0.0675675675675675;0.432432432432432
Control.SRR15539832;40;38;0.625;15;25;0.125;0.375
Control.SRR15539832;38;38;0.631578947368421;14;24;0.131578947368421;0.368421052631579
Control.SRR15539832;46;38;0.5;23;23;0;0.5
Control.SRR15539832;39;38;0.435897435897436;22;17;0.0641025641025641;0.435897435897436
Control.SRR15539832;45;38;0.511111111111111;22;23;0.0111111111111111;0.488888888888889
Control.SRR15539832;41;38;0.585365853658537;17;24;0.0853658536585366;0.414634146341463
Control.SRR15539832;44;38;0.522727272727273;21;23;0.0227272727272727;0.477272727272727
Control.SRR15539832;46;38;0.521739130434783;22;24;0.0217391304347826;0.478260869565217
Control.SRR15539832;41;38;0.536585365853659;19;22;0.0365853658536586;0.463414634146341
Control.SRR15539832;37;38;0.405405405405405;22;15;0.0945945945945946;0.405405405405405
Control.SRR15539832;38;38;0.447368421052632;21;17;0.0526315789473684;0.447368421052632
Control.SRR15539832;37;38;0.513513513513513;18;19;0.0135135135135135;0.486486486486487
Control.SRR15539832;36;38;0.527777777777778;17;19;0.0277777777777778;0.472222222222222
Control.SRR15539832;39;38;0.41025641025641;23;16;0.0897435897435898;0.41025641025641
Control.SRR15539832;40;38;0.45;22;18;0.05;0.45
Control.SRR15539832;38;38;0.552631578947368;17;21;0.0526315789473685;0.447368421052632
Control.SRR15539832;38;38;0.605263157894737;15;23;0.105263157894737;0.394736842105263
Control.SRR15539832;35;38;0.571428571428571;15;20;0.0714285714285714;0.428571428571429
Control.SRR15539832;38;38;0.394736842105263;23;15;0.105263157894737;0.394736842105263
Control.SRR15539832;38;38;0.5;19;19;0;0.5
Control.SRR15539832;35;38;0.4;21;14;0.1;0.4
Control.SRR15539832;37;38;0.459459459459459;20;17;0.0405405405405405;0.459459459459459
Control.SRR15539832;40;38;0.5;20;20;0;0.5
Control.SRR15539832;37;38;0.432432432432432;21;16;0.0675675675675675;0.432432432432432
Control.SRR15539832;35;38;0.428571428571429;20;15;0.0714285714285715;0.428571428571429
Control.SRR15539832;43;38;0.534883720930233;20;23;0.0348837209302325;0.465116279069767
Control.SRR15539832;39;38;0.564102564102564;17;22;0.0641025641025641;0.435897435897436
Control.SRR15539832;42;38;0.5;21;21;0;0.5
Control.SRR15539832;35;38;0.371428571428571;22;13;0.128571428571429;0.371428571428571
Control.SRR15539832;46;38;0.434782608695652;26;20;0.0652173913043478;0.434782608695652
Control.SRR15539832;41;38;0.609756097560976;16;25;0.109756097560976;0.390243902439024
Control.SRR15539832;39;38;0.435897435897436;22;17;0.0641025641025641;0.435897435897436
Control.SRR15539832;41;38;0.609756097560976;16;25;0.109756097560976;0.390243902439024
Control.SRR15539832;37;38;0.459459459459459;20;17;0.0405405405405405;0.459459459459459
Control.SRR15539832;40;38;0.45;22;18;0.05;0.45
Control.SRR15539832;39;38;0.615384615384615;15;24;0.115384615384615;0.384615384615385
Control.SRR15539832;44;38;0.340909090909091;29;15;0.159090909090909;0.340909090909091
Control.SRR15539832;43;38;0.418604651162791;25;18;0.0813953488372093;0.418604651162791
Control.SRR15539832;43;38;0.534883720930233;20;23;0.0348837209302325;0.465116279069767
Control.SRR15539832;35;38;0.428571428571429;20;15;0.0714285714285715;0.428571428571429
Control.SRR15539832;44;38;0.636363636363636;16;28;0.136363636363636;0.363636363636364
Control.SRR15539832;39;38;0.564102564102564;17;22;0.0641025641025641;0.435897435897436
Control.SRR15539832;37;38;0.594594594594595;15;22;0.0945945945945946;0.405405405405405
Control.SRR15539832;41;38;0.51219512195122;20;21;0.0121951219512195;0.48780487804878
Control.SRR15539832;37;38;0.540540540540541;17;20;0.0405405405405406;0.459459459459459
Control.SRR15539832;43;38;0.441860465116279;24;19;0.0581395348837209;0.441860465116279
Control.SRR15539832;41;38;0.317073170731707;28;13;0.182926829268293;0.317073170731707
Control.SRR15539832;37;38;0.513513513513513;18;19;0.0135135135135135;0.486486486486487
Control.SRR15539832;45;38;0.488888888888889;23;22;0.0111111111111111;0.488888888888889
Control.SRR15539832;44;38;0.659090909090909;15;29;0.159090909090909;0.340909090909091
Control.SRR15539832;46;38;0.326086956521739;31;15;0.173913043478261;0.326086956521739
Control.SRR15539832;45;38;0.511111111111111;22;23;0.0111111111111111;0.488888888888889
Control.SRR15539832;46;38;0.456521739130435;25;21;0.0434782608695652;0.456521739130435
Control.SRR15539832;39;38;0.435897435897436;22;17;0.0641025641025641;0.435897435897436
Control.SRR15539832;36;38;0.416666666666667;21;15;0.0833333333333333;0.416666666666667
Control.SRR15539832;39;38;0.538461538461538;18;21;0.0384615384615384;0.461538461538462
Control.SRR15539832;41;38;0.585365853658537;17;24;0.0853658536585366;0.414634146341463
Control.SRR15539832;37;38;0.567567567567568;16;21;0.0675675675675675;0.432432432432432
Control.SRR15539832;44;38;0.522727272727273;21;23;0.0227272727272727;0.477272727272727
Control.SRR15539832;46;38;0.41304347826087;27;19;0.0869565217391304;0.41304347826087
Control.SRR15539832;37;38;0.432432432432432;21;16;0.0675675675675675;0.432432432432432
Control.SRR15539832;42;38;0.571428571428571;18;24;0.0714285714285714;0.428571428571429
Control.SRR15539832;39;38;0.461538461538462;21;18;0.0384615384615384;0.461538461538462
Control.SRR15539832;38;38;0.526315789473684;18;20;0.0263157894736842;0.473684210526316
Control.SRR15539832;36;38;0.444444444444444;20;16;0.0555555555555556;0.444444444444444
Control.SRR15539832;41;38;0.48780487804878;21;20;0.0121951219512195;0.48780487804878
Control.SRR15539832;46;38;0.434782608695652;26;20;0.0652173913043478;0.434782608695652
Control.SRR15539832;46;38;0.521739130434783;22;24;0.0217391304347826;0.478260869565217
Control.SRR15539832;43;38;0.581395348837209;18;25;0.0813953488372093;0.418604651162791
Control.SRR15539832;37;38;0.513513513513513;18;19;0.0135135135135135;0.486486486486487
Control.SRR15539832;43;38;0.488372093023256;22;21;0.0116279069767442;0.488372093023256
Control.SRR15539832;42;38;0.476190476190476;22;20;0.0238095238095238;0.476190476190476
Control.SRR15539832;32;38;0.46875;17;15;0.03125;0.46875
Control.SRR15539832;31;38;0.483870967741935;16;15;0.0161290322580645;0.483870967741935
Control.SRR15539832;37;38;0.486486486486487;19;18;0.0135135135135135;0.486486486486487
Control.SRR15539832;41;38;0.414634146341463;24;17;0.0853658536585366;0.414634146341463
Control.SRR15539832;37;38;0.513513513513513;18;19;0.0135135135135135;0.486486486486487
Control.SRR15539832;33;38;0.424242424242424;19;14;0.0757575757575757;0.424242424242424
Control.SRR15539832;35;38;0.571428571428571;15;20;0.0714285714285714;0.428571428571429
Control.SRR15539832;41;38;0.48780487804878;21;20;0.0121951219512195;0.48780487804878
Control.SRR15539832;37;38;0.486486486486487;19;18;0.0135135135135135;0.486486486486487
Control.SRR15539832;36;38;0.388888888888889;22;14;0.111111111111111;0.388888888888889
Control.SRR15539832;34;38;0.382352941176471;21;13;0.117647058823529;0.382352941176471
Control.SRR15539832;35;38;0.6;14;21;0.1;0.4
Control.SRR15539832;31;38;0.451612903225806;17;14;0.0483870967741936;0.451612903225806
Control.SRR15539832;32;38;0.4375;18;14;0.0625;0.4375
Control.SRR15539832;35;38;0.371428571428571;22;13;0.128571428571429;0.371428571428571
Control.SRR15539832;38;38;0.552631578947368;17;21;0.0526315789473685;0.447368421052632
Control.SRR15539832;41;38;0.51219512195122;20;21;0.0121951219512195;0.48780487804878
Control.SRR15539832;41;38;0.51219512195122;20;21;0.0121951219512195;0.48780487804878
Control.SRR15539832;40;38;0.475;21;19;0.025;0.475
Control.SRR15539832;33;38;0.333333333333333;22;11;0.166666666666667;0.333333333333333
Control.SRR15539832;32;38;0.4375;18;14;0.0625;0.4375
Control.SRR15539832;31;38;0.451612903225806;17;14;0.0483870967741936;0.451612903225806
Control.SRR15539832;33;38;0.545454545454545;15;18;0.0454545454545454;0.454545454545455
Control.SRR15539832;36;38;0.527777777777778;17;19;0.0277777777777778;0.472222222222222
Control.SRR15539832;32;38;0.53125;15;17;0.03125;0.46875
Control.SRR15539832;36;38;0.388888888888889;22;14;0.111111111111111;0.388888888888889
Control.SRR15539832;37;38;0.459459459459459;20;17;0.0405405405405405;0.459459459459459
Control.SRR15539832;36;38;0.5;18;18;0;0.5
Control.SRR15539832;35;38;0.4;21;14;0.1;0.4
Control.SRR15539832;31;38;0.387096774193548;19;12;0.112903225806452;0.387096774193548
Control.SRR15539832;34;38;0.529411764705882;16;18;0.0294117647058824;0.470588235294118
Control.SRR15539832;35;38;0.542857142857143;16;19;0.0428571428571428;0.457142857142857
Control.SRR15539832;33;38;0.363636363636364;21;12;0.136363636363636;0.363636363636364
Control.SRR15539832;31;38;0.483870967741935;16;15;0.0161290322580645;0.483870967741935
Control.SRR15539832;36;38;0.444444444444444;20;16;0.0555555555555556;0.444444444444444
Control.SRR15539832;39;38;0.58974358974359;16;23;0.0897435897435898;0.41025641025641
Control.SRR15539832;32;38;0.4375;18;14;0.0625;0.4375
Control.SRR15539832;40;38;0.55;18;22;0.05;0.45
Control.SRR15539832;38;38;0.552631578947368;17;21;0.0526315789473685;0.447368421052632
Control.SRR15539832;39;38;0.538461538461538;18;21;0.0384615384615384;0.461538461538462
Control.SRR15539832;36;38;0.527777777777778;17;19;0.0277777777777778;0.472222222222222
Control.SRR15539832;38;38;0.5;19;19;0;0.5
Control.SRR15539832;40;38;0.425;23;17;0.075;0.425
Control.SRR15539832;32;38;0.5625;14;18;0.0625;0.4375
Control.SRR15539832;41;38;0.463414634146341;22;19;0.0365853658536585;0.463414634146341
Control.SRR15539832;37;38;0.432432432432432;21;16;0.0675675675675675;0.432432432432432
Control.SRR15539832;40;38;0.375;25;15;0.125;0.375
Control.SRR15539832;33;38;0.484848484848485;17;16;0.0151515151515151;0.484848484848485
Control.SRR15539832;35;38;0.342857142857143;23;12;0.157142857142857;0.342857142857143
Control.SRR15539832;40;38;0.45;22;18;0.05;0.45
Control.SRR15539832;34;38;0.617647058823529;13;21;0.117647058823529;0.382352941176471
Control.SRR15539832;37;38;0.513513513513513;18;19;0.0135135135135135;0.486486486486487
Control.SRR15539832;32;38;0.5;16;16;0;0.5
Control.SRR15539832;33;38;0.484848484848485;17;16;0.0151515151515151;0.484848484848485
Control.SRR15539832;34;38;0.411764705882353;20;14;0.0882352941176471;0.411764705882353
Control.SRR15539832;34;38;0.558823529411765;15;19;0.0588235294117647;0.441176470588235
Control.SRR15539832;31;38;0.516129032258065;15;16;0.0161290322580645;0.483870967741935
Control.SRR15539832;36;38;0.5;18;18;0;0.5
Control.SRR15539832;37;38;0.567567567567568;16;21;0.0675675675675675;0.432432432432432
Control.SRR15539832;39;38;0.487179487179487;20;19;0.0128205128205128;0.487179487179487
Control.SRR15539832;31;38;0.387096774193548;19;12;0.112903225806452;0.387096774193548
Control.SRR15539832;38;38;0.447368421052632;21;17;0.0526315789473684;0.447368421052632
Control.SRR15539832;38;38;0.552631578947368;17;21;0.0526315789473685;0.447368421052632
Control.SRR15539832;32;38;0.5625;14;18;0.0625;0.4375
Control.SRR15539832;40;38;0.45;22;18;0.05;0.45
Control.SRR15539832;33;38;0.333333333333333;22;11;0.166666666666667;0.333333333333333
Control.SRR15539832;33;38;0.606060606060606;13;20;0.106060606060606;0.393939393939394
Control.SRR15539832;37;38;0.567567567567568;16;21;0.0675675675675675;0.432432432432432
Control.SRR15539832;38;38;0.421052631578947;22;16;0.0789473684210527;0.421052631578947
Control.SRR15539832;41;38;0.560975609756098;18;23;0.0609756097560976;0.439024390243902
Control.SRR15539832;37;38;0.567567567567568;16;21;0.0675675675675675;0.432432432432432
Control.SRR15539832;34;38;0.441176470588235;19;15;0.0588235294117647;0.441176470588235
Control.SRR15539832;36;38;0.416666666666667;21;15;0.0833333333333333;0.416666666666667
Control.SRR15539832;40;38;0.5;20;20;0;0.5
Control.SRR15539832;41;38;0.585365853658537;17;24;0.0853658536585366;0.414634146341463
Control.SRR15539832;40;38;0.5;20;20;0;0.5
Control.SRR15539832;33;38;0.393939393939394;20;13;0.106060606060606;0.393939393939394
Control.SRR15539832;32;38;0.4375;18;14;0.0625;0.4375
Control.SRR15539832;31;38;0.580645161290323;13;18;0.0806451612903226;0.419354838709677
Control.SRR15539832;35;38;0.485714285714286;18;17;0.0142857142857143;0.485714285714286
Control.SRR15539832;39;38;0.538461538461538;18;21;0.0384615384615384;0.461538461538462
Control.SRR15539832;31;38;0.483870967741935;16;15;0.0161290322580645;0.483870967741935
Control.SRR15539832;35;38;0.371428571428571;22;13;0.128571428571429;0.371428571428571
Control.SRR15539832;34;38;0.5;17;17;0;0.5
Control.SRR15539832;40;38;0.45;22;18;0.05;0.45
Control.SRR15539832;33;38;0.484848484848485;17;16;0.0151515151515151;0.484848484848485
Control.SRR15539832;38;38;0.447368421052632;21;17;0.0526315789473684;0.447368421052632
Control.SRR15539832;40;38;0.575;17;23;0.075;0.425
Control.SRR15539832;39;38;0.358974358974359;25;14;0.141025641025641;0.358974358974359
Control.SRR15539832;35;38;0.571428571428571;15;20;0.0714285714285714;0.428571428571429
Control.SRR15539832;33;38;0.515151515151515;16;17;0.0151515151515151;0.484848484848485
Control.SRR15539832;31;38;0.419354838709677;18;13;0.0806451612903226;0.419354838709677
Control.SRR15539832;32;38;0.46875;17;15;0.03125;0.46875
Control.SRR15539832;35;38;0.485714285714286;18;17;0.0142857142857143;0.485714285714286
Control.SRR15539832;33;38;0.545454545454545;15;18;0.0454545454545454;0.454545454545455
Control.SRR15539832;41;38;0.51219512195122;20;21;0.0121951219512195;0.48780487804878
Control.SRR15539832;34;38;0.558823529411765;15;19;0.0588235294117647;0.441176470588235
Control.SRR15539832;32;38;0.4375;18;14;0.0625;0.4375
Control.SRR15539832;32;38;0.46875;17;15;0.03125;0.46875
Control.SRR15539832;36;38;0.444444444444444;20;16;0.0555555555555556;0.444444444444444
Control.SRR15539832;35;38;0.571428571428571;15;20;0.0714285714285714;0.428571428571429
Control.SRR15539832;31;38;0.451612903225806;17;14;0.0483870967741936;0.451612903225806
Control.SRR15539832;33;38;0.454545454545455;18;15;0.0454545454545455;0.454545454545455
Control.SRR15539832;34;38;0.5;17;17;0;0.5
Control.SRR15539832;37;38;0.486486486486487;19;18;0.0135135135135135;0.486486486486487
Control.SRR15539832;31;38;0.387096774193548;19;12;0.112903225806452;0.387096774193548
Control.SRR15539832;38;38;0.447368421052632;21;17;0.0526315789473684;0.447368421052632
Control.SRR15539832;36;38;0.5;18;18;0;0.5
Control.SRR15539832;36;38;0.472222222222222;19;17;0.0277777777777778;0.472222222222222
Control.SRR15539832;34;38;0.558823529411765;15;19;0.0588235294117647;0.441176470588235
Control.SRR15539832;35;38;0.542857142857143;16;19;0.0428571428571428;0.457142857142857
Control.SRR15539832;41;38;0.463414634146341;22;19;0.0365853658536585;0.463414634146341
Control.SRR15539832;39;38;0.564102564102564;17;22;0.0641025641025641;0.435897435897436
Control.SRR15539832;36;38;0.444444444444444;20;16;0.0555555555555556;0.444444444444444
Control.SRR15539832;39;38;0.41025641025641;23;16;0.0897435897435898;0.41025641025641
Control.SRR15539832;36;38;0.527777777777778;17;19;0.0277777777777778;0.472222222222222
Control.SRR15539832;33;38;0.484848484848485;17;16;0.0151515151515151;0.484848484848485
Control.SRR15539832;34;38;0.558823529411765;15;19;0.0588235294117647;0.441176470588235
Control.SRR15539832;32;38;0.4375;18;14;0.0625;0.4375
Control.SRR15539832;31;38;0.483870967741935;16;15;0.0161290322580645;0.483870967741935
Control.SRR15539832;34;38;0.558823529411765;15;19;0.0588235294117647;0.441176470588235
Control.SRR15539832;34;38;0.441176470588235;19;15;0.0588235294117647;0.441176470588235
Control.SRR15539832;37;38;0.324324324324324;25;12;0.175675675675676;0.324324324324324
Control.SRR15539832;38;38;0.421052631578947;22;16;0.0789473684210527;0.421052631578947
Control.SRR15539832;35;38;0.571428571428571;15;20;0.0714285714285714;0.428571428571429
Control.SRR15539832;31;38;0.548387096774194;14;17;0.0483870967741935;0.451612903225806
Control.SRR15539832;36;38;0.416666666666667;21;15;0.0833333333333333;0.416666666666667
Control.SRR15539832;38;38;0.473684210526316;20;18;0.0263157894736842;0.473684210526316
Control.SRR15539832;39;38;0.538461538461538;18;21;0.0384615384615384;0.461538461538462
Control.SRR15539832;41;38;0.560975609756098;18;23;0.0609756097560976;0.439024390243902
Control.SRR15539832;39;38;0.358974358974359;25;14;0.141025641025641;0.358974358974359
Control.SRR15539832;41;38;0.560975609756098;18;23;0.0609756097560976;0.439024390243902
Control.SRR15539832;39;38;0.333333333333333;26;13;0.166666666666667;0.333333333333333
Control.SRR15539832;39;38;0.41025641025641;23;16;0.0897435897435898;0.41025641025641
Control.SRR15539832;37;38;0.459459459459459;20;17;0.0405405405405405;0.459459459459459
Control.SRR15539832;34;38;0.5;17;17;0;0.5
Control.SRR15539832;34;38;0.470588235294118;18;16;0.0294117647058824;0.470588235294118
Control.SRR15539832;40;38;0.55;18;22;0.05;0.45
Control.SRR15539832;34;38;0.5;17;17;0;0.5
Control.SRR15539832;31;38;0.516129032258065;15;16;0.0161290322580645;0.483870967741935
Control.SRR15539832;37;38;0.486486486486487;19;18;0.0135135135135135;0.486486486486487
Control.SRR15539832;31;38;0.483870967741935;16;15;0.0161290322580645;0.483870967741935
Control.SRR15539832;31;38;0.483870967741935;16;15;0.0161290322580645;0.483870967741935
Control.SRR15539832;37;38;0.567567567567568;16;21;0.0675675675675675;0.432432432432432
Control.SRR15539832;40;38;0.425;23;17;0.075;0.425
Control.SRR15539832;37;38;0.378378378378378;23;14;0.121621621621622;0.378378378378378
Control.SRR15539832;37;38;0.567567567567568;16;21;0.0675675675675675;0.432432432432432
Control.SRR15539832;38;38;0.657894736842105;13;25;0.157894736842105;0.342105263157895
Control.SRR15539832;37;38;0.486486486486487;19;18;0.0135135135135135;0.486486486486487
Control.SRR15539832;31;38;0.548387096774194;14;17;0.0483870967741935;0.451612903225806
Control.SRR15539832;35;38;0.514285714285714;17;18;0.0142857142857142;0.485714285714286
Control.SRR15539832;39;38;0.615384615384615;15;24;0.115384615384615;0.384615384615385
Control.SRR15539832;40;38;0.475;21;19;0.025;0.475
Control.SRR15539832;31;38;0.612903225806452;12;19;0.112903225806452;0.387096774193548
Control.SRR15539832;37;38;0.594594594594595;15;22;0.0945945945945946;0.405405405405405
Control.SRR15539832;37;38;0.486486486486487;19;18;0.0135135135135135;0.486486486486487
Control.SRR15539832;38;38;0.552631578947368;17;21;0.0526315789473685;0.447368421052632
Control.SRR15539832;36;38;0.583333333333333;15;21;0.0833333333333334;0.416666666666667
Control.SRR15539832;38;38;0.421052631578947;22;16;0.0789473684210527;0.421052631578947
Control.SRR15539832;34;38;0.411764705882353;20;14;0.0882352941176471;0.411764705882353
Control.SRR15539832;40;38;0.625;15;25;0.125;0.375
Control.SRR15539832;38;38;0.5;19;19;0;0.5
Control.SRR15539832;36;38;0.611111111111111;14;22;0.111111111111111;0.388888888888889
Control.SRR15539832;35;38;0.742857142857143;9;26;0.242857142857143;0.257142857142857
Control.SRR15539832;34;38;0.588235294117647;14;20;0.0882352941176471;0.411764705882353
Control.SRR15539832;34;38;0.617647058823529;13;21;0.117647058823529;0.382352941176471
Control.SRR15539832;33;38;0.484848484848485;17;16;0.0151515151515151;0.484848484848485
Control.SRR15539832;37;38;0.486486486486487;19;18;0.0135135135135135;0.486486486486487
Control.SRR15539832;41;38;0.463414634146341;22;19;0.0365853658536585;0.463414634146341
Control.SRR15539832;32;38;0.46875;17;15;0.03125;0.46875
Control.SRR15539832;34;38;0.5;17;17;0;0.5
Control.SRR15539832;34;38;0.470588235294118;18;16;0.0294117647058824;0.470588235294118
Control.SRR15539832;34;38;0.529411764705882;16;18;0.0294117647058824;0.470588235294118
Control.SRR15539832;33;38;0.606060606060606;13;20;0.106060606060606;0.393939393939394
Control.SRR15539832;40;38;0.525;19;21;0.025;0.475
Control.SRR15539832;33;38;0.454545454545455;18;15;0.0454545454545455;0.454545454545455
Control.SRR15539832;41;38;0.341463414634146;27;14;0.158536585365854;0.341463414634146
Control.SRR15539832;35;38;0.428571428571429;20;15;0.0714285714285715;0.428571428571429
Control.SRR15539832;37;38;0.405405405405405;22;15;0.0945945945945946;0.405405405405405
Control.SRR15539832;37;38;0.459459459459459;20;17;0.0405405405405405;0.459459459459459
Control.SRR15539832;40;38;0.55;18;22;0.05;0.45
Control.SRR15539832;39;38;0.512820512820513;19;20;0.0128205128205128;0.487179487179487
Control.SRR15539832;39;38;0.435897435897436;22;17;0.0641025641025641;0.435897435897436
Control.SRR15539832;31;38;0.483870967741935;16;15;0.0161290322580645;0.483870967741935
Control.SRR15539832;38;38;0.5;19;19;0;0.5
Control.SRR15539832;38;38;0.526315789473684;18;20;0.0263157894736842;0.473684210526316
Control.SRR15539832;35;38;0.514285714285714;17;18;0.0142857142857142;0.485714285714286
Control.SRR15539832;36;38;0.444444444444444;20;16;0.0555555555555556;0.444444444444444
Control.SRR15539832;38;38;0.578947368421053;16;22;0.0789473684210527;0.421052631578947
Control.SRR15539832;38;38;0.421052631578947;22;16;0.0789473684210527;0.421052631578947
Control.SRR15539832;36;38;0.472222222222222;19;17;0.0277777777777778;0.472222222222222
Control.SRR15539832;41;38;0.317073170731707;28;13;0.182926829268293;0.317073170731707
Control.SRR15539832;36;38;0.611111111111111;14;22;0.111111111111111;0.388888888888889
Control.SRR15539832;39;38;0.538461538461538;18;21;0.0384615384615384;0.461538461538462
Control.SRR15539832;39;38;0.512820512820513;19;20;0.0128205128205128;0.487179487179487
Control.SRR15539832;37;38;0.513513513513513;18;19;0.0135135135135135;0.486486486486487
Control.SRR15539832;33;38;0.575757575757576;14;19;0.0757575757575758;0.424242424242424
Control.SRR15539832;33;38;0.484848484848485;17;16;0.0151515151515151;0.484848484848485
Control.SRR15539832;34;38;0.558823529411765;15;19;0.0588235294117647;0.441176470588235
Control.SRR15539832;38;38;0.684210526315789;12;26;0.184210526315789;0.315789473684211
Control.SRR15539832;36;38;0.305555555555556;25;11;0.194444444444444;0.305555555555556
Control.SRR15539832;40;38;0.525;19;21;0.025;0.475
Control.SRR15539832;35;38;0.542857142857143;16;19;0.0428571428571428;0.457142857142857
Control.SRR15539832;37;38;0.567567567567568;16;21;0.0675675675675675;0.432432432432432
Control.SRR15539832;41;38;0.48780487804878;21;20;0.0121951219512195;0.48780487804878
Control.SRR15539832;41;38;0.536585365853659;19;22;0.0365853658536586;0.463414634146341
Control.SRR15539832;31;38;0.483870967741935;16;15;0.0161290322580645;0.483870967741935
Control.SRR15539832;38;38;0.526315789473684;18;20;0.0263157894736842;0.473684210526316
Control.SRR15539832;37;38;0.621621621621622;14;23;0.121621621621622;0.378378378378378
Control.SRR15539832;35;38;0.428571428571429;20;15;0.0714285714285715;0.428571428571429
Control.SRR15539832;37;38;0.621621621621622;14;23;0.121621621621622;0.378378378378378
Control.SRR15539832;35;38;0.657142857142857;12;23;0.157142857142857;0.342857142857143
Control.SRR15539832;33;38;0.363636363636364;21;12;0.136363636363636;0.363636363636364
Control.SRR15539832;41;38;0.463414634146341;22;19;0.0365853658536585;0.463414634146341
Control.SRR15539832;31;38;0.419354838709677;18;13;0.0806451612903226;0.419354838709677
Control.SRR15539832;34;38;0.529411764705882;16;18;0.0294117647058824;0.470588235294118
Control.SRR15539832;33;38;0.545454545454545;15;18;0.0454545454545454;0.454545454545455
Control.SRR15539832;39;38;0.512820512820513;19;20;0.0128205128205128;0.487179487179487
Control.SRR15539832;36;38;0.361111111111111;23;13;0.138888888888889;0.361111111111111
Control.SRR15539832;35;38;0.514285714285714;17;18;0.0142857142857142;0.485714285714286
Control.SRR15539832;40;38;0.525;19;21;0.025;0.475
Control.SRR15539832;31;38;0.483870967741935;16;15;0.0161290322580645;0.483870967741935
Control.SRR15539832;33;38;0.363636363636364;21;12;0.136363636363636;0.363636363636364
Control.SRR15539832;41;38;0.536585365853659;19;22;0.0365853658536586;0.463414634146341
Control.SRR15539832;38;38;0.5;19;19;0;0.5
Control.SRR15539832;33;38;0.666666666666667;11;22;0.166666666666667;0.333333333333333
Control.SRR15539832;41;38;0.536585365853659;19;22;0.0365853658536586;0.463414634146341
Control.SRR15539832;37;38;0.540540540540541;17;20;0.0405405405405406;0.459459459459459
Control.SRR15539832;41;38;0.51219512195122;20;21;0.0121951219512195;0.48780487804878
Control.SRR15539832;39;38;0.538461538461538;18;21;0.0384615384615384;0.461538461538462
Control.SRR15539832;38;38;0.394736842105263;23;15;0.105263157894737;0.394736842105263
Control.SRR15539832;31;38;0.419354838709677;18;13;0.0806451612903226;0.419354838709677
Control.SRR15539832;37;38;0.486486486486487;19;18;0.0135135135135135;0.486486486486487
Control.SRR15539832;34;38;0.558823529411765;15;19;0.0588235294117647;0.441176470588235
Control.SRR15539832;38;38;0.473684210526316;20;18;0.0263157894736842;0.473684210526316
Control.SRR15539832;39;38;0.487179487179487;20;19;0.0128205128205128;0.487179487179487
Control.SRR15539832;40;38;0.575;17;23;0.075;0.425
Control.SRR15539832;35;38;0.428571428571429;20;15;0.0714285714285715;0.428571428571429
Control.SRR15539832;39;38;0.461538461538462;21;18;0.0384615384615384;0.461538461538462
Control.SRR15539832;40;38;0.45;22;18;0.05;0.45
Control.SRR15539832;31;38;0.580645161290323;13;18;0.0806451612903226;0.419354838709677
Control.SRR15539832;35;38;0.485714285714286;18;17;0.0142857142857143;0.485714285714286
Control.SRR15539832;35;38;0.542857142857143;16;19;0.0428571428571428;0.457142857142857
Control.SRR15539832;34;38;0.470588235294118;18;16;0.0294117647058824;0.470588235294118
Control.SRR15539832;36;38;0.527777777777778;17;19;0.0277777777777778;0.472222222222222
Control.SRR15539832;36;38;0.5;18;18;0;0.5
Control.SRR15539832;39;38;0.41025641025641;23;16;0.0897435897435898;0.41025641025641
Control.SRR15539832;33;38;0.454545454545455;18;15;0.0454545454545455;0.454545454545455
Control.SRR15539832;36;38;0.555555555555556;16;20;0.0555555555555556;0.444444444444444
Control.SRR15539832;37;38;0.567567567567568;16;21;0.0675675675675675;0.432432432432432
Control.SRR15539832;36;38;0.444444444444444;20;16;0.0555555555555556;0.444444444444444
Control.SRR15539832;40;38;0.525;19;21;0.025;0.475
Control.SRR15539832;39;38;0.58974358974359;16;23;0.0897435897435898;0.41025641025641
Control.SRR15539832;34;38;0.411764705882353;20;14;0.0882352941176471;0.411764705882353
Control.SRR15539832;33;38;0.454545454545455;18;15;0.0454545454545455;0.454545454545455
Control.SRR15539832;39;38;0.487179487179487;20;19;0.0128205128205128;0.487179487179487
Control.SRR15539832;32;38;0.5;16;16;0;0.5
Control.SRR15539832;33;38;0.484848484848485;17;16;0.0151515151515151;0.484848484848485
Control.SRR15539832;36;38;0.583333333333333;15;21;0.0833333333333334;0.416666666666667
Control.SRR15539832;33;38;0.424242424242424;19;14;0.0757575757575757;0.424242424242424
Control.SRR15539832;32;38;0.34375;21;11;0.15625;0.34375
Control.SRR15539832;38;38;0.578947368421053;16;22;0.0789473684210527;0.421052631578947
Control.SRR15539832;34;38;0.441176470588235;19;15;0.0588235294117647;0.441176470588235
Control.SRR15539832;31;38;0.483870967741935;16;15;0.0161290322580645;0.483870967741935
Control.SRR15539832;37;38;0.513513513513513;18;19;0.0135135135135135;0.486486486486487
Control.SRR15539832;40;38;0.5;20;20;0;0.5
Control.SRR15539832;40;38;0.5;20;20;0;0.5
Control.SRR15539832;35;38;0.285714285714286;25;10;0.214285714285714;0.285714285714286
Control.SRR15539832;33;38;0.484848484848485;17;16;0.0151515151515151;0.484848484848485
Control.SRR15539832;38;38;0.473684210526316;20;18;0.0263157894736842;0.473684210526316
Control.SRR15539832;33;38;0.575757575757576;14;19;0.0757575757575758;0.424242424242424
Control.SRR15539832;40;38;0.575;17;23;0.075;0.425
Control.SRR15539832;39;38;0.564102564102564;17;22;0.0641025641025641;0.435897435897436
Control.SRR15539832;36;38;0.472222222222222;19;17;0.0277777777777778;0.472222222222222
Control.SRR15539832;37;38;0.486486486486487;19;18;0.0135135135135135;0.486486486486487
Control.SRR15539832;36;38;0.527777777777778;17;19;0.0277777777777778;0.472222222222222
Control.SRR15539832;35;38;0.571428571428571;15;20;0.0714285714285714;0.428571428571429
Control.SRR15539832;31;38;0.451612903225806;17;14;0.0483870967741936;0.451612903225806
Control.SRR15539832;37;38;0.351351351351351;24;13;0.148648648648649;0.351351351351351
Control.SRR15539832;37;38;0.513513513513513;18;19;0.0135135135135135;0.486486486486487
Control.SRR15539832;35;38;0.428571428571429;20;15;0.0714285714285715;0.428571428571429
Control.SRR15539832;32;38;0.625;12;20;0.125;0.375
Control.SRR15539832;33;38;0.636363636363636;12;21;0.136363636363636;0.363636363636364
Control.SRR15539832;36;38;0.611111111111111;14;22;0.111111111111111;0.388888888888889
Control.SRR15539832;33;38;0.454545454545455;18;15;0.0454545454545455;0.454545454545455
Control.SRR15539832;37;38;0.594594594594595;15;22;0.0945945945945946;0.405405405405405
Control.SRR15539832;38;38;0.526315789473684;18;20;0.0263157894736842;0.473684210526316
Control.SRR15539832;41;38;0.560975609756098;18;23;0.0609756097560976;0.439024390243902
Control.SRR15539832;40;38;0.65;14;26;0.15;0.35
Control.SRR15539832;39;38;0.487179487179487;20;19;0.0128205128205128;0.487179487179487
Control.SRR15539832;38;38;0.526315789473684;18;20;0.0263157894736842;0.473684210526316
Control.SRR15539832;39;38;0.461538461538462;21;18;0.0384615384615384;0.461538461538462
Control.SRR15539832;35;38;0.685714285714286;11;24;0.185714285714286;0.314285714285714
Control.SRR15539832;38;38;0.289473684210526;27;11;0.210526315789474;0.289473684210526
Control.SRR15539832;31;38;0.483870967741935;16;15;0.0161290322580645;0.483870967741935
Control.SRR15539832;32;38;0.5;16;16;0;0.5
Control.SRR15539832;37;38;0.540540540540541;17;20;0.0405405405405406;0.459459459459459
Control.SRR15539832;40;38;0.425;23;17;0.075;0.425
Control.SRR15539832;39;38;0.58974358974359;16;23;0.0897435897435898;0.41025641025641
Control.SRR15539832;37;38;0.486486486486487;19;18;0.0135135135135135;0.486486486486487
Control.SRR15539832;33;38;0.454545454545455;18;15;0.0454545454545455;0.454545454545455
Control.SRR15539832;38;38;0.447368421052632;21;17;0.0526315789473684;0.447368421052632
Control.SRR15539832;41;38;0.48780487804878;21;20;0.0121951219512195;0.48780487804878
Control.SRR15539832;39;38;0.487179487179487;20;19;0.0128205128205128;0.487179487179487
Control.SRR15539832;35;38;0.457142857142857;19;16;0.0428571428571429;0.457142857142857
Control.SRR15539832;33;38;0.393939393939394;20;13;0.106060606060606;0.393939393939394
Control.SRR15539832;40;38;0.475;21;19;0.025;0.475
Control.SRR15539832;39;38;0.461538461538462;21;18;0.0384615384615384;0.461538461538462
Control.SRR15539832;32;38;0.5625;14;18;0.0625;0.4375
Control.SRR15539832;33;38;0.484848484848485;17;16;0.0151515151515151;0.484848484848485
Control.SRR15539832;34;38;0.529411764705882;16;18;0.0294117647058824;0.470588235294118
Control.SRR15539832;36;38;0.444444444444444;20;16;0.0555555555555556;0.444444444444444
Control.SRR15539832;35;38;0.314285714285714;24;11;0.185714285714286;0.314285714285714
Control.SRR15539832;40;38;0.45;22;18;0.05;0.45
Control.SRR15539832;41;38;0.609756097560976;16;25;0.109756097560976;0.390243902439024
Control.SRR15539832;31;38;0.354838709677419;20;11;0.145161290322581;0.354838709677419
Control.SRR15539832;35;38;0.628571428571429;13;22;0.128571428571429;0.371428571428571
Control.SRR15539832;41;38;0.48780487804878;21;20;0.0121951219512195;0.48780487804878
Control.SRR15539832;38;38;0.421052631578947;22;16;0.0789473684210527;0.421052631578947
Control.SRR15539832;36;38;0.666666666666667;12;24;0.166666666666667;0.333333333333333
Control.SRR15539832;41;38;0.609756097560976;16;25;0.109756097560976;0.390243902439024
Control.SRR15539832;41;38;0.634146341463415;15;26;0.134146341463415;0.365853658536585
Control.SRR15539832;38;38;0.526315789473684;18;20;0.0263157894736842;0.473684210526316
Control.SRR15539832;34;38;0.470588235294118;18;16;0.0294117647058824;0.470588235294118
Control.SRR15539832;33;38;0.393939393939394;20;13;0.106060606060606;0.393939393939394
Control.SRR15539832;40;38;0.425;23;17;0.075;0.425
Control.SRR15539832;38;38;0.473684210526316;20;18;0.0263157894736842;0.473684210526316
Control.SRR15539832;33;38;0.333333333333333;22;11;0.166666666666667;0.333333333333333
Control.SRR15539832;39;38;0.564102564102564;17;22;0.0641025641025641;0.435897435897436
Control.SRR15539832;39;38;0.58974358974359;16;23;0.0897435897435898;0.41025641025641
Control.SRR15539832;40;38;0.625;15;25;0.125;0.375
Control.SRR15539832;39;38;0.435897435897436;22;17;0.0641025641025641;0.435897435897436
Control.SRR15539832;37;38;0.432432432432432;21;16;0.0675675675675675;0.432432432432432
Control.SRR15539832;39;38;0.461538461538462;21;18;0.0384615384615384;0.461538461538462
Control.SRR15539832;41;38;0.439024390243902;23;18;0.0609756097560976;0.439024390243902
Control.SRR15539832;37;38;0.459459459459459;20;17;0.0405405405405405;0.459459459459459
Control.SRR15539832;34;38;0.470588235294118;18;16;0.0294117647058824;0.470588235294118
Control.SRR15539832;39;38;0.435897435897436;22;17;0.0641025641025641;0.435897435897436
Control.SRR15539832;37;38;0.567567567567568;16;21;0.0675675675675675;0.432432432432432
Control.SRR15539832;40;38;0.5;20;20;0;0.5
Control.SRR15539832;37;38;0.486486486486487;19;18;0.0135135135135135;0.486486486486487
Control.SRR15539832;41;38;0.51219512195122;20;21;0.0121951219512195;0.48780487804878
Control.SRR15539832;37;38;0.486486486486487;19;18;0.0135135135135135;0.486486486486487
Control.SRR15539832;40;38;0.575;17;23;0.075;0.425
Control.SRR15539832;38;38;0.631578947368421;14;24;0.131578947368421;0.368421052631579
Control.SRR15539832;32;38;0.4375;18;14;0.0625;0.4375
Control.SRR15539832;37;38;0.540540540540541;17;20;0.0405405405405406;0.459459459459459
Control.SRR15539832;39;38;0.564102564102564;17;22;0.0641025641025641;0.435897435897436
Control.SRR15539832;40;38;0.475;21;19;0.025;0.475
Control.SRR15539832;35;38;0.371428571428571;22;13;0.128571428571429;0.371428571428571
Control.SRR15539832;34;38;0.588235294117647;14;20;0.0882352941176471;0.411764705882353
Control.SRR15539832;39;38;0.512820512820513;19;20;0.0128205128205128;0.487179487179487
Control.SRR15539832;41;38;0.463414634146341;22;19;0.0365853658536585;0.463414634146341
Control.SRR15539832;36;38;0.472222222222222;19;17;0.0277777777777778;0.472222222222222
Control.SRR15539832;39;38;0.512820512820513;19;20;0.0128205128205128;0.487179487179487
Control.SRR15539832;32;38;0.4375;18;14;0.0625;0.4375
Control.SRR15539832;34;38;0.470588235294118;18;16;0.0294117647058824;0.470588235294118
Control.SRR15539832;41;38;0.585365853658537;17;24;0.0853658536585366;0.414634146341463
Control.SRR15539832;36;38;0.472222222222222;19;17;0.0277777777777778;0.472222222222222
Control.SRR15539832;37;38;0.540540540540541;17;20;0.0405405405405406;0.459459459459459
Control.SRR15539832;35;38;0.685714285714286;11;24;0.185714285714286;0.314285714285714
Control.SRR15539832;32;38;0.53125;15;17;0.03125;0.46875
Control.SRR15539832;34;38;0.617647058823529;13;21;0.117647058823529;0.382352941176471
Control.SRR15539832;35;38;0.285714285714286;25;10;0.214285714285714;0.285714285714286
Control.SRR15539832;31;38;0.548387096774194;14;17;0.0483870967741935;0.451612903225806
Control.SRR15539832;33;38;0.636363636363636;12;21;0.136363636363636;0.363636363636364
Control.SRR15539832;37;38;0.567567567567568;16;21;0.0675675675675675;0.432432432432432
Control.SRR15539832;37;38;0.459459459459459;20;17;0.0405405405405405;0.459459459459459
Control.SRR15539832;39;38;0.487179487179487;20;19;0.0128205128205128;0.487179487179487
Control.SRR15539832;32;38;0.53125;15;17;0.03125;0.46875
Control.SRR15539832;31;38;0.451612903225806;17;14;0.0483870967741936;0.451612903225806
Control.SRR15539832;34;38;0.617647058823529;13;21;0.117647058823529;0.382352941176471
Control.SRR15539832;38;38;0.552631578947368;17;21;0.0526315789473685;0.447368421052632
Control.SRR15539832;33;38;0.515151515151515;16;17;0.0151515151515151;0.484848484848485
Control.SRR15539832;36;38;0.444444444444444;20;16;0.0555555555555556;0.444444444444444
Control.SRR15539832;35;38;0.514285714285714;17;18;0.0142857142857142;0.485714285714286
Control.SRR15539832;36;38;0.583333333333333;15;21;0.0833333333333334;0.416666666666667
Control.SRR15539832;39;38;0.461538461538462;21;18;0.0384615384615384;0.461538461538462
Control.SRR15539832;39;38;0.435897435897436;22;17;0.0641025641025641;0.435897435897436
Control.SRR15539832;40;38;0.575;17;23;0.075;0.425
Control.SRR15539832;38;38;0.394736842105263;23;15;0.105263157894737;0.394736842105263
Control.SRR15539832;38;38;0.447368421052632;21;17;0.0526315789473684;0.447368421052632
Control.SRR15539832;40;38;0.6;16;24;0.1;0.4
Control.SRR15539832;35;38;0.542857142857143;16;19;0.0428571428571428;0.457142857142857
Control.SRR15539832;36;38;0.444444444444444;20;16;0.0555555555555556;0.444444444444444
Control.SRR15539832;39;38;0.435897435897436;22;17;0.0641025641025641;0.435897435897436
Control.SRR15539832;34;38;0.647058823529412;12;22;0.147058823529412;0.352941176470588
Control.SRR15539832;36;38;0.694444444444444;11;25;0.194444444444444;0.305555555555556
Control.SRR15539832;38;38;0.552631578947368;17;21;0.0526315789473685;0.447368421052632
Control.SRR15539832;40;38;0.525;19;21;0.025;0.475
Control.SRR15539832;37;38;0.459459459459459;20;17;0.0405405405405405;0.459459459459459
Control.SRR15539832;35;38;0.514285714285714;17;18;0.0142857142857142;0.485714285714286
Control.SRR15539832;34;38;0.5;17;17;0;0.5
Control.SRR15539832;41;38;0.536585365853659;19;22;0.0365853658536586;0.463414634146341
Control.SRR15539832;33;38;0.424242424242424;19;14;0.0757575757575757;0.424242424242424
Control.SRR15539832;41;38;0.585365853658537;17;24;0.0853658536585366;0.414634146341463
Control.SRR15539832;41;38;0.560975609756098;18;23;0.0609756097560976;0.439024390243902
Control.SRR15539832;38;38;0.473684210526316;20;18;0.0263157894736842;0.473684210526316
Control.SRR15539832;38;38;0.394736842105263;23;15;0.105263157894737;0.394736842105263
Control.SRR15539832;39;38;0.435897435897436;22;17;0.0641025641025641;0.435897435897436
Control.SRR15539832;34;38;0.588235294117647;14;20;0.0882352941176471;0.411764705882353
Control.SRR15539832;36;38;0.416666666666667;21;15;0.0833333333333333;0.416666666666667
Control.SRR15539832;39;38;0.512820512820513;19;20;0.0128205128205128;0.487179487179487
Control.SRR15539832;40;38;0.525;19;21;0.025;0.475
Control.SRR15539832;37;38;0.513513513513513;18;19;0.0135135135135135;0.486486486486487
Control.SRR15539832;38;38;0.447368421052632;21;17;0.0526315789473684;0.447368421052632
Control.SRR15539832;37;38;0.486486486486487;19;18;0.0135135135135135;0.486486486486487
Control.SRR15539832;41;38;0.48780487804878;21;20;0.0121951219512195;0.48780487804878
Control.SRR15539832;39;38;0.564102564102564;17;22;0.0641025641025641;0.435897435897436
Control.SRR15539832;40;38;0.6;16;24;0.1;0.4
Control.SRR15539832;37;38;0.594594594594595;15;22;0.0945945945945946;0.405405405405405
Control.SRR15539832;33;38;0.545454545454545;15;18;0.0454545454545454;0.454545454545455
Control.SRR15539832;35;38;0.457142857142857;19;16;0.0428571428571429;0.457142857142857
Control.SRR15539832;37;38;0.459459459459459;20;17;0.0405405405405405;0.459459459459459
Control.SRR15539832;32;38;0.5;16;16;0;0.5
Control.SRR15539832;33;38;0.696969696969697;10;23;0.196969696969697;0.303030303030303
Control.SRR15539832;31;38;0.290322580645161;22;9;0.209677419354839;0.290322580645161
Control.SRR15539832;33;38;0.515151515151515;16;17;0.0151515151515151;0.484848484848485
Control.SRR15539832;40;38;0.425;23;17;0.075;0.425
Control.SRR15539832;34;38;0.647058823529412;12;22;0.147058823529412;0.352941176470588
Control.SRR15539832;40;38;0.525;19;21;0.025;0.475
Control.SRR15539832;36;38;0.666666666666667;12;24;0.166666666666667;0.333333333333333
Control.SRR15539832;35;38;0.657142857142857;12;23;0.157142857142857;0.342857142857143
Control.SRR15539832;31;38;0.451612903225806;17;14;0.0483870967741936;0.451612903225806
Control.SRR15539832;33;38;0.424242424242424;19;14;0.0757575757575757;0.424242424242424
Control.SRR15539832;38;38;0.394736842105263;23;15;0.105263157894737;0.394736842105263
Control.SRR15539832;38;38;0.578947368421053;16;22;0.0789473684210527;0.421052631578947
Control.SRR15539832;37;38;0.459459459459459;20;17;0.0405405405405405;0.459459459459459
Control.SRR15539832;38;38;0.526315789473684;18;20;0.0263157894736842;0.473684210526316
Control.SRR15539832;36;38;0.416666666666667;21;15;0.0833333333333333;0.416666666666667
Control.SRR15539832;37;38;0.540540540540541;17;20;0.0405405405405406;0.459459459459459
Control.SRR15539832;39;38;0.512820512820513;19;20;0.0128205128205128;0.487179487179487
Control.SRR15539832;37;38;0.567567567567568;16;21;0.0675675675675675;0.432432432432432
Control.SRR15539832;37;38;0.378378378378378;23;14;0.121621621621622;0.378378378378378
Control.SRR15539832;37;38;0.486486486486487;19;18;0.0135135135135135;0.486486486486487
Control.SRR15539832;34;38;0.441176470588235;19;15;0.0588235294117647;0.441176470588235
Control.SRR15539832;36;38;0.527777777777778;17;19;0.0277777777777778;0.472222222222222
Control.SRR15539832;39;38;0.564102564102564;17;22;0.0641025641025641;0.435897435897436
Control.SRR15539832;38;38;0.473684210526316;20;18;0.0263157894736842;0.473684210526316
Control.SRR15539832;40;38;0.4;24;16;0.1;0.4
Control.SRR15539832;31;38;0.612903225806452;12;19;0.112903225806452;0.387096774193548
Control.SRR15539832;35;38;0.571428571428571;15;20;0.0714285714285714;0.428571428571429
Control.SRR15539832;31;38;0.516129032258065;15;16;0.0161290322580645;0.483870967741935
Control.SRR15539832;35;38;0.457142857142857;19;16;0.0428571428571429;0.457142857142857
Control.SRR15539832;39;38;0.538461538461538;18;21;0.0384615384615384;0.461538461538462
Control.SRR15539832;39;38;0.564102564102564;17;22;0.0641025641025641;0.435897435897436
Control.SRR15539832;35;38;0.571428571428571;15;20;0.0714285714285714;0.428571428571429
Control.SRR15539832;40;38;0.55;18;22;0.05;0.45
Control.SRR15539832;35;38;0.514285714285714;17;18;0.0142857142857142;0.485714285714286
Control.SRR15539832;39;38;0.384615384615385;24;15;0.115384615384615;0.384615384615385
Control.SRR15539832;32;38;0.59375;13;19;0.09375;0.40625
Control.SRR15539832;33;38;0.454545454545455;18;15;0.0454545454545455;0.454545454545455
Control.SRR15539832;39;38;0.487179487179487;20;19;0.0128205128205128;0.487179487179487
Control.SRR15539832;31;38;0.483870967741935;16;15;0.0161290322580645;0.483870967741935
Control.SRR15539832;38;38;0.5;19;19;0;0.5
Control.SRR15539832;33;38;0.393939393939394;20;13;0.106060606060606;0.393939393939394
Control.SRR15539832;34;38;0.5;17;17;0;0.5
Control.SRR15539832;34;38;0.470588235294118;18;16;0.0294117647058824;0.470588235294118
Control.SRR15539832;37;38;0.459459459459459;20;17;0.0405405405405405;0.459459459459459
Control.SRR15539832;44;38;0.522727272727273;21;23;0.0227272727272727;0.477272727272727
Control.SRR15539832;40;38;0.6;16;24;0.1;0.4
Control.SRR15539832;41;38;0.341463414634146;27;14;0.158536585365854;0.341463414634146
Control.SRR15539832;40;38;0.375;25;15;0.125;0.375
Control.SRR15539832;41;38;0.414634146341463;24;17;0.0853658536585366;0.414634146341463
Control.SRR15539832;36;38;0.583333333333333;15;21;0.0833333333333334;0.416666666666667
Control.SRR15539832;38;38;0.526315789473684;18;20;0.0263157894736842;0.473684210526316
Control.SRR15539832;44;38;0.545454545454545;20;24;0.0454545454545454;0.454545454545455
Control.SRR15539832;40;38;0.475;21;19;0.025;0.475
Control.SRR15539832;40;38;0.5;20;20;0;0.5
Control.SRR15539832;40;38;0.525;19;21;0.025;0.475
Control.SRR15539832;43;38;0.627906976744186;16;27;0.127906976744186;0.372093023255814
Control.SRR15539832;38;38;0.526315789473684;18;20;0.0263157894736842;0.473684210526316
Control.SRR15539832;40;38;0.5;20;20;0;0.5
Control.SRR15539832;39;38;0.58974358974359;16;23;0.0897435897435898;0.41025641025641
Control.SRR15539832;42;38;0.452380952380952;23;19;0.0476190476190476;0.452380952380952
Control.SRR15539832;36;38;0.472222222222222;19;17;0.0277777777777778;0.472222222222222
Control.SRR15539832;42;38;0.333333333333333;28;14;0.166666666666667;0.333333333333333
Control.SRR15539832;34;38;0.441176470588235;19;15;0.0588235294117647;0.441176470588235
Control.SRR15539832;36;38;0.527777777777778;17;19;0.0277777777777778;0.472222222222222
Control.SRR15539832;38;38;0.394736842105263;23;15;0.105263157894737;0.394736842105263
Control.SRR15539832;35;38;0.6;14;21;0.1;0.4
Control.SRR15539832;35;38;0.428571428571429;20;15;0.0714285714285715;0.428571428571429
Control.SRR15539832;40;38;0.475;21;19;0.025;0.475
Control.SRR15539832;36;38;0.583333333333333;15;21;0.0833333333333334;0.416666666666667
Control.SRR15539832;37;38;0.621621621621622;14;23;0.121621621621622;0.378378378378378
Control.SRR15539832;37;38;0.621621621621622;14;23;0.121621621621622;0.378378378378378
Control.SRR15539832;40;38;0.45;22;18;0.05;0.45
Control.SRR15539832;42;38;0.380952380952381;26;16;0.119047619047619;0.380952380952381
Control.SRR15539832;39;38;0.461538461538462;21;18;0.0384615384615384;0.461538461538462
Control.SRR15539832;38;38;0.526315789473684;18;20;0.0263157894736842;0.473684210526316
Control.SRR15539832;40;38;0.575;17;23;0.075;0.425
Control.SRR15539832;37;38;0.297297297297297;26;11;0.202702702702703;0.297297297297297
Control.SRR15539832;38;38;0.552631578947368;17;21;0.0526315789473685;0.447368421052632
Control.SRR15539832;43;38;0.604651162790698;17;26;0.104651162790698;0.395348837209302
Control.SRR15539832;40;38;0.4;24;16;0.1;0.4
Control.SRR15539832;41;38;0.463414634146341;22;19;0.0365853658536585;0.463414634146341
Control.SRR15539832;40;38;0.4;24;16;0.1;0.4
Control.SRR15539832;38;38;0.447368421052632;21;17;0.0526315789473684;0.447368421052632
Control.SRR15539832;34;38;0.558823529411765;15;19;0.0588235294117647;0.441176470588235
Control.SRR15539832;35;38;0.485714285714286;18;17;0.0142857142857143;0.485714285714286
Control.SRR15539832;44;38;0.5;22;22;0;0.5
Control.SRR15539832;38;38;0.421052631578947;22;16;0.0789473684210527;0.421052631578947
Control.SRR15539832;43;38;0.395348837209302;26;17;0.104651162790698;0.395348837209302
Control.SRR15539832;40;38;0.4;24;16;0.1;0.4
Control.SRR15539832;40;38;0.4;24;16;0.1;0.4
Control.SRR15539832;41;38;0.560975609756098;18;23;0.0609756097560976;0.439024390243902
Control.SRR15539832;41;38;0.585365853658537;17;24;0.0853658536585366;0.414634146341463
Control.SRR15539832;44;38;0.590909090909091;18;26;0.0909090909090909;0.409090909090909
Control.SRR15539832;36;38;0.472222222222222;19;17;0.0277777777777778;0.472222222222222
Control.SRR15539832;40;38;0.6;16;24;0.1;0.4
Control.SRR15539832;36;38;0.777777777777778;8;28;0.277777777777778;0.222222222222222
Control.SRR15539832;37;38;0.324324324324324;25;12;0.175675675675676;0.324324324324324
Control.SRR15539832;35;38;0.4;21;14;0.1;0.4
Control.SRR15539832;35;38;0.485714285714286;18;17;0.0142857142857143;0.485714285714286
Control.SRR15539832;43;38;0.395348837209302;26;17;0.104651162790698;0.395348837209302
Control.SRR15539832;38;38;0.447368421052632;21;17;0.0526315789473684;0.447368421052632
Control.SRR15539832;38;38;0.421052631578947;22;16;0.0789473684210527;0.421052631578947
Control.SRR15539832;42;38;0.428571428571429;24;18;0.0714285714285715;0.428571428571429
Control.SRR15539832;44;38;0.386363636363636;27;17;0.113636363636364;0.386363636363636
Control.SRR15539832;44;38;0.477272727272727;23;21;0.0227272727272727;0.477272727272727
Control.SRR15539832;41;38;0.463414634146341;22;19;0.0365853658536585;0.463414634146341
Control.SRR15539832;34;38;0.529411764705882;16;18;0.0294117647058824;0.470588235294118
Control.SRR15539832;41;38;0.463414634146341;22;19;0.0365853658536585;0.463414634146341
Control.SRR15539832;36;38;0.444444444444444;20;16;0.0555555555555556;0.444444444444444
Control.SRR15539832;37;38;0.513513513513513;18;19;0.0135135135135135;0.486486486486487
Control.SRR15539832;37;38;0.513513513513513;18;19;0.0135135135135135;0.486486486486487
Control.SRR15539832;38;38;0.447368421052632;21;17;0.0526315789473684;0.447368421052632
Control.SRR15539832;40;38;0.525;19;21;0.025;0.475
Control.SRR15539832;40;38;0.35;26;14;0.15;0.35
Control.SRR15539832;36;38;0.444444444444444;20;16;0.0555555555555556;0.444444444444444
Control.SRR15539832;36;38;0.583333333333333;15;21;0.0833333333333334;0.416666666666667
Control.SRR15539832;38;38;0.342105263157895;25;13;0.157894736842105;0.342105263157895
Control.SRR15539832;35;38;0.628571428571429;13;22;0.128571428571429;0.371428571428571
Control.SRR15539832;42;38;0.547619047619048;19;23;0.0476190476190477;0.452380952380952
Control.SRR15539832;40;38;0.425;23;17;0.075;0.425
Control.SRR15539832;43;38;0.395348837209302;26;17;0.104651162790698;0.395348837209302
Control.SRR15539832;35;38;0.514285714285714;17;18;0.0142857142857142;0.485714285714286
Control.SRR15539832;41;38;0.48780487804878;21;20;0.0121951219512195;0.48780487804878
Control.SRR15539832;39;38;0.641025641025641;14;25;0.141025641025641;0.358974358974359
Control.SRR15539832;40;38;0.6;16;24;0.1;0.4
Control.SRR15539832;42;38;0.452380952380952;23;19;0.0476190476190476;0.452380952380952
Control.SRR15539832;37;38;0.486486486486487;19;18;0.0135135135135135;0.486486486486487
Control.SRR15539832;42;38;0.452380952380952;23;19;0.0476190476190476;0.452380952380952
Control.SRR15539832;40;38;0.475;21;19;0.025;0.475
Control.SRR15539832;44;38;0.454545454545455;24;20;0.0454545454545455;0.454545454545455
Control.SRR15539832;42;38;0.5;21;21;0;0.5
Control.SRR15539832;36;38;0.583333333333333;15;21;0.0833333333333334;0.416666666666667
Control.SRR15539832;44;38;0.590909090909091;18;26;0.0909090909090909;0.409090909090909
Control.SRR15539832;37;38;0.540540540540541;17;20;0.0405405405405406;0.459459459459459
Control.SRR15539832;38;38;0.5;19;19;0;0.5
Control.SRR15539832;38;38;0.605263157894737;15;23;0.105263157894737;0.394736842105263
Control.SRR15539832;36;38;0.638888888888889;13;23;0.138888888888889;0.361111111111111
Control.SRR15539832;35;38;0.428571428571429;20;15;0.0714285714285715;0.428571428571429
Control.SRR15539832;41;38;0.48780487804878;21;20;0.0121951219512195;0.48780487804878
Control.SRR15539832;38;38;0.5;19;19;0;0.5
Control.SRR15539832;34;38;0.588235294117647;14;20;0.0882352941176471;0.411764705882353
Control.SRR15539832;35;38;0.457142857142857;19;16;0.0428571428571429;0.457142857142857
Control.SRR15539832;39;38;0.41025641025641;23;16;0.0897435897435898;0.41025641025641
Control.SRR15539832;39;38;0.538461538461538;18;21;0.0384615384615384;0.461538461538462
Control.SRR15539832;37;38;0.540540540540541;17;20;0.0405405405405406;0.459459459459459
Control.SRR15539832;42;38;0.285714285714286;30;12;0.214285714285714;0.285714285714286
Control.SRR15539832;37;38;0.324324324324324;25;12;0.175675675675676;0.324324324324324
Control.SRR15539832;39;38;0.512820512820513;19;20;0.0128205128205128;0.487179487179487
Control.SRR15539832;38;38;0.578947368421053;16;22;0.0789473684210527;0.421052631578947
Control.SRR15539832;44;38;0.613636363636364;17;27;0.113636363636364;0.386363636363636
Control.SRR15539832;40;38;0.475;21;19;0.025;0.475
Control.SRR15539832;44;38;0.477272727272727;23;21;0.0227272727272727;0.477272727272727
Control.SRR15539832;40;38;0.55;18;22;0.05;0.45
Control.SRR15539832;41;38;0.658536585365854;14;27;0.158536585365854;0.341463414634146
Control.SRR15539832;35;38;0.571428571428571;15;20;0.0714285714285714;0.428571428571429
Control.SRR15539832;35;38;0.485714285714286;18;17;0.0142857142857143;0.485714285714286
Control.SRR15539832;35;38;0.485714285714286;18;17;0.0142857142857143;0.485714285714286
Control.SRR15539832;37;38;0.675675675675676;12;25;0.175675675675676;0.324324324324324
Control.SRR15539832;36;38;0.638888888888889;13;23;0.138888888888889;0.361111111111111
Control.SRR15539832;40;38;0.65;14;26;0.15;0.35
Control.SRR15539832;36;38;0.527777777777778;17;19;0.0277777777777778;0.472222222222222
Control.SRR15539832;40;38;0.425;23;17;0.075;0.425
Control.SRR15539832;37;38;0.486486486486487;19;18;0.0135135135135135;0.486486486486487
Control.SRR15539832;42;38;0.404761904761905;25;17;0.0952380952380952;0.404761904761905
Control.SRR15539832;36;38;0.361111111111111;23;13;0.138888888888889;0.361111111111111
Control.SRR15539832;35;38;0.457142857142857;19;16;0.0428571428571429;0.457142857142857
Control.SRR15539832;38;38;0.447368421052632;21;17;0.0526315789473684;0.447368421052632
Control.SRR15539832;38;38;0.5;19;19;0;0.5
Control.SRR15539832;36;38;0.5;18;18;0;0.5
Control.SRR15539832;37;38;0.432432432432432;21;16;0.0675675675675675;0.432432432432432
Control.SRR15539832;42;38;0.476190476190476;22;20;0.0238095238095238;0.476190476190476
Control.SRR15539832;40;38;0.5;20;20;0;0.5
Control.SRR15539832;42;38;0.452380952380952;23;19;0.0476190476190476;0.452380952380952
Control.SRR15539832;42;38;0.452380952380952;23;19;0.0476190476190476;0.452380952380952
Control.SRR15539832;36;38;0.5;18;18;0;0.5
Control.SRR15539832;34;38;0.5;17;17;0;0.5
Control.SRR15539832;35;38;0.4;21;14;0.1;0.4
Control.SRR15539832;34;38;0.588235294117647;14;20;0.0882352941176471;0.411764705882353
Control.SRR15539832;40;38;0.375;25;15;0.125;0.375
Control.SRR15539832;37;38;0.567567567567568;16;21;0.0675675675675675;0.432432432432432
Control.SRR15539832;34;38;0.676470588235294;11;23;0.176470588235294;0.323529411764706
Control.SRR15539832;35;38;0.485714285714286;18;17;0.0142857142857143;0.485714285714286
Control.SRR15539832;35;38;0.514285714285714;17;18;0.0142857142857142;0.485714285714286
Control.SRR15539832;34;38;0.529411764705882;16;18;0.0294117647058824;0.470588235294118
Control.SRR15539832;35;38;0.628571428571429;13;22;0.128571428571429;0.371428571428571
Control.SRR15539832;36;38;0.527777777777778;17;19;0.0277777777777778;0.472222222222222
Control.SRR15539832;37;38;0.621621621621622;14;23;0.121621621621622;0.378378378378378
Control.SRR15539832;38;38;0.368421052631579;24;14;0.131578947368421;0.368421052631579
Control.SRR15539832;36;38;0.5;18;18;0;0.5
Control.SRR15539832;38;38;0.605263157894737;15;23;0.105263157894737;0.394736842105263
Control.SRR15539832;41;38;0.463414634146341;22;19;0.0365853658536585;0.463414634146341
Control.SRR15539832;36;38;0.444444444444444;20;16;0.0555555555555556;0.444444444444444
Control.SRR15539832;37;38;0.486486486486487;19;18;0.0135135135135135;0.486486486486487
Control.SRR15539832;34;38;0.441176470588235;19;15;0.0588235294117647;0.441176470588235
Control.SRR15539832;34;38;0.5;17;17;0;0.5
Control.SRR15539832;37;38;0.540540540540541;17;20;0.0405405405405406;0.459459459459459
Control.SRR15539832;38;38;0.368421052631579;24;14;0.131578947368421;0.368421052631579
Control.SRR15539832;43;38;0.558139534883721;19;24;0.0581395348837209;0.441860465116279
Control.SRR15539832;44;38;0.431818181818182;25;19;0.0681818181818182;0.431818181818182
Control.SRR15539832;35;38;0.285714285714286;25;10;0.214285714285714;0.285714285714286
Control.SRR15539832;43;38;0.558139534883721;19;24;0.0581395348837209;0.441860465116279
Control.SRR15539832;40;38;0.6;16;24;0.1;0.4
Control.SRR15539832;42;38;0.428571428571429;24;18;0.0714285714285715;0.428571428571429
Control.SRR15539832;43;38;0.581395348837209;18;25;0.0813953488372093;0.418604651162791
Control.SRR15539832;42;38;0.428571428571429;24;18;0.0714285714285715;0.428571428571429
Control.SRR15539832;41;38;0.414634146341463;24;17;0.0853658536585366;0.414634146341463
Control.SRR15539832;37;38;0.567567567567568;16;21;0.0675675675675675;0.432432432432432
Control.SRR15539832;35;38;0.457142857142857;19;16;0.0428571428571429;0.457142857142857
Control.SRR15539832;44;38;0.522727272727273;21;23;0.0227272727272727;0.477272727272727
Control.SRR15539832;37;38;0.513513513513513;18;19;0.0135135135135135;0.486486486486487
Control.SRR15539832;35;38;0.485714285714286;18;17;0.0142857142857143;0.485714285714286
Control.SRR15539832;40;38;0.525;19;21;0.025;0.475
Control.SRR15539832;34;38;0.382352941176471;21;13;0.117647058823529;0.382352941176471
Control.SRR15539832;34;38;0.441176470588235;19;15;0.0588235294117647;0.441176470588235
Control.SRR15539832;39;38;0.461538461538462;21;18;0.0384615384615384;0.461538461538462
Control.SRR15539832;41;38;0.634146341463415;15;26;0.134146341463415;0.365853658536585
Control.SRR15539832;42;38;0.523809523809524;20;22;0.0238095238095238;0.476190476190476
Control.SRR15539832;35;38;0.571428571428571;15;20;0.0714285714285714;0.428571428571429
Control.SRR15539832;40;38;0.625;15;25;0.125;0.375
Control.SRR15539832;43;38;0.627906976744186;16;27;0.127906976744186;0.372093023255814
Control.SRR15539832;44;38;0.659090909090909;15;29;0.159090909090909;0.340909090909091
Control.SRR15539832;44;38;0.568181818181818;19;25;0.0681818181818182;0.431818181818182
Control.SRR15539832;36;38;0.472222222222222;19;17;0.0277777777777778;0.472222222222222
Control.SRR15539832;39;38;0.512820512820513;19;20;0.0128205128205128;0.487179487179487
Control.SRR15539832;40;38;0.525;19;21;0.025;0.475
Control.SRR15539832;39;38;0.538461538461538;18;21;0.0384615384615384;0.461538461538462
Control.SRR15539832;37;38;0.486486486486487;19;18;0.0135135135135135;0.486486486486487
Control.SRR15539832;40;38;0.475;21;19;0.025;0.475
Control.SRR15539832;37;38;0.459459459459459;20;17;0.0405405405405405;0.459459459459459
Control.SRR15539832;34;38;0.588235294117647;14;20;0.0882352941176471;0.411764705882353
Control.SRR15539832;34;38;0.588235294117647;14;20;0.0882352941176471;0.411764705882353
Control.SRR15539832;38;38;0.447368421052632;21;17;0.0526315789473684;0.447368421052632
Control.SRR15539832;40;38;0.55;18;22;0.05;0.45
Control.SRR15539832;36;38;0.5;18;18;0;0.5
Control.SRR15539832;39;38;0.538461538461538;18;21;0.0384615384615384;0.461538461538462
Control.SRR15539832;42;38;0.404761904761905;25;17;0.0952380952380952;0.404761904761905
Control.SRR15539832;37;38;0.513513513513513;18;19;0.0135135135135135;0.486486486486487
Control.SRR15539832;43;38;0.511627906976744;21;22;0.0116279069767442;0.488372093023256
Control.SRR15539832;35;38;0.542857142857143;16;19;0.0428571428571428;0.457142857142857
Control.SRR15539832;41;38;0.414634146341463;24;17;0.0853658536585366;0.414634146341463
Control.SRR15539832;43;38;0.511627906976744;21;22;0.0116279069767442;0.488372093023256
Control.SRR15539832;42;38;0.476190476190476;22;20;0.0238095238095238;0.476190476190476
Control.SRR15539832;34;38;0.411764705882353;20;14;0.0882352941176471;0.411764705882353
Control.SRR15539832;38;38;0.631578947368421;14;24;0.131578947368421;0.368421052631579
Control.SRR15539832;36;38;0.444444444444444;20;16;0.0555555555555556;0.444444444444444
Control.SRR15539832;36;38;0.583333333333333;15;21;0.0833333333333334;0.416666666666667
Control.SRR15539832;35;38;0.514285714285714;17;18;0.0142857142857142;0.485714285714286
Control.SRR15539832;39;38;0.435897435897436;22;17;0.0641025641025641;0.435897435897436
Control.SRR15539832;36;38;0.583333333333333;15;21;0.0833333333333334;0.416666666666667
Control.SRR15539832;38;38;0.394736842105263;23;15;0.105263157894737;0.394736842105263
Control.SRR15539832;34;38;0.411764705882353;20;14;0.0882352941176471;0.411764705882353
Control.SRR15539832;44;38;0.613636363636364;17;27;0.113636363636364;0.386363636363636
Control.SRR15539832;41;38;0.634146341463415;15;26;0.134146341463415;0.365853658536585
Control.SRR15539832;36;38;0.388888888888889;22;14;0.111111111111111;0.388888888888889
Control.SRR15539832;42;38;0.523809523809524;20;22;0.0238095238095238;0.476190476190476
Control.SRR15539832;39;38;0.538461538461538;18;21;0.0384615384615384;0.461538461538462
Control.SRR15539832;34;38;0.5;17;17;0;0.5
Control.SRR15539832;39;38;0.512820512820513;19;20;0.0128205128205128;0.487179487179487
Control.SRR15539832;34;38;0.5;17;17;0;0.5
Control.SRR15539832;39;38;0.615384615384615;15;24;0.115384615384615;0.384615384615385
Control.SRR15539832;44;38;0.431818181818182;25;19;0.0681818181818182;0.431818181818182
Control.SRR15539832;34;38;0.470588235294118;18;16;0.0294117647058824;0.470588235294118
Control.SRR15539832;40;38;0.4;24;16;0.1;0.4
Control.SRR15539832;35;38;0.485714285714286;18;17;0.0142857142857143;0.485714285714286
Control.SRR15539832;36;38;0.583333333333333;15;21;0.0833333333333334;0.416666666666667
Control.SRR15539832;43;38;0.511627906976744;21;22;0.0116279069767442;0.488372093023256
Control.SRR15539832;41;38;0.48780487804878;21;20;0.0121951219512195;0.48780487804878
Control.SRR15539832;38;38;0.631578947368421;14;24;0.131578947368421;0.368421052631579
Control.SRR15539832;40;38;0.525;19;21;0.025;0.475
Control.SRR15539832;41;38;0.585365853658537;17;24;0.0853658536585366;0.414634146341463
Control.SRR15539832;34;38;0.529411764705882;16;18;0.0294117647058824;0.470588235294118
Control.SRR15539832;44;38;0.454545454545455;24;20;0.0454545454545455;0.454545454545455
Control.SRR15539832;35;38;0.571428571428571;15;20;0.0714285714285714;0.428571428571429
Control.SRR15539832;35;38;0.542857142857143;16;19;0.0428571428571428;0.457142857142857
Control.SRR15539832;39;38;0.538461538461538;18;21;0.0384615384615384;0.461538461538462
Control.SRR15539832;34;38;0.470588235294118;18;16;0.0294117647058824;0.470588235294118
Control.SRR15539832;38;38;0.5;19;19;0;0.5
Control.SRR15539832;39;38;0.487179487179487;20;19;0.0128205128205128;0.487179487179487
Control.SRR15539832;42;38;0.380952380952381;26;16;0.119047619047619;0.380952380952381
Control.SRR15539832;37;38;0.378378378378378;23;14;0.121621621621622;0.378378378378378
Control.SRR15539832;35;38;0.428571428571429;20;15;0.0714285714285715;0.428571428571429
Control.SRR15539832;38;38;0.447368421052632;21;17;0.0526315789473684;0.447368421052632
Control.SRR15539832;37;38;0.432432432432432;21;16;0.0675675675675675;0.432432432432432
Control.SRR15539832;34;38;0.617647058823529;13;21;0.117647058823529;0.382352941176471
Control.SRR15539832;35;38;0.485714285714286;18;17;0.0142857142857143;0.485714285714286
Control.SRR15539832;43;38;0.581395348837209;18;25;0.0813953488372093;0.418604651162791
Control.SRR15539832;34;38;0.5;17;17;0;0.5
Control.SRR15539832;44;38;0.5;22;22;0;0.5
Control.SRR15539832;43;38;0.534883720930233;20;23;0.0348837209302325;0.465116279069767
Control.SRR15539832;37;38;0.486486486486487;19;18;0.0135135135135135;0.486486486486487
Control.SRR15539832;44;38;0.5;22;22;0;0.5
Control.SRR15539832;34;38;0.382352941176471;21;13;0.117647058823529;0.382352941176471
Control.SRR15539832;42;38;0.571428571428571;18;24;0.0714285714285714;0.428571428571429
Control.SRR15539832;38;38;0.447368421052632;21;17;0.0526315789473684;0.447368421052632
Control.SRR15539832;42;38;0.428571428571429;24;18;0.0714285714285715;0.428571428571429
Control.SRR15539832;35;38;0.514285714285714;17;18;0.0142857142857142;0.485714285714286
Control.SRR15539832;44;38;0.5;22;22;0;0.5
Control.SRR15539832;39;38;0.487179487179487;20;19;0.0128205128205128;0.487179487179487
Control.SRR15539832;34;38;0.529411764705882;16;18;0.0294117647058824;0.470588235294118
Control.SRR15539832;39;38;0.435897435897436;22;17;0.0641025641025641;0.435897435897436
Control.SRR15539832;42;38;0.547619047619048;19;23;0.0476190476190477;0.452380952380952
Control.SRR15539832;39;38;0.487179487179487;20;19;0.0128205128205128;0.487179487179487
Control.SRR15539832;41;38;0.390243902439024;25;16;0.109756097560976;0.390243902439024
Control.SRR15539832;43;38;0.372093023255814;27;16;0.127906976744186;0.372093023255814
Control.SRR15539832;40;38;0.625;15;25;0.125;0.375
Control.SRR15539832;35;38;0.485714285714286;18;17;0.0142857142857143;0.485714285714286
Control.SRR15539832;38;38;0.473684210526316;20;18;0.0263157894736842;0.473684210526316
Control.SRR15539832;38;38;0.5;19;19;0;0.5
Control.SRR15539832;38;38;0.5;19;19;0;0.5
Control.SRR15539832;35;38;0.342857142857143;23;12;0.157142857142857;0.342857142857143
Control.SRR15539832;37;38;0.540540540540541;17;20;0.0405405405405406;0.459459459459459
Control.SRR15539832;41;38;0.51219512195122;20;21;0.0121951219512195;0.48780487804878
Control.SRR15539832;41;38;0.439024390243902;23;18;0.0609756097560976;0.439024390243902
Control.SRR15539832;34;38;0.411764705882353;20;14;0.0882352941176471;0.411764705882353
Control.SRR15539832;35;38;0.457142857142857;19;16;0.0428571428571429;0.457142857142857
Control.SRR15539832;37;38;0.459459459459459;20;17;0.0405405405405405;0.459459459459459
Control.SRR15539832;42;38;0.428571428571429;24;18;0.0714285714285715;0.428571428571429
Control.SRR15539832;42;38;0.642857142857143;15;27;0.142857142857143;0.357142857142857
Control.SRR15539832;34;38;0.529411764705882;16;18;0.0294117647058824;0.470588235294118
Control.SRR15539832;42;38;0.5;21;21;0;0.5
Control.SRR15539832;37;38;0.351351351351351;24;13;0.148648648648649;0.351351351351351
Control.SRR15539832;36;38;0.583333333333333;15;21;0.0833333333333334;0.416666666666667
Control.SRR15539832;44;38;0.386363636363636;27;17;0.113636363636364;0.386363636363636
Control.SRR15539832;38;38;0.473684210526316;20;18;0.0263157894736842;0.473684210526316
Control.SRR15539832;42;38;0.523809523809524;20;22;0.0238095238095238;0.476190476190476
Control.SRR15539832;42;38;0.357142857142857;27;15;0.142857142857143;0.357142857142857
Control.SRR15539832;40;38;0.625;15;25;0.125;0.375
Control.SRR15539832;36;38;0.638888888888889;13;23;0.138888888888889;0.361111111111111
Control.SRR15539832;42;38;0.523809523809524;20;22;0.0238095238095238;0.476190476190476
Control.SRR15539832;36;38;0.416666666666667;21;15;0.0833333333333333;0.416666666666667
Control.SRR15539832;42;38;0.619047619047619;16;26;0.119047619047619;0.380952380952381
Control.SRR15539832;40;38;0.5;20;20;0;0.5
Control.SRR15539832;36;38;0.583333333333333;15;21;0.0833333333333334;0.416666666666667
Control.SRR15539832;36;38;0.416666666666667;21;15;0.0833333333333333;0.416666666666667
Control.SRR15539832;37;38;0.621621621621622;14;23;0.121621621621622;0.378378378378378
Control.SRR15539832;39;38;0.538461538461538;18;21;0.0384615384615384;0.461538461538462
Control.SRR15539832;37;38;0.432432432432432;21;16;0.0675675675675675;0.432432432432432
Control.SRR15539832;35;38;0.514285714285714;17;18;0.0142857142857142;0.485714285714286
Control.SRR15539832;35;38;0.657142857142857;12;23;0.157142857142857;0.342857142857143
Control.SRR15539832;37;38;0.540540540540541;17;20;0.0405405405405406;0.459459459459459
Control.SRR15539832;43;38;0.534883720930233;20;23;0.0348837209302325;0.465116279069767
Control.SRR15539832;37;38;0.513513513513513;18;19;0.0135135135135135;0.486486486486487
Control.SRR15539832;35;38;0.485714285714286;18;17;0.0142857142857143;0.485714285714286
Control.SRR15539832;44;38;0.522727272727273;21;23;0.0227272727272727;0.477272727272727
Control.SRR15539832;38;38;0.631578947368421;14;24;0.131578947368421;0.368421052631579
Control.SRR15539832;42;38;0.5;21;21;0;0.5
Control.SRR15539832;42;38;0.30952380952381;29;13;0.19047619047619;0.30952380952381
Control.SRR15539832;43;38;0.511627906976744;21;22;0.0116279069767442;0.488372093023256
Control.SRR15539832;37;38;0.513513513513513;18;19;0.0135135135135135;0.486486486486487
Control.SRR15539832;42;38;0.595238095238095;17;25;0.0952380952380952;0.404761904761905
Control.SRR15539832;41;38;0.51219512195122;20;21;0.0121951219512195;0.48780487804878
Control.SRR15539832;44;38;0.295454545454545;31;13;0.204545454545455;0.295454545454545
Control.SRR15539832;39;38;0.564102564102564;17;22;0.0641025641025641;0.435897435897436
Control.SRR15539832;34;38;0.441176470588235;19;15;0.0588235294117647;0.441176470588235
Control.SRR15539832;35;38;0.4;21;14;0.1;0.4
Control.SRR15539832;36;38;0.416666666666667;21;15;0.0833333333333333;0.416666666666667
Control.SRR15539832;40;38;0.425;23;17;0.075;0.425
Control.SRR15539832;35;38;0.542857142857143;16;19;0.0428571428571428;0.457142857142857
Control.SRR15539832;40;38;0.375;25;15;0.125;0.375
Control.SRR15539832;34;38;0.558823529411765;15;19;0.0588235294117647;0.441176470588235
Control.SRR15539832;38;38;0.631578947368421;14;24;0.131578947368421;0.368421052631579
Control.SRR15539832;40;38;0.425;23;17;0.075;0.425
Control.SRR15539832;40;38;0.45;22;18;0.05;0.45
Control.SRR15539832;40;38;0.5;20;20;0;0.5
Control.SRR15539832;40;38;0.55;18;22;0.05;0.45
Control.SRR15539832;42;38;0.5;21;21;0;0.5
Control.SRR15539832;43;38;0.465116279069767;23;20;0.0348837209302326;0.465116279069767
Control.SRR15539832;41;38;0.536585365853659;19;22;0.0365853658536586;0.463414634146341
Control.SRR15539832;40;38;0.425;23;17;0.075;0.425
Control.SRR15539832;39;38;0.58974358974359;16;23;0.0897435897435898;0.41025641025641
Control.SRR15539832;38;38;0.552631578947368;17;21;0.0526315789473685;0.447368421052632
Control.SRR15539832;38;38;0.631578947368421;14;24;0.131578947368421;0.368421052631579
Control.SRR15539832;43;38;0.441860465116279;24;19;0.0581395348837209;0.441860465116279
Control.SRR15539832;43;38;0.348837209302326;28;15;0.151162790697674;0.348837209302326
Control.SRR15539832;37;38;0.567567567567568;16;21;0.0675675675675675;0.432432432432432
Control.SRR15539832;38;38;0.421052631578947;22;16;0.0789473684210527;0.421052631578947
Control.SRR15539832;38;38;0.368421052631579;24;14;0.131578947368421;0.368421052631579
Control.SRR15539832;42;38;0.523809523809524;20;22;0.0238095238095238;0.476190476190476
Control.SRR15539832;34;38;0.529411764705882;16;18;0.0294117647058824;0.470588235294118
Control.SRR15539832;42;38;0.523809523809524;20;22;0.0238095238095238;0.476190476190476
Control.SRR15539832;35;38;0.542857142857143;16;19;0.0428571428571428;0.457142857142857
Control.SRR15539832;42;38;0.428571428571429;24;18;0.0714285714285715;0.428571428571429
Control.SRR15539832;38;38;0.473684210526316;20;18;0.0263157894736842;0.473684210526316
Control.SRR15539832;42;38;0.476190476190476;22;20;0.0238095238095238;0.476190476190476
Control.SRR15539832;39;38;0.487179487179487;20;19;0.0128205128205128;0.487179487179487
Control.SRR15539832;38;38;0.342105263157895;25;13;0.157894736842105;0.342105263157895
Control.SRR15539832;40;38;0.425;23;17;0.075;0.425
Control.SRR15539832;36;38;0.555555555555556;16;20;0.0555555555555556;0.444444444444444
Control.SRR15539832;37;38;0.432432432432432;21;16;0.0675675675675675;0.432432432432432
Control.SRR15539832;37;38;0.513513513513513;18;19;0.0135135135135135;0.486486486486487
Control.SRR15539832;39;38;0.564102564102564;17;22;0.0641025641025641;0.435897435897436
Control.SRR15539832;43;38;0.558139534883721;19;24;0.0581395348837209;0.441860465116279
Control.SRR15539832;34;38;0.5;17;17;0;0.5
Control.SRR15539832;35;38;0.428571428571429;20;15;0.0714285714285715;0.428571428571429
Control.SRR15539832;43;38;0.418604651162791;25;18;0.0813953488372093;0.418604651162791
Control.SRR15539832;38;38;0.421052631578947;22;16;0.0789473684210527;0.421052631578947
Control.SRR15539832;36;38;0.5;18;18;0;0.5
Control.SRR15539832;37;38;0.702702702702703;11;26;0.202702702702703;0.297297297297297
Control.SRR15539832;43;38;0.581395348837209;18;25;0.0813953488372093;0.418604651162791
Control.SRR15539832;44;38;0.409090909090909;26;18;0.0909090909090909;0.409090909090909
Control.SRR15539832;42;38;0.476190476190476;22;20;0.0238095238095238;0.476190476190476
Control.SRR15539832;37;38;0.486486486486487;19;18;0.0135135135135135;0.486486486486487
Control.SRR15539832;34;38;0.647058823529412;12;22;0.147058823529412;0.352941176470588
Control.SRR15539832;43;38;0.534883720930233;20;23;0.0348837209302325;0.465116279069767
Control.SRR15539832;40;38;0.45;22;18;0.05;0.45
Control.SRR15539832;36;38;0.527777777777778;17;19;0.0277777777777778;0.472222222222222
Control.SRR15539832;41;38;0.463414634146341;22;19;0.0365853658536585;0.463414634146341
Control.SRR15539832;39;38;0.58974358974359;16;23;0.0897435897435898;0.41025641025641
Control.SRR15539832;43;38;0.581395348837209;18;25;0.0813953488372093;0.418604651162791
Control.SRR15539832;37;38;0.513513513513513;18;19;0.0135135135135135;0.486486486486487
Control.SRR15539832;43;38;0.511627906976744;21;22;0.0116279069767442;0.488372093023256
Control.SRR15539832;42;38;0.571428571428571;18;24;0.0714285714285714;0.428571428571429
Control.SRR15539832;41;38;0.390243902439024;25;16;0.109756097560976;0.390243902439024
Control.SRR15539832;40;38;0.475;21;19;0.025;0.475
Control.SRR15539832;40;38;0.55;18;22;0.05;0.45
Control.SRR15539832;41;38;0.414634146341463;24;17;0.0853658536585366;0.414634146341463
Control.SRR15539832;37;38;0.486486486486487;19;18;0.0135135135135135;0.486486486486487
Control.SRR15539832;37;38;0.378378378378378;23;14;0.121621621621622;0.378378378378378
Control.SRR15539832;36;38;0.444444444444444;20;16;0.0555555555555556;0.444444444444444
Control.SRR15539832;40;38;0.475;21;19;0.025;0.475
Control.SRR15539832;40;38;0.5;20;20;0;0.5
Control.SRR15539832;34;38;0.647058823529412;12;22;0.147058823529412;0.352941176470588
Control.SRR15539832;41;38;0.536585365853659;19;22;0.0365853658536586;0.463414634146341
Control.SRR15539832;37;38;0.540540540540541;17;20;0.0405405405405406;0.459459459459459
Control.SRR15539832;37;38;0.459459459459459;20;17;0.0405405405405405;0.459459459459459
Control.SRR15539832;40;38;0.575;17;23;0.075;0.425
Control.SRR15539832;42;38;0.452380952380952;23;19;0.0476190476190476;0.452380952380952
Control.SRR15539832;44;38;0.613636363636364;17;27;0.113636363636364;0.386363636363636
Control.SRR15539832;43;38;0.348837209302326;28;15;0.151162790697674;0.348837209302326
Control.SRR15539832;44;38;0.522727272727273;21;23;0.0227272727272727;0.477272727272727
Control.SRR15539832;41;38;0.51219512195122;20;21;0.0121951219512195;0.48780487804878
Control.SRR15539832;42;38;0.547619047619048;19;23;0.0476190476190477;0.452380952380952
Control.SRR15539832;35;38;0.514285714285714;17;18;0.0142857142857142;0.485714285714286
Control.SRR15539832;42;38;0.619047619047619;16;26;0.119047619047619;0.380952380952381
Control.SRR15539832;37;38;0.594594594594595;15;22;0.0945945945945946;0.405405405405405
Control.SRR15539832;41;38;0.414634146341463;24;17;0.0853658536585366;0.414634146341463
Control.SRR15539832;44;38;0.477272727272727;23;21;0.0227272727272727;0.477272727272727
Control.SRR15539832;41;38;0.536585365853659;19;22;0.0365853658536586;0.463414634146341
Control.SRR15539832;35;38;0.714285714285714;10;25;0.214285714285714;0.285714285714286
Control.SRR15539832;44;38;0.454545454545455;24;20;0.0454545454545455;0.454545454545455
Control.SRR15539832;41;38;0.536585365853659;19;22;0.0365853658536586;0.463414634146341
Control.SRR15539832;40;38;0.475;21;19;0.025;0.475
Control.SRR15539832;34;38;0.470588235294118;18;16;0.0294117647058824;0.470588235294118
Control.SRR15539832;37;38;0.378378378378378;23;14;0.121621621621622;0.378378378378378
Control.SRR15539832;36;38;0.583333333333333;15;21;0.0833333333333334;0.416666666666667
Control.SRR15539832;34;38;0.382352941176471;21;13;0.117647058823529;0.382352941176471
Control.SRR15539832;35;38;0.371428571428571;22;13;0.128571428571429;0.371428571428571
Control.SRR15539832;34;38;0.470588235294118;18;16;0.0294117647058824;0.470588235294118
Control.SRR15539832;40;38;0.4;24;16;0.1;0.4
Control.SRR15539832;41;38;0.51219512195122;20;21;0.0121951219512195;0.48780487804878
Control.SRR15539832;37;38;0.621621621621622;14;23;0.121621621621622;0.378378378378378
Control.SRR15539832;38;38;0.526315789473684;18;20;0.0263157894736842;0.473684210526316
Control.SRR15539832;39;38;0.564102564102564;17;22;0.0641025641025641;0.435897435897436
Control.SRR15539832;40;38;0.55;18;22;0.05;0.45
Control.SRR15539832;35;38;0.514285714285714;17;18;0.0142857142857142;0.485714285714286
Control.SRR15539832;35;38;0.428571428571429;20;15;0.0714285714285715;0.428571428571429
Control.SRR15539832;39;38;0.512820512820513;19;20;0.0128205128205128;0.487179487179487
Control.SRR15539832;37;38;0.513513513513513;18;19;0.0135135135135135;0.486486486486487
Control.SRR15539832;36;38;0.444444444444444;20;16;0.0555555555555556;0.444444444444444
Control.SRR15539832;41;38;0.463414634146341;22;19;0.0365853658536585;0.463414634146341
Control.SRR15539832;34;38;0.441176470588235;19;15;0.0588235294117647;0.441176470588235
Control.SRR15539832;38;38;0.447368421052632;21;17;0.0526315789473684;0.447368421052632
Control.SRR15539832;36;38;0.472222222222222;19;17;0.0277777777777778;0.472222222222222
Control.SRR15539832;38;38;0.631578947368421;14;24;0.131578947368421;0.368421052631579
Control.SRR15539832;41;38;0.390243902439024;25;16;0.109756097560976;0.390243902439024
Control.SRR15539832;39;38;0.641025641025641;14;25;0.141025641025641;0.358974358974359
Control.SRR15539832;41;38;0.463414634146341;22;19;0.0365853658536585;0.463414634146341
Control.SRR15539832;39;38;0.538461538461538;18;21;0.0384615384615384;0.461538461538462
Control.SRR15539832;43;38;0.441860465116279;24;19;0.0581395348837209;0.441860465116279
Control.SRR15539832;38;38;0.473684210526316;20;18;0.0263157894736842;0.473684210526316
Control.SRR15539832;39;38;0.538461538461538;18;21;0.0384615384615384;0.461538461538462
Control.SRR15539832;38;38;0.5;19;19;0;0.5
Control.SRR15539832;39;38;0.358974358974359;25;14;0.141025641025641;0.358974358974359
Control.SRR15539832;37;38;0.594594594594595;15;22;0.0945945945945946;0.405405405405405
Control.SRR15539832;42;38;0.523809523809524;20;22;0.0238095238095238;0.476190476190476
Control.SRR15539832;42;38;0.523809523809524;20;22;0.0238095238095238;0.476190476190476
Control.SRR15539832;34;38;0.411764705882353;20;14;0.0882352941176471;0.411764705882353
Control.SRR15539832;38;38;0.421052631578947;22;16;0.0789473684210527;0.421052631578947
Control.SRR15539832;36;38;0.388888888888889;22;14;0.111111111111111;0.388888888888889
Control.SRR15539832;43;38;0.418604651162791;25;18;0.0813953488372093;0.418604651162791
Control.SRR15539832;39;38;0.538461538461538;18;21;0.0384615384615384;0.461538461538462
Control.SRR15539832;38;38;0.5;19;19;0;0.5
Control.SRR15539832;36;38;0.555555555555556;16;20;0.0555555555555556;0.444444444444444
Control.SRR15539832;42;38;0.476190476190476;22;20;0.0238095238095238;0.476190476190476
Control.SRR15539832;34;38;0.558823529411765;15;19;0.0588235294117647;0.441176470588235
Control.SRR15539832;38;38;0.5;19;19;0;0.5
Control.SRR15539832;40;38;0.5;20;20;0;0.5
Control.SRR15539832;40;38;0.475;21;19;0.025;0.475
Control.SRR15539832;35;38;0.428571428571429;20;15;0.0714285714285715;0.428571428571429
Control.SRR15539832;40;38;0.375;25;15;0.125;0.375
Control.SRR15539832;35;38;0.485714285714286;18;17;0.0142857142857143;0.485714285714286
Control.SRR15539832;35;38;0.4;21;14;0.1;0.4
Control.SRR15539832;34;38;0.352941176470588;22;12;0.147058823529412;0.352941176470588
Control.SRR15539832;42;38;0.5;21;21;0;0.5
Control.SRR15539832;41;38;0.48780487804878;21;20;0.0121951219512195;0.48780487804878
Control.SRR15539832;35;38;0.485714285714286;18;17;0.0142857142857143;0.485714285714286
Control.SRR15539832;40;38;0.625;15;25;0.125;0.375
Control.SRR15539832;39;38;0.538461538461538;18;21;0.0384615384615384;0.461538461538462
Control.SRR15539832;39;38;0.384615384615385;24;15;0.115384615384615;0.384615384615385
Control.SRR15539832;44;38;0.545454545454545;20;24;0.0454545454545454;0.454545454545455
Control.SRR15539832;39;38;0.666666666666667;13;26;0.166666666666667;0.333333333333333
Control.SRR15539832;42;38;0.428571428571429;24;18;0.0714285714285715;0.428571428571429
Control.SRR15539832;41;38;0.463414634146341;22;19;0.0365853658536585;0.463414634146341
Control.SRR15539832;37;38;0.405405405405405;22;15;0.0945945945945946;0.405405405405405
Control.SRR15539832;34;38;0.558823529411765;15;19;0.0588235294117647;0.441176470588235
Control.SRR15539832;38;38;0.394736842105263;23;15;0.105263157894737;0.394736842105263
Control.SRR15539832;43;38;0.465116279069767;23;20;0.0348837209302326;0.465116279069767
Control.SRR15539832;38;38;0.368421052631579;24;14;0.131578947368421;0.368421052631579
Control.SRR15539832;34;38;0.382352941176471;21;13;0.117647058823529;0.382352941176471
Control.SRR15539832;35;38;0.342857142857143;23;12;0.157142857142857;0.342857142857143
Control.SRR15539832;42;38;0.452380952380952;23;19;0.0476190476190476;0.452380952380952
Control.SRR15539832;37;38;0.594594594594595;15;22;0.0945945945945946;0.405405405405405
Control.SRR15539832;41;38;0.51219512195122;20;21;0.0121951219512195;0.48780487804878
Control.SRR15539832;37;38;0.405405405405405;22;15;0.0945945945945946;0.405405405405405
Control.SRR15539832;41;38;0.48780487804878;21;20;0.0121951219512195;0.48780487804878
Control.SRR15539832;38;38;0.473684210526316;20;18;0.0263157894736842;0.473684210526316
Control.SRR15539832;37;38;0.459459459459459;20;17;0.0405405405405405;0.459459459459459
Control.SRR15539832;35;38;0.514285714285714;17;18;0.0142857142857142;0.485714285714286
Control.SRR15539832;36;38;0.444444444444444;20;16;0.0555555555555556;0.444444444444444
Control.SRR15539832;41;38;0.536585365853659;19;22;0.0365853658536586;0.463414634146341
Control.SRR15539832;41;38;0.585365853658537;17;24;0.0853658536585366;0.414634146341463
Control.SRR15539832;38;38;0.5;19;19;0;0.5
Control.SRR15539832;43;38;0.604651162790698;17;26;0.104651162790698;0.395348837209302
Control.SRR15539832;39;38;0.512820512820513;19;20;0.0128205128205128;0.487179487179487
Control.SRR15539832;41;38;0.536585365853659;19;22;0.0365853658536586;0.463414634146341
Control.SRR15539832;37;38;0.405405405405405;22;15;0.0945945945945946;0.405405405405405
Control.SRR15539832;36;38;0.416666666666667;21;15;0.0833333333333333;0.416666666666667
Control.SRR15539832;44;38;0.522727272727273;21;23;0.0227272727272727;0.477272727272727
Control.SRR15539832;41;38;0.439024390243902;23;18;0.0609756097560976;0.439024390243902
Control.SRR15539832;34;38;0.529411764705882;16;18;0.0294117647058824;0.470588235294118
Control.SRR15539832;39;38;0.615384615384615;15;24;0.115384615384615;0.384615384615385
Control.SRR15539832;41;38;0.51219512195122;20;21;0.0121951219512195;0.48780487804878
Control.SRR15539832;37;38;0.459459459459459;20;17;0.0405405405405405;0.459459459459459
Control.SRR15539832;42;38;0.452380952380952;23;19;0.0476190476190476;0.452380952380952
Control.SRR15539832;36;38;0.472222222222222;19;17;0.0277777777777778;0.472222222222222
Control.SRR15539832;38;38;0.5;19;19;0;0.5
Control.SRR15539832;41;38;0.609756097560976;16;25;0.109756097560976;0.390243902439024
Control.SRR15539832;42;38;0.428571428571429;24;18;0.0714285714285715;0.428571428571429
Control.SRR15539832;39;38;0.717948717948718;11;28;0.217948717948718;0.282051282051282
Control.SRR15539832;43;38;0.395348837209302;26;17;0.104651162790698;0.395348837209302
Control.SRR15539832;34;38;0.470588235294118;18;16;0.0294117647058824;0.470588235294118
Control.SRR15539832;38;38;0.5;19;19;0;0.5
Control.SRR15539832;38;38;0.526315789473684;18;20;0.0263157894736842;0.473684210526316
Control.SRR15539832;41;38;0.536585365853659;19;22;0.0365853658536586;0.463414634146341
Control.SRR15539832;40;38;0.5;20;20;0;0.5
Control.SRR15539832;36;38;0.416666666666667;21;15;0.0833333333333333;0.416666666666667
Control.SRR15539832;43;38;0.488372093023256;22;21;0.0116279069767442;0.488372093023256
Control.SRR15539832;42;38;0.571428571428571;18;24;0.0714285714285714;0.428571428571429
Control.SRR15539832;40;38;0.55;18;22;0.05;0.45
Control.SRR15539832;43;38;0.488372093023256;22;21;0.0116279069767442;0.488372093023256
Control.SRR15539832;34;38;0.558823529411765;15;19;0.0588235294117647;0.441176470588235
Control.SRR15539832;36;38;0.527777777777778;17;19;0.0277777777777778;0.472222222222222
Control.SRR15539832;36;38;0.444444444444444;20;16;0.0555555555555556;0.444444444444444
Control.SRR15539832;42;38;0.452380952380952;23;19;0.0476190476190476;0.452380952380952
Control.SRR15539832;36;38;0.361111111111111;23;13;0.138888888888889;0.361111111111111
Control.SRR15539832;42;38;0.452380952380952;23;19;0.0476190476190476;0.452380952380952
Control.SRR15539832;37;38;0.459459459459459;20;17;0.0405405405405405;0.459459459459459
Control.SRR15539832;40;38;0.45;22;18;0.05;0.45
Control.SRR15539832;38;38;0.421052631578947;22;16;0.0789473684210527;0.421052631578947
Control.SRR15539832;34;38;0.441176470588235;19;15;0.0588235294117647;0.441176470588235
Control.SRR15539832;37;38;0.675675675675676;12;25;0.175675675675676;0.324324324324324
Control.SRR15539832;39;38;0.461538461538462;21;18;0.0384615384615384;0.461538461538462
Control.SRR15539832;41;38;0.463414634146341;22;19;0.0365853658536585;0.463414634146341
Control.SRR15539832;43;38;0.558139534883721;19;24;0.0581395348837209;0.441860465116279
Control.SRR15539832;36;38;0.527777777777778;17;19;0.0277777777777778;0.472222222222222
Control.SRR15539832;40;38;0.5;20;20;0;0.5
Control.SRR15539832;43;38;0.604651162790698;17;26;0.104651162790698;0.395348837209302
Control.SRR15539832;42;38;0.547619047619048;19;23;0.0476190476190477;0.452380952380952
Control.SRR15539832;39;38;0.512820512820513;19;20;0.0128205128205128;0.487179487179487
Control.SRR15539832;44;38;0.431818181818182;25;19;0.0681818181818182;0.431818181818182
Control.SRR15539832;42;38;0.428571428571429;24;18;0.0714285714285715;0.428571428571429
Control.SRR15539832;39;38;0.487179487179487;20;19;0.0128205128205128;0.487179487179487
Control.SRR15539832;40;38;0.45;22;18;0.05;0.45
Control.SRR15539832;41;38;0.414634146341463;24;17;0.0853658536585366;0.414634146341463
Control.SRR15539832;34;38;0.411764705882353;20;14;0.0882352941176471;0.411764705882353
Control.SRR15539832;34;38;0.529411764705882;16;18;0.0294117647058824;0.470588235294118
Control.SRR15539832;36;38;0.5;18;18;0;0.5
Control.SRR15539832;36;38;0.555555555555556;16;20;0.0555555555555556;0.444444444444444
Control.SRR15539832;40;38;0.625;15;25;0.125;0.375
Control.SRR15539832;39;38;0.564102564102564;17;22;0.0641025641025641;0.435897435897436
Control.SRR15539832;34;38;0.323529411764706;23;11;0.176470588235294;0.323529411764706
Control.SRR15539832;41;38;0.463414634146341;22;19;0.0365853658536585;0.463414634146341
Control.SRR15539832;38;38;0.5;19;19;0;0.5
Control.SRR15539832;40;38;0.325;27;13;0.175;0.325
Control.SRR15539832;40;38;0.6;16;24;0.1;0.4
Control.SRR15539832;36;38;0.5;18;18;0;0.5
Control.SRR15539832;36;38;0.472222222222222;19;17;0.0277777777777778;0.472222222222222
Control.SRR15539832;36;38;0.555555555555556;16;20;0.0555555555555556;0.444444444444444
Control.SRR15539832;38;38;0.5;19;19;0;0.5
Control.SRR15539832;39;38;0.435897435897436;22;17;0.0641025641025641;0.435897435897436
Control.SRR15539832;40;38;0.6;16;24;0.1;0.4
Control.SRR15539832;43;38;0.418604651162791;25;18;0.0813953488372093;0.418604651162791
Control.SRR15539832;37;38;0.432432432432432;21;16;0.0675675675675675;0.432432432432432
Control.SRR15539832;37;38;0.621621621621622;14;23;0.121621621621622;0.378378378378378
Control.SRR15539832;34;38;0.470588235294118;18;16;0.0294117647058824;0.470588235294118
Control.SRR15539832;36;38;0.5;18;18;0;0.5
Control.SRR15539832;37;38;0.594594594594595;15;22;0.0945945945945946;0.405405405405405
Control.SRR15539832;41;38;0.51219512195122;20;21;0.0121951219512195;0.48780487804878
Control.SRR15539832;37;38;0.486486486486487;19;18;0.0135135135135135;0.486486486486487
Control.SRR15539832;44;38;0.409090909090909;26;18;0.0909090909090909;0.409090909090909
Control.SRR15539832;42;38;0.547619047619048;19;23;0.0476190476190477;0.452380952380952
Control.SRR15539832;41;38;0.609756097560976;16;25;0.109756097560976;0.390243902439024
Control.SRR15539832;42;38;0.476190476190476;22;20;0.0238095238095238;0.476190476190476
Control.SRR15539832;41;38;0.536585365853659;19;22;0.0365853658536586;0.463414634146341
Control.SRR15539832;40;38;0.475;21;19;0.025;0.475
Control.SRR15539832;34;38;0.5;17;17;0;0.5
Control.SRR15539832;35;38;0.571428571428571;15;20;0.0714285714285714;0.428571428571429
Control.SRR15539832;35;38;0.685714285714286;11;24;0.185714285714286;0.314285714285714
Control.SRR15539832;43;38;0.418604651162791;25;18;0.0813953488372093;0.418604651162791
Control.SRR15539832;40;38;0.4;24;16;0.1;0.4
Control.SRR15539832;44;38;0.613636363636364;17;27;0.113636363636364;0.386363636363636
Control.SRR15539832;44;38;0.522727272727273;21;23;0.0227272727272727;0.477272727272727
Control.SRR15539832;44;38;0.5;22;22;0;0.5
Control.SRR15539832;39;38;0.435897435897436;22;17;0.0641025641025641;0.435897435897436
Control.SRR15539832;34;38;0.411764705882353;20;14;0.0882352941176471;0.411764705882353
Control.SRR15539832;44;38;0.5;22;22;0;0.5
Control.SRR15539832;40;38;0.7;12;28;0.2;0.3
Control.SRR15539832;36;38;0.5;18;18;0;0.5
Control.SRR15539832;42;38;0.595238095238095;17;25;0.0952380952380952;0.404761904761905
Control.SRR15539832;35;38;0.4;21;14;0.1;0.4
Control.SRR15539832;41;38;0.585365853658537;17;24;0.0853658536585366;0.414634146341463
Control.SRR15539832;39;38;0.487179487179487;20;19;0.0128205128205128;0.487179487179487
Control.SRR15539832;37;38;0.675675675675676;12;25;0.175675675675676;0.324324324324324
Control.SRR15539832;36;38;0.444444444444444;20;16;0.0555555555555556;0.444444444444444
Control.SRR15539832;39;38;0.384615384615385;24;15;0.115384615384615;0.384615384615385
Control.SRR15539832;35;38;0.428571428571429;20;15;0.0714285714285715;0.428571428571429
Control.SRR15539832;44;38;0.568181818181818;19;25;0.0681818181818182;0.431818181818182
Control.SRR15539832;34;38;0.441176470588235;19;15;0.0588235294117647;0.441176470588235
Control.SRR15539832;43;38;0.488372093023256;22;21;0.0116279069767442;0.488372093023256
Control.SRR15539832;37;38;0.405405405405405;22;15;0.0945945945945946;0.405405405405405
Control.SRR15539832;44;38;0.5;22;22;0;0.5
Control.SRR15539832;38;38;0.552631578947368;17;21;0.0526315789473685;0.447368421052632
Control.SRR15539832;39;38;0.538461538461538;18;21;0.0384615384615384;0.461538461538462
Control.SRR15539832;37;38;0.459459459459459;20;17;0.0405405405405405;0.459459459459459
Control.SRR15539832;38;38;0.578947368421053;16;22;0.0789473684210527;0.421052631578947
Control.SRR15539832;44;38;0.568181818181818;19;25;0.0681818181818182;0.431818181818182
Control.SRR15539832;37;38;0.432432432432432;21;16;0.0675675675675675;0.432432432432432
Control.SRR15539832;39;38;0.41025641025641;23;16;0.0897435897435898;0.41025641025641
Control.SRR15539832;39;38;0.487179487179487;20;19;0.0128205128205128;0.487179487179487
Control.SRR15539832;37;38;0.594594594594595;15;22;0.0945945945945946;0.405405405405405
Control.SRR15539832;37;38;0.567567567567568;16;21;0.0675675675675675;0.432432432432432
Control.SRR15539832;40;38;0.575;17;23;0.075;0.425
Control.SRR15539832;41;38;0.658536585365854;14;27;0.158536585365854;0.341463414634146
Control.SRR15539832;38;38;0.421052631578947;22;16;0.0789473684210527;0.421052631578947
Control.SRR15539832;39;38;0.461538461538462;21;18;0.0384615384615384;0.461538461538462
Control.SRR15539832;43;38;0.534883720930233;20;23;0.0348837209302325;0.465116279069767
Control.SRR15539832;34;38;0.323529411764706;23;11;0.176470588235294;0.323529411764706
Control.SRR15539832;37;38;0.486486486486487;19;18;0.0135135135135135;0.486486486486487
Control.SRR15539832;34;38;0.382352941176471;21;13;0.117647058823529;0.382352941176471
Control.SRR15539832;39;38;0.615384615384615;15;24;0.115384615384615;0.384615384615385
Control.SRR15539832;36;38;0.527777777777778;17;19;0.0277777777777778;0.472222222222222
Control.SRR15539832;36;38;0.583333333333333;15;21;0.0833333333333334;0.416666666666667
Control.SRR15539832;40;38;0.475;21;19;0.025;0.475
Control.SRR15539832;42;38;0.428571428571429;24;18;0.0714285714285715;0.428571428571429
Control.SRR15539832;38;38;0.473684210526316;20;18;0.0263157894736842;0.473684210526316
Control.SRR15539832;38;38;0.5;19;19;0;0.5
Control.SRR15539832;39;38;0.512820512820513;19;20;0.0128205128205128;0.487179487179487
Control.SRR15539832;42;38;0.452380952380952;23;19;0.0476190476190476;0.452380952380952
Control.SRR15539832;43;38;0.488372093023256;22;21;0.0116279069767442;0.488372093023256
Control.SRR15539832;43;38;0.441860465116279;24;19;0.0581395348837209;0.441860465116279
Control.SRR15539832;39;38;0.512820512820513;19;20;0.0128205128205128;0.487179487179487
Control.SRR15539832;35;38;0.542857142857143;16;19;0.0428571428571428;0.457142857142857
Control.SRR15539832;40;38;0.6;16;24;0.1;0.4
Control.SRR15539832;40;38;0.35;26;14;0.15;0.35
Control.SRR15539832;36;38;0.527777777777778;17;19;0.0277777777777778;0.472222222222222
Control.SRR15539832;34;38;0.529411764705882;16;18;0.0294117647058824;0.470588235294118
Control.SRR15539832;40;38;0.575;17;23;0.075;0.425
Control.SRR15539832;35;38;0.371428571428571;22;13;0.128571428571429;0.371428571428571
Control.SRR15539832;38;38;0.473684210526316;20;18;0.0263157894736842;0.473684210526316
Control.SRR15539832;39;38;0.333333333333333;26;13;0.166666666666667;0.333333333333333
Control.SRR15539832;43;38;0.534883720930233;20;23;0.0348837209302325;0.465116279069767
Control.SRR15539832;41;38;0.463414634146341;22;19;0.0365853658536585;0.463414634146341
Control.SRR15539832;39;38;0.487179487179487;20;19;0.0128205128205128;0.487179487179487
Control.SRR15539832;39;38;0.461538461538462;21;18;0.0384615384615384;0.461538461538462
Control.SRR15539832;37;38;0.432432432432432;21;16;0.0675675675675675;0.432432432432432
Control.SRR15539832;35;38;0.457142857142857;19;16;0.0428571428571429;0.457142857142857
Control.SRR15539832;37;38;0.540540540540541;17;20;0.0405405405405406;0.459459459459459
Control.SRR15539832;36;38;0.5;18;18;0;0.5
Control.SRR15539832;34;38;0.5;17;17;0;0.5
Control.SRR15539832;34;38;0.588235294117647;14;20;0.0882352941176471;0.411764705882353
Control.SRR15539832;42;38;0.476190476190476;22;20;0.0238095238095238;0.476190476190476
Control.SRR15539832;37;38;0.702702702702703;11;26;0.202702702702703;0.297297297297297
Control.SRR15539832;37;38;0.243243243243243;28;9;0.256756756756757;0.243243243243243
Control.SRR15539832;41;38;0.585365853658537;17;24;0.0853658536585366;0.414634146341463
Control.SRR15539832;36;38;0.527777777777778;17;19;0.0277777777777778;0.472222222222222
Control.SRR15539832;36;38;0.5;18;18;0;0.5
Control.SRR15539832;34;38;0.470588235294118;18;16;0.0294117647058824;0.470588235294118
Control.SRR15539832;34;38;0.676470588235294;11;23;0.176470588235294;0.323529411764706
Control.SRR15539832;41;38;0.390243902439024;25;16;0.109756097560976;0.390243902439024
Control.SRR15539832;34;38;0.558823529411765;15;19;0.0588235294117647;0.441176470588235
Control.SRR15539832;39;38;0.384615384615385;24;15;0.115384615384615;0.384615384615385
Control.SRR15539832;37;38;0.486486486486487;19;18;0.0135135135135135;0.486486486486487
Control.SRR15539832;34;38;0.470588235294118;18;16;0.0294117647058824;0.470588235294118
Control.SRR15539832;41;38;0.463414634146341;22;19;0.0365853658536585;0.463414634146341
Control.SRR15539832;41;38;0.51219512195122;20;21;0.0121951219512195;0.48780487804878
Control.SRR15539832;44;38;0.522727272727273;21;23;0.0227272727272727;0.477272727272727
Control.SRR15539832;41;38;0.414634146341463;24;17;0.0853658536585366;0.414634146341463
Control.SRR15539832;34;38;0.588235294117647;14;20;0.0882352941176471;0.411764705882353
Control.SRR15539832;44;38;0.590909090909091;18;26;0.0909090909090909;0.409090909090909
Control.SRR15539832;40;38;0.4;24;16;0.1;0.4
Control.SRR15539832;42;38;0.476190476190476;22;20;0.0238095238095238;0.476190476190476
Control.SRR15539832;34;38;0.558823529411765;15;19;0.0588235294117647;0.441176470588235
Control.SRR15539832;38;38;0.368421052631579;24;14;0.131578947368421;0.368421052631579
Control.SRR15539832;39;38;0.487179487179487;20;19;0.0128205128205128;0.487179487179487
Control.SRR15539832;39;38;0.512820512820513;19;20;0.0128205128205128;0.487179487179487
Control.SRR15539832;42;38;0.619047619047619;16;26;0.119047619047619;0.380952380952381
Control.SRR15539832;43;38;0.418604651162791;25;18;0.0813953488372093;0.418604651162791
Control.SRR15539832;41;38;0.414634146341463;24;17;0.0853658536585366;0.414634146341463
Control.SRR15539832;41;38;0.658536585365854;14;27;0.158536585365854;0.341463414634146
Control.SRR15539832;43;38;0.488372093023256;22;21;0.0116279069767442;0.488372093023256
Control.SRR15539832;38;38;0.5;19;19;0;0.5
Control.SRR15539832;42;38;0.476190476190476;22;20;0.0238095238095238;0.476190476190476
Control.SRR15539832;41;38;0.560975609756098;18;23;0.0609756097560976;0.439024390243902
Control.SRR15539832;37;38;0.486486486486487;19;18;0.0135135135135135;0.486486486486487
Control.SRR15539832;38;38;0.5;19;19;0;0.5
Control.SRR15539832;38;38;0.5;19;19;0;0.5
Control.SRR15539832;38;38;0.578947368421053;16;22;0.0789473684210527;0.421052631578947
Control.SRR15539832;37;38;0.621621621621622;14;23;0.121621621621622;0.378378378378378
Control.SRR15539832;36;38;0.472222222222222;19;17;0.0277777777777778;0.472222222222222
Control.SRR15539832;34;38;0.5;17;17;0;0.5
Control.SRR15539832;41;38;0.414634146341463;24;17;0.0853658536585366;0.414634146341463
Control.SRR15539832;44;38;0.409090909090909;26;18;0.0909090909090909;0.409090909090909
Control.SRR15539832;40;38;0.5;20;20;0;0.5
Control.SRR15539832;42;38;0.571428571428571;18;24;0.0714285714285714;0.428571428571429
Control.SRR15539832;41;38;0.634146341463415;15;26;0.134146341463415;0.365853658536585
Control.SRR15539832;41;38;0.634146341463415;15;26;0.134146341463415;0.365853658536585
Control.SRR15539832;43;38;0.511627906976744;21;22;0.0116279069767442;0.488372093023256
Control.SRR15539832;35;38;0.571428571428571;15;20;0.0714285714285714;0.428571428571429
Control.SRR15539832;35;38;0.514285714285714;17;18;0.0142857142857142;0.485714285714286
Control.SRR15539832;37;38;0.675675675675676;12;25;0.175675675675676;0.324324324324324
Control.SRR15539832;39;38;0.538461538461538;18;21;0.0384615384615384;0.461538461538462
Control.SRR15539832;40;38;0.425;23;17;0.075;0.425
Control.SRR15539832;34;38;0.5;17;17;0;0.5
Control.SRR15539832;34;38;0.5;17;17;0;0.5
Control.SRR15539832;36;38;0.444444444444444;20;16;0.0555555555555556;0.444444444444444
Control.SRR15539832;43;38;0.558139534883721;19;24;0.0581395348837209;0.441860465116279
Control.SRR15539832;34;38;0.676470588235294;11;23;0.176470588235294;0.323529411764706
Control.SRR15539832;35;38;0.571428571428571;15;20;0.0714285714285714;0.428571428571429
Control.SRR15539832;42;38;0.5;21;21;0;0.5
Control.SRR15539832;43;38;0.488372093023256;22;21;0.0116279069767442;0.488372093023256
Control.SRR15539832;36;38;0.5;18;18;0;0.5
Control.SRR15539832;41;38;0.463414634146341;22;19;0.0365853658536585;0.463414634146341
Control.SRR15539832;40;38;0.525;19;21;0.025;0.475
Control.SRR15539832;42;38;0.571428571428571;18;24;0.0714285714285714;0.428571428571429
Control.SRR15539832;36;38;0.5;18;18;0;0.5
Control.SRR15539832;41;38;0.439024390243902;23;18;0.0609756097560976;0.439024390243902
Control.SRR15539832;34;38;0.617647058823529;13;21;0.117647058823529;0.382352941176471
Control.SRR15539832;37;38;0.459459459459459;20;17;0.0405405405405405;0.459459459459459
Control.SRR15539832;36;38;0.5;18;18;0;0.5
Control.SRR15539832;34;38;0.5;17;17;0;0.5
Control.SRR15539832;42;38;0.5;21;21;0;0.5
Control.SRR15539832;40;38;0.4;24;16;0.1;0.4
Control.SRR15539832;41;38;0.536585365853659;19;22;0.0365853658536586;0.463414634146341
Control.SRR15539832;35;38;0.571428571428571;15;20;0.0714285714285714;0.428571428571429
Control.SRR15539832;39;38;0.512820512820513;19;20;0.0128205128205128;0.487179487179487
Control.SRR15539832;35;38;0.514285714285714;17;18;0.0142857142857142;0.485714285714286
Control.SRR15539832;41;38;0.707317073170732;12;29;0.207317073170732;0.292682926829268
Control.SRR15539832;44;38;0.704545454545455;13;31;0.204545454545455;0.295454545454545
Control.SRR15539832;44;38;0.409090909090909;26;18;0.0909090909090909;0.409090909090909
Control.SRR15539832;40;38;0.45;22;18;0.05;0.45
Control.SRR15539832;41;38;0.609756097560976;16;25;0.109756097560976;0.390243902439024
Control.SRR15539832;38;38;0.342105263157895;25;13;0.157894736842105;0.342105263157895
Control.SRR15539832;37;38;0.378378378378378;23;14;0.121621621621622;0.378378378378378
Control.SRR15539832;42;38;0.571428571428571;18;24;0.0714285714285714;0.428571428571429
Control.SRR15539832;41;38;0.439024390243902;23;18;0.0609756097560976;0.439024390243902
Control.SRR15539832;39;38;0.41025641025641;23;16;0.0897435897435898;0.41025641025641
Control.SRR15539832;36;38;0.555555555555556;16;20;0.0555555555555556;0.444444444444444
Control.SRR15539832;39;38;0.384615384615385;24;15;0.115384615384615;0.384615384615385
Control.SRR15539832;36;38;0.555555555555556;16;20;0.0555555555555556;0.444444444444444
Control.SRR15539832;34;38;0.529411764705882;16;18;0.0294117647058824;0.470588235294118
Control.SRR15539832;35;38;0.628571428571429;13;22;0.128571428571429;0.371428571428571
Control.SRR15539832;34;38;0.5;17;17;0;0.5
Control.SRR15539832;36;38;0.472222222222222;19;17;0.0277777777777778;0.472222222222222
Control.SRR15539832;36;38;0.5;18;18;0;0.5
Control.SRR15539832;41;38;0.658536585365854;14;27;0.158536585365854;0.341463414634146
Control.SRR15539832;34;38;0.441176470588235;19;15;0.0588235294117647;0.441176470588235
Control.SRR15539832;36;38;0.444444444444444;20;16;0.0555555555555556;0.444444444444444
Control.SRR15539832;36;38;0.416666666666667;21;15;0.0833333333333333;0.416666666666667
Control.SRR15539832;40;38;0.5;20;20;0;0.5
Control.SRR15539832;34;38;0.588235294117647;14;20;0.0882352941176471;0.411764705882353
Control.SRR15539832;34;38;0.529411764705882;16;18;0.0294117647058824;0.470588235294118
Control.SRR15539832;41;38;0.536585365853659;19;22;0.0365853658536586;0.463414634146341
Control.SRR15539832;43;38;0.511627906976744;21;22;0.0116279069767442;0.488372093023256
Control.SRR15539832;41;38;0.51219512195122;20;21;0.0121951219512195;0.48780487804878
Control.SRR15539832;44;38;0.454545454545455;24;20;0.0454545454545455;0.454545454545455
Control.SRR15539832;34;38;0.382352941176471;21;13;0.117647058823529;0.382352941176471
Control.SRR15539832;41;38;0.634146341463415;15;26;0.134146341463415;0.365853658536585
Control.SRR15539832;35;38;0.285714285714286;25;10;0.214285714285714;0.285714285714286
Control.SRR15539832;36;38;0.527777777777778;17;19;0.0277777777777778;0.472222222222222
Control.SRR15539832;43;38;0.534883720930233;20;23;0.0348837209302325;0.465116279069767
Control.SRR15539832;37;38;0.432432432432432;21;16;0.0675675675675675;0.432432432432432
Control.SRR15539832;35;38;0.542857142857143;16;19;0.0428571428571428;0.457142857142857
Control.SRR15539832;41;38;0.585365853658537;17;24;0.0853658536585366;0.414634146341463
Control.SRR15539832;41;38;0.536585365853659;19;22;0.0365853658536586;0.463414634146341
Control.SRR15539832;41;38;0.463414634146341;22;19;0.0365853658536585;0.463414634146341
Control.SRR15539832;39;38;0.487179487179487;20;19;0.0128205128205128;0.487179487179487
Control.SRR15539832;43;38;0.511627906976744;21;22;0.0116279069767442;0.488372093023256
Control.SRR15539832;34;38;0.5;17;17;0;0.5
Control.SRR15539832;40;38;0.6;16;24;0.1;0.4
Control.SRR15539832;39;38;0.384615384615385;24;15;0.115384615384615;0.384615384615385
Control.SRR15539832;40;38;0.35;26;14;0.15;0.35
Control.SRR15539832;39;38;0.41025641025641;23;16;0.0897435897435898;0.41025641025641
Control.SRR15539832;43;38;0.534883720930233;20;23;0.0348837209302325;0.465116279069767
Control.SRR15539832;40;38;0.425;23;17;0.075;0.425
Control.SRR15539832;36;38;0.472222222222222;19;17;0.0277777777777778;0.472222222222222
Control.SRR15539832;43;38;0.604651162790698;17;26;0.104651162790698;0.395348837209302
Control.SRR15539832;37;38;0.324324324324324;25;12;0.175675675675676;0.324324324324324
Control.SRR15539832;40;38;0.575;17;23;0.075;0.425
Control.SRR15539832;43;38;0.604651162790698;17;26;0.104651162790698;0.395348837209302
Control.SRR15539832;36;38;0.555555555555556;16;20;0.0555555555555556;0.444444444444444
Control.SRR15539832;37;38;0.594594594594595;15;22;0.0945945945945946;0.405405405405405
Control.SRR15539832;38;38;0.526315789473684;18;20;0.0263157894736842;0.473684210526316
Control.SRR15539832;40;38;0.45;22;18;0.05;0.45
Control.SRR15539832;36;38;0.527777777777778;17;19;0.0277777777777778;0.472222222222222
Control.SRR15539832;40;38;0.55;18;22;0.05;0.45
Control.SRR15539832;35;38;0.457142857142857;19;16;0.0428571428571429;0.457142857142857
Control.SRR15539832;36;38;0.5;18;18;0;0.5
Control.SRR15539832;34;38;0.411764705882353;20;14;0.0882352941176471;0.411764705882353
Control.SRR15539832;40;38;0.525;19;21;0.025;0.475
Control.SRR15539832;37;38;0.567567567567568;16;21;0.0675675675675675;0.432432432432432
Control.SRR15539832;44;38;0.590909090909091;18;26;0.0909090909090909;0.409090909090909
Control.SRR15539832;40;38;0.575;17;23;0.075;0.425
Control.SRR15539832;34;38;0.352941176470588;22;12;0.147058823529412;0.352941176470588
Control.SRR15539832;41;38;0.463414634146341;22;19;0.0365853658536585;0.463414634146341
Control.SRR15539832;41;38;0.536585365853659;19;22;0.0365853658536586;0.463414634146341
Control.SRR15539832;40;38;0.425;23;17;0.075;0.425
Control.SRR15539832;37;38;0.594594594594595;15;22;0.0945945945945946;0.405405405405405
Control.SRR15539832;39;38;0.333333333333333;26;13;0.166666666666667;0.333333333333333
Control.SRR15539832;43;38;0.581395348837209;18;25;0.0813953488372093;0.418604651162791
Control.SRR15539832;39;38;0.58974358974359;16;23;0.0897435897435898;0.41025641025641
Control.SRR15539832;37;38;0.513513513513513;18;19;0.0135135135135135;0.486486486486487
Control.SRR15539832;34;38;0.470588235294118;18;16;0.0294117647058824;0.470588235294118
Control.SRR15539832;36;38;0.444444444444444;20;16;0.0555555555555556;0.444444444444444
Control.SRR15539832;34;38;0.441176470588235;19;15;0.0588235294117647;0.441176470588235
Control.SRR15539832;44;38;0.522727272727273;21;23;0.0227272727272727;0.477272727272727
Control.SRR15539832;43;38;0.720930232558139;12;31;0.220930232558139;0.27906976744186
Control.SRR15539832;34;38;0.529411764705882;16;18;0.0294117647058824;0.470588235294118
Control.SRR15539832;35;38;0.428571428571429;20;15;0.0714285714285715;0.428571428571429
Control.SRR15539832;39;38;0.461538461538462;21;18;0.0384615384615384;0.461538461538462
Control.SRR15539832;41;38;0.414634146341463;24;17;0.0853658536585366;0.414634146341463
Control.SRR15539832;43;38;0.488372093023256;22;21;0.0116279069767442;0.488372093023256
Control.SRR15539832;36;38;0.472222222222222;19;17;0.0277777777777778;0.472222222222222
Control.SRR15539832;37;38;0.459459459459459;20;17;0.0405405405405405;0.459459459459459
Control.SRR15539832;34;38;0.5;17;17;0;0.5
Control.SRR15539832;38;38;0.421052631578947;22;16;0.0789473684210527;0.421052631578947
Control.SRR15539832;37;38;0.459459459459459;20;17;0.0405405405405405;0.459459459459459
Control.SRR15539832;35;38;0.685714285714286;11;24;0.185714285714286;0.314285714285714
Control.SRR15539832;37;38;0.594594594594595;15;22;0.0945945945945946;0.405405405405405
Control.SRR15539832;35;38;0.485714285714286;18;17;0.0142857142857143;0.485714285714286
Control.SRR15539832;35;38;0.571428571428571;15;20;0.0714285714285714;0.428571428571429
Control.SRR15539832;35;38;0.457142857142857;19;16;0.0428571428571429;0.457142857142857
Control.SRR15539832;39;38;0.41025641025641;23;16;0.0897435897435898;0.41025641025641
Control.SRR15539832;44;38;0.545454545454545;20;24;0.0454545454545454;0.454545454545455
Control.SRR15539832;40;38;0.5;20;20;0;0.5
Control.SRR15539832;40;38;0.5;20;20;0;0.5
Control.SRR15539832;37;38;0.405405405405405;22;15;0.0945945945945946;0.405405405405405
Control.SRR15539832;36;38;0.555555555555556;16;20;0.0555555555555556;0.444444444444444
Control.SRR15539832;38;38;0.710526315789474;11;27;0.210526315789474;0.289473684210526
Control.SRR15539832;36;38;0.388888888888889;22;14;0.111111111111111;0.388888888888889
Control.SRR15539832;38;38;0.473684210526316;20;18;0.0263157894736842;0.473684210526316
Control.SRR15539832;44;38;0.522727272727273;21;23;0.0227272727272727;0.477272727272727
Control.SRR15539832;43;38;0.604651162790698;17;26;0.104651162790698;0.395348837209302
Control.SRR15539832;43;38;0.488372093023256;22;21;0.0116279069767442;0.488372093023256
Control.SRR15539832;44;38;0.477272727272727;23;21;0.0227272727272727;0.477272727272727
Control.SRR15539832;34;38;0.470588235294118;18;16;0.0294117647058824;0.470588235294118
Control.SRR15539832;41;38;0.463414634146341;22;19;0.0365853658536585;0.463414634146341
Control.SRR15539832;36;38;0.611111111111111;14;22;0.111111111111111;0.388888888888889
Control.SRR15539832;40;38;0.475;21;19;0.025;0.475
Control.SRR15539832;41;38;0.414634146341463;24;17;0.0853658536585366;0.414634146341463
Control.SRR15539832;37;38;0.432432432432432;21;16;0.0675675675675675;0.432432432432432
Control.SRR15539832;36;38;0.444444444444444;20;16;0.0555555555555556;0.444444444444444
Control.SRR15539832;39;38;0.41025641025641;23;16;0.0897435897435898;0.41025641025641
Control.SRR15539832;39;38;0.564102564102564;17;22;0.0641025641025641;0.435897435897436
Control.SRR15539832;42;38;0.476190476190476;22;20;0.0238095238095238;0.476190476190476
Control.SRR15539832;43;38;0.558139534883721;19;24;0.0581395348837209;0.441860465116279
Control.SRR15539832;39;38;0.487179487179487;20;19;0.0128205128205128;0.487179487179487
Control.SRR15539832;40;38;0.525;19;21;0.025;0.475
Control.SRR15539832;39;38;0.564102564102564;17;22;0.0641025641025641;0.435897435897436
Control.SRR15539832;44;38;0.522727272727273;21;23;0.0227272727272727;0.477272727272727
Control.SRR15539832;39;38;0.384615384615385;24;15;0.115384615384615;0.384615384615385
Control.SRR15539832;42;38;0.571428571428571;18;24;0.0714285714285714;0.428571428571429
Control.SRR15539832;43;38;0.511627906976744;21;22;0.0116279069767442;0.488372093023256
Control.SRR15539832;37;38;0.486486486486487;19;18;0.0135135135135135;0.486486486486487
Control.SRR15539832;39;38;0.538461538461538;18;21;0.0384615384615384;0.461538461538462
Control.SRR15539832;34;38;0.352941176470588;22;12;0.147058823529412;0.352941176470588
Control.SRR15539832;42;38;0.642857142857143;15;27;0.142857142857143;0.357142857142857
Control.SRR15539832;43;38;0.511627906976744;21;22;0.0116279069767442;0.488372093023256
Control.SRR15539832;43;38;0.534883720930233;20;23;0.0348837209302325;0.465116279069767
Control.SRR15539832;41;38;0.48780487804878;21;20;0.0121951219512195;0.48780487804878
Control.SRR15539832;36;38;0.555555555555556;16;20;0.0555555555555556;0.444444444444444
Control.SRR15539832;42;38;0.428571428571429;24;18;0.0714285714285715;0.428571428571429
Control.SRR15539832;42;38;0.428571428571429;24;18;0.0714285714285715;0.428571428571429
Control.SRR15539832;41;38;0.317073170731707;28;13;0.182926829268293;0.317073170731707
Control.SRR15539832;38;38;0.447368421052632;21;17;0.0526315789473684;0.447368421052632
Control.SRR15539832;35;38;0.514285714285714;17;18;0.0142857142857142;0.485714285714286
Control.SRR15539832;40;38;0.525;19;21;0.025;0.475
Control.SRR15539832;40;38;0.425;23;17;0.075;0.425
Control.SRR15539832;44;38;0.545454545454545;20;24;0.0454545454545454;0.454545454545455
Control.SRR15539832;38;38;0.342105263157895;25;13;0.157894736842105;0.342105263157895
Control.SRR15539832;43;38;0.627906976744186;16;27;0.127906976744186;0.372093023255814
Control.SRR15539832;35;38;0.428571428571429;20;15;0.0714285714285715;0.428571428571429
Control.SRR15539832;43;38;0.720930232558139;12;31;0.220930232558139;0.27906976744186
Control.SRR15539832;42;38;0.619047619047619;16;26;0.119047619047619;0.380952380952381
Control.SRR15539832;40;38;0.525;19;21;0.025;0.475
Control.SRR15539832;43;38;0.465116279069767;23;20;0.0348837209302326;0.465116279069767
Control.SRR15539832;42;38;0.476190476190476;22;20;0.0238095238095238;0.476190476190476
Control.SRR15539832;37;38;0.513513513513513;18;19;0.0135135135135135;0.486486486486487
Control.SRR15539832;35;38;0.428571428571429;20;15;0.0714285714285715;0.428571428571429
Control.SRR15539832;39;38;0.41025641025641;23;16;0.0897435897435898;0.41025641025641
Control.SRR15539832;42;38;0.5;21;21;0;0.5
Control.SRR15539832;44;38;0.477272727272727;23;21;0.0227272727272727;0.477272727272727
Control.SRR15539832;40;38;0.575;17;23;0.075;0.425
Control.SRR15539832;37;38;0.513513513513513;18;19;0.0135135135135135;0.486486486486487
Control.SRR15539832;43;38;0.395348837209302;26;17;0.104651162790698;0.395348837209302
Control.SRR15539832;36;38;0.444444444444444;20;16;0.0555555555555556;0.444444444444444
Control.SRR15539832;37;38;0.378378378378378;23;14;0.121621621621622;0.378378378378378
Control.SRR15539832;40;38;0.65;14;26;0.15;0.35
Control.SRR15539832;35;38;0.542857142857143;16;19;0.0428571428571428;0.457142857142857
Control.SRR15539832;40;38;0.5;20;20;0;0.5
Control.SRR15539832;35;38;0.485714285714286;18;17;0.0142857142857143;0.485714285714286
Control.SRR15539832;35;38;0.628571428571429;13;22;0.128571428571429;0.371428571428571
Control.SRR15539832;44;38;0.5;22;22;0;0.5
Control.SRR15539832;43;38;0.511627906976744;21;22;0.0116279069767442;0.488372093023256
Control.SRR15539832;40;38;0.475;21;19;0.025;0.475
Control.SRR15539832;44;38;0.386363636363636;27;17;0.113636363636364;0.386363636363636
Control.SRR15539832;38;38;0.578947368421053;16;22;0.0789473684210527;0.421052631578947
Control.SRR15539832;35;38;0.571428571428571;15;20;0.0714285714285714;0.428571428571429
Control.SRR15539832;44;38;0.613636363636364;17;27;0.113636363636364;0.386363636363636
Control.SRR15539832;34;38;0.5;17;17;0;0.5
Control.SRR15539832;41;38;0.536585365853659;19;22;0.0365853658536586;0.463414634146341
Control.SRR15539832;43;38;0.441860465116279;24;19;0.0581395348837209;0.441860465116279
Control.SRR15539832;36;38;0.583333333333333;15;21;0.0833333333333334;0.416666666666667
Control.SRR15539832;36;38;0.555555555555556;16;20;0.0555555555555556;0.444444444444444
Control.SRR15539832;42;38;0.571428571428571;18;24;0.0714285714285714;0.428571428571429
Control.SRR15539832;40;38;0.4;24;16;0.1;0.4
Control.SRR15539832;44;38;0.568181818181818;19;25;0.0681818181818182;0.431818181818182
Control.SRR15539832;39;38;0.333333333333333;26;13;0.166666666666667;0.333333333333333
Control.SRR15539832;36;38;0.416666666666667;21;15;0.0833333333333333;0.416666666666667
Control.SRR15539832;36;38;0.583333333333333;15;21;0.0833333333333334;0.416666666666667
Control.SRR15539832;35;38;0.485714285714286;18;17;0.0142857142857143;0.485714285714286
Control.SRR15539832;44;38;0.454545454545455;24;20;0.0454545454545455;0.454545454545455
Control.SRR15539832;35;38;0.485714285714286;18;17;0.0142857142857143;0.485714285714286
Control.SRR15539832;36;38;0.527777777777778;17;19;0.0277777777777778;0.472222222222222
Control.SRR15539832;42;38;0.261904761904762;31;11;0.238095238095238;0.261904761904762
Control.SRR15539832;42;38;0.5;21;21;0;0.5
Control.SRR15539832;42;38;0.571428571428571;18;24;0.0714285714285714;0.428571428571429
Control.SRR15539832;37;38;0.540540540540541;17;20;0.0405405405405406;0.459459459459459
Control.SRR15539832;43;38;0.418604651162791;25;18;0.0813953488372093;0.418604651162791
Control.SRR15539832;43;38;0.534883720930233;20;23;0.0348837209302325;0.465116279069767
Control.SRR15539832;43;38;0.581395348837209;18;25;0.0813953488372093;0.418604651162791
Control.SRR15539832;37;38;0.459459459459459;20;17;0.0405405405405405;0.459459459459459
Control.SRR15539832;42;38;0.428571428571429;24;18;0.0714285714285715;0.428571428571429
Control.SRR15539832;44;38;0.431818181818182;25;19;0.0681818181818182;0.431818181818182
Control.SRR15539832;40;38;0.55;18;22;0.05;0.45
Control.SRR15539832;44;38;0.454545454545455;24;20;0.0454545454545455;0.454545454545455
Control.SRR15539832;34;38;0.411764705882353;20;14;0.0882352941176471;0.411764705882353
Control.SRR15539832;34;38;0.529411764705882;16;18;0.0294117647058824;0.470588235294118
Control.SRR15539832;34;38;0.5;17;17;0;0.5
Control.SRR15539832;39;38;0.358974358974359;25;14;0.141025641025641;0.358974358974359
Control.SRR15539832;40;38;0.5;20;20;0;0.5
Control.SRR15539832;40;38;0.45;22;18;0.05;0.45
Control.SRR15539832;38;38;0.447368421052632;21;17;0.0526315789473684;0.447368421052632
Control.SRR15539832;39;38;0.538461538461538;18;21;0.0384615384615384;0.461538461538462
Control.SRR15539832;40;38;0.475;21;19;0.025;0.475
Control.SRR15539832;42;38;0.547619047619048;19;23;0.0476190476190477;0.452380952380952
Control.SRR15539832;43;38;0.581395348837209;18;25;0.0813953488372093;0.418604651162791
Control.SRR15539832;34;38;0.558823529411765;15;19;0.0588235294117647;0.441176470588235
Control.SRR15539832;43;38;0.395348837209302;26;17;0.104651162790698;0.395348837209302
Control.SRR15539832;36;38;0.388888888888889;22;14;0.111111111111111;0.388888888888889
Control.SRR15539832;35;38;0.571428571428571;15;20;0.0714285714285714;0.428571428571429
Control.SRR15539832;36;38;0.416666666666667;21;15;0.0833333333333333;0.416666666666667
Control.SRR15539832;36;38;0.583333333333333;15;21;0.0833333333333334;0.416666666666667
Control.SRR15539832;37;38;0.567567567567568;16;21;0.0675675675675675;0.432432432432432
Control.SRR15539832;34;38;0.588235294117647;14;20;0.0882352941176471;0.411764705882353
Control.SRR15539832;39;38;0.58974358974359;16;23;0.0897435897435898;0.41025641025641
Control.SRR15539832;42;38;0.547619047619048;19;23;0.0476190476190477;0.452380952380952
Control.SRR15539832;41;38;0.463414634146341;22;19;0.0365853658536585;0.463414634146341
Control.SRR15539832;35;38;0.428571428571429;20;15;0.0714285714285715;0.428571428571429
Control.SRR15539832;39;38;0.384615384615385;24;15;0.115384615384615;0.384615384615385
Control.SRR15539832;36;38;0.555555555555556;16;20;0.0555555555555556;0.444444444444444
Control.SRR15539832;43;38;0.418604651162791;25;18;0.0813953488372093;0.418604651162791
Control.SRR15539832;34;38;0.529411764705882;16;18;0.0294117647058824;0.470588235294118
Control.SRR15539832;39;38;0.461538461538462;21;18;0.0384615384615384;0.461538461538462
Control.SRR15539832;34;38;0.529411764705882;16;18;0.0294117647058824;0.470588235294118
Control.SRR15539832;39;38;0.538461538461538;18;21;0.0384615384615384;0.461538461538462
Control.SRR15539832;40;38;0.575;17;23;0.075;0.425
Control.SRR15539832;39;38;0.461538461538462;21;18;0.0384615384615384;0.461538461538462
Control.SRR15539832;34;38;0.470588235294118;18;16;0.0294117647058824;0.470588235294118
Control.SRR15539832;43;38;0.558139534883721;19;24;0.0581395348837209;0.441860465116279
Control.SRR15539832;42;38;0.5;21;21;0;0.5
Control.SRR15539832;43;38;0.558139534883721;19;24;0.0581395348837209;0.441860465116279
Control.SRR15539832;39;38;0.358974358974359;25;14;0.141025641025641;0.358974358974359
Control.SRR15539832;35;38;0.514285714285714;17;18;0.0142857142857142;0.485714285714286
Control.SRR15539832;37;38;0.648648648648649;13;24;0.148648648648649;0.351351351351351
Control.SRR15539832;43;38;0.441860465116279;24;19;0.0581395348837209;0.441860465116279
Control.SRR15539832;36;38;0.5;18;18;0;0.5
Control.SRR15539832;40;38;0.45;22;18;0.05;0.45
Control.SRR15539832;39;38;0.461538461538462;21;18;0.0384615384615384;0.461538461538462
Control.SRR15539832;39;38;0.461538461538462;21;18;0.0384615384615384;0.461538461538462
Control.SRR15539832;36;38;0.388888888888889;22;14;0.111111111111111;0.388888888888889
Control.SRR15539832;36;38;0.527777777777778;17;19;0.0277777777777778;0.472222222222222
Control.SRR15539832;37;38;0.432432432432432;21;16;0.0675675675675675;0.432432432432432
Control.SRR15539832;39;38;0.487179487179487;20;19;0.0128205128205128;0.487179487179487
Control.SRR15539832;40;38;0.55;18;22;0.05;0.45
Control.SRR15539832;34;38;0.382352941176471;21;13;0.117647058823529;0.382352941176471
Control.SRR15539832;34;38;0.470588235294118;18;16;0.0294117647058824;0.470588235294118
Control.SRR15539832;37;38;0.540540540540541;17;20;0.0405405405405406;0.459459459459459
Control.SRR15539832;37;38;0.567567567567568;16;21;0.0675675675675675;0.432432432432432
Control.SRR15539832;42;38;0.595238095238095;17;25;0.0952380952380952;0.404761904761905
Control.SRR15539832;38;38;0.552631578947368;17;21;0.0526315789473685;0.447368421052632
Control.SRR15539832;37;38;0.540540540540541;17;20;0.0405405405405406;0.459459459459459
Control.SRR15539832;40;38;0.45;22;18;0.05;0.45
Control.SRR15539832;40;38;0.475;21;19;0.025;0.475
Control.SRR15539832;40;38;0.5;20;20;0;0.5
Control.SRR15539832;41;38;0.48780487804878;21;20;0.0121951219512195;0.48780487804878
Control.SRR15539832;37;38;0.567567567567568;16;21;0.0675675675675675;0.432432432432432
Control.SRR15539832;43;38;0.441860465116279;24;19;0.0581395348837209;0.441860465116279
Control.SRR15539832;41;38;0.609756097560976;16;25;0.109756097560976;0.390243902439024
Control.SRR15539832;40;38;0.4;24;16;0.1;0.4
Control.SRR15539832;34;38;0.617647058823529;13;21;0.117647058823529;0.382352941176471
Control.SRR15539832;35;38;0.571428571428571;15;20;0.0714285714285714;0.428571428571429
Control.SRR15539832;39;38;0.564102564102564;17;22;0.0641025641025641;0.435897435897436
Control.SRR15539832;42;38;0.404761904761905;25;17;0.0952380952380952;0.404761904761905
Control.SRR15539832;40;38;0.6;16;24;0.1;0.4
Control.SRR15539832;39;38;0.512820512820513;19;20;0.0128205128205128;0.487179487179487
Control.SRR15539832;39;38;0.512820512820513;19;20;0.0128205128205128;0.487179487179487
Control.SRR15539832;39;38;0.538461538461538;18;21;0.0384615384615384;0.461538461538462
Control.SRR15539832;40;38;0.45;22;18;0.05;0.45
Control.SRR15539832;37;38;0.432432432432432;21;16;0.0675675675675675;0.432432432432432
Control.SRR15539832;38;38;0.447368421052632;21;17;0.0526315789473684;0.447368421052632
Control.SRR15539832;41;38;0.48780487804878;21;20;0.0121951219512195;0.48780487804878
Control.SRR15539832;44;38;0.522727272727273;21;23;0.0227272727272727;0.477272727272727
Control.SRR15539832;40;38;0.475;21;19;0.025;0.475
Control.SRR15539832;39;38;0.538461538461538;18;21;0.0384615384615384;0.461538461538462
Control.SRR15539832;34;38;0.558823529411765;15;19;0.0588235294117647;0.441176470588235
Control.SRR15539832;40;38;0.55;18;22;0.05;0.45
Control.SRR15539832;43;38;0.534883720930233;20;23;0.0348837209302325;0.465116279069767
Control.SRR15539832;44;38;0.477272727272727;23;21;0.0227272727272727;0.477272727272727
Control.SRR15539832;43;38;0.488372093023256;22;21;0.0116279069767442;0.488372093023256
Control.SRR15539832;37;38;0.378378378378378;23;14;0.121621621621622;0.378378378378378
Control.SRR15539832;40;38;0.425;23;17;0.075;0.425
Control.SRR15539832;36;38;0.472222222222222;19;17;0.0277777777777778;0.472222222222222
Control.SRR15539832;39;38;0.512820512820513;19;20;0.0128205128205128;0.487179487179487
Control.SRR15539832;40;38;0.525;19;21;0.025;0.475
Control.SRR15539832;42;38;0.523809523809524;20;22;0.0238095238095238;0.476190476190476
Control.SRR15539832;37;38;0.405405405405405;22;15;0.0945945945945946;0.405405405405405
Control.SRR15539832;38;38;0.421052631578947;22;16;0.0789473684210527;0.421052631578947
Control.SRR15539832;37;38;0.459459459459459;20;17;0.0405405405405405;0.459459459459459
Control.SRR15539832;36;38;0.555555555555556;16;20;0.0555555555555556;0.444444444444444
Control.SRR15539832;40;38;0.575;17;23;0.075;0.425
Control.SRR15539832;35;38;0.571428571428571;15;20;0.0714285714285714;0.428571428571429
Control.SRR15539832;44;38;0.613636363636364;17;27;0.113636363636364;0.386363636363636
Control.SRR15539832;42;38;0.452380952380952;23;19;0.0476190476190476;0.452380952380952
Control.SRR15539832;37;38;0.648648648648649;13;24;0.148648648648649;0.351351351351351
Control.SRR15539832;36;38;0.555555555555556;16;20;0.0555555555555556;0.444444444444444
Control.SRR15539832;37;38;0.567567567567568;16;21;0.0675675675675675;0.432432432432432
Control.SRR15539832;44;38;0.590909090909091;18;26;0.0909090909090909;0.409090909090909
Control.SRR15539832;41;38;0.536585365853659;19;22;0.0365853658536586;0.463414634146341
Control.SRR15539832;37;38;0.540540540540541;17;20;0.0405405405405406;0.459459459459459
Control.SRR15539832;36;38;0.583333333333333;15;21;0.0833333333333334;0.416666666666667
Control.SRR15539832;37;38;0.486486486486487;19;18;0.0135135135135135;0.486486486486487
Control.SRR15539832;40;38;0.55;18;22;0.05;0.45
Control.SRR15539832;37;38;0.486486486486487;19;18;0.0135135135135135;0.486486486486487
Control.SRR15539832;44;38;0.5;22;22;0;0.5
Control.SRR15539832;35;38;0.4;21;14;0.1;0.4
Control.SRR15539832;41;38;0.463414634146341;22;19;0.0365853658536585;0.463414634146341
Control.SRR15539832;43;38;0.511627906976744;21;22;0.0116279069767442;0.488372093023256
Control.SRR15539832;44;38;0.454545454545455;24;20;0.0454545454545455;0.454545454545455
Control.SRR15539832;43;38;0.465116279069767;23;20;0.0348837209302326;0.465116279069767
Control.SRR15539832;38;38;0.368421052631579;24;14;0.131578947368421;0.368421052631579
Control.SRR15539832;37;38;0.486486486486487;19;18;0.0135135135135135;0.486486486486487
Control.SRR15539832;35;38;0.657142857142857;12;23;0.157142857142857;0.342857142857143
Control.SRR15539832;34;38;0.529411764705882;16;18;0.0294117647058824;0.470588235294118
Control.SRR15539832;40;38;0.55;18;22;0.05;0.45
Control.SRR15539832;34;38;0.529411764705882;16;18;0.0294117647058824;0.470588235294118
Control.SRR15539832;35;38;0.628571428571429;13;22;0.128571428571429;0.371428571428571
Control.SRR15539832;39;38;0.487179487179487;20;19;0.0128205128205128;0.487179487179487
Control.SRR15539832;38;38;0.473684210526316;20;18;0.0263157894736842;0.473684210526316
Control.SRR15539832;41;38;0.414634146341463;24;17;0.0853658536585366;0.414634146341463
Control.SRR15539832;40;38;0.5;20;20;0;0.5
Control.SRR15539832;34;38;0.676470588235294;11;23;0.176470588235294;0.323529411764706
Control.SRR15539832;36;38;0.555555555555556;16;20;0.0555555555555556;0.444444444444444
Control.SRR15539832;41;38;0.439024390243902;23;18;0.0609756097560976;0.439024390243902
Control.SRR15539832;37;38;0.378378378378378;23;14;0.121621621621622;0.378378378378378
Control.SRR15539832;40;38;0.425;23;17;0.075;0.425
Control.SRR15539832;37;38;0.486486486486487;19;18;0.0135135135135135;0.486486486486487
Control.SRR15539832;34;38;0.588235294117647;14;20;0.0882352941176471;0.411764705882353
Control.SRR15539832;42;38;0.380952380952381;26;16;0.119047619047619;0.380952380952381
Control.SRR15539832;39;38;0.461538461538462;21;18;0.0384615384615384;0.461538461538462
Control.SRR15539832;44;38;0.545454545454545;20;24;0.0454545454545454;0.454545454545455
Control.SRR15539832;36;38;0.5;18;18;0;0.5
Control.SRR15539832;43;38;0.534883720930233;20;23;0.0348837209302325;0.465116279069767
Control.SRR15539832;41;38;0.51219512195122;20;21;0.0121951219512195;0.48780487804878
Control.SRR15539832;44;38;0.454545454545455;24;20;0.0454545454545455;0.454545454545455
Control.SRR15539832;42;38;0.476190476190476;22;20;0.0238095238095238;0.476190476190476
Control.SRR15539832;41;38;0.536585365853659;19;22;0.0365853658536586;0.463414634146341
Control.SRR15539832;43;38;0.511627906976744;21;22;0.0116279069767442;0.488372093023256
Control.SRR15539832;35;38;0.542857142857143;16;19;0.0428571428571428;0.457142857142857
Control.SRR15539832;37;38;0.756756756756757;9;28;0.256756756756757;0.243243243243243
Control.SRR15539832;37;38;0.594594594594595;15;22;0.0945945945945946;0.405405405405405
Control.SRR15539832;34;38;0.529411764705882;16;18;0.0294117647058824;0.470588235294118
Control.SRR15539832;36;38;0.5;18;18;0;0.5
Control.SRR15539832;34;38;0.441176470588235;19;15;0.0588235294117647;0.441176470588235
Control.SRR15539832;37;38;0.432432432432432;21;16;0.0675675675675675;0.432432432432432
Control.SRR15539832;39;38;0.461538461538462;21;18;0.0384615384615384;0.461538461538462
Control.SRR15539832;41;38;0.51219512195122;20;21;0.0121951219512195;0.48780487804878
Control.SRR15539832;41;38;0.390243902439024;25;16;0.109756097560976;0.390243902439024
Control.SRR15539832;37;38;0.432432432432432;21;16;0.0675675675675675;0.432432432432432
Control.SRR15539832;40;38;0.5;20;20;0;0.5
Control.SRR15539832;43;38;0.395348837209302;26;17;0.104651162790698;0.395348837209302
Control.SRR15539832;42;38;0.357142857142857;27;15;0.142857142857143;0.357142857142857
Control.SRR15539832;37;38;0.594594594594595;15;22;0.0945945945945946;0.405405405405405
Control.SRR15539832;35;38;0.514285714285714;17;18;0.0142857142857142;0.485714285714286
Control.SRR15539832;36;38;0.361111111111111;23;13;0.138888888888889;0.361111111111111
Control.SRR15539832;41;38;0.634146341463415;15;26;0.134146341463415;0.365853658536585
Control.SRR15539832;43;38;0.372093023255814;27;16;0.127906976744186;0.372093023255814
Control.SRR15539832;39;38;0.538461538461538;18;21;0.0384615384615384;0.461538461538462
Control.SRR15539832;42;38;0.642857142857143;15;27;0.142857142857143;0.357142857142857
Control.SRR15539832;39;38;0.538461538461538;18;21;0.0384615384615384;0.461538461538462
Control.SRR15539832;35;38;0.657142857142857;12;23;0.157142857142857;0.342857142857143
Control.SRR15539832;40;38;0.5;20;20;0;0.5
Control.SRR15539832;42;38;0.428571428571429;24;18;0.0714285714285715;0.428571428571429
Control.SRR15539832;40;38;0.45;22;18;0.05;0.45
Control.SRR15539832;40;38;0.575;17;23;0.075;0.425
Control.SRR15539832;44;38;0.454545454545455;24;20;0.0454545454545455;0.454545454545455
Control.SRR15539832;41;38;0.463414634146341;22;19;0.0365853658536585;0.463414634146341
Control.SRR15539832;38;38;0.552631578947368;17;21;0.0526315789473685;0.447368421052632
Control.SRR15539832;39;38;0.58974358974359;16;23;0.0897435897435898;0.41025641025641
Control.SRR15539832;38;38;0.473684210526316;20;18;0.0263157894736842;0.473684210526316
Control.SRR15539832;34;38;0.411764705882353;20;14;0.0882352941176471;0.411764705882353
Control.SRR15539832;36;38;0.416666666666667;21;15;0.0833333333333333;0.416666666666667
Control.SRR15539832;38;38;0.578947368421053;16;22;0.0789473684210527;0.421052631578947
Control.SRR15539832;35;38;0.428571428571429;20;15;0.0714285714285715;0.428571428571429
Control.SRR15539832;40;38;0.5;20;20;0;0.5
Control.SRR15539832;38;38;0.473684210526316;20;18;0.0263157894736842;0.473684210526316
Control.SRR15539832;37;38;0.486486486486487;19;18;0.0135135135135135;0.486486486486487
Control.SRR15539832;43;38;0.511627906976744;21;22;0.0116279069767442;0.488372093023256
Control.SRR15539832;38;38;0.473684210526316;20;18;0.0263157894736842;0.473684210526316
Control.SRR15539832;37;38;0.567567567567568;16;21;0.0675675675675675;0.432432432432432
Control.SRR15539832;41;38;0.585365853658537;17;24;0.0853658536585366;0.414634146341463
Control.SRR15539832;37;38;0.540540540540541;17;20;0.0405405405405406;0.459459459459459
Control.SRR15539832;40;38;0.425;23;17;0.075;0.425
Control.SRR15539832;41;38;0.634146341463415;15;26;0.134146341463415;0.365853658536585
Control.SRR15539832;35;38;0.6;14;21;0.1;0.4
Control.SRR15539832;43;38;0.372093023255814;27;16;0.127906976744186;0.372093023255814
Control.SRR15539832;44;38;0.409090909090909;26;18;0.0909090909090909;0.409090909090909
Control.SRR15539832;40;38;0.475;21;19;0.025;0.475
Control.SRR15539832;38;38;0.578947368421053;16;22;0.0789473684210527;0.421052631578947
Control.SRR15539832;34;38;0.558823529411765;15;19;0.0588235294117647;0.441176470588235
Control.SRR15539832;35;38;0.457142857142857;19;16;0.0428571428571429;0.457142857142857
Control.SRR15539832;34;38;0.5;17;17;0;0.5
Control.SRR15539832;42;38;0.476190476190476;22;20;0.0238095238095238;0.476190476190476
Control.SRR15539832;39;38;0.487179487179487;20;19;0.0128205128205128;0.487179487179487
Control.SRR15539832;39;38;0.512820512820513;19;20;0.0128205128205128;0.487179487179487
Control.SRR15539832;41;38;0.585365853658537;17;24;0.0853658536585366;0.414634146341463
Control.SRR15539832;37;38;0.459459459459459;20;17;0.0405405405405405;0.459459459459459
Control.SRR15539832;35;38;0.485714285714286;18;17;0.0142857142857143;0.485714285714286
Control.SRR15539832;42;38;0.523809523809524;20;22;0.0238095238095238;0.476190476190476
Control.SRR15539832;38;38;0.552631578947368;17;21;0.0526315789473685;0.447368421052632
Control.SRR15539832;37;38;0.486486486486487;19;18;0.0135135135135135;0.486486486486487
Control.SRR15539832;34;38;0.529411764705882;16;18;0.0294117647058824;0.470588235294118
Control.SRR15539832;41;38;0.51219512195122;20;21;0.0121951219512195;0.48780487804878
Control.SRR15539832;42;38;0.523809523809524;20;22;0.0238095238095238;0.476190476190476
Control.SRR15539832;35;38;0.714285714285714;10;25;0.214285714285714;0.285714285714286
Control.SRR15539832;38;38;0.5;19;19;0;0.5
Control.SRR15539832;44;38;0.522727272727273;21;23;0.0227272727272727;0.477272727272727
Control.SRR15539832;42;38;0.380952380952381;26;16;0.119047619047619;0.380952380952381
Control.SRR15539832;41;38;0.365853658536585;26;15;0.134146341463415;0.365853658536585
Control.SRR15539832;41;38;0.439024390243902;23;18;0.0609756097560976;0.439024390243902
Control.SRR15539832;35;38;0.571428571428571;15;20;0.0714285714285714;0.428571428571429
Control.SRR15539832;36;38;0.5;18;18;0;0.5
Control.SRR15539832;36;38;0.527777777777778;17;19;0.0277777777777778;0.472222222222222
Control.SRR15539832;40;38;0.45;22;18;0.05;0.45
Control.SRR15539832;41;38;0.560975609756098;18;23;0.0609756097560976;0.439024390243902
Control.SRR15539832;36;38;0.388888888888889;22;14;0.111111111111111;0.388888888888889
Control.SRR15539832;40;38;0.625;15;25;0.125;0.375
Control.SRR15539832;43;38;0.511627906976744;21;22;0.0116279069767442;0.488372093023256
Control.SRR15539832;42;38;0.476190476190476;22;20;0.0238095238095238;0.476190476190476
Control.SRR15539832;39;38;0.435897435897436;22;17;0.0641025641025641;0.435897435897436
Control.SRR15539832;42;38;0.428571428571429;24;18;0.0714285714285715;0.428571428571429
Control.SRR15539832;36;38;0.305555555555556;25;11;0.194444444444444;0.305555555555556
Control.SRR15539832;41;38;0.48780487804878;21;20;0.0121951219512195;0.48780487804878
Control.SRR15539832;43;38;0.488372093023256;22;21;0.0116279069767442;0.488372093023256
Control.SRR15539832;39;38;0.58974358974359;16;23;0.0897435897435898;0.41025641025641
Control.SRR15539832;41;38;0.536585365853659;19;22;0.0365853658536586;0.463414634146341
Control.SRR15539832;38;38;0.5;19;19;0;0.5
Control.SRR15539832;38;38;0.605263157894737;15;23;0.105263157894737;0.394736842105263
Control.SRR15539832;44;38;0.409090909090909;26;18;0.0909090909090909;0.409090909090909
Control.SRR15539832;37;38;0.594594594594595;15;22;0.0945945945945946;0.405405405405405
Control.SRR15539832;44;38;0.318181818181818;30;14;0.181818181818182;0.318181818181818
Control.SRR15539832;42;38;0.404761904761905;25;17;0.0952380952380952;0.404761904761905
Control.SRR15539832;39;38;0.564102564102564;17;22;0.0641025641025641;0.435897435897436
Control.SRR15539832;41;38;0.463414634146341;22;19;0.0365853658536585;0.463414634146341
Control.SRR15539832;38;38;0.421052631578947;22;16;0.0789473684210527;0.421052631578947
Control.SRR15539832;44;38;0.545454545454545;20;24;0.0454545454545454;0.454545454545455
Control.SRR15539832;42;38;0.452380952380952;23;19;0.0476190476190476;0.452380952380952
Control.SRR15539832;37;38;0.297297297297297;26;11;0.202702702702703;0.297297297297297
Control.SRR15539832;35;38;0.6;14;21;0.1;0.4
Control.SRR15539832;42;38;0.595238095238095;17;25;0.0952380952380952;0.404761904761905
Control.SRR15539832;38;38;0.473684210526316;20;18;0.0263157894736842;0.473684210526316
Control.SRR15539832;36;38;0.444444444444444;20;16;0.0555555555555556;0.444444444444444
Control.SRR15539832;40;38;0.5;20;20;0;0.5
Control.SRR15539832;37;38;0.513513513513513;18;19;0.0135135135135135;0.486486486486487
Control.SRR15539832;38;38;0.473684210526316;20;18;0.0263157894736842;0.473684210526316
Control.SRR15539832;43;38;0.441860465116279;24;19;0.0581395348837209;0.441860465116279
Control.SRR15539832;40;38;0.475;21;19;0.025;0.475
Control.SRR15539832;40;38;0.425;23;17;0.075;0.425
Control.SRR15539832;36;38;0.416666666666667;21;15;0.0833333333333333;0.416666666666667
Control.SRR15539832;36;38;0.388888888888889;22;14;0.111111111111111;0.388888888888889
Control.SRR15539832;41;38;0.48780487804878;21;20;0.0121951219512195;0.48780487804878
Control.SRR15539832;40;38;0.7;12;28;0.2;0.3
Control.SRR15539832;42;38;0.5;21;21;0;0.5
Control.SRR15539832;41;38;0.439024390243902;23;18;0.0609756097560976;0.439024390243902
Control.SRR15539832;44;38;0.477272727272727;23;21;0.0227272727272727;0.477272727272727
Control.SRR15539832;34;38;0.411764705882353;20;14;0.0882352941176471;0.411764705882353
Control.SRR15539832;41;38;0.51219512195122;20;21;0.0121951219512195;0.48780487804878
Control.SRR15539832;44;38;0.477272727272727;23;21;0.0227272727272727;0.477272727272727
Control.SRR15539832;39;38;0.435897435897436;22;17;0.0641025641025641;0.435897435897436
Control.SRR15539832;43;38;0.465116279069767;23;20;0.0348837209302326;0.465116279069767
Control.SRR15539832;37;38;0.351351351351351;24;13;0.148648648648649;0.351351351351351
Control.SRR15539832;35;38;0.4;21;14;0.1;0.4
Control.SRR15539832;37;38;0.513513513513513;18;19;0.0135135135135135;0.486486486486487
Control.SRR15539832;37;38;0.540540540540541;17;20;0.0405405405405406;0.459459459459459
Control.SRR15539832;35;38;0.571428571428571;15;20;0.0714285714285714;0.428571428571429
Control.SRR15539832;40;38;0.675;13;27;0.175;0.325
Control.SRR15539832;36;38;0.472222222222222;19;17;0.0277777777777778;0.472222222222222
Control.SRR15539832;39;38;0.461538461538462;21;18;0.0384615384615384;0.461538461538462
Control.SRR15539832;35;38;0.485714285714286;18;17;0.0142857142857143;0.485714285714286
Control.SRR15539832;37;38;0.486486486486487;19;18;0.0135135135135135;0.486486486486487
Control.SRR15539832;34;38;0.588235294117647;14;20;0.0882352941176471;0.411764705882353
Control.SRR15539832;40;38;0.45;22;18;0.05;0.45
Control.SRR15539832;42;38;0.523809523809524;20;22;0.0238095238095238;0.476190476190476
Control.SRR15539832;36;38;0.444444444444444;20;16;0.0555555555555556;0.444444444444444
Control.SRR15539832;41;38;0.390243902439024;25;16;0.109756097560976;0.390243902439024
Control.SRR15539832;43;38;0.558139534883721;19;24;0.0581395348837209;0.441860465116279
Control.SRR15539832;40;38;0.4;24;16;0.1;0.4
Control.SRR15539832;40;38;0.475;21;19;0.025;0.475
Control.SRR15539832;43;38;0.325581395348837;29;14;0.174418604651163;0.325581395348837
Control.SRR15539832;43;38;0.534883720930233;20;23;0.0348837209302325;0.465116279069767
Control.SRR15539832;43;38;0.488372093023256;22;21;0.0116279069767442;0.488372093023256
Control.SRR15539832;41;38;0.536585365853659;19;22;0.0365853658536586;0.463414634146341
Control.SRR15539832;39;38;0.461538461538462;21;18;0.0384615384615384;0.461538461538462
Control.SRR15539832;42;38;0.595238095238095;17;25;0.0952380952380952;0.404761904761905
Control.SRR15539832;43;38;0.441860465116279;24;19;0.0581395348837209;0.441860465116279
Control.SRR15539832;42;38;0.619047619047619;16;26;0.119047619047619;0.380952380952381
Control.SRR15539832;43;38;0.488372093023256;22;21;0.0116279069767442;0.488372093023256
Control.SRR15539832;43;38;0.558139534883721;19;24;0.0581395348837209;0.441860465116279
Control.SRR15539832;41;38;0.682926829268293;13;28;0.182926829268293;0.317073170731707
Control.SRR15539832;44;38;0.5;22;22;0;0.5
Control.SRR15539832;37;38;0.513513513513513;18;19;0.0135135135135135;0.486486486486487
Control.SRR15539832;34;38;0.441176470588235;19;15;0.0588235294117647;0.441176470588235
Control.SRR15539832;35;38;0.371428571428571;22;13;0.128571428571429;0.371428571428571
Control.SRR15539832;43;38;0.488372093023256;22;21;0.0116279069767442;0.488372093023256
Control.SRR15539832;43;38;0.488372093023256;22;21;0.0116279069767442;0.488372093023256
Control.SRR15539832;42;38;0.523809523809524;20;22;0.0238095238095238;0.476190476190476
Control.SRR15539832;44;38;0.613636363636364;17;27;0.113636363636364;0.386363636363636
Control.SRR15539832;39;38;0.538461538461538;18;21;0.0384615384615384;0.461538461538462
Control.SRR15539832;42;38;0.5;21;21;0;0.5
Control.SRR15539832;35;38;0.4;21;14;0.1;0.4
Control.SRR15539832;40;38;0.45;22;18;0.05;0.45
Control.SRR15539832;35;38;0.514285714285714;17;18;0.0142857142857142;0.485714285714286
Control.SRR15539832;44;38;0.431818181818182;25;19;0.0681818181818182;0.431818181818182
Control.SRR15539832;40;38;0.5;20;20;0;0.5
Control.SRR15539832;42;38;0.428571428571429;24;18;0.0714285714285715;0.428571428571429
Control.SRR15539832;44;38;0.431818181818182;25;19;0.0681818181818182;0.431818181818182
Control.SRR15539832;42;38;0.476190476190476;22;20;0.0238095238095238;0.476190476190476
Control.SRR15539832;38;38;0.5;19;19;0;0.5
Control.SRR15539832;44;38;0.477272727272727;23;21;0.0227272727272727;0.477272727272727
Control.SRR15539832;41;38;0.560975609756098;18;23;0.0609756097560976;0.439024390243902
Control.SRR15539832;42;38;0.452380952380952;23;19;0.0476190476190476;0.452380952380952
Control.SRR15539832;39;38;0.333333333333333;26;13;0.166666666666667;0.333333333333333
Control.SRR15539832;43;38;0.511627906976744;21;22;0.0116279069767442;0.488372093023256
Control.SRR15539832;44;38;0.409090909090909;26;18;0.0909090909090909;0.409090909090909
Control.SRR15539832;42;38;0.571428571428571;18;24;0.0714285714285714;0.428571428571429
Control.SRR15539832;36;38;0.611111111111111;14;22;0.111111111111111;0.388888888888889
Control.SRR15539832;37;38;0.513513513513513;18;19;0.0135135135135135;0.486486486486487
Control.SRR15539832;38;38;0.578947368421053;16;22;0.0789473684210527;0.421052631578947
Control.SRR15539832;34;38;0.411764705882353;20;14;0.0882352941176471;0.411764705882353
Control.SRR15539832;43;38;0.488372093023256;22;21;0.0116279069767442;0.488372093023256
Control.SRR15539832;40;38;0.575;17;23;0.075;0.425
Control.SRR15539832;38;38;0.473684210526316;20;18;0.0263157894736842;0.473684210526316
Control.SRR15539832;34;38;0.529411764705882;16;18;0.0294117647058824;0.470588235294118
Control.SRR15539832;44;38;0.522727272727273;21;23;0.0227272727272727;0.477272727272727
Control.SRR15539832;43;38;0.604651162790698;17;26;0.104651162790698;0.395348837209302
Control.SRR15539832;38;38;0.447368421052632;21;17;0.0526315789473684;0.447368421052632
Control.SRR15539832;34;38;0.588235294117647;14;20;0.0882352941176471;0.411764705882353
Control.SRR15539832;38;38;0.421052631578947;22;16;0.0789473684210527;0.421052631578947
Control.SRR15539832;43;38;0.534883720930233;20;23;0.0348837209302325;0.465116279069767
Control.SRR15539832;42;38;0.5;21;21;0;0.5
Control.SRR15539832;37;38;0.594594594594595;15;22;0.0945945945945946;0.405405405405405
Control.SRR15539832;41;38;0.48780487804878;21;20;0.0121951219512195;0.48780487804878
Control.SRR15539832;40;38;0.525;19;21;0.025;0.475
Control.SRR15539832;43;38;0.418604651162791;25;18;0.0813953488372093;0.418604651162791
Control.SRR15539832;37;38;0.486486486486487;19;18;0.0135135135135135;0.486486486486487
Control.SRR15539832;43;38;0.465116279069767;23;20;0.0348837209302326;0.465116279069767
Control.SRR15539832;34;38;0.617647058823529;13;21;0.117647058823529;0.382352941176471
Control.SRR15539832;40;38;0.525;19;21;0.025;0.475
Control.SRR15539832;37;38;0.351351351351351;24;13;0.148648648648649;0.351351351351351
Control.SRR15539832;37;38;0.513513513513513;18;19;0.0135135135135135;0.486486486486487
Control.SRR15539832;43;38;0.558139534883721;19;24;0.0581395348837209;0.441860465116279
Control.SRR15539832;40;38;0.525;19;21;0.025;0.475
Control.SRR15539832;36;38;0.555555555555556;16;20;0.0555555555555556;0.444444444444444
Control.SRR15539832;44;38;0.5;22;22;0;0.5
Control.SRR15539832;38;38;0.473684210526316;20;18;0.0263157894736842;0.473684210526316
Control.SRR15539832;38;38;0.421052631578947;22;16;0.0789473684210527;0.421052631578947
Control.SRR15539832;42;38;0.595238095238095;17;25;0.0952380952380952;0.404761904761905
Control.SRR15539832;44;38;0.5;22;22;0;0.5
Control.SRR15539832;34;38;0.470588235294118;18;16;0.0294117647058824;0.470588235294118
Control.SRR15539832;37;38;0.513513513513513;18;19;0.0135135135135135;0.486486486486487
Control.SRR15539832;41;38;0.439024390243902;23;18;0.0609756097560976;0.439024390243902
Control.SRR15539832;38;38;0.473684210526316;20;18;0.0263157894736842;0.473684210526316
Control.SRR15539832;37;38;0.648648648648649;13;24;0.148648648648649;0.351351351351351
Control.SRR15539832;37;38;0.378378378378378;23;14;0.121621621621622;0.378378378378378
Control.SRR15539832;38;38;0.684210526315789;12;26;0.184210526315789;0.315789473684211
Control.SRR15539832;42;38;0.404761904761905;25;17;0.0952380952380952;0.404761904761905
Control.SRR15539832;34;38;0.529411764705882;16;18;0.0294117647058824;0.470588235294118
Control.SRR15539832;35;38;0.542857142857143;16;19;0.0428571428571428;0.457142857142857
Control.SRR15539832;36;38;0.583333333333333;15;21;0.0833333333333334;0.416666666666667
Control.SRR15539832;38;38;0.473684210526316;20;18;0.0263157894736842;0.473684210526316
Control.SRR15539832;44;38;0.545454545454545;20;24;0.0454545454545454;0.454545454545455
Control.SRR15539832;42;38;0.476190476190476;22;20;0.0238095238095238;0.476190476190476
Control.SRR15539832;43;38;0.581395348837209;18;25;0.0813953488372093;0.418604651162791
Control.SRR15539832;35;38;0.485714285714286;18;17;0.0142857142857143;0.485714285714286
Control.SRR15539832;42;38;0.5;21;21;0;0.5
Control.SRR15539832;38;38;0.526315789473684;18;20;0.0263157894736842;0.473684210526316
Control.SRR15539832;41;38;0.48780487804878;21;20;0.0121951219512195;0.48780487804878
Control.SRR15539832;42;38;0.547619047619048;19;23;0.0476190476190477;0.452380952380952
Control.SRR15539832;40;38;0.525;19;21;0.025;0.475
Control.SRR15539832;36;38;0.583333333333333;15;21;0.0833333333333334;0.416666666666667
Control.SRR15539832;40;38;0.45;22;18;0.05;0.45
Control.SRR15539832;42;38;0.619047619047619;16;26;0.119047619047619;0.380952380952381
Control.SRR15539832;41;38;0.536585365853659;19;22;0.0365853658536586;0.463414634146341
Control.SRR15539832;40;38;0.475;21;19;0.025;0.475
Control.SRR15539832;42;38;0.571428571428571;18;24;0.0714285714285714;0.428571428571429
Control.SRR15539832;42;38;0.333333333333333;28;14;0.166666666666667;0.333333333333333
Control.SRR15539832;37;38;0.459459459459459;20;17;0.0405405405405405;0.459459459459459
Control.SRR15539832;41;38;0.414634146341463;24;17;0.0853658536585366;0.414634146341463
Control.SRR15539832;37;38;0.513513513513513;18;19;0.0135135135135135;0.486486486486487
Control.SRR15539832;41;38;0.536585365853659;19;22;0.0365853658536586;0.463414634146341
Control.SRR15539832;40;38;0.5;20;20;0;0.5
Control.SRR15539832;37;38;0.405405405405405;22;15;0.0945945945945946;0.405405405405405
Control.SRR15539832;37;38;0.486486486486487;19;18;0.0135135135135135;0.486486486486487
Control.SRR15539832;41;38;0.48780487804878;21;20;0.0121951219512195;0.48780487804878
Control.SRR15539832;43;38;0.441860465116279;24;19;0.0581395348837209;0.441860465116279
Control.SRR15539832;38;38;0.5;19;19;0;0.5
Control.SRR15539832;36;38;0.527777777777778;17;19;0.0277777777777778;0.472222222222222
Control.SRR15539832;41;38;0.536585365853659;19;22;0.0365853658536586;0.463414634146341
Control.SRR15539832;44;38;0.681818181818182;14;30;0.181818181818182;0.318181818181818
Control.SRR15539832;42;38;0.476190476190476;22;20;0.0238095238095238;0.476190476190476
Control.SRR15539832;44;38;0.454545454545455;24;20;0.0454545454545455;0.454545454545455
Control.SRR15539832;44;38;0.5;22;22;0;0.5
Control.SRR15539832;39;38;0.666666666666667;13;26;0.166666666666667;0.333333333333333
Control.SRR15539832;41;38;0.414634146341463;24;17;0.0853658536585366;0.414634146341463
Control.SRR15539832;40;38;0.625;15;25;0.125;0.375
Control.SRR15539832;41;38;0.341463414634146;27;14;0.158536585365854;0.341463414634146
Control.SRR15539832;36;38;0.5;18;18;0;0.5
Control.SRR15539832;44;38;0.5;22;22;0;0.5
Control.SRR15539832;37;38;0.486486486486487;19;18;0.0135135135135135;0.486486486486487
Control.SRR15539832;40;38;0.575;17;23;0.075;0.425
Control.SRR15539832;44;38;0.568181818181818;19;25;0.0681818181818182;0.431818181818182
Control.SRR15539832;34;38;0.529411764705882;16;18;0.0294117647058824;0.470588235294118
Control.SRR15539832;40;38;0.6;16;24;0.1;0.4
Control.SRR15539832;44;38;0.340909090909091;29;15;0.159090909090909;0.340909090909091
Control.SRR15539832;34;38;0.470588235294118;18;16;0.0294117647058824;0.470588235294118
Control.SRR15539832;43;38;0.348837209302326;28;15;0.151162790697674;0.348837209302326
Control.SRR15539832;40;38;0.475;21;19;0.025;0.475
Control.SRR15539832;37;38;0.621621621621622;14;23;0.121621621621622;0.378378378378378
Control.SRR15539832;39;38;0.435897435897436;22;17;0.0641025641025641;0.435897435897436
Control.SRR15539832;44;38;0.522727272727273;21;23;0.0227272727272727;0.477272727272727
Control.SRR15539832;44;38;0.590909090909091;18;26;0.0909090909090909;0.409090909090909
Control.SRR15539832;39;38;0.461538461538462;21;18;0.0384615384615384;0.461538461538462
Control.SRR15539832;41;38;0.48780487804878;21;20;0.0121951219512195;0.48780487804878
Control.SRR15539832;42;38;0.452380952380952;23;19;0.0476190476190476;0.452380952380952
Control.SRR15539832;36;38;0.472222222222222;19;17;0.0277777777777778;0.472222222222222
Control.SRR15539832;34;38;0.470588235294118;18;16;0.0294117647058824;0.470588235294118
Control.SRR15539832;38;38;0.5;19;19;0;0.5
Control.SRR15539832;39;38;0.461538461538462;21;18;0.0384615384615384;0.461538461538462
Control.SRR15539832;44;38;0.545454545454545;20;24;0.0454545454545454;0.454545454545455
Control.SRR15539832;39;38;0.487179487179487;20;19;0.0128205128205128;0.487179487179487
Control.SRR15539832;42;38;0.357142857142857;27;15;0.142857142857143;0.357142857142857
Control.SRR15539832;39;38;0.538461538461538;18;21;0.0384615384615384;0.461538461538462
Control.SRR15539832;35;38;0.657142857142857;12;23;0.157142857142857;0.342857142857143
Control.SRR15539832;40;38;0.4;24;16;0.1;0.4
Control.SRR15539832;34;38;0.588235294117647;14;20;0.0882352941176471;0.411764705882353
Control.SRR15539832;43;38;0.558139534883721;19;24;0.0581395348837209;0.441860465116279
Control.SRR15539832;40;38;0.425;23;17;0.075;0.425
Control.SRR15539832;41;38;0.390243902439024;25;16;0.109756097560976;0.390243902439024
Control.SRR15539832;39;38;0.58974358974359;16;23;0.0897435897435898;0.41025641025641
Control.SRR15539832;41;38;0.48780487804878;21;20;0.0121951219512195;0.48780487804878
Control.SRR15539832;43;38;0.488372093023256;22;21;0.0116279069767442;0.488372093023256
Control.SRR15539832;39;38;0.487179487179487;20;19;0.0128205128205128;0.487179487179487
Control.SRR15539832;40;38;0.375;25;15;0.125;0.375
Control.SRR15539832;41;38;0.439024390243902;23;18;0.0609756097560976;0.439024390243902
Control.SRR15539832;44;38;0.5;22;22;0;0.5
Control.SRR15539832;38;38;0.552631578947368;17;21;0.0526315789473685;0.447368421052632
Control.SRR15539832;35;38;0.542857142857143;16;19;0.0428571428571428;0.457142857142857
Control.SRR15539832;44;38;0.363636363636364;28;16;0.136363636363636;0.363636363636364
Control.SRR15539832;34;38;0.529411764705882;16;18;0.0294117647058824;0.470588235294118
Control.SRR15539832;42;38;0.428571428571429;24;18;0.0714285714285715;0.428571428571429
Control.SRR15539832;38;38;0.394736842105263;23;15;0.105263157894737;0.394736842105263
Control.SRR15539832;40;38;0.425;23;17;0.075;0.425
Control.SRR15539832;42;38;0.547619047619048;19;23;0.0476190476190477;0.452380952380952
Control.SRR15539832;42;38;0.476190476190476;22;20;0.0238095238095238;0.476190476190476
Control.SRR15539832;42;38;0.5;21;21;0;0.5
Control.SRR15539832;34;38;0.529411764705882;16;18;0.0294117647058824;0.470588235294118
Control.SRR15539832;38;38;0.473684210526316;20;18;0.0263157894736842;0.473684210526316
Control.SRR15539832;43;38;0.418604651162791;25;18;0.0813953488372093;0.418604651162791
Control.SRR15539832;41;38;0.414634146341463;24;17;0.0853658536585366;0.414634146341463
Control.SRR15539832;35;38;0.514285714285714;17;18;0.0142857142857142;0.485714285714286
Control.SRR15539832;39;38;0.358974358974359;25;14;0.141025641025641;0.358974358974359
Control.SRR15539832;44;38;0.477272727272727;23;21;0.0227272727272727;0.477272727272727
Control.SRR15539832;42;38;0.547619047619048;19;23;0.0476190476190477;0.452380952380952
Control.SRR15539832;40;38;0.475;21;19;0.025;0.475
Control.SRR15539832;44;38;0.477272727272727;23;21;0.0227272727272727;0.477272727272727
Control.SRR15539832;43;38;0.488372093023256;22;21;0.0116279069767442;0.488372093023256
Control.SRR15539832;42;38;0.428571428571429;24;18;0.0714285714285715;0.428571428571429
Control.SRR15539832;37;38;0.540540540540541;17;20;0.0405405405405406;0.459459459459459
Control.SRR15539832;34;38;0.470588235294118;18;16;0.0294117647058824;0.470588235294118
Control.SRR15539832;44;38;0.5;22;22;0;0.5
Control.SRR15539832;36;38;0.638888888888889;13;23;0.138888888888889;0.361111111111111
Control.SRR15539832;35;38;0.457142857142857;19;16;0.0428571428571429;0.457142857142857
Control.SRR15539832;44;38;0.454545454545455;24;20;0.0454545454545455;0.454545454545455
Control.SRR15539832;39;38;0.512820512820513;19;20;0.0128205128205128;0.487179487179487
Control.SRR15539832;36;38;0.5;18;18;0;0.5
Control.SRR15539832;44;38;0.454545454545455;24;20;0.0454545454545455;0.454545454545455
Control.SRR15539832;36;38;0.527777777777778;17;19;0.0277777777777778;0.472222222222222
Control.SRR15539832;39;38;0.641025641025641;14;25;0.141025641025641;0.358974358974359
Control.SRR15539832;40;38;0.5;20;20;0;0.5
Control.SRR15539832;42;38;0.642857142857143;15;27;0.142857142857143;0.357142857142857
Control.SRR15539832;41;38;0.536585365853659;19;22;0.0365853658536586;0.463414634146341
Control.SRR15539832;42;38;0.714285714285714;12;30;0.214285714285714;0.285714285714286
Control.SRR15539832;43;38;0.441860465116279;24;19;0.0581395348837209;0.441860465116279
Control.SRR15539832;43;38;0.441860465116279;24;19;0.0581395348837209;0.441860465116279
Control.SRR15539832;36;38;0.694444444444444;11;25;0.194444444444444;0.305555555555556
Control.SRR15539832;43;38;0.395348837209302;26;17;0.104651162790698;0.395348837209302
Control.SRR15539832;42;38;0.452380952380952;23;19;0.0476190476190476;0.452380952380952
Control.SRR15539832;39;38;0.666666666666667;13;26;0.166666666666667;0.333333333333333
Control.SRR15539832;40;38;0.425;23;17;0.075;0.425
Control.SRR15539832;44;38;0.590909090909091;18;26;0.0909090909090909;0.409090909090909
Control.SRR15539832;40;38;0.4;24;16;0.1;0.4
Control.SRR15539832;43;38;0.348837209302326;28;15;0.151162790697674;0.348837209302326
Control.SRR15539832;40;38;0.375;25;15;0.125;0.375
Control.SRR15539832;34;38;0.558823529411765;15;19;0.0588235294117647;0.441176470588235
Control.SRR15539832;40;38;0.625;15;25;0.125;0.375
Control.SRR15539832;41;38;0.585365853658537;17;24;0.0853658536585366;0.414634146341463
Control.SRR15539832;42;38;0.547619047619048;19;23;0.0476190476190477;0.452380952380952
Control.SRR15539832;41;38;0.317073170731707;28;13;0.182926829268293;0.317073170731707
Control.SRR15539832;39;38;0.461538461538462;21;18;0.0384615384615384;0.461538461538462
Control.SRR15539832;44;38;0.477272727272727;23;21;0.0227272727272727;0.477272727272727
Control.SRR15539832;44;38;0.568181818181818;19;25;0.0681818181818182;0.431818181818182
Control.SRR15539832;43;38;0.348837209302326;28;15;0.151162790697674;0.348837209302326
Control.SRR15539832;37;38;0.459459459459459;20;17;0.0405405405405405;0.459459459459459
Control.SRR15539832;44;38;0.590909090909091;18;26;0.0909090909090909;0.409090909090909
Control.SRR15539832;40;38;0.5;20;20;0;0.5
Control.SRR15539832;36;38;0.527777777777778;17;19;0.0277777777777778;0.472222222222222
Control.SRR15539832;40;38;0.625;15;25;0.125;0.375
Control.SRR15539832;40;38;0.525;19;21;0.025;0.475
Control.SRR15539832;42;38;0.571428571428571;18;24;0.0714285714285714;0.428571428571429
Control.SRR15539832;43;38;0.488372093023256;22;21;0.0116279069767442;0.488372093023256
Control.SRR15539832;36;38;0.527777777777778;17;19;0.0277777777777778;0.472222222222222
Control.SRR15539832;43;38;0.604651162790698;17;26;0.104651162790698;0.395348837209302
Control.SRR15539832;34;38;0.470588235294118;18;16;0.0294117647058824;0.470588235294118
Control.SRR15539832;38;38;0.473684210526316;20;18;0.0263157894736842;0.473684210526316
Control.SRR15539832;38;38;0.447368421052632;21;17;0.0526315789473684;0.447368421052632
Control.SRR15539832;38;38;0.552631578947368;17;21;0.0526315789473685;0.447368421052632
Control.SRR15539832;38;38;0.578947368421053;16;22;0.0789473684210527;0.421052631578947
Control.SRR15539832;38;38;0.552631578947368;17;21;0.0526315789473685;0.447368421052632
Control.SRR15539832;36;38;0.638888888888889;13;23;0.138888888888889;0.361111111111111
Control.SRR15539832;42;38;0.428571428571429;24;18;0.0714285714285715;0.428571428571429
Control.SRR15539832;34;38;0.352941176470588;22;12;0.147058823529412;0.352941176470588
Control.SRR15539832;40;38;0.575;17;23;0.075;0.425
Control.SRR15539832;36;38;0.611111111111111;14;22;0.111111111111111;0.388888888888889
Control.SRR15539832;41;38;0.585365853658537;17;24;0.0853658536585366;0.414634146341463
Control.SRR15539832;37;38;0.459459459459459;20;17;0.0405405405405405;0.459459459459459
Control.SRR15539832;40;38;0.55;18;22;0.05;0.45
Control.SRR15539832;42;38;0.5;21;21;0;0.5
Control.SRR15539832;42;38;0.380952380952381;26;16;0.119047619047619;0.380952380952381
Control.SRR15539832;40;38;0.55;18;22;0.05;0.45
Control.SRR15539832;38;38;0.526315789473684;18;20;0.0263157894736842;0.473684210526316
Control.SRR15539832;43;38;0.488372093023256;22;21;0.0116279069767442;0.488372093023256
Control.SRR15539832;42;38;0.5;21;21;0;0.5
Control.SRR15539832;43;38;0.534883720930233;20;23;0.0348837209302325;0.465116279069767
Control.SRR15539832;41;38;0.634146341463415;15;26;0.134146341463415;0.365853658536585
Control.SRR15539832;37;38;0.459459459459459;20;17;0.0405405405405405;0.459459459459459
Control.SRR15539832;34;38;0.676470588235294;11;23;0.176470588235294;0.323529411764706
Control.SRR15539832;37;38;0.513513513513513;18;19;0.0135135135135135;0.486486486486487
Control.SRR15539832;34;38;0.441176470588235;19;15;0.0588235294117647;0.441176470588235
Control.SRR15539832;41;38;0.48780487804878;21;20;0.0121951219512195;0.48780487804878
Control.SRR15539832;41;38;0.48780487804878;21;20;0.0121951219512195;0.48780487804878
Control.SRR15539832;41;38;0.609756097560976;16;25;0.109756097560976;0.390243902439024
Control.SRR15539832;38;38;0.5;19;19;0;0.5
Control.SRR15539832;44;38;0.704545454545455;13;31;0.204545454545455;0.295454545454545
Control.SRR15539832;37;38;0.459459459459459;20;17;0.0405405405405405;0.459459459459459
Control.SRR15539832;36;38;0.527777777777778;17;19;0.0277777777777778;0.472222222222222
Control.SRR15539832;42;38;0.571428571428571;18;24;0.0714285714285714;0.428571428571429
Control.SRR15539832;40;38;0.55;18;22;0.05;0.45
Control.SRR15539832;34;38;0.617647058823529;13;21;0.117647058823529;0.382352941176471
Control.SRR15539832;42;38;0.5;21;21;0;0.5
Control.SRR15539832;41;38;0.560975609756098;18;23;0.0609756097560976;0.439024390243902
Control.SRR15539832;43;38;0.465116279069767;23;20;0.0348837209302326;0.465116279069767
Control.SRR15539832;43;38;0.395348837209302;26;17;0.104651162790698;0.395348837209302
Control.SRR15539832;40;38;0.525;19;21;0.025;0.475
Control.SRR15539832;44;38;0.454545454545455;24;20;0.0454545454545455;0.454545454545455
Control.SRR15539832;37;38;0.27027027027027;27;10;0.22972972972973;0.27027027027027
Control.SRR15539832;44;38;0.363636363636364;28;16;0.136363636363636;0.363636363636364
Control.SRR15539832;41;38;0.439024390243902;23;18;0.0609756097560976;0.439024390243902
Control.SRR15539832;36;38;0.472222222222222;19;17;0.0277777777777778;0.472222222222222
Control.SRR15539832;36;38;0.666666666666667;12;24;0.166666666666667;0.333333333333333
Control.SRR15539832;37;38;0.594594594594595;15;22;0.0945945945945946;0.405405405405405
Control.SRR15539832;41;38;0.414634146341463;24;17;0.0853658536585366;0.414634146341463
Control.SRR15539832;42;38;0.595238095238095;17;25;0.0952380952380952;0.404761904761905
Control.SRR15539832;41;38;0.560975609756098;18;23;0.0609756097560976;0.439024390243902
Control.SRR15539832;38;38;0.605263157894737;15;23;0.105263157894737;0.394736842105263
Control.SRR15539832;40;38;0.575;17;23;0.075;0.425
Control.SRR15539832;34;38;0.382352941176471;21;13;0.117647058823529;0.382352941176471
Control.SRR15539832;43;38;0.488372093023256;22;21;0.0116279069767442;0.488372093023256
Control.SRR15539832;40;38;0.525;19;21;0.025;0.475
Control.SRR15539832;35;38;0.485714285714286;18;17;0.0142857142857143;0.485714285714286
Control.SRR15539832;43;38;0.465116279069767;23;20;0.0348837209302326;0.465116279069767
Control.SRR15539832;44;38;0.636363636363636;16;28;0.136363636363636;0.363636363636364
Control.SRR15539832;41;38;0.463414634146341;22;19;0.0365853658536585;0.463414634146341
Control.SRR15539832;42;38;0.619047619047619;16;26;0.119047619047619;0.380952380952381
Control.SRR15539832;38;38;0.394736842105263;23;15;0.105263157894737;0.394736842105263
Control.SRR15539832;43;38;0.465116279069767;23;20;0.0348837209302326;0.465116279069767
Control.SRR15539832;39;38;0.358974358974359;25;14;0.141025641025641;0.358974358974359
Control.SRR15539832;42;38;0.595238095238095;17;25;0.0952380952380952;0.404761904761905
Control.SRR15539832;41;38;0.414634146341463;24;17;0.0853658536585366;0.414634146341463
Control.SRR15539832;36;38;0.555555555555556;16;20;0.0555555555555556;0.444444444444444
Control.SRR15539832;34;38;0.411764705882353;20;14;0.0882352941176471;0.411764705882353
Control.SRR15539832;38;38;0.421052631578947;22;16;0.0789473684210527;0.421052631578947
Control.SRR15539832;37;38;0.405405405405405;22;15;0.0945945945945946;0.405405405405405
Control.SRR15539832;36;38;0.5;18;18;0;0.5
Control.SRR15539832;41;38;0.585365853658537;17;24;0.0853658536585366;0.414634146341463
Control.SRR15539832;39;38;0.487179487179487;20;19;0.0128205128205128;0.487179487179487
Control.SRR15539832;41;38;0.658536585365854;14;27;0.158536585365854;0.341463414634146
Control.SRR15539832;44;38;0.545454545454545;20;24;0.0454545454545454;0.454545454545455
Control.SRR15539832;38;38;0.578947368421053;16;22;0.0789473684210527;0.421052631578947
Control.SRR15539832;44;38;0.545454545454545;20;24;0.0454545454545454;0.454545454545455
Control.SRR15539832;39;38;0.512820512820513;19;20;0.0128205128205128;0.487179487179487
Control.SRR15539832;42;38;0.476190476190476;22;20;0.0238095238095238;0.476190476190476
Control.SRR15539832;43;38;0.581395348837209;18;25;0.0813953488372093;0.418604651162791
Control.SRR15539832;41;38;0.48780487804878;21;20;0.0121951219512195;0.48780487804878
Control.SRR15539832;34;38;0.529411764705882;16;18;0.0294117647058824;0.470588235294118
Control.SRR15539832;35;38;0.742857142857143;9;26;0.242857142857143;0.257142857142857
Control.SRR15539832;35;38;0.342857142857143;23;12;0.157142857142857;0.342857142857143
Control.SRR15539832;43;38;0.488372093023256;22;21;0.0116279069767442;0.488372093023256
Control.SRR15539832;39;38;0.384615384615385;24;15;0.115384615384615;0.384615384615385
Control.SRR15539832;38;38;0.631578947368421;14;24;0.131578947368421;0.368421052631579
Control.SRR15539832;37;38;0.324324324324324;25;12;0.175675675675676;0.324324324324324
Control.SRR15539832;42;38;0.476190476190476;22;20;0.0238095238095238;0.476190476190476
Control.SRR15539832;40;38;0.475;21;19;0.025;0.475
Control.SRR15539832;43;38;0.558139534883721;19;24;0.0581395348837209;0.441860465116279
Control.SRR15539832;44;38;0.590909090909091;18;26;0.0909090909090909;0.409090909090909
Control.SRR15539832;41;38;0.536585365853659;19;22;0.0365853658536586;0.463414634146341
Control.SRR15539832;40;38;0.475;21;19;0.025;0.475
Control.SRR15539832;35;38;0.485714285714286;18;17;0.0142857142857143;0.485714285714286
Control.SRR15539832;39;38;0.487179487179487;20;19;0.0128205128205128;0.487179487179487
Control.SRR15539832;42;38;0.523809523809524;20;22;0.0238095238095238;0.476190476190476
Control.SRR15539832;39;38;0.692307692307692;12;27;0.192307692307692;0.307692307692308
Control.SRR15539832;37;38;0.567567567567568;16;21;0.0675675675675675;0.432432432432432
Control.SRR15539832;41;38;0.585365853658537;17;24;0.0853658536585366;0.414634146341463
Control.SRR15539832;42;38;0.619047619047619;16;26;0.119047619047619;0.380952380952381
Control.SRR15539832;38;38;0.657894736842105;13;25;0.157894736842105;0.342105263157895
Control.SRR15539832;34;38;0.617647058823529;13;21;0.117647058823529;0.382352941176471
Control.SRR15539832;34;38;0.382352941176471;21;13;0.117647058823529;0.382352941176471
Control.SRR15539832;41;38;0.439024390243902;23;18;0.0609756097560976;0.439024390243902
Control.SRR15539832;42;38;0.547619047619048;19;23;0.0476190476190477;0.452380952380952
Control.SRR15539832;43;38;0.558139534883721;19;24;0.0581395348837209;0.441860465116279
Control.SRR15539832;36;38;0.555555555555556;16;20;0.0555555555555556;0.444444444444444
Control.SRR15539832;36;38;0.333333333333333;24;12;0.166666666666667;0.333333333333333
Control.SRR15539832;44;38;0.5;22;22;0;0.5
Control.SRR15539832;39;38;0.435897435897436;22;17;0.0641025641025641;0.435897435897436
Control.SRR15539832;44;38;0.454545454545455;24;20;0.0454545454545455;0.454545454545455
Control.SRR15539832;44;38;0.431818181818182;25;19;0.0681818181818182;0.431818181818182
Control.SRR15539832;39;38;0.512820512820513;19;20;0.0128205128205128;0.487179487179487
Control.SRR15539832;42;38;0.452380952380952;23;19;0.0476190476190476;0.452380952380952
Control.SRR15539832;37;38;0.486486486486487;19;18;0.0135135135135135;0.486486486486487
Control.SRR15539832;41;38;0.682926829268293;13;28;0.182926829268293;0.317073170731707
Control.SRR15539832;41;38;0.585365853658537;17;24;0.0853658536585366;0.414634146341463
Control.SRR15539832;42;38;0.476190476190476;22;20;0.0238095238095238;0.476190476190476
Control.SRR15539832;43;38;0.534883720930233;20;23;0.0348837209302325;0.465116279069767
Control.SRR15539832;41;38;0.48780487804878;21;20;0.0121951219512195;0.48780487804878
Control.SRR15539832;37;38;0.540540540540541;17;20;0.0405405405405406;0.459459459459459
Control.SRR15539832;43;38;0.488372093023256;22;21;0.0116279069767442;0.488372093023256
Control.SRR15539832;40;38;0.55;18;22;0.05;0.45
Control.SRR15539832;38;38;0.526315789473684;18;20;0.0263157894736842;0.473684210526316
Control.SRR15539832;42;38;0.571428571428571;18;24;0.0714285714285714;0.428571428571429
Control.SRR15539832;38;38;0.605263157894737;15;23;0.105263157894737;0.394736842105263
Control.SRR15539832;35;38;0.628571428571429;13;22;0.128571428571429;0.371428571428571
Control.SRR15539832;42;38;0.5;21;21;0;0.5
Control.SRR15539832;39;38;0.564102564102564;17;22;0.0641025641025641;0.435897435897436
Control.SRR15539832;42;38;0.476190476190476;22;20;0.0238095238095238;0.476190476190476
Control.SRR15539832;41;38;0.51219512195122;20;21;0.0121951219512195;0.48780487804878
Control.SRR15539832;34;38;0.529411764705882;16;18;0.0294117647058824;0.470588235294118
Control.SRR15539832;39;38;0.461538461538462;21;18;0.0384615384615384;0.461538461538462
Control.SRR15539832;41;38;0.585365853658537;17;24;0.0853658536585366;0.414634146341463
Control.SRR15539832;38;38;0.5;19;19;0;0.5
Control.SRR15539832;39;38;0.487179487179487;20;19;0.0128205128205128;0.487179487179487
Control.SRR15539832;35;38;0.542857142857143;16;19;0.0428571428571428;0.457142857142857
Control.SRR15539832;39;38;0.487179487179487;20;19;0.0128205128205128;0.487179487179487
Control.SRR15539832;36;38;0.5;18;18;0;0.5
Control.SRR15539832;35;38;0.485714285714286;18;17;0.0142857142857143;0.485714285714286
Control.SRR15539832;35;38;0.485714285714286;18;17;0.0142857142857143;0.485714285714286
Control.SRR15539832;39;38;0.461538461538462;21;18;0.0384615384615384;0.461538461538462
Control.SRR15539832;39;38;0.435897435897436;22;17;0.0641025641025641;0.435897435897436
Control.SRR15539832;43;38;0.511627906976744;21;22;0.0116279069767442;0.488372093023256
Control.SRR15539832;43;38;0.441860465116279;24;19;0.0581395348837209;0.441860465116279
Control.SRR15539832;41;38;0.51219512195122;20;21;0.0121951219512195;0.48780487804878
Control.SRR15539832;39;38;0.512820512820513;19;20;0.0128205128205128;0.487179487179487
Control.SRR15539832;41;38;0.414634146341463;24;17;0.0853658536585366;0.414634146341463
Control.SRR15539832;43;38;0.348837209302326;28;15;0.151162790697674;0.348837209302326
Control.SRR15539832;37;38;0.486486486486487;19;18;0.0135135135135135;0.486486486486487
Control.SRR15539832;43;38;0.395348837209302;26;17;0.104651162790698;0.395348837209302
Control.SRR15539832;37;38;0.297297297297297;26;11;0.202702702702703;0.297297297297297
Control.SRR15539832;35;38;0.542857142857143;16;19;0.0428571428571428;0.457142857142857
Control.SRR15539832;34;38;0.382352941176471;21;13;0.117647058823529;0.382352941176471
Control.SRR15539832;41;38;0.439024390243902;23;18;0.0609756097560976;0.439024390243902
Control.SRR15539832;42;38;0.523809523809524;20;22;0.0238095238095238;0.476190476190476
Control.SRR15539832;40;38;0.55;18;22;0.05;0.45
Control.SRR15539832;40;38;0.575;17;23;0.075;0.425
Control.SRR15539832;41;38;0.439024390243902;23;18;0.0609756097560976;0.439024390243902
Control.SRR15539832;36;38;0.472222222222222;19;17;0.0277777777777778;0.472222222222222
Control.SRR15539832;34;38;0.411764705882353;20;14;0.0882352941176471;0.411764705882353
Control.SRR15539832;37;38;0.513513513513513;18;19;0.0135135135135135;0.486486486486487
Control.SRR15539832;34;38;0.470588235294118;18;16;0.0294117647058824;0.470588235294118
Control.SRR15539832;43;38;0.511627906976744;21;22;0.0116279069767442;0.488372093023256
Control.SRR15539832;43;38;0.465116279069767;23;20;0.0348837209302326;0.465116279069767
Control.SRR15539832;41;38;0.463414634146341;22;19;0.0365853658536585;0.463414634146341
Control.SRR15539832;41;38;0.463414634146341;22;19;0.0365853658536585;0.463414634146341
Control.SRR15539832;39;38;0.435897435897436;22;17;0.0641025641025641;0.435897435897436
Control.SRR15539832;40;38;0.425;23;17;0.075;0.425
Control.SRR15539832;38;38;0.473684210526316;20;18;0.0263157894736842;0.473684210526316
Control.SRR15539832;44;38;0.522727272727273;21;23;0.0227272727272727;0.477272727272727
Control.SRR15539832;42;38;0.547619047619048;19;23;0.0476190476190477;0.452380952380952
Control.SRR15539832;44;38;0.454545454545455;24;20;0.0454545454545455;0.454545454545455
Control.SRR15539832;40;38;0.35;26;14;0.15;0.35
Control.SRR15539832;42;38;0.476190476190476;22;20;0.0238095238095238;0.476190476190476
Control.SRR15539832;39;38;0.564102564102564;17;22;0.0641025641025641;0.435897435897436
Control.SRR15539832;38;38;0.421052631578947;22;16;0.0789473684210527;0.421052631578947
Control.SRR15539832;43;38;0.511627906976744;21;22;0.0116279069767442;0.488372093023256
Control.SRR15539832;39;38;0.487179487179487;20;19;0.0128205128205128;0.487179487179487
Control.SRR15539832;38;38;0.447368421052632;21;17;0.0526315789473684;0.447368421052632
Control.SRR15539832;39;38;0.615384615384615;15;24;0.115384615384615;0.384615384615385
Control.SRR15539832;41;38;0.463414634146341;22;19;0.0365853658536585;0.463414634146341
Control.SRR15539832;43;38;0.511627906976744;21;22;0.0116279069767442;0.488372093023256
Control.SRR15539832;40;38;0.525;19;21;0.025;0.475
Control.SRR15539832;39;38;0.333333333333333;26;13;0.166666666666667;0.333333333333333
Control.SRR15539832;44;38;0.5;22;22;0;0.5
Control.SRR15539832;35;38;0.6;14;21;0.1;0.4
Control.SRR15539832;34;38;0.558823529411765;15;19;0.0588235294117647;0.441176470588235
Control.SRR15539832;41;38;0.609756097560976;16;25;0.109756097560976;0.390243902439024
Control.SRR15539832;38;38;0.473684210526316;20;18;0.0263157894736842;0.473684210526316
Control.SRR15539832;39;38;0.564102564102564;17;22;0.0641025641025641;0.435897435897436
Control.SRR15539832;37;38;0.486486486486487;19;18;0.0135135135135135;0.486486486486487
Control.SRR15539832;41;38;0.390243902439024;25;16;0.109756097560976;0.390243902439024
Control.SRR15539832;36;38;0.666666666666667;12;24;0.166666666666667;0.333333333333333
Control.SRR15539832;38;38;0.552631578947368;17;21;0.0526315789473685;0.447368421052632
Control.SRR15539832;43;38;0.348837209302326;28;15;0.151162790697674;0.348837209302326
Control.SRR15539832;44;38;0.613636363636364;17;27;0.113636363636364;0.386363636363636
Control.SRR15539832;43;38;0.348837209302326;28;15;0.151162790697674;0.348837209302326
Control.SRR15539832;42;38;0.523809523809524;20;22;0.0238095238095238;0.476190476190476
Control.SRR15539832;35;38;0.457142857142857;19;16;0.0428571428571429;0.457142857142857
Control.SRR15539832;38;38;0.473684210526316;20;18;0.0263157894736842;0.473684210526316
Control.SRR15539832;40;38;0.575;17;23;0.075;0.425
Control.SRR15539832;44;38;0.545454545454545;20;24;0.0454545454545454;0.454545454545455
Control.SRR15539832;37;38;0.459459459459459;20;17;0.0405405405405405;0.459459459459459
Control.SRR15539832;37;38;0.486486486486487;19;18;0.0135135135135135;0.486486486486487
Control.SRR15539832;36;38;0.583333333333333;15;21;0.0833333333333334;0.416666666666667
Control.SRR15539832;38;38;0.5;19;19;0;0.5
Control.SRR15539832;39;38;0.538461538461538;18;21;0.0384615384615384;0.461538461538462
Control.SRR15539832;43;38;0.372093023255814;27;16;0.127906976744186;0.372093023255814
Control.SRR15539832;34;38;0.411764705882353;20;14;0.0882352941176471;0.411764705882353
Control.SRR15539832;36;38;0.388888888888889;22;14;0.111111111111111;0.388888888888889
Control.SRR15539832;43;38;0.511627906976744;21;22;0.0116279069767442;0.488372093023256
Control.SRR15539832;42;38;0.476190476190476;22;20;0.0238095238095238;0.476190476190476
Control.SRR15539832;36;38;0.444444444444444;20;16;0.0555555555555556;0.444444444444444
Control.SRR15539832;42;38;0.380952380952381;26;16;0.119047619047619;0.380952380952381
Control.SRR15539832;38;38;0.473684210526316;20;18;0.0263157894736842;0.473684210526316
Control.SRR15539832;36;38;0.444444444444444;20;16;0.0555555555555556;0.444444444444444
Control.SRR15539832;34;38;0.529411764705882;16;18;0.0294117647058824;0.470588235294118
Control.SRR15539832;37;38;0.459459459459459;20;17;0.0405405405405405;0.459459459459459
Control.SRR15539832;40;38;0.5;20;20;0;0.5
Control.SRR15539832;40;38;0.575;17;23;0.075;0.425
Control.SRR15539832;38;38;0.421052631578947;22;16;0.0789473684210527;0.421052631578947
Control.SRR15539832;39;38;0.512820512820513;19;20;0.0128205128205128;0.487179487179487
Control.SRR15539832;42;38;0.642857142857143;15;27;0.142857142857143;0.357142857142857
Control.SRR15539832;37;38;0.594594594594595;15;22;0.0945945945945946;0.405405405405405
Control.SRR15539832;42;38;0.452380952380952;23;19;0.0476190476190476;0.452380952380952
Control.SRR15539832;42;38;0.333333333333333;28;14;0.166666666666667;0.333333333333333
Control.SRR15539832;37;38;0.432432432432432;21;16;0.0675675675675675;0.432432432432432
Control.SRR15539832;42;38;0.5;21;21;0;0.5
Control.SRR15539832;40;38;0.45;22;18;0.05;0.45
Control.SRR15539832;36;38;0.611111111111111;14;22;0.111111111111111;0.388888888888889
Control.SRR15539832;36;38;0.611111111111111;14;22;0.111111111111111;0.388888888888889
Control.SRR15539832;41;38;0.51219512195122;20;21;0.0121951219512195;0.48780487804878
Control.SRR15539832;39;38;0.384615384615385;24;15;0.115384615384615;0.384615384615385
Control.SRR15539832;38;38;0.657894736842105;13;25;0.157894736842105;0.342105263157895
Control.SRR15539832;44;38;0.522727272727273;21;23;0.0227272727272727;0.477272727272727
Control.SRR15539832;42;38;0.452380952380952;23;19;0.0476190476190476;0.452380952380952
Control.SRR15539832;34;38;0.5;17;17;0;0.5
Control.SRR15539832;29;38;0.517241379310345;14;15;0.0172413793103449;0.482758620689655
Control.SRR15539832;32;38;0.46875;17;15;0.03125;0.46875
Control.SRR15539832;31;38;0.483870967741935;16;15;0.0161290322580645;0.483870967741935
Control.SRR15539832;32;38;0.53125;15;17;0.03125;0.46875
Control.SRR15539832;33;38;0.454545454545455;18;15;0.0454545454545455;0.454545454545455
Control.SRR15539832;33;38;0.636363636363636;12;21;0.136363636363636;0.363636363636364
Control.SRR15539832;37;38;0.621621621621622;14;23;0.121621621621622;0.378378378378378
Control.SRR15539832;32;38;0.46875;17;15;0.03125;0.46875
Control.SRR15539832;37;38;0.540540540540541;17;20;0.0405405405405406;0.459459459459459
Control.SRR15539832;36;38;0.361111111111111;23;13;0.138888888888889;0.361111111111111
Control.SRR15539832;33;38;0.636363636363636;12;21;0.136363636363636;0.363636363636364
Control.SRR15539832;29;38;0.551724137931034;13;16;0.0517241379310345;0.448275862068966
Control.SRR15539832;31;38;0.419354838709677;18;13;0.0806451612903226;0.419354838709677
Control.SRR15539832;34;38;0.470588235294118;18;16;0.0294117647058824;0.470588235294118
Control.SRR15539832;35;38;0.514285714285714;17;18;0.0142857142857142;0.485714285714286
Control.SRR15539832;29;38;0.344827586206897;19;10;0.155172413793103;0.344827586206897
Control.SRR15539832;35;38;0.314285714285714;24;11;0.185714285714286;0.314285714285714
Control.SRR15539832;37;38;0.459459459459459;20;17;0.0405405405405405;0.459459459459459
Control.SRR15539832;34;38;0.411764705882353;20;14;0.0882352941176471;0.411764705882353
Control.SRR15539832;32;38;0.375;20;12;0.125;0.375
Control.SRR15539832;32;38;0.5;16;16;0;0.5
Control.SRR15539832;32;38;0.5;16;16;0;0.5
Control.SRR15539832;33;38;0.575757575757576;14;19;0.0757575757575758;0.424242424242424
Control.SRR15539832;36;38;0.444444444444444;20;16;0.0555555555555556;0.444444444444444
Control.SRR15539832;34;38;0.617647058823529;13;21;0.117647058823529;0.382352941176471
Control.SRR15539832;31;38;0.451612903225806;17;14;0.0483870967741936;0.451612903225806
Control.SRR15539832;29;38;0.482758620689655;15;14;0.0172413793103448;0.482758620689655
Control.SRR15539832;29;38;0.586206896551724;12;17;0.0862068965517241;0.413793103448276
Control.SRR15539832;29;38;0.551724137931034;13;16;0.0517241379310345;0.448275862068966
Control.SRR15539832;34;38;0.617647058823529;13;21;0.117647058823529;0.382352941176471
Control.SRR15539832;37;38;0.405405405405405;22;15;0.0945945945945946;0.405405405405405
Control.SRR15539832;34;38;0.5;17;17;0;0.5
Control.SRR15539832;34;38;0.441176470588235;19;15;0.0588235294117647;0.441176470588235
Control.SRR15539832;31;38;0.516129032258065;15;16;0.0161290322580645;0.483870967741935
Control.SRR15539832;35;38;0.542857142857143;16;19;0.0428571428571428;0.457142857142857
Control.SRR15539832;34;38;0.558823529411765;15;19;0.0588235294117647;0.441176470588235
Control.SRR15539832;31;38;0.580645161290323;13;18;0.0806451612903226;0.419354838709677
Control.SRR15539832;30;38;0.633333333333333;11;19;0.133333333333333;0.366666666666667
Control.SRR15539832;32;38;0.53125;15;17;0.03125;0.46875
Control.SRR15539832;32;38;0.3125;22;10;0.1875;0.3125
Control.SRR15539832;35;38;0.542857142857143;16;19;0.0428571428571428;0.457142857142857
Control.SRR15539832;35;38;0.6;14;21;0.1;0.4
Control.SRR15539832;31;38;0.67741935483871;10;21;0.17741935483871;0.32258064516129
Control.SRR15539832;36;38;0.444444444444444;20;16;0.0555555555555556;0.444444444444444
Control.SRR15539832;36;38;0.472222222222222;19;17;0.0277777777777778;0.472222222222222
Control.SRR15539832;35;38;0.628571428571429;13;22;0.128571428571429;0.371428571428571
Control.SRR15539832;33;38;0.636363636363636;12;21;0.136363636363636;0.363636363636364
Control.SRR15539832;31;38;0.451612903225806;17;14;0.0483870967741936;0.451612903225806
Control.SRR15539832;30;38;0.666666666666667;10;20;0.166666666666667;0.333333333333333
Control.SRR15539832;35;38;0.6;14;21;0.1;0.4
Control.SRR15539832;32;38;0.6875;10;22;0.1875;0.3125
Control.SRR15539832;31;38;0.483870967741935;16;15;0.0161290322580645;0.483870967741935
Control.SRR15539832;31;38;0.516129032258065;15;16;0.0161290322580645;0.483870967741935
Control.SRR15539832;29;38;0.517241379310345;14;15;0.0172413793103449;0.482758620689655
Control.SRR15539832;33;38;0.545454545454545;15;18;0.0454545454545454;0.454545454545455
Control.SRR15539832;29;38;0.689655172413793;9;20;0.189655172413793;0.310344827586207
Control.SRR15539832;33;38;0.484848484848485;17;16;0.0151515151515151;0.484848484848485
Control.SRR15539832;30;38;0.333333333333333;20;10;0.166666666666667;0.333333333333333
Control.SRR15539832;30;38;0.466666666666667;16;14;0.0333333333333333;0.466666666666667
Control.SRR15539832;32;38;0.53125;15;17;0.03125;0.46875
Control.SRR15539832;35;38;0.628571428571429;13;22;0.128571428571429;0.371428571428571
Control.SRR15539832;34;38;0.323529411764706;23;11;0.176470588235294;0.323529411764706
Control.SRR15539832;32;38;0.40625;19;13;0.09375;0.40625
Control.SRR15539832;32;38;0.46875;17;15;0.03125;0.46875
Control.SRR15539832;35;38;0.485714285714286;18;17;0.0142857142857143;0.485714285714286
Control.SRR15539832;33;38;0.424242424242424;19;14;0.0757575757575757;0.424242424242424
Control.SRR15539832;33;38;0.515151515151515;16;17;0.0151515151515151;0.484848484848485
Control.SRR15539832;30;38;0.366666666666667;19;11;0.133333333333333;0.366666666666667
Control.SRR15539832;32;38;0.28125;23;9;0.21875;0.28125
Control.SRR15539832;30;38;0.3;21;9;0.2;0.3
Control.SRR15539832;35;38;0.4;21;14;0.1;0.4
Control.SRR15539832;32;38;0.65625;11;21;0.15625;0.34375
Control.SRR15539832;32;38;0.34375;21;11;0.15625;0.34375
Control.SRR15539832;31;38;0.516129032258065;15;16;0.0161290322580645;0.483870967741935
Control.SRR15539832;33;38;0.575757575757576;14;19;0.0757575757575758;0.424242424242424
Control.SRR15539832;30;38;0.6;12;18;0.1;0.4
Control.SRR15539832;31;38;0.483870967741935;16;15;0.0161290322580645;0.483870967741935
Control.SRR15539832;34;38;0.470588235294118;18;16;0.0294117647058824;0.470588235294118
Control.SRR15539832;33;38;0.515151515151515;16;17;0.0151515151515151;0.484848484848485
Control.SRR15539832;33;38;0.303030303030303;23;10;0.196969696969697;0.303030303030303
Control.SRR15539832;35;38;0.6;14;21;0.1;0.4
Control.SRR15539832;35;38;0.6;14;21;0.1;0.4
Control.SRR15539832;34;38;0.441176470588235;19;15;0.0588235294117647;0.441176470588235
Control.SRR15539832;32;38;0.5;16;16;0;0.5
Control.SRR15539832;33;38;0.515151515151515;16;17;0.0151515151515151;0.484848484848485
Control.SRR15539832;37;38;0.405405405405405;22;15;0.0945945945945946;0.405405405405405
Control.SRR15539832;29;38;0.517241379310345;14;15;0.0172413793103449;0.482758620689655
Control.SRR15539832;34;38;0.470588235294118;18;16;0.0294117647058824;0.470588235294118
Control.SRR15539832;30;38;0.566666666666667;13;17;0.0666666666666667;0.433333333333333
Control.SRR15539832;30;38;0.5;15;15;0;0.5
Control.SRR15539832;31;38;0.483870967741935;16;15;0.0161290322580645;0.483870967741935
Control.SRR15539832;29;38;0.379310344827586;18;11;0.120689655172414;0.379310344827586
Control.SRR15539832;29;38;0.517241379310345;14;15;0.0172413793103449;0.482758620689655
Control.SRR15539832;32;38;0.4375;18;14;0.0625;0.4375
Control.SRR15539832;34;38;0.411764705882353;20;14;0.0882352941176471;0.411764705882353
Control.SRR15539832;36;38;0.416666666666667;21;15;0.0833333333333333;0.416666666666667
Control.SRR15539832;31;38;0.451612903225806;17;14;0.0483870967741936;0.451612903225806
Control.SRR15539832;30;38;0.366666666666667;19;11;0.133333333333333;0.366666666666667
Control.SRR15539832;31;38;0.548387096774194;14;17;0.0483870967741935;0.451612903225806
Control.SRR15539832;33;38;0.454545454545455;18;15;0.0454545454545455;0.454545454545455
Control.SRR15539832;33;38;0.454545454545455;18;15;0.0454545454545455;0.454545454545455
Control.SRR15539832;31;38;0.516129032258065;15;16;0.0161290322580645;0.483870967741935
Control.SRR15539832;33;38;0.636363636363636;12;21;0.136363636363636;0.363636363636364
Control.SRR15539832;29;38;0.620689655172414;11;18;0.120689655172414;0.379310344827586
Control.SRR15539832;36;38;0.527777777777778;17;19;0.0277777777777778;0.472222222222222
Control.SRR15539832;32;38;0.5;16;16;0;0.5
Control.SRR15539832;32;38;0.40625;19;13;0.09375;0.40625
Control.SRR15539832;36;38;0.527777777777778;17;19;0.0277777777777778;0.472222222222222
Control.SRR15539832;35;38;0.428571428571429;20;15;0.0714285714285715;0.428571428571429
Control.SRR15539832;37;38;0.513513513513513;18;19;0.0135135135135135;0.486486486486487
Control.SRR15539832;35;38;0.457142857142857;19;16;0.0428571428571429;0.457142857142857
Control.SRR15539832;35;38;0.4;21;14;0.1;0.4
Control.SRR15539832;37;38;0.486486486486487;19;18;0.0135135135135135;0.486486486486487
Control.SRR15539832;30;38;0.6;12;18;0.1;0.4
Control.SRR15539832;35;38;0.6;14;21;0.1;0.4
Control.SRR15539832;37;38;0.513513513513513;18;19;0.0135135135135135;0.486486486486487
Control.SRR15539832;32;38;0.4375;18;14;0.0625;0.4375
Control.SRR15539832;34;38;0.676470588235294;11;23;0.176470588235294;0.323529411764706
Control.SRR15539832;29;38;0.448275862068966;16;13;0.0517241379310345;0.448275862068966
Control.SRR15539832;32;38;0.40625;19;13;0.09375;0.40625
Control.SRR15539832;33;38;0.515151515151515;16;17;0.0151515151515151;0.484848484848485
Control.SRR15539832;36;38;0.527777777777778;17;19;0.0277777777777778;0.472222222222222
Control.SRR15539832;36;38;0.583333333333333;15;21;0.0833333333333334;0.416666666666667
Control.SRR15539832;30;38;0.466666666666667;16;14;0.0333333333333333;0.466666666666667
Control.SRR15539832;32;38;0.5;16;16;0;0.5
Control.SRR15539832;29;38;0.482758620689655;15;14;0.0172413793103448;0.482758620689655
Control.SRR15539832;33;38;0.575757575757576;14;19;0.0757575757575758;0.424242424242424
Control.SRR15539832;34;38;0.5;17;17;0;0.5
Control.SRR15539832;35;38;0.542857142857143;16;19;0.0428571428571428;0.457142857142857
Control.SRR15539832;37;38;0.540540540540541;17;20;0.0405405405405406;0.459459459459459
Control.SRR15539832;32;38;0.53125;15;17;0.03125;0.46875
Control.SRR15539832;30;38;0.4;18;12;0.1;0.4
Control.SRR15539832;35;38;0.542857142857143;16;19;0.0428571428571428;0.457142857142857
Control.SRR15539832;29;38;0.379310344827586;18;11;0.120689655172414;0.379310344827586
Control.SRR15539832;35;38;0.457142857142857;19;16;0.0428571428571429;0.457142857142857
Control.SRR15539832;30;38;0.5;15;15;0;0.5
Control.SRR15539832;33;38;0.545454545454545;15;18;0.0454545454545454;0.454545454545455
Control.SRR15539832;32;38;0.59375;13;19;0.09375;0.40625
Control.SRR15539832;31;38;0.548387096774194;14;17;0.0483870967741935;0.451612903225806
Control.SRR15539832;29;38;0.482758620689655;15;14;0.0172413793103448;0.482758620689655
Control.SRR15539832;33;38;0.606060606060606;13;20;0.106060606060606;0.393939393939394
Control.SRR15539832;35;38;0.6;14;21;0.1;0.4
Control.SRR15539832;34;38;0.5;17;17;0;0.5
Control.SRR15539832;33;38;0.484848484848485;17;16;0.0151515151515151;0.484848484848485
Control.SRR15539832;30;38;0.6;12;18;0.1;0.4
Control.SRR15539832;31;38;0.483870967741935;16;15;0.0161290322580645;0.483870967741935
Control.SRR15539832;34;38;0.5;17;17;0;0.5
Control.SRR15539832;31;38;0.483870967741935;16;15;0.0161290322580645;0.483870967741935
Control.SRR15539832;37;38;0.621621621621622;14;23;0.121621621621622;0.378378378378378
Control.SRR15539832;32;38;0.4375;18;14;0.0625;0.4375
Control.SRR15539832;34;38;0.441176470588235;19;15;0.0588235294117647;0.441176470588235
Control.SRR15539832;33;38;0.484848484848485;17;16;0.0151515151515151;0.484848484848485
Control.SRR15539832;35;38;0.514285714285714;17;18;0.0142857142857142;0.485714285714286
Control.SRR15539832;29;38;0.689655172413793;9;20;0.189655172413793;0.310344827586207
Control.SRR15539832;33;38;0.515151515151515;16;17;0.0151515151515151;0.484848484848485
Control.SRR15539832;29;38;0.448275862068966;16;13;0.0517241379310345;0.448275862068966
Control.SRR15539832;37;38;0.432432432432432;21;16;0.0675675675675675;0.432432432432432
Control.SRR15539832;30;38;0.4;18;12;0.1;0.4
Control.SRR15539832;36;38;0.527777777777778;17;19;0.0277777777777778;0.472222222222222
Control.SRR15539832;37;38;0.567567567567568;16;21;0.0675675675675675;0.432432432432432
Control.SRR15539832;31;38;0.580645161290323;13;18;0.0806451612903226;0.419354838709677
Control.SRR15539832;32;38;0.625;12;20;0.125;0.375
Control.SRR15539832;33;38;0.484848484848485;17;16;0.0151515151515151;0.484848484848485
Control.SRR15539832;37;38;0.540540540540541;17;20;0.0405405405405406;0.459459459459459
Control.SRR15539832;35;38;0.514285714285714;17;18;0.0142857142857142;0.485714285714286
Control.SRR15539832;31;38;0.290322580645161;22;9;0.209677419354839;0.290322580645161
Control.SRR15539832;30;38;0.7;9;21;0.2;0.3
Control.SRR15539832;35;38;0.428571428571429;20;15;0.0714285714285715;0.428571428571429
Control.SRR15539832;34;38;0.441176470588235;19;15;0.0588235294117647;0.441176470588235
Control.SRR15539832;33;38;0.424242424242424;19;14;0.0757575757575757;0.424242424242424
Control.SRR15539832;31;38;0.516129032258065;15;16;0.0161290322580645;0.483870967741935
Control.SRR15539832;32;38;0.5625;14;18;0.0625;0.4375
Control.SRR15539832;34;38;0.617647058823529;13;21;0.117647058823529;0.382352941176471
Control.SRR15539832;34;38;0.411764705882353;20;14;0.0882352941176471;0.411764705882353
Control.SRR15539832;31;38;0.387096774193548;19;12;0.112903225806452;0.387096774193548
Control.SRR15539832;33;38;0.515151515151515;16;17;0.0151515151515151;0.484848484848485
Control.SRR15539832;36;38;0.527777777777778;17;19;0.0277777777777778;0.472222222222222
Control.SRR15539832;37;38;0.459459459459459;20;17;0.0405405405405405;0.459459459459459
Control.SRR15539832;31;38;0.483870967741935;16;15;0.0161290322580645;0.483870967741935
Control.SRR15539832;37;38;0.513513513513513;18;19;0.0135135135135135;0.486486486486487
Control.SRR15539832;35;38;0.514285714285714;17;18;0.0142857142857142;0.485714285714286
Control.SRR15539832;36;38;0.527777777777778;17;19;0.0277777777777778;0.472222222222222
Control.SRR15539832;30;38;0.433333333333333;17;13;0.0666666666666667;0.433333333333333
Control.SRR15539832;30;38;0.466666666666667;16;14;0.0333333333333333;0.466666666666667
Control.SRR15539832;31;38;0.483870967741935;16;15;0.0161290322580645;0.483870967741935
Control.SRR15539832;31;38;0.516129032258065;15;16;0.0161290322580645;0.483870967741935
Control.SRR15539832;33;38;0.666666666666667;11;22;0.166666666666667;0.333333333333333
Control.SRR15539832;34;38;0.529411764705882;16;18;0.0294117647058824;0.470588235294118
Control.SRR15539832;29;38;0.379310344827586;18;11;0.120689655172414;0.379310344827586
Control.SRR15539832;30;38;0.566666666666667;13;17;0.0666666666666667;0.433333333333333
Control.SRR15539832;29;38;0.482758620689655;15;14;0.0172413793103448;0.482758620689655
Control.SRR15539832;33;38;0.545454545454545;15;18;0.0454545454545454;0.454545454545455
Control.SRR15539832;35;38;0.485714285714286;18;17;0.0142857142857143;0.485714285714286
Control.SRR15539832;37;38;0.459459459459459;20;17;0.0405405405405405;0.459459459459459
Control.SRR15539832;37;38;0.72972972972973;10;27;0.22972972972973;0.27027027027027
Control.SRR15539832;33;38;0.515151515151515;16;17;0.0151515151515151;0.484848484848485
Control.SRR15539832;33;38;0.696969696969697;10;23;0.196969696969697;0.303030303030303
Control.SRR15539832;31;38;0.451612903225806;17;14;0.0483870967741936;0.451612903225806
Control.SRR15539832;31;38;0.580645161290323;13;18;0.0806451612903226;0.419354838709677
Control.SRR15539832;33;38;0.454545454545455;18;15;0.0454545454545455;0.454545454545455
Control.SRR15539832;29;38;0.517241379310345;14;15;0.0172413793103449;0.482758620689655
Control.SRR15539832;30;38;0.5;15;15;0;0.5
Control.SRR15539832;32;38;0.375;20;12;0.125;0.375
Control.SRR15539832;37;38;0.513513513513513;18;19;0.0135135135135135;0.486486486486487
Control.SRR15539832;37;38;0.540540540540541;17;20;0.0405405405405406;0.459459459459459
Control.SRR15539832;35;38;0.457142857142857;19;16;0.0428571428571429;0.457142857142857
Control.SRR15539832;36;38;0.416666666666667;21;15;0.0833333333333333;0.416666666666667
Control.SRR15539832;31;38;0.483870967741935;16;15;0.0161290322580645;0.483870967741935
Control.SRR15539832;32;38;0.46875;17;15;0.03125;0.46875
Control.SRR15539832;30;38;0.566666666666667;13;17;0.0666666666666667;0.433333333333333
Control.SRR15539832;29;38;0.551724137931034;13;16;0.0517241379310345;0.448275862068966
Control.SRR15539832;30;38;0.5;15;15;0;0.5
Control.SRR15539832;29;38;0.551724137931034;13;16;0.0517241379310345;0.448275862068966
Control.SRR15539832;36;38;0.527777777777778;17;19;0.0277777777777778;0.472222222222222
Control.SRR15539832;37;38;0.513513513513513;18;19;0.0135135135135135;0.486486486486487
Control.SRR15539832;31;38;0.354838709677419;20;11;0.145161290322581;0.354838709677419
Control.SRR15539832;37;38;0.459459459459459;20;17;0.0405405405405405;0.459459459459459
Control.SRR15539832;32;38;0.5;16;16;0;0.5
Control.SRR15539832;34;38;0.470588235294118;18;16;0.0294117647058824;0.470588235294118
Control.SRR15539832;30;38;0.466666666666667;16;14;0.0333333333333333;0.466666666666667
Control.SRR15539832;36;38;0.416666666666667;21;15;0.0833333333333333;0.416666666666667
Control.SRR15539832;32;38;0.5;16;16;0;0.5
Control.SRR15539832;37;38;0.540540540540541;17;20;0.0405405405405406;0.459459459459459
Control.SRR15539832;32;38;0.5;16;16;0;0.5
Control.SRR15539832;36;38;0.611111111111111;14;22;0.111111111111111;0.388888888888889
Control.SRR15539832;34;38;0.470588235294118;18;16;0.0294117647058824;0.470588235294118
Control.SRR15539832;35;38;0.657142857142857;12;23;0.157142857142857;0.342857142857143
Control.SRR15539832;34;38;0.529411764705882;16;18;0.0294117647058824;0.470588235294118
Control.SRR15539832;35;38;0.6;14;21;0.1;0.4
Control.SRR15539832;29;38;0.655172413793103;10;19;0.155172413793103;0.344827586206897
Control.SRR15539832;36;38;0.361111111111111;23;13;0.138888888888889;0.361111111111111
Control.SRR15539832;35;38;0.428571428571429;20;15;0.0714285714285715;0.428571428571429
Control.SRR15539832;31;38;0.580645161290323;13;18;0.0806451612903226;0.419354838709677
Control.SRR15539832;32;38;0.5;16;16;0;0.5
Control.SRR15539832;35;38;0.514285714285714;17;18;0.0142857142857142;0.485714285714286
Control.SRR15539832;34;38;0.529411764705882;16;18;0.0294117647058824;0.470588235294118
Control.SRR15539832;34;38;0.5;17;17;0;0.5
Control.SRR15539832;33;38;0.636363636363636;12;21;0.136363636363636;0.363636363636364
Control.SRR15539832;33;38;0.454545454545455;18;15;0.0454545454545455;0.454545454545455
Control.SRR15539832;37;38;0.486486486486487;19;18;0.0135135135135135;0.486486486486487
Control.SRR15539832;35;38;0.514285714285714;17;18;0.0142857142857142;0.485714285714286
Control.SRR15539832;34;38;0.323529411764706;23;11;0.176470588235294;0.323529411764706
Control.SRR15539832;29;38;0.379310344827586;18;11;0.120689655172414;0.379310344827586
Control.SRR15539832;36;38;0.388888888888889;22;14;0.111111111111111;0.388888888888889
Control.SRR15539832;31;38;0.387096774193548;19;12;0.112903225806452;0.387096774193548
Control.SRR15539832;34;38;0.411764705882353;20;14;0.0882352941176471;0.411764705882353
Control.SRR15539832;30;38;0.6;12;18;0.1;0.4
Control.SRR15539832;30;38;0.466666666666667;16;14;0.0333333333333333;0.466666666666667
Control.SRR15539832;37;38;0.432432432432432;21;16;0.0675675675675675;0.432432432432432
Control.SRR15539832;32;38;0.40625;19;13;0.09375;0.40625
Control.SRR15539832;29;38;0.517241379310345;14;15;0.0172413793103449;0.482758620689655
Control.SRR15539832;35;38;0.657142857142857;12;23;0.157142857142857;0.342857142857143
Control.SRR15539832;35;38;0.485714285714286;18;17;0.0142857142857143;0.485714285714286
Control.SRR15539832;35;38;0.542857142857143;16;19;0.0428571428571428;0.457142857142857
Control.SRR15539832;37;38;0.513513513513513;18;19;0.0135135135135135;0.486486486486487
Control.SRR15539832;32;38;0.4375;18;14;0.0625;0.4375
Control.SRR15539832;33;38;0.454545454545455;18;15;0.0454545454545455;0.454545454545455
Control.SRR15539832;34;38;0.382352941176471;21;13;0.117647058823529;0.382352941176471
Control.SRR15539832;29;38;0.482758620689655;15;14;0.0172413793103448;0.482758620689655
Control.SRR15539832;37;38;0.459459459459459;20;17;0.0405405405405405;0.459459459459459
Control.SRR15539832;29;38;0.551724137931034;13;16;0.0517241379310345;0.448275862068966
Control.SRR15539832;35;38;0.771428571428571;8;27;0.271428571428571;0.228571428571429
Control.SRR15539832;37;38;0.432432432432432;21;16;0.0675675675675675;0.432432432432432
Control.SRR15539832;29;38;0.689655172413793;9;20;0.189655172413793;0.310344827586207
Control.SRR15539832;30;38;0.466666666666667;16;14;0.0333333333333333;0.466666666666667
Control.SRR15539832;37;38;0.432432432432432;21;16;0.0675675675675675;0.432432432432432
Control.SRR15539832;29;38;0.482758620689655;15;14;0.0172413793103448;0.482758620689655
Control.SRR15539832;36;38;0.638888888888889;13;23;0.138888888888889;0.361111111111111
Control.SRR15539832;35;38;0.342857142857143;23;12;0.157142857142857;0.342857142857143
Control.SRR15539832;31;38;0.516129032258065;15;16;0.0161290322580645;0.483870967741935
Control.SRR15539832;30;38;0.7;9;21;0.2;0.3
Control.SRR15539832;37;38;0.432432432432432;21;16;0.0675675675675675;0.432432432432432
Control.SRR15539832;34;38;0.470588235294118;18;16;0.0294117647058824;0.470588235294118
Control.SRR15539832;35;38;0.457142857142857;19;16;0.0428571428571429;0.457142857142857
Control.SRR15539832;33;38;0.424242424242424;19;14;0.0757575757575757;0.424242424242424
Control.SRR15539832;30;38;0.566666666666667;13;17;0.0666666666666667;0.433333333333333
Control.SRR15539832;35;38;0.657142857142857;12;23;0.157142857142857;0.342857142857143
Control.SRR15539832;32;38;0.46875;17;15;0.03125;0.46875
Control.SRR15539832;35;38;0.571428571428571;15;20;0.0714285714285714;0.428571428571429
Control.SRR15539832;33;38;0.515151515151515;16;17;0.0151515151515151;0.484848484848485
Control.SRR15539832;32;38;0.5;16;16;0;0.5
Control.SRR15539832;29;38;0.689655172413793;9;20;0.189655172413793;0.310344827586207
Control.SRR15539832;37;38;0.567567567567568;16;21;0.0675675675675675;0.432432432432432
Control.SRR15539832;31;38;0.419354838709677;18;13;0.0806451612903226;0.419354838709677
Control.SRR15539832;35;38;0.371428571428571;22;13;0.128571428571429;0.371428571428571
Control.SRR15539832;32;38;0.34375;21;11;0.15625;0.34375
Control.SRR15539832;36;38;0.416666666666667;21;15;0.0833333333333333;0.416666666666667
Control.SRR15539832;34;38;0.411764705882353;20;14;0.0882352941176471;0.411764705882353
Control.SRR15539832;35;38;0.657142857142857;12;23;0.157142857142857;0.342857142857143
Control.SRR15539832;29;38;0.655172413793103;10;19;0.155172413793103;0.344827586206897
Control.SRR15539832;30;38;0.7;9;21;0.2;0.3
Control.SRR15539832;35;38;0.457142857142857;19;16;0.0428571428571429;0.457142857142857
Control.SRR15539832;37;38;0.432432432432432;21;16;0.0675675675675675;0.432432432432432
Control.SRR15539832;35;38;0.514285714285714;17;18;0.0142857142857142;0.485714285714286
Control.SRR15539832;30;38;0.533333333333333;14;16;0.0333333333333333;0.466666666666667
Control.SRR15539832;33;38;0.424242424242424;19;14;0.0757575757575757;0.424242424242424
Control.SRR15539832;37;38;0.513513513513513;18;19;0.0135135135135135;0.486486486486487
Control.SRR15539832;32;38;0.4375;18;14;0.0625;0.4375
Control.SRR15539832;32;38;0.53125;15;17;0.03125;0.46875
Control.SRR15539832;31;38;0.67741935483871;10;21;0.17741935483871;0.32258064516129
Control.SRR15539832;33;38;0.484848484848485;17;16;0.0151515151515151;0.484848484848485
Control.SRR15539832;33;38;0.515151515151515;16;17;0.0151515151515151;0.484848484848485
Control.SRR15539832;29;38;0.655172413793103;10;19;0.155172413793103;0.344827586206897
Control.SRR15539832;31;38;0.580645161290323;13;18;0.0806451612903226;0.419354838709677
Control.SRR15539832;35;38;0.485714285714286;18;17;0.0142857142857143;0.485714285714286
Control.SRR15539832;35;38;0.6;14;21;0.1;0.4
Control.SRR15539832;32;38;0.53125;15;17;0.03125;0.46875
Control.SRR15539832;34;38;0.470588235294118;18;16;0.0294117647058824;0.470588235294118
Control.SRR15539832;34;38;0.647058823529412;12;22;0.147058823529412;0.352941176470588
Control.SRR15539832;34;38;0.470588235294118;18;16;0.0294117647058824;0.470588235294118
Control.SRR15539832;31;38;0.612903225806452;12;19;0.112903225806452;0.387096774193548
Control.SRR15539832;32;38;0.5;16;16;0;0.5
Control.SRR15539832;35;38;0.485714285714286;18;17;0.0142857142857143;0.485714285714286
Control.SRR15539832;35;38;0.571428571428571;15;20;0.0714285714285714;0.428571428571429
Control.SRR15539832;32;38;0.59375;13;19;0.09375;0.40625
Control.SRR15539832;32;38;0.40625;19;13;0.09375;0.40625
Control.SRR15539832;30;38;0.633333333333333;11;19;0.133333333333333;0.366666666666667
Control.SRR15539832;33;38;0.575757575757576;14;19;0.0757575757575758;0.424242424242424
Control.SRR15539832;33;38;0.515151515151515;16;17;0.0151515151515151;0.484848484848485
Control.SRR15539832;29;38;0.517241379310345;14;15;0.0172413793103449;0.482758620689655
Control.SRR15539832;32;38;0.46875;17;15;0.03125;0.46875
Control.SRR15539832;37;38;0.594594594594595;15;22;0.0945945945945946;0.405405405405405
Control.SRR15539832;36;38;0.5;18;18;0;0.5
Control.SRR15539832;34;38;0.352941176470588;22;12;0.147058823529412;0.352941176470588
Control.SRR15539832;32;38;0.65625;11;21;0.15625;0.34375
Control.SRR15539832;29;38;0.275862068965517;21;8;0.224137931034483;0.275862068965517
Control.SRR15539832;36;38;0.388888888888889;22;14;0.111111111111111;0.388888888888889
Control.SRR15539832;29;38;0.655172413793103;10;19;0.155172413793103;0.344827586206897
Control.SRR15539832;37;38;0.594594594594595;15;22;0.0945945945945946;0.405405405405405
Control.SRR15539832;31;38;0.387096774193548;19;12;0.112903225806452;0.387096774193548
Control.SRR15539832;34;38;0.411764705882353;20;14;0.0882352941176471;0.411764705882353
Control.SRR15539832;31;38;0.548387096774194;14;17;0.0483870967741935;0.451612903225806
Control.SRR15539832;33;38;0.575757575757576;14;19;0.0757575757575758;0.424242424242424
Control.SRR15539832;34;38;0.617647058823529;13;21;0.117647058823529;0.382352941176471
Control.SRR15539832;30;38;0.4;18;12;0.1;0.4
Control.SRR15539832;32;38;0.5;16;16;0;0.5
Control.SRR15539832;36;38;0.361111111111111;23;13;0.138888888888889;0.361111111111111
Control.SRR15539832;36;38;0.416666666666667;21;15;0.0833333333333333;0.416666666666667
Control.SRR15539832;36;38;0.527777777777778;17;19;0.0277777777777778;0.472222222222222
Control.SRR15539832;36;38;0.555555555555556;16;20;0.0555555555555556;0.444444444444444
Control.SRR15539832;36;38;0.416666666666667;21;15;0.0833333333333333;0.416666666666667
Control.SRR15539832;37;38;0.567567567567568;16;21;0.0675675675675675;0.432432432432432
Control.SRR15539832;33;38;0.696969696969697;10;23;0.196969696969697;0.303030303030303
Control.SRR15539832;29;38;0.517241379310345;14;15;0.0172413793103449;0.482758620689655
Control.SRR15539832;37;38;0.567567567567568;16;21;0.0675675675675675;0.432432432432432
Control.SRR15539832;33;38;0.515151515151515;16;17;0.0151515151515151;0.484848484848485
Control.SRR15539832;30;38;0.6;12;18;0.1;0.4
Control.SRR15539832;37;38;0.513513513513513;18;19;0.0135135135135135;0.486486486486487
Control.SRR15539832;30;38;0.766666666666667;7;23;0.266666666666667;0.233333333333333
Control.SRR15539832;36;38;0.5;18;18;0;0.5
Control.SRR15539832;31;38;0.451612903225806;17;14;0.0483870967741936;0.451612903225806
Control.SRR15539832;30;38;0.6;12;18;0.1;0.4
Control.SRR15539832;31;38;0.67741935483871;10;21;0.17741935483871;0.32258064516129
Control.SRR15539832;35;38;0.542857142857143;16;19;0.0428571428571428;0.457142857142857
Control.SRR15539832;36;38;0.638888888888889;13;23;0.138888888888889;0.361111111111111
Control.SRR15539832;29;38;0.413793103448276;17;12;0.0862068965517241;0.413793103448276
Control.SRR15539832;37;38;0.432432432432432;21;16;0.0675675675675675;0.432432432432432
Control.SRR15539832;29;38;0.620689655172414;11;18;0.120689655172414;0.379310344827586
Control.SRR15539832;34;38;0.5;17;17;0;0.5
Control.SRR15539832;33;38;0.606060606060606;13;20;0.106060606060606;0.393939393939394
Control.SRR15539832;35;38;0.314285714285714;24;11;0.185714285714286;0.314285714285714
Control.SRR15539832;32;38;0.46875;17;15;0.03125;0.46875
Control.SRR15539832;35;38;0.514285714285714;17;18;0.0142857142857142;0.485714285714286
Control.SRR15539832;34;38;0.5;17;17;0;0.5
Control.SRR15539832;37;38;0.675675675675676;12;25;0.175675675675676;0.324324324324324
Control.SRR15539832;36;38;0.472222222222222;19;17;0.0277777777777778;0.472222222222222
Control.SRR15539832;30;38;0.5;15;15;0;0.5
Control.SRR15539832;31;38;0.580645161290323;13;18;0.0806451612903226;0.419354838709677
Control.SRR15539832;30;38;0.466666666666667;16;14;0.0333333333333333;0.466666666666667
Control.SRR15539832;30;38;0.6;12;18;0.1;0.4
Control.SRR15539832;34;38;0.588235294117647;14;20;0.0882352941176471;0.411764705882353
Control.SRR15539832;35;38;0.571428571428571;15;20;0.0714285714285714;0.428571428571429
Control.SRR15539832;29;38;0.379310344827586;18;11;0.120689655172414;0.379310344827586
Control.SRR15539832;29;38;0.517241379310345;14;15;0.0172413793103449;0.482758620689655
Control.SRR15539832;30;38;0.6;12;18;0.1;0.4
Control.SRR15539832;33;38;0.575757575757576;14;19;0.0757575757575758;0.424242424242424
Control.SRR15539832;33;38;0.575757575757576;14;19;0.0757575757575758;0.424242424242424
Control.SRR15539832;31;38;0.419354838709677;18;13;0.0806451612903226;0.419354838709677
Control.SRR15539832;37;38;0.459459459459459;20;17;0.0405405405405405;0.459459459459459
Control.SRR15539832;29;38;0.586206896551724;12;17;0.0862068965517241;0.413793103448276
Control.SRR15539832;31;38;0.548387096774194;14;17;0.0483870967741935;0.451612903225806
Control.SRR15539832;32;38;0.65625;11;21;0.15625;0.34375
Control.SRR15539832;32;38;0.5;16;16;0;0.5
Control.SRR15539832;33;38;0.545454545454545;15;18;0.0454545454545454;0.454545454545455
Control.SRR15539832;36;38;0.555555555555556;16;20;0.0555555555555556;0.444444444444444
Control.SRR15539832;33;38;0.484848484848485;17;16;0.0151515151515151;0.484848484848485
Control.SRR15539832;30;38;0.566666666666667;13;17;0.0666666666666667;0.433333333333333
Control.SRR15539832;33;38;0.454545454545455;18;15;0.0454545454545455;0.454545454545455
Control.SRR15539832;37;38;0.513513513513513;18;19;0.0135135135135135;0.486486486486487
Control.SRR15539832;37;38;0.567567567567568;16;21;0.0675675675675675;0.432432432432432
Control.SRR15539832;36;38;0.444444444444444;20;16;0.0555555555555556;0.444444444444444
Control.SRR15539832;35;38;0.4;21;14;0.1;0.4
Control.SRR15539832;31;38;0.451612903225806;17;14;0.0483870967741936;0.451612903225806
Control.SRR15539832;33;38;0.515151515151515;16;17;0.0151515151515151;0.484848484848485
Control.SRR15539832;33;38;0.545454545454545;15;18;0.0454545454545454;0.454545454545455
Control.SRR15539832;35;38;0.485714285714286;18;17;0.0142857142857143;0.485714285714286
Control.SRR15539832;36;38;0.555555555555556;16;20;0.0555555555555556;0.444444444444444
Control.SRR15539832;34;38;0.294117647058824;24;10;0.205882352941176;0.294117647058824
Control.SRR15539832;38;38;0.5;19;19;0;0.5
Control.SRR15539832;45;38;0.533333333333333;21;24;0.0333333333333333;0.466666666666667
Control.SRR15539832;41;38;0.48780487804878;21;20;0.0121951219512195;0.48780487804878
Control.SRR15539832;42;38;0.404761904761905;25;17;0.0952380952380952;0.404761904761905
Control.SRR15539832;36;38;0.694444444444444;11;25;0.194444444444444;0.305555555555556
Control.SRR15539832;38;38;0.552631578947368;17;21;0.0526315789473685;0.447368421052632
Control.SRR15539832;36;38;0.444444444444444;20;16;0.0555555555555556;0.444444444444444
Control.SRR15539832;46;38;0.565217391304348;20;26;0.0652173913043478;0.434782608695652
Control.SRR15539832;38;38;0.631578947368421;14;24;0.131578947368421;0.368421052631579
Control.SRR15539832;45;38;0.422222222222222;26;19;0.0777777777777778;0.422222222222222
Control.SRR15539832;35;38;0.542857142857143;16;19;0.0428571428571428;0.457142857142857
Control.SRR15539832;36;38;0.5;18;18;0;0.5
Control.SRR15539832;37;38;0.405405405405405;22;15;0.0945945945945946;0.405405405405405
Control.SRR15539832;41;38;0.48780487804878;21;20;0.0121951219512195;0.48780487804878
Control.SRR15539832;37;38;0.405405405405405;22;15;0.0945945945945946;0.405405405405405
Control.SRR15539832;39;38;0.564102564102564;17;22;0.0641025641025641;0.435897435897436
Control.SRR15539832;37;38;0.459459459459459;20;17;0.0405405405405405;0.459459459459459
Control.SRR15539832;38;38;0.526315789473684;18;20;0.0263157894736842;0.473684210526316
Control.SRR15539832;39;38;0.538461538461538;18;21;0.0384615384615384;0.461538461538462
Control.SRR15539832;38;38;0.657894736842105;13;25;0.157894736842105;0.342105263157895
Control.SRR15539832;38;38;0.578947368421053;16;22;0.0789473684210527;0.421052631578947
Control.SRR15539832;44;38;0.454545454545455;24;20;0.0454545454545455;0.454545454545455
Control.SRR15539832;41;38;0.536585365853659;19;22;0.0365853658536586;0.463414634146341
Control.SRR15539832;39;38;0.41025641025641;23;16;0.0897435897435898;0.41025641025641
Control.SRR15539832;46;38;0.456521739130435;25;21;0.0434782608695652;0.456521739130435
Control.SRR15539832;46;38;0.369565217391304;29;17;0.130434782608696;0.369565217391304
Control.SRR15539832;37;38;0.378378378378378;23;14;0.121621621621622;0.378378378378378
Control.SRR15539832;36;38;0.444444444444444;20;16;0.0555555555555556;0.444444444444444
Control.SRR15539832;35;38;0.457142857142857;19;16;0.0428571428571429;0.457142857142857
Control.SRR15539832;37;38;0.432432432432432;21;16;0.0675675675675675;0.432432432432432
Control.SRR15539832;36;38;0.555555555555556;16;20;0.0555555555555556;0.444444444444444
Control.SRR15539832;35;38;0.485714285714286;18;17;0.0142857142857143;0.485714285714286
Control.SRR15539832;37;38;0.621621621621622;14;23;0.121621621621622;0.378378378378378
Control.SRR15539832;35;38;0.571428571428571;15;20;0.0714285714285714;0.428571428571429
Control.SRR15539832;42;38;0.595238095238095;17;25;0.0952380952380952;0.404761904761905
Control.SRR15539832;41;38;0.585365853658537;17;24;0.0853658536585366;0.414634146341463
Control.SRR15539832;35;38;0.542857142857143;16;19;0.0428571428571428;0.457142857142857
Control.SRR15539832;38;38;0.5;19;19;0;0.5
Control.SRR15539832;44;38;0.477272727272727;23;21;0.0227272727272727;0.477272727272727
Control.SRR15539832;35;38;0.542857142857143;16;19;0.0428571428571428;0.457142857142857
Control.SRR15539832;39;38;0.564102564102564;17;22;0.0641025641025641;0.435897435897436
Control.SRR15539832;40;38;0.5;20;20;0;0.5
Control.SRR15539832;38;38;0.631578947368421;14;24;0.131578947368421;0.368421052631579
Control.SRR15539832;41;38;0.439024390243902;23;18;0.0609756097560976;0.439024390243902
Control.SRR15539832;41;38;0.609756097560976;16;25;0.109756097560976;0.390243902439024
Control.SRR15539832;40;38;0.45;22;18;0.05;0.45
Control.SRR15539832;39;38;0.512820512820513;19;20;0.0128205128205128;0.487179487179487
Control.SRR15539832;43;38;0.511627906976744;21;22;0.0116279069767442;0.488372093023256
Control.SRR15539832;41;38;0.536585365853659;19;22;0.0365853658536586;0.463414634146341
Control.SRR15539832;38;38;0.526315789473684;18;20;0.0263157894736842;0.473684210526316
Control.SRR15539832;46;38;0.5;23;23;0;0.5
Control.SRR15539832;44;38;0.659090909090909;15;29;0.159090909090909;0.340909090909091
Control.SRR15539832;38;38;0.605263157894737;15;23;0.105263157894737;0.394736842105263
Control.SRR15539832;38;38;0.552631578947368;17;21;0.0526315789473685;0.447368421052632
Control.SRR15539832;38;38;0.657894736842105;13;25;0.157894736842105;0.342105263157895
Control.SRR15539832;35;38;0.514285714285714;17;18;0.0142857142857142;0.485714285714286
Control.SRR15539832;40;38;0.525;19;21;0.025;0.475
Control.SRR15539832;39;38;0.538461538461538;18;21;0.0384615384615384;0.461538461538462
Control.SRR15539832;44;38;0.431818181818182;25;19;0.0681818181818182;0.431818181818182
Control.SRR15539832;40;38;0.55;18;22;0.05;0.45
Control.SRR15539832;36;38;0.638888888888889;13;23;0.138888888888889;0.361111111111111
Control.SRR15539832;39;38;0.487179487179487;20;19;0.0128205128205128;0.487179487179487
Control.SRR15539832;36;38;0.388888888888889;22;14;0.111111111111111;0.388888888888889
Control.SRR15539832;38;38;0.578947368421053;16;22;0.0789473684210527;0.421052631578947
Control.SRR15539832;42;38;0.619047619047619;16;26;0.119047619047619;0.380952380952381
Control.SRR15539832;45;38;0.488888888888889;23;22;0.0111111111111111;0.488888888888889
Control.SRR15539832;37;38;0.594594594594595;15;22;0.0945945945945946;0.405405405405405
Control.SRR15539832;39;38;0.435897435897436;22;17;0.0641025641025641;0.435897435897436
Control.SRR15539832;41;38;0.536585365853659;19;22;0.0365853658536586;0.463414634146341
Control.SRR15539832;36;38;0.611111111111111;14;22;0.111111111111111;0.388888888888889
Control.SRR15539832;37;38;0.432432432432432;21;16;0.0675675675675675;0.432432432432432
Control.SRR15539832;35;38;0.514285714285714;17;18;0.0142857142857142;0.485714285714286
Control.SRR15539832;35;38;0.285714285714286;25;10;0.214285714285714;0.285714285714286
Control.SRR15539832;37;38;0.459459459459459;20;17;0.0405405405405405;0.459459459459459
Control.SRR15539832;37;38;0.594594594594595;15;22;0.0945945945945946;0.405405405405405
Control.SRR15539832;36;38;0.555555555555556;16;20;0.0555555555555556;0.444444444444444
Control.SRR15539832;42;38;0.523809523809524;20;22;0.0238095238095238;0.476190476190476
Control.SRR15539832;40;38;0.4;24;16;0.1;0.4
Control.SRR15539832;38;38;0.473684210526316;20;18;0.0263157894736842;0.473684210526316
Control.SRR15539832;42;38;0.476190476190476;22;20;0.0238095238095238;0.476190476190476
Control.SRR15539832;36;38;0.527777777777778;17;19;0.0277777777777778;0.472222222222222
Control.SRR15539832;35;38;0.314285714285714;24;11;0.185714285714286;0.314285714285714
Control.SRR15539832;42;38;0.380952380952381;26;16;0.119047619047619;0.380952380952381
Control.SRR15539832;40;38;0.425;23;17;0.075;0.425
Control.SRR15539832;37;38;0.459459459459459;20;17;0.0405405405405405;0.459459459459459
Control.SRR15539832;40;38;0.475;21;19;0.025;0.475
Control.SRR15539832;36;38;0.583333333333333;15;21;0.0833333333333334;0.416666666666667
Control.SRR15539832;44;38;0.363636363636364;28;16;0.136363636363636;0.363636363636364
Control.SRR15539832;41;38;0.439024390243902;23;18;0.0609756097560976;0.439024390243902
Control.SRR15539832;38;38;0.526315789473684;18;20;0.0263157894736842;0.473684210526316
Control.SRR15539832;42;38;0.452380952380952;23;19;0.0476190476190476;0.452380952380952
Control.SRR15539832;35;38;0.485714285714286;18;17;0.0142857142857143;0.485714285714286
Control.SRR15539832;40;38;0.475;21;19;0.025;0.475
Control.SRR15539832;37;38;0.702702702702703;11;26;0.202702702702703;0.297297297297297
Control.SRR15539832;39;38;0.512820512820513;19;20;0.0128205128205128;0.487179487179487
Control.SRR15539832;40;38;0.475;21;19;0.025;0.475
Control.SRR15539832;46;38;0.608695652173913;18;28;0.108695652173913;0.391304347826087
Control.SRR15539832;35;38;0.542857142857143;16;19;0.0428571428571428;0.457142857142857
Control.SRR15539832;36;38;0.555555555555556;16;20;0.0555555555555556;0.444444444444444
Control.SRR15539832;35;38;0.457142857142857;19;16;0.0428571428571429;0.457142857142857
Control.SRR15539832;39;38;0.641025641025641;14;25;0.141025641025641;0.358974358974359
Control.SRR15539832;44;38;0.454545454545455;24;20;0.0454545454545455;0.454545454545455
Control.SRR15539832;42;38;0.476190476190476;22;20;0.0238095238095238;0.476190476190476
Control.SRR15539832;36;38;0.333333333333333;24;12;0.166666666666667;0.333333333333333
Control.SRR15539832;35;38;0.285714285714286;25;10;0.214285714285714;0.285714285714286
Control.SRR15539832;42;38;0.595238095238095;17;25;0.0952380952380952;0.404761904761905
Control.SRR15539832;45;38;0.533333333333333;21;24;0.0333333333333333;0.466666666666667
Control.SRR15539832;43;38;0.465116279069767;23;20;0.0348837209302326;0.465116279069767
Control.SRR15539832;36;38;0.638888888888889;13;23;0.138888888888889;0.361111111111111
Control.SRR15539832;37;38;0.432432432432432;21;16;0.0675675675675675;0.432432432432432
Control.SRR15539832;37;38;0.432432432432432;21;16;0.0675675675675675;0.432432432432432
Control.SRR15539832;45;38;0.422222222222222;26;19;0.0777777777777778;0.422222222222222
Control.SRR15539832;37;38;0.513513513513513;18;19;0.0135135135135135;0.486486486486487
Control.SRR15539832;40;38;0.45;22;18;0.05;0.45
Control.SRR15539832;35;38;0.571428571428571;15;20;0.0714285714285714;0.428571428571429
Control.SRR15539832;39;38;0.641025641025641;14;25;0.141025641025641;0.358974358974359
Control.SRR15539832;43;38;0.558139534883721;19;24;0.0581395348837209;0.441860465116279
Control.SRR15539832;40;38;0.4;24;16;0.1;0.4
Control.SRR15539832;46;38;0.58695652173913;19;27;0.0869565217391305;0.41304347826087
Control.SRR15539832;42;38;0.5;21;21;0;0.5
Control.SRR15539832;39;38;0.512820512820513;19;20;0.0128205128205128;0.487179487179487
Control.SRR15539832;45;38;0.555555555555556;20;25;0.0555555555555556;0.444444444444444
Control.SRR15539832;44;38;0.409090909090909;26;18;0.0909090909090909;0.409090909090909
Control.SRR15539832;38;38;0.421052631578947;22;16;0.0789473684210527;0.421052631578947
Control.SRR15539832;35;38;0.485714285714286;18;17;0.0142857142857143;0.485714285714286
Control.SRR15539832;39;38;0.435897435897436;22;17;0.0641025641025641;0.435897435897436
Control.SRR15539832;42;38;0.357142857142857;27;15;0.142857142857143;0.357142857142857
Control.SRR15539832;36;38;0.583333333333333;15;21;0.0833333333333334;0.416666666666667
Control.SRR15539832;38;38;0.526315789473684;18;20;0.0263157894736842;0.473684210526316
Control.SRR15539832;43;38;0.488372093023256;22;21;0.0116279069767442;0.488372093023256
Control.SRR15539832;44;38;0.5;22;22;0;0.5
Control.SRR15539832;35;38;0.628571428571429;13;22;0.128571428571429;0.371428571428571
Control.SRR15539832;42;38;0.5;21;21;0;0.5
Control.SRR15539832;40;38;0.425;23;17;0.075;0.425
Control.SRR15539832;40;38;0.375;25;15;0.125;0.375
Control.SRR15539832;38;38;0.394736842105263;23;15;0.105263157894737;0.394736842105263
Control.SRR15539832;40;38;0.4;24;16;0.1;0.4
Control.SRR15539832;43;38;0.558139534883721;19;24;0.0581395348837209;0.441860465116279
Control.SRR15539832;45;38;0.444444444444444;25;20;0.0555555555555556;0.444444444444444
Control.SRR15539832;41;38;0.341463414634146;27;14;0.158536585365854;0.341463414634146
Control.SRR15539832;40;38;0.525;19;21;0.025;0.475
Control.SRR15539832;42;38;0.452380952380952;23;19;0.0476190476190476;0.452380952380952
Control.SRR15539832;35;38;0.514285714285714;17;18;0.0142857142857142;0.485714285714286
Control.SRR15539832;38;38;0.421052631578947;22;16;0.0789473684210527;0.421052631578947
Control.SRR15539832;38;38;0.578947368421053;16;22;0.0789473684210527;0.421052631578947
Control.SRR15539832;41;38;0.682926829268293;13;28;0.182926829268293;0.317073170731707
Control.SRR15539832;35;38;0.657142857142857;12;23;0.157142857142857;0.342857142857143
Control.SRR15539832;35;38;0.457142857142857;19;16;0.0428571428571429;0.457142857142857
Control.SRR15539832;42;38;0.619047619047619;16;26;0.119047619047619;0.380952380952381
Control.SRR15539832;41;38;0.634146341463415;15;26;0.134146341463415;0.365853658536585
Control.SRR15539832;45;38;0.533333333333333;21;24;0.0333333333333333;0.466666666666667
Control.SRR15539832;44;38;0.545454545454545;20;24;0.0454545454545454;0.454545454545455
Control.SRR15539832;41;38;0.51219512195122;20;21;0.0121951219512195;0.48780487804878
Control.SRR15539832;37;38;0.351351351351351;24;13;0.148648648648649;0.351351351351351
Control.SRR15539832;41;38;0.560975609756098;18;23;0.0609756097560976;0.439024390243902
Control.SRR15539832;44;38;0.522727272727273;21;23;0.0227272727272727;0.477272727272727
Control.SRR15539832;40;38;0.375;25;15;0.125;0.375
Control.SRR15539832;36;38;0.583333333333333;15;21;0.0833333333333334;0.416666666666667
Control.SRR15539832;44;38;0.568181818181818;19;25;0.0681818181818182;0.431818181818182
Control.SRR15539832;37;38;0.486486486486487;19;18;0.0135135135135135;0.486486486486487
Control.SRR15539832;41;38;0.585365853658537;17;24;0.0853658536585366;0.414634146341463
Control.SRR15539832;43;38;0.465116279069767;23;20;0.0348837209302326;0.465116279069767
Control.SRR15539832;42;38;0.452380952380952;23;19;0.0476190476190476;0.452380952380952
Control.SRR15539832;36;38;0.611111111111111;14;22;0.111111111111111;0.388888888888889
Control.SRR15539832;41;38;0.48780487804878;21;20;0.0121951219512195;0.48780487804878
Control.SRR15539832;36;38;0.527777777777778;17;19;0.0277777777777778;0.472222222222222
Control.SRR15539832;38;38;0.447368421052632;21;17;0.0526315789473684;0.447368421052632
Control.SRR15539832;43;38;0.488372093023256;22;21;0.0116279069767442;0.488372093023256
Control.SRR15539832;39;38;0.435897435897436;22;17;0.0641025641025641;0.435897435897436
Control.SRR15539832;43;38;0.511627906976744;21;22;0.0116279069767442;0.488372093023256
Control.SRR15539832;45;38;0.511111111111111;22;23;0.0111111111111111;0.488888888888889
Control.SRR15539832;44;38;0.409090909090909;26;18;0.0909090909090909;0.409090909090909
Control.SRR15539832;46;38;0.456521739130435;25;21;0.0434782608695652;0.456521739130435
Control.SRR15539832;40;38;0.5;20;20;0;0.5
Control.SRR15539832;37;38;0.405405405405405;22;15;0.0945945945945946;0.405405405405405
Control.SRR15539832;35;38;0.657142857142857;12;23;0.157142857142857;0.342857142857143
Control.SRR15539832;42;38;0.595238095238095;17;25;0.0952380952380952;0.404761904761905
Control.SRR15539832;39;38;0.41025641025641;23;16;0.0897435897435898;0.41025641025641
Control.SRR15539832;37;38;0.594594594594595;15;22;0.0945945945945946;0.405405405405405
Control.SRR15539832;46;38;0.5;23;23;0;0.5
Control.SRR15539832;45;38;0.511111111111111;22;23;0.0111111111111111;0.488888888888889
Control.SRR15539832;37;38;0.540540540540541;17;20;0.0405405405405406;0.459459459459459
Control.SRR15539832;35;38;0.514285714285714;17;18;0.0142857142857142;0.485714285714286
Control.SRR15539832;43;38;0.511627906976744;21;22;0.0116279069767442;0.488372093023256
Control.SRR15539832;41;38;0.414634146341463;24;17;0.0853658536585366;0.414634146341463
Control.SRR15539832;46;38;0.543478260869565;21;25;0.0434782608695652;0.456521739130435
Control.SRR15539832;43;38;0.372093023255814;27;16;0.127906976744186;0.372093023255814
Control.SRR15539832;36;38;0.611111111111111;14;22;0.111111111111111;0.388888888888889
Control.SRR15539832;45;38;0.666666666666667;15;30;0.166666666666667;0.333333333333333
Control.SRR15539832;42;38;0.642857142857143;15;27;0.142857142857143;0.357142857142857
Control.SRR15539832;42;38;0.547619047619048;19;23;0.0476190476190477;0.452380952380952
Control.SRR15539832;41;38;0.634146341463415;15;26;0.134146341463415;0.365853658536585
Control.SRR15539832;37;38;0.567567567567568;16;21;0.0675675675675675;0.432432432432432
Control.SRR15539832;37;38;0.486486486486487;19;18;0.0135135135135135;0.486486486486487
Control.SRR15539832;46;38;0.5;23;23;0;0.5
Control.SRR15539832;39;38;0.512820512820513;19;20;0.0128205128205128;0.487179487179487
Control.SRR15539832;35;38;0.485714285714286;18;17;0.0142857142857143;0.485714285714286
Control.SRR15539832;40;38;0.55;18;22;0.05;0.45
Control.SRR15539832;40;38;0.55;18;22;0.05;0.45
Control.SRR15539832;46;38;0.478260869565217;24;22;0.0217391304347826;0.478260869565217
Control.SRR15539832;41;38;0.463414634146341;22;19;0.0365853658536585;0.463414634146341
Control.SRR15539832;44;38;0.590909090909091;18;26;0.0909090909090909;0.409090909090909
Control.SRR15539832;45;38;0.4;27;18;0.1;0.4
Control.SRR15539832;35;38;0.4;21;14;0.1;0.4
Control.SRR15539832;36;38;0.444444444444444;20;16;0.0555555555555556;0.444444444444444
Control.SRR15539832;39;38;0.641025641025641;14;25;0.141025641025641;0.358974358974359
Control.SRR15539832;36;38;0.555555555555556;16;20;0.0555555555555556;0.444444444444444
Control.SRR15539832;43;38;0.465116279069767;23;20;0.0348837209302326;0.465116279069767
Control.SRR15539832;35;38;0.4;21;14;0.1;0.4
Control.SRR15539832;43;38;0.511627906976744;21;22;0.0116279069767442;0.488372093023256
Control.SRR15539832;37;38;0.648648648648649;13;24;0.148648648648649;0.351351351351351
Control.SRR15539832;36;38;0.444444444444444;20;16;0.0555555555555556;0.444444444444444
Control.SRR15539832;42;38;0.571428571428571;18;24;0.0714285714285714;0.428571428571429
Control.SRR15539832;39;38;0.564102564102564;17;22;0.0641025641025641;0.435897435897436
Control.SRR15539832;36;38;0.555555555555556;16;20;0.0555555555555556;0.444444444444444
Control.SRR15539832;42;38;0.476190476190476;22;20;0.0238095238095238;0.476190476190476
Control.SRR15539832;42;38;0.452380952380952;23;19;0.0476190476190476;0.452380952380952
Control.SRR15539832;39;38;0.512820512820513;19;20;0.0128205128205128;0.487179487179487
Control.SRR15539832;35;38;0.6;14;21;0.1;0.4
Control.SRR15539832;40;38;0.5;20;20;0;0.5
Control.SRR15539832;36;38;0.444444444444444;20;16;0.0555555555555556;0.444444444444444
Control.SRR15539832;35;38;0.571428571428571;15;20;0.0714285714285714;0.428571428571429
Control.SRR15539832;36;38;0.5;18;18;0;0.5
Control.SRR15539832;39;38;0.461538461538462;21;18;0.0384615384615384;0.461538461538462
Control.SRR15539832;40;38;0.525;19;21;0.025;0.475
Control.SRR15539832;45;38;0.422222222222222;26;19;0.0777777777777778;0.422222222222222
Control.SRR15539832;38;38;0.447368421052632;21;17;0.0526315789473684;0.447368421052632
Control.SRR15539832;46;38;0.456521739130435;25;21;0.0434782608695652;0.456521739130435
Control.SRR15539832;42;38;0.404761904761905;25;17;0.0952380952380952;0.404761904761905
Control.SRR15539832;44;38;0.568181818181818;19;25;0.0681818181818182;0.431818181818182
Control.SRR15539832;44;38;0.477272727272727;23;21;0.0227272727272727;0.477272727272727
Control.SRR15539832;42;38;0.523809523809524;20;22;0.0238095238095238;0.476190476190476
Control.SRR15539832;44;38;0.5;22;22;0;0.5
Control.SRR15539832;35;38;0.571428571428571;15;20;0.0714285714285714;0.428571428571429
Control.SRR15539832;46;38;0.41304347826087;27;19;0.0869565217391304;0.41304347826087
Control.SRR15539832;37;38;0.459459459459459;20;17;0.0405405405405405;0.459459459459459
Control.SRR15539832;37;38;0.513513513513513;18;19;0.0135135135135135;0.486486486486487
Control.SRR15539832;44;38;0.454545454545455;24;20;0.0454545454545455;0.454545454545455
Control.SRR15539832;39;38;0.461538461538462;21;18;0.0384615384615384;0.461538461538462
Control.SRR15539832;38;38;0.473684210526316;20;18;0.0263157894736842;0.473684210526316
Control.SRR15539832;37;38;0.513513513513513;18;19;0.0135135135135135;0.486486486486487
Control.SRR15539832;37;38;0.567567567567568;16;21;0.0675675675675675;0.432432432432432
Control.SRR15539832;40;38;0.5;20;20;0;0.5
Control.SRR15539832;39;38;0.564102564102564;17;22;0.0641025641025641;0.435897435897436
Control.SRR15539832;37;38;0.675675675675676;12;25;0.175675675675676;0.324324324324324
Control.SRR15539832;39;38;0.384615384615385;24;15;0.115384615384615;0.384615384615385
Control.SRR15539832;38;38;0.526315789473684;18;20;0.0263157894736842;0.473684210526316
Control.SRR15539832;40;38;0.625;15;25;0.125;0.375
Control.SRR15539832;39;38;0.666666666666667;13;26;0.166666666666667;0.333333333333333
Control.SRR15539832;42;38;0.523809523809524;20;22;0.0238095238095238;0.476190476190476
Control.SRR15539832;39;38;0.564102564102564;17;22;0.0641025641025641;0.435897435897436
Control.SRR15539832;42;38;0.404761904761905;25;17;0.0952380952380952;0.404761904761905
Control.SRR15539832;36;38;0.611111111111111;14;22;0.111111111111111;0.388888888888889
Control.SRR15539832;41;38;0.51219512195122;20;21;0.0121951219512195;0.48780487804878
Control.SRR15539832;45;38;0.533333333333333;21;24;0.0333333333333333;0.466666666666667
Control.SRR15539832;40;38;0.45;22;18;0.05;0.45
Control.SRR15539832;42;38;0.5;21;21;0;0.5
Control.SRR15539832;40;38;0.525;19;21;0.025;0.475
Control.SRR15539832;39;38;0.358974358974359;25;14;0.141025641025641;0.358974358974359
Control.SRR15539832;41;38;0.51219512195122;20;21;0.0121951219512195;0.48780487804878
Control.SRR15539832;39;38;0.487179487179487;20;19;0.0128205128205128;0.487179487179487
Control.SRR15539832;39;38;0.358974358974359;25;14;0.141025641025641;0.358974358974359
Control.SRR15539832;46;38;0.434782608695652;26;20;0.0652173913043478;0.434782608695652
Control.SRR15539832;45;38;0.4;27;18;0.1;0.4
Control.SRR15539832;46;38;0.543478260869565;21;25;0.0434782608695652;0.456521739130435
Control.SRR15539832;43;38;0.488372093023256;22;21;0.0116279069767442;0.488372093023256
Control.SRR15539832;41;38;0.536585365853659;19;22;0.0365853658536586;0.463414634146341
Control.SRR15539832;41;38;0.414634146341463;24;17;0.0853658536585366;0.414634146341463
Control.SRR15539832;45;38;0.511111111111111;22;23;0.0111111111111111;0.488888888888889
Control.SRR15539832;38;38;0.5;19;19;0;0.5
Control.SRR15539832;37;38;0.540540540540541;17;20;0.0405405405405406;0.459459459459459
Control.SRR15539832;37;38;0.459459459459459;20;17;0.0405405405405405;0.459459459459459
Control.SRR15539832;38;38;0.368421052631579;24;14;0.131578947368421;0.368421052631579
Control.SRR15539832;46;38;0.41304347826087;27;19;0.0869565217391304;0.41304347826087
Control.SRR15539832;41;38;0.560975609756098;18;23;0.0609756097560976;0.439024390243902
Control.SRR15539832;42;38;0.571428571428571;18;24;0.0714285714285714;0.428571428571429
Control.SRR15539832;46;38;0.478260869565217;24;22;0.0217391304347826;0.478260869565217
Control.SRR15539832;38;38;0.605263157894737;15;23;0.105263157894737;0.394736842105263
Control.SRR15539832;46;38;0.478260869565217;24;22;0.0217391304347826;0.478260869565217
Control.SRR15539832;40;38;0.55;18;22;0.05;0.45
Control.SRR15539832;36;38;0.555555555555556;16;20;0.0555555555555556;0.444444444444444
Control.SRR15539832;40;38;0.45;22;18;0.05;0.45
Control.SRR15539832;40;38;0.5;20;20;0;0.5
Control.SRR15539832;46;38;0.456521739130435;25;21;0.0434782608695652;0.456521739130435
Control.SRR15539832;38;38;0.578947368421053;16;22;0.0789473684210527;0.421052631578947
Control.SRR15539832;38;38;0.473684210526316;20;18;0.0263157894736842;0.473684210526316
Control.SRR15539832;39;38;0.487179487179487;20;19;0.0128205128205128;0.487179487179487
Control.SRR15539832;43;38;0.441860465116279;24;19;0.0581395348837209;0.441860465116279
Control.SRR15539832;35;38;0.6;14;21;0.1;0.4
Control.SRR15539832;45;38;0.488888888888889;23;22;0.0111111111111111;0.488888888888889
Control.SRR15539832;43;38;0.348837209302326;28;15;0.151162790697674;0.348837209302326
Control.SRR15539832;39;38;0.333333333333333;26;13;0.166666666666667;0.333333333333333
Control.SRR15539832;40;38;0.6;16;24;0.1;0.4
Control.SRR15539832;38;38;0.631578947368421;14;24;0.131578947368421;0.368421052631579
Control.SRR15539832;41;38;0.51219512195122;20;21;0.0121951219512195;0.48780487804878
Control.SRR15539832;42;38;0.5;21;21;0;0.5
Control.SRR15539832;37;38;0.486486486486487;19;18;0.0135135135135135;0.486486486486487
Control.SRR15539832;42;38;0.30952380952381;29;13;0.19047619047619;0.30952380952381
Control.SRR15539832;35;38;0.428571428571429;20;15;0.0714285714285715;0.428571428571429
Control.SRR15539832;42;38;0.619047619047619;16;26;0.119047619047619;0.380952380952381
Control.SRR15539832;37;38;0.594594594594595;15;22;0.0945945945945946;0.405405405405405
Control.SRR15539832;36;38;0.583333333333333;15;21;0.0833333333333334;0.416666666666667
Control.SRR15539832;37;38;0.621621621621622;14;23;0.121621621621622;0.378378378378378
Control.SRR15539832;43;38;0.418604651162791;25;18;0.0813953488372093;0.418604651162791
Control.SRR15539832;38;38;0.605263157894737;15;23;0.105263157894737;0.394736842105263
Control.SRR15539832;38;38;0.552631578947368;17;21;0.0526315789473685;0.447368421052632
Control.SRR15539832;41;38;0.536585365853659;19;22;0.0365853658536586;0.463414634146341
Control.SRR15539832;41;38;0.560975609756098;18;23;0.0609756097560976;0.439024390243902
Control.SRR15539832;38;38;0.421052631578947;22;16;0.0789473684210527;0.421052631578947
Control.SRR15539832;41;38;0.51219512195122;20;21;0.0121951219512195;0.48780487804878
Control.SRR15539832;40;38;0.425;23;17;0.075;0.425
Control.SRR15539832;41;38;0.292682926829268;29;12;0.207317073170732;0.292682926829268
Control.SRR15539832;44;38;0.590909090909091;18;26;0.0909090909090909;0.409090909090909
Control.SRR15539832;41;38;0.51219512195122;20;21;0.0121951219512195;0.48780487804878
Control.SRR15539832;41;38;0.560975609756098;18;23;0.0609756097560976;0.439024390243902
Control.SRR15539832;42;38;0.523809523809524;20;22;0.0238095238095238;0.476190476190476
Control.SRR15539832;38;38;0.447368421052632;21;17;0.0526315789473684;0.447368421052632
Control.SRR15539832;43;38;0.441860465116279;24;19;0.0581395348837209;0.441860465116279
Control.SRR15539832;38;38;0.473684210526316;20;18;0.0263157894736842;0.473684210526316
Control.SRR15539832;35;38;0.571428571428571;15;20;0.0714285714285714;0.428571428571429
Control.SRR15539832;40;38;0.45;22;18;0.05;0.45
Control.SRR15539832;37;38;0.459459459459459;20;17;0.0405405405405405;0.459459459459459
Control.SRR15539832;35;38;0.457142857142857;19;16;0.0428571428571429;0.457142857142857
Control.SRR15539832;46;38;0.543478260869565;21;25;0.0434782608695652;0.456521739130435
Control.SRR15539832;42;38;0.380952380952381;26;16;0.119047619047619;0.380952380952381
Control.SRR15539832;37;38;0.513513513513513;18;19;0.0135135135135135;0.486486486486487
Control.SRR15539832;42;38;0.476190476190476;22;20;0.0238095238095238;0.476190476190476
Control.SRR15539832;42;38;0.476190476190476;22;20;0.0238095238095238;0.476190476190476
Control.SRR15539832;42;38;0.571428571428571;18;24;0.0714285714285714;0.428571428571429
Control.SRR15539832;41;38;0.48780487804878;21;20;0.0121951219512195;0.48780487804878
Control.SRR15539832;38;38;0.447368421052632;21;17;0.0526315789473684;0.447368421052632
Control.SRR15539832;40;38;0.475;21;19;0.025;0.475
Control.SRR15539832;45;38;0.444444444444444;25;20;0.0555555555555556;0.444444444444444
Control.SRR15539832;40;38;0.35;26;14;0.15;0.35
Control.SRR15539832;44;38;0.522727272727273;21;23;0.0227272727272727;0.477272727272727
Control.SRR15539832;35;38;0.485714285714286;18;17;0.0142857142857143;0.485714285714286
Control.SRR15539832;35;38;0.428571428571429;20;15;0.0714285714285715;0.428571428571429
Control.SRR15539832;40;38;0.575;17;23;0.075;0.425
Control.SRR15539832;46;38;0.5;23;23;0;0.5
Control.SRR15539832;36;38;0.583333333333333;15;21;0.0833333333333334;0.416666666666667
Control.SRR15539832;46;38;0.478260869565217;24;22;0.0217391304347826;0.478260869565217
Control.SRR15539832;43;38;0.534883720930233;20;23;0.0348837209302325;0.465116279069767
Control.SRR15539832;44;38;0.431818181818182;25;19;0.0681818181818182;0.431818181818182
Control.SRR15539832;42;38;0.452380952380952;23;19;0.0476190476190476;0.452380952380952
Control.SRR15539832;36;38;0.444444444444444;20;16;0.0555555555555556;0.444444444444444
Control.SRR15539832;42;38;0.452380952380952;23;19;0.0476190476190476;0.452380952380952
Control.SRR15539832;45;38;0.511111111111111;22;23;0.0111111111111111;0.488888888888889
Control.SRR15539832;39;38;0.461538461538462;21;18;0.0384615384615384;0.461538461538462
Control.SRR15539832;37;38;0.540540540540541;17;20;0.0405405405405406;0.459459459459459
Control.SRR15539832;40;38;0.45;22;18;0.05;0.45
Control.SRR15539832;35;38;0.514285714285714;17;18;0.0142857142857142;0.485714285714286
Control.SRR15539832;42;38;0.5;21;21;0;0.5
Control.SRR15539832;46;38;0.5;23;23;0;0.5
Control.SRR15539832;42;38;0.380952380952381;26;16;0.119047619047619;0.380952380952381
Control.SRR15539832;39;38;0.487179487179487;20;19;0.0128205128205128;0.487179487179487
Control.SRR15539832;38;38;0.447368421052632;21;17;0.0526315789473684;0.447368421052632
Control.SRR15539832;41;38;0.51219512195122;20;21;0.0121951219512195;0.48780487804878
Control.SRR15539832;46;38;0.565217391304348;20;26;0.0652173913043478;0.434782608695652
Control.SRR15539832;46;38;0.5;23;23;0;0.5
Control.SRR15539832;37;38;0.567567567567568;16;21;0.0675675675675675;0.432432432432432
Control.SRR15539832;35;38;0.571428571428571;15;20;0.0714285714285714;0.428571428571429
Control.SRR15539832;42;38;0.523809523809524;20;22;0.0238095238095238;0.476190476190476
Control.SRR15539832;41;38;0.463414634146341;22;19;0.0365853658536585;0.463414634146341
Control.SRR15539832;38;38;0.552631578947368;17;21;0.0526315789473685;0.447368421052632
Control.SRR15539832;44;38;0.568181818181818;19;25;0.0681818181818182;0.431818181818182
Control.SRR15539832;37;38;0.513513513513513;18;19;0.0135135135135135;0.486486486486487
Control.SRR15539832;36;38;0.444444444444444;20;16;0.0555555555555556;0.444444444444444
Control.SRR15539832;42;38;0.642857142857143;15;27;0.142857142857143;0.357142857142857
Control.SRR15539832;39;38;0.641025641025641;14;25;0.141025641025641;0.358974358974359
Control.SRR15539832;37;38;0.27027027027027;27;10;0.22972972972973;0.27027027027027
Control.SRR15539832;39;38;0.641025641025641;14;25;0.141025641025641;0.358974358974359
Control.SRR15539832;40;38;0.475;21;19;0.025;0.475
Control.SRR15539832;44;38;0.659090909090909;15;29;0.159090909090909;0.340909090909091
Control.SRR15539832;42;38;0.380952380952381;26;16;0.119047619047619;0.380952380952381
Control.SRR15539832;37;38;0.459459459459459;20;17;0.0405405405405405;0.459459459459459
Control.SRR15539832;39;38;0.435897435897436;22;17;0.0641025641025641;0.435897435897436
Control.SRR15539832;46;38;0.478260869565217;24;22;0.0217391304347826;0.478260869565217
Control.SRR15539832;42;38;0.523809523809524;20;22;0.0238095238095238;0.476190476190476
Control.SRR15539832;38;38;0.526315789473684;18;20;0.0263157894736842;0.473684210526316
Control.SRR15539832;45;38;0.466666666666667;24;21;0.0333333333333333;0.466666666666667
Control.SRR15539832;35;38;0.571428571428571;15;20;0.0714285714285714;0.428571428571429
Control.SRR15539832;41;38;0.51219512195122;20;21;0.0121951219512195;0.48780487804878
Control.SRR15539832;46;38;0.543478260869565;21;25;0.0434782608695652;0.456521739130435
Control.SRR15539832;45;38;0.422222222222222;26;19;0.0777777777777778;0.422222222222222
Control.SRR15539832;36;38;0.611111111111111;14;22;0.111111111111111;0.388888888888889
Control.SRR15539832;46;38;0.695652173913043;14;32;0.195652173913043;0.304347826086957
Control.SRR15539832;46;38;0.434782608695652;26;20;0.0652173913043478;0.434782608695652
Control.SRR15539832;43;38;0.651162790697674;15;28;0.151162790697674;0.348837209302326
Control.SRR15539832;46;38;0.565217391304348;20;26;0.0652173913043478;0.434782608695652
Control.SRR15539832;38;38;0.526315789473684;18;20;0.0263157894736842;0.473684210526316
Control.SRR15539832;39;38;0.41025641025641;23;16;0.0897435897435898;0.41025641025641
Control.SRR15539832;44;38;0.477272727272727;23;21;0.0227272727272727;0.477272727272727
Control.SRR15539832;36;38;0.361111111111111;23;13;0.138888888888889;0.361111111111111
Control.SRR15539832;39;38;0.58974358974359;16;23;0.0897435897435898;0.41025641025641
Control.SRR15539832;41;38;0.365853658536585;26;15;0.134146341463415;0.365853658536585
Control.SRR15539832;40;38;0.4;24;16;0.1;0.4
Control.SRR15539832;44;38;0.454545454545455;24;20;0.0454545454545455;0.454545454545455
Control.SRR15539832;38;38;0.5;19;19;0;0.5
Control.SRR15539832;46;38;0.5;23;23;0;0.5
Control.SRR15539832;40;38;0.375;25;15;0.125;0.375
Control.SRR15539832;38;38;0.447368421052632;21;17;0.0526315789473684;0.447368421052632
Control.SRR15539832;37;38;0.432432432432432;21;16;0.0675675675675675;0.432432432432432
Control.SRR15539832;46;38;0.478260869565217;24;22;0.0217391304347826;0.478260869565217
Control.SRR15539832;37;38;0.486486486486487;19;18;0.0135135135135135;0.486486486486487
Control.SRR15539832;43;38;0.488372093023256;22;21;0.0116279069767442;0.488372093023256
Control.SRR15539832;36;38;0.638888888888889;13;23;0.138888888888889;0.361111111111111
Control.SRR15539832;41;38;0.560975609756098;18;23;0.0609756097560976;0.439024390243902
Control.SRR15539832;39;38;0.41025641025641;23;16;0.0897435897435898;0.41025641025641
Control.SRR15539832;40;38;0.55;18;22;0.05;0.45
Control.SRR15539832;43;38;0.395348837209302;26;17;0.104651162790698;0.395348837209302
Control.SRR15539832;39;38;0.487179487179487;20;19;0.0128205128205128;0.487179487179487
Control.SRR15539832;41;38;0.414634146341463;24;17;0.0853658536585366;0.414634146341463
Control.SRR15539832;41;38;0.585365853658537;17;24;0.0853658536585366;0.414634146341463
Control.SRR15539832;45;38;0.511111111111111;22;23;0.0111111111111111;0.488888888888889
Control.SRR15539832;38;38;0.473684210526316;20;18;0.0263157894736842;0.473684210526316
Control.SRR15539832;35;38;0.628571428571429;13;22;0.128571428571429;0.371428571428571
Control.SRR15539832;36;38;0.611111111111111;14;22;0.111111111111111;0.388888888888889
Control.SRR15539832;36;38;0.388888888888889;22;14;0.111111111111111;0.388888888888889
Control.SRR15539832;42;38;0.452380952380952;23;19;0.0476190476190476;0.452380952380952
Control.SRR15539832;40;38;0.475;21;19;0.025;0.475
Control.SRR15539832;40;38;0.6;16;24;0.1;0.4
Control.SRR15539832;44;38;0.454545454545455;24;20;0.0454545454545455;0.454545454545455
Control.SRR15539832;42;38;0.547619047619048;19;23;0.0476190476190477;0.452380952380952
Control.SRR15539832;46;38;0.478260869565217;24;22;0.0217391304347826;0.478260869565217
Control.SRR15539832;41;38;0.560975609756098;18;23;0.0609756097560976;0.439024390243902
Control.SRR15539832;41;38;0.634146341463415;15;26;0.134146341463415;0.365853658536585
Control.SRR15539832;46;38;0.456521739130435;25;21;0.0434782608695652;0.456521739130435
Control.SRR15539832;38;38;0.447368421052632;21;17;0.0526315789473684;0.447368421052632
Control.SRR15539832;44;38;0.477272727272727;23;21;0.0227272727272727;0.477272727272727
Control.SRR15539832;36;38;0.555555555555556;16;20;0.0555555555555556;0.444444444444444
Control.SRR15539832;37;38;0.567567567567568;16;21;0.0675675675675675;0.432432432432432
Control.SRR15539832;39;38;0.538461538461538;18;21;0.0384615384615384;0.461538461538462
Control.SRR15539832;46;38;0.652173913043478;16;30;0.152173913043478;0.347826086956522
Control.SRR15539832;39;38;0.564102564102564;17;22;0.0641025641025641;0.435897435897436
Control.SRR15539832;41;38;0.536585365853659;19;22;0.0365853658536586;0.463414634146341
Control.SRR15539832;41;38;0.536585365853659;19;22;0.0365853658536586;0.463414634146341
Control.SRR15539832;42;38;0.5;21;21;0;0.5
Control.SRR15539832;45;38;0.444444444444444;25;20;0.0555555555555556;0.444444444444444
Control.SRR15539832;39;38;0.487179487179487;20;19;0.0128205128205128;0.487179487179487
Control.SRR15539832;40;38;0.45;22;18;0.05;0.45
Control.SRR15539832;42;38;0.452380952380952;23;19;0.0476190476190476;0.452380952380952
Control.SRR15539832;43;38;0.441860465116279;24;19;0.0581395348837209;0.441860465116279
Control.SRR15539832;39;38;0.487179487179487;20;19;0.0128205128205128;0.487179487179487
Control.SRR15539832;40;38;0.525;19;21;0.025;0.475
Control.SRR15539832;42;38;0.285714285714286;30;12;0.214285714285714;0.285714285714286
Control.SRR15539832;45;38;0.444444444444444;25;20;0.0555555555555556;0.444444444444444
Control.SRR15539832;44;38;0.477272727272727;23;21;0.0227272727272727;0.477272727272727
Control.SRR15539832;42;38;0.428571428571429;24;18;0.0714285714285715;0.428571428571429
Control.SRR15539832;40;38;0.55;18;22;0.05;0.45
Control.SRR15539832;40;38;0.55;18;22;0.05;0.45
Control.SRR15539832;37;38;0.513513513513513;18;19;0.0135135135135135;0.486486486486487
Control.SRR15539832;38;38;0.368421052631579;24;14;0.131578947368421;0.368421052631579
Control.SRR15539832;46;38;0.630434782608696;17;29;0.130434782608696;0.369565217391304
Control.SRR15539832;38;38;0.552631578947368;17;21;0.0526315789473685;0.447368421052632
Control.SRR15539832;39;38;0.512820512820513;19;20;0.0128205128205128;0.487179487179487
Control.SRR15539832;42;38;0.476190476190476;22;20;0.0238095238095238;0.476190476190476
Control.SRR15539832;46;38;0.5;23;23;0;0.5
Control.SRR15539832;36;38;0.611111111111111;14;22;0.111111111111111;0.388888888888889
Control.SRR15539832;43;38;0.441860465116279;24;19;0.0581395348837209;0.441860465116279
Control.SRR15539832;39;38;0.564102564102564;17;22;0.0641025641025641;0.435897435897436
Control.SRR15539832;44;38;0.568181818181818;19;25;0.0681818181818182;0.431818181818182
Control.SRR15539832;37;38;0.459459459459459;20;17;0.0405405405405405;0.459459459459459
Control.SRR15539832;39;38;0.487179487179487;20;19;0.0128205128205128;0.487179487179487
Control.SRR15539832;43;38;0.558139534883721;19;24;0.0581395348837209;0.441860465116279
Control.SRR15539832;36;38;0.555555555555556;16;20;0.0555555555555556;0.444444444444444
Control.SRR15539832;39;38;0.487179487179487;20;19;0.0128205128205128;0.487179487179487
Control.SRR15539832;38;38;0.526315789473684;18;20;0.0263157894736842;0.473684210526316
Control.SRR15539832;42;38;0.5;21;21;0;0.5
Control.SRR15539832;46;38;0.521739130434783;22;24;0.0217391304347826;0.478260869565217
Control.SRR15539832;37;38;0.405405405405405;22;15;0.0945945945945946;0.405405405405405
Control.SRR15539832;37;38;0.486486486486487;19;18;0.0135135135135135;0.486486486486487
Control.SRR15539832;45;38;0.555555555555556;20;25;0.0555555555555556;0.444444444444444
Control.SRR15539832;45;38;0.577777777777778;19;26;0.0777777777777777;0.422222222222222
Control.SRR15539832;42;38;0.595238095238095;17;25;0.0952380952380952;0.404761904761905
Control.SRR15539832;39;38;0.487179487179487;20;19;0.0128205128205128;0.487179487179487
Control.SRR15539832;39;38;0.384615384615385;24;15;0.115384615384615;0.384615384615385
Control.SRR15539832;41;38;0.463414634146341;22;19;0.0365853658536585;0.463414634146341
Control.SRR15539832;39;38;0.41025641025641;23;16;0.0897435897435898;0.41025641025641
Control.SRR15539832;36;38;0.583333333333333;15;21;0.0833333333333334;0.416666666666667
Control.SRR15539832;40;38;0.45;22;18;0.05;0.45
Control.SRR15539832;45;38;0.4;27;18;0.1;0.4
Control.SRR15539832;45;38;0.6;18;27;0.1;0.4
Control.SRR15539832;42;38;0.428571428571429;24;18;0.0714285714285715;0.428571428571429
Control.SRR15539832;43;38;0.558139534883721;19;24;0.0581395348837209;0.441860465116279
Control.SRR15539832;41;38;0.439024390243902;23;18;0.0609756097560976;0.439024390243902
Control.SRR15539832;45;38;0.622222222222222;17;28;0.122222222222222;0.377777777777778
Control.SRR15539832;43;38;0.534883720930233;20;23;0.0348837209302325;0.465116279069767
Control.SRR15539832;46;38;0.58695652173913;19;27;0.0869565217391305;0.41304347826087
Control.SRR15539832;44;38;0.5;22;22;0;0.5
Control.SRR15539832;38;38;0.5;19;19;0;0.5
Control.SRR15539832;40;38;0.525;19;21;0.025;0.475
Control.SRR15539832;33;38;0.484848484848485;17;16;0.0151515151515151;0.484848484848485
Control.SRR15539832;37;38;0.459459459459459;20;17;0.0405405405405405;0.459459459459459
Control.SRR15539832;30;38;0.5;15;15;0;0.5
Control.SRR15539832;39;38;0.564102564102564;17;22;0.0641025641025641;0.435897435897436
Control.SRR15539832;36;38;0.527777777777778;17;19;0.0277777777777778;0.472222222222222
Control.SRR15539832;39;38;0.615384615384615;15;24;0.115384615384615;0.384615384615385
Control.SRR15539832;37;38;0.432432432432432;21;16;0.0675675675675675;0.432432432432432
Control.SRR15539832;33;38;0.515151515151515;16;17;0.0151515151515151;0.484848484848485
Control.SRR15539832;36;38;0.555555555555556;16;20;0.0555555555555556;0.444444444444444
Control.SRR15539832;34;38;0.676470588235294;11;23;0.176470588235294;0.323529411764706
Control.SRR15539832;31;38;0.548387096774194;14;17;0.0483870967741935;0.451612903225806
Control.SRR15539832;37;38;0.513513513513513;18;19;0.0135135135135135;0.486486486486487
Control.SRR15539832;36;38;0.388888888888889;22;14;0.111111111111111;0.388888888888889
Control.SRR15539832;37;38;0.486486486486487;19;18;0.0135135135135135;0.486486486486487
Control.SRR15539832;35;38;0.571428571428571;15;20;0.0714285714285714;0.428571428571429
Control.SRR15539832;35;38;0.457142857142857;19;16;0.0428571428571429;0.457142857142857
Control.SRR15539832;38;38;0.5;19;19;0;0.5
Control.SRR15539832;36;38;0.444444444444444;20;16;0.0555555555555556;0.444444444444444
Control.SRR15539832;38;38;0.447368421052632;21;17;0.0526315789473684;0.447368421052632
Control.SRR15539832;30;38;0.466666666666667;16;14;0.0333333333333333;0.466666666666667
Control.SRR15539832;33;38;0.363636363636364;21;12;0.136363636363636;0.363636363636364
Control.SRR15539832;34;38;0.558823529411765;15;19;0.0588235294117647;0.441176470588235
Control.SRR15539832;36;38;0.555555555555556;16;20;0.0555555555555556;0.444444444444444
Control.SRR15539832;35;38;0.457142857142857;19;16;0.0428571428571429;0.457142857142857
Control.SRR15539832;35;38;0.457142857142857;19;16;0.0428571428571429;0.457142857142857
Control.SRR15539832;35;38;0.428571428571429;20;15;0.0714285714285715;0.428571428571429
Control.SRR15539832;38;38;0.421052631578947;22;16;0.0789473684210527;0.421052631578947
Control.SRR15539832;30;38;0.7;9;21;0.2;0.3
Control.SRR15539832;33;38;0.515151515151515;16;17;0.0151515151515151;0.484848484848485
Control.SRR15539832;30;38;0.366666666666667;19;11;0.133333333333333;0.366666666666667
Control.SRR15539832;33;38;0.424242424242424;19;14;0.0757575757575757;0.424242424242424
Control.SRR15539832;37;38;0.567567567567568;16;21;0.0675675675675675;0.432432432432432
Control.SRR15539832;40;38;0.425;23;17;0.075;0.425
Control.SRR15539832;34;38;0.411764705882353;20;14;0.0882352941176471;0.411764705882353
Control.SRR15539832;31;38;0.32258064516129;21;10;0.17741935483871;0.32258064516129
Control.SRR15539832;30;38;0.533333333333333;14;16;0.0333333333333333;0.466666666666667
Control.SRR15539832;32;38;0.53125;15;17;0.03125;0.46875
Control.SRR15539832;39;38;0.41025641025641;23;16;0.0897435897435898;0.41025641025641
Control.SRR15539832;34;38;0.294117647058824;24;10;0.205882352941176;0.294117647058824
Control.SRR15539832;34;38;0.676470588235294;11;23;0.176470588235294;0.323529411764706
Control.SRR15539832;31;38;0.161290322580645;26;5;0.338709677419355;0.161290322580645
Control.SRR15539832;39;38;0.564102564102564;17;22;0.0641025641025641;0.435897435897436
Control.SRR15539832;40;38;0.5;20;20;0;0.5
Control.SRR15539832;37;38;0.594594594594595;15;22;0.0945945945945946;0.405405405405405
Control.SRR15539832;33;38;0.606060606060606;13;20;0.106060606060606;0.393939393939394
Control.SRR15539832;30;38;0.5;15;15;0;0.5
Control.SRR15539832;38;38;0.394736842105263;23;15;0.105263157894737;0.394736842105263
Control.SRR15539832;34;38;0.5;17;17;0;0.5
Control.SRR15539832;40;38;0.5;20;20;0;0.5
Control.SRR15539832;37;38;0.567567567567568;16;21;0.0675675675675675;0.432432432432432
Control.SRR15539832;33;38;0.575757575757576;14;19;0.0757575757575758;0.424242424242424
Control.SRR15539832;37;38;0.459459459459459;20;17;0.0405405405405405;0.459459459459459
Control.SRR15539832;40;38;0.625;15;25;0.125;0.375
Control.SRR15539832;33;38;0.424242424242424;19;14;0.0757575757575757;0.424242424242424
Control.SRR15539832;32;38;0.46875;17;15;0.03125;0.46875
Control.SRR15539832;31;38;0.419354838709677;18;13;0.0806451612903226;0.419354838709677
Control.SRR15539832;30;38;0.7;9;21;0.2;0.3
Control.SRR15539832;33;38;0.484848484848485;17;16;0.0151515151515151;0.484848484848485
Control.SRR15539832;32;38;0.5625;14;18;0.0625;0.4375
Control.SRR15539832;33;38;0.363636363636364;21;12;0.136363636363636;0.363636363636364
Control.SRR15539832;33;38;0.484848484848485;17;16;0.0151515151515151;0.484848484848485
Control.SRR15539832;37;38;0.567567567567568;16;21;0.0675675675675675;0.432432432432432
Control.SRR15539832;30;38;0.466666666666667;16;14;0.0333333333333333;0.466666666666667
Control.SRR15539832;36;38;0.611111111111111;14;22;0.111111111111111;0.388888888888889
Control.SRR15539832;40;38;0.575;17;23;0.075;0.425
Control.SRR15539832;30;38;0.6;12;18;0.1;0.4
Control.SRR15539832;37;38;0.540540540540541;17;20;0.0405405405405406;0.459459459459459
Control.SRR15539832;31;38;0.483870967741935;16;15;0.0161290322580645;0.483870967741935
Control.SRR15539832;30;38;0.4;18;12;0.1;0.4
Control.SRR15539832;33;38;0.515151515151515;16;17;0.0151515151515151;0.484848484848485
Control.SRR15539832;38;38;0.394736842105263;23;15;0.105263157894737;0.394736842105263
Control.SRR15539832;36;38;0.583333333333333;15;21;0.0833333333333334;0.416666666666667
Control.SRR15539832;34;38;0.558823529411765;15;19;0.0588235294117647;0.441176470588235
Control.SRR15539832;33;38;0.606060606060606;13;20;0.106060606060606;0.393939393939394
Control.SRR15539832;33;38;0.515151515151515;16;17;0.0151515151515151;0.484848484848485
Control.SRR15539832;40;38;0.55;18;22;0.05;0.45
Control.SRR15539832;31;38;0.483870967741935;16;15;0.0161290322580645;0.483870967741935
Control.SRR15539832;38;38;0.605263157894737;15;23;0.105263157894737;0.394736842105263
Control.SRR15539832;31;38;0.580645161290323;13;18;0.0806451612903226;0.419354838709677
Control.SRR15539832;33;38;0.333333333333333;22;11;0.166666666666667;0.333333333333333
Control.SRR15539832;36;38;0.694444444444444;11;25;0.194444444444444;0.305555555555556
Control.SRR15539832;31;38;0.387096774193548;19;12;0.112903225806452;0.387096774193548
Control.SRR15539832;30;38;0.433333333333333;17;13;0.0666666666666667;0.433333333333333
Control.SRR15539832;33;38;0.424242424242424;19;14;0.0757575757575757;0.424242424242424
Control.SRR15539832;38;38;0.526315789473684;18;20;0.0263157894736842;0.473684210526316
Control.SRR15539832;32;38;0.59375;13;19;0.09375;0.40625
Control.SRR15539832;40;38;0.625;15;25;0.125;0.375
Control.SRR15539832;39;38;0.58974358974359;16;23;0.0897435897435898;0.41025641025641
Control.SRR15539832;37;38;0.513513513513513;18;19;0.0135135135135135;0.486486486486487
Control.SRR15539832;35;38;0.542857142857143;16;19;0.0428571428571428;0.457142857142857
Control.SRR15539832;30;38;0.5;15;15;0;0.5
Control.SRR15539832;38;38;0.552631578947368;17;21;0.0526315789473685;0.447368421052632
Control.SRR15539832;33;38;0.515151515151515;16;17;0.0151515151515151;0.484848484848485
Control.SRR15539832;31;38;0.548387096774194;14;17;0.0483870967741935;0.451612903225806
Control.SRR15539832;33;38;0.393939393939394;20;13;0.106060606060606;0.393939393939394
Control.SRR15539832;33;38;0.545454545454545;15;18;0.0454545454545454;0.454545454545455
Control.SRR15539832;33;38;0.515151515151515;16;17;0.0151515151515151;0.484848484848485
Control.SRR15539832;38;38;0.526315789473684;18;20;0.0263157894736842;0.473684210526316
Control.SRR15539832;36;38;0.416666666666667;21;15;0.0833333333333333;0.416666666666667
Control.SRR15539832;32;38;0.53125;15;17;0.03125;0.46875
Control.SRR15539832;31;38;0.516129032258065;15;16;0.0161290322580645;0.483870967741935
Control.SRR15539832;37;38;0.540540540540541;17;20;0.0405405405405406;0.459459459459459
Control.SRR15539832;38;38;0.447368421052632;21;17;0.0526315789473684;0.447368421052632
Control.SRR15539832;33;38;0.393939393939394;20;13;0.106060606060606;0.393939393939394
Control.SRR15539832;30;38;0.6;12;18;0.1;0.4
Control.SRR15539832;34;38;0.5;17;17;0;0.5
Control.SRR15539832;33;38;0.454545454545455;18;15;0.0454545454545455;0.454545454545455
Control.SRR15539832;33;38;0.393939393939394;20;13;0.106060606060606;0.393939393939394
Control.SRR15539832;34;38;0.294117647058824;24;10;0.205882352941176;0.294117647058824
Control.SRR15539832;40;38;0.575;17;23;0.075;0.425
Control.SRR15539832;33;38;0.636363636363636;12;21;0.136363636363636;0.363636363636364
Control.SRR15539832;38;38;0.394736842105263;23;15;0.105263157894737;0.394736842105263
Control.SRR15539832;32;38;0.625;12;20;0.125;0.375
Control.SRR15539832;37;38;0.486486486486487;19;18;0.0135135135135135;0.486486486486487
Control.SRR15539832;38;38;0.5;19;19;0;0.5
Control.SRR15539832;34;38;0.5;17;17;0;0.5
Control.SRR15539832;38;38;0.447368421052632;21;17;0.0526315789473684;0.447368421052632
Control.SRR15539832;31;38;0.548387096774194;14;17;0.0483870967741935;0.451612903225806
Control.SRR15539832;33;38;0.484848484848485;17;16;0.0151515151515151;0.484848484848485
Control.SRR15539832;36;38;0.527777777777778;17;19;0.0277777777777778;0.472222222222222
Control.SRR15539832;31;38;0.483870967741935;16;15;0.0161290322580645;0.483870967741935
Control.SRR15539832;32;38;0.59375;13;19;0.09375;0.40625
Control.SRR15539832;31;38;0.419354838709677;18;13;0.0806451612903226;0.419354838709677
Control.SRR15539832;38;38;0.421052631578947;22;16;0.0789473684210527;0.421052631578947
Control.SRR15539832;30;38;0.566666666666667;13;17;0.0666666666666667;0.433333333333333
Control.SRR15539832;30;38;0.433333333333333;17;13;0.0666666666666667;0.433333333333333
Control.SRR15539832;38;38;0.342105263157895;25;13;0.157894736842105;0.342105263157895
Control.SRR15539832;39;38;0.384615384615385;24;15;0.115384615384615;0.384615384615385
Control.SRR15539832;33;38;0.424242424242424;19;14;0.0757575757575757;0.424242424242424
Control.SRR15539832;39;38;0.435897435897436;22;17;0.0641025641025641;0.435897435897436
Control.SRR15539832;39;38;0.564102564102564;17;22;0.0641025641025641;0.435897435897436
Control.SRR15539832;35;38;0.571428571428571;15;20;0.0714285714285714;0.428571428571429
Control.SRR15539832;40;38;0.525;19;21;0.025;0.475
Control.SRR15539832;36;38;0.472222222222222;19;17;0.0277777777777778;0.472222222222222
Control.SRR15539832;40;38;0.575;17;23;0.075;0.425
Control.SRR15539832;35;38;0.6;14;21;0.1;0.4
Control.SRR15539832;38;38;0.578947368421053;16;22;0.0789473684210527;0.421052631578947
Control.SRR15539832;34;38;0.441176470588235;19;15;0.0588235294117647;0.441176470588235
Control.SRR15539832;31;38;0.419354838709677;18;13;0.0806451612903226;0.419354838709677
Control.SRR15539832;31;38;0.548387096774194;14;17;0.0483870967741935;0.451612903225806
Control.SRR15539832;32;38;0.40625;19;13;0.09375;0.40625
Control.SRR15539832;35;38;0.457142857142857;19;16;0.0428571428571429;0.457142857142857
Control.SRR15539832;33;38;0.454545454545455;18;15;0.0454545454545455;0.454545454545455
Control.SRR15539832;30;38;0.5;15;15;0;0.5
Control.SRR15539832;33;38;0.484848484848485;17;16;0.0151515151515151;0.484848484848485
Control.SRR15539832;36;38;0.5;18;18;0;0.5
Control.SRR15539832;40;38;0.65;14;26;0.15;0.35
Control.SRR15539832;35;38;0.6;14;21;0.1;0.4
Control.SRR15539832;34;38;0.470588235294118;18;16;0.0294117647058824;0.470588235294118
Control.SRR15539832;34;38;0.470588235294118;18;16;0.0294117647058824;0.470588235294118
Control.SRR15539832;34;38;0.441176470588235;19;15;0.0588235294117647;0.441176470588235
Control.SRR15539832;31;38;0.645161290322581;11;20;0.145161290322581;0.354838709677419
Control.SRR15539832;36;38;0.472222222222222;19;17;0.0277777777777778;0.472222222222222
Control.SRR15539832;37;38;0.486486486486487;19;18;0.0135135135135135;0.486486486486487
Control.SRR15539832;34;38;0.352941176470588;22;12;0.147058823529412;0.352941176470588
Control.SRR15539832;34;38;0.588235294117647;14;20;0.0882352941176471;0.411764705882353
Control.SRR15539832;36;38;0.472222222222222;19;17;0.0277777777777778;0.472222222222222
Control.SRR15539832;35;38;0.428571428571429;20;15;0.0714285714285715;0.428571428571429
Control.SRR15539832;30;38;0.466666666666667;16;14;0.0333333333333333;0.466666666666667
Control.SRR15539832;32;38;0.5625;14;18;0.0625;0.4375
Control.SRR15539832;36;38;0.444444444444444;20;16;0.0555555555555556;0.444444444444444
Control.SRR15539832;33;38;0.333333333333333;22;11;0.166666666666667;0.333333333333333
Control.SRR15539832;32;38;0.40625;19;13;0.09375;0.40625
Control.SRR15539832;31;38;0.580645161290323;13;18;0.0806451612903226;0.419354838709677
Control.SRR15539832;36;38;0.555555555555556;16;20;0.0555555555555556;0.444444444444444
Control.SRR15539832;30;38;0.666666666666667;10;20;0.166666666666667;0.333333333333333
Control.SRR15539832;34;38;0.352941176470588;22;12;0.147058823529412;0.352941176470588
Control.SRR15539832;33;38;0.363636363636364;21;12;0.136363636363636;0.363636363636364
Control.SRR15539832;32;38;0.375;20;12;0.125;0.375
Control.SRR15539832;34;38;0.558823529411765;15;19;0.0588235294117647;0.441176470588235
Control.SRR15539832;30;38;0.566666666666667;13;17;0.0666666666666667;0.433333333333333
Control.SRR15539832;32;38;0.40625;19;13;0.09375;0.40625
Control.SRR15539832;35;38;0.485714285714286;18;17;0.0142857142857143;0.485714285714286
Control.SRR15539832;34;38;0.470588235294118;18;16;0.0294117647058824;0.470588235294118
Control.SRR15539832;33;38;0.484848484848485;17;16;0.0151515151515151;0.484848484848485
Control.SRR15539832;35;38;0.6;14;21;0.1;0.4
Control.SRR15539832;36;38;0.527777777777778;17;19;0.0277777777777778;0.472222222222222
Control.SRR15539832;35;38;0.4;21;14;0.1;0.4
Control.SRR15539832;37;38;0.540540540540541;17;20;0.0405405405405406;0.459459459459459
Control.SRR15539832;37;38;0.621621621621622;14;23;0.121621621621622;0.378378378378378
Control.SRR15539832;35;38;0.542857142857143;16;19;0.0428571428571428;0.457142857142857
Control.SRR15539832;31;38;0.612903225806452;12;19;0.112903225806452;0.387096774193548
Control.SRR15539832;30;38;0.633333333333333;11;19;0.133333333333333;0.366666666666667
Control.SRR15539832;35;38;0.371428571428571;22;13;0.128571428571429;0.371428571428571
Control.SRR15539832;39;38;0.435897435897436;22;17;0.0641025641025641;0.435897435897436
Control.SRR15539832;30;38;0.633333333333333;11;19;0.133333333333333;0.366666666666667
Control.SRR15539832;38;38;0.5;19;19;0;0.5
Control.SRR15539832;34;38;0.617647058823529;13;21;0.117647058823529;0.382352941176471
Control.SRR15539832;33;38;0.484848484848485;17;16;0.0151515151515151;0.484848484848485
Control.SRR15539832;31;38;0.645161290322581;11;20;0.145161290322581;0.354838709677419
Control.SRR15539832;35;38;0.428571428571429;20;15;0.0714285714285715;0.428571428571429
Control.SRR15539832;36;38;0.333333333333333;24;12;0.166666666666667;0.333333333333333
Control.SRR15539832;37;38;0.432432432432432;21;16;0.0675675675675675;0.432432432432432
Control.SRR15539832;37;38;0.513513513513513;18;19;0.0135135135135135;0.486486486486487
Control.SRR15539832;37;38;0.459459459459459;20;17;0.0405405405405405;0.459459459459459
Control.SRR15539832;35;38;0.571428571428571;15;20;0.0714285714285714;0.428571428571429
Control.SRR15539832;36;38;0.277777777777778;26;10;0.222222222222222;0.277777777777778
Control.SRR15539832;37;38;0.486486486486487;19;18;0.0135135135135135;0.486486486486487
Control.SRR15539832;34;38;0.5;17;17;0;0.5
Control.SRR15539832;40;38;0.55;18;22;0.05;0.45
Control.SRR15539832;40;38;0.475;21;19;0.025;0.475
Control.SRR15539832;32;38;0.5;16;16;0;0.5
Control.SRR15539832;32;38;0.46875;17;15;0.03125;0.46875
Control.SRR15539832;32;38;0.5;16;16;0;0.5
Control.SRR15539832;31;38;0.516129032258065;15;16;0.0161290322580645;0.483870967741935
Control.SRR15539832;39;38;0.564102564102564;17;22;0.0641025641025641;0.435897435897436
Control.SRR15539832;40;38;0.525;19;21;0.025;0.475
Control.SRR15539832;40;38;0.55;18;22;0.05;0.45
Control.SRR15539832;31;38;0.419354838709677;18;13;0.0806451612903226;0.419354838709677
Control.SRR15539832;38;38;0.447368421052632;21;17;0.0526315789473684;0.447368421052632
Control.SRR15539832;37;38;0.459459459459459;20;17;0.0405405405405405;0.459459459459459
Control.SRR15539832;35;38;0.457142857142857;19;16;0.0428571428571429;0.457142857142857
Control.SRR15539832;38;38;0.342105263157895;25;13;0.157894736842105;0.342105263157895
Control.SRR15539832;37;38;0.621621621621622;14;23;0.121621621621622;0.378378378378378
Control.SRR15539832;39;38;0.461538461538462;21;18;0.0384615384615384;0.461538461538462
Control.SRR15539832;30;38;0.466666666666667;16;14;0.0333333333333333;0.466666666666667
Control.SRR15539832;32;38;0.59375;13;19;0.09375;0.40625
Control.SRR15539832;34;38;0.558823529411765;15;19;0.0588235294117647;0.441176470588235
Control.SRR15539832;33;38;0.454545454545455;18;15;0.0454545454545455;0.454545454545455
Control.SRR15539832;30;38;0.433333333333333;17;13;0.0666666666666667;0.433333333333333
Control.SRR15539832;38;38;0.631578947368421;14;24;0.131578947368421;0.368421052631579
Control.SRR15539832;38;38;0.473684210526316;20;18;0.0263157894736842;0.473684210526316
Control.SRR15539832;34;38;0.352941176470588;22;12;0.147058823529412;0.352941176470588
Control.SRR15539832;37;38;0.432432432432432;21;16;0.0675675675675675;0.432432432432432
Control.SRR15539832;39;38;0.512820512820513;19;20;0.0128205128205128;0.487179487179487
Control.SRR15539832;32;38;0.625;12;20;0.125;0.375
Control.SRR15539832;31;38;0.483870967741935;16;15;0.0161290322580645;0.483870967741935
Control.SRR15539832;40;38;0.525;19;21;0.025;0.475
Control.SRR15539832;35;38;0.371428571428571;22;13;0.128571428571429;0.371428571428571
Control.SRR15539832;30;38;0.5;15;15;0;0.5
Control.SRR15539832;35;38;0.542857142857143;16;19;0.0428571428571428;0.457142857142857
Control.SRR15539832;35;38;0.457142857142857;19;16;0.0428571428571429;0.457142857142857
Control.SRR15539832;32;38;0.625;12;20;0.125;0.375
Control.SRR15539832;34;38;0.5;17;17;0;0.5
Control.SRR15539832;36;38;0.722222222222222;10;26;0.222222222222222;0.277777777777778
Control.SRR15539832;38;38;0.473684210526316;20;18;0.0263157894736842;0.473684210526316
Control.SRR15539832;35;38;0.657142857142857;12;23;0.157142857142857;0.342857142857143
Control.SRR15539832;36;38;0.527777777777778;17;19;0.0277777777777778;0.472222222222222
Control.SRR15539832;32;38;0.5625;14;18;0.0625;0.4375
Control.SRR15539832;37;38;0.594594594594595;15;22;0.0945945945945946;0.405405405405405
Control.SRR15539832;39;38;0.615384615384615;15;24;0.115384615384615;0.384615384615385
Control.SRR15539832;37;38;0.405405405405405;22;15;0.0945945945945946;0.405405405405405
Control.SRR15539832;34;38;0.558823529411765;15;19;0.0588235294117647;0.441176470588235
Control.SRR15539832;35;38;0.542857142857143;16;19;0.0428571428571428;0.457142857142857
Control.SRR15539832;32;38;0.53125;15;17;0.03125;0.46875
Control.SRR15539832;37;38;0.378378378378378;23;14;0.121621621621622;0.378378378378378
Control.SRR15539832;37;38;0.459459459459459;20;17;0.0405405405405405;0.459459459459459
Control.SRR15539832;32;38;0.71875;9;23;0.21875;0.28125
Control.SRR15539832;35;38;0.485714285714286;18;17;0.0142857142857143;0.485714285714286
Control.SRR15539832;31;38;0.548387096774194;14;17;0.0483870967741935;0.451612903225806
Control.SRR15539832;38;38;0.552631578947368;17;21;0.0526315789473685;0.447368421052632
Control.SRR15539832;39;38;0.538461538461538;18;21;0.0384615384615384;0.461538461538462
Control.SRR15539832;33;38;0.515151515151515;16;17;0.0151515151515151;0.484848484848485
Control.SRR15539832;32;38;0.40625;19;13;0.09375;0.40625
Control.SRR15539832;38;38;0.552631578947368;17;21;0.0526315789473685;0.447368421052632
Control.SRR15539832;40;38;0.5;20;20;0;0.5
Control.SRR15539832;36;38;0.555555555555556;16;20;0.0555555555555556;0.444444444444444
Control.SRR15539832;40;38;0.5;20;20;0;0.5
Control.SRR15539832;38;38;0.421052631578947;22;16;0.0789473684210527;0.421052631578947
Control.SRR15539832;37;38;0.432432432432432;21;16;0.0675675675675675;0.432432432432432
Control.SRR15539832;33;38;0.515151515151515;16;17;0.0151515151515151;0.484848484848485
Control.SRR15539832;34;38;0.558823529411765;15;19;0.0588235294117647;0.441176470588235
Control.SRR15539832;33;38;0.545454545454545;15;18;0.0454545454545454;0.454545454545455
Control.SRR15539832;31;38;0.32258064516129;21;10;0.17741935483871;0.32258064516129
Control.SRR15539832;39;38;0.435897435897436;22;17;0.0641025641025641;0.435897435897436
Control.SRR15539832;36;38;0.555555555555556;16;20;0.0555555555555556;0.444444444444444
Control.SRR15539832;34;38;0.617647058823529;13;21;0.117647058823529;0.382352941176471
Control.SRR15539832;39;38;0.58974358974359;16;23;0.0897435897435898;0.41025641025641
Control.SRR15539832;35;38;0.542857142857143;16;19;0.0428571428571428;0.457142857142857
Control.SRR15539832;33;38;0.515151515151515;16;17;0.0151515151515151;0.484848484848485
Control.SRR15539832;31;38;0.548387096774194;14;17;0.0483870967741935;0.451612903225806
Control.SRR15539832;36;38;0.583333333333333;15;21;0.0833333333333334;0.416666666666667
Control.SRR15539832;31;38;0.483870967741935;16;15;0.0161290322580645;0.483870967741935
Control.SRR15539832;39;38;0.487179487179487;20;19;0.0128205128205128;0.487179487179487
Control.SRR15539832;35;38;0.542857142857143;16;19;0.0428571428571428;0.457142857142857
Control.SRR15539832;30;38;0.533333333333333;14;16;0.0333333333333333;0.466666666666667
Control.SRR15539832;32;38;0.3125;22;10;0.1875;0.3125
Control.SRR15539832;39;38;0.512820512820513;19;20;0.0128205128205128;0.487179487179487
Control.SRR15539832;33;38;0.696969696969697;10;23;0.196969696969697;0.303030303030303
Control.SRR15539832;37;38;0.243243243243243;28;9;0.256756756756757;0.243243243243243
Control.SRR15539832;40;38;0.525;19;21;0.025;0.475
Control.SRR15539832;39;38;0.384615384615385;24;15;0.115384615384615;0.384615384615385
Control.SRR15539832;31;38;0.32258064516129;21;10;0.17741935483871;0.32258064516129
Control.SRR15539832;39;38;0.461538461538462;21;18;0.0384615384615384;0.461538461538462
Control.SRR15539832;36;38;0.555555555555556;16;20;0.0555555555555556;0.444444444444444
Control.SRR15539832;37;38;0.405405405405405;22;15;0.0945945945945946;0.405405405405405
Control.SRR15539832;37;38;0.621621621621622;14;23;0.121621621621622;0.378378378378378
Control.SRR15539832;35;38;0.6;14;21;0.1;0.4
Control.SRR15539832;37;38;0.459459459459459;20;17;0.0405405405405405;0.459459459459459
Control.SRR15539832;35;38;0.485714285714286;18;17;0.0142857142857143;0.485714285714286
Control.SRR15539832;36;38;0.416666666666667;21;15;0.0833333333333333;0.416666666666667
Control.SRR15539832;37;38;0.459459459459459;20;17;0.0405405405405405;0.459459459459459
Control.SRR15539832;34;38;0.558823529411765;15;19;0.0588235294117647;0.441176470588235
Control.SRR15539832;35;38;0.457142857142857;19;16;0.0428571428571429;0.457142857142857
Control.SRR15539832;33;38;0.545454545454545;15;18;0.0454545454545454;0.454545454545455
Control.SRR15539832;30;38;0.566666666666667;13;17;0.0666666666666667;0.433333333333333
Control.SRR15539832;37;38;0.540540540540541;17;20;0.0405405405405406;0.459459459459459
Control.SRR15539832;39;38;0.564102564102564;17;22;0.0641025641025641;0.435897435897436
Control.SRR15539832;38;38;0.289473684210526;27;11;0.210526315789474;0.289473684210526
Control.SRR15539832;37;38;0.405405405405405;22;15;0.0945945945945946;0.405405405405405
Control.SRR15539832;38;38;0.421052631578947;22;16;0.0789473684210527;0.421052631578947
Control.SRR15539832;32;38;0.5625;14;18;0.0625;0.4375
Control.SRR15539832;33;38;0.515151515151515;16;17;0.0151515151515151;0.484848484848485
Control.SRR15539832;38;38;0.5;19;19;0;0.5
Control.SRR15539832;31;38;0.67741935483871;10;21;0.17741935483871;0.32258064516129
Control.SRR15539832;31;38;0.483870967741935;16;15;0.0161290322580645;0.483870967741935
Control.SRR15539832;30;38;0.566666666666667;13;17;0.0666666666666667;0.433333333333333
Control.SRR15539832;30;38;0.566666666666667;13;17;0.0666666666666667;0.433333333333333
Control.SRR15539832;36;38;0.416666666666667;21;15;0.0833333333333333;0.416666666666667
Control.SRR15539832;36;38;0.555555555555556;16;20;0.0555555555555556;0.444444444444444
Control.SRR15539832;34;38;0.470588235294118;18;16;0.0294117647058824;0.470588235294118
Control.SRR15539832;37;38;0.405405405405405;22;15;0.0945945945945946;0.405405405405405
Control.SRR15539832;35;38;0.542857142857143;16;19;0.0428571428571428;0.457142857142857
Control.SRR15539832;34;38;0.411764705882353;20;14;0.0882352941176471;0.411764705882353
Control.SRR15539832;34;38;0.411764705882353;20;14;0.0882352941176471;0.411764705882353
Control.SRR15539832;35;38;0.371428571428571;22;13;0.128571428571429;0.371428571428571
Control.SRR15539832;39;38;0.435897435897436;22;17;0.0641025641025641;0.435897435897436
Control.SRR15539832;33;38;0.393939393939394;20;13;0.106060606060606;0.393939393939394
Control.SRR15539832;30;38;0.633333333333333;11;19;0.133333333333333;0.366666666666667
Control.SRR15539832;32;38;0.46875;17;15;0.03125;0.46875
Control.SRR15539832;35;38;0.514285714285714;17;18;0.0142857142857142;0.485714285714286
Control.SRR15539832;35;38;0.485714285714286;18;17;0.0142857142857143;0.485714285714286
Control.SRR15539832;33;38;0.515151515151515;16;17;0.0151515151515151;0.484848484848485
Control.SRR15539832;38;38;0.473684210526316;20;18;0.0263157894736842;0.473684210526316
Control.SRR15539832;37;38;0.351351351351351;24;13;0.148648648648649;0.351351351351351
Control.SRR15539832;37;38;0.486486486486487;19;18;0.0135135135135135;0.486486486486487
Control.SRR15539832;39;38;0.435897435897436;22;17;0.0641025641025641;0.435897435897436
Control.SRR15539832;32;38;0.34375;21;11;0.15625;0.34375
Control.SRR15539832;32;38;0.4375;18;14;0.0625;0.4375
Control.SRR15539832;31;38;0.548387096774194;14;17;0.0483870967741935;0.451612903225806
Control.SRR15539832;31;38;0.612903225806452;12;19;0.112903225806452;0.387096774193548
Control.SRR15539832;36;38;0.472222222222222;19;17;0.0277777777777778;0.472222222222222
Control.SRR15539832;30;38;0.566666666666667;13;17;0.0666666666666667;0.433333333333333
Control.SRR15539832;40;38;0.375;25;15;0.125;0.375
Control.SRR15539832;31;38;0.483870967741935;16;15;0.0161290322580645;0.483870967741935
Control.SRR15539832;36;38;0.388888888888889;22;14;0.111111111111111;0.388888888888889
Control.SRR15539832;35;38;0.657142857142857;12;23;0.157142857142857;0.342857142857143
Control.SRR15539832;35;38;0.4;21;14;0.1;0.4
Control.SRR15539832;33;38;0.363636363636364;21;12;0.136363636363636;0.363636363636364
Control.SRR15539832;30;38;0.433333333333333;17;13;0.0666666666666667;0.433333333333333
Control.SRR15539832;32;38;0.71875;9;23;0.21875;0.28125
Control.SRR15539832;31;38;0.516129032258065;15;16;0.0161290322580645;0.483870967741935
Control.SRR15539832;32;38;0.5625;14;18;0.0625;0.4375
Control.SRR15539832;35;38;0.457142857142857;19;16;0.0428571428571429;0.457142857142857
Control.SRR15539832;33;38;0.636363636363636;12;21;0.136363636363636;0.363636363636364
Control.SRR15539832;30;38;0.4;18;12;0.1;0.4
Control.SRR15539832;30;38;0.633333333333333;11;19;0.133333333333333;0.366666666666667
Control.SRR15539832;31;38;0.548387096774194;14;17;0.0483870967741935;0.451612903225806
Control.SRR15539832;39;38;0.615384615384615;15;24;0.115384615384615;0.384615384615385
Control.SRR15539832;34;38;0.529411764705882;16;18;0.0294117647058824;0.470588235294118
Control.SRR15539832;33;38;0.575757575757576;14;19;0.0757575757575758;0.424242424242424
Control.SRR15539832;30;38;0.4;18;12;0.1;0.4
Control.SRR15539832;36;38;0.416666666666667;21;15;0.0833333333333333;0.416666666666667
Control.SRR15539832;30;38;0.5;15;15;0;0.5
Control.SRR15539832;30;38;0.5;15;15;0;0.5
Control.SRR15539832;31;38;0.516129032258065;15;16;0.0161290322580645;0.483870967741935
Control.SRR15539832;35;38;0.485714285714286;18;17;0.0142857142857143;0.485714285714286
Control.SRR15539832;30;38;0.4;18;12;0.1;0.4
Control.SRR15539832;38;38;0.631578947368421;14;24;0.131578947368421;0.368421052631579
Control.SRR15539832;40;38;0.475;21;19;0.025;0.475
Control.SRR15539832;38;38;0.394736842105263;23;15;0.105263157894737;0.394736842105263
Control.SRR15539832;37;38;0.486486486486487;19;18;0.0135135135135135;0.486486486486487
Control.SRR15539832;31;38;0.516129032258065;15;16;0.0161290322580645;0.483870967741935
Control.SRR15539832;36;38;0.444444444444444;20;16;0.0555555555555556;0.444444444444444
Control.SRR15539832;36;38;0.611111111111111;14;22;0.111111111111111;0.388888888888889
Control.SRR15539832;34;38;0.529411764705882;16;18;0.0294117647058824;0.470588235294118
Control.SRR15539832;36;38;0.388888888888889;22;14;0.111111111111111;0.388888888888889
Control.SRR15539832;30;38;0.5;15;15;0;0.5
Control.SRR15539832;38;38;0.605263157894737;15;23;0.105263157894737;0.394736842105263
Control.SRR15539832;33;38;0.454545454545455;18;15;0.0454545454545455;0.454545454545455
Control.SRR15539832;40;38;0.5;20;20;0;0.5
Control.SRR15539832;30;38;0.566666666666667;13;17;0.0666666666666667;0.433333333333333
Control.SRR15539832;40;38;0.475;21;19;0.025;0.475
Control.SRR15539832;40;38;0.575;17;23;0.075;0.425
Control.SRR15539832;40;38;0.6;16;24;0.1;0.4
Control.SRR15539832;32;38;0.40625;19;13;0.09375;0.40625
Control.SRR15539832;35;38;0.514285714285714;17;18;0.0142857142857142;0.485714285714286
Control.SRR15539832;37;38;0.513513513513513;18;19;0.0135135135135135;0.486486486486487
Control.SRR15539832;31;38;0.32258064516129;21;10;0.17741935483871;0.32258064516129
Control.SRR15539832;32;38;0.375;20;12;0.125;0.375
Control.SRR15539832;40;38;0.425;23;17;0.075;0.425
Control.SRR15539832;38;38;0.473684210526316;20;18;0.0263157894736842;0.473684210526316
Control.SRR15539832;37;38;0.621621621621622;14;23;0.121621621621622;0.378378378378378
Control.SRR15539832;38;38;0.605263157894737;15;23;0.105263157894737;0.394736842105263
Control.SRR15539832;34;38;0.558823529411765;15;19;0.0588235294117647;0.441176470588235
Control.SRR15539832;30;38;0.5;15;15;0;0.5
Control.SRR15539832;36;38;0.638888888888889;13;23;0.138888888888889;0.361111111111111
Control.SRR15539832;35;38;0.485714285714286;18;17;0.0142857142857143;0.485714285714286
Control.SRR15539832;35;38;0.571428571428571;15;20;0.0714285714285714;0.428571428571429
Control.SRR15539832;37;38;0.459459459459459;20;17;0.0405405405405405;0.459459459459459
Control.SRR15539832;36;38;0.388888888888889;22;14;0.111111111111111;0.388888888888889
Control.SRR15539832;39;38;0.358974358974359;25;14;0.141025641025641;0.358974358974359
Control.SRR15539832;31;38;0.645161290322581;11;20;0.145161290322581;0.354838709677419
Control.SRR15539832;31;38;0.483870967741935;16;15;0.0161290322580645;0.483870967741935
Control.SRR15539832;35;38;0.371428571428571;22;13;0.128571428571429;0.371428571428571
Control.SRR15539832;35;38;0.4;21;14;0.1;0.4
Control.SRR15539832;39;38;0.512820512820513;19;20;0.0128205128205128;0.487179487179487
Control.SRR15539832;35;38;0.485714285714286;18;17;0.0142857142857143;0.485714285714286
Control.SRR15539832;40;38;0.425;23;17;0.075;0.425
Control.SRR15539832;34;38;0.588235294117647;14;20;0.0882352941176471;0.411764705882353
Control.SRR15539832;40;38;0.55;18;22;0.05;0.45
Control.SRR15539832;32;38;0.46875;17;15;0.03125;0.46875
Control.SRR15539832;36;38;0.416666666666667;21;15;0.0833333333333333;0.416666666666667
Control.SRR15539832;34;38;0.411764705882353;20;14;0.0882352941176471;0.411764705882353
Control.SRR15539832;37;38;0.459459459459459;20;17;0.0405405405405405;0.459459459459459
Control.SRR15539832;36;38;0.5;18;18;0;0.5
Control.SRR15539832;37;38;0.432432432432432;21;16;0.0675675675675675;0.432432432432432
Control.SRR15539832;34;38;0.441176470588235;19;15;0.0588235294117647;0.441176470588235
Control.SRR15539832;35;38;0.428571428571429;20;15;0.0714285714285715;0.428571428571429
Control.SRR15539832;37;38;0.540540540540541;17;20;0.0405405405405406;0.459459459459459
Control.SRR15539832;38;38;0.473684210526316;20;18;0.0263157894736842;0.473684210526316
Control.SRR15539832;38;38;0.473684210526316;20;18;0.0263157894736842;0.473684210526316
Control.SRR15539832;31;38;0.419354838709677;18;13;0.0806451612903226;0.419354838709677
Control.SRR15539832;37;38;0.432432432432432;21;16;0.0675675675675675;0.432432432432432
Control.SRR15539832;37;38;0.513513513513513;18;19;0.0135135135135135;0.486486486486487
Control.SRR15539832;32;38;0.40625;19;13;0.09375;0.40625
Control.SRR15539832;32;38;0.6875;10;22;0.1875;0.3125
Control.SRR15539832;40;38;0.55;18;22;0.05;0.45
Control.SRR15539832;35;38;0.371428571428571;22;13;0.128571428571429;0.371428571428571
Control.SRR15539832;34;38;0.676470588235294;11;23;0.176470588235294;0.323529411764706
Control.SRR15539832;39;38;0.641025641025641;14;25;0.141025641025641;0.358974358974359
Control.SRR15539832;36;38;0.5;18;18;0;0.5
Control.SRR15539832;39;38;0.564102564102564;17;22;0.0641025641025641;0.435897435897436
Control.SRR15539832;40;38;0.475;21;19;0.025;0.475
Control.SRR15539832;39;38;0.461538461538462;21;18;0.0384615384615384;0.461538461538462
Control.SRR15539832;36;38;0.472222222222222;19;17;0.0277777777777778;0.472222222222222
Control.SRR15539832;38;38;0.552631578947368;17;21;0.0526315789473685;0.447368421052632
Control.SRR15539832;31;38;0.580645161290323;13;18;0.0806451612903226;0.419354838709677
Control.SRR15539832;36;38;0.638888888888889;13;23;0.138888888888889;0.361111111111111
Control.SRR15539832;34;38;0.529411764705882;16;18;0.0294117647058824;0.470588235294118
Control.SRR15539832;38;38;0.447368421052632;21;17;0.0526315789473684;0.447368421052632
Control.SRR15539832;31;38;0.483870967741935;16;15;0.0161290322580645;0.483870967741935
Control.SRR15539832;31;38;0.451612903225806;17;14;0.0483870967741936;0.451612903225806
Control.SRR15539832;31;38;0.516129032258065;15;16;0.0161290322580645;0.483870967741935
Control.SRR15539832;31;38;0.516129032258065;15;16;0.0161290322580645;0.483870967741935
Control.SRR15539832;35;38;0.457142857142857;19;16;0.0428571428571429;0.457142857142857
Control.SRR15539832;32;38;0.375;20;12;0.125;0.375
Control.SRR15539832;38;38;0.368421052631579;24;14;0.131578947368421;0.368421052631579
Control.SRR15539832;40;38;0.575;17;23;0.075;0.425
Control.SRR15539832;39;38;0.512820512820513;19;20;0.0128205128205128;0.487179487179487
Control.SRR15539832;34;38;0.470588235294118;18;16;0.0294117647058824;0.470588235294118
Control.SRR15539832;40;38;0.575;17;23;0.075;0.425
Control.SRR15539832;36;38;0.472222222222222;19;17;0.0277777777777778;0.472222222222222
Control.SRR15539832;40;38;0.525;19;21;0.025;0.475
Control.SRR15539832;40;38;0.475;21;19;0.025;0.475
Control.SRR15539832;35;38;0.485714285714286;18;17;0.0142857142857143;0.485714285714286
Control.SRR15539832;30;38;0.433333333333333;17;13;0.0666666666666667;0.433333333333333
Control.SRR15539832;35;38;0.6;14;21;0.1;0.4
Control.SRR15539832;35;38;0.428571428571429;20;15;0.0714285714285715;0.428571428571429
Control.SRR15539832;40;38;0.45;22;18;0.05;0.45
Control.SRR15539832;32;38;0.46875;17;15;0.03125;0.46875
Control.SRR15539832;35;38;0.657142857142857;12;23;0.157142857142857;0.342857142857143
Control.SRR15539832;30;38;0.666666666666667;10;20;0.166666666666667;0.333333333333333
Control.SRR15539832;32;38;0.53125;15;17;0.03125;0.46875
Control.SRR15539832;35;38;0.542857142857143;16;19;0.0428571428571428;0.457142857142857
Control.SRR15539832;35;38;0.628571428571429;13;22;0.128571428571429;0.371428571428571
Control.SRR15539832;33;38;0.393939393939394;20;13;0.106060606060606;0.393939393939394
Control.SRR15539832;33;38;0.515151515151515;16;17;0.0151515151515151;0.484848484848485
Control.SRR15539832;38;38;0.447368421052632;21;17;0.0526315789473684;0.447368421052632
Control.SRR15539832;35;38;0.485714285714286;18;17;0.0142857142857143;0.485714285714286
Control.SRR15539832;40;38;0.45;22;18;0.05;0.45
Control.SRR15539832;40;38;0.525;19;21;0.025;0.475
Control.SRR15539832;38;38;0.578947368421053;16;22;0.0789473684210527;0.421052631578947
Control.SRR15539832;33;38;0.545454545454545;15;18;0.0454545454545454;0.454545454545455
Control.SRR15539832;40;38;0.625;15;25;0.125;0.375
Control.SRR15539832;34;38;0.470588235294118;18;16;0.0294117647058824;0.470588235294118
Control.SRR15539832;39;38;0.41025641025641;23;16;0.0897435897435898;0.41025641025641
Control.SRR15539832;34;38;0.529411764705882;16;18;0.0294117647058824;0.470588235294118
Control.SRR15539832;36;38;0.444444444444444;20;16;0.0555555555555556;0.444444444444444
Control.SRR15539832;30;38;0.533333333333333;14;16;0.0333333333333333;0.466666666666667
Control.SRR15539832;33;38;0.484848484848485;17;16;0.0151515151515151;0.484848484848485
Control.SRR15539832;31;38;0.32258064516129;21;10;0.17741935483871;0.32258064516129
Control.SRR15539832;38;38;0.5;19;19;0;0.5
Control.SRR15539832;39;38;0.435897435897436;22;17;0.0641025641025641;0.435897435897436
Control.SRR15539832;34;38;0.5;17;17;0;0.5
Control.SRR15539832;38;38;0.605263157894737;15;23;0.105263157894737;0.394736842105263
Control.SRR15539832;38;38;0.5;19;19;0;0.5
Control.SRR15539832;35;38;0.514285714285714;17;18;0.0142857142857142;0.485714285714286
Control.SRR15539832;36;38;0.416666666666667;21;15;0.0833333333333333;0.416666666666667
Control.SRR15539832;36;38;0.472222222222222;19;17;0.0277777777777778;0.472222222222222
Control.SRR15539832;34;38;0.558823529411765;15;19;0.0588235294117647;0.441176470588235
Control.SRR15539832;38;38;0.473684210526316;20;18;0.0263157894736842;0.473684210526316
Control.SRR15539832;39;38;0.487179487179487;20;19;0.0128205128205128;0.487179487179487
Control.SRR15539832;40;38;0.425;23;17;0.075;0.425
Control.SRR15539832;35;38;0.371428571428571;22;13;0.128571428571429;0.371428571428571
Control.SRR15539832;38;38;0.552631578947368;17;21;0.0526315789473685;0.447368421052632
Control.SRR15539832;31;38;0.483870967741935;16;15;0.0161290322580645;0.483870967741935
Control.SRR15539832;38;38;0.578947368421053;16;22;0.0789473684210527;0.421052631578947
Control.SRR15539832;40;38;0.45;22;18;0.05;0.45
Control.SRR15539832;34;38;0.529411764705882;16;18;0.0294117647058824;0.470588235294118
Control.SRR15539832;30;38;0.333333333333333;20;10;0.166666666666667;0.333333333333333
Control.SRR15539832;39;38;0.538461538461538;18;21;0.0384615384615384;0.461538461538462
Control.SRR15539832;37;38;0.486486486486487;19;18;0.0135135135135135;0.486486486486487
Control.SRR15539832;37;38;0.459459459459459;20;17;0.0405405405405405;0.459459459459459
Control.SRR15539832;35;38;0.514285714285714;17;18;0.0142857142857142;0.485714285714286
Control.SRR15539832;37;38;0.459459459459459;20;17;0.0405405405405405;0.459459459459459
Control.SRR15539832;31;38;0.548387096774194;14;17;0.0483870967741935;0.451612903225806
Control.SRR15539832;35;38;0.457142857142857;19;16;0.0428571428571429;0.457142857142857
Control.SRR15539832;39;38;0.58974358974359;16;23;0.0897435897435898;0.41025641025641
Control.SRR15539832;38;38;0.631578947368421;14;24;0.131578947368421;0.368421052631579
Control.SRR15539832;33;38;0.545454545454545;15;18;0.0454545454545454;0.454545454545455
Control.SRR15539832;33;38;0.484848484848485;17;16;0.0151515151515151;0.484848484848485
Control.SRR15539832;39;38;0.512820512820513;19;20;0.0128205128205128;0.487179487179487
Control.SRR15539832;31;38;0.451612903225806;17;14;0.0483870967741936;0.451612903225806
Control.SRR15539832;31;38;0.580645161290323;13;18;0.0806451612903226;0.419354838709677
Control.SRR15539832;40;38;0.625;15;25;0.125;0.375
Control.SRR15539832;34;38;0.5;17;17;0;0.5
Control.SRR15539832;40;38;0.475;21;19;0.025;0.475
Control.SRR15539832;32;38;0.5;16;16;0;0.5
Control.SRR15539832;32;38;0.40625;19;13;0.09375;0.40625
Control.SRR15539832;32;38;0.5;16;16;0;0.5
Control.SRR15539832;33;38;0.515151515151515;16;17;0.0151515151515151;0.484848484848485
Control.SRR15539832;34;38;0.470588235294118;18;16;0.0294117647058824;0.470588235294118
Control.SRR15539832;39;38;0.564102564102564;17;22;0.0641025641025641;0.435897435897436
Control.SRR15539832;39;38;0.333333333333333;26;13;0.166666666666667;0.333333333333333
Control.SRR15539832;31;38;0.419354838709677;18;13;0.0806451612903226;0.419354838709677
Control.SRR15539832;37;38;0.513513513513513;18;19;0.0135135135135135;0.486486486486487
Control.SRR15539832;34;38;0.470588235294118;18;16;0.0294117647058824;0.470588235294118
Control.SRR15539832;40;38;0.675;13;27;0.175;0.325
Control.SRR15539832;40;38;0.5;20;20;0;0.5
Control.SRR15539832;36;38;0.583333333333333;15;21;0.0833333333333334;0.416666666666667
Control.SRR15539832;30;38;0.466666666666667;16;14;0.0333333333333333;0.466666666666667
Control.SRR15539832;36;38;0.555555555555556;16;20;0.0555555555555556;0.444444444444444
Control.SRR15539832;30;38;0.366666666666667;19;11;0.133333333333333;0.366666666666667
Control.SRR15539832;35;38;0.514285714285714;17;18;0.0142857142857142;0.485714285714286
Control.SRR15539832;35;38;0.428571428571429;20;15;0.0714285714285715;0.428571428571429
Control.SRR15539832;31;38;0.387096774193548;19;12;0.112903225806452;0.387096774193548
Control.SRR15539832;31;38;0.516129032258065;15;16;0.0161290322580645;0.483870967741935
Control.SRR15539832;35;38;0.571428571428571;15;20;0.0714285714285714;0.428571428571429
Control.SRR15539832;40;38;0.45;22;18;0.05;0.45
Control.SRR15539832;37;38;0.432432432432432;21;16;0.0675675675675675;0.432432432432432
Control.SRR15539832;39;38;0.461538461538462;21;18;0.0384615384615384;0.461538461538462
Control.SRR15539832;38;38;0.421052631578947;22;16;0.0789473684210527;0.421052631578947
Control.SRR15539832;37;38;0.405405405405405;22;15;0.0945945945945946;0.405405405405405
Control.SRR15539832;35;38;0.685714285714286;11;24;0.185714285714286;0.314285714285714
Control.SRR15539832;37;38;0.648648648648649;13;24;0.148648648648649;0.351351351351351
Control.SRR15539832;31;38;0.516129032258065;15;16;0.0161290322580645;0.483870967741935
Control.SRR15539832;39;38;0.487179487179487;20;19;0.0128205128205128;0.487179487179487
Control.SRR15539832;38;38;0.526315789473684;18;20;0.0263157894736842;0.473684210526316
Control.SRR15539832;32;38;0.40625;19;13;0.09375;0.40625
Control.SRR15539832;30;38;0.333333333333333;20;10;0.166666666666667;0.333333333333333
Control.SRR15539832;36;38;0.388888888888889;22;14;0.111111111111111;0.388888888888889
Control.SRR15539832;35;38;0.542857142857143;16;19;0.0428571428571428;0.457142857142857
Control.SRR15539832;36;38;0.555555555555556;16;20;0.0555555555555556;0.444444444444444
Control.SRR15539832;30;38;0.566666666666667;13;17;0.0666666666666667;0.433333333333333
Control.SRR15539832;31;38;0.548387096774194;14;17;0.0483870967741935;0.451612903225806
Control.SRR15539832;36;38;0.472222222222222;19;17;0.0277777777777778;0.472222222222222
Control.SRR15539832;35;38;0.457142857142857;19;16;0.0428571428571429;0.457142857142857
Control.SRR15539832;37;38;0.648648648648649;13;24;0.148648648648649;0.351351351351351
Control.SRR15539832;36;38;0.583333333333333;15;21;0.0833333333333334;0.416666666666667
Control.SRR15539832;38;38;0.526315789473684;18;20;0.0263157894736842;0.473684210526316
Control.SRR15539832;31;38;0.419354838709677;18;13;0.0806451612903226;0.419354838709677
Control.SRR15539832;33;38;0.424242424242424;19;14;0.0757575757575757;0.424242424242424
Control.SRR15539832;39;38;0.461538461538462;21;18;0.0384615384615384;0.461538461538462
Control.SRR15539832;38;38;0.526315789473684;18;20;0.0263157894736842;0.473684210526316
Control.SRR15539832;40;38;0.5;20;20;0;0.5
Control.SRR15539832;35;38;0.457142857142857;19;16;0.0428571428571429;0.457142857142857
Control.SRR15539832;37;38;0.459459459459459;20;17;0.0405405405405405;0.459459459459459
Control.SRR15539832;39;38;0.384615384615385;24;15;0.115384615384615;0.384615384615385
Control.SRR15539832;34;38;0.5;17;17;0;0.5
Control.SRR15539832;32;38;0.5;16;16;0;0.5
Control.SRR15539832;35;38;0.514285714285714;17;18;0.0142857142857142;0.485714285714286
Control.SRR15539832;30;38;0.566666666666667;13;17;0.0666666666666667;0.433333333333333
Control.SRR15539832;31;38;0.548387096774194;14;17;0.0483870967741935;0.451612903225806
Control.SRR15539832;30;38;0.466666666666667;16;14;0.0333333333333333;0.466666666666667
Control.SRR15539832;33;38;0.454545454545455;18;15;0.0454545454545455;0.454545454545455
Control.SRR15539832;39;38;0.487179487179487;20;19;0.0128205128205128;0.487179487179487
Control.SRR15539832;36;38;0.583333333333333;15;21;0.0833333333333334;0.416666666666667
Control.SRR15539832;38;38;0.631578947368421;14;24;0.131578947368421;0.368421052631579
Control.SRR15539832;34;38;0.558823529411765;15;19;0.0588235294117647;0.441176470588235
Control.SRR15539832;37;38;0.459459459459459;20;17;0.0405405405405405;0.459459459459459
Control.SRR15539832;35;38;0.571428571428571;15;20;0.0714285714285714;0.428571428571429
Control.SRR15539832;34;38;0.411764705882353;20;14;0.0882352941176471;0.411764705882353
Control.SRR15539832;30;38;0.5;15;15;0;0.5
Control.SRR15539832;33;38;0.454545454545455;18;15;0.0454545454545455;0.454545454545455
Control.SRR15539832;32;38;0.46875;17;15;0.03125;0.46875
Control.SRR15539832;33;38;0.393939393939394;20;13;0.106060606060606;0.393939393939394
Control.SRR15539832;33;38;0.515151515151515;16;17;0.0151515151515151;0.484848484848485
Control.SRR15539832;36;38;0.527777777777778;17;19;0.0277777777777778;0.472222222222222
Control.SRR15539832;31;38;0.419354838709677;18;13;0.0806451612903226;0.419354838709677
Control.SRR15539832;31;38;0.580645161290323;13;18;0.0806451612903226;0.419354838709677
Control.SRR15539832;33;38;0.575757575757576;14;19;0.0757575757575758;0.424242424242424
Control.SRR15539832;30;38;0.466666666666667;16;14;0.0333333333333333;0.466666666666667
Control.SRR15539832;33;38;0.545454545454545;15;18;0.0454545454545454;0.454545454545455
Control.SRR15539832;33;38;0.484848484848485;17;16;0.0151515151515151;0.484848484848485
Control.SRR15539832;30;38;0.633333333333333;11;19;0.133333333333333;0.366666666666667
Control.SRR15539832;33;38;0.606060606060606;13;20;0.106060606060606;0.393939393939394
Control.SRR15539832;31;38;0.580645161290323;13;18;0.0806451612903226;0.419354838709677
Control.SRR15539832;31;38;0.483870967741935;16;15;0.0161290322580645;0.483870967741935
Control.SRR15539832;38;38;0.526315789473684;18;20;0.0263157894736842;0.473684210526316
Control.SRR15539832;32;38;0.40625;19;13;0.09375;0.40625
Control.SRR15539832;37;38;0.432432432432432;21;16;0.0675675675675675;0.432432432432432
Control.SRR15539832;34;38;0.529411764705882;16;18;0.0294117647058824;0.470588235294118
Control.SRR15539832;40;38;0.5;20;20;0;0.5
Control.SRR15539832;31;38;0.483870967741935;16;15;0.0161290322580645;0.483870967741935
Control.SRR15539832;31;38;0.580645161290323;13;18;0.0806451612903226;0.419354838709677
Control.SRR15539832;37;38;0.432432432432432;21;16;0.0675675675675675;0.432432432432432
Control.SRR15539832;36;38;0.611111111111111;14;22;0.111111111111111;0.388888888888889
Control.SRR15539832;35;38;0.342857142857143;23;12;0.157142857142857;0.342857142857143
Control.SRR15539832;30;38;0.5;15;15;0;0.5
Control.SRR15539832;38;38;0.5;19;19;0;0.5
Control.SRR15539832;38;38;0.421052631578947;22;16;0.0789473684210527;0.421052631578947
Control.SRR15539832;36;38;0.583333333333333;15;21;0.0833333333333334;0.416666666666667
Control.SRR15539832;31;38;0.419354838709677;18;13;0.0806451612903226;0.419354838709677
Control.SRR15539832;35;38;0.6;14;21;0.1;0.4
Control.SRR15539832;35;38;0.571428571428571;15;20;0.0714285714285714;0.428571428571429
Control.SRR15539832;33;38;0.393939393939394;20;13;0.106060606060606;0.393939393939394
Control.SRR15539832;37;38;0.513513513513513;18;19;0.0135135135135135;0.486486486486487
Control.SRR15539832;34;38;0.588235294117647;14;20;0.0882352941176471;0.411764705882353
Control.SRR15539832;38;38;0.526315789473684;18;20;0.0263157894736842;0.473684210526316
Control.SRR15539832;40;38;0.675;13;27;0.175;0.325
Control.SRR15539832;38;38;0.605263157894737;15;23;0.105263157894737;0.394736842105263
Control.SRR15539832;31;38;0.451612903225806;17;14;0.0483870967741936;0.451612903225806
Control.SRR15539832;31;38;0.451612903225806;17;14;0.0483870967741936;0.451612903225806
Control.SRR15539832;40;38;0.475;21;19;0.025;0.475
Control.SRR15539832;32;38;0.34375;21;11;0.15625;0.34375
Control.SRR15539832;31;38;0.548387096774194;14;17;0.0483870967741935;0.451612903225806
Control.SRR15539832;35;38;0.457142857142857;19;16;0.0428571428571429;0.457142857142857
Control.SRR15539832;38;38;0.526315789473684;18;20;0.0263157894736842;0.473684210526316
Control.SRR15539832;32;38;0.125;28;4;0.375;0.125
Control.SRR15539832;36;38;0.611111111111111;14;22;0.111111111111111;0.388888888888889
Control.SRR15539832;34;38;0.441176470588235;19;15;0.0588235294117647;0.441176470588235
Control.SRR15539832;35;38;0.457142857142857;19;16;0.0428571428571429;0.457142857142857
Control.SRR15539832;35;38;0.571428571428571;15;20;0.0714285714285714;0.428571428571429
Control.SRR15539832;39;38;0.461538461538462;21;18;0.0384615384615384;0.461538461538462
Control.SRR15539832;39;38;0.564102564102564;17;22;0.0641025641025641;0.435897435897436
Control.SRR15539832;39;38;0.435897435897436;22;17;0.0641025641025641;0.435897435897436
Control.SRR15539832;40;38;0.35;26;14;0.15;0.35
Control.SRR15539832;33;38;0.515151515151515;16;17;0.0151515151515151;0.484848484848485
Control.SRR15539832;37;38;0.486486486486487;19;18;0.0135135135135135;0.486486486486487
Control.SRR15539832;31;38;0.387096774193548;19;12;0.112903225806452;0.387096774193548
Control.SRR15539832;32;38;0.625;12;20;0.125;0.375
Control.SRR15539832;40;38;0.575;17;23;0.075;0.425
Control.SRR15539832;34;38;0.558823529411765;15;19;0.0588235294117647;0.441176470588235
Control.SRR15539832;36;38;0.444444444444444;20;16;0.0555555555555556;0.444444444444444
Control.SRR15539832;39;38;0.615384615384615;15;24;0.115384615384615;0.384615384615385
Control.SRR15539832;30;38;0.466666666666667;16;14;0.0333333333333333;0.466666666666667
Control.SRR15539832;37;38;0.594594594594595;15;22;0.0945945945945946;0.405405405405405
Control.SRR15539832;35;38;0.6;14;21;0.1;0.4
Control.SRR15539832;33;38;0.636363636363636;12;21;0.136363636363636;0.363636363636364
Control.SRR15539832;32;38;0.4375;18;14;0.0625;0.4375
Control.SRR15539832;34;38;0.676470588235294;11;23;0.176470588235294;0.323529411764706
Control.SRR15539832;33;38;0.515151515151515;16;17;0.0151515151515151;0.484848484848485
Control.SRR15539832;38;38;0.578947368421053;16;22;0.0789473684210527;0.421052631578947
Control.SRR15539832;37;38;0.594594594594595;15;22;0.0945945945945946;0.405405405405405
Control.SRR15539832;35;38;0.4;21;14;0.1;0.4
Control.SRR15539832;30;38;0.366666666666667;19;11;0.133333333333333;0.366666666666667
Control.SRR15539832;33;38;0.575757575757576;14;19;0.0757575757575758;0.424242424242424
Control.SRR15539832;39;38;0.487179487179487;20;19;0.0128205128205128;0.487179487179487
Control.SRR15539832;39;38;0.512820512820513;19;20;0.0128205128205128;0.487179487179487
Control.SRR15539832;37;38;0.513513513513513;18;19;0.0135135135135135;0.486486486486487
Control.SRR15539832;32;38;0.5625;14;18;0.0625;0.4375
Control.SRR15539832;40;38;0.5;20;20;0;0.5
Control.SRR15539832;36;38;0.444444444444444;20;16;0.0555555555555556;0.444444444444444
Control.SRR15539832;36;38;0.555555555555556;16;20;0.0555555555555556;0.444444444444444
Control.SRR15539832;35;38;0.514285714285714;17;18;0.0142857142857142;0.485714285714286
Control.SRR15539832;33;38;0.515151515151515;16;17;0.0151515151515151;0.484848484848485
Control.SRR15539832;30;38;0.566666666666667;13;17;0.0666666666666667;0.433333333333333
Control.SRR15539832;37;38;0.513513513513513;18;19;0.0135135135135135;0.486486486486487
Control.SRR15539832;35;38;0.485714285714286;18;17;0.0142857142857143;0.485714285714286
Control.SRR15539832;30;38;0.6;12;18;0.1;0.4
Control.SRR15539832;30;38;0.4;18;12;0.1;0.4
Control.SRR15539832;31;38;0.612903225806452;12;19;0.112903225806452;0.387096774193548
Control.SRR15539832;36;38;0.583333333333333;15;21;0.0833333333333334;0.416666666666667
Control.SRR15539832;37;38;0.459459459459459;20;17;0.0405405405405405;0.459459459459459
Control.SRR15539832;36;38;0.611111111111111;14;22;0.111111111111111;0.388888888888889
Control.SRR15539832;39;38;0.512820512820513;19;20;0.0128205128205128;0.487179487179487
Control.SRR15539832;33;38;0.606060606060606;13;20;0.106060606060606;0.393939393939394
Control.SRR15539832;35;38;0.428571428571429;20;15;0.0714285714285715;0.428571428571429
Control.SRR15539832;36;38;0.638888888888889;13;23;0.138888888888889;0.361111111111111
Control.SRR15539832;30;38;0.433333333333333;17;13;0.0666666666666667;0.433333333333333
Control.SRR15539832;34;38;0.529411764705882;16;18;0.0294117647058824;0.470588235294118
Control.SRR15539832;30;38;0.666666666666667;10;20;0.166666666666667;0.333333333333333
Control.SRR15539832;30;38;0.6;12;18;0.1;0.4
Control.SRR15539832;31;38;0.580645161290323;13;18;0.0806451612903226;0.419354838709677
Control.SRR15539832;46;38;0.630434782608696;17;29;0.130434782608696;0.369565217391304
Control.SRR15539832;43;38;0.395348837209302;26;17;0.104651162790698;0.395348837209302
Control.SRR15539832;39;38;0.41025641025641;23;16;0.0897435897435898;0.41025641025641
Control.SRR15539832;42;38;0.595238095238095;17;25;0.0952380952380952;0.404761904761905
Control.SRR15539832;40;38;0.55;18;22;0.05;0.45
Control.SRR15539832;42;38;0.5;21;21;0;0.5
Control.SRR15539832;44;38;0.568181818181818;19;25;0.0681818181818182;0.431818181818182
Control.SRR15539832;40;38;0.475;21;19;0.025;0.475
Control.SRR15539832;45;38;0.488888888888889;23;22;0.0111111111111111;0.488888888888889
Control.SRR15539832;41;38;0.51219512195122;20;21;0.0121951219512195;0.48780487804878
Control.SRR15539832;46;38;0.5;23;23;0;0.5
Control.SRR15539832;43;38;0.488372093023256;22;21;0.0116279069767442;0.488372093023256
Control.SRR15539832;41;38;0.48780487804878;21;20;0.0121951219512195;0.48780487804878
Control.SRR15539832;44;38;0.431818181818182;25;19;0.0681818181818182;0.431818181818182
Control.SRR15539832;38;38;0.5;19;19;0;0.5
Control.SRR15539832;36;38;0.416666666666667;21;15;0.0833333333333333;0.416666666666667
Control.SRR15539832;40;38;0.575;17;23;0.075;0.425
Control.SRR15539832;36;38;0.583333333333333;15;21;0.0833333333333334;0.416666666666667
Control.SRR15539832;44;38;0.477272727272727;23;21;0.0227272727272727;0.477272727272727
Control.SRR15539832;46;38;0.5;23;23;0;0.5
Control.SRR15539832;39;38;0.487179487179487;20;19;0.0128205128205128;0.487179487179487
Control.SRR15539832;44;38;0.477272727272727;23;21;0.0227272727272727;0.477272727272727
Control.SRR15539832;42;38;0.595238095238095;17;25;0.0952380952380952;0.404761904761905
Control.SRR15539832;41;38;0.560975609756098;18;23;0.0609756097560976;0.439024390243902
Control.SRR15539832;41;38;0.51219512195122;20;21;0.0121951219512195;0.48780487804878
Control.SRR15539832;39;38;0.487179487179487;20;19;0.0128205128205128;0.487179487179487
Control.SRR15539832;43;38;0.511627906976744;21;22;0.0116279069767442;0.488372093023256
Control.SRR15539832;35;38;0.6;14;21;0.1;0.4
Control.SRR15539832;39;38;0.512820512820513;19;20;0.0128205128205128;0.487179487179487
Control.SRR15539832;39;38;0.435897435897436;22;17;0.0641025641025641;0.435897435897436
Control.SRR15539832;37;38;0.378378378378378;23;14;0.121621621621622;0.378378378378378
Control.SRR15539832;45;38;0.444444444444444;25;20;0.0555555555555556;0.444444444444444
Control.SRR15539832;38;38;0.447368421052632;21;17;0.0526315789473684;0.447368421052632
Control.SRR15539832;37;38;0.567567567567568;16;21;0.0675675675675675;0.432432432432432
Control.SRR15539832;39;38;0.641025641025641;14;25;0.141025641025641;0.358974358974359
Control.SRR15539832;40;38;0.575;17;23;0.075;0.425
Control.SRR15539832;43;38;0.488372093023256;22;21;0.0116279069767442;0.488372093023256
Control.SRR15539832;42;38;0.547619047619048;19;23;0.0476190476190477;0.452380952380952
Control.SRR15539832;46;38;0.521739130434783;22;24;0.0217391304347826;0.478260869565217
Control.SRR15539832;41;38;0.439024390243902;23;18;0.0609756097560976;0.439024390243902
Control.SRR15539832;39;38;0.384615384615385;24;15;0.115384615384615;0.384615384615385
Control.SRR15539832;38;38;0.421052631578947;22;16;0.0789473684210527;0.421052631578947
Control.SRR15539832;38;38;0.5;19;19;0;0.5
Control.SRR15539832;36;38;0.472222222222222;19;17;0.0277777777777778;0.472222222222222
Control.SRR15539832;45;38;0.555555555555556;20;25;0.0555555555555556;0.444444444444444
Control.SRR15539832;37;38;0.540540540540541;17;20;0.0405405405405406;0.459459459459459
Control.SRR15539832;36;38;0.444444444444444;20;16;0.0555555555555556;0.444444444444444
Control.SRR15539832;44;38;0.568181818181818;19;25;0.0681818181818182;0.431818181818182
Control.SRR15539832;38;38;0.578947368421053;16;22;0.0789473684210527;0.421052631578947
Control.SRR15539832;40;38;0.425;23;17;0.075;0.425
Control.SRR15539832;43;38;0.372093023255814;27;16;0.127906976744186;0.372093023255814
Control.SRR15539832;45;38;0.466666666666667;24;21;0.0333333333333333;0.466666666666667
Control.SRR15539832;36;38;0.472222222222222;19;17;0.0277777777777778;0.472222222222222
Control.SRR15539832;39;38;0.564102564102564;17;22;0.0641025641025641;0.435897435897436
Control.SRR15539832;37;38;0.567567567567568;16;21;0.0675675675675675;0.432432432432432
Control.SRR15539832;37;38;0.486486486486487;19;18;0.0135135135135135;0.486486486486487
Control.SRR15539832;37;38;0.567567567567568;16;21;0.0675675675675675;0.432432432432432
Control.SRR15539832;45;38;0.533333333333333;21;24;0.0333333333333333;0.466666666666667
Control.SRR15539832;43;38;0.558139534883721;19;24;0.0581395348837209;0.441860465116279
Control.SRR15539832;45;38;0.533333333333333;21;24;0.0333333333333333;0.466666666666667
Control.SRR15539832;42;38;0.666666666666667;14;28;0.166666666666667;0.333333333333333
Control.SRR15539832;39;38;0.538461538461538;18;21;0.0384615384615384;0.461538461538462
Control.SRR15539832;37;38;0.459459459459459;20;17;0.0405405405405405;0.459459459459459
Control.SRR15539832;43;38;0.418604651162791;25;18;0.0813953488372093;0.418604651162791
Control.SRR15539832;45;38;0.444444444444444;25;20;0.0555555555555556;0.444444444444444
Control.SRR15539832;40;38;0.45;22;18;0.05;0.45
Control.SRR15539832;37;38;0.621621621621622;14;23;0.121621621621622;0.378378378378378
Control.SRR15539832;40;38;0.65;14;26;0.15;0.35
Control.SRR15539832;36;38;0.611111111111111;14;22;0.111111111111111;0.388888888888889
Control.SRR15539832;38;38;0.684210526315789;12;26;0.184210526315789;0.315789473684211
Control.SRR15539832;38;38;0.578947368421053;16;22;0.0789473684210527;0.421052631578947
Control.SRR15539832;40;38;0.475;21;19;0.025;0.475
Control.SRR15539832;35;38;0.514285714285714;17;18;0.0142857142857142;0.485714285714286
Control.SRR15539832;35;38;0.571428571428571;15;20;0.0714285714285714;0.428571428571429
Control.SRR15539832;43;38;0.558139534883721;19;24;0.0581395348837209;0.441860465116279
Control.SRR15539832;43;38;0.372093023255814;27;16;0.127906976744186;0.372093023255814
Control.SRR15539832;39;38;0.487179487179487;20;19;0.0128205128205128;0.487179487179487
Control.SRR15539832;40;38;0.475;21;19;0.025;0.475
Control.SRR15539832;35;38;0.542857142857143;16;19;0.0428571428571428;0.457142857142857
Control.SRR15539832;40;38;0.5;20;20;0;0.5
Control.SRR15539832;39;38;0.538461538461538;18;21;0.0384615384615384;0.461538461538462
Control.SRR15539832;41;38;0.51219512195122;20;21;0.0121951219512195;0.48780487804878
Control.SRR15539832;41;38;0.48780487804878;21;20;0.0121951219512195;0.48780487804878
Control.SRR15539832;36;38;0.555555555555556;16;20;0.0555555555555556;0.444444444444444
Control.SRR15539832;38;38;0.421052631578947;22;16;0.0789473684210527;0.421052631578947
Control.SRR15539832;39;38;0.58974358974359;16;23;0.0897435897435898;0.41025641025641
Control.SRR15539832;42;38;0.571428571428571;18;24;0.0714285714285714;0.428571428571429
Control.SRR15539832;38;38;0.421052631578947;22;16;0.0789473684210527;0.421052631578947
Control.SRR15539832;35;38;0.571428571428571;15;20;0.0714285714285714;0.428571428571429
Control.SRR15539832;37;38;0.432432432432432;21;16;0.0675675675675675;0.432432432432432
Control.SRR15539832;37;38;0.621621621621622;14;23;0.121621621621622;0.378378378378378
Control.SRR15539832;38;38;0.473684210526316;20;18;0.0263157894736842;0.473684210526316
Control.SRR15539832;37;38;0.432432432432432;21;16;0.0675675675675675;0.432432432432432
Control.SRR15539832;41;38;0.536585365853659;19;22;0.0365853658536586;0.463414634146341
Control.SRR15539832;36;38;0.5;18;18;0;0.5
Control.SRR15539832;36;38;0.388888888888889;22;14;0.111111111111111;0.388888888888889
Control.SRR15539832;36;38;0.555555555555556;16;20;0.0555555555555556;0.444444444444444
Control.SRR15539832;38;38;0.578947368421053;16;22;0.0789473684210527;0.421052631578947
Control.SRR15539832;38;38;0.394736842105263;23;15;0.105263157894737;0.394736842105263
Control.SRR15539832;44;38;0.522727272727273;21;23;0.0227272727272727;0.477272727272727
Control.SRR15539832;38;38;0.526315789473684;18;20;0.0263157894736842;0.473684210526316
Control.SRR15539832;35;38;0.628571428571429;13;22;0.128571428571429;0.371428571428571
Control.SRR15539832;37;38;0.540540540540541;17;20;0.0405405405405406;0.459459459459459
Control.SRR15539832;41;38;0.536585365853659;19;22;0.0365853658536586;0.463414634146341
Control.SRR15539832;42;38;0.476190476190476;22;20;0.0238095238095238;0.476190476190476
Control.SRR15539832;41;38;0.536585365853659;19;22;0.0365853658536586;0.463414634146341
Control.SRR15539832;38;38;0.578947368421053;16;22;0.0789473684210527;0.421052631578947
Control.SRR15539832;38;38;0.526315789473684;18;20;0.0263157894736842;0.473684210526316
Control.SRR15539832;41;38;0.439024390243902;23;18;0.0609756097560976;0.439024390243902
Control.SRR15539832;44;38;0.636363636363636;16;28;0.136363636363636;0.363636363636364
Control.SRR15539832;37;38;0.567567567567568;16;21;0.0675675675675675;0.432432432432432
Control.SRR15539832;39;38;0.487179487179487;20;19;0.0128205128205128;0.487179487179487
Control.SRR15539832;41;38;0.463414634146341;22;19;0.0365853658536585;0.463414634146341
Control.SRR15539832;38;38;0.394736842105263;23;15;0.105263157894737;0.394736842105263
Control.SRR15539832;37;38;0.459459459459459;20;17;0.0405405405405405;0.459459459459459
Control.SRR15539832;44;38;0.568181818181818;19;25;0.0681818181818182;0.431818181818182
Control.SRR15539832;40;38;0.6;16;24;0.1;0.4
Control.SRR15539832;44;38;0.5;22;22;0;0.5
Control.SRR15539832;40;38;0.475;21;19;0.025;0.475
Control.SRR15539832;37;38;0.378378378378378;23;14;0.121621621621622;0.378378378378378
Control.SRR15539832;40;38;0.625;15;25;0.125;0.375
Control.SRR15539832;36;38;0.472222222222222;19;17;0.0277777777777778;0.472222222222222
Control.SRR15539832;43;38;0.465116279069767;23;20;0.0348837209302326;0.465116279069767
Control.SRR15539832;37;38;0.432432432432432;21;16;0.0675675675675675;0.432432432432432
Control.SRR15539832;37;38;0.567567567567568;16;21;0.0675675675675675;0.432432432432432
Control.SRR15539832;38;38;0.552631578947368;17;21;0.0526315789473685;0.447368421052632
Control.SRR15539832;43;38;0.604651162790698;17;26;0.104651162790698;0.395348837209302
Control.SRR15539832;35;38;0.342857142857143;23;12;0.157142857142857;0.342857142857143
Control.SRR15539832;38;38;0.631578947368421;14;24;0.131578947368421;0.368421052631579
Control.SRR15539832;38;38;0.578947368421053;16;22;0.0789473684210527;0.421052631578947
Control.SRR15539832;36;38;0.527777777777778;17;19;0.0277777777777778;0.472222222222222
Control.SRR15539832;40;38;0.3;28;12;0.2;0.3
Control.SRR15539832;46;38;0.608695652173913;18;28;0.108695652173913;0.391304347826087
Control.SRR15539832;38;38;0.315789473684211;26;12;0.184210526315789;0.315789473684211
Control.SRR15539832;41;38;0.634146341463415;15;26;0.134146341463415;0.365853658536585
Control.SRR15539832;37;38;0.594594594594595;15;22;0.0945945945945946;0.405405405405405
Control.SRR15539832;44;38;0.5;22;22;0;0.5
Control.SRR15539832;43;38;0.441860465116279;24;19;0.0581395348837209;0.441860465116279
Control.SRR15539832;44;38;0.5;22;22;0;0.5
Control.SRR15539832;44;38;0.568181818181818;19;25;0.0681818181818182;0.431818181818182
Control.SRR15539832;41;38;0.536585365853659;19;22;0.0365853658536586;0.463414634146341
Control.SRR15539832;39;38;0.435897435897436;22;17;0.0641025641025641;0.435897435897436
Control.SRR15539832;40;38;0.55;18;22;0.05;0.45
Control.SRR15539832;42;38;0.452380952380952;23;19;0.0476190476190476;0.452380952380952
Control.SRR15539832;42;38;0.571428571428571;18;24;0.0714285714285714;0.428571428571429
Control.SRR15539832;43;38;0.534883720930233;20;23;0.0348837209302325;0.465116279069767
Control.SRR15539832;41;38;0.341463414634146;27;14;0.158536585365854;0.341463414634146
Control.SRR15539832;42;38;0.547619047619048;19;23;0.0476190476190477;0.452380952380952
Control.SRR15539832;46;38;0.326086956521739;31;15;0.173913043478261;0.326086956521739
Control.SRR15539832;37;38;0.513513513513513;18;19;0.0135135135135135;0.486486486486487
Control.SRR15539832;37;38;0.486486486486487;19;18;0.0135135135135135;0.486486486486487
Control.SRR15539832;38;38;0.315789473684211;26;12;0.184210526315789;0.315789473684211
Control.SRR15539832;45;38;0.488888888888889;23;22;0.0111111111111111;0.488888888888889
Control.SRR15539832;39;38;0.58974358974359;16;23;0.0897435897435898;0.41025641025641
Control.SRR15539832;36;38;0.555555555555556;16;20;0.0555555555555556;0.444444444444444
Control.SRR15539832;41;38;0.658536585365854;14;27;0.158536585365854;0.341463414634146
Control.SRR15539832;45;38;0.577777777777778;19;26;0.0777777777777777;0.422222222222222
Control.SRR15539832;36;38;0.527777777777778;17;19;0.0277777777777778;0.472222222222222
Control.SRR15539832;39;38;0.461538461538462;21;18;0.0384615384615384;0.461538461538462
Control.SRR15539832;43;38;0.534883720930233;20;23;0.0348837209302325;0.465116279069767
Control.SRR15539832;45;38;0.488888888888889;23;22;0.0111111111111111;0.488888888888889
Control.SRR15539832;43;38;0.511627906976744;21;22;0.0116279069767442;0.488372093023256
Control.SRR15539832;39;38;0.41025641025641;23;16;0.0897435897435898;0.41025641025641
Control.SRR15539832;41;38;0.414634146341463;24;17;0.0853658536585366;0.414634146341463
Control.SRR15539832;38;38;0.394736842105263;23;15;0.105263157894737;0.394736842105263
Control.SRR15539832;40;38;0.5;20;20;0;0.5
Control.SRR15539832;40;38;0.525;19;21;0.025;0.475
Control.SRR15539832;37;38;0.405405405405405;22;15;0.0945945945945946;0.405405405405405
Control.SRR15539832;46;38;0.608695652173913;18;28;0.108695652173913;0.391304347826087
Control.SRR15539832;35;38;0.542857142857143;16;19;0.0428571428571428;0.457142857142857
Control.SRR15539832;39;38;0.461538461538462;21;18;0.0384615384615384;0.461538461538462
Control.SRR15539832;39;38;0.461538461538462;21;18;0.0384615384615384;0.461538461538462
Control.SRR15539832;35;38;0.485714285714286;18;17;0.0142857142857143;0.485714285714286
Control.SRR15539832;42;38;0.571428571428571;18;24;0.0714285714285714;0.428571428571429
Control.SRR15539832;43;38;0.395348837209302;26;17;0.104651162790698;0.395348837209302
Control.SRR15539832;39;38;0.487179487179487;20;19;0.0128205128205128;0.487179487179487
Control.SRR15539832;41;38;0.560975609756098;18;23;0.0609756097560976;0.439024390243902
Control.SRR15539832;46;38;0.478260869565217;24;22;0.0217391304347826;0.478260869565217
Control.SRR15539832;37;38;0.405405405405405;22;15;0.0945945945945946;0.405405405405405
Control.SRR15539832;44;38;0.522727272727273;21;23;0.0227272727272727;0.477272727272727
Control.SRR15539832;45;38;0.488888888888889;23;22;0.0111111111111111;0.488888888888889
Control.SRR15539832;39;38;0.538461538461538;18;21;0.0384615384615384;0.461538461538462
Control.SRR15539832;42;38;0.476190476190476;22;20;0.0238095238095238;0.476190476190476
Control.SRR15539832;35;38;0.428571428571429;20;15;0.0714285714285715;0.428571428571429
Control.SRR15539832;37;38;0.459459459459459;20;17;0.0405405405405405;0.459459459459459
Control.SRR15539832;42;38;0.404761904761905;25;17;0.0952380952380952;0.404761904761905
Control.SRR15539832;37;38;0.594594594594595;15;22;0.0945945945945946;0.405405405405405
Control.SRR15539832;44;38;0.522727272727273;21;23;0.0227272727272727;0.477272727272727
Control.SRR15539832;45;38;0.488888888888889;23;22;0.0111111111111111;0.488888888888889
Control.SRR15539832;40;38;0.425;23;17;0.075;0.425
Control.SRR15539832;42;38;0.476190476190476;22;20;0.0238095238095238;0.476190476190476
Control.SRR15539832;41;38;0.48780487804878;21;20;0.0121951219512195;0.48780487804878
Control.SRR15539832;42;38;0.452380952380952;23;19;0.0476190476190476;0.452380952380952
Control.SRR15539832;42;38;0.333333333333333;28;14;0.166666666666667;0.333333333333333
Control.SRR15539832;41;38;0.560975609756098;18;23;0.0609756097560976;0.439024390243902
Control.SRR15539832;38;38;0.473684210526316;20;18;0.0263157894736842;0.473684210526316
Control.SRR15539832;37;38;0.513513513513513;18;19;0.0135135135135135;0.486486486486487
Control.SRR15539832;41;38;0.609756097560976;16;25;0.109756097560976;0.390243902439024
Control.SRR15539832;44;38;0.522727272727273;21;23;0.0227272727272727;0.477272727272727
Control.SRR15539832;39;38;0.487179487179487;20;19;0.0128205128205128;0.487179487179487
Control.SRR15539832;38;38;0.526315789473684;18;20;0.0263157894736842;0.473684210526316
Control.SRR15539832;36;38;0.5;18;18;0;0.5
Control.SRR15539832;36;38;0.472222222222222;19;17;0.0277777777777778;0.472222222222222
Control.SRR15539832;35;38;0.371428571428571;22;13;0.128571428571429;0.371428571428571
Control.SRR15539832;45;38;0.511111111111111;22;23;0.0111111111111111;0.488888888888889
Control.SRR15539832;37;38;0.459459459459459;20;17;0.0405405405405405;0.459459459459459
Control.SRR15539832;37;38;0.378378378378378;23;14;0.121621621621622;0.378378378378378
Control.SRR15539832;36;38;0.583333333333333;15;21;0.0833333333333334;0.416666666666667
Control.SRR15539832;38;38;0.473684210526316;20;18;0.0263157894736842;0.473684210526316
Control.SRR15539832;39;38;0.564102564102564;17;22;0.0641025641025641;0.435897435897436
Control.SRR15539832;39;38;0.435897435897436;22;17;0.0641025641025641;0.435897435897436
Control.SRR15539832;38;38;0.605263157894737;15;23;0.105263157894737;0.394736842105263
Control.SRR15539832;38;38;0.657894736842105;13;25;0.157894736842105;0.342105263157895
Control.SRR15539832;45;38;0.533333333333333;21;24;0.0333333333333333;0.466666666666667
Control.SRR15539832;38;38;0.473684210526316;20;18;0.0263157894736842;0.473684210526316
Control.SRR15539832;38;38;0.631578947368421;14;24;0.131578947368421;0.368421052631579
Control.SRR15539832;42;38;0.380952380952381;26;16;0.119047619047619;0.380952380952381
Control.SRR15539832;37;38;0.459459459459459;20;17;0.0405405405405405;0.459459459459459
Control.SRR15539832;43;38;0.488372093023256;22;21;0.0116279069767442;0.488372093023256
Control.SRR15539832;45;38;0.444444444444444;25;20;0.0555555555555556;0.444444444444444
Control.SRR15539832;38;38;0.526315789473684;18;20;0.0263157894736842;0.473684210526316
Control.SRR15539832;37;38;0.567567567567568;16;21;0.0675675675675675;0.432432432432432
Control.SRR15539832;40;38;0.45;22;18;0.05;0.45
Control.SRR15539832;39;38;0.538461538461538;18;21;0.0384615384615384;0.461538461538462
Control.SRR15539832;45;38;0.577777777777778;19;26;0.0777777777777777;0.422222222222222
Control.SRR15539832;35;38;0.457142857142857;19;16;0.0428571428571429;0.457142857142857
Control.SRR15539832;43;38;0.465116279069767;23;20;0.0348837209302326;0.465116279069767
Control.SRR15539832;43;38;0.627906976744186;16;27;0.127906976744186;0.372093023255814
Control.SRR15539832;42;38;0.452380952380952;23;19;0.0476190476190476;0.452380952380952
Control.SRR15539832;42;38;0.666666666666667;14;28;0.166666666666667;0.333333333333333
Control.SRR15539832;36;38;0.361111111111111;23;13;0.138888888888889;0.361111111111111
Control.SRR15539832;36;38;0.583333333333333;15;21;0.0833333333333334;0.416666666666667
Control.SRR15539832;41;38;0.390243902439024;25;16;0.109756097560976;0.390243902439024
Control.SRR15539832;40;38;0.375;25;15;0.125;0.375
Control.SRR15539832;35;38;0.457142857142857;19;16;0.0428571428571429;0.457142857142857
Control.SRR15539832;46;38;0.5;23;23;0;0.5
Control.SRR15539832;36;38;0.555555555555556;16;20;0.0555555555555556;0.444444444444444
Control.SRR15539832;38;38;0.473684210526316;20;18;0.0263157894736842;0.473684210526316
Control.SRR15539832;37;38;0.27027027027027;27;10;0.22972972972973;0.27027027027027
Control.SRR15539832;36;38;0.416666666666667;21;15;0.0833333333333333;0.416666666666667
Control.SRR15539832;38;38;0.447368421052632;21;17;0.0526315789473684;0.447368421052632
Control.SRR15539832;40;38;0.525;19;21;0.025;0.475
Control.SRR15539832;35;38;0.514285714285714;17;18;0.0142857142857142;0.485714285714286
Control.SRR15539832;35;38;0.285714285714286;25;10;0.214285714285714;0.285714285714286
Control.SRR15539832;37;38;0.459459459459459;20;17;0.0405405405405405;0.459459459459459
Control.SRR15539832;40;38;0.5;20;20;0;0.5
Control.SRR15539832;46;38;0.5;23;23;0;0.5
Control.SRR15539832;46;38;0.434782608695652;26;20;0.0652173913043478;0.434782608695652
Control.SRR15539832;46;38;0.434782608695652;26;20;0.0652173913043478;0.434782608695652
Control.SRR15539832;44;38;0.318181818181818;30;14;0.181818181818182;0.318181818181818
Control.SRR15539832;44;38;0.568181818181818;19;25;0.0681818181818182;0.431818181818182
Control.SRR15539832;45;38;0.4;27;18;0.1;0.4
Control.SRR15539832;46;38;0.521739130434783;22;24;0.0217391304347826;0.478260869565217
Control.SRR15539832;37;38;0.459459459459459;20;17;0.0405405405405405;0.459459459459459
Control.SRR15539832;45;38;0.533333333333333;21;24;0.0333333333333333;0.466666666666667
Control.SRR15539832;39;38;0.615384615384615;15;24;0.115384615384615;0.384615384615385
Control.SRR15539832;38;38;0.394736842105263;23;15;0.105263157894737;0.394736842105263
Control.SRR15539832;35;38;0.514285714285714;17;18;0.0142857142857142;0.485714285714286
Control.SRR15539832;38;38;0.578947368421053;16;22;0.0789473684210527;0.421052631578947
Control.SRR15539832;43;38;0.441860465116279;24;19;0.0581395348837209;0.441860465116279
Control.SRR15539832;42;38;0.452380952380952;23;19;0.0476190476190476;0.452380952380952
Control.SRR15539832;35;38;0.285714285714286;25;10;0.214285714285714;0.285714285714286
Control.SRR15539832;44;38;0.590909090909091;18;26;0.0909090909090909;0.409090909090909
Control.SRR15539832;41;38;0.414634146341463;24;17;0.0853658536585366;0.414634146341463
Control.SRR15539832;38;38;0.526315789473684;18;20;0.0263157894736842;0.473684210526316
Control.SRR15539832;44;38;0.545454545454545;20;24;0.0454545454545454;0.454545454545455
Control.SRR15539832;40;38;0.475;21;19;0.025;0.475
Control.SRR15539832;42;38;0.5;21;21;0;0.5
Control.SRR15539832;40;38;0.4;24;16;0.1;0.4
Control.SRR15539832;41;38;0.390243902439024;25;16;0.109756097560976;0.390243902439024
Control.SRR15539832;37;38;0.513513513513513;18;19;0.0135135135135135;0.486486486486487
Control.SRR15539832;45;38;0.466666666666667;24;21;0.0333333333333333;0.466666666666667
Control.SRR15539832;41;38;0.536585365853659;19;22;0.0365853658536586;0.463414634146341
Control.SRR15539832;37;38;0.459459459459459;20;17;0.0405405405405405;0.459459459459459
Control.SRR15539832;39;38;0.435897435897436;22;17;0.0641025641025641;0.435897435897436
Control.SRR15539832;41;38;0.439024390243902;23;18;0.0609756097560976;0.439024390243902
Control.SRR15539832;44;38;0.522727272727273;21;23;0.0227272727272727;0.477272727272727
Control.SRR15539832;41;38;0.48780487804878;21;20;0.0121951219512195;0.48780487804878
Control.SRR15539832;40;38;0.6;16;24;0.1;0.4
Control.SRR15539832;45;38;0.6;18;27;0.1;0.4
Control.SRR15539832;38;38;0.526315789473684;18;20;0.0263157894736842;0.473684210526316
Control.SRR15539832;39;38;0.512820512820513;19;20;0.0128205128205128;0.487179487179487
Control.SRR15539832;35;38;0.485714285714286;18;17;0.0142857142857143;0.485714285714286
Control.SRR15539832;44;38;0.636363636363636;16;28;0.136363636363636;0.363636363636364
Control.SRR15539832;43;38;0.441860465116279;24;19;0.0581395348837209;0.441860465116279
Control.SRR15539832;43;38;0.372093023255814;27;16;0.127906976744186;0.372093023255814
Control.SRR15539832;44;38;0.477272727272727;23;21;0.0227272727272727;0.477272727272727
Control.SRR15539832;45;38;0.533333333333333;21;24;0.0333333333333333;0.466666666666667
Control.SRR15539832;44;38;0.545454545454545;20;24;0.0454545454545454;0.454545454545455
Control.SRR15539832;38;38;0.605263157894737;15;23;0.105263157894737;0.394736842105263
Control.SRR15539832;42;38;0.476190476190476;22;20;0.0238095238095238;0.476190476190476
Control.SRR15539832;43;38;0.558139534883721;19;24;0.0581395348837209;0.441860465116279
Control.SRR15539832;43;38;0.418604651162791;25;18;0.0813953488372093;0.418604651162791
Control.SRR15539832;35;38;0.4;21;14;0.1;0.4
Control.SRR15539832;42;38;0.547619047619048;19;23;0.0476190476190477;0.452380952380952
Control.SRR15539832;46;38;0.434782608695652;26;20;0.0652173913043478;0.434782608695652
Control.SRR15539832;40;38;0.5;20;20;0;0.5
Control.SRR15539832;45;38;0.577777777777778;19;26;0.0777777777777777;0.422222222222222
Control.SRR15539832;44;38;0.545454545454545;20;24;0.0454545454545454;0.454545454545455
Control.SRR15539832;38;38;0.421052631578947;22;16;0.0789473684210527;0.421052631578947
Control.SRR15539832;42;38;0.642857142857143;15;27;0.142857142857143;0.357142857142857
Control.SRR15539832;43;38;0.534883720930233;20;23;0.0348837209302325;0.465116279069767
Control.SRR15539832;39;38;0.282051282051282;28;11;0.217948717948718;0.282051282051282
Control.SRR15539832;39;38;0.666666666666667;13;26;0.166666666666667;0.333333333333333
Control.SRR15539832;41;38;0.439024390243902;23;18;0.0609756097560976;0.439024390243902
Control.SRR15539832;37;38;0.405405405405405;22;15;0.0945945945945946;0.405405405405405
Control.SRR15539832;41;38;0.439024390243902;23;18;0.0609756097560976;0.439024390243902
Control.SRR15539832;42;38;0.476190476190476;22;20;0.0238095238095238;0.476190476190476
Control.SRR15539832;36;38;0.638888888888889;13;23;0.138888888888889;0.361111111111111
Control.SRR15539832;39;38;0.461538461538462;21;18;0.0384615384615384;0.461538461538462
Control.SRR15539832;35;38;0.4;21;14;0.1;0.4
Control.SRR15539832;44;38;0.431818181818182;25;19;0.0681818181818182;0.431818181818182
Control.SRR15539832;46;38;0.478260869565217;24;22;0.0217391304347826;0.478260869565217
Control.SRR15539832;39;38;0.487179487179487;20;19;0.0128205128205128;0.487179487179487
Control.SRR15539832;40;38;0.5;20;20;0;0.5
Control.SRR15539832;42;38;0.5;21;21;0;0.5
Control.SRR15539832;41;38;0.463414634146341;22;19;0.0365853658536585;0.463414634146341
Control.SRR15539832;41;38;0.463414634146341;22;19;0.0365853658536585;0.463414634146341
Control.SRR15539832;43;38;0.488372093023256;22;21;0.0116279069767442;0.488372093023256
Control.SRR15539832;37;38;0.486486486486487;19;18;0.0135135135135135;0.486486486486487
Control.SRR15539832;41;38;0.414634146341463;24;17;0.0853658536585366;0.414634146341463
Control.SRR15539832;46;38;0.41304347826087;27;19;0.0869565217391304;0.41304347826087
Control.SRR15539832;44;38;0.340909090909091;29;15;0.159090909090909;0.340909090909091
Control.SRR15539832;38;38;0.526315789473684;18;20;0.0263157894736842;0.473684210526316
Control.SRR15539832;41;38;0.48780487804878;21;20;0.0121951219512195;0.48780487804878
Control.SRR15539832;40;38;0.65;14;26;0.15;0.35
Control.SRR15539832;42;38;0.523809523809524;20;22;0.0238095238095238;0.476190476190476
Control.SRR15539832;40;38;0.575;17;23;0.075;0.425
Control.SRR15539832;44;38;0.568181818181818;19;25;0.0681818181818182;0.431818181818182
Control.SRR15539832;42;38;0.428571428571429;24;18;0.0714285714285715;0.428571428571429
Control.SRR15539832;46;38;0.456521739130435;25;21;0.0434782608695652;0.456521739130435
Control.SRR15539832;44;38;0.454545454545455;24;20;0.0454545454545455;0.454545454545455
Control.SRR15539832;43;38;0.511627906976744;21;22;0.0116279069767442;0.488372093023256
Control.SRR15539832;43;38;0.534883720930233;20;23;0.0348837209302325;0.465116279069767
Control.SRR15539832;36;38;0.583333333333333;15;21;0.0833333333333334;0.416666666666667
Control.SRR15539832;45;38;0.555555555555556;20;25;0.0555555555555556;0.444444444444444
Control.SRR15539832;41;38;0.51219512195122;20;21;0.0121951219512195;0.48780487804878
Control.SRR15539832;45;38;0.533333333333333;21;24;0.0333333333333333;0.466666666666667
Control.SRR15539832;40;38;0.55;18;22;0.05;0.45
Control.SRR15539832;35;38;0.4;21;14;0.1;0.4
Control.SRR15539832;44;38;0.454545454545455;24;20;0.0454545454545455;0.454545454545455
Control.SRR15539832;44;38;0.363636363636364;28;16;0.136363636363636;0.363636363636364
Control.SRR15539832;43;38;0.511627906976744;21;22;0.0116279069767442;0.488372093023256
Control.SRR15539832;41;38;0.414634146341463;24;17;0.0853658536585366;0.414634146341463
Control.SRR15539832;35;38;0.514285714285714;17;18;0.0142857142857142;0.485714285714286
Control.SRR15539832;46;38;0.478260869565217;24;22;0.0217391304347826;0.478260869565217
Control.SRR15539832;46;38;0.478260869565217;24;22;0.0217391304347826;0.478260869565217
Control.SRR15539832;41;38;0.439024390243902;23;18;0.0609756097560976;0.439024390243902
Control.SRR15539832;40;38;0.525;19;21;0.025;0.475
Control.SRR15539832;46;38;0.5;23;23;0;0.5
Control.SRR15539832;42;38;0.428571428571429;24;18;0.0714285714285715;0.428571428571429
Control.SRR15539832;40;38;0.525;19;21;0.025;0.475
Control.SRR15539832;40;38;0.575;17;23;0.075;0.425
Control.SRR15539832;37;38;0.486486486486487;19;18;0.0135135135135135;0.486486486486487
Control.SRR15539832;45;38;0.4;27;18;0.1;0.4
Control.SRR15539832;39;38;0.564102564102564;17;22;0.0641025641025641;0.435897435897436
Control.SRR15539832;39;38;0.615384615384615;15;24;0.115384615384615;0.384615384615385
Control.SRR15539832;43;38;0.511627906976744;21;22;0.0116279069767442;0.488372093023256
Control.SRR15539832;45;38;0.533333333333333;21;24;0.0333333333333333;0.466666666666667
Control.SRR15539832;37;38;0.486486486486487;19;18;0.0135135135135135;0.486486486486487
Control.SRR15539832;40;38;0.425;23;17;0.075;0.425
Control.SRR15539832;46;38;0.456521739130435;25;21;0.0434782608695652;0.456521739130435
Control.SRR15539832;36;38;0.527777777777778;17;19;0.0277777777777778;0.472222222222222
Control.SRR15539832;46;38;0.630434782608696;17;29;0.130434782608696;0.369565217391304
Control.SRR15539832;41;38;0.439024390243902;23;18;0.0609756097560976;0.439024390243902
Control.SRR15539832;42;38;0.595238095238095;17;25;0.0952380952380952;0.404761904761905
Control.SRR15539832;40;38;0.425;23;17;0.075;0.425
Control.SRR15539832;41;38;0.609756097560976;16;25;0.109756097560976;0.390243902439024
Control.SRR15539832;42;38;0.380952380952381;26;16;0.119047619047619;0.380952380952381
Control.SRR15539832;35;38;0.542857142857143;16;19;0.0428571428571428;0.457142857142857
Control.SRR15539832;42;38;0.404761904761905;25;17;0.0952380952380952;0.404761904761905
Control.SRR15539832;45;38;0.466666666666667;24;21;0.0333333333333333;0.466666666666667
Control.SRR15539832;39;38;0.487179487179487;20;19;0.0128205128205128;0.487179487179487
Control.SRR15539832;40;38;0.5;20;20;0;0.5
Control.SRR15539832;45;38;0.577777777777778;19;26;0.0777777777777777;0.422222222222222
Control.SRR15539832;43;38;0.465116279069767;23;20;0.0348837209302326;0.465116279069767
Control.SRR15539832;40;38;0.575;17;23;0.075;0.425
Control.SRR15539832;40;38;0.6;16;24;0.1;0.4
Control.SRR15539832;42;38;0.404761904761905;25;17;0.0952380952380952;0.404761904761905
Control.SRR15539832;43;38;0.325581395348837;29;14;0.174418604651163;0.325581395348837
Control.SRR15539832;46;38;0.5;23;23;0;0.5
Control.SRR15539832;37;38;0.351351351351351;24;13;0.148648648648649;0.351351351351351
Control.SRR15539832;45;38;0.466666666666667;24;21;0.0333333333333333;0.466666666666667
Control.SRR15539832;44;38;0.568181818181818;19;25;0.0681818181818182;0.431818181818182
Control.SRR15539832;46;38;0.5;23;23;0;0.5
Control.SRR15539832;44;38;0.568181818181818;19;25;0.0681818181818182;0.431818181818182
Control.SRR15539832;45;38;0.4;27;18;0.1;0.4
Control.SRR15539832;38;38;0.526315789473684;18;20;0.0263157894736842;0.473684210526316
Control.SRR15539832;44;38;0.477272727272727;23;21;0.0227272727272727;0.477272727272727
Control.SRR15539832;46;38;0.608695652173913;18;28;0.108695652173913;0.391304347826087
Control.SRR15539832;44;38;0.409090909090909;26;18;0.0909090909090909;0.409090909090909
Control.SRR15539832;35;38;0.542857142857143;16;19;0.0428571428571428;0.457142857142857
Control.SRR15539832;41;38;0.414634146341463;24;17;0.0853658536585366;0.414634146341463
Control.SRR15539832;42;38;0.547619047619048;19;23;0.0476190476190477;0.452380952380952
Control.SRR15539832;42;38;0.595238095238095;17;25;0.0952380952380952;0.404761904761905
Control.SRR15539832;37;38;0.513513513513513;18;19;0.0135135135135135;0.486486486486487
Control.SRR15539832;43;38;0.395348837209302;26;17;0.104651162790698;0.395348837209302
Control.SRR15539832;45;38;0.377777777777778;28;17;0.122222222222222;0.377777777777778
Control.SRR15539832;45;38;0.4;27;18;0.1;0.4
Control.SRR15539832;37;38;0.486486486486487;19;18;0.0135135135135135;0.486486486486487
Control.SRR15539832;46;38;0.58695652173913;19;27;0.0869565217391305;0.41304347826087
Control.SRR15539832;41;38;0.536585365853659;19;22;0.0365853658536586;0.463414634146341
Control.SRR15539832;35;38;0.6;14;21;0.1;0.4
Control.SRR15539832;45;38;0.6;18;27;0.1;0.4
Control.SRR15539832;43;38;0.511627906976744;21;22;0.0116279069767442;0.488372093023256
Control.SRR15539832;37;38;0.405405405405405;22;15;0.0945945945945946;0.405405405405405
Control.SRR15539832;39;38;0.564102564102564;17;22;0.0641025641025641;0.435897435897436
Control.SRR15539832;43;38;0.581395348837209;18;25;0.0813953488372093;0.418604651162791
Control.SRR15539832;39;38;0.512820512820513;19;20;0.0128205128205128;0.487179487179487
Control.SRR15539832;37;38;0.513513513513513;18;19;0.0135135135135135;0.486486486486487
Control.SRR15539832;41;38;0.439024390243902;23;18;0.0609756097560976;0.439024390243902
Control.SRR15539832;41;38;0.414634146341463;24;17;0.0853658536585366;0.414634146341463
Control.SRR15539832;43;38;0.604651162790698;17;26;0.104651162790698;0.395348837209302
Control.SRR15539832;44;38;0.545454545454545;20;24;0.0454545454545454;0.454545454545455
Control.SRR15539832;38;38;0.552631578947368;17;21;0.0526315789473685;0.447368421052632
Control.SRR15539832;35;38;0.514285714285714;17;18;0.0142857142857142;0.485714285714286
Control.SRR15539832;40;38;0.625;15;25;0.125;0.375
Control.SRR15539832;38;38;0.684210526315789;12;26;0.184210526315789;0.315789473684211
Control.SRR15539832;44;38;0.522727272727273;21;23;0.0227272727272727;0.477272727272727
Control.SRR15539832;41;38;0.536585365853659;19;22;0.0365853658536586;0.463414634146341
Control.SRR15539832;39;38;0.333333333333333;26;13;0.166666666666667;0.333333333333333
Control.SRR15539832;45;38;0.577777777777778;19;26;0.0777777777777777;0.422222222222222
Control.SRR15539832;46;38;0.456521739130435;25;21;0.0434782608695652;0.456521739130435
Control.SRR15539832;36;38;0.583333333333333;15;21;0.0833333333333334;0.416666666666667
Control.SRR15539832;35;38;0.514285714285714;17;18;0.0142857142857142;0.485714285714286
Control.SRR15539832;38;38;0.473684210526316;20;18;0.0263157894736842;0.473684210526316
Control.SRR15539832;43;38;0.418604651162791;25;18;0.0813953488372093;0.418604651162791
Control.SRR15539832;38;38;0.447368421052632;21;17;0.0526315789473684;0.447368421052632
Control.SRR15539832;39;38;0.512820512820513;19;20;0.0128205128205128;0.487179487179487
Control.SRR15539832;43;38;0.465116279069767;23;20;0.0348837209302326;0.465116279069767
Control.SRR15539832;45;38;0.377777777777778;28;17;0.122222222222222;0.377777777777778
Control.SRR15539832;35;38;0.628571428571429;13;22;0.128571428571429;0.371428571428571
Control.SRR15539832;44;38;0.409090909090909;26;18;0.0909090909090909;0.409090909090909
Control.SRR15539832;37;38;0.567567567567568;16;21;0.0675675675675675;0.432432432432432
Control.SRR15539832;39;38;0.641025641025641;14;25;0.141025641025641;0.358974358974359
Control.SRR15539832;35;38;0.571428571428571;15;20;0.0714285714285714;0.428571428571429
Control.SRR15539832;36;38;0.472222222222222;19;17;0.0277777777777778;0.472222222222222
Control.SRR15539832;45;38;0.511111111111111;22;23;0.0111111111111111;0.488888888888889
Control.SRR15539832;46;38;0.369565217391304;29;17;0.130434782608696;0.369565217391304
Control.SRR15539832;41;38;0.536585365853659;19;22;0.0365853658536586;0.463414634146341
Control.SRR15539832;42;38;0.547619047619048;19;23;0.0476190476190477;0.452380952380952
Control.SRR15539832;44;38;0.454545454545455;24;20;0.0454545454545455;0.454545454545455
Control.SRR15539832;35;38;0.285714285714286;25;10;0.214285714285714;0.285714285714286
Control.SRR15539832;40;38;0.425;23;17;0.075;0.425
Control.SRR15539832;40;38;0.475;21;19;0.025;0.475
Control.SRR15539832;41;38;0.414634146341463;24;17;0.0853658536585366;0.414634146341463
Control.SRR15539832;40;38;0.325;27;13;0.175;0.325
Control.SRR15539832;42;38;0.380952380952381;26;16;0.119047619047619;0.380952380952381
Control.SRR15539832;38;38;0.5;19;19;0;0.5
Control.SRR15539832;44;38;0.431818181818182;25;19;0.0681818181818182;0.431818181818182
Control.SRR15539832;42;38;0.5;21;21;0;0.5
Control.SRR15539832;36;38;0.527777777777778;17;19;0.0277777777777778;0.472222222222222
Control.SRR15539832;38;38;0.5;19;19;0;0.5
Control.SRR15539832;44;38;0.431818181818182;25;19;0.0681818181818182;0.431818181818182
Control.SRR15539832;36;38;0.611111111111111;14;22;0.111111111111111;0.388888888888889
Control.SRR15539832;43;38;0.488372093023256;22;21;0.0116279069767442;0.488372093023256
Control.SRR15539832;41;38;0.51219512195122;20;21;0.0121951219512195;0.48780487804878
Control.SRR15539832;43;38;0.511627906976744;21;22;0.0116279069767442;0.488372093023256
Control.SRR15539832;45;38;0.466666666666667;24;21;0.0333333333333333;0.466666666666667
Control.SRR15539832;42;38;0.619047619047619;16;26;0.119047619047619;0.380952380952381
Control.SRR15539832;39;38;0.435897435897436;22;17;0.0641025641025641;0.435897435897436
Control.SRR15539832;38;38;0.578947368421053;16;22;0.0789473684210527;0.421052631578947
Control.SRR15539832;41;38;0.463414634146341;22;19;0.0365853658536585;0.463414634146341
Control.SRR15539832;37;38;0.540540540540541;17;20;0.0405405405405406;0.459459459459459
Control.SRR15539832;35;38;0.457142857142857;19;16;0.0428571428571429;0.457142857142857
Control.SRR15539832;40;38;0.475;21;19;0.025;0.475
Control.SRR15539832;39;38;0.487179487179487;20;19;0.0128205128205128;0.487179487179487
Control.SRR15539832;43;38;0.418604651162791;25;18;0.0813953488372093;0.418604651162791
Control.SRR15539832;45;38;0.4;27;18;0.1;0.4
Control.SRR15539832;37;38;0.432432432432432;21;16;0.0675675675675675;0.432432432432432
Control.SRR15539832;45;38;0.533333333333333;21;24;0.0333333333333333;0.466666666666667
Control.SRR15539832;46;38;0.391304347826087;28;18;0.108695652173913;0.391304347826087
Control.SRR15539832;35;38;0.457142857142857;19;16;0.0428571428571429;0.457142857142857
Control.SRR15539832;38;38;0.421052631578947;22;16;0.0789473684210527;0.421052631578947
Control.SRR15539832;42;38;0.357142857142857;27;15;0.142857142857143;0.357142857142857
Control.SRR15539832;38;38;0.526315789473684;18;20;0.0263157894736842;0.473684210526316
Control.SRR15539832;36;38;0.527777777777778;17;19;0.0277777777777778;0.472222222222222
Control.SRR15539832;37;38;0.459459459459459;20;17;0.0405405405405405;0.459459459459459
Control.SRR15539832;39;38;0.538461538461538;18;21;0.0384615384615384;0.461538461538462
Control.SRR15539832;38;38;0.5;19;19;0;0.5
Control.SRR15539832;42;38;0.380952380952381;26;16;0.119047619047619;0.380952380952381
Control.SRR15539832;42;38;0.452380952380952;23;19;0.0476190476190476;0.452380952380952
Control.SRR15539832;42;38;0.619047619047619;16;26;0.119047619047619;0.380952380952381
Control.SRR15539832;37;38;0.513513513513513;18;19;0.0135135135135135;0.486486486486487
Control.SRR15539832;42;38;0.523809523809524;20;22;0.0238095238095238;0.476190476190476
Control.SRR15539832;35;38;0.428571428571429;20;15;0.0714285714285715;0.428571428571429
Control.SRR15539832;43;38;0.488372093023256;22;21;0.0116279069767442;0.488372093023256
Control.SRR15539832;38;38;0.473684210526316;20;18;0.0263157894736842;0.473684210526316
Control.SRR15539832;41;38;0.536585365853659;19;22;0.0365853658536586;0.463414634146341
Control.SRR15539832;45;38;0.422222222222222;26;19;0.0777777777777778;0.422222222222222
Control.SRR15539832;46;38;0.391304347826087;28;18;0.108695652173913;0.391304347826087
Control.SRR15539832;37;38;0.621621621621622;14;23;0.121621621621622;0.378378378378378
Control.SRR15539832;38;38;0.578947368421053;16;22;0.0789473684210527;0.421052631578947
Control.SRR15539832;41;38;0.414634146341463;24;17;0.0853658536585366;0.414634146341463
Control.SRR15539832;45;38;0.511111111111111;22;23;0.0111111111111111;0.488888888888889
Control.SRR15539832;37;38;0.405405405405405;22;15;0.0945945945945946;0.405405405405405
Control.SRR15539832;43;38;0.604651162790698;17;26;0.104651162790698;0.395348837209302
Control.SRR15539832;40;38;0.4;24;16;0.1;0.4
Control.SRR15539832;39;38;0.538461538461538;18;21;0.0384615384615384;0.461538461538462
Control.SRR15539832;43;38;0.558139534883721;19;24;0.0581395348837209;0.441860465116279
Control.SRR15539832;45;38;0.422222222222222;26;19;0.0777777777777778;0.422222222222222
Control.SRR15539832;42;38;0.452380952380952;23;19;0.0476190476190476;0.452380952380952
Control.SRR15539832;35;38;0.514285714285714;17;18;0.0142857142857142;0.485714285714286
Control.SRR15539832;45;38;0.488888888888889;23;22;0.0111111111111111;0.488888888888889
Control.SRR15539832;39;38;0.641025641025641;14;25;0.141025641025641;0.358974358974359
Control.SRR15539832;43;38;0.581395348837209;18;25;0.0813953488372093;0.418604651162791
Control.SRR15539832;43;38;0.465116279069767;23;20;0.0348837209302326;0.465116279069767
Control.SRR15539832;45;38;0.444444444444444;25;20;0.0555555555555556;0.444444444444444
Control.SRR15539832;40;38;0.55;18;22;0.05;0.45
Control.SRR15539832;37;38;0.432432432432432;21;16;0.0675675675675675;0.432432432432432
Control.SRR15539832;36;38;0.527777777777778;17;19;0.0277777777777778;0.472222222222222
Control.SRR15539832;35;38;0.371428571428571;22;13;0.128571428571429;0.371428571428571
Control.SRR15539832;41;38;0.48780487804878;21;20;0.0121951219512195;0.48780487804878
Control.SRR15539832;41;38;0.463414634146341;22;19;0.0365853658536585;0.463414634146341
Control.SRR15539832;42;38;0.619047619047619;16;26;0.119047619047619;0.380952380952381
Control.SRR15539832;39;38;0.512820512820513;19;20;0.0128205128205128;0.487179487179487
Control.SRR15539832;39;38;0.692307692307692;12;27;0.192307692307692;0.307692307692308
Control.SRR15539832;45;38;0.511111111111111;22;23;0.0111111111111111;0.488888888888889
Control.SRR15539832;42;38;0.666666666666667;14;28;0.166666666666667;0.333333333333333
Control.SRR15539832;42;38;0.595238095238095;17;25;0.0952380952380952;0.404761904761905
Control.SRR15539832;41;38;0.536585365853659;19;22;0.0365853658536586;0.463414634146341
Control.SRR15539832;35;38;0.542857142857143;16;19;0.0428571428571428;0.457142857142857
Control.SRR15539832;40;38;0.575;17;23;0.075;0.425
Control.SRR15539832;36;38;0.5;18;18;0;0.5
Control.SRR15539832;45;38;0.4;27;18;0.1;0.4
Control.SRR15539832;38;38;0.473684210526316;20;18;0.0263157894736842;0.473684210526316
Control.SRR15539832;41;38;0.48780487804878;21;20;0.0121951219512195;0.48780487804878
Control.SRR15539832;39;38;0.743589743589744;10;29;0.243589743589744;0.256410256410256
Control.SRR15539832;36;38;0.555555555555556;16;20;0.0555555555555556;0.444444444444444
Control.SRR15539832;36;38;0.472222222222222;19;17;0.0277777777777778;0.472222222222222
Control.SRR15539832;38;38;0.263157894736842;28;10;0.236842105263158;0.263157894736842
Control.SRR15539832;41;38;0.48780487804878;21;20;0.0121951219512195;0.48780487804878
Control.SRR15539832;43;38;0.604651162790698;17;26;0.104651162790698;0.395348837209302
Control.SRR15539832;39;38;0.641025641025641;14;25;0.141025641025641;0.358974358974359
Control.SRR15539832;43;38;0.534883720930233;20;23;0.0348837209302325;0.465116279069767
Control.SRR15539832;41;38;0.609756097560976;16;25;0.109756097560976;0.390243902439024
Control.SRR15539832;40;38;0.525;19;21;0.025;0.475
Control.SRR15539832;44;38;0.522727272727273;21;23;0.0227272727272727;0.477272727272727
Control.SRR15539832;42;38;0.571428571428571;18;24;0.0714285714285714;0.428571428571429
Control.SRR15539832;37;38;0.648648648648649;13;24;0.148648648648649;0.351351351351351
Control.SRR15539832;36;38;0.555555555555556;16;20;0.0555555555555556;0.444444444444444
Control.SRR15539832;36;38;0.555555555555556;16;20;0.0555555555555556;0.444444444444444
Control.SRR15539832;37;38;0.540540540540541;17;20;0.0405405405405406;0.459459459459459
Control.SRR15539832;40;38;0.475;21;19;0.025;0.475
Control.SRR15539832;46;38;0.565217391304348;20;26;0.0652173913043478;0.434782608695652
Control.SRR15539832;42;38;0.595238095238095;17;25;0.0952380952380952;0.404761904761905
Control.SRR15539832;43;38;0.372093023255814;27;16;0.127906976744186;0.372093023255814
Control.SRR15539832;44;38;0.454545454545455;24;20;0.0454545454545455;0.454545454545455
Control.SRR15539832;45;38;0.466666666666667;24;21;0.0333333333333333;0.466666666666667
Control.SRR15539832;39;38;0.58974358974359;16;23;0.0897435897435898;0.41025641025641
Control.SRR15539832;46;38;0.630434782608696;17;29;0.130434782608696;0.369565217391304
Control.SRR15539832;40;38;0.55;18;22;0.05;0.45
Control.SRR15539832;36;38;0.527777777777778;17;19;0.0277777777777778;0.472222222222222
Control.SRR15539832;37;38;0.351351351351351;24;13;0.148648648648649;0.351351351351351
Control.SRR15539832;39;38;0.564102564102564;17;22;0.0641025641025641;0.435897435897436
Control.SRR15539832;35;38;0.485714285714286;18;17;0.0142857142857143;0.485714285714286
Control.SRR15539832;40;38;0.45;22;18;0.05;0.45
Control.SRR15539832;41;38;0.536585365853659;19;22;0.0365853658536586;0.463414634146341
Control.SRR15539832;41;38;0.439024390243902;23;18;0.0609756097560976;0.439024390243902
Control.SRR15539832;40;38;0.375;25;15;0.125;0.375
Control.SRR15539832;44;38;0.659090909090909;15;29;0.159090909090909;0.340909090909091
Control.SRR15539832;41;38;0.634146341463415;15;26;0.134146341463415;0.365853658536585
Control.SRR15539832;36;38;0.305555555555556;25;11;0.194444444444444;0.305555555555556
Control.SRR15539832;36;38;0.472222222222222;19;17;0.0277777777777778;0.472222222222222
Control.SRR15539832;44;38;0.545454545454545;20;24;0.0454545454545454;0.454545454545455
Control.SRR15539832;37;38;0.513513513513513;18;19;0.0135135135135135;0.486486486486487
Control.SRR15539832;43;38;0.441860465116279;24;19;0.0581395348837209;0.441860465116279
Control.SRR15539832;36;38;0.388888888888889;22;14;0.111111111111111;0.388888888888889
Control.SRR15539832;37;38;0.351351351351351;24;13;0.148648648648649;0.351351351351351
Control.SRR15539832;39;38;0.538461538461538;18;21;0.0384615384615384;0.461538461538462
Control.SRR15539832;37;38;0.540540540540541;17;20;0.0405405405405406;0.459459459459459
Control.SRR15539832;39;38;0.487179487179487;20;19;0.0128205128205128;0.487179487179487
Control.SRR15539832;37;38;0.594594594594595;15;22;0.0945945945945946;0.405405405405405
Control.SRR15539832;35;38;0.514285714285714;17;18;0.0142857142857142;0.485714285714286
Control.SRR15539832;43;38;0.651162790697674;15;28;0.151162790697674;0.348837209302326
Control.SRR15539832;41;38;0.463414634146341;22;19;0.0365853658536585;0.463414634146341
Control.SRR15539832;35;38;0.571428571428571;15;20;0.0714285714285714;0.428571428571429
Control.SRR15539832;41;38;0.48780487804878;21;20;0.0121951219512195;0.48780487804878
Control.SRR15539832;35;38;0.457142857142857;19;16;0.0428571428571429;0.457142857142857
Control.SRR15539832;46;38;0.41304347826087;27;19;0.0869565217391304;0.41304347826087
Control.SRR15539832;43;38;0.581395348837209;18;25;0.0813953488372093;0.418604651162791
Control.SRR15539832;40;38;0.475;21;19;0.025;0.475
Control.SRR15539832;41;38;0.463414634146341;22;19;0.0365853658536585;0.463414634146341
Control.SRR15539832;43;38;0.604651162790698;17;26;0.104651162790698;0.395348837209302
Control.SRR15539832;39;38;0.41025641025641;23;16;0.0897435897435898;0.41025641025641
Control.SRR15539832;35;38;0.428571428571429;20;15;0.0714285714285715;0.428571428571429
Control.SRR15539832;40;38;0.525;19;21;0.025;0.475
Control.SRR15539832;42;38;0.523809523809524;20;22;0.0238095238095238;0.476190476190476
Control.SRR15539832;41;38;0.536585365853659;19;22;0.0365853658536586;0.463414634146341
Control.SRR15539832;39;38;0.512820512820513;19;20;0.0128205128205128;0.487179487179487
Control.SRR15539832;35;38;0.428571428571429;20;15;0.0714285714285715;0.428571428571429
Control.SRR15539832;42;38;0.571428571428571;18;24;0.0714285714285714;0.428571428571429
Control.SRR15539832;42;38;0.571428571428571;18;24;0.0714285714285714;0.428571428571429
Control.SRR15539832;40;38;0.45;22;18;0.05;0.45
Control.SRR15539832;46;38;0.521739130434783;22;24;0.0217391304347826;0.478260869565217
Control.SRR15539832;39;38;0.461538461538462;21;18;0.0384615384615384;0.461538461538462
Control.SRR15539832;45;38;0.488888888888889;23;22;0.0111111111111111;0.488888888888889
Control.SRR15539832;39;38;0.538461538461538;18;21;0.0384615384615384;0.461538461538462
Control.SRR15539832;39;38;0.435897435897436;22;17;0.0641025641025641;0.435897435897436
Control.SRR15539832;40;38;0.525;19;21;0.025;0.475
Control.SRR15539832;45;38;0.533333333333333;21;24;0.0333333333333333;0.466666666666667
Control.SRR15539832;44;38;0.340909090909091;29;15;0.159090909090909;0.340909090909091
Control.SRR15539832;40;38;0.575;17;23;0.075;0.425
Control.SRR15539832;42;38;0.571428571428571;18;24;0.0714285714285714;0.428571428571429
Control.SRR15539832;40;38;0.55;18;22;0.05;0.45
Control.SRR15539832;44;38;0.545454545454545;20;24;0.0454545454545454;0.454545454545455
Control.SRR15539832;36;38;0.583333333333333;15;21;0.0833333333333334;0.416666666666667
Control.SRR15539832;39;38;0.564102564102564;17;22;0.0641025641025641;0.435897435897436
Control.SRR15539832;38;38;0.473684210526316;20;18;0.0263157894736842;0.473684210526316
Control.SRR15539832;36;38;0.527777777777778;17;19;0.0277777777777778;0.472222222222222
Control.SRR15539832;38;38;0.473684210526316;20;18;0.0263157894736842;0.473684210526316
Control.SRR15539832;39;38;0.435897435897436;22;17;0.0641025641025641;0.435897435897436
Control.SRR15539832;41;38;0.268292682926829;30;11;0.231707317073171;0.268292682926829
Control.SRR15539832;44;38;0.545454545454545;20;24;0.0454545454545454;0.454545454545455
Control.SRR15539832;37;38;0.567567567567568;16;21;0.0675675675675675;0.432432432432432
Control.SRR15539832;38;38;0.342105263157895;25;13;0.157894736842105;0.342105263157895
Control.SRR15539832;37;38;0.324324324324324;25;12;0.175675675675676;0.324324324324324
Control.SRR15539832;41;38;0.48780487804878;21;20;0.0121951219512195;0.48780487804878
Control.SRR15539832;46;38;0.456521739130435;25;21;0.0434782608695652;0.456521739130435
Control.SRR15539832;39;38;0.564102564102564;17;22;0.0641025641025641;0.435897435897436
Control.SRR15539832;40;38;0.55;18;22;0.05;0.45
Control.SRR15539832;44;38;0.5;22;22;0;0.5
Control.SRR15539832;42;38;0.714285714285714;12;30;0.214285714285714;0.285714285714286
Control.SRR15539832;41;38;0.463414634146341;22;19;0.0365853658536585;0.463414634146341
Control.SRR15539832;37;38;0.351351351351351;24;13;0.148648648648649;0.351351351351351
Control.SRR15539832;45;38;0.422222222222222;26;19;0.0777777777777778;0.422222222222222
Control.SRR15539832;42;38;0.428571428571429;24;18;0.0714285714285715;0.428571428571429
Control.SRR15539832;38;38;0.315789473684211;26;12;0.184210526315789;0.315789473684211
Control.SRR15539832;38;38;0.421052631578947;22;16;0.0789473684210527;0.421052631578947
Control.SRR15539832;37;38;0.486486486486487;19;18;0.0135135135135135;0.486486486486487
Control.SRR15539832;44;38;0.386363636363636;27;17;0.113636363636364;0.386363636363636
Control.SRR15539832;40;38;0.55;18;22;0.05;0.45
Control.SRR15539832;36;38;0.555555555555556;16;20;0.0555555555555556;0.444444444444444
Control.SRR15539832;39;38;0.512820512820513;19;20;0.0128205128205128;0.487179487179487
Control.SRR15539832;39;38;0.512820512820513;19;20;0.0128205128205128;0.487179487179487
Control.SRR15539832;40;38;0.5;20;20;0;0.5
Control.SRR15539832;41;38;0.560975609756098;18;23;0.0609756097560976;0.439024390243902
Control.SRR15539832;45;38;0.4;27;18;0.1;0.4
Control.SRR15539832;38;38;0.447368421052632;21;17;0.0526315789473684;0.447368421052632
Control.SRR15539832;37;38;0.459459459459459;20;17;0.0405405405405405;0.459459459459459
Control.SRR15539832;41;38;0.48780487804878;21;20;0.0121951219512195;0.48780487804878
Control.SRR15539832;38;38;0.342105263157895;25;13;0.157894736842105;0.342105263157895
Control.SRR15539832;44;38;0.477272727272727;23;21;0.0227272727272727;0.477272727272727
Control.SRR15539832;44;38;0.295454545454545;31;13;0.204545454545455;0.295454545454545
Control.SRR15539832;40;38;0.55;18;22;0.05;0.45
Control.SRR15539832;43;38;0.441860465116279;24;19;0.0581395348837209;0.441860465116279
Control.SRR15539832;39;38;0.41025641025641;23;16;0.0897435897435898;0.41025641025641
Control.SRR15539832;36;38;0.5;18;18;0;0.5
Control.SRR15539832;43;38;0.302325581395349;30;13;0.197674418604651;0.302325581395349
Control.SRR15539832;39;38;0.538461538461538;18;21;0.0384615384615384;0.461538461538462
Control.SRR15539832;42;38;0.523809523809524;20;22;0.0238095238095238;0.476190476190476
Control.SRR15539832;38;38;0.5;19;19;0;0.5
Control.SRR15539832;46;38;0.521739130434783;22;24;0.0217391304347826;0.478260869565217
Control.SRR15539832;36;38;0.527777777777778;17;19;0.0277777777777778;0.472222222222222
Control.SRR15539832;41;38;0.560975609756098;18;23;0.0609756097560976;0.439024390243902
Control.SRR15539832;46;38;0.565217391304348;20;26;0.0652173913043478;0.434782608695652
Control.SRR15539832;40;38;0.55;18;22;0.05;0.45
Control.SRR15539832;38;38;0.552631578947368;17;21;0.0526315789473685;0.447368421052632
Control.SRR15539832;43;38;0.441860465116279;24;19;0.0581395348837209;0.441860465116279
Control.SRR15539832;34;38;0.558823529411765;15;19;0.0588235294117647;0.441176470588235
Control.SRR15539832;38;38;0.578947368421053;16;22;0.0789473684210527;0.421052631578947
Control.SRR15539832;37;38;0.459459459459459;20;17;0.0405405405405405;0.459459459459459
Control.SRR15539832;44;38;0.568181818181818;19;25;0.0681818181818182;0.431818181818182
Control.SRR15539832;39;38;0.41025641025641;23;16;0.0897435897435898;0.41025641025641
Control.SRR15539832;38;38;0.5;19;19;0;0.5
Control.SRR15539832;38;38;0.552631578947368;17;21;0.0526315789473685;0.447368421052632
Control.SRR15539832;43;38;0.511627906976744;21;22;0.0116279069767442;0.488372093023256
Control.SRR15539832;44;38;0.386363636363636;27;17;0.113636363636364;0.386363636363636
Control.SRR15539832;40;38;0.45;22;18;0.05;0.45
Control.SRR15539832;43;38;0.465116279069767;23;20;0.0348837209302326;0.465116279069767
Control.SRR15539832;38;38;0.684210526315789;12;26;0.184210526315789;0.315789473684211
Control.SRR15539832;40;38;0.375;25;15;0.125;0.375
Control.SRR15539832;36;38;0.444444444444444;20;16;0.0555555555555556;0.444444444444444
Control.SRR15539832;39;38;0.512820512820513;19;20;0.0128205128205128;0.487179487179487
Control.SRR15539832;36;38;0.388888888888889;22;14;0.111111111111111;0.388888888888889
Control.SRR15539832;36;38;0.416666666666667;21;15;0.0833333333333333;0.416666666666667
Control.SRR15539832;41;38;0.536585365853659;19;22;0.0365853658536586;0.463414634146341
Control.SRR15539832;42;38;0.404761904761905;25;17;0.0952380952380952;0.404761904761905
Control.SRR15539832;34;38;0.647058823529412;12;22;0.147058823529412;0.352941176470588
Control.SRR15539832;43;38;0.534883720930233;20;23;0.0348837209302325;0.465116279069767
Control.SRR15539832;37;38;0.594594594594595;15;22;0.0945945945945946;0.405405405405405
Control.SRR15539832;44;38;0.545454545454545;20;24;0.0454545454545454;0.454545454545455
Control.SRR15539832;34;38;0.5;17;17;0;0.5
Control.SRR15539832;36;38;0.555555555555556;16;20;0.0555555555555556;0.444444444444444
Control.SRR15539832;34;38;0.5;17;17;0;0.5
Control.SRR15539832;38;38;0.447368421052632;21;17;0.0526315789473684;0.447368421052632
Control.SRR15539832;34;38;0.411764705882353;20;14;0.0882352941176471;0.411764705882353
Control.SRR15539832;36;38;0.444444444444444;20;16;0.0555555555555556;0.444444444444444
Control.SRR15539832;40;38;0.525;19;21;0.025;0.475
Control.SRR15539832;35;38;0.514285714285714;17;18;0.0142857142857142;0.485714285714286
Control.SRR15539832;44;38;0.477272727272727;23;21;0.0227272727272727;0.477272727272727
Control.SRR15539832;36;38;0.5;18;18;0;0.5
Control.SRR15539832;42;38;0.452380952380952;23;19;0.0476190476190476;0.452380952380952
Control.SRR15539832;35;38;0.628571428571429;13;22;0.128571428571429;0.371428571428571
Control.SRR15539832;37;38;0.513513513513513;18;19;0.0135135135135135;0.486486486486487
Control.SRR15539832;35;38;0.514285714285714;17;18;0.0142857142857142;0.485714285714286
Control.SRR15539832;42;38;0.547619047619048;19;23;0.0476190476190477;0.452380952380952
Control.SRR15539832;41;38;0.439024390243902;23;18;0.0609756097560976;0.439024390243902
Control.SRR15539832;40;38;0.5;20;20;0;0.5
Control.SRR15539832;38;38;0.5;19;19;0;0.5
Control.SRR15539832;34;38;0.676470588235294;11;23;0.176470588235294;0.323529411764706
Control.SRR15539832;34;38;0.5;17;17;0;0.5
Control.SRR15539832;39;38;0.487179487179487;20;19;0.0128205128205128;0.487179487179487
Control.SRR15539832;34;38;0.441176470588235;19;15;0.0588235294117647;0.441176470588235
Control.SRR15539832;40;38;0.55;18;22;0.05;0.45
Control.SRR15539832;39;38;0.564102564102564;17;22;0.0641025641025641;0.435897435897436
Control.SRR15539832;38;38;0.447368421052632;21;17;0.0526315789473684;0.447368421052632
Control.SRR15539832;37;38;0.405405405405405;22;15;0.0945945945945946;0.405405405405405
Control.SRR15539832;38;38;0.552631578947368;17;21;0.0526315789473685;0.447368421052632
Control.SRR15539832;44;38;0.590909090909091;18;26;0.0909090909090909;0.409090909090909
Control.SRR15539832;38;38;0.368421052631579;24;14;0.131578947368421;0.368421052631579
Control.SRR15539832;39;38;0.461538461538462;21;18;0.0384615384615384;0.461538461538462
Control.SRR15539832;36;38;0.333333333333333;24;12;0.166666666666667;0.333333333333333
Control.SRR15539832;41;38;0.414634146341463;24;17;0.0853658536585366;0.414634146341463
Control.SRR15539832;35;38;0.6;14;21;0.1;0.4
Control.SRR15539832;35;38;0.514285714285714;17;18;0.0142857142857142;0.485714285714286
Control.SRR15539832;36;38;0.5;18;18;0;0.5
Control.SRR15539832;36;38;0.361111111111111;23;13;0.138888888888889;0.361111111111111
Control.SRR15539832;37;38;0.594594594594595;15;22;0.0945945945945946;0.405405405405405
Control.SRR15539832;34;38;0.5;17;17;0;0.5
Control.SRR15539832;39;38;0.512820512820513;19;20;0.0128205128205128;0.487179487179487
Control.SRR15539832;40;38;0.625;15;25;0.125;0.375
Control.SRR15539832;35;38;0.428571428571429;20;15;0.0714285714285715;0.428571428571429
Control.SRR15539832;40;38;0.475;21;19;0.025;0.475
Control.SRR15539832;34;38;0.352941176470588;22;12;0.147058823529412;0.352941176470588
Control.SRR15539832;34;38;0.470588235294118;18;16;0.0294117647058824;0.470588235294118
Control.SRR15539832;35;38;0.4;21;14;0.1;0.4
Control.SRR15539832;41;38;0.536585365853659;19;22;0.0365853658536586;0.463414634146341
Control.SRR15539832;35;38;0.485714285714286;18;17;0.0142857142857143;0.485714285714286
Control.SRR15539832;37;38;0.459459459459459;20;17;0.0405405405405405;0.459459459459459
Control.SRR15539832;43;38;0.511627906976744;21;22;0.0116279069767442;0.488372093023256
Control.SRR15539832;43;38;0.558139534883721;19;24;0.0581395348837209;0.441860465116279
Control.SRR15539832;39;38;0.461538461538462;21;18;0.0384615384615384;0.461538461538462
Control.SRR15539832;40;38;0.45;22;18;0.05;0.45
Control.SRR15539832;43;38;0.441860465116279;24;19;0.0581395348837209;0.441860465116279
Control.SRR15539832;41;38;0.439024390243902;23;18;0.0609756097560976;0.439024390243902
Control.SRR15539832;40;38;0.575;17;23;0.075;0.425
Control.SRR15539832;41;38;0.51219512195122;20;21;0.0121951219512195;0.48780487804878
Control.SRR15539832;34;38;0.529411764705882;16;18;0.0294117647058824;0.470588235294118
Control.SRR15539832;38;38;0.421052631578947;22;16;0.0789473684210527;0.421052631578947
Control.SRR15539832;37;38;0.648648648648649;13;24;0.148648648648649;0.351351351351351
Control.SRR15539832;36;38;0.638888888888889;13;23;0.138888888888889;0.361111111111111
Control.SRR15539832;40;38;0.425;23;17;0.075;0.425
Control.SRR15539832;41;38;0.341463414634146;27;14;0.158536585365854;0.341463414634146
Control.SRR15539832;37;38;0.432432432432432;21;16;0.0675675675675675;0.432432432432432
Control.SRR15539832;41;38;0.634146341463415;15;26;0.134146341463415;0.365853658536585
Control.SRR15539832;42;38;0.5;21;21;0;0.5
Control.SRR15539832;38;38;0.368421052631579;24;14;0.131578947368421;0.368421052631579
Control.SRR15539832;40;38;0.675;13;27;0.175;0.325
Control.SRR15539832;36;38;0.611111111111111;14;22;0.111111111111111;0.388888888888889
Control.SRR15539832;39;38;0.435897435897436;22;17;0.0641025641025641;0.435897435897436
Control.SRR15539832;35;38;0.428571428571429;20;15;0.0714285714285715;0.428571428571429
Control.SRR15539832;36;38;0.611111111111111;14;22;0.111111111111111;0.388888888888889
Control.SRR15539832;36;38;0.416666666666667;21;15;0.0833333333333333;0.416666666666667
Control.SRR15539832;43;38;0.465116279069767;23;20;0.0348837209302326;0.465116279069767
Control.SRR15539832;35;38;0.314285714285714;24;11;0.185714285714286;0.314285714285714
Control.SRR15539832;35;38;0.514285714285714;17;18;0.0142857142857142;0.485714285714286
Control.SRR15539832;43;38;0.418604651162791;25;18;0.0813953488372093;0.418604651162791
Control.SRR15539832;34;38;0.529411764705882;16;18;0.0294117647058824;0.470588235294118
Control.SRR15539832;35;38;0.6;14;21;0.1;0.4
Control.SRR15539832;34;38;0.588235294117647;14;20;0.0882352941176471;0.411764705882353
Control.SRR15539832;37;38;0.513513513513513;18;19;0.0135135135135135;0.486486486486487
Control.SRR15539832;37;38;0.567567567567568;16;21;0.0675675675675675;0.432432432432432
Control.SRR15539832;35;38;0.628571428571429;13;22;0.128571428571429;0.371428571428571
Control.SRR15539832;34;38;0.529411764705882;16;18;0.0294117647058824;0.470588235294118
Control.SRR15539832;34;38;0.558823529411765;15;19;0.0588235294117647;0.441176470588235
Control.SRR15539832;34;38;0.441176470588235;19;15;0.0588235294117647;0.441176470588235
Control.SRR15539832;37;38;0.405405405405405;22;15;0.0945945945945946;0.405405405405405
Control.SRR15539832;36;38;0.5;18;18;0;0.5
Control.SRR15539832;43;38;0.418604651162791;25;18;0.0813953488372093;0.418604651162791
Control.SRR15539832;40;38;0.475;21;19;0.025;0.475
Control.SRR15539832;35;38;0.571428571428571;15;20;0.0714285714285714;0.428571428571429
Control.SRR15539832;44;38;0.545454545454545;20;24;0.0454545454545454;0.454545454545455
Control.SRR15539832;41;38;0.439024390243902;23;18;0.0609756097560976;0.439024390243902
Control.SRR15539832;43;38;0.372093023255814;27;16;0.127906976744186;0.372093023255814
Control.SRR15539832;37;38;0.432432432432432;21;16;0.0675675675675675;0.432432432432432
Control.SRR15539832;42;38;0.5;21;21;0;0.5
Control.SRR15539832;42;38;0.5;21;21;0;0.5
Control.SRR15539832;36;38;0.472222222222222;19;17;0.0277777777777778;0.472222222222222
Control.SRR15539832;44;38;0.590909090909091;18;26;0.0909090909090909;0.409090909090909
Control.SRR15539832;36;38;0.5;18;18;0;0.5
Control.SRR15539832;38;38;0.421052631578947;22;16;0.0789473684210527;0.421052631578947
Control.SRR15539832;34;38;0.588235294117647;14;20;0.0882352941176471;0.411764705882353
Control.SRR15539832;44;38;0.454545454545455;24;20;0.0454545454545455;0.454545454545455
Control.SRR15539832;40;38;0.575;17;23;0.075;0.425
Control.SRR15539832;38;38;0.526315789473684;18;20;0.0263157894736842;0.473684210526316
Control.SRR15539832;40;38;0.4;24;16;0.1;0.4
Control.SRR15539832;35;38;0.6;14;21;0.1;0.4
Control.SRR15539832;37;38;0.567567567567568;16;21;0.0675675675675675;0.432432432432432
Control.SRR15539832;43;38;0.348837209302326;28;15;0.151162790697674;0.348837209302326
Control.SRR15539832;36;38;0.472222222222222;19;17;0.0277777777777778;0.472222222222222
Control.SRR15539832;35;38;0.628571428571429;13;22;0.128571428571429;0.371428571428571
Control.SRR15539832;35;38;0.542857142857143;16;19;0.0428571428571428;0.457142857142857
Control.SRR15539832;40;38;0.625;15;25;0.125;0.375
Control.SRR15539832;34;38;0.588235294117647;14;20;0.0882352941176471;0.411764705882353
Control.SRR15539832;39;38;0.358974358974359;25;14;0.141025641025641;0.358974358974359
Control.SRR15539832;39;38;0.461538461538462;21;18;0.0384615384615384;0.461538461538462
Control.SRR15539832;40;38;0.475;21;19;0.025;0.475
Control.SRR15539832;40;38;0.6;16;24;0.1;0.4
Control.SRR15539832;36;38;0.583333333333333;15;21;0.0833333333333334;0.416666666666667
Control.SRR15539832;39;38;0.461538461538462;21;18;0.0384615384615384;0.461538461538462
Control.SRR15539832;39;38;0.512820512820513;19;20;0.0128205128205128;0.487179487179487
Control.SRR15539832;36;38;0.666666666666667;12;24;0.166666666666667;0.333333333333333
Control.SRR15539832;38;38;0.394736842105263;23;15;0.105263157894737;0.394736842105263
Control.SRR15539832;38;38;0.526315789473684;18;20;0.0263157894736842;0.473684210526316
Control.SRR15539832;34;38;0.558823529411765;15;19;0.0588235294117647;0.441176470588235
Control.SRR15539832;43;38;0.441860465116279;24;19;0.0581395348837209;0.441860465116279
Control.SRR15539832;36;38;0.555555555555556;16;20;0.0555555555555556;0.444444444444444
Control.SRR15539832;42;38;0.404761904761905;25;17;0.0952380952380952;0.404761904761905
Control.SRR15539832;41;38;0.48780487804878;21;20;0.0121951219512195;0.48780487804878
Control.SRR15539832;39;38;0.538461538461538;18;21;0.0384615384615384;0.461538461538462
Control.SRR15539832;34;38;0.411764705882353;20;14;0.0882352941176471;0.411764705882353
Control.SRR15539832;42;38;0.523809523809524;20;22;0.0238095238095238;0.476190476190476
Control.SRR15539832;35;38;0.428571428571429;20;15;0.0714285714285715;0.428571428571429
Control.SRR15539832;35;38;0.514285714285714;17;18;0.0142857142857142;0.485714285714286
Control.SRR15539832;35;38;0.457142857142857;19;16;0.0428571428571429;0.457142857142857
Control.SRR15539832;36;38;0.527777777777778;17;19;0.0277777777777778;0.472222222222222
Control.SRR15539832;40;38;0.525;19;21;0.025;0.475
Control.SRR15539832;40;38;0.425;23;17;0.075;0.425
Control.SRR15539832;37;38;0.567567567567568;16;21;0.0675675675675675;0.432432432432432
Control.SRR15539832;35;38;0.514285714285714;17;18;0.0142857142857142;0.485714285714286
Control.SRR15539832;35;38;0.571428571428571;15;20;0.0714285714285714;0.428571428571429
Control.SRR15539832;41;38;0.536585365853659;19;22;0.0365853658536586;0.463414634146341
Control.SRR15539832;42;38;0.69047619047619;13;29;0.19047619047619;0.30952380952381
Control.SRR15539832;44;38;0.613636363636364;17;27;0.113636363636364;0.386363636363636
Control.SRR15539832;36;38;0.416666666666667;21;15;0.0833333333333333;0.416666666666667
Control.SRR15539832;43;38;0.558139534883721;19;24;0.0581395348837209;0.441860465116279
Control.SRR15539832;40;38;0.475;21;19;0.025;0.475
Control.SRR15539832;37;38;0.513513513513513;18;19;0.0135135135135135;0.486486486486487
Control.SRR15539832;34;38;0.470588235294118;18;16;0.0294117647058824;0.470588235294118
Control.SRR15539832;36;38;0.555555555555556;16;20;0.0555555555555556;0.444444444444444
Control.SRR15539832;34;38;0.441176470588235;19;15;0.0588235294117647;0.441176470588235
Control.SRR15539832;43;38;0.511627906976744;21;22;0.0116279069767442;0.488372093023256
Control.SRR15539832;40;38;0.525;19;21;0.025;0.475
Control.SRR15539832;37;38;0.432432432432432;21;16;0.0675675675675675;0.432432432432432
Control.SRR15539832;42;38;0.476190476190476;22;20;0.0238095238095238;0.476190476190476
Control.SRR15539832;35;38;0.571428571428571;15;20;0.0714285714285714;0.428571428571429
Control.SRR15539832;41;38;0.51219512195122;20;21;0.0121951219512195;0.48780487804878
Control.SRR15539832;37;38;0.486486486486487;19;18;0.0135135135135135;0.486486486486487
Control.SRR15539832;38;38;0.526315789473684;18;20;0.0263157894736842;0.473684210526316
Control.SRR15539832;34;38;0.382352941176471;21;13;0.117647058823529;0.382352941176471
Control.SRR15539832;41;38;0.463414634146341;22;19;0.0365853658536585;0.463414634146341
Control.SRR15539832;38;38;0.578947368421053;16;22;0.0789473684210527;0.421052631578947
Control.SRR15539832;38;38;0.447368421052632;21;17;0.0526315789473684;0.447368421052632
Control.SRR15539832;36;38;0.638888888888889;13;23;0.138888888888889;0.361111111111111
Control.SRR15539832;40;38;0.4;24;16;0.1;0.4
Control.SRR15539832;40;38;0.5;20;20;0;0.5
Control.SRR15539832;39;38;0.358974358974359;25;14;0.141025641025641;0.358974358974359
Control.SRR15539832;34;38;0.441176470588235;19;15;0.0588235294117647;0.441176470588235
Control.SRR15539832;41;38;0.414634146341463;24;17;0.0853658536585366;0.414634146341463
Control.SRR15539832;42;38;0.547619047619048;19;23;0.0476190476190477;0.452380952380952
Control.SRR15539832;39;38;0.487179487179487;20;19;0.0128205128205128;0.487179487179487
Control.SRR15539832;42;38;0.571428571428571;18;24;0.0714285714285714;0.428571428571429
Control.SRR15539832;38;38;0.552631578947368;17;21;0.0526315789473685;0.447368421052632
Control.SRR15539832;35;38;0.428571428571429;20;15;0.0714285714285715;0.428571428571429
Control.SRR15539832;38;38;0.421052631578947;22;16;0.0789473684210527;0.421052631578947
Control.SRR15539832;38;38;0.473684210526316;20;18;0.0263157894736842;0.473684210526316
Control.SRR15539832;38;38;0.578947368421053;16;22;0.0789473684210527;0.421052631578947
Control.SRR15539832;37;38;0.567567567567568;16;21;0.0675675675675675;0.432432432432432
Control.SRR15539832;41;38;0.48780487804878;21;20;0.0121951219512195;0.48780487804878
Control.SRR15539832;37;38;0.378378378378378;23;14;0.121621621621622;0.378378378378378
Control.SRR15539832;40;38;0.55;18;22;0.05;0.45
Control.SRR15539832;39;38;0.461538461538462;21;18;0.0384615384615384;0.461538461538462
Control.SRR15539832;39;38;0.435897435897436;22;17;0.0641025641025641;0.435897435897436
Control.SRR15539832;42;38;0.476190476190476;22;20;0.0238095238095238;0.476190476190476
Control.SRR15539832;37;38;0.486486486486487;19;18;0.0135135135135135;0.486486486486487
Control.SRR15539832;38;38;0.421052631578947;22;16;0.0789473684210527;0.421052631578947
Control.SRR15539832;43;38;0.395348837209302;26;17;0.104651162790698;0.395348837209302
Control.SRR15539832;40;38;0.675;13;27;0.175;0.325
Control.SRR15539832;34;38;0.647058823529412;12;22;0.147058823529412;0.352941176470588
Control.SRR15539832;37;38;0.621621621621622;14;23;0.121621621621622;0.378378378378378
Control.SRR15539832;36;38;0.555555555555556;16;20;0.0555555555555556;0.444444444444444
Control.SRR15539832;36;38;0.555555555555556;16;20;0.0555555555555556;0.444444444444444
Control.SRR15539832;36;38;0.527777777777778;17;19;0.0277777777777778;0.472222222222222
Control.SRR15539832;36;38;0.555555555555556;16;20;0.0555555555555556;0.444444444444444
Control.SRR15539832;44;38;0.590909090909091;18;26;0.0909090909090909;0.409090909090909
Control.SRR15539832;43;38;0.348837209302326;28;15;0.151162790697674;0.348837209302326
Control.SRR15539832;36;38;0.583333333333333;15;21;0.0833333333333334;0.416666666666667
Control.SRR15539832;42;38;0.547619047619048;19;23;0.0476190476190477;0.452380952380952
Control.SRR15539832;34;38;0.411764705882353;20;14;0.0882352941176471;0.411764705882353
Control.SRR15539832;44;38;0.409090909090909;26;18;0.0909090909090909;0.409090909090909
Control.SRR15539832;38;38;0.657894736842105;13;25;0.157894736842105;0.342105263157895
Control.SRR15539832;44;38;0.454545454545455;24;20;0.0454545454545455;0.454545454545455
Control.SRR15539832;36;38;0.444444444444444;20;16;0.0555555555555556;0.444444444444444
Control.SRR15539832;35;38;0.514285714285714;17;18;0.0142857142857142;0.485714285714286
Control.SRR15539832;35;38;0.542857142857143;16;19;0.0428571428571428;0.457142857142857
Control.SRR15539832;41;38;0.609756097560976;16;25;0.109756097560976;0.390243902439024
Control.SRR15539832;40;38;0.525;19;21;0.025;0.475
Control.SRR15539832;39;38;0.435897435897436;22;17;0.0641025641025641;0.435897435897436
Control.SRR15539832;35;38;0.4;21;14;0.1;0.4
Control.SRR15539832;41;38;0.48780487804878;21;20;0.0121951219512195;0.48780487804878
Control.SRR15539832;34;38;0.558823529411765;15;19;0.0588235294117647;0.441176470588235
Control.SRR15539832;42;38;0.547619047619048;19;23;0.0476190476190477;0.452380952380952
Control.SRR15539832;44;38;0.5;22;22;0;0.5
Control.SRR15539832;43;38;0.488372093023256;22;21;0.0116279069767442;0.488372093023256
Control.SRR15539832;36;38;0.388888888888889;22;14;0.111111111111111;0.388888888888889
Control.SRR15539832;37;38;0.540540540540541;17;20;0.0405405405405406;0.459459459459459
Control.SRR15539832;40;38;0.45;22;18;0.05;0.45
Control.SRR15539832;38;38;0.552631578947368;17;21;0.0526315789473685;0.447368421052632
Control.SRR15539832;37;38;0.405405405405405;22;15;0.0945945945945946;0.405405405405405
Control.SRR15539832;40;38;0.6;16;24;0.1;0.4
Control.SRR15539832;41;38;0.48780487804878;21;20;0.0121951219512195;0.48780487804878
Control.SRR15539832;43;38;0.465116279069767;23;20;0.0348837209302326;0.465116279069767
Control.SRR15539832;42;38;0.5;21;21;0;0.5
Control.SRR15539832;43;38;0.441860465116279;24;19;0.0581395348837209;0.441860465116279
Control.SRR15539832;39;38;0.384615384615385;24;15;0.115384615384615;0.384615384615385
Control.SRR15539832;39;38;0.461538461538462;21;18;0.0384615384615384;0.461538461538462
Control.SRR15539832;44;38;0.590909090909091;18;26;0.0909090909090909;0.409090909090909
Control.SRR15539832;35;38;0.314285714285714;24;11;0.185714285714286;0.314285714285714
Control.SRR15539832;43;38;0.534883720930233;20;23;0.0348837209302325;0.465116279069767
Control.SRR15539832;42;38;0.476190476190476;22;20;0.0238095238095238;0.476190476190476
Control.SRR15539832;39;38;0.58974358974359;16;23;0.0897435897435898;0.41025641025641
Control.SRR15539832;35;38;0.4;21;14;0.1;0.4
Control.SRR15539832;36;38;0.444444444444444;20;16;0.0555555555555556;0.444444444444444
Control.SRR15539832;43;38;0.511627906976744;21;22;0.0116279069767442;0.488372093023256
Control.SRR15539832;40;38;0.55;18;22;0.05;0.45
Control.SRR15539832;43;38;0.558139534883721;19;24;0.0581395348837209;0.441860465116279
Control.SRR15539832;43;38;0.488372093023256;22;21;0.0116279069767442;0.488372093023256
Control.SRR15539832;37;38;0.459459459459459;20;17;0.0405405405405405;0.459459459459459
Control.SRR15539832;38;38;0.394736842105263;23;15;0.105263157894737;0.394736842105263
Control.SRR15539832;39;38;0.58974358974359;16;23;0.0897435897435898;0.41025641025641
Control.SRR15539832;40;38;0.425;23;17;0.075;0.425
Control.SRR15539832;40;38;0.5;20;20;0;0.5
Control.SRR15539832;38;38;0.631578947368421;14;24;0.131578947368421;0.368421052631579
Control.SRR15539832;35;38;0.628571428571429;13;22;0.128571428571429;0.371428571428571
Control.SRR15539832;36;38;0.5;18;18;0;0.5
Control.SRR15539832;38;38;0.447368421052632;21;17;0.0526315789473684;0.447368421052632
Control.SRR15539832;44;38;0.5;22;22;0;0.5
Control.SRR15539832;38;38;0.578947368421053;16;22;0.0789473684210527;0.421052631578947
Control.SRR15539832;37;38;0.648648648648649;13;24;0.148648648648649;0.351351351351351
Control.SRR15539832;41;38;0.48780487804878;21;20;0.0121951219512195;0.48780487804878
Control.SRR15539832;38;38;0.447368421052632;21;17;0.0526315789473684;0.447368421052632
Control.SRR15539832;41;38;0.292682926829268;29;12;0.207317073170732;0.292682926829268
Control.SRR15539832;39;38;0.512820512820513;19;20;0.0128205128205128;0.487179487179487
Control.SRR15539832;44;38;0.431818181818182;25;19;0.0681818181818182;0.431818181818182
Control.SRR15539832;40;38;0.5;20;20;0;0.5
Control.SRR15539832;41;38;0.51219512195122;20;21;0.0121951219512195;0.48780487804878
Control.SRR15539832;38;38;0.578947368421053;16;22;0.0789473684210527;0.421052631578947
Control.SRR15539832;43;38;0.395348837209302;26;17;0.104651162790698;0.395348837209302
Control.SRR15539832;36;38;0.472222222222222;19;17;0.0277777777777778;0.472222222222222
Control.SRR15539832;36;38;0.527777777777778;17;19;0.0277777777777778;0.472222222222222
Control.SRR15539832;41;38;0.439024390243902;23;18;0.0609756097560976;0.439024390243902
Control.SRR15539832;42;38;0.428571428571429;24;18;0.0714285714285715;0.428571428571429
Control.SRR15539832;43;38;0.558139534883721;19;24;0.0581395348837209;0.441860465116279
Control.SRR15539832;37;38;0.459459459459459;20;17;0.0405405405405405;0.459459459459459
Control.SRR15539832;36;38;0.638888888888889;13;23;0.138888888888889;0.361111111111111
Control.SRR15539832;39;38;0.538461538461538;18;21;0.0384615384615384;0.461538461538462
Control.SRR15539832;36;38;0.5;18;18;0;0.5
Control.SRR15539832;43;38;0.488372093023256;22;21;0.0116279069767442;0.488372093023256
Control.SRR15539832;40;38;0.45;22;18;0.05;0.45
Control.SRR15539832;44;38;0.431818181818182;25;19;0.0681818181818182;0.431818181818182
Control.SRR15539832;40;38;0.5;20;20;0;0.5
Control.SRR15539832;38;38;0.473684210526316;20;18;0.0263157894736842;0.473684210526316
Control.SRR15539832;38;38;0.657894736842105;13;25;0.157894736842105;0.342105263157895
Control.SRR15539832;38;38;0.526315789473684;18;20;0.0263157894736842;0.473684210526316
Control.SRR15539832;36;38;0.722222222222222;10;26;0.222222222222222;0.277777777777778
Control.SRR15539832;34;38;0.5;17;17;0;0.5
Control.SRR15539832;38;38;0.552631578947368;17;21;0.0526315789473685;0.447368421052632
Control.SRR15539832;35;38;0.457142857142857;19;16;0.0428571428571429;0.457142857142857
Control.SRR15539832;34;38;0.676470588235294;11;23;0.176470588235294;0.323529411764706
Control.SRR15539832;39;38;0.564102564102564;17;22;0.0641025641025641;0.435897435897436
Control.SRR15539832;38;38;0.526315789473684;18;20;0.0263157894736842;0.473684210526316
Control.SRR15539832;41;38;0.634146341463415;15;26;0.134146341463415;0.365853658536585
Control.SRR15539832;35;38;0.514285714285714;17;18;0.0142857142857142;0.485714285714286
Control.SRR15539832;40;38;0.5;20;20;0;0.5
Control.SRR15539832;42;38;0.476190476190476;22;20;0.0238095238095238;0.476190476190476
Control.SRR15539832;42;38;0.666666666666667;14;28;0.166666666666667;0.333333333333333
Control.SRR15539832;39;38;0.538461538461538;18;21;0.0384615384615384;0.461538461538462
Control.SRR15539832;35;38;0.342857142857143;23;12;0.157142857142857;0.342857142857143
Control.SRR15539832;35;38;0.428571428571429;20;15;0.0714285714285715;0.428571428571429
Control.SRR15539832;41;38;0.585365853658537;17;24;0.0853658536585366;0.414634146341463
Control.SRR15539832;40;38;0.4;24;16;0.1;0.4
Control.SRR15539832;40;38;0.45;22;18;0.05;0.45
Control.SRR15539832;40;38;0.5;20;20;0;0.5
Control.SRR15539832;42;38;0.404761904761905;25;17;0.0952380952380952;0.404761904761905
Control.SRR15539832;40;38;0.475;21;19;0.025;0.475
Control.SRR15539832;38;38;0.578947368421053;16;22;0.0789473684210527;0.421052631578947
Control.SRR15539832;37;38;0.594594594594595;15;22;0.0945945945945946;0.405405405405405
Control.SRR15539832;39;38;0.461538461538462;21;18;0.0384615384615384;0.461538461538462
Control.SRR15539832;44;38;0.5;22;22;0;0.5
Control.SRR15539832;44;38;0.613636363636364;17;27;0.113636363636364;0.386363636363636
Control.SRR15539832;36;38;0.472222222222222;19;17;0.0277777777777778;0.472222222222222
Control.SRR15539832;38;38;0.5;19;19;0;0.5
Control.SRR15539832;39;38;0.41025641025641;23;16;0.0897435897435898;0.41025641025641
Control.SRR15539832;35;38;0.628571428571429;13;22;0.128571428571429;0.371428571428571
Control.SRR15539832;36;38;0.555555555555556;16;20;0.0555555555555556;0.444444444444444
Control.SRR15539832;41;38;0.560975609756098;18;23;0.0609756097560976;0.439024390243902
Control.SRR15539832;38;38;0.473684210526316;20;18;0.0263157894736842;0.473684210526316
Control.SRR15539832;36;38;0.472222222222222;19;17;0.0277777777777778;0.472222222222222
Control.SRR15539832;36;38;0.722222222222222;10;26;0.222222222222222;0.277777777777778
Control.SRR15539832;40;38;0.425;23;17;0.075;0.425
Control.SRR15539832;39;38;0.461538461538462;21;18;0.0384615384615384;0.461538461538462
Control.SRR15539832;40;38;0.575;17;23;0.075;0.425
Control.SRR15539832;35;38;0.514285714285714;17;18;0.0142857142857142;0.485714285714286
Control.SRR15539832;37;38;0.567567567567568;16;21;0.0675675675675675;0.432432432432432
Control.SRR15539832;39;38;0.333333333333333;26;13;0.166666666666667;0.333333333333333
Control.SRR15539832;37;38;0.567567567567568;16;21;0.0675675675675675;0.432432432432432
Control.SRR15539832;34;38;0.441176470588235;19;15;0.0588235294117647;0.441176470588235
Control.SRR15539832;41;38;0.365853658536585;26;15;0.134146341463415;0.365853658536585
Control.SRR15539832;38;38;0.447368421052632;21;17;0.0526315789473684;0.447368421052632
Control.SRR15539832;38;38;0.473684210526316;20;18;0.0263157894736842;0.473684210526316
Control.SRR15539832;37;38;0.405405405405405;22;15;0.0945945945945946;0.405405405405405
Control.SRR15539832;34;38;0.529411764705882;16;18;0.0294117647058824;0.470588235294118
Control.SRR15539832;41;38;0.439024390243902;23;18;0.0609756097560976;0.439024390243902
Control.SRR15539832;40;38;0.25;30;10;0.25;0.25
Control.SRR15539832;37;38;0.567567567567568;16;21;0.0675675675675675;0.432432432432432
Control.SRR15539832;42;38;0.476190476190476;22;20;0.0238095238095238;0.476190476190476
Control.SRR15539832;43;38;0.674418604651163;14;29;0.174418604651163;0.325581395348837
Control.SRR15539832;35;38;0.571428571428571;15;20;0.0714285714285714;0.428571428571429
Control.SRR15539832;44;38;0.477272727272727;23;21;0.0227272727272727;0.477272727272727
Control.SRR15539832;39;38;0.538461538461538;18;21;0.0384615384615384;0.461538461538462
Control.SRR15539832;36;38;0.416666666666667;21;15;0.0833333333333333;0.416666666666667
Control.SRR15539832;41;38;0.414634146341463;24;17;0.0853658536585366;0.414634146341463
Control.SRR15539832;38;38;0.5;19;19;0;0.5
Control.SRR15539832;35;38;0.485714285714286;18;17;0.0142857142857143;0.485714285714286
Control.SRR15539832;38;38;0.5;19;19;0;0.5
Control.SRR15539832;34;38;0.470588235294118;18;16;0.0294117647058824;0.470588235294118
Control.SRR15539832;37;38;0.513513513513513;18;19;0.0135135135135135;0.486486486486487
Control.SRR15539832;40;38;0.425;23;17;0.075;0.425
Control.SRR15539832;44;38;0.613636363636364;17;27;0.113636363636364;0.386363636363636
Control.SRR15539832;34;38;0.588235294117647;14;20;0.0882352941176471;0.411764705882353
Control.SRR15539832;34;38;0.411764705882353;20;14;0.0882352941176471;0.411764705882353
Control.SRR15539832;41;38;0.439024390243902;23;18;0.0609756097560976;0.439024390243902
Control.SRR15539832;43;38;0.604651162790698;17;26;0.104651162790698;0.395348837209302
Control.SRR15539832;44;38;0.431818181818182;25;19;0.0681818181818182;0.431818181818182
Control.SRR15539832;40;38;0.4;24;16;0.1;0.4
Control.SRR15539832;38;38;0.605263157894737;15;23;0.105263157894737;0.394736842105263
Control.SRR15539832;34;38;0.411764705882353;20;14;0.0882352941176471;0.411764705882353
Control.SRR15539832;42;38;0.523809523809524;20;22;0.0238095238095238;0.476190476190476
Control.SRR15539832;42;38;0.380952380952381;26;16;0.119047619047619;0.380952380952381
Control.SRR15539832;36;38;0.5;18;18;0;0.5
Control.SRR15539832;37;38;0.486486486486487;19;18;0.0135135135135135;0.486486486486487
Control.SRR15539832;35;38;0.514285714285714;17;18;0.0142857142857142;0.485714285714286
Control.SRR15539832;39;38;0.615384615384615;15;24;0.115384615384615;0.384615384615385
Control.SRR15539832;38;38;0.473684210526316;20;18;0.0263157894736842;0.473684210526316
Control.SRR15539832;39;38;0.461538461538462;21;18;0.0384615384615384;0.461538461538462
Control.SRR15539832;43;38;0.465116279069767;23;20;0.0348837209302326;0.465116279069767
Control.SRR15539832;38;38;0.657894736842105;13;25;0.157894736842105;0.342105263157895
Control.SRR15539832;41;38;0.682926829268293;13;28;0.182926829268293;0.317073170731707
Control.SRR15539832;39;38;0.461538461538462;21;18;0.0384615384615384;0.461538461538462
Control.SRR15539832;36;38;0.555555555555556;16;20;0.0555555555555556;0.444444444444444
Control.SRR15539832;44;38;0.454545454545455;24;20;0.0454545454545455;0.454545454545455
Control.SRR15539832;37;38;0.405405405405405;22;15;0.0945945945945946;0.405405405405405
Control.SRR15539832;41;38;0.463414634146341;22;19;0.0365853658536585;0.463414634146341
Control.SRR15539832;41;38;0.341463414634146;27;14;0.158536585365854;0.341463414634146
Control.SRR15539832;44;38;0.340909090909091;29;15;0.159090909090909;0.340909090909091
Control.SRR15539832;44;38;0.545454545454545;20;24;0.0454545454545454;0.454545454545455
Control.SRR15539832;37;38;0.459459459459459;20;17;0.0405405405405405;0.459459459459459
Control.SRR15539832;35;38;0.514285714285714;17;18;0.0142857142857142;0.485714285714286
Control.SRR15539832;35;38;0.542857142857143;16;19;0.0428571428571428;0.457142857142857
Control.SRR15539832;38;38;0.394736842105263;23;15;0.105263157894737;0.394736842105263
Control.SRR15539832;40;38;0.425;23;17;0.075;0.425
Control.SRR15539832;42;38;0.523809523809524;20;22;0.0238095238095238;0.476190476190476
Control.SRR15539832;37;38;0.540540540540541;17;20;0.0405405405405406;0.459459459459459
Control.SRR15539832;36;38;0.5;18;18;0;0.5
Control.SRR15539832;36;38;0.5;18;18;0;0.5
Control.SRR15539832;44;38;0.454545454545455;24;20;0.0454545454545455;0.454545454545455
Control.SRR15539832;43;38;0.441860465116279;24;19;0.0581395348837209;0.441860465116279
Control.SRR15539832;37;38;0.648648648648649;13;24;0.148648648648649;0.351351351351351
Control.SRR15539832;35;38;0.4;21;14;0.1;0.4
Control.SRR15539832;39;38;0.487179487179487;20;19;0.0128205128205128;0.487179487179487
Control.SRR15539832;38;38;0.394736842105263;23;15;0.105263157894737;0.394736842105263
Control.SRR15539832;41;38;0.341463414634146;27;14;0.158536585365854;0.341463414634146
Control.SRR15539832;39;38;0.41025641025641;23;16;0.0897435897435898;0.41025641025641
Control.SRR15539832;39;38;0.58974358974359;16;23;0.0897435897435898;0.41025641025641
Control.SRR15539832;37;38;0.459459459459459;20;17;0.0405405405405405;0.459459459459459
Control.SRR15539832;43;38;0.465116279069767;23;20;0.0348837209302326;0.465116279069767
Control.SRR15539832;42;38;0.476190476190476;22;20;0.0238095238095238;0.476190476190476
Control.SRR15539832;44;38;0.5;22;22;0;0.5
Control.SRR15539832;42;38;0.452380952380952;23;19;0.0476190476190476;0.452380952380952
Control.SRR15539832;38;38;0.473684210526316;20;18;0.0263157894736842;0.473684210526316
Control.SRR15539832;34;38;0.558823529411765;15;19;0.0588235294117647;0.441176470588235
Control.SRR15539832;41;38;0.439024390243902;23;18;0.0609756097560976;0.439024390243902
Control.SRR15539832;44;38;0.545454545454545;20;24;0.0454545454545454;0.454545454545455
Control.SRR15539832;42;38;0.476190476190476;22;20;0.0238095238095238;0.476190476190476
Control.SRR15539832;36;38;0.555555555555556;16;20;0.0555555555555556;0.444444444444444
Control.SRR15539832;43;38;0.488372093023256;22;21;0.0116279069767442;0.488372093023256
Control.SRR15539832;39;38;0.512820512820513;19;20;0.0128205128205128;0.487179487179487
Control.SRR15539832;34;38;0.529411764705882;16;18;0.0294117647058824;0.470588235294118
Control.SRR15539832;35;38;0.514285714285714;17;18;0.0142857142857142;0.485714285714286
Control.SRR15539832;36;38;0.5;18;18;0;0.5
Control.SRR15539832;37;38;0.702702702702703;11;26;0.202702702702703;0.297297297297297
Control.SRR15539832;43;38;0.418604651162791;25;18;0.0813953488372093;0.418604651162791
Control.SRR15539832;42;38;0.5;21;21;0;0.5
Control.SRR15539832;41;38;0.560975609756098;18;23;0.0609756097560976;0.439024390243902
Control.SRR15539832;44;38;0.522727272727273;21;23;0.0227272727272727;0.477272727272727
Control.SRR15539832;40;38;0.475;21;19;0.025;0.475
Control.SRR15539832;35;38;0.6;14;21;0.1;0.4
Control.SRR15539832;36;38;0.527777777777778;17;19;0.0277777777777778;0.472222222222222
Control.SRR15539832;41;38;0.51219512195122;20;21;0.0121951219512195;0.48780487804878
Control.SRR15539832;43;38;0.534883720930233;20;23;0.0348837209302325;0.465116279069767
Control.SRR15539832;37;38;0.540540540540541;17;20;0.0405405405405406;0.459459459459459
Control.SRR15539832;36;38;0.444444444444444;20;16;0.0555555555555556;0.444444444444444
Control.SRR15539832;41;38;0.414634146341463;24;17;0.0853658536585366;0.414634146341463
Control.SRR15539832;39;38;0.461538461538462;21;18;0.0384615384615384;0.461538461538462
Control.SRR15539832;35;38;0.514285714285714;17;18;0.0142857142857142;0.485714285714286
Control.SRR15539832;41;38;0.463414634146341;22;19;0.0365853658536585;0.463414634146341
Control.SRR15539832;37;38;0.594594594594595;15;22;0.0945945945945946;0.405405405405405
Control.SRR15539832;39;38;0.487179487179487;20;19;0.0128205128205128;0.487179487179487
Control.SRR15539832;37;38;0.378378378378378;23;14;0.121621621621622;0.378378378378378
Control.SRR15539832;35;38;0.457142857142857;19;16;0.0428571428571429;0.457142857142857
Control.SRR15539832;41;38;0.560975609756098;18;23;0.0609756097560976;0.439024390243902
Control.SRR15539832;40;38;0.45;22;18;0.05;0.45
Control.SRR15539832;36;38;0.5;18;18;0;0.5
Control.SRR15539832;37;38;0.459459459459459;20;17;0.0405405405405405;0.459459459459459
Control.SRR15539832;43;38;0.418604651162791;25;18;0.0813953488372093;0.418604651162791
Control.SRR15539832;38;38;0.605263157894737;15;23;0.105263157894737;0.394736842105263
Control.SRR15539832;44;38;0.477272727272727;23;21;0.0227272727272727;0.477272727272727
Control.SRR15539832;39;38;0.666666666666667;13;26;0.166666666666667;0.333333333333333
Control.SRR15539832;42;38;0.428571428571429;24;18;0.0714285714285715;0.428571428571429
Control.SRR15539832;42;38;0.452380952380952;23;19;0.0476190476190476;0.452380952380952
Control.SRR15539832;42;38;0.476190476190476;22;20;0.0238095238095238;0.476190476190476
Control.SRR15539832;39;38;0.358974358974359;25;14;0.141025641025641;0.358974358974359
Control.SRR15539832;41;38;0.439024390243902;23;18;0.0609756097560976;0.439024390243902
Control.SRR15539832;39;38;0.461538461538462;21;18;0.0384615384615384;0.461538461538462
Control.SRR15539832;42;38;0.452380952380952;23;19;0.0476190476190476;0.452380952380952
Control.SRR15539832;44;38;0.545454545454545;20;24;0.0454545454545454;0.454545454545455
Control.SRR15539832;40;38;0.6;16;24;0.1;0.4
Control.SRR15539832;36;38;0.611111111111111;14;22;0.111111111111111;0.388888888888889
Control.SRR15539832;38;38;0.5;19;19;0;0.5
Control.SRR15539832;41;38;0.585365853658537;17;24;0.0853658536585366;0.414634146341463
Control.SRR15539832;34;38;0.529411764705882;16;18;0.0294117647058824;0.470588235294118
Control.SRR15539832;43;38;0.558139534883721;19;24;0.0581395348837209;0.441860465116279
Control.SRR15539832;39;38;0.538461538461538;18;21;0.0384615384615384;0.461538461538462
Control.SRR15539832;44;38;0.613636363636364;17;27;0.113636363636364;0.386363636363636
Control.SRR15539832;43;38;0.441860465116279;24;19;0.0581395348837209;0.441860465116279
Control.SRR15539832;37;38;0.405405405405405;22;15;0.0945945945945946;0.405405405405405
Control.SRR15539832;40;38;0.5;20;20;0;0.5
Control.SRR15539832;40;38;0.6;16;24;0.1;0.4
Control.SRR15539832;44;38;0.545454545454545;20;24;0.0454545454545454;0.454545454545455
Control.SRR15539832;43;38;0.418604651162791;25;18;0.0813953488372093;0.418604651162791
Control.SRR15539832;44;38;0.454545454545455;24;20;0.0454545454545455;0.454545454545455
Control.SRR15539832;44;38;0.522727272727273;21;23;0.0227272727272727;0.477272727272727
Control.SRR15539832;37;38;0.486486486486487;19;18;0.0135135135135135;0.486486486486487
Control.SRR15539832;44;38;0.454545454545455;24;20;0.0454545454545455;0.454545454545455
Control.SRR15539832;43;38;0.465116279069767;23;20;0.0348837209302326;0.465116279069767
Control.SRR15539832;44;38;0.477272727272727;23;21;0.0227272727272727;0.477272727272727
Control.SRR15539832;36;38;0.5;18;18;0;0.5
Control.SRR15539832;44;38;0.522727272727273;21;23;0.0227272727272727;0.477272727272727
Control.SRR15539832;37;38;0.378378378378378;23;14;0.121621621621622;0.378378378378378
Control.SRR15539832;34;38;0.441176470588235;19;15;0.0588235294117647;0.441176470588235
Control.SRR15539832;42;38;0.452380952380952;23;19;0.0476190476190476;0.452380952380952
Control.SRR15539832;42;38;0.428571428571429;24;18;0.0714285714285715;0.428571428571429
Control.SRR15539832;43;38;0.604651162790698;17;26;0.104651162790698;0.395348837209302
Control.SRR15539832;39;38;0.487179487179487;20;19;0.0128205128205128;0.487179487179487
Control.SRR15539832;40;38;0.5;20;20;0;0.5
Control.SRR15539832;43;38;0.441860465116279;24;19;0.0581395348837209;0.441860465116279
Control.SRR15539832;35;38;0.514285714285714;17;18;0.0142857142857142;0.485714285714286
Control.SRR15539832;34;38;0.558823529411765;15;19;0.0588235294117647;0.441176470588235
Control.SRR15539832;39;38;0.538461538461538;18;21;0.0384615384615384;0.461538461538462
Control.SRR15539832;36;38;0.416666666666667;21;15;0.0833333333333333;0.416666666666667
Control.SRR15539832;34;38;0.588235294117647;14;20;0.0882352941176471;0.411764705882353
Control.SRR15539832;35;38;0.485714285714286;18;17;0.0142857142857143;0.485714285714286
Control.SRR15539832;41;38;0.414634146341463;24;17;0.0853658536585366;0.414634146341463
Control.SRR15539832;37;38;0.567567567567568;16;21;0.0675675675675675;0.432432432432432
Control.SRR15539832;38;38;0.447368421052632;21;17;0.0526315789473684;0.447368421052632
Control.SRR15539832;38;38;0.5;19;19;0;0.5
Control.SRR15539832;38;38;0.552631578947368;17;21;0.0526315789473685;0.447368421052632
Control.SRR15539832;43;38;0.465116279069767;23;20;0.0348837209302326;0.465116279069767
Control.SRR15539832;35;38;0.514285714285714;17;18;0.0142857142857142;0.485714285714286
Control.SRR15539832;36;38;0.5;18;18;0;0.5
Control.SRR15539832;38;38;0.578947368421053;16;22;0.0789473684210527;0.421052631578947
Control.SRR15539832;39;38;0.538461538461538;18;21;0.0384615384615384;0.461538461538462
Control.SRR15539832;42;38;0.547619047619048;19;23;0.0476190476190477;0.452380952380952
Control.SRR15539832;40;38;0.675;13;27;0.175;0.325
Control.SRR15539832;38;38;0.552631578947368;17;21;0.0526315789473685;0.447368421052632
Control.SRR15539832;40;38;0.525;19;21;0.025;0.475
Control.SRR15539832;37;38;0.513513513513513;18;19;0.0135135135135135;0.486486486486487
Control.SRR15539832;43;38;0.627906976744186;16;27;0.127906976744186;0.372093023255814
Control.SRR15539832;41;38;0.414634146341463;24;17;0.0853658536585366;0.414634146341463
Control.SRR15539832;35;38;0.457142857142857;19;16;0.0428571428571429;0.457142857142857
Control.SRR15539832;40;38;0.575;17;23;0.075;0.425
Control.SRR15539832;39;38;0.461538461538462;21;18;0.0384615384615384;0.461538461538462
Control.SRR15539832;42;38;0.380952380952381;26;16;0.119047619047619;0.380952380952381
Control.SRR15539832;39;38;0.512820512820513;19;20;0.0128205128205128;0.487179487179487
Control.SRR15539832;34;38;0.411764705882353;20;14;0.0882352941176471;0.411764705882353
Control.SRR15539832;41;38;0.390243902439024;25;16;0.109756097560976;0.390243902439024
Control.SRR15539832;39;38;0.435897435897436;22;17;0.0641025641025641;0.435897435897436
Control.SRR15539832;41;38;0.439024390243902;23;18;0.0609756097560976;0.439024390243902
Control.SRR15539832;34;38;0.294117647058824;24;10;0.205882352941176;0.294117647058824
Control.SRR15539832;35;38;0.342857142857143;23;12;0.157142857142857;0.342857142857143
Control.SRR15539832;43;38;0.604651162790698;17;26;0.104651162790698;0.395348837209302
Control.SRR15539832;43;38;0.395348837209302;26;17;0.104651162790698;0.395348837209302
Control.SRR15539832;36;38;0.555555555555556;16;20;0.0555555555555556;0.444444444444444
Control.SRR15539832;37;38;0.594594594594595;15;22;0.0945945945945946;0.405405405405405
Control.SRR15539832;36;38;0.638888888888889;13;23;0.138888888888889;0.361111111111111
Control.SRR15539832;35;38;0.628571428571429;13;22;0.128571428571429;0.371428571428571
Control.SRR15539832;40;38;0.625;15;25;0.125;0.375
Control.SRR15539832;41;38;0.536585365853659;19;22;0.0365853658536586;0.463414634146341
Control.SRR15539832;42;38;0.5;21;21;0;0.5
Control.SRR15539832;43;38;0.372093023255814;27;16;0.127906976744186;0.372093023255814
Control.SRR15539832;44;38;0.613636363636364;17;27;0.113636363636364;0.386363636363636
Control.SRR15539832;40;38;0.575;17;23;0.075;0.425
Control.SRR15539832;34;38;0.529411764705882;16;18;0.0294117647058824;0.470588235294118
Control.SRR15539832;38;38;0.5;19;19;0;0.5
Control.SRR15539832;37;38;0.405405405405405;22;15;0.0945945945945946;0.405405405405405
Control.SRR15539832;35;38;0.571428571428571;15;20;0.0714285714285714;0.428571428571429
Control.SRR15539832;35;38;0.371428571428571;22;13;0.128571428571429;0.371428571428571
Control.SRR15539832;41;38;0.48780487804878;21;20;0.0121951219512195;0.48780487804878
Control.SRR15539832;42;38;0.547619047619048;19;23;0.0476190476190477;0.452380952380952
Control.SRR15539832;40;38;0.5;20;20;0;0.5
Control.SRR15539832;39;38;0.538461538461538;18;21;0.0384615384615384;0.461538461538462
Control.SRR15539832;41;38;0.560975609756098;18;23;0.0609756097560976;0.439024390243902
Control.SRR15539832;44;38;0.477272727272727;23;21;0.0227272727272727;0.477272727272727
Control.SRR15539832;39;38;0.41025641025641;23;16;0.0897435897435898;0.41025641025641
Control.SRR15539832;42;38;0.547619047619048;19;23;0.0476190476190477;0.452380952380952
Control.SRR15539832;42;38;0.285714285714286;30;12;0.214285714285714;0.285714285714286
Control.SRR15539832;42;38;0.5;21;21;0;0.5
Control.SRR15539832;39;38;0.487179487179487;20;19;0.0128205128205128;0.487179487179487
Control.SRR15539832;35;38;0.6;14;21;0.1;0.4
Control.SRR15539832;38;38;0.5;19;19;0;0.5
Control.SRR15539832;40;38;0.5;20;20;0;0.5
Control.SRR15539832;42;38;0.595238095238095;17;25;0.0952380952380952;0.404761904761905
Control.SRR15539832;35;38;0.514285714285714;17;18;0.0142857142857142;0.485714285714286
Control.SRR15539832;40;38;0.5;20;20;0;0.5
Control.SRR15539832;35;38;0.371428571428571;22;13;0.128571428571429;0.371428571428571
Control.SRR15539832;37;38;0.513513513513513;18;19;0.0135135135135135;0.486486486486487
Control.SRR15539832;41;38;0.536585365853659;19;22;0.0365853658536586;0.463414634146341
Control.SRR15539832;40;38;0.525;19;21;0.025;0.475
Control.SRR15539832;34;38;0.558823529411765;15;19;0.0588235294117647;0.441176470588235
Control.SRR15539832;41;38;0.536585365853659;19;22;0.0365853658536586;0.463414634146341
Control.SRR15539832;36;38;0.611111111111111;14;22;0.111111111111111;0.388888888888889
Control.SRR15539832;41;38;0.560975609756098;18;23;0.0609756097560976;0.439024390243902
Control.SRR15539832;42;38;0.523809523809524;20;22;0.0238095238095238;0.476190476190476
Control.SRR15539832;39;38;0.41025641025641;23;16;0.0897435897435898;0.41025641025641
Control.SRR15539832;34;38;0.441176470588235;19;15;0.0588235294117647;0.441176470588235
Control.SRR15539832;35;38;0.342857142857143;23;12;0.157142857142857;0.342857142857143
Control.SRR15539832;37;38;0.513513513513513;18;19;0.0135135135135135;0.486486486486487
Control.SRR15539832;34;38;0.470588235294118;18;16;0.0294117647058824;0.470588235294118
Control.SRR15539832;40;38;0.55;18;22;0.05;0.45
Control.SRR15539832;42;38;0.476190476190476;22;20;0.0238095238095238;0.476190476190476
Control.SRR15539832;44;38;0.431818181818182;25;19;0.0681818181818182;0.431818181818182
Control.SRR15539832;41;38;0.609756097560976;16;25;0.109756097560976;0.390243902439024
Control.SRR15539832;39;38;0.538461538461538;18;21;0.0384615384615384;0.461538461538462
Control.SRR15539832;39;38;0.512820512820513;19;20;0.0128205128205128;0.487179487179487
Control.SRR15539832;39;38;0.384615384615385;24;15;0.115384615384615;0.384615384615385
Control.SRR15539832;39;38;0.512820512820513;19;20;0.0128205128205128;0.487179487179487
Control.SRR15539832;39;38;0.461538461538462;21;18;0.0384615384615384;0.461538461538462
Control.SRR15539832;44;38;0.568181818181818;19;25;0.0681818181818182;0.431818181818182
Control.SRR15539832;39;38;0.512820512820513;19;20;0.0128205128205128;0.487179487179487
Control.SRR15539832;37;38;0.432432432432432;21;16;0.0675675675675675;0.432432432432432
Control.SRR15539832;41;38;0.48780487804878;21;20;0.0121951219512195;0.48780487804878
Control.SRR15539832;41;38;0.390243902439024;25;16;0.109756097560976;0.390243902439024
Control.SRR15539832;37;38;0.459459459459459;20;17;0.0405405405405405;0.459459459459459
Control.SRR15539832;37;38;0.432432432432432;21;16;0.0675675675675675;0.432432432432432
Control.SRR15539832;40;38;0.45;22;18;0.05;0.45
Control.SRR15539832;43;38;0.581395348837209;18;25;0.0813953488372093;0.418604651162791
Control.SRR15539832;44;38;0.477272727272727;23;21;0.0227272727272727;0.477272727272727
Control.SRR15539832;38;38;0.447368421052632;21;17;0.0526315789473684;0.447368421052632
Control.SRR15539832;43;38;0.488372093023256;22;21;0.0116279069767442;0.488372093023256
Control.SRR15539832;40;38;0.45;22;18;0.05;0.45
Control.SRR15539832;39;38;0.641025641025641;14;25;0.141025641025641;0.358974358974359
Control.SRR15539832;41;38;0.48780487804878;21;20;0.0121951219512195;0.48780487804878
Control.SRR15539832;42;38;0.547619047619048;19;23;0.0476190476190477;0.452380952380952
Control.SRR15539832;37;38;0.486486486486487;19;18;0.0135135135135135;0.486486486486487
Control.SRR15539832;39;38;0.512820512820513;19;20;0.0128205128205128;0.487179487179487
Control.SRR15539832;41;38;0.536585365853659;19;22;0.0365853658536586;0.463414634146341
Control.SRR15539832;42;38;0.452380952380952;23;19;0.0476190476190476;0.452380952380952
Control.SRR15539832;44;38;0.522727272727273;21;23;0.0227272727272727;0.477272727272727
Control.SRR15539832;36;38;0.527777777777778;17;19;0.0277777777777778;0.472222222222222
Control.SRR15539832;34;38;0.352941176470588;22;12;0.147058823529412;0.352941176470588
Control.SRR15539832;43;38;0.534883720930233;20;23;0.0348837209302325;0.465116279069767
Control.SRR15539832;41;38;0.439024390243902;23;18;0.0609756097560976;0.439024390243902
Control.SRR15539832;34;38;0.470588235294118;18;16;0.0294117647058824;0.470588235294118
Control.SRR15539832;40;38;0.475;21;19;0.025;0.475
Control.SRR15539832;42;38;0.404761904761905;25;17;0.0952380952380952;0.404761904761905
Control.SRR15539832;42;38;0.571428571428571;18;24;0.0714285714285714;0.428571428571429
Control.SRR15539832;41;38;0.536585365853659;19;22;0.0365853658536586;0.463414634146341
Control.SRR15539832;39;38;0.487179487179487;20;19;0.0128205128205128;0.487179487179487
Control.SRR15539832;39;38;0.58974358974359;16;23;0.0897435897435898;0.41025641025641
Control.SRR15539832;35;38;0.514285714285714;17;18;0.0142857142857142;0.485714285714286
Control.SRR15539832;35;38;0.342857142857143;23;12;0.157142857142857;0.342857142857143
Control.SRR15539832;39;38;0.333333333333333;26;13;0.166666666666667;0.333333333333333
Control.SRR15539832;40;38;0.4;24;16;0.1;0.4
Control.SRR15539832;38;38;0.552631578947368;17;21;0.0526315789473685;0.447368421052632
Control.SRR15539832;36;38;0.638888888888889;13;23;0.138888888888889;0.361111111111111
Control.SRR15539832;34;38;0.558823529411765;15;19;0.0588235294117647;0.441176470588235
Control.SRR15539832;37;38;0.459459459459459;20;17;0.0405405405405405;0.459459459459459
Control.SRR15539832;42;38;0.476190476190476;22;20;0.0238095238095238;0.476190476190476
Control.SRR15539832;37;38;0.459459459459459;20;17;0.0405405405405405;0.459459459459459
Control.SRR15539832;42;38;0.476190476190476;22;20;0.0238095238095238;0.476190476190476
Control.SRR15539832;43;38;0.558139534883721;19;24;0.0581395348837209;0.441860465116279
Control.SRR15539832;40;38;0.475;21;19;0.025;0.475
Control.SRR15539832;40;38;0.475;21;19;0.025;0.475
Control.SRR15539832;44;38;0.522727272727273;21;23;0.0227272727272727;0.477272727272727
Control.SRR15539832;42;38;0.428571428571429;24;18;0.0714285714285715;0.428571428571429
Control.SRR15539832;42;38;0.452380952380952;23;19;0.0476190476190476;0.452380952380952
Control.SRR15539832;36;38;0.472222222222222;19;17;0.0277777777777778;0.472222222222222
Control.SRR15539832;42;38;0.619047619047619;16;26;0.119047619047619;0.380952380952381
Control.SRR15539832;40;38;0.55;18;22;0.05;0.45
Control.SRR15539832;37;38;0.486486486486487;19;18;0.0135135135135135;0.486486486486487
Control.SRR15539832;37;38;0.459459459459459;20;17;0.0405405405405405;0.459459459459459
Control.SRR15539832;38;38;0.552631578947368;17;21;0.0526315789473685;0.447368421052632
Control.SRR15539832;44;38;0.431818181818182;25;19;0.0681818181818182;0.431818181818182
Control.SRR15539832;40;38;0.45;22;18;0.05;0.45
Control.SRR15539832;36;38;0.638888888888889;13;23;0.138888888888889;0.361111111111111
Control.SRR15539832;44;38;0.636363636363636;16;28;0.136363636363636;0.363636363636364
Control.SRR15539832;38;38;0.552631578947368;17;21;0.0526315789473685;0.447368421052632
Control.SRR15539832;39;38;0.487179487179487;20;19;0.0128205128205128;0.487179487179487
Control.SRR15539832;40;38;0.525;19;21;0.025;0.475
Control.SRR15539832;42;38;0.5;21;21;0;0.5
Control.SRR15539832;39;38;0.564102564102564;17;22;0.0641025641025641;0.435897435897436
Control.SRR15539832;35;38;0.428571428571429;20;15;0.0714285714285715;0.428571428571429
Control.SRR15539832;36;38;0.583333333333333;15;21;0.0833333333333334;0.416666666666667
Control.SRR15539832;37;38;0.621621621621622;14;23;0.121621621621622;0.378378378378378
Control.SRR15539832;40;38;0.475;21;19;0.025;0.475
Control.SRR15539832;40;38;0.575;17;23;0.075;0.425
Control.SRR15539832;40;38;0.475;21;19;0.025;0.475
Control.SRR15539832;38;38;0.473684210526316;20;18;0.0263157894736842;0.473684210526316
Control.SRR15539832;35;38;0.371428571428571;22;13;0.128571428571429;0.371428571428571
Control.SRR15539832;36;38;0.472222222222222;19;17;0.0277777777777778;0.472222222222222
Control.SRR15539832;39;38;0.512820512820513;19;20;0.0128205128205128;0.487179487179487
Control.SRR15539832;37;38;0.432432432432432;21;16;0.0675675675675675;0.432432432432432
Control.SRR15539832;35;38;0.571428571428571;15;20;0.0714285714285714;0.428571428571429
Control.SRR15539832;38;38;0.526315789473684;18;20;0.0263157894736842;0.473684210526316
Control.SRR15539832;39;38;0.538461538461538;18;21;0.0384615384615384;0.461538461538462
Control.SRR15539832;42;38;0.333333333333333;28;14;0.166666666666667;0.333333333333333
Control.SRR15539832;39;38;0.615384615384615;15;24;0.115384615384615;0.384615384615385
Control.SRR15539832;37;38;0.567567567567568;16;21;0.0675675675675675;0.432432432432432
Control.SRR15539832;42;38;0.404761904761905;25;17;0.0952380952380952;0.404761904761905
Control.SRR15539832;43;38;0.465116279069767;23;20;0.0348837209302326;0.465116279069767
Control.SRR15539832;40;38;0.475;21;19;0.025;0.475
Control.SRR15539832;38;38;0.552631578947368;17;21;0.0526315789473685;0.447368421052632
Control.SRR15539832;42;38;0.571428571428571;18;24;0.0714285714285714;0.428571428571429
Control.SRR15539832;43;38;0.581395348837209;18;25;0.0813953488372093;0.418604651162791
Control.SRR15539832;37;38;0.540540540540541;17;20;0.0405405405405406;0.459459459459459
Control.SRR15539832;37;38;0.459459459459459;20;17;0.0405405405405405;0.459459459459459
Control.SRR15539832;36;38;0.638888888888889;13;23;0.138888888888889;0.361111111111111
Control.SRR15539832;34;38;0.411764705882353;20;14;0.0882352941176471;0.411764705882353
Control.SRR15539832;39;38;0.435897435897436;22;17;0.0641025641025641;0.435897435897436
Control.SRR15539832;39;38;0.487179487179487;20;19;0.0128205128205128;0.487179487179487
Control.SRR15539832;36;38;0.555555555555556;16;20;0.0555555555555556;0.444444444444444
Control.SRR15539832;40;38;0.45;22;18;0.05;0.45
Control.SRR15539832;43;38;0.534883720930233;20;23;0.0348837209302325;0.465116279069767
Control.SRR15539832;41;38;0.414634146341463;24;17;0.0853658536585366;0.414634146341463
Control.SRR15539832;43;38;0.488372093023256;22;21;0.0116279069767442;0.488372093023256
Control.SRR15539832;41;38;0.48780487804878;21;20;0.0121951219512195;0.48780487804878
Control.SRR15539832;40;38;0.375;25;15;0.125;0.375
Control.SRR15539832;44;38;0.454545454545455;24;20;0.0454545454545455;0.454545454545455
Control.SRR15539832;38;38;0.473684210526316;20;18;0.0263157894736842;0.473684210526316
Control.SRR15539832;35;38;0.514285714285714;17;18;0.0142857142857142;0.485714285714286
Control.SRR15539832;34;38;0.529411764705882;16;18;0.0294117647058824;0.470588235294118
Control.SRR15539832;39;38;0.58974358974359;16;23;0.0897435897435898;0.41025641025641
Control.SRR15539832;38;38;0.605263157894737;15;23;0.105263157894737;0.394736842105263
Control.SRR15539832;37;38;0.621621621621622;14;23;0.121621621621622;0.378378378378378
Control.SRR15539832;42;38;0.476190476190476;22;20;0.0238095238095238;0.476190476190476
Control.SRR15539832;36;38;0.388888888888889;22;14;0.111111111111111;0.388888888888889
Control.SRR15539832;43;38;0.511627906976744;21;22;0.0116279069767442;0.488372093023256
Control.SRR15539832;43;38;0.558139534883721;19;24;0.0581395348837209;0.441860465116279
Control.SRR15539832;37;38;0.486486486486487;19;18;0.0135135135135135;0.486486486486487
Control.SRR15539832;37;38;0.540540540540541;17;20;0.0405405405405406;0.459459459459459
Control.SRR15539832;39;38;0.538461538461538;18;21;0.0384615384615384;0.461538461538462
Control.SRR15539832;39;38;0.41025641025641;23;16;0.0897435897435898;0.41025641025641
Control.SRR15539832;43;38;0.395348837209302;26;17;0.104651162790698;0.395348837209302
Control.SRR15539832;43;38;0.488372093023256;22;21;0.0116279069767442;0.488372093023256
Control.SRR15539832;36;38;0.472222222222222;19;17;0.0277777777777778;0.472222222222222
Control.SRR15539832;42;38;0.547619047619048;19;23;0.0476190476190477;0.452380952380952
Control.SRR15539832;38;38;0.473684210526316;20;18;0.0263157894736842;0.473684210526316
Control.SRR15539832;37;38;0.459459459459459;20;17;0.0405405405405405;0.459459459459459
Control.SRR15539832;41;38;0.536585365853659;19;22;0.0365853658536586;0.463414634146341
Control.SRR15539832;35;38;0.485714285714286;18;17;0.0142857142857143;0.485714285714286
Control.SRR15539832;42;38;0.428571428571429;24;18;0.0714285714285715;0.428571428571429
Control.SRR15539832;35;38;0.514285714285714;17;18;0.0142857142857142;0.485714285714286
Control.SRR15539832;39;38;0.512820512820513;19;20;0.0128205128205128;0.487179487179487
Control.SRR15539832;34;38;0.382352941176471;21;13;0.117647058823529;0.382352941176471
Control.SRR15539832;40;38;0.6;16;24;0.1;0.4
Control.SRR15539832;40;38;0.475;21;19;0.025;0.475
Control.SRR15539832;34;38;0.382352941176471;21;13;0.117647058823529;0.382352941176471
Control.SRR15539832;37;38;0.513513513513513;18;19;0.0135135135135135;0.486486486486487
Control.SRR15539832;36;38;0.638888888888889;13;23;0.138888888888889;0.361111111111111
Control.SRR15539832;38;38;0.578947368421053;16;22;0.0789473684210527;0.421052631578947
Control.SRR15539832;39;38;0.461538461538462;21;18;0.0384615384615384;0.461538461538462
Control.SRR15539832;38;38;0.552631578947368;17;21;0.0526315789473685;0.447368421052632
Control.SRR15539832;42;38;0.452380952380952;23;19;0.0476190476190476;0.452380952380952
Control.SRR15539832;44;38;0.545454545454545;20;24;0.0454545454545454;0.454545454545455
Control.SRR15539832;40;38;0.35;26;14;0.15;0.35
Control.SRR15539832;44;38;0.477272727272727;23;21;0.0227272727272727;0.477272727272727
Control.SRR15539832;43;38;0.418604651162791;25;18;0.0813953488372093;0.418604651162791
Control.SRR15539832;36;38;0.527777777777778;17;19;0.0277777777777778;0.472222222222222
Control.SRR15539832;35;38;0.542857142857143;16;19;0.0428571428571428;0.457142857142857
Control.SRR15539832;34;38;0.470588235294118;18;16;0.0294117647058824;0.470588235294118
Control.SRR15539832;38;38;0.552631578947368;17;21;0.0526315789473685;0.447368421052632
Control.SRR15539832;39;38;0.58974358974359;16;23;0.0897435897435898;0.41025641025641
Control.SRR15539832;39;38;0.435897435897436;22;17;0.0641025641025641;0.435897435897436
Control.SRR15539832;35;38;0.685714285714286;11;24;0.185714285714286;0.314285714285714
Control.SRR15539832;34;38;0.441176470588235;19;15;0.0588235294117647;0.441176470588235
Control.SRR15539832;38;38;0.447368421052632;21;17;0.0526315789473684;0.447368421052632
Control.SRR15539832;35;38;0.571428571428571;15;20;0.0714285714285714;0.428571428571429
Control.SRR15539832;39;38;0.461538461538462;21;18;0.0384615384615384;0.461538461538462
Control.SRR15539832;41;38;0.560975609756098;18;23;0.0609756097560976;0.439024390243902
Control.SRR15539832;40;38;0.6;16;24;0.1;0.4
Control.SRR15539832;36;38;0.361111111111111;23;13;0.138888888888889;0.361111111111111
Control.SRR15539832;38;38;0.578947368421053;16;22;0.0789473684210527;0.421052631578947
Control.SRR15539832;39;38;0.512820512820513;19;20;0.0128205128205128;0.487179487179487
Control.SRR15539832;36;38;0.527777777777778;17;19;0.0277777777777778;0.472222222222222
Control.SRR15539832;38;38;0.447368421052632;21;17;0.0526315789473684;0.447368421052632
Control.SRR15539832;42;38;0.571428571428571;18;24;0.0714285714285714;0.428571428571429
Control.SRR15539832;44;38;0.522727272727273;21;23;0.0227272727272727;0.477272727272727
Control.SRR15539832;39;38;0.58974358974359;16;23;0.0897435897435898;0.41025641025641
Control.SRR15539832;40;38;0.675;13;27;0.175;0.325
Control.SRR15539832;40;38;0.5;20;20;0;0.5
Control.SRR15539832;39;38;0.435897435897436;22;17;0.0641025641025641;0.435897435897436
Control.SRR15539832;37;38;0.513513513513513;18;19;0.0135135135135135;0.486486486486487
Control.SRR15539832;42;38;0.642857142857143;15;27;0.142857142857143;0.357142857142857
Control.SRR15539832;40;38;0.45;22;18;0.05;0.45
Control.SRR15539832;39;38;0.512820512820513;19;20;0.0128205128205128;0.487179487179487
Control.SRR15539832;40;38;0.55;18;22;0.05;0.45
Control.SRR15539832;40;38;0.625;15;25;0.125;0.375
Control.SRR15539832;34;38;0.617647058823529;13;21;0.117647058823529;0.382352941176471
Control.SRR15539832;40;38;0.45;22;18;0.05;0.45
Control.SRR15539832;36;38;0.5;18;18;0;0.5
Control.SRR15539832;38;38;0.578947368421053;16;22;0.0789473684210527;0.421052631578947
Control.SRR15539832;43;38;0.511627906976744;21;22;0.0116279069767442;0.488372093023256
Control.SRR15539832;34;38;0.352941176470588;22;12;0.147058823529412;0.352941176470588
Control.SRR15539832;42;38;0.523809523809524;20;22;0.0238095238095238;0.476190476190476
Control.SRR15539832;43;38;0.488372093023256;22;21;0.0116279069767442;0.488372093023256
Control.SRR15539832;44;38;0.5;22;22;0;0.5
Control.SRR15539832;41;38;0.390243902439024;25;16;0.109756097560976;0.390243902439024
Control.SRR15539832;44;38;0.522727272727273;21;23;0.0227272727272727;0.477272727272727
Control.SRR15539832;37;38;0.567567567567568;16;21;0.0675675675675675;0.432432432432432
Control.SRR15539832;43;38;0.511627906976744;21;22;0.0116279069767442;0.488372093023256
Control.SRR15539832;43;38;0.465116279069767;23;20;0.0348837209302326;0.465116279069767
Control.SRR15539832;37;38;0.513513513513513;18;19;0.0135135135135135;0.486486486486487
Control.SRR15539832;36;38;0.583333333333333;15;21;0.0833333333333334;0.416666666666667
Control.SRR15539832;38;38;0.447368421052632;21;17;0.0526315789473684;0.447368421052632
Control.SRR15539832;38;38;0.5;19;19;0;0.5
Control.SRR15539832;34;38;0.382352941176471;21;13;0.117647058823529;0.382352941176471
Control.SRR15539832;44;38;0.5;22;22;0;0.5
Control.SRR15539832;38;38;0.605263157894737;15;23;0.105263157894737;0.394736842105263
Control.SRR15539832;44;38;0.545454545454545;20;24;0.0454545454545454;0.454545454545455
Control.SRR15539832;34;38;0.529411764705882;16;18;0.0294117647058824;0.470588235294118
Control.SRR15539832;36;38;0.527777777777778;17;19;0.0277777777777778;0.472222222222222
Control.SRR15539832;36;38;0.5;18;18;0;0.5
Control.SRR15539832;37;38;0.486486486486487;19;18;0.0135135135135135;0.486486486486487
Control.SRR15539832;41;38;0.51219512195122;20;21;0.0121951219512195;0.48780487804878
Control.SRR15539832;40;38;0.55;18;22;0.05;0.45
Control.SRR15539832;34;38;0.588235294117647;14;20;0.0882352941176471;0.411764705882353
Control.SRR15539832;40;38;0.55;18;22;0.05;0.45
Control.SRR15539832;44;38;0.5;22;22;0;0.5
Control.SRR15539832;37;38;0.648648648648649;13;24;0.148648648648649;0.351351351351351
Control.SRR15539832;38;38;0.526315789473684;18;20;0.0263157894736842;0.473684210526316
Control.SRR15539832;39;38;0.666666666666667;13;26;0.166666666666667;0.333333333333333
Control.SRR15539832;37;38;0.432432432432432;21;16;0.0675675675675675;0.432432432432432
Control.SRR15539832;40;38;0.625;15;25;0.125;0.375
Control.SRR15539832;43;38;0.441860465116279;24;19;0.0581395348837209;0.441860465116279
Control.SRR15539832;39;38;0.461538461538462;21;18;0.0384615384615384;0.461538461538462
Control.SRR15539832;38;38;0.447368421052632;21;17;0.0526315789473684;0.447368421052632
Control.SRR15539832;41;38;0.439024390243902;23;18;0.0609756097560976;0.439024390243902
Control.SRR15539832;37;38;0.513513513513513;18;19;0.0135135135135135;0.486486486486487
Control.SRR15539832;35;38;0.428571428571429;20;15;0.0714285714285715;0.428571428571429
Control.SRR15539832;38;38;0.605263157894737;15;23;0.105263157894737;0.394736842105263
Control.SRR15539832;34;38;0.588235294117647;14;20;0.0882352941176471;0.411764705882353
Control.SRR15539832;38;38;0.421052631578947;22;16;0.0789473684210527;0.421052631578947
Control.SRR15539832;40;38;0.425;23;17;0.075;0.425
Control.SRR15539832;37;38;0.540540540540541;17;20;0.0405405405405406;0.459459459459459
Control.SRR15539832;34;38;0.558823529411765;15;19;0.0588235294117647;0.441176470588235
Control.SRR15539832;38;38;0.5;19;19;0;0.5
Control.SRR15539832;41;38;0.609756097560976;16;25;0.109756097560976;0.390243902439024
Control.SRR15539832;41;38;0.48780487804878;21;20;0.0121951219512195;0.48780487804878
Control.SRR15539832;34;38;0.529411764705882;16;18;0.0294117647058824;0.470588235294118
Control.SRR15539832;43;38;0.534883720930233;20;23;0.0348837209302325;0.465116279069767
Control.SRR15539832;35;38;0.628571428571429;13;22;0.128571428571429;0.371428571428571
Control.SRR15539832;38;38;0.342105263157895;25;13;0.157894736842105;0.342105263157895
Control.SRR15539832;38;38;0.526315789473684;18;20;0.0263157894736842;0.473684210526316
Control.SRR15539832;44;38;0.477272727272727;23;21;0.0227272727272727;0.477272727272727
Control.SRR15539832;34;38;0.529411764705882;16;18;0.0294117647058824;0.470588235294118
Control.SRR15539832;36;38;0.361111111111111;23;13;0.138888888888889;0.361111111111111
Control.SRR15539832;39;38;0.58974358974359;16;23;0.0897435897435898;0.41025641025641
Control.SRR15539832;44;38;0.477272727272727;23;21;0.0227272727272727;0.477272727272727
Control.SRR15539832;37;38;0.621621621621622;14;23;0.121621621621622;0.378378378378378
Control.SRR15539832;40;38;0.525;19;21;0.025;0.475
Control.SRR15539832;41;38;0.439024390243902;23;18;0.0609756097560976;0.439024390243902
Control.SRR15539832;42;38;0.404761904761905;25;17;0.0952380952380952;0.404761904761905
Control.SRR15539832;42;38;0.404761904761905;25;17;0.0952380952380952;0.404761904761905
Control.SRR15539832;43;38;0.418604651162791;25;18;0.0813953488372093;0.418604651162791
Control.SRR15539832;42;38;0.5;21;21;0;0.5
Control.SRR15539832;43;38;0.534883720930233;20;23;0.0348837209302325;0.465116279069767
Control.SRR15539832;39;38;0.435897435897436;22;17;0.0641025641025641;0.435897435897436
Control.SRR15539832;35;38;0.542857142857143;16;19;0.0428571428571428;0.457142857142857
Control.SRR15539832;36;38;0.472222222222222;19;17;0.0277777777777778;0.472222222222222
Control.SRR15539832;36;38;0.527777777777778;17;19;0.0277777777777778;0.472222222222222
Control.SRR15539832;40;38;0.525;19;21;0.025;0.475
Control.SRR15539832;43;38;0.418604651162791;25;18;0.0813953488372093;0.418604651162791
Control.SRR15539832;35;38;0.485714285714286;18;17;0.0142857142857143;0.485714285714286
Control.SRR15539832;40;38;0.45;22;18;0.05;0.45
Control.SRR15539832;43;38;0.325581395348837;29;14;0.174418604651163;0.325581395348837
Control.SRR15539832;39;38;0.435897435897436;22;17;0.0641025641025641;0.435897435897436
Control.SRR15539832;36;38;0.583333333333333;15;21;0.0833333333333334;0.416666666666667
Control.SRR15539832;39;38;0.435897435897436;22;17;0.0641025641025641;0.435897435897436
Control.SRR15539832;42;38;0.452380952380952;23;19;0.0476190476190476;0.452380952380952
Control.SRR15539832;39;38;0.512820512820513;19;20;0.0128205128205128;0.487179487179487
Control.SRR15539832;37;38;0.486486486486487;19;18;0.0135135135135135;0.486486486486487
Control.SRR15539832;43;38;0.488372093023256;22;21;0.0116279069767442;0.488372093023256
Control.SRR15539832;42;38;0.452380952380952;23;19;0.0476190476190476;0.452380952380952
Control.SRR15539832;41;38;0.463414634146341;22;19;0.0365853658536585;0.463414634146341
Control.SRR15539832;40;38;0.575;17;23;0.075;0.425
Control.SRR15539832;39;38;0.538461538461538;18;21;0.0384615384615384;0.461538461538462
Control.SRR15539832;34;38;0.558823529411765;15;19;0.0588235294117647;0.441176470588235
Control.SRR15539832;41;38;0.341463414634146;27;14;0.158536585365854;0.341463414634146
Control.SRR15539832;42;38;0.547619047619048;19;23;0.0476190476190477;0.452380952380952
Control.SRR15539832;40;38;0.45;22;18;0.05;0.45
Control.SRR15539832;40;38;0.425;23;17;0.075;0.425
Control.SRR15539832;35;38;0.428571428571429;20;15;0.0714285714285715;0.428571428571429
Control.SRR15539832;37;38;0.567567567567568;16;21;0.0675675675675675;0.432432432432432
Control.SRR15539832;34;38;0.470588235294118;18;16;0.0294117647058824;0.470588235294118
Control.SRR15539832;44;38;0.454545454545455;24;20;0.0454545454545455;0.454545454545455
Control.SRR15539832;35;38;0.514285714285714;17;18;0.0142857142857142;0.485714285714286
Control.SRR15539832;37;38;0.486486486486487;19;18;0.0135135135135135;0.486486486486487
Control.SRR15539832;40;38;0.55;18;22;0.05;0.45
Control.SRR15539832;40;38;0.475;21;19;0.025;0.475
Control.SRR15539832;35;38;0.571428571428571;15;20;0.0714285714285714;0.428571428571429
Control.SRR15539832;34;38;0.470588235294118;18;16;0.0294117647058824;0.470588235294118
Control.SRR15539832;38;38;0.552631578947368;17;21;0.0526315789473685;0.447368421052632
Control.SRR15539832;41;38;0.585365853658537;17;24;0.0853658536585366;0.414634146341463
Control.SRR15539832;41;38;0.48780487804878;21;20;0.0121951219512195;0.48780487804878
Control.SRR15539832;40;38;0.575;17;23;0.075;0.425
Control.SRR15539832;34;38;0.441176470588235;19;15;0.0588235294117647;0.441176470588235
Control.SRR15539832;43;38;0.325581395348837;29;14;0.174418604651163;0.325581395348837
Control.SRR15539832;39;38;0.487179487179487;20;19;0.0128205128205128;0.487179487179487
Control.SRR15539832;38;38;0.394736842105263;23;15;0.105263157894737;0.394736842105263
Control.SRR15539832;35;38;0.457142857142857;19;16;0.0428571428571429;0.457142857142857
Control.SRR15539832;37;38;0.594594594594595;15;22;0.0945945945945946;0.405405405405405
Control.SRR15539832;39;38;0.384615384615385;24;15;0.115384615384615;0.384615384615385
Control.SRR15539832;34;38;0.5;17;17;0;0.5
Control.SRR15539832;38;38;0.421052631578947;22;16;0.0789473684210527;0.421052631578947
Control.SRR15539832;35;38;0.485714285714286;18;17;0.0142857142857143;0.485714285714286
Control.SRR15539832;36;38;0.5;18;18;0;0.5
Control.SRR15539832;36;38;0.5;18;18;0;0.5
Control.SRR15539832;39;38;0.358974358974359;25;14;0.141025641025641;0.358974358974359
Control.SRR15539832;41;38;0.48780487804878;21;20;0.0121951219512195;0.48780487804878
Control.SRR15539832;39;38;0.512820512820513;19;20;0.0128205128205128;0.487179487179487
Control.SRR15539832;43;38;0.534883720930233;20;23;0.0348837209302325;0.465116279069767
Control.SRR15539832;41;38;0.560975609756098;18;23;0.0609756097560976;0.439024390243902
Control.SRR15539832;44;38;0.409090909090909;26;18;0.0909090909090909;0.409090909090909
Control.SRR15539832;42;38;0.571428571428571;18;24;0.0714285714285714;0.428571428571429
Control.SRR15539832;35;38;0.571428571428571;15;20;0.0714285714285714;0.428571428571429
Control.SRR15539832;39;38;0.41025641025641;23;16;0.0897435897435898;0.41025641025641
Control.SRR15539832;40;38;0.475;21;19;0.025;0.475
Control.SRR15539832;35;38;0.485714285714286;18;17;0.0142857142857143;0.485714285714286
Control.SRR15539832;40;38;0.375;25;15;0.125;0.375
Control.SRR15539832;41;38;0.365853658536585;26;15;0.134146341463415;0.365853658536585
Control.SRR15539832;38;38;0.447368421052632;21;17;0.0526315789473684;0.447368421052632
Control.SRR15539832;34;38;0.411764705882353;20;14;0.0882352941176471;0.411764705882353
Control.SRR15539832;36;38;0.611111111111111;14;22;0.111111111111111;0.388888888888889
Control.SRR15539832;43;38;0.674418604651163;14;29;0.174418604651163;0.325581395348837
Control.SRR15539832;41;38;0.390243902439024;25;16;0.109756097560976;0.390243902439024
Control.SRR15539832;40;38;0.65;14;26;0.15;0.35
Control.SRR15539832;41;38;0.390243902439024;25;16;0.109756097560976;0.390243902439024
Control.SRR15539832;38;38;0.526315789473684;18;20;0.0263157894736842;0.473684210526316
Control.SRR15539832;38;38;0.421052631578947;22;16;0.0789473684210527;0.421052631578947
Control.SRR15539832;41;38;0.536585365853659;19;22;0.0365853658536586;0.463414634146341
Control.SRR15539832;38;38;0.578947368421053;16;22;0.0789473684210527;0.421052631578947
Control.SRR15539832;40;38;0.55;18;22;0.05;0.45
Control.SRR15539832;40;38;0.475;21;19;0.025;0.475
Control.SRR15539832;36;38;0.361111111111111;23;13;0.138888888888889;0.361111111111111
Control.SRR15539832;41;38;0.560975609756098;18;23;0.0609756097560976;0.439024390243902
Control.SRR15539832;41;38;0.365853658536585;26;15;0.134146341463415;0.365853658536585
Control.SRR15539832;40;38;0.375;25;15;0.125;0.375
Control.SRR15539832;40;38;0.525;19;21;0.025;0.475
Control.SRR15539832;38;38;0.5;19;19;0;0.5
Control.SRR15539832;40;38;0.45;22;18;0.05;0.45
Control.SRR15539832;38;38;0.368421052631579;24;14;0.131578947368421;0.368421052631579
Control.SRR15539832;37;38;0.513513513513513;18;19;0.0135135135135135;0.486486486486487
Control.SRR15539832;42;38;0.476190476190476;22;20;0.0238095238095238;0.476190476190476
Control.SRR15539832;41;38;0.51219512195122;20;21;0.0121951219512195;0.48780487804878
Control.SRR15539832;44;38;0.659090909090909;15;29;0.159090909090909;0.340909090909091
Control.SRR15539832;40;38;0.65;14;26;0.15;0.35
Control.SRR15539832;44;38;0.454545454545455;24;20;0.0454545454545455;0.454545454545455
Control.SRR15539832;40;38;0.575;17;23;0.075;0.425
Control.SRR15539832;42;38;0.357142857142857;27;15;0.142857142857143;0.357142857142857
Control.SRR15539832;41;38;0.463414634146341;22;19;0.0365853658536585;0.463414634146341
Control.SRR15539832;36;38;0.527777777777778;17;19;0.0277777777777778;0.472222222222222
Control.SRR15539832;42;38;0.595238095238095;17;25;0.0952380952380952;0.404761904761905
Control.SRR15539832;34;38;0.617647058823529;13;21;0.117647058823529;0.382352941176471
Control.SRR15539832;40;38;0.5;20;20;0;0.5
Control.SRR15539832;36;38;0.611111111111111;14;22;0.111111111111111;0.388888888888889
Control.SRR15539832;42;38;0.5;21;21;0;0.5
Control.SRR15539832;39;38;0.461538461538462;21;18;0.0384615384615384;0.461538461538462
Control.SRR15539832;34;38;0.441176470588235;19;15;0.0588235294117647;0.441176470588235
Control.SRR15539832;38;38;0.5;19;19;0;0.5
Control.SRR15539832;37;38;0.378378378378378;23;14;0.121621621621622;0.378378378378378
Control.SRR15539832;43;38;0.534883720930233;20;23;0.0348837209302325;0.465116279069767
Control.SRR15539832;43;38;0.441860465116279;24;19;0.0581395348837209;0.441860465116279
Control.SRR15539832;40;38;0.5;20;20;0;0.5
Control.SRR15539832;35;38;0.542857142857143;16;19;0.0428571428571428;0.457142857142857
Control.SRR15539832;44;38;0.522727272727273;21;23;0.0227272727272727;0.477272727272727
Control.SRR15539832;43;38;0.511627906976744;21;22;0.0116279069767442;0.488372093023256
Control.SRR15539832;43;38;0.488372093023256;22;21;0.0116279069767442;0.488372093023256
Control.SRR15539832;44;38;0.545454545454545;20;24;0.0454545454545454;0.454545454545455
Control.SRR15539832;44;38;0.454545454545455;24;20;0.0454545454545455;0.454545454545455
Control.SRR15539832;44;38;0.5;22;22;0;0.5
Control.SRR15539832;43;38;0.558139534883721;19;24;0.0581395348837209;0.441860465116279
Control.SRR15539832;44;38;0.5;22;22;0;0.5
Control.SRR15539832;35;38;0.514285714285714;17;18;0.0142857142857142;0.485714285714286
Control.SRR15539832;40;38;0.65;14;26;0.15;0.35
Control.SRR15539832;42;38;0.476190476190476;22;20;0.0238095238095238;0.476190476190476
Control.SRR15539832;39;38;0.358974358974359;25;14;0.141025641025641;0.358974358974359
Control.SRR15539832;43;38;0.395348837209302;26;17;0.104651162790698;0.395348837209302
Control.SRR15539832;45;38;0.466666666666667;24;21;0.0333333333333333;0.466666666666667
Control.SRR15539832;41;38;0.536585365853659;19;22;0.0365853658536586;0.463414634146341
Control.SRR15539832;43;38;0.325581395348837;29;14;0.174418604651163;0.325581395348837
Control.SRR15539832;46;38;0.58695652173913;19;27;0.0869565217391305;0.41304347826087
Control.SRR15539832;44;38;0.5;22;22;0;0.5
Control.SRR15539832;36;38;0.666666666666667;12;24;0.166666666666667;0.333333333333333
Control.SRR15539832;42;38;0.595238095238095;17;25;0.0952380952380952;0.404761904761905
Control.SRR15539832;38;38;0.421052631578947;22;16;0.0789473684210527;0.421052631578947
Control.SRR15539832;39;38;0.538461538461538;18;21;0.0384615384615384;0.461538461538462
Control.SRR15539832;36;38;0.444444444444444;20;16;0.0555555555555556;0.444444444444444
Control.SRR15539832;36;38;0.444444444444444;20;16;0.0555555555555556;0.444444444444444
Control.SRR15539832;41;38;0.341463414634146;27;14;0.158536585365854;0.341463414634146
Control.SRR15539832;40;38;0.475;21;19;0.025;0.475
Control.SRR15539832;41;38;0.463414634146341;22;19;0.0365853658536585;0.463414634146341
Control.SRR15539832;46;38;0.478260869565217;24;22;0.0217391304347826;0.478260869565217
Control.SRR15539832;45;38;0.555555555555556;20;25;0.0555555555555556;0.444444444444444
Control.SRR15539832;45;38;0.555555555555556;20;25;0.0555555555555556;0.444444444444444
Control.SRR15539832;42;38;0.547619047619048;19;23;0.0476190476190477;0.452380952380952
Control.SRR15539832;37;38;0.432432432432432;21;16;0.0675675675675675;0.432432432432432
Control.SRR15539832;38;38;0.526315789473684;18;20;0.0263157894736842;0.473684210526316
Control.SRR15539832;35;38;0.4;21;14;0.1;0.4
Control.SRR15539832;41;38;0.414634146341463;24;17;0.0853658536585366;0.414634146341463
Control.SRR15539832;38;38;0.605263157894737;15;23;0.105263157894737;0.394736842105263
Control.SRR15539832;35;38;0.571428571428571;15;20;0.0714285714285714;0.428571428571429
Control.SRR15539832;40;38;0.525;19;21;0.025;0.475
Control.SRR15539832;41;38;0.463414634146341;22;19;0.0365853658536585;0.463414634146341
Control.SRR15539832;45;38;0.577777777777778;19;26;0.0777777777777777;0.422222222222222
Control.SRR15539832;42;38;0.476190476190476;22;20;0.0238095238095238;0.476190476190476
Control.SRR15539832;43;38;0.27906976744186;31;12;0.22093023255814;0.27906976744186
Control.SRR15539832;39;38;0.512820512820513;19;20;0.0128205128205128;0.487179487179487
Control.SRR15539832;43;38;0.465116279069767;23;20;0.0348837209302326;0.465116279069767
Control.SRR15539832;40;38;0.55;18;22;0.05;0.45
Control.SRR15539832;37;38;0.459459459459459;20;17;0.0405405405405405;0.459459459459459
Control.SRR15539832;41;38;0.51219512195122;20;21;0.0121951219512195;0.48780487804878
Control.SRR15539832;43;38;0.441860465116279;24;19;0.0581395348837209;0.441860465116279
Control.SRR15539832;40;38;0.45;22;18;0.05;0.45
Control.SRR15539832;36;38;0.472222222222222;19;17;0.0277777777777778;0.472222222222222
Control.SRR15539832;36;38;0.333333333333333;24;12;0.166666666666667;0.333333333333333
Control.SRR15539832;41;38;0.390243902439024;25;16;0.109756097560976;0.390243902439024
Control.SRR15539832;42;38;0.595238095238095;17;25;0.0952380952380952;0.404761904761905
Control.SRR15539832;35;38;0.428571428571429;20;15;0.0714285714285715;0.428571428571429
Control.SRR15539832;39;38;0.461538461538462;21;18;0.0384615384615384;0.461538461538462
Control.SRR15539832;40;38;0.425;23;17;0.075;0.425
Control.SRR15539832;35;38;0.542857142857143;16;19;0.0428571428571428;0.457142857142857
Control.SRR15539832;44;38;0.545454545454545;20;24;0.0454545454545454;0.454545454545455
Control.SRR15539832;39;38;0.564102564102564;17;22;0.0641025641025641;0.435897435897436
Control.SRR15539832;40;38;0.4;24;16;0.1;0.4
Control.SRR15539832;38;38;0.368421052631579;24;14;0.131578947368421;0.368421052631579
Control.SRR15539832;39;38;0.487179487179487;20;19;0.0128205128205128;0.487179487179487
Control.SRR15539832;38;38;0.578947368421053;16;22;0.0789473684210527;0.421052631578947
Control.SRR15539832;38;38;0.421052631578947;22;16;0.0789473684210527;0.421052631578947
Control.SRR15539832;42;38;0.523809523809524;20;22;0.0238095238095238;0.476190476190476
Control.SRR15539832;44;38;0.545454545454545;20;24;0.0454545454545454;0.454545454545455
Control.SRR15539832;35;38;0.571428571428571;15;20;0.0714285714285714;0.428571428571429
Control.SRR15539832;39;38;0.538461538461538;18;21;0.0384615384615384;0.461538461538462
Control.SRR15539832;35;38;0.4;21;14;0.1;0.4
Control.SRR15539832;45;38;0.577777777777778;19;26;0.0777777777777777;0.422222222222222
Control.SRR15539832;45;38;0.488888888888889;23;22;0.0111111111111111;0.488888888888889
Control.SRR15539832;38;38;0.526315789473684;18;20;0.0263157894736842;0.473684210526316
Control.SRR15539832;38;38;0.394736842105263;23;15;0.105263157894737;0.394736842105263
Control.SRR15539832;44;38;0.454545454545455;24;20;0.0454545454545455;0.454545454545455
Control.SRR15539832;40;38;0.45;22;18;0.05;0.45
Control.SRR15539832;42;38;0.452380952380952;23;19;0.0476190476190476;0.452380952380952
Control.SRR15539832;44;38;0.5;22;22;0;0.5
Control.SRR15539832;44;38;0.454545454545455;24;20;0.0454545454545455;0.454545454545455
Control.SRR15539832;46;38;0.434782608695652;26;20;0.0652173913043478;0.434782608695652
Control.SRR15539832;35;38;0.514285714285714;17;18;0.0142857142857142;0.485714285714286
Control.SRR15539832;38;38;0.368421052631579;24;14;0.131578947368421;0.368421052631579
Control.SRR15539832;46;38;0.565217391304348;20;26;0.0652173913043478;0.434782608695652
Control.SRR15539832;40;38;0.525;19;21;0.025;0.475
Control.SRR15539832;40;38;0.425;23;17;0.075;0.425
Control.SRR15539832;43;38;0.441860465116279;24;19;0.0581395348837209;0.441860465116279
Control.SRR15539832;46;38;0.673913043478261;15;31;0.173913043478261;0.326086956521739
Control.SRR15539832;37;38;0.459459459459459;20;17;0.0405405405405405;0.459459459459459
Control.SRR15539832;38;38;0.473684210526316;20;18;0.0263157894736842;0.473684210526316
Control.SRR15539832;37;38;0.540540540540541;17;20;0.0405405405405406;0.459459459459459
Control.SRR15539832;36;38;0.527777777777778;17;19;0.0277777777777778;0.472222222222222
Control.SRR15539832;37;38;0.378378378378378;23;14;0.121621621621622;0.378378378378378
Control.SRR15539832;43;38;0.465116279069767;23;20;0.0348837209302326;0.465116279069767
Control.SRR15539832;41;38;0.414634146341463;24;17;0.0853658536585366;0.414634146341463
Control.SRR15539832;42;38;0.5;21;21;0;0.5
Control.SRR15539832;37;38;0.459459459459459;20;17;0.0405405405405405;0.459459459459459
Control.SRR15539832;38;38;0.473684210526316;20;18;0.0263157894736842;0.473684210526316
Control.SRR15539832;41;38;0.414634146341463;24;17;0.0853658536585366;0.414634146341463
Control.SRR15539832;35;38;0.571428571428571;15;20;0.0714285714285714;0.428571428571429
Control.SRR15539832;37;38;0.486486486486487;19;18;0.0135135135135135;0.486486486486487
Control.SRR15539832;37;38;0.513513513513513;18;19;0.0135135135135135;0.486486486486487
Control.SRR15539832;37;38;0.486486486486487;19;18;0.0135135135135135;0.486486486486487
Control.SRR15539832;42;38;0.476190476190476;22;20;0.0238095238095238;0.476190476190476
Control.SRR15539832;43;38;0.465116279069767;23;20;0.0348837209302326;0.465116279069767
Control.SRR15539832;36;38;0.444444444444444;20;16;0.0555555555555556;0.444444444444444
Control.SRR15539832;41;38;0.439024390243902;23;18;0.0609756097560976;0.439024390243902
Control.SRR15539832;38;38;0.368421052631579;24;14;0.131578947368421;0.368421052631579
Control.SRR15539832;45;38;0.4;27;18;0.1;0.4
Control.SRR15539832;41;38;0.439024390243902;23;18;0.0609756097560976;0.439024390243902
Control.SRR15539832;39;38;0.384615384615385;24;15;0.115384615384615;0.384615384615385
Control.SRR15539832;39;38;0.538461538461538;18;21;0.0384615384615384;0.461538461538462
Control.SRR15539832;38;38;0.447368421052632;21;17;0.0526315789473684;0.447368421052632
Control.SRR15539832;43;38;0.465116279069767;23;20;0.0348837209302326;0.465116279069767
Control.SRR15539832;38;38;0.657894736842105;13;25;0.157894736842105;0.342105263157895
Control.SRR15539832;37;38;0.513513513513513;18;19;0.0135135135135135;0.486486486486487
Control.SRR15539832;37;38;0.459459459459459;20;17;0.0405405405405405;0.459459459459459
Control.SRR15539832;42;38;0.595238095238095;17;25;0.0952380952380952;0.404761904761905
Control.SRR15539832;36;38;0.472222222222222;19;17;0.0277777777777778;0.472222222222222
Control.SRR15539832;36;38;0.583333333333333;15;21;0.0833333333333334;0.416666666666667
Control.SRR15539832;43;38;0.511627906976744;21;22;0.0116279069767442;0.488372093023256
Control.SRR15539832;40;38;0.525;19;21;0.025;0.475
Control.SRR15539832;40;38;0.45;22;18;0.05;0.45
Control.SRR15539832;38;38;0.473684210526316;20;18;0.0263157894736842;0.473684210526316
Control.SRR15539832;43;38;0.488372093023256;22;21;0.0116279069767442;0.488372093023256
Control.SRR15539832;46;38;0.58695652173913;19;27;0.0869565217391305;0.41304347826087
Control.SRR15539832;36;38;0.388888888888889;22;14;0.111111111111111;0.388888888888889
Control.SRR15539832;35;38;0.571428571428571;15;20;0.0714285714285714;0.428571428571429
Control.SRR15539832;38;38;0.552631578947368;17;21;0.0526315789473685;0.447368421052632
Control.SRR15539832;35;38;0.485714285714286;18;17;0.0142857142857143;0.485714285714286
Control.SRR15539832;36;38;0.638888888888889;13;23;0.138888888888889;0.361111111111111
Control.SRR15539832;37;38;0.513513513513513;18;19;0.0135135135135135;0.486486486486487
Control.SRR15539832;39;38;0.564102564102564;17;22;0.0641025641025641;0.435897435897436
Control.SRR15539832;35;38;0.485714285714286;18;17;0.0142857142857143;0.485714285714286
Control.SRR15539832;41;38;0.414634146341463;24;17;0.0853658536585366;0.414634146341463
Control.SRR15539832;39;38;0.41025641025641;23;16;0.0897435897435898;0.41025641025641
Control.SRR15539832;40;38;0.475;21;19;0.025;0.475
Control.SRR15539832;39;38;0.692307692307692;12;27;0.192307692307692;0.307692307692308
Control.SRR15539832;39;38;0.512820512820513;19;20;0.0128205128205128;0.487179487179487
Control.SRR15539832;39;38;0.358974358974359;25;14;0.141025641025641;0.358974358974359
Control.SRR15539832;45;38;0.511111111111111;22;23;0.0111111111111111;0.488888888888889
Control.SRR15539832;44;38;0.477272727272727;23;21;0.0227272727272727;0.477272727272727
Control.SRR15539832;37;38;0.594594594594595;15;22;0.0945945945945946;0.405405405405405
Control.SRR15539832;38;38;0.5;19;19;0;0.5
Control.SRR15539832;41;38;0.463414634146341;22;19;0.0365853658536585;0.463414634146341
Control.SRR15539832;35;38;0.4;21;14;0.1;0.4
Control.SRR15539832;38;38;0.447368421052632;21;17;0.0526315789473684;0.447368421052632
Control.SRR15539832;37;38;0.405405405405405;22;15;0.0945945945945946;0.405405405405405
Control.SRR15539832;38;38;0.526315789473684;18;20;0.0263157894736842;0.473684210526316
Control.SRR15539832;44;38;0.545454545454545;20;24;0.0454545454545454;0.454545454545455
Control.SRR15539832;41;38;0.51219512195122;20;21;0.0121951219512195;0.48780487804878
Control.SRR15539832;43;38;0.325581395348837;29;14;0.174418604651163;0.325581395348837
Control.SRR15539832;45;38;0.511111111111111;22;23;0.0111111111111111;0.488888888888889
Control.SRR15539832;40;38;0.4;24;16;0.1;0.4
Control.SRR15539832;46;38;0.347826086956522;30;16;0.152173913043478;0.347826086956522
Control.SRR15539832;43;38;0.441860465116279;24;19;0.0581395348837209;0.441860465116279
Control.SRR15539832;45;38;0.444444444444444;25;20;0.0555555555555556;0.444444444444444
Control.SRR15539832;37;38;0.486486486486487;19;18;0.0135135135135135;0.486486486486487
Control.SRR15539832;35;38;0.628571428571429;13;22;0.128571428571429;0.371428571428571
Control.SRR15539832;35;38;0.514285714285714;17;18;0.0142857142857142;0.485714285714286
Control.SRR15539832;35;38;0.542857142857143;16;19;0.0428571428571428;0.457142857142857
Control.SRR15539832;37;38;0.459459459459459;20;17;0.0405405405405405;0.459459459459459
Control.SRR15539832;38;38;0.368421052631579;24;14;0.131578947368421;0.368421052631579
Control.SRR15539832;39;38;0.487179487179487;20;19;0.0128205128205128;0.487179487179487
Control.SRR15539832;44;38;0.545454545454545;20;24;0.0454545454545454;0.454545454545455
Control.SRR15539832;39;38;0.435897435897436;22;17;0.0641025641025641;0.435897435897436
Control.SRR15539832;37;38;0.621621621621622;14;23;0.121621621621622;0.378378378378378
Control.SRR15539832;37;38;0.432432432432432;21;16;0.0675675675675675;0.432432432432432
Control.SRR15539832;36;38;0.527777777777778;17;19;0.0277777777777778;0.472222222222222
Control.SRR15539832;37;38;0.486486486486487;19;18;0.0135135135135135;0.486486486486487
Control.SRR15539832;35;38;0.428571428571429;20;15;0.0714285714285715;0.428571428571429
Control.SRR15539832;45;38;0.555555555555556;20;25;0.0555555555555556;0.444444444444444
Control.SRR15539832;41;38;0.414634146341463;24;17;0.0853658536585366;0.414634146341463
Control.SRR15539832;44;38;0.522727272727273;21;23;0.0227272727272727;0.477272727272727
Control.SRR15539832;38;38;0.605263157894737;15;23;0.105263157894737;0.394736842105263
Control.SRR15539832;40;38;0.45;22;18;0.05;0.45
Control.SRR15539832;36;38;0.5;18;18;0;0.5
Control.SRR15539832;40;38;0.425;23;17;0.075;0.425
Control.SRR15539832;44;38;0.454545454545455;24;20;0.0454545454545455;0.454545454545455
Control.SRR15539832;46;38;0.41304347826087;27;19;0.0869565217391304;0.41304347826087
Control.SRR15539832;36;38;0.5;18;18;0;0.5
Control.SRR15539832;40;38;0.425;23;17;0.075;0.425
Control.SRR15539832;42;38;0.571428571428571;18;24;0.0714285714285714;0.428571428571429
Control.SRR15539832;37;38;0.648648648648649;13;24;0.148648648648649;0.351351351351351
Control.SRR15539832;46;38;0.58695652173913;19;27;0.0869565217391305;0.41304347826087
Control.SRR15539832;46;38;0.521739130434783;22;24;0.0217391304347826;0.478260869565217
Control.SRR15539832;38;38;0.447368421052632;21;17;0.0526315789473684;0.447368421052632
Control.SRR15539832;35;38;0.542857142857143;16;19;0.0428571428571428;0.457142857142857
Control.SRR15539832;40;38;0.675;13;27;0.175;0.325
Control.SRR15539832;42;38;0.404761904761905;25;17;0.0952380952380952;0.404761904761905
Control.SRR15539832;39;38;0.58974358974359;16;23;0.0897435897435898;0.41025641025641
Control.SRR15539832;36;38;0.444444444444444;20;16;0.0555555555555556;0.444444444444444
Control.SRR15539832;38;38;0.5;19;19;0;0.5
Control.SRR15539832;40;38;0.625;15;25;0.125;0.375
Control.SRR15539832;40;38;0.45;22;18;0.05;0.45
Control.SRR15539832;40;38;0.4;24;16;0.1;0.4
Control.SRR15539832;37;38;0.459459459459459;20;17;0.0405405405405405;0.459459459459459
Control.SRR15539832;43;38;0.465116279069767;23;20;0.0348837209302326;0.465116279069767
Control.SRR15539832;38;38;0.526315789473684;18;20;0.0263157894736842;0.473684210526316
Control.SRR15539832;37;38;0.648648648648649;13;24;0.148648648648649;0.351351351351351
Control.SRR15539832;35;38;0.6;14;21;0.1;0.4
Control.SRR15539832;41;38;0.682926829268293;13;28;0.182926829268293;0.317073170731707
Control.SRR15539832;44;38;0.522727272727273;21;23;0.0227272727272727;0.477272727272727
Control.SRR15539832;38;38;0.631578947368421;14;24;0.131578947368421;0.368421052631579
Control.SRR15539832;37;38;0.621621621621622;14;23;0.121621621621622;0.378378378378378
Control.SRR15539832;42;38;0.476190476190476;22;20;0.0238095238095238;0.476190476190476
Control.SRR15539832;37;38;0.486486486486487;19;18;0.0135135135135135;0.486486486486487
Control.SRR15539832;38;38;0.552631578947368;17;21;0.0526315789473685;0.447368421052632
Control.SRR15539832;36;38;0.444444444444444;20;16;0.0555555555555556;0.444444444444444
Control.SRR15539832;46;38;0.478260869565217;24;22;0.0217391304347826;0.478260869565217
Control.SRR15539832;35;38;0.485714285714286;18;17;0.0142857142857143;0.485714285714286
Control.SRR15539832;39;38;0.435897435897436;22;17;0.0641025641025641;0.435897435897436
Control.SRR15539832;35;38;0.485714285714286;18;17;0.0142857142857143;0.485714285714286
Control.SRR15539832;36;38;0.527777777777778;17;19;0.0277777777777778;0.472222222222222
Control.SRR15539832;45;38;0.311111111111111;31;14;0.188888888888889;0.311111111111111
Control.SRR15539832;41;38;0.439024390243902;23;18;0.0609756097560976;0.439024390243902
Control.SRR15539832;39;38;0.487179487179487;20;19;0.0128205128205128;0.487179487179487
Control.SRR15539832;46;38;0.565217391304348;20;26;0.0652173913043478;0.434782608695652
Control.SRR15539832;37;38;0.594594594594595;15;22;0.0945945945945946;0.405405405405405
Control.SRR15539832;38;38;0.473684210526316;20;18;0.0263157894736842;0.473684210526316
Control.SRR15539832;38;38;0.657894736842105;13;25;0.157894736842105;0.342105263157895
Control.SRR15539832;41;38;0.585365853658537;17;24;0.0853658536585366;0.414634146341463
Control.SRR15539832;39;38;0.461538461538462;21;18;0.0384615384615384;0.461538461538462
Control.SRR15539832;40;38;0.4;24;16;0.1;0.4
Control.SRR15539832;38;38;0.473684210526316;20;18;0.0263157894736842;0.473684210526316
Control.SRR15539832;45;38;0.444444444444444;25;20;0.0555555555555556;0.444444444444444
Control.SRR15539832;38;38;0.526315789473684;18;20;0.0263157894736842;0.473684210526316
Control.SRR15539832;40;38;0.4;24;16;0.1;0.4
Control.SRR15539832;38;38;0.473684210526316;20;18;0.0263157894736842;0.473684210526316
Control.SRR15539832;37;38;0.405405405405405;22;15;0.0945945945945946;0.405405405405405
Control.SRR15539832;35;38;0.428571428571429;20;15;0.0714285714285715;0.428571428571429
Control.SRR15539832;39;38;0.435897435897436;22;17;0.0641025641025641;0.435897435897436
Control.SRR15539832;41;38;0.585365853658537;17;24;0.0853658536585366;0.414634146341463
Control.SRR15539832;41;38;0.390243902439024;25;16;0.109756097560976;0.390243902439024
Control.SRR15539832;41;38;0.536585365853659;19;22;0.0365853658536586;0.463414634146341
Control.SRR15539832;40;38;0.5;20;20;0;0.5
Control.SRR15539832;40;38;0.5;20;20;0;0.5
Control.SRR15539832;37;38;0.459459459459459;20;17;0.0405405405405405;0.459459459459459
Control.SRR15539832;38;38;0.578947368421053;16;22;0.0789473684210527;0.421052631578947
Control.SRR15539832;46;38;0.478260869565217;24;22;0.0217391304347826;0.478260869565217
Control.SRR15539832;42;38;0.523809523809524;20;22;0.0238095238095238;0.476190476190476
Control.SRR15539832;40;38;0.35;26;14;0.15;0.35
Control.SRR15539832;39;38;0.512820512820513;19;20;0.0128205128205128;0.487179487179487
Control.SRR15539832;45;38;0.422222222222222;26;19;0.0777777777777778;0.422222222222222
Control.SRR15539832;38;38;0.605263157894737;15;23;0.105263157894737;0.394736842105263
Control.SRR15539832;38;38;0.578947368421053;16;22;0.0789473684210527;0.421052631578947
Control.SRR15539832;43;38;0.511627906976744;21;22;0.0116279069767442;0.488372093023256
Control.SRR15539832;42;38;0.547619047619048;19;23;0.0476190476190477;0.452380952380952
Control.SRR15539832;40;38;0.55;18;22;0.05;0.45
Control.SRR15539832;45;38;0.533333333333333;21;24;0.0333333333333333;0.466666666666667
Control.SRR15539832;46;38;0.41304347826087;27;19;0.0869565217391304;0.41304347826087
Control.SRR15539832;35;38;0.371428571428571;22;13;0.128571428571429;0.371428571428571
Control.SRR15539832;37;38;0.459459459459459;20;17;0.0405405405405405;0.459459459459459
Control.SRR15539832;43;38;0.418604651162791;25;18;0.0813953488372093;0.418604651162791
Control.SRR15539832;45;38;0.444444444444444;25;20;0.0555555555555556;0.444444444444444
Control.SRR15539832;44;38;0.545454545454545;20;24;0.0454545454545454;0.454545454545455
Control.SRR15539832;39;38;0.58974358974359;16;23;0.0897435897435898;0.41025641025641
Control.SRR15539832;45;38;0.688888888888889;14;31;0.188888888888889;0.311111111111111
Control.SRR15539832;37;38;0.405405405405405;22;15;0.0945945945945946;0.405405405405405
Control.SRR15539832;39;38;0.435897435897436;22;17;0.0641025641025641;0.435897435897436
Control.SRR15539832;39;38;0.512820512820513;19;20;0.0128205128205128;0.487179487179487
Control.SRR15539832;42;38;0.452380952380952;23;19;0.0476190476190476;0.452380952380952
Control.SRR15539832;42;38;0.428571428571429;24;18;0.0714285714285715;0.428571428571429
Control.SRR15539832;46;38;0.673913043478261;15;31;0.173913043478261;0.326086956521739
Control.SRR15539832;39;38;0.333333333333333;26;13;0.166666666666667;0.333333333333333
Control.SRR15539832;38;38;0.394736842105263;23;15;0.105263157894737;0.394736842105263
Control.SRR15539832;36;38;0.527777777777778;17;19;0.0277777777777778;0.472222222222222
Control.SRR15539832;37;38;0.459459459459459;20;17;0.0405405405405405;0.459459459459459
Control.SRR15539832;41;38;0.439024390243902;23;18;0.0609756097560976;0.439024390243902
Control.SRR15539832;38;38;0.526315789473684;18;20;0.0263157894736842;0.473684210526316
Control.SRR15539832;38;38;0.473684210526316;20;18;0.0263157894736842;0.473684210526316
Control.SRR15539832;39;38;0.512820512820513;19;20;0.0128205128205128;0.487179487179487
Control.SRR15539832;38;38;0.447368421052632;21;17;0.0526315789473684;0.447368421052632
Control.SRR15539832;35;38;0.457142857142857;19;16;0.0428571428571429;0.457142857142857
Control.SRR15539832;41;38;0.341463414634146;27;14;0.158536585365854;0.341463414634146
Control.SRR15539832;44;38;0.522727272727273;21;23;0.0227272727272727;0.477272727272727
Control.SRR15539832;42;38;0.476190476190476;22;20;0.0238095238095238;0.476190476190476
Control.SRR15539832;37;38;0.459459459459459;20;17;0.0405405405405405;0.459459459459459
Control.SRR15539832;40;38;0.35;26;14;0.15;0.35
Control.SRR15539832;40;38;0.6;16;24;0.1;0.4
Control.SRR15539832;38;38;0.368421052631579;24;14;0.131578947368421;0.368421052631579
Control.SRR15539832;38;38;0.578947368421053;16;22;0.0789473684210527;0.421052631578947
Control.SRR15539832;40;38;0.5;20;20;0;0.5
Control.SRR15539832;37;38;0.567567567567568;16;21;0.0675675675675675;0.432432432432432
Control.SRR15539832;46;38;0.521739130434783;22;24;0.0217391304347826;0.478260869565217
Control.SRR15539832;42;38;0.380952380952381;26;16;0.119047619047619;0.380952380952381
Control.SRR15539832;35;38;0.485714285714286;18;17;0.0142857142857143;0.485714285714286
Control.SRR15539832;42;38;0.476190476190476;22;20;0.0238095238095238;0.476190476190476
Control.SRR15539832;37;38;0.486486486486487;19;18;0.0135135135135135;0.486486486486487
Control.SRR15539832;35;38;0.571428571428571;15;20;0.0714285714285714;0.428571428571429
Control.SRR15539832;43;38;0.511627906976744;21;22;0.0116279069767442;0.488372093023256
Control.SRR15539832;43;38;0.488372093023256;22;21;0.0116279069767442;0.488372093023256
Control.SRR15539832;42;38;0.5;21;21;0;0.5
Control.SRR15539832;45;38;0.533333333333333;21;24;0.0333333333333333;0.466666666666667
Control.SRR15539832;42;38;0.380952380952381;26;16;0.119047619047619;0.380952380952381
Control.SRR15539832;36;38;0.5;18;18;0;0.5
Control.SRR15539832;38;38;0.578947368421053;16;22;0.0789473684210527;0.421052631578947
Control.SRR15539832;40;38;0.625;15;25;0.125;0.375
Control.SRR15539832;36;38;0.444444444444444;20;16;0.0555555555555556;0.444444444444444
Control.SRR15539832;43;38;0.604651162790698;17;26;0.104651162790698;0.395348837209302
Control.SRR15539832;36;38;0.444444444444444;20;16;0.0555555555555556;0.444444444444444
Control.SRR15539832;45;38;0.511111111111111;22;23;0.0111111111111111;0.488888888888889
Control.SRR15539832;40;38;0.45;22;18;0.05;0.45
Control.SRR15539832;35;38;0.514285714285714;17;18;0.0142857142857142;0.485714285714286
Control.SRR15539832;41;38;0.463414634146341;22;19;0.0365853658536585;0.463414634146341
Control.SRR15539832;35;38;0.485714285714286;18;17;0.0142857142857143;0.485714285714286
Control.SRR15539832;40;38;0.375;25;15;0.125;0.375
Control.SRR15539832;35;38;0.457142857142857;19;16;0.0428571428571429;0.457142857142857
Control.SRR15539832;39;38;0.41025641025641;23;16;0.0897435897435898;0.41025641025641
Control.SRR15539832;41;38;0.560975609756098;18;23;0.0609756097560976;0.439024390243902
Control.SRR15539832;44;38;0.477272727272727;23;21;0.0227272727272727;0.477272727272727
Control.SRR15539832;43;38;0.372093023255814;27;16;0.127906976744186;0.372093023255814
Control.SRR15539832;41;38;0.414634146341463;24;17;0.0853658536585366;0.414634146341463
Control.SRR15539832;36;38;0.527777777777778;17;19;0.0277777777777778;0.472222222222222
Control.SRR15539832;39;38;0.384615384615385;24;15;0.115384615384615;0.384615384615385
Control.SRR15539832;38;38;0.421052631578947;22;16;0.0789473684210527;0.421052631578947
Control.SRR15539832;35;38;0.542857142857143;16;19;0.0428571428571428;0.457142857142857
Control.SRR15539832;44;38;0.477272727272727;23;21;0.0227272727272727;0.477272727272727
Control.SRR15539832;40;38;0.525;19;21;0.025;0.475
Control.SRR15539832;43;38;0.558139534883721;19;24;0.0581395348837209;0.441860465116279
Control.SRR15539832;35;38;0.428571428571429;20;15;0.0714285714285715;0.428571428571429
Control.SRR15539832;37;38;0.567567567567568;16;21;0.0675675675675675;0.432432432432432
Control.SRR15539832;36;38;0.527777777777778;17;19;0.0277777777777778;0.472222222222222
Control.SRR15539832;40;38;0.65;14;26;0.15;0.35
Control.SRR15539832;41;38;0.463414634146341;22;19;0.0365853658536585;0.463414634146341
Control.SRR15539832;35;38;0.457142857142857;19;16;0.0428571428571429;0.457142857142857
Control.SRR15539832;41;38;0.439024390243902;23;18;0.0609756097560976;0.439024390243902
Control.SRR15539832;45;38;0.6;18;27;0.1;0.4
Control.SRR15539832;38;38;0.657894736842105;13;25;0.157894736842105;0.342105263157895
Control.SRR15539832;37;38;0.594594594594595;15;22;0.0945945945945946;0.405405405405405
Control.SRR15539832;39;38;0.435897435897436;22;17;0.0641025641025641;0.435897435897436
Control.SRR15539832;41;38;0.414634146341463;24;17;0.0853658536585366;0.414634146341463
Control.SRR15539832;35;38;0.571428571428571;15;20;0.0714285714285714;0.428571428571429
Control.SRR15539832;45;38;0.444444444444444;25;20;0.0555555555555556;0.444444444444444
Control.SRR15539832;44;38;0.431818181818182;25;19;0.0681818181818182;0.431818181818182
Control.SRR15539832;43;38;0.465116279069767;23;20;0.0348837209302326;0.465116279069767
Control.SRR15539832;42;38;0.452380952380952;23;19;0.0476190476190476;0.452380952380952
Control.SRR15539832;39;38;0.358974358974359;25;14;0.141025641025641;0.358974358974359
Control.SRR15539832;43;38;0.488372093023256;22;21;0.0116279069767442;0.488372093023256
Control.SRR15539832;40;38;0.475;21;19;0.025;0.475
Control.SRR15539832;37;38;0.513513513513513;18;19;0.0135135135135135;0.486486486486487
Control.SRR15539832;42;38;0.595238095238095;17;25;0.0952380952380952;0.404761904761905
Control.SRR15539832;39;38;0.564102564102564;17;22;0.0641025641025641;0.435897435897436
Control.SRR15539832;35;38;0.514285714285714;17;18;0.0142857142857142;0.485714285714286
Control.SRR15539832;35;38;0.428571428571429;20;15;0.0714285714285715;0.428571428571429
Control.SRR15539832;35;38;0.314285714285714;24;11;0.185714285714286;0.314285714285714
Control.SRR15539832;35;38;0.457142857142857;19;16;0.0428571428571429;0.457142857142857
Control.SRR15539832;42;38;0.523809523809524;20;22;0.0238095238095238;0.476190476190476
Control.SRR15539832;46;38;0.478260869565217;24;22;0.0217391304347826;0.478260869565217
Control.SRR15539832;38;38;0.447368421052632;21;17;0.0526315789473684;0.447368421052632
Control.SRR15539832;37;38;0.459459459459459;20;17;0.0405405405405405;0.459459459459459
Control.SRR15539832;44;38;0.477272727272727;23;21;0.0227272727272727;0.477272727272727
Control.SRR15539832;38;38;0.526315789473684;18;20;0.0263157894736842;0.473684210526316
Control.SRR15539832;46;38;0.630434782608696;17;29;0.130434782608696;0.369565217391304
Control.SRR15539832;37;38;0.459459459459459;20;17;0.0405405405405405;0.459459459459459
Control.SRR15539832;36;38;0.611111111111111;14;22;0.111111111111111;0.388888888888889
Control.SRR15539832;44;38;0.5;22;22;0;0.5
Control.SRR15539832;45;38;0.466666666666667;24;21;0.0333333333333333;0.466666666666667
Control.SRR15539832;35;38;0.485714285714286;18;17;0.0142857142857143;0.485714285714286
Control.SRR15539832;40;38;0.575;17;23;0.075;0.425
Control.SRR15539832;43;38;0.465116279069767;23;20;0.0348837209302326;0.465116279069767
Control.SRR15539832;42;38;0.5;21;21;0;0.5
Control.SRR15539832;46;38;0.565217391304348;20;26;0.0652173913043478;0.434782608695652
Control.SRR15539832;41;38;0.51219512195122;20;21;0.0121951219512195;0.48780487804878
Control.SRR15539832;41;38;0.707317073170732;12;29;0.207317073170732;0.292682926829268
Control.SRR15539832;44;38;0.431818181818182;25;19;0.0681818181818182;0.431818181818182
Control.SRR15539832;44;38;0.454545454545455;24;20;0.0454545454545455;0.454545454545455
Control.SRR15539832;39;38;0.58974358974359;16;23;0.0897435897435898;0.41025641025641
Control.SRR15539832;40;38;0.5;20;20;0;0.5
Control.SRR15539832;38;38;0.552631578947368;17;21;0.0526315789473685;0.447368421052632
Control.SRR15539832;39;38;0.564102564102564;17;22;0.0641025641025641;0.435897435897436
Control.SRR15539832;41;38;0.51219512195122;20;21;0.0121951219512195;0.48780487804878
Control.SRR15539832;39;38;0.461538461538462;21;18;0.0384615384615384;0.461538461538462
Control.SRR15539832;35;38;0.457142857142857;19;16;0.0428571428571429;0.457142857142857
Control.SRR15539832;38;38;0.526315789473684;18;20;0.0263157894736842;0.473684210526316
Control.SRR15539832;37;38;0.567567567567568;16;21;0.0675675675675675;0.432432432432432
Control.SRR15539832;36;38;0.416666666666667;21;15;0.0833333333333333;0.416666666666667
Control.SRR15539832;44;38;0.659090909090909;15;29;0.159090909090909;0.340909090909091
Control.SRR15539832;38;38;0.552631578947368;17;21;0.0526315789473685;0.447368421052632
Control.SRR15539832;38;38;0.605263157894737;15;23;0.105263157894737;0.394736842105263
Control.SRR15539832;36;38;0.638888888888889;13;23;0.138888888888889;0.361111111111111
Control.SRR15539832;38;38;0.526315789473684;18;20;0.0263157894736842;0.473684210526316
Control.SRR15539832;42;38;0.571428571428571;18;24;0.0714285714285714;0.428571428571429
Control.SRR15539832;46;38;0.434782608695652;26;20;0.0652173913043478;0.434782608695652
Control.SRR15539832;42;38;0.547619047619048;19;23;0.0476190476190477;0.452380952380952
Control.SRR15539832;45;38;0.488888888888889;23;22;0.0111111111111111;0.488888888888889
Control.SRR15539832;44;38;0.545454545454545;20;24;0.0454545454545454;0.454545454545455
Control.SRR15539832;36;38;0.5;18;18;0;0.5
Control.SRR15539832;41;38;0.536585365853659;19;22;0.0365853658536586;0.463414634146341
Control.SRR15539832;37;38;0.540540540540541;17;20;0.0405405405405406;0.459459459459459
Control.SRR15539832;41;38;0.560975609756098;18;23;0.0609756097560976;0.439024390243902
Control.SRR15539832;41;38;0.48780487804878;21;20;0.0121951219512195;0.48780487804878
Control.SRR15539832;41;38;0.609756097560976;16;25;0.109756097560976;0.390243902439024
Control.SRR15539832;40;38;0.45;22;18;0.05;0.45
Control.SRR15539832;35;38;0.542857142857143;16;19;0.0428571428571428;0.457142857142857
Control.SRR15539832;45;38;0.422222222222222;26;19;0.0777777777777778;0.422222222222222
Control.SRR15539832;43;38;0.511627906976744;21;22;0.0116279069767442;0.488372093023256
Control.SRR15539832;42;38;0.571428571428571;18;24;0.0714285714285714;0.428571428571429
Control.SRR15539832;45;38;0.488888888888889;23;22;0.0111111111111111;0.488888888888889
Control.SRR15539832;40;38;0.525;19;21;0.025;0.475
Control.SRR15539832;40;38;0.5;20;20;0;0.5
Control.SRR15539832;41;38;0.609756097560976;16;25;0.109756097560976;0.390243902439024
Control.SRR15539832;46;38;0.478260869565217;24;22;0.0217391304347826;0.478260869565217
Control.SRR15539832;36;38;0.444444444444444;20;16;0.0555555555555556;0.444444444444444
Control.SRR15539832;40;38;0.45;22;18;0.05;0.45
Control.SRR15539832;36;38;0.527777777777778;17;19;0.0277777777777778;0.472222222222222
Control.SRR15539832;35;38;0.542857142857143;16;19;0.0428571428571428;0.457142857142857
Control.SRR15539832;44;38;0.590909090909091;18;26;0.0909090909090909;0.409090909090909
Control.SRR15539832;40;38;0.425;23;17;0.075;0.425
Control.SRR15539832;43;38;0.441860465116279;24;19;0.0581395348837209;0.441860465116279
Control.SRR15539832;43;38;0.558139534883721;19;24;0.0581395348837209;0.441860465116279
Control.SRR15539832;38;38;0.578947368421053;16;22;0.0789473684210527;0.421052631578947
Control.SRR15539832;40;38;0.55;18;22;0.05;0.45
Control.SRR15539832;36;38;0.5;18;18;0;0.5
Control.SRR15539832;35;38;0.428571428571429;20;15;0.0714285714285715;0.428571428571429
Control.SRR15539832;42;38;0.428571428571429;24;18;0.0714285714285715;0.428571428571429
Control.SRR15539832;35;38;0.657142857142857;12;23;0.157142857142857;0.342857142857143
Control.SRR15539832;37;38;0.513513513513513;18;19;0.0135135135135135;0.486486486486487
Control.SRR15539832;45;38;0.622222222222222;17;28;0.122222222222222;0.377777777777778
Control.SRR15539832;40;38;0.525;19;21;0.025;0.475
Control.SRR15539832;42;38;0.380952380952381;26;16;0.119047619047619;0.380952380952381
Control.SRR15539832;38;38;0.447368421052632;21;17;0.0526315789473684;0.447368421052632
Control.SRR15539832;38;38;0.526315789473684;18;20;0.0263157894736842;0.473684210526316
Control.SRR15539832;36;38;0.444444444444444;20;16;0.0555555555555556;0.444444444444444
Control.SRR15539832;35;38;0.6;14;21;0.1;0.4
Control.SRR15539832;42;38;0.595238095238095;17;25;0.0952380952380952;0.404761904761905
Control.SRR15539832;44;38;0.454545454545455;24;20;0.0454545454545455;0.454545454545455
Control.SRR15539832;43;38;0.441860465116279;24;19;0.0581395348837209;0.441860465116279
Control.SRR15539832;46;38;0.456521739130435;25;21;0.0434782608695652;0.456521739130435
Control.SRR15539832;37;38;0.459459459459459;20;17;0.0405405405405405;0.459459459459459
Control.SRR15539832;39;38;0.512820512820513;19;20;0.0128205128205128;0.487179487179487
Control.SRR15539832;37;38;0.486486486486487;19;18;0.0135135135135135;0.486486486486487
Control.SRR15539832;43;38;0.534883720930233;20;23;0.0348837209302325;0.465116279069767
Control.SRR15539832;41;38;0.560975609756098;18;23;0.0609756097560976;0.439024390243902
Control.SRR15539832;44;38;0.363636363636364;28;16;0.136363636363636;0.363636363636364
Control.SRR15539832;38;38;0.578947368421053;16;22;0.0789473684210527;0.421052631578947
Control.SRR15539832;40;38;0.525;19;21;0.025;0.475
Control.SRR15539832;36;38;0.555555555555556;16;20;0.0555555555555556;0.444444444444444
Control.SRR15539832;37;38;0.567567567567568;16;21;0.0675675675675675;0.432432432432432
Control.SRR15539832;36;38;0.666666666666667;12;24;0.166666666666667;0.333333333333333
Control.SRR15539832;38;38;0.526315789473684;18;20;0.0263157894736842;0.473684210526316
Control.SRR15539832;37;38;0.540540540540541;17;20;0.0405405405405406;0.459459459459459
Control.SRR15539832;43;38;0.488372093023256;22;21;0.0116279069767442;0.488372093023256
Control.SRR15539832;45;38;0.333333333333333;30;15;0.166666666666667;0.333333333333333
Control.SRR15539832;41;38;0.414634146341463;24;17;0.0853658536585366;0.414634146341463
Control.SRR15539832;36;38;0.5;18;18;0;0.5
Control.SRR15539832;36;38;0.611111111111111;14;22;0.111111111111111;0.388888888888889
Control.SRR15539832;43;38;0.534883720930233;20;23;0.0348837209302325;0.465116279069767
Control.SRR15539832;44;38;0.318181818181818;30;14;0.181818181818182;0.318181818181818
Control.SRR15539832;44;38;0.590909090909091;18;26;0.0909090909090909;0.409090909090909
Control.SRR15539832;42;38;0.547619047619048;19;23;0.0476190476190477;0.452380952380952
Control.SRR15539832;40;38;0.45;22;18;0.05;0.45
Control.SRR15539832;43;38;0.488372093023256;22;21;0.0116279069767442;0.488372093023256
Control.SRR15539832;38;38;0.5;19;19;0;0.5
Control.SRR15539832;40;38;0.625;15;25;0.125;0.375
Control.SRR15539832;43;38;0.488372093023256;22;21;0.0116279069767442;0.488372093023256
Control.SRR15539832;41;38;0.51219512195122;20;21;0.0121951219512195;0.48780487804878
Control.SRR15539832;38;38;0.473684210526316;20;18;0.0263157894736842;0.473684210526316
Control.SRR15539832;40;38;0.45;22;18;0.05;0.45
Control.SRR15539832;35;38;0.428571428571429;20;15;0.0714285714285715;0.428571428571429
Control.SRR15539832;40;38;0.475;21;19;0.025;0.475
Control.SRR15539832;38;38;0.447368421052632;21;17;0.0526315789473684;0.447368421052632
Control.SRR15539832;43;38;0.418604651162791;25;18;0.0813953488372093;0.418604651162791
Control.SRR15539832;45;38;0.466666666666667;24;21;0.0333333333333333;0.466666666666667
Control.SRR15539832;42;38;0.619047619047619;16;26;0.119047619047619;0.380952380952381
Control.SRR15539832;45;38;0.555555555555556;20;25;0.0555555555555556;0.444444444444444
Control.SRR15539832;44;38;0.409090909090909;26;18;0.0909090909090909;0.409090909090909
Control.SRR15539832;41;38;0.48780487804878;21;20;0.0121951219512195;0.48780487804878
Control.SRR15539832;41;38;0.560975609756098;18;23;0.0609756097560976;0.439024390243902
Control.SRR15539832;36;38;0.472222222222222;19;17;0.0277777777777778;0.472222222222222
Control.SRR15539832;46;38;0.565217391304348;20;26;0.0652173913043478;0.434782608695652
Control.SRR15539832;43;38;0.511627906976744;21;22;0.0116279069767442;0.488372093023256
Control.SRR15539832;39;38;0.487179487179487;20;19;0.0128205128205128;0.487179487179487
Control.SRR15539832;43;38;0.558139534883721;19;24;0.0581395348837209;0.441860465116279
Control.SRR15539832;44;38;0.431818181818182;25;19;0.0681818181818182;0.431818181818182
Control.SRR15539832;36;38;0.472222222222222;19;17;0.0277777777777778;0.472222222222222
Control.SRR15539832;46;38;0.5;23;23;0;0.5
Control.SRR15539832;44;38;0.590909090909091;18;26;0.0909090909090909;0.409090909090909
Control.SRR15539832;43;38;0.418604651162791;25;18;0.0813953488372093;0.418604651162791
Control.SRR15539832;39;38;0.487179487179487;20;19;0.0128205128205128;0.487179487179487
Control.SRR15539832;43;38;0.465116279069767;23;20;0.0348837209302326;0.465116279069767
Control.SRR15539832;35;38;0.628571428571429;13;22;0.128571428571429;0.371428571428571
Control.SRR15539832;35;38;0.514285714285714;17;18;0.0142857142857142;0.485714285714286
Control.SRR15539832;43;38;0.465116279069767;23;20;0.0348837209302326;0.465116279069767
Control.SRR15539832;37;38;0.540540540540541;17;20;0.0405405405405406;0.459459459459459
Control.SRR15539832;44;38;0.386363636363636;27;17;0.113636363636364;0.386363636363636
Control.SRR15539832;42;38;0.357142857142857;27;15;0.142857142857143;0.357142857142857
Control.SRR15539832;35;38;0.428571428571429;20;15;0.0714285714285715;0.428571428571429
Control.SRR15539832;37;38;0.486486486486487;19;18;0.0135135135135135;0.486486486486487
Control.SRR15539832;41;38;0.365853658536585;26;15;0.134146341463415;0.365853658536585
Control.SRR15539832;44;38;0.477272727272727;23;21;0.0227272727272727;0.477272727272727
Control.SRR15539832;39;38;0.435897435897436;22;17;0.0641025641025641;0.435897435897436
Control.SRR15539832;41;38;0.536585365853659;19;22;0.0365853658536586;0.463414634146341
Control.SRR15539832;35;38;0.542857142857143;16;19;0.0428571428571428;0.457142857142857
Control.SRR15539832;40;38;0.475;21;19;0.025;0.475
Control.SRR15539832;35;38;0.514285714285714;17;18;0.0142857142857142;0.485714285714286
Control.SRR15539832;41;38;0.390243902439024;25;16;0.109756097560976;0.390243902439024
Control.SRR15539832;38;38;0.526315789473684;18;20;0.0263157894736842;0.473684210526316
Control.SRR15539832;37;38;0.513513513513513;18;19;0.0135135135135135;0.486486486486487
Control.SRR15539832;45;38;0.644444444444444;16;29;0.144444444444444;0.355555555555556
Control.SRR15539832;39;38;0.487179487179487;20;19;0.0128205128205128;0.487179487179487
Control.SRR15539832;36;38;0.666666666666667;12;24;0.166666666666667;0.333333333333333
Control.SRR15539832;44;38;0.340909090909091;29;15;0.159090909090909;0.340909090909091
Control.SRR15539832;45;38;0.333333333333333;30;15;0.166666666666667;0.333333333333333
Control.SRR15539832;41;38;0.365853658536585;26;15;0.134146341463415;0.365853658536585
Control.SRR15539832;40;38;0.525;19;21;0.025;0.475
Control.SRR15539832;45;38;0.444444444444444;25;20;0.0555555555555556;0.444444444444444
Control.SRR15539832;36;38;0.611111111111111;14;22;0.111111111111111;0.388888888888889
Control.SRR15539832;42;38;0.380952380952381;26;16;0.119047619047619;0.380952380952381
Control.SRR15539832;41;38;0.414634146341463;24;17;0.0853658536585366;0.414634146341463
Control.SRR15539832;43;38;0.418604651162791;25;18;0.0813953488372093;0.418604651162791
Control.SRR15539832;42;38;0.523809523809524;20;22;0.0238095238095238;0.476190476190476
Control.SRR15539832;46;38;0.391304347826087;28;18;0.108695652173913;0.391304347826087
Control.SRR15539832;38;38;0.473684210526316;20;18;0.0263157894736842;0.473684210526316
Control.SRR15539832;36;38;0.416666666666667;21;15;0.0833333333333333;0.416666666666667
Control.SRR15539832;38;38;0.447368421052632;21;17;0.0526315789473684;0.447368421052632
Control.SRR15539832;42;38;0.547619047619048;19;23;0.0476190476190477;0.452380952380952
Control.SRR15539832;35;38;0.485714285714286;18;17;0.0142857142857143;0.485714285714286
Control.SRR15539832;39;38;0.461538461538462;21;18;0.0384615384615384;0.461538461538462
Control.SRR15539832;42;38;0.5;21;21;0;0.5
Control.SRR15539832;45;38;0.488888888888889;23;22;0.0111111111111111;0.488888888888889
Control.SRR15539832;41;38;0.585365853658537;17;24;0.0853658536585366;0.414634146341463
Control.SRR15539832;44;38;0.568181818181818;19;25;0.0681818181818182;0.431818181818182
Control.SRR15539832;41;38;0.439024390243902;23;18;0.0609756097560976;0.439024390243902
Control.SRR15539832;41;38;0.48780487804878;21;20;0.0121951219512195;0.48780487804878
Control.SRR15539832;35;38;0.571428571428571;15;20;0.0714285714285714;0.428571428571429
Control.SRR15539832;35;38;0.4;21;14;0.1;0.4
Control.SRR15539832;41;38;0.51219512195122;20;21;0.0121951219512195;0.48780487804878
Control.SRR15539832;42;38;0.452380952380952;23;19;0.0476190476190476;0.452380952380952
Control.SRR15539832;41;38;0.414634146341463;24;17;0.0853658536585366;0.414634146341463
Control.SRR15539832;44;38;0.477272727272727;23;21;0.0227272727272727;0.477272727272727
Control.SRR15539832;42;38;0.452380952380952;23;19;0.0476190476190476;0.452380952380952
Control.SRR15539832;40;38;0.65;14;26;0.15;0.35
Control.SRR15539832;35;38;0.514285714285714;17;18;0.0142857142857142;0.485714285714286
Control.SRR15539832;40;38;0.525;19;21;0.025;0.475
Control.SRR15539832;38;38;0.368421052631579;24;14;0.131578947368421;0.368421052631579
Control.SRR15539832;46;38;0.565217391304348;20;26;0.0652173913043478;0.434782608695652
Control.SRR15539832;40;38;0.45;22;18;0.05;0.45
Control.SRR15539832;35;38;0.428571428571429;20;15;0.0714285714285715;0.428571428571429
Control.SRR15539832;43;38;0.604651162790698;17;26;0.104651162790698;0.395348837209302
Control.SRR15539832;41;38;0.51219512195122;20;21;0.0121951219512195;0.48780487804878
Control.SRR15539832;38;38;0.526315789473684;18;20;0.0263157894736842;0.473684210526316
Control.SRR15539832;46;38;0.543478260869565;21;25;0.0434782608695652;0.456521739130435
Control.SRR15539832;42;38;0.547619047619048;19;23;0.0476190476190477;0.452380952380952
Control.SRR15539832;46;38;0.391304347826087;28;18;0.108695652173913;0.391304347826087
Control.SRR15539832;46;38;0.521739130434783;22;24;0.0217391304347826;0.478260869565217
Control.SRR15539832;44;38;0.590909090909091;18;26;0.0909090909090909;0.409090909090909
Control.SRR15539832;37;38;0.351351351351351;24;13;0.148648648648649;0.351351351351351
Control.SRR15539832;43;38;0.604651162790698;17;26;0.104651162790698;0.395348837209302
Control.SRR15539832;45;38;0.555555555555556;20;25;0.0555555555555556;0.444444444444444
Control.SRR15539832;38;38;0.394736842105263;23;15;0.105263157894737;0.394736842105263
Control.SRR15539832;46;38;0.5;23;23;0;0.5
Control.SRR15539832;46;38;0.456521739130435;25;21;0.0434782608695652;0.456521739130435
Control.SRR15539832;45;38;0.488888888888889;23;22;0.0111111111111111;0.488888888888889
Control.SRR15539832;39;38;0.435897435897436;22;17;0.0641025641025641;0.435897435897436
Control.SRR15539832;40;38;0.575;17;23;0.075;0.425
Control.SRR15539832;43;38;0.325581395348837;29;14;0.174418604651163;0.325581395348837
Control.SRR15539832;39;38;0.538461538461538;18;21;0.0384615384615384;0.461538461538462
Control.SRR15539832;42;38;0.595238095238095;17;25;0.0952380952380952;0.404761904761905
Control.SRR15539832;39;38;0.538461538461538;18;21;0.0384615384615384;0.461538461538462
Control.SRR15539832;39;38;0.461538461538462;21;18;0.0384615384615384;0.461538461538462
Control.SRR15539832;39;38;0.487179487179487;20;19;0.0128205128205128;0.487179487179487
Control.SRR15539832;39;38;0.538461538461538;18;21;0.0384615384615384;0.461538461538462
Control.SRR15539832;38;38;0.578947368421053;16;22;0.0789473684210527;0.421052631578947
Control.SRR15539832;37;38;0.513513513513513;18;19;0.0135135135135135;0.486486486486487
Control.SRR15539832;37;38;0.594594594594595;15;22;0.0945945945945946;0.405405405405405
Control.SRR15539832;39;38;0.41025641025641;23;16;0.0897435897435898;0.41025641025641
Control.SRR15539832;41;38;0.439024390243902;23;18;0.0609756097560976;0.439024390243902
Control.SRR15539832;41;38;0.439024390243902;23;18;0.0609756097560976;0.439024390243902
Control.SRR15539832;39;38;0.435897435897436;22;17;0.0641025641025641;0.435897435897436
Control.SRR15539832;39;38;0.435897435897436;22;17;0.0641025641025641;0.435897435897436
Control.SRR15539832;38;38;0.394736842105263;23;15;0.105263157894737;0.394736842105263
Control.SRR15539832;37;38;0.513513513513513;18;19;0.0135135135135135;0.486486486486487
Control.SRR15539832;41;38;0.341463414634146;27;14;0.158536585365854;0.341463414634146
Control.SRR15539832;44;38;0.454545454545455;24;20;0.0454545454545455;0.454545454545455
Control.SRR15539832;41;38;0.585365853658537;17;24;0.0853658536585366;0.414634146341463
Control.SRR15539832;44;38;0.568181818181818;19;25;0.0681818181818182;0.431818181818182
Control.SRR15539832;39;38;0.41025641025641;23;16;0.0897435897435898;0.41025641025641
Control.SRR15539832;46;38;0.478260869565217;24;22;0.0217391304347826;0.478260869565217
Control.SRR15539832;39;38;0.58974358974359;16;23;0.0897435897435898;0.41025641025641
Control.SRR15539832;46;38;0.478260869565217;24;22;0.0217391304347826;0.478260869565217
Control.SRR15539832;39;38;0.435897435897436;22;17;0.0641025641025641;0.435897435897436
Control.SRR15539832;42;38;0.523809523809524;20;22;0.0238095238095238;0.476190476190476
Control.SRR15539832;39;38;0.615384615384615;15;24;0.115384615384615;0.384615384615385
Control.SRR15539832;38;38;0.447368421052632;21;17;0.0526315789473684;0.447368421052632
Control.SRR15539832;44;38;0.340909090909091;29;15;0.159090909090909;0.340909090909091
Control.SRR15539832;41;38;0.560975609756098;18;23;0.0609756097560976;0.439024390243902
Control.SRR15539832;39;38;0.435897435897436;22;17;0.0641025641025641;0.435897435897436
Control.SRR15539832;38;38;0.578947368421053;16;22;0.0789473684210527;0.421052631578947
Control.SRR15539832;39;38;0.333333333333333;26;13;0.166666666666667;0.333333333333333
Control.SRR15539832;41;38;0.536585365853659;19;22;0.0365853658536586;0.463414634146341
Control.SRR15539832;41;38;0.609756097560976;16;25;0.109756097560976;0.390243902439024
Control.SRR15539832;37;38;0.432432432432432;21;16;0.0675675675675675;0.432432432432432
Control.SRR15539832;36;38;0.694444444444444;11;25;0.194444444444444;0.305555555555556
Control.SRR15539832;40;38;0.425;23;17;0.075;0.425
Control.SRR15539832;42;38;0.5;21;21;0;0.5
Control.SRR15539832;42;38;0.30952380952381;29;13;0.19047619047619;0.30952380952381
Control.SRR15539832;39;38;0.512820512820513;19;20;0.0128205128205128;0.487179487179487
Control.SRR15539832;36;38;0.5;18;18;0;0.5
Control.SRR15539832;40;38;0.525;19;21;0.025;0.475
Control.SRR15539832;46;38;0.5;23;23;0;0.5
Control.SRR15539832;39;38;0.461538461538462;21;18;0.0384615384615384;0.461538461538462
Control.SRR15539832;35;38;0.457142857142857;19;16;0.0428571428571429;0.457142857142857
Control.SRR15539832;41;38;0.536585365853659;19;22;0.0365853658536586;0.463414634146341
Control.SRR15539832;46;38;0.543478260869565;21;25;0.0434782608695652;0.456521739130435
Control.SRR15539832;45;38;0.444444444444444;25;20;0.0555555555555556;0.444444444444444
Control.SRR15539832;38;38;0.605263157894737;15;23;0.105263157894737;0.394736842105263
Control.SRR15539832;40;38;0.425;23;17;0.075;0.425
Control.SRR15539832;42;38;0.452380952380952;23;19;0.0476190476190476;0.452380952380952
Control.SRR15539832;44;38;0.386363636363636;27;17;0.113636363636364;0.386363636363636
Control.SRR15539832;41;38;0.51219512195122;20;21;0.0121951219512195;0.48780487804878
Control.SRR15539832;41;38;0.439024390243902;23;18;0.0609756097560976;0.439024390243902
Control.SRR15539832;42;38;0.285714285714286;30;12;0.214285714285714;0.285714285714286
Control.SRR15539832;36;38;0.305555555555556;25;11;0.194444444444444;0.305555555555556
Control.SRR15539832;43;38;0.418604651162791;25;18;0.0813953488372093;0.418604651162791
Control.SRR15539832;43;38;0.651162790697674;15;28;0.151162790697674;0.348837209302326
Control.SRR15539832;37;38;0.459459459459459;20;17;0.0405405405405405;0.459459459459459
Control.SRR15539832;44;38;0.454545454545455;24;20;0.0454545454545455;0.454545454545455
Control.SRR15539832;45;38;0.533333333333333;21;24;0.0333333333333333;0.466666666666667
Control.SRR15539832;46;38;0.5;23;23;0;0.5
Control.SRR15539832;35;38;0.514285714285714;17;18;0.0142857142857142;0.485714285714286
Control.SRR15539832;36;38;0.527777777777778;17;19;0.0277777777777778;0.472222222222222
Control.SRR15539832;37;38;0.702702702702703;11;26;0.202702702702703;0.297297297297297
Control.SRR15539832;40;38;0.425;23;17;0.075;0.425
Control.SRR15539832;37;38;0.432432432432432;21;16;0.0675675675675675;0.432432432432432
Control.SRR15539832;38;38;0.5;19;19;0;0.5
Control.SRR15539832;42;38;0.428571428571429;24;18;0.0714285714285715;0.428571428571429
Control.SRR15539832;42;38;0.523809523809524;20;22;0.0238095238095238;0.476190476190476
Control.SRR15539832;39;38;0.615384615384615;15;24;0.115384615384615;0.384615384615385
Control.SRR15539832;44;38;0.5;22;22;0;0.5
Control.SRR15539832;37;38;0.621621621621622;14;23;0.121621621621622;0.378378378378378
Control.SRR15539832;44;38;0.522727272727273;21;23;0.0227272727272727;0.477272727272727
Control.SRR15539832;41;38;0.48780487804878;21;20;0.0121951219512195;0.48780487804878
Control.SRR15539832;39;38;0.307692307692308;27;12;0.192307692307692;0.307692307692308
Control.SRR15539832;37;38;0.567567567567568;16;21;0.0675675675675675;0.432432432432432
Control.SRR15539832;39;38;0.487179487179487;20;19;0.0128205128205128;0.487179487179487
Control.SRR15539832;37;38;0.459459459459459;20;17;0.0405405405405405;0.459459459459459
Control.SRR15539832;46;38;0.521739130434783;22;24;0.0217391304347826;0.478260869565217
Control.SRR15539832;42;38;0.380952380952381;26;16;0.119047619047619;0.380952380952381
Control.SRR15539832;40;38;0.475;21;19;0.025;0.475
Control.SRR15539832;44;38;0.340909090909091;29;15;0.159090909090909;0.340909090909091
Control.SRR15539832;45;38;0.488888888888889;23;22;0.0111111111111111;0.488888888888889
Control.SRR15539832;46;38;0.456521739130435;25;21;0.0434782608695652;0.456521739130435
Control.SRR15539832;45;38;0.444444444444444;25;20;0.0555555555555556;0.444444444444444
Control.SRR15539832;42;38;0.642857142857143;15;27;0.142857142857143;0.357142857142857
Control.SRR15539832;38;38;0.473684210526316;20;18;0.0263157894736842;0.473684210526316
Control.SRR15539832;35;38;0.428571428571429;20;15;0.0714285714285715;0.428571428571429
Control.SRR15539832;38;38;0.473684210526316;20;18;0.0263157894736842;0.473684210526316
Control.SRR15539832;38;38;0.447368421052632;21;17;0.0526315789473684;0.447368421052632
Control.SRR15539832;36;38;0.583333333333333;15;21;0.0833333333333334;0.416666666666667
Control.SRR15539832;35;38;0.457142857142857;19;16;0.0428571428571429;0.457142857142857
Control.SRR15539832;45;38;0.555555555555556;20;25;0.0555555555555556;0.444444444444444
Control.SRR15539832;41;38;0.51219512195122;20;21;0.0121951219512195;0.48780487804878
Control.SRR15539832;37;38;0.675675675675676;12;25;0.175675675675676;0.324324324324324
Control.SRR15539832;40;38;0.55;18;22;0.05;0.45
Control.SRR15539832;42;38;0.404761904761905;25;17;0.0952380952380952;0.404761904761905
Control.SRR15539832;42;38;0.5;21;21;0;0.5
Control.SRR15539832;38;38;0.526315789473684;18;20;0.0263157894736842;0.473684210526316
Control.SRR15539832;36;38;0.611111111111111;14;22;0.111111111111111;0.388888888888889
Control.SRR15539832;42;38;0.523809523809524;20;22;0.0238095238095238;0.476190476190476
Control.SRR15539832;36;38;0.5;18;18;0;0.5
Control.SRR15539832;40;38;0.475;21;19;0.025;0.475
Control.SRR15539832;37;38;0.459459459459459;20;17;0.0405405405405405;0.459459459459459
Control.SRR15539832;43;38;0.488372093023256;22;21;0.0116279069767442;0.488372093023256
Control.SRR15539832;44;38;0.636363636363636;16;28;0.136363636363636;0.363636363636364
Control.SRR15539832;45;38;0.377777777777778;28;17;0.122222222222222;0.377777777777778
Control.SRR15539832;37;38;0.486486486486487;19;18;0.0135135135135135;0.486486486486487
Control.SRR15539832;43;38;0.465116279069767;23;20;0.0348837209302326;0.465116279069767
Control.SRR15539832;42;38;0.428571428571429;24;18;0.0714285714285715;0.428571428571429
Control.SRR15539832;43;38;0.441860465116279;24;19;0.0581395348837209;0.441860465116279
Control.SRR15539832;46;38;0.434782608695652;26;20;0.0652173913043478;0.434782608695652
Control.SRR15539832;41;38;0.609756097560976;16;25;0.109756097560976;0.390243902439024
Control.SRR15539832;44;38;0.5;22;22;0;0.5
Control.SRR15539832;44;38;0.590909090909091;18;26;0.0909090909090909;0.409090909090909
Control.SRR15539832;44;38;0.477272727272727;23;21;0.0227272727272727;0.477272727272727
Control.SRR15539832;40;38;0.525;19;21;0.025;0.475
Control.SRR15539832;36;38;0.472222222222222;19;17;0.0277777777777778;0.472222222222222
Control.SRR15539832;37;38;0.405405405405405;22;15;0.0945945945945946;0.405405405405405
Control.SRR15539832;43;38;0.465116279069767;23;20;0.0348837209302326;0.465116279069767
Control.SRR15539832;42;38;0.476190476190476;22;20;0.0238095238095238;0.476190476190476
Control.SRR15539832;38;38;0.552631578947368;17;21;0.0526315789473685;0.447368421052632
Control.SRR15539832;44;38;0.363636363636364;28;16;0.136363636363636;0.363636363636364
Control.SRR15539832;41;38;0.609756097560976;16;25;0.109756097560976;0.390243902439024
Control.SRR15539832;36;38;0.555555555555556;16;20;0.0555555555555556;0.444444444444444
Control.SRR15539832;36;38;0.555555555555556;16;20;0.0555555555555556;0.444444444444444
Control.SRR15539832;35;38;0.514285714285714;17;18;0.0142857142857142;0.485714285714286
Control.SRR15539832;44;38;0.454545454545455;24;20;0.0454545454545455;0.454545454545455
Control.SRR15539832;38;38;0.605263157894737;15;23;0.105263157894737;0.394736842105263
Control.SRR15539832;44;38;0.477272727272727;23;21;0.0227272727272727;0.477272727272727
Control.SRR15539832;36;38;0.472222222222222;19;17;0.0277777777777778;0.472222222222222
Control.SRR15539832;38;38;0.421052631578947;22;16;0.0789473684210527;0.421052631578947
Control.SRR15539832;46;38;0.565217391304348;20;26;0.0652173913043478;0.434782608695652
Control.SRR15539832;44;38;0.477272727272727;23;21;0.0227272727272727;0.477272727272727
Control.SRR15539832;40;38;0.55;18;22;0.05;0.45
Control.SRR15539832;36;38;0.472222222222222;19;17;0.0277777777777778;0.472222222222222
Control.SRR15539832;39;38;0.487179487179487;20;19;0.0128205128205128;0.487179487179487
Control.SRR15539832;42;38;0.666666666666667;14;28;0.166666666666667;0.333333333333333
Control.SRR15539832;39;38;0.358974358974359;25;14;0.141025641025641;0.358974358974359
Control.SRR15539832;40;38;0.425;23;17;0.075;0.425
Control.SRR15539832;43;38;0.558139534883721;19;24;0.0581395348837209;0.441860465116279
Control.SRR15539832;43;38;0.627906976744186;16;27;0.127906976744186;0.372093023255814
Control.SRR15539832;43;38;0.441860465116279;24;19;0.0581395348837209;0.441860465116279
Control.SRR15539832;37;38;0.594594594594595;15;22;0.0945945945945946;0.405405405405405
Control.SRR15539832;44;38;0.522727272727273;21;23;0.0227272727272727;0.477272727272727
Control.SRR15539832;44;38;0.454545454545455;24;20;0.0454545454545455;0.454545454545455
Control.SRR15539832;43;38;0.488372093023256;22;21;0.0116279069767442;0.488372093023256
Control.SRR15539832;40;38;0.45;22;18;0.05;0.45
Control.SRR15539832;41;38;0.48780487804878;21;20;0.0121951219512195;0.48780487804878
Control.SRR15539832;36;38;0.611111111111111;14;22;0.111111111111111;0.388888888888889
Control.SRR15539832;40;38;0.55;18;22;0.05;0.45
Control.SRR15539832;46;38;0.41304347826087;27;19;0.0869565217391304;0.41304347826087
Control.SRR15539832;41;38;0.536585365853659;19;22;0.0365853658536586;0.463414634146341
Control.SRR15539832;39;38;0.58974358974359;16;23;0.0897435897435898;0.41025641025641
Control.SRR15539832;36;38;0.583333333333333;15;21;0.0833333333333334;0.416666666666667
Control.SRR15539832;35;38;0.6;14;21;0.1;0.4
Control.SRR15539832;35;38;0.371428571428571;22;13;0.128571428571429;0.371428571428571
Control.SRR15539832;36;38;0.333333333333333;24;12;0.166666666666667;0.333333333333333
Control.SRR15539832;46;38;0.434782608695652;26;20;0.0652173913043478;0.434782608695652
Control.SRR15539832;46;38;0.456521739130435;25;21;0.0434782608695652;0.456521739130435
Control.SRR15539832;46;38;0.58695652173913;19;27;0.0869565217391305;0.41304347826087
Control.SRR15539832;44;38;0.5;22;22;0;0.5
Control.SRR15539832;43;38;0.558139534883721;19;24;0.0581395348837209;0.441860465116279
Control.SRR15539832;38;38;0.526315789473684;18;20;0.0263157894736842;0.473684210526316
Control.SRR15539832;37;38;0.675675675675676;12;25;0.175675675675676;0.324324324324324
Control.SRR15539832;43;38;0.534883720930233;20;23;0.0348837209302325;0.465116279069767
Control.SRR15539832;35;38;0.342857142857143;23;12;0.157142857142857;0.342857142857143
Control.SRR15539832;36;38;0.444444444444444;20;16;0.0555555555555556;0.444444444444444
Control.SRR15539832;36;38;0.583333333333333;15;21;0.0833333333333334;0.416666666666667
Control.SRR15539832;38;38;0.447368421052632;21;17;0.0526315789473684;0.447368421052632
Control.SRR15539832;40;38;0.475;21;19;0.025;0.475
Control.SRR15539832;38;38;0.5;19;19;0;0.5
Control.SRR15539832;45;38;0.555555555555556;20;25;0.0555555555555556;0.444444444444444
Control.SRR15539832;37;38;0.459459459459459;20;17;0.0405405405405405;0.459459459459459
Control.SRR15539832;46;38;0.565217391304348;20;26;0.0652173913043478;0.434782608695652
Control.SRR15539832;36;38;0.5;18;18;0;0.5
Control.SRR15539832;37;38;0.351351351351351;24;13;0.148648648648649;0.351351351351351
Control.SRR15539832;38;38;0.5;19;19;0;0.5
Control.SRR15539832;38;38;0.473684210526316;20;18;0.0263157894736842;0.473684210526316
Control.SRR15539832;46;38;0.478260869565217;24;22;0.0217391304347826;0.478260869565217
Control.SRR15539832;45;38;0.444444444444444;25;20;0.0555555555555556;0.444444444444444
Control.SRR15539832;37;38;0.486486486486487;19;18;0.0135135135135135;0.486486486486487
Control.SRR15539832;37;38;0.567567567567568;16;21;0.0675675675675675;0.432432432432432
Control.SRR15539832;46;38;0.304347826086957;32;14;0.195652173913043;0.304347826086957
Control.SRR15539832;36;38;0.444444444444444;20;16;0.0555555555555556;0.444444444444444
Control.SRR15539832;35;38;0.4;21;14;0.1;0.4
Control.SRR15539832;40;38;0.425;23;17;0.075;0.425
Control.SRR15539832;36;38;0.555555555555556;16;20;0.0555555555555556;0.444444444444444
Control.SRR15539832;41;38;0.609756097560976;16;25;0.109756097560976;0.390243902439024
Control.SRR15539832;35;38;0.542857142857143;16;19;0.0428571428571428;0.457142857142857
Control.SRR15539832;45;38;0.533333333333333;21;24;0.0333333333333333;0.466666666666667
Control.SRR15539832;40;38;0.5;20;20;0;0.5
Control.SRR15539832;46;38;0.41304347826087;27;19;0.0869565217391304;0.41304347826087
Control.SRR15539832;42;38;0.547619047619048;19;23;0.0476190476190477;0.452380952380952
Control.SRR15539832;36;38;0.444444444444444;20;16;0.0555555555555556;0.444444444444444
Control.SRR15539832;42;38;0.5;21;21;0;0.5
Control.SRR15539832;46;38;0.434782608695652;26;20;0.0652173913043478;0.434782608695652
Control.SRR15539832;44;38;0.477272727272727;23;21;0.0227272727272727;0.477272727272727
Control.SRR15539832;41;38;0.51219512195122;20;21;0.0121951219512195;0.48780487804878
Control.SRR15539832;35;38;0.428571428571429;20;15;0.0714285714285715;0.428571428571429
Control.SRR15539832;38;38;0.473684210526316;20;18;0.0263157894736842;0.473684210526316
Control.SRR15539832;41;38;0.560975609756098;18;23;0.0609756097560976;0.439024390243902
Control.SRR15539832;40;38;0.675;13;27;0.175;0.325
Control.SRR15539832;35;38;0.428571428571429;20;15;0.0714285714285715;0.428571428571429
Control.SRR15539832;46;38;0.608695652173913;18;28;0.108695652173913;0.391304347826087
Control.SRR15539832;45;38;0.555555555555556;20;25;0.0555555555555556;0.444444444444444
Control.SRR15539832;41;38;0.390243902439024;25;16;0.109756097560976;0.390243902439024
Control.SRR15539832;42;38;0.380952380952381;26;16;0.119047619047619;0.380952380952381
Control.SRR15539832;38;38;0.526315789473684;18;20;0.0263157894736842;0.473684210526316
Control.SRR15539832;38;38;0.368421052631579;24;14;0.131578947368421;0.368421052631579
Control.SRR15539832;36;38;0.472222222222222;19;17;0.0277777777777778;0.472222222222222
Control.SRR15539832;36;38;0.555555555555556;16;20;0.0555555555555556;0.444444444444444
Control.SRR15539832;36;38;0.416666666666667;21;15;0.0833333333333333;0.416666666666667
Control.SRR15539832;40;38;0.475;21;19;0.025;0.475
Control.SRR15539832;38;38;0.5;19;19;0;0.5
Control.SRR15539832;43;38;0.441860465116279;24;19;0.0581395348837209;0.441860465116279
Control.SRR15539832;39;38;0.435897435897436;22;17;0.0641025641025641;0.435897435897436
Control.SRR15539832;42;38;0.571428571428571;18;24;0.0714285714285714;0.428571428571429
Control.SRR15539832;39;38;0.538461538461538;18;21;0.0384615384615384;0.461538461538462
Control.SRR15539832;40;38;0.375;25;15;0.125;0.375
Control.SRR15539832;46;38;0.434782608695652;26;20;0.0652173913043478;0.434782608695652
Control.SRR15539832;42;38;0.595238095238095;17;25;0.0952380952380952;0.404761904761905
Control.SRR15539832;45;38;0.422222222222222;26;19;0.0777777777777778;0.422222222222222
Control.SRR15539832;35;38;0.542857142857143;16;19;0.0428571428571428;0.457142857142857
Control.SRR15539832;38;38;0.421052631578947;22;16;0.0789473684210527;0.421052631578947
Control.SRR15539832;38;38;0.526315789473684;18;20;0.0263157894736842;0.473684210526316
Control.SRR15539832;44;38;0.545454545454545;20;24;0.0454545454545454;0.454545454545455
Control.SRR15539832;36;38;0.472222222222222;19;17;0.0277777777777778;0.472222222222222
Control.SRR15539832;39;38;0.615384615384615;15;24;0.115384615384615;0.384615384615385
Control.SRR15539832;40;38;0.475;21;19;0.025;0.475
Control.SRR15539832;40;38;0.575;17;23;0.075;0.425
Control.SRR15539832;46;38;0.565217391304348;20;26;0.0652173913043478;0.434782608695652
Control.SRR15539832;43;38;0.488372093023256;22;21;0.0116279069767442;0.488372093023256
Control.SRR15539832;41;38;0.463414634146341;22;19;0.0365853658536585;0.463414634146341
Control.SRR15539832;40;38;0.5;20;20;0;0.5
Control.SRR15539832;35;38;0.4;21;14;0.1;0.4
Control.SRR15539832;42;38;0.547619047619048;19;23;0.0476190476190477;0.452380952380952
Control.SRR15539832;46;38;0.456521739130435;25;21;0.0434782608695652;0.456521739130435
Control.SRR15539832;39;38;0.564102564102564;17;22;0.0641025641025641;0.435897435897436
Control.SRR15539832;44;38;0.454545454545455;24;20;0.0454545454545455;0.454545454545455
Control.SRR15539832;38;38;0.631578947368421;14;24;0.131578947368421;0.368421052631579
Control.SRR15539832;43;38;0.558139534883721;19;24;0.0581395348837209;0.441860465116279
Control.SRR15539832;37;38;0.405405405405405;22;15;0.0945945945945946;0.405405405405405
Control.SRR15539832;39;38;0.538461538461538;18;21;0.0384615384615384;0.461538461538462
Control.SRR15539832;39;38;0.461538461538462;21;18;0.0384615384615384;0.461538461538462
Control.SRR15539832;39;38;0.41025641025641;23;16;0.0897435897435898;0.41025641025641
Control.SRR15539832;41;38;0.51219512195122;20;21;0.0121951219512195;0.48780487804878
Control.SRR15539832;39;38;0.487179487179487;20;19;0.0128205128205128;0.487179487179487
Control.SRR15539832;38;38;0.342105263157895;25;13;0.157894736842105;0.342105263157895
Control.SRR15539832;37;38;0.540540540540541;17;20;0.0405405405405406;0.459459459459459
Control.SRR15539832;44;38;0.545454545454545;20;24;0.0454545454545454;0.454545454545455
Control.SRR15539832;43;38;0.465116279069767;23;20;0.0348837209302326;0.465116279069767
Control.SRR15539832;41;38;0.585365853658537;17;24;0.0853658536585366;0.414634146341463
Control.SRR15539832;42;38;0.523809523809524;20;22;0.0238095238095238;0.476190476190476
Control.SRR15539832;39;38;0.641025641025641;14;25;0.141025641025641;0.358974358974359
Control.SRR15539832;37;38;0.459459459459459;20;17;0.0405405405405405;0.459459459459459
Control.SRR15539832;46;38;0.5;23;23;0;0.5
Control.SRR15539832;46;38;0.521739130434783;22;24;0.0217391304347826;0.478260869565217
Control.SRR15539832;43;38;0.395348837209302;26;17;0.104651162790698;0.395348837209302
Control.SRR15539832;45;38;0.333333333333333;30;15;0.166666666666667;0.333333333333333
Control.SRR15539832;40;38;0.55;18;22;0.05;0.45
Control.SRR15539832;43;38;0.534883720930233;20;23;0.0348837209302325;0.465116279069767
Control.SRR15539832;35;38;0.314285714285714;24;11;0.185714285714286;0.314285714285714
Control.SRR15539832;37;38;0.27027027027027;27;10;0.22972972972973;0.27027027027027
Control.SRR15539832;36;38;0.555555555555556;16;20;0.0555555555555556;0.444444444444444
Control.SRR15539832;44;38;0.477272727272727;23;21;0.0227272727272727;0.477272727272727
Control.SRR15539832;46;38;0.434782608695652;26;20;0.0652173913043478;0.434782608695652
Control.SRR15539832;42;38;0.523809523809524;20;22;0.0238095238095238;0.476190476190476
Control.SRR15539832;35;38;0.4;21;14;0.1;0.4
Control.SRR15539832;37;38;0.621621621621622;14;23;0.121621621621622;0.378378378378378
Control.SRR15539832;42;38;0.428571428571429;24;18;0.0714285714285715;0.428571428571429
Control.SRR15539832;40;38;0.6;16;24;0.1;0.4
Control.SRR15539832;37;38;0.513513513513513;18;19;0.0135135135135135;0.486486486486487
Control.SRR15539832;36;38;0.638888888888889;13;23;0.138888888888889;0.361111111111111
Control.SRR15539832;38;38;0.526315789473684;18;20;0.0263157894736842;0.473684210526316
Control.SRR15539832;36;38;0.527777777777778;17;19;0.0277777777777778;0.472222222222222
Control.SRR15539832;41;38;0.536585365853659;19;22;0.0365853658536586;0.463414634146341
Control.SRR15539832;42;38;0.619047619047619;16;26;0.119047619047619;0.380952380952381
Control.SRR15539832;46;38;0.347826086956522;30;16;0.152173913043478;0.347826086956522
Control.SRR15539832;38;38;0.394736842105263;23;15;0.105263157894737;0.394736842105263
Control.SRR15539832;40;38;0.475;21;19;0.025;0.475
Control.SRR15539832;43;38;0.558139534883721;19;24;0.0581395348837209;0.441860465116279
Control.SRR15539832;43;38;0.581395348837209;18;25;0.0813953488372093;0.418604651162791
Control.SRR15539832;42;38;0.452380952380952;23;19;0.0476190476190476;0.452380952380952
Control.SRR15539832;39;38;0.487179487179487;20;19;0.0128205128205128;0.487179487179487
Control.SRR15539832;38;38;0.552631578947368;17;21;0.0526315789473685;0.447368421052632
Control.SRR15539832;41;38;0.536585365853659;19;22;0.0365853658536586;0.463414634146341
Control.SRR15539832;44;38;0.5;22;22;0;0.5
Control.SRR15539832;36;38;0.666666666666667;12;24;0.166666666666667;0.333333333333333
Control.SRR15539832;38;38;0.631578947368421;14;24;0.131578947368421;0.368421052631579
Control.SRR15539832;35;38;0.514285714285714;17;18;0.0142857142857142;0.485714285714286
Control.SRR15539832;35;38;0.514285714285714;17;18;0.0142857142857142;0.485714285714286
Control.SRR15539832;44;38;0.636363636363636;16;28;0.136363636363636;0.363636363636364
Control.SRR15539832;43;38;0.465116279069767;23;20;0.0348837209302326;0.465116279069767
Control.SRR15539832;37;38;0.459459459459459;20;17;0.0405405405405405;0.459459459459459
Control.SRR15539832;38;38;0.578947368421053;16;22;0.0789473684210527;0.421052631578947
Control.SRR15539832;39;38;0.538461538461538;18;21;0.0384615384615384;0.461538461538462
Control.SRR15539832;37;38;0.540540540540541;17;20;0.0405405405405406;0.459459459459459
Control.SRR15539832;35;38;0.485714285714286;18;17;0.0142857142857143;0.485714285714286
Control.SRR15539832;42;38;0.357142857142857;27;15;0.142857142857143;0.357142857142857
Control.SRR15539832;36;38;0.5;18;18;0;0.5
Control.SRR15539832;35;38;0.6;14;21;0.1;0.4
Control.SRR15539832;37;38;0.702702702702703;11;26;0.202702702702703;0.297297297297297
Control.SRR15539832;41;38;0.585365853658537;17;24;0.0853658536585366;0.414634146341463
Control.SRR15539832;38;38;0.5;19;19;0;0.5
Control.SRR15539832;41;38;0.51219512195122;20;21;0.0121951219512195;0.48780487804878
Control.SRR15539832;39;38;0.461538461538462;21;18;0.0384615384615384;0.461538461538462
Control.SRR15539832;35;38;0.485714285714286;18;17;0.0142857142857143;0.485714285714286
Control.SRR15539832;43;38;0.511627906976744;21;22;0.0116279069767442;0.488372093023256
Control.SRR15539832;46;38;0.5;23;23;0;0.5
Control.SRR15539832;40;38;0.6;16;24;0.1;0.4
Control.SRR15539832;39;38;0.41025641025641;23;16;0.0897435897435898;0.41025641025641
Control.SRR15539832;43;38;0.441860465116279;24;19;0.0581395348837209;0.441860465116279
Control.SRR15539832;40;38;0.625;15;25;0.125;0.375
Control.SRR15539832;40;38;0.45;22;18;0.05;0.45
Control.SRR15539832;36;38;0.444444444444444;20;16;0.0555555555555556;0.444444444444444
Control.SRR15539832;39;38;0.41025641025641;23;16;0.0897435897435898;0.41025641025641
Control.SRR15539832;39;38;0.666666666666667;13;26;0.166666666666667;0.333333333333333
Control.SRR15539832;42;38;0.523809523809524;20;22;0.0238095238095238;0.476190476190476
Control.SRR15539832;39;38;0.512820512820513;19;20;0.0128205128205128;0.487179487179487
Control.SRR15539832;41;38;0.463414634146341;22;19;0.0365853658536585;0.463414634146341
Control.SRR15539832;35;38;0.542857142857143;16;19;0.0428571428571428;0.457142857142857
Control.SRR15539832;41;38;0.585365853658537;17;24;0.0853658536585366;0.414634146341463
Control.SRR15539832;45;38;0.377777777777778;28;17;0.122222222222222;0.377777777777778
Control.SRR15539832;36;38;0.472222222222222;19;17;0.0277777777777778;0.472222222222222
Control.SRR15539832;45;38;0.466666666666667;24;21;0.0333333333333333;0.466666666666667
Control.SRR15539832;38;38;0.473684210526316;20;18;0.0263157894736842;0.473684210526316
Control.SRR15539832;37;38;0.540540540540541;17;20;0.0405405405405406;0.459459459459459
Control.SRR15539832;35;38;0.6;14;21;0.1;0.4
Control.SRR15539832;35;38;0.428571428571429;20;15;0.0714285714285715;0.428571428571429
Control.SRR15539832;35;38;0.542857142857143;16;19;0.0428571428571428;0.457142857142857
Control.SRR15539832;37;38;0.513513513513513;18;19;0.0135135135135135;0.486486486486487
Control.SRR15539832;38;38;0.5;19;19;0;0.5
Control.SRR15539832;40;38;0.625;15;25;0.125;0.375
Control.SRR15539832;39;38;0.564102564102564;17;22;0.0641025641025641;0.435897435897436
Control.SRR15539832;43;38;0.441860465116279;24;19;0.0581395348837209;0.441860465116279
Control.SRR15539832;40;38;0.475;21;19;0.025;0.475
Control.SRR15539832;43;38;0.511627906976744;21;22;0.0116279069767442;0.488372093023256
Control.SRR15539832;42;38;0.595238095238095;17;25;0.0952380952380952;0.404761904761905
Control.SRR15539832;44;38;0.590909090909091;18;26;0.0909090909090909;0.409090909090909
Control.SRR15539832;44;38;0.454545454545455;24;20;0.0454545454545455;0.454545454545455
Control.SRR15539832;41;38;0.51219512195122;20;21;0.0121951219512195;0.48780487804878
Control.SRR15539832;42;38;0.404761904761905;25;17;0.0952380952380952;0.404761904761905
Control.SRR15539832;45;38;0.622222222222222;17;28;0.122222222222222;0.377777777777778
Control.SRR15539832;35;38;0.514285714285714;17;18;0.0142857142857142;0.485714285714286
Control.SRR15539832;42;38;0.428571428571429;24;18;0.0714285714285715;0.428571428571429
Control.SRR15539832;45;38;0.533333333333333;21;24;0.0333333333333333;0.466666666666667
Control.SRR15539832;35;38;0.571428571428571;15;20;0.0714285714285714;0.428571428571429
Control.SRR15539832;40;38;0.5;20;20;0;0.5
Control.SRR15539832;34;38;0.5;17;17;0;0.5
Control.SRR15539832;36;38;0.583333333333333;15;21;0.0833333333333334;0.416666666666667
Control.SRR15539832;38;38;0.447368421052632;21;17;0.0526315789473684;0.447368421052632
Control.SRR15539832;34;38;0.382352941176471;21;13;0.117647058823529;0.382352941176471
Control.SRR15539832;33;38;0.545454545454545;15;18;0.0454545454545454;0.454545454545455
Control.SRR15539832;35;38;0.457142857142857;19;16;0.0428571428571429;0.457142857142857
Control.SRR15539832;35;38;0.628571428571429;13;22;0.128571428571429;0.371428571428571
Control.SRR15539832;33;38;0.515151515151515;16;17;0.0151515151515151;0.484848484848485
Control.SRR15539832;31;38;0.419354838709677;18;13;0.0806451612903226;0.419354838709677
Control.SRR15539832;30;38;0.5;15;15;0;0.5
Control.SRR15539832;29;38;0.517241379310345;14;15;0.0172413793103449;0.482758620689655
Control.SRR15539832;36;38;0.5;18;18;0;0.5
Control.SRR15539832;38;38;0.447368421052632;21;17;0.0526315789473684;0.447368421052632
Control.SRR15539832;34;38;0.382352941176471;21;13;0.117647058823529;0.382352941176471
Control.SRR15539832;32;38;0.59375;13;19;0.09375;0.40625
Control.SRR15539832;35;38;0.571428571428571;15;20;0.0714285714285714;0.428571428571429
Control.SRR15539832;37;38;0.405405405405405;22;15;0.0945945945945946;0.405405405405405
Control.SRR15539832;33;38;0.454545454545455;18;15;0.0454545454545455;0.454545454545455
Control.SRR15539832;34;38;0.617647058823529;13;21;0.117647058823529;0.382352941176471
Control.SRR15539832;36;38;0.583333333333333;15;21;0.0833333333333334;0.416666666666667
Control.SRR15539832;35;38;0.6;14;21;0.1;0.4
Control.SRR15539832;34;38;0.558823529411765;15;19;0.0588235294117647;0.441176470588235
Control.SRR15539832;35;38;0.657142857142857;12;23;0.157142857142857;0.342857142857143
Control.SRR15539832;36;38;0.444444444444444;20;16;0.0555555555555556;0.444444444444444
Control.SRR15539832;34;38;0.558823529411765;15;19;0.0588235294117647;0.441176470588235
Control.SRR15539832;32;38;0.46875;17;15;0.03125;0.46875
Control.SRR15539832;39;38;0.487179487179487;20;19;0.0128205128205128;0.487179487179487
Control.SRR15539832;31;38;0.548387096774194;14;17;0.0483870967741935;0.451612903225806
Control.SRR15539832;38;38;0.5;19;19;0;0.5
Control.SRR15539832;33;38;0.424242424242424;19;14;0.0757575757575757;0.424242424242424
Control.SRR15539832;33;38;0.454545454545455;18;15;0.0454545454545455;0.454545454545455
Control.SRR15539832;33;38;0.666666666666667;11;22;0.166666666666667;0.333333333333333
Control.SRR15539832;31;38;0.451612903225806;17;14;0.0483870967741936;0.451612903225806
Control.SRR15539832;30;38;0.566666666666667;13;17;0.0666666666666667;0.433333333333333
Control.SRR15539832;29;38;0.551724137931034;13;16;0.0517241379310345;0.448275862068966
Control.SRR15539832;34;38;0.352941176470588;22;12;0.147058823529412;0.352941176470588
Control.SRR15539832;37;38;0.405405405405405;22;15;0.0945945945945946;0.405405405405405
Control.SRR15539832;38;38;0.421052631578947;22;16;0.0789473684210527;0.421052631578947
Control.SRR15539832;37;38;0.459459459459459;20;17;0.0405405405405405;0.459459459459459
Control.SRR15539832;31;38;0.354838709677419;20;11;0.145161290322581;0.354838709677419
Control.SRR15539832;36;38;0.444444444444444;20;16;0.0555555555555556;0.444444444444444
Control.SRR15539832;38;38;0.631578947368421;14;24;0.131578947368421;0.368421052631579
Control.SRR15539832;38;38;0.394736842105263;23;15;0.105263157894737;0.394736842105263
Control.SRR15539832;31;38;0.451612903225806;17;14;0.0483870967741936;0.451612903225806
Control.SRR15539832;35;38;0.485714285714286;18;17;0.0142857142857143;0.485714285714286
Control.SRR15539832;31;38;0.548387096774194;14;17;0.0483870967741935;0.451612903225806
Control.SRR15539832;34;38;0.382352941176471;21;13;0.117647058823529;0.382352941176471
Control.SRR15539832;34;38;0.558823529411765;15;19;0.0588235294117647;0.441176470588235
Control.SRR15539832;34;38;0.411764705882353;20;14;0.0882352941176471;0.411764705882353
Control.SRR15539832;34;38;0.5;17;17;0;0.5
Control.SRR15539832;35;38;0.542857142857143;16;19;0.0428571428571428;0.457142857142857
Control.SRR15539832;34;38;0.823529411764706;6;28;0.323529411764706;0.176470588235294
Control.SRR15539832;33;38;0.636363636363636;12;21;0.136363636363636;0.363636363636364
Control.SRR15539832;31;38;0.419354838709677;18;13;0.0806451612903226;0.419354838709677
Control.SRR15539832;39;38;0.41025641025641;23;16;0.0897435897435898;0.41025641025641
Control.SRR15539832;29;38;0.448275862068966;16;13;0.0517241379310345;0.448275862068966
Control.SRR15539832;34;38;0.323529411764706;23;11;0.176470588235294;0.323529411764706
Control.SRR15539832;36;38;0.388888888888889;22;14;0.111111111111111;0.388888888888889
Control.SRR15539832;37;38;0.513513513513513;18;19;0.0135135135135135;0.486486486486487
Control.SRR15539832;34;38;0.529411764705882;16;18;0.0294117647058824;0.470588235294118
Control.SRR15539832;39;38;0.41025641025641;23;16;0.0897435897435898;0.41025641025641
Control.SRR15539832;31;38;0.483870967741935;16;15;0.0161290322580645;0.483870967741935
Control.SRR15539832;35;38;0.514285714285714;17;18;0.0142857142857142;0.485714285714286
Control.SRR15539832;38;38;0.578947368421053;16;22;0.0789473684210527;0.421052631578947
Control.SRR15539832;33;38;0.303030303030303;23;10;0.196969696969697;0.303030303030303
Control.SRR15539832;29;38;0.586206896551724;12;17;0.0862068965517241;0.413793103448276
Control.SRR15539832;32;38;0.34375;21;11;0.15625;0.34375
Control.SRR15539832;32;38;0.65625;11;21;0.15625;0.34375
Control.SRR15539832;33;38;0.454545454545455;18;15;0.0454545454545455;0.454545454545455
Control.SRR15539832;37;38;0.513513513513513;18;19;0.0135135135135135;0.486486486486487
Control.SRR15539832;35;38;0.371428571428571;22;13;0.128571428571429;0.371428571428571
Control.SRR15539832;33;38;0.575757575757576;14;19;0.0757575757575758;0.424242424242424
Control.SRR15539832;33;38;0.454545454545455;18;15;0.0454545454545455;0.454545454545455
Control.SRR15539832;38;38;0.631578947368421;14;24;0.131578947368421;0.368421052631579
Control.SRR15539832;35;38;0.342857142857143;23;12;0.157142857142857;0.342857142857143
Control.SRR15539832;39;38;0.41025641025641;23;16;0.0897435897435898;0.41025641025641
Control.SRR15539832;29;38;0.413793103448276;17;12;0.0862068965517241;0.413793103448276
Control.SRR15539832;29;38;0.379310344827586;18;11;0.120689655172414;0.379310344827586
Control.SRR15539832;33;38;0.545454545454545;15;18;0.0454545454545454;0.454545454545455
Control.SRR15539832;30;38;0.466666666666667;16;14;0.0333333333333333;0.466666666666667
Control.SRR15539832;35;38;0.457142857142857;19;16;0.0428571428571429;0.457142857142857
Control.SRR15539832;29;38;0.379310344827586;18;11;0.120689655172414;0.379310344827586
Control.SRR15539832;32;38;0.375;20;12;0.125;0.375
Control.SRR15539832;32;38;0.4375;18;14;0.0625;0.4375
Control.SRR15539832;33;38;0.424242424242424;19;14;0.0757575757575757;0.424242424242424
Control.SRR15539832;30;38;0.4;18;12;0.1;0.4
Control.SRR15539832;32;38;0.59375;13;19;0.09375;0.40625
Control.SRR15539832;30;38;0.433333333333333;17;13;0.0666666666666667;0.433333333333333
Control.SRR15539832;31;38;0.548387096774194;14;17;0.0483870967741935;0.451612903225806
Control.SRR15539832;36;38;0.444444444444444;20;16;0.0555555555555556;0.444444444444444
Control.SRR15539832;37;38;0.567567567567568;16;21;0.0675675675675675;0.432432432432432
Control.SRR15539832;37;38;0.513513513513513;18;19;0.0135135135135135;0.486486486486487
Control.SRR15539832;35;38;0.6;14;21;0.1;0.4
Control.SRR15539832;35;38;0.4;21;14;0.1;0.4
Control.SRR15539832;39;38;0.58974358974359;16;23;0.0897435897435898;0.41025641025641
Control.SRR15539832;37;38;0.432432432432432;21;16;0.0675675675675675;0.432432432432432
Control.SRR15539832;32;38;0.53125;15;17;0.03125;0.46875
Control.SRR15539832;32;38;0.625;12;20;0.125;0.375
Control.SRR15539832;36;38;0.555555555555556;16;20;0.0555555555555556;0.444444444444444
Control.SRR15539832;30;38;0.6;12;18;0.1;0.4
Control.SRR15539832;31;38;0.580645161290323;13;18;0.0806451612903226;0.419354838709677
Control.SRR15539832;33;38;0.515151515151515;16;17;0.0151515151515151;0.484848484848485
Control.SRR15539832;31;38;0.483870967741935;16;15;0.0161290322580645;0.483870967741935
Control.SRR15539832;37;38;0.675675675675676;12;25;0.175675675675676;0.324324324324324
Control.SRR15539832;35;38;0.485714285714286;18;17;0.0142857142857143;0.485714285714286
Control.SRR15539832;29;38;0.551724137931034;13;16;0.0517241379310345;0.448275862068966
Control.SRR15539832;38;38;0.447368421052632;21;17;0.0526315789473684;0.447368421052632
Control.SRR15539832;39;38;0.307692307692308;27;12;0.192307692307692;0.307692307692308
Control.SRR15539832;37;38;0.567567567567568;16;21;0.0675675675675675;0.432432432432432
Control.SRR15539832;34;38;0.441176470588235;19;15;0.0588235294117647;0.441176470588235
Control.SRR15539832;36;38;0.555555555555556;16;20;0.0555555555555556;0.444444444444444
Control.SRR15539832;37;38;0.567567567567568;16;21;0.0675675675675675;0.432432432432432
Control.SRR15539832;37;38;0.648648648648649;13;24;0.148648648648649;0.351351351351351
Control.SRR15539832;38;38;0.342105263157895;25;13;0.157894736842105;0.342105263157895
Control.SRR15539832;34;38;0.558823529411765;15;19;0.0588235294117647;0.441176470588235
Control.SRR15539832;38;38;0.552631578947368;17;21;0.0526315789473685;0.447368421052632
Control.SRR15539832;37;38;0.432432432432432;21;16;0.0675675675675675;0.432432432432432
Control.SRR15539832;35;38;0.4;21;14;0.1;0.4
Control.SRR15539832;39;38;0.641025641025641;14;25;0.141025641025641;0.358974358974359
Control.SRR15539832;39;38;0.564102564102564;17;22;0.0641025641025641;0.435897435897436
Control.SRR15539832;36;38;0.555555555555556;16;20;0.0555555555555556;0.444444444444444
Control.SRR15539832;33;38;0.454545454545455;18;15;0.0454545454545455;0.454545454545455
Control.SRR15539832;38;38;0.394736842105263;23;15;0.105263157894737;0.394736842105263
Control.SRR15539832;32;38;0.53125;15;17;0.03125;0.46875
Control.SRR15539832;32;38;0.40625;19;13;0.09375;0.40625
Control.SRR15539832;35;38;0.542857142857143;16;19;0.0428571428571428;0.457142857142857
Control.SRR15539832;30;38;0.433333333333333;17;13;0.0666666666666667;0.433333333333333
Control.SRR15539832;39;38;0.41025641025641;23;16;0.0897435897435898;0.41025641025641
Control.SRR15539832;36;38;0.527777777777778;17;19;0.0277777777777778;0.472222222222222
Control.SRR15539832;36;38;0.361111111111111;23;13;0.138888888888889;0.361111111111111
Control.SRR15539832;38;38;0.5;19;19;0;0.5
Control.SRR15539832;32;38;0.625;12;20;0.125;0.375
Control.SRR15539832;34;38;0.558823529411765;15;19;0.0588235294117647;0.441176470588235
Control.SRR15539832;31;38;0.580645161290323;13;18;0.0806451612903226;0.419354838709677
Control.SRR15539832;33;38;0.545454545454545;15;18;0.0454545454545454;0.454545454545455
Control.SRR15539832;30;38;0.6;12;18;0.1;0.4
Control.SRR15539832;32;38;0.46875;17;15;0.03125;0.46875
Control.SRR15539832;37;38;0.594594594594595;15;22;0.0945945945945946;0.405405405405405
Control.SRR15539832;32;38;0.65625;11;21;0.15625;0.34375
Control.SRR15539832;31;38;0.483870967741935;16;15;0.0161290322580645;0.483870967741935
Control.SRR15539832;31;38;0.483870967741935;16;15;0.0161290322580645;0.483870967741935
Control.SRR15539832;29;38;0.655172413793103;10;19;0.155172413793103;0.344827586206897
Control.SRR15539832;35;38;0.514285714285714;17;18;0.0142857142857142;0.485714285714286
Control.SRR15539832;32;38;0.375;20;12;0.125;0.375
Control.SRR15539832;32;38;0.59375;13;19;0.09375;0.40625
Control.SRR15539832;34;38;0.617647058823529;13;21;0.117647058823529;0.382352941176471
Control.SRR15539832;33;38;0.515151515151515;16;17;0.0151515151515151;0.484848484848485
Control.SRR15539832;32;38;0.59375;13;19;0.09375;0.40625
Control.SRR15539832;35;38;0.542857142857143;16;19;0.0428571428571428;0.457142857142857
Control.SRR15539832;31;38;0.483870967741935;16;15;0.0161290322580645;0.483870967741935
Control.SRR15539832;30;38;0.566666666666667;13;17;0.0666666666666667;0.433333333333333
Control.SRR15539832;29;38;0.620689655172414;11;18;0.120689655172414;0.379310344827586
Control.SRR15539832;35;38;0.4;21;14;0.1;0.4
Control.SRR15539832;36;38;0.444444444444444;20;16;0.0555555555555556;0.444444444444444
Control.SRR15539832;29;38;0.413793103448276;17;12;0.0862068965517241;0.413793103448276
Control.SRR15539832;35;38;0.485714285714286;18;17;0.0142857142857143;0.485714285714286
Control.SRR15539832;33;38;0.363636363636364;21;12;0.136363636363636;0.363636363636364
Control.SRR15539832;39;38;0.615384615384615;15;24;0.115384615384615;0.384615384615385
Control.SRR15539832;34;38;0.323529411764706;23;11;0.176470588235294;0.323529411764706
Control.SRR15539832;37;38;0.486486486486487;19;18;0.0135135135135135;0.486486486486487
Control.SRR15539832;35;38;0.457142857142857;19;16;0.0428571428571429;0.457142857142857
Control.SRR15539832;39;38;0.487179487179487;20;19;0.0128205128205128;0.487179487179487
Control.SRR15539832;36;38;0.638888888888889;13;23;0.138888888888889;0.361111111111111
Control.SRR15539832;38;38;0.578947368421053;16;22;0.0789473684210527;0.421052631578947
Control.SRR15539832;35;38;0.485714285714286;18;17;0.0142857142857143;0.485714285714286
Control.SRR15539832;36;38;0.444444444444444;20;16;0.0555555555555556;0.444444444444444
Control.SRR15539832;31;38;0.612903225806452;12;19;0.112903225806452;0.387096774193548
Control.SRR15539832;37;38;0.378378378378378;23;14;0.121621621621622;0.378378378378378
Control.SRR15539832;31;38;0.451612903225806;17;14;0.0483870967741936;0.451612903225806
Control.SRR15539832;30;38;0.5;15;15;0;0.5
Control.SRR15539832;34;38;0.294117647058824;24;10;0.205882352941176;0.294117647058824
Control.SRR15539832;29;38;0.448275862068966;16;13;0.0517241379310345;0.448275862068966
Control.SRR15539832;34;38;0.470588235294118;18;16;0.0294117647058824;0.470588235294118
Control.SRR15539832;35;38;0.457142857142857;19;16;0.0428571428571429;0.457142857142857
Control.SRR15539832;29;38;0.482758620689655;15;14;0.0172413793103448;0.482758620689655
Control.SRR15539832;33;38;0.545454545454545;15;18;0.0454545454545454;0.454545454545455
Control.SRR15539832;35;38;0.542857142857143;16;19;0.0428571428571428;0.457142857142857
Control.SRR15539832;37;38;0.432432432432432;21;16;0.0675675675675675;0.432432432432432
Control.SRR15539832;32;38;0.5;16;16;0;0.5
Control.SRR15539832;34;38;0.617647058823529;13;21;0.117647058823529;0.382352941176471
Control.SRR15539832;38;38;0.526315789473684;18;20;0.0263157894736842;0.473684210526316
Control.SRR15539832;31;38;0.451612903225806;17;14;0.0483870967741936;0.451612903225806
Control.SRR15539832;29;38;0.413793103448276;17;12;0.0862068965517241;0.413793103448276
Control.SRR15539832;29;38;0.655172413793103;10;19;0.155172413793103;0.344827586206897
Control.SRR15539832;39;38;0.538461538461538;18;21;0.0384615384615384;0.461538461538462
Control.SRR15539832;37;38;0.351351351351351;24;13;0.148648648648649;0.351351351351351
Control.SRR15539832;37;38;0.567567567567568;16;21;0.0675675675675675;0.432432432432432
Control.SRR15539832;30;38;0.433333333333333;17;13;0.0666666666666667;0.433333333333333
Control.SRR15539832;37;38;0.567567567567568;16;21;0.0675675675675675;0.432432432432432
Control.SRR15539832;38;38;0.447368421052632;21;17;0.0526315789473684;0.447368421052632
Control.SRR15539832;37;38;0.567567567567568;16;21;0.0675675675675675;0.432432432432432
Control.SRR15539832;34;38;0.588235294117647;14;20;0.0882352941176471;0.411764705882353
Control.SRR15539832;35;38;0.485714285714286;18;17;0.0142857142857143;0.485714285714286
Control.SRR15539832;33;38;0.545454545454545;15;18;0.0454545454545454;0.454545454545455
Control.SRR15539832;30;38;0.566666666666667;13;17;0.0666666666666667;0.433333333333333
Control.SRR15539832;36;38;0.611111111111111;14;22;0.111111111111111;0.388888888888889
Control.SRR15539832;38;38;0.578947368421053;16;22;0.0789473684210527;0.421052631578947
Control.SRR15539832;34;38;0.588235294117647;14;20;0.0882352941176471;0.411764705882353
Control.SRR15539832;34;38;0.441176470588235;19;15;0.0588235294117647;0.441176470588235
Control.SRR15539832;37;38;0.513513513513513;18;19;0.0135135135135135;0.486486486486487
Control.SRR15539832;39;38;0.41025641025641;23;16;0.0897435897435898;0.41025641025641
Control.SRR15539832;39;38;0.333333333333333;26;13;0.166666666666667;0.333333333333333
Control.SRR15539832;38;38;0.605263157894737;15;23;0.105263157894737;0.394736842105263
Control.SRR15539832;35;38;0.428571428571429;20;15;0.0714285714285715;0.428571428571429
Control.SRR15539832;32;38;0.625;12;20;0.125;0.375
Control.SRR15539832;30;38;0.466666666666667;16;14;0.0333333333333333;0.466666666666667
Control.SRR15539832;31;38;0.451612903225806;17;14;0.0483870967741936;0.451612903225806
Control.SRR15539832;39;38;0.461538461538462;21;18;0.0384615384615384;0.461538461538462
Control.SRR15539832;39;38;0.461538461538462;21;18;0.0384615384615384;0.461538461538462
Control.SRR15539832;35;38;0.571428571428571;15;20;0.0714285714285714;0.428571428571429
Control.SRR15539832;32;38;0.53125;15;17;0.03125;0.46875
Control.SRR15539832;32;38;0.4375;18;14;0.0625;0.4375
Control.SRR15539832;31;38;0.419354838709677;18;13;0.0806451612903226;0.419354838709677
Control.SRR15539832;33;38;0.545454545454545;15;18;0.0454545454545454;0.454545454545455
Control.SRR15539832;37;38;0.351351351351351;24;13;0.148648648648649;0.351351351351351
Control.SRR15539832;32;38;0.4375;18;14;0.0625;0.4375
Control.SRR15539832;33;38;0.363636363636364;21;12;0.136363636363636;0.363636363636364
Control.SRR15539832;31;38;0.354838709677419;20;11;0.145161290322581;0.354838709677419
Control.SRR15539832;39;38;0.41025641025641;23;16;0.0897435897435898;0.41025641025641
Control.SRR15539832;31;38;0.709677419354839;9;22;0.209677419354839;0.290322580645161
Control.SRR15539832;30;38;0.433333333333333;17;13;0.0666666666666667;0.433333333333333
Control.SRR15539832;35;38;0.685714285714286;11;24;0.185714285714286;0.314285714285714
Control.SRR15539832;29;38;0.448275862068966;16;13;0.0517241379310345;0.448275862068966
Control.SRR15539832;38;38;0.552631578947368;17;21;0.0526315789473685;0.447368421052632
Control.SRR15539832;38;38;0.631578947368421;14;24;0.131578947368421;0.368421052631579
Control.SRR15539832;32;38;0.53125;15;17;0.03125;0.46875
Control.SRR15539832;29;38;0.517241379310345;14;15;0.0172413793103449;0.482758620689655
Control.SRR15539832;31;38;0.451612903225806;17;14;0.0483870967741936;0.451612903225806
Control.SRR15539832;29;38;0.379310344827586;18;11;0.120689655172414;0.379310344827586
Control.SRR15539832;37;38;0.405405405405405;22;15;0.0945945945945946;0.405405405405405
Control.SRR15539832;34;38;0.529411764705882;16;18;0.0294117647058824;0.470588235294118
Control.SRR15539832;39;38;0.564102564102564;17;22;0.0641025641025641;0.435897435897436
Control.SRR15539832;36;38;0.555555555555556;16;20;0.0555555555555556;0.444444444444444
Control.SRR15539832;35;38;0.542857142857143;16;19;0.0428571428571428;0.457142857142857
Control.SRR15539832;33;38;0.545454545454545;15;18;0.0454545454545454;0.454545454545455
Control.SRR15539832;31;38;0.580645161290323;13;18;0.0806451612903226;0.419354838709677
Control.SRR15539832;32;38;0.40625;19;13;0.09375;0.40625
Control.SRR15539832;35;38;0.342857142857143;23;12;0.157142857142857;0.342857142857143
Control.SRR15539832;39;38;0.461538461538462;21;18;0.0384615384615384;0.461538461538462
Control.SRR15539832;37;38;0.594594594594595;15;22;0.0945945945945946;0.405405405405405
Control.SRR15539832;35;38;0.314285714285714;24;11;0.185714285714286;0.314285714285714
Control.SRR15539832;30;38;0.6;12;18;0.1;0.4
Control.SRR15539832;32;38;0.5;16;16;0;0.5
Control.SRR15539832;29;38;0.379310344827586;18;11;0.120689655172414;0.379310344827586
Control.SRR15539832;33;38;0.545454545454545;15;18;0.0454545454545454;0.454545454545455
Control.SRR15539832;39;38;0.58974358974359;16;23;0.0897435897435898;0.41025641025641
Control.SRR15539832;31;38;0.516129032258065;15;16;0.0161290322580645;0.483870967741935
Control.SRR15539832;29;38;0.517241379310345;14;15;0.0172413793103449;0.482758620689655
Control.SRR15539832;37;38;0.459459459459459;20;17;0.0405405405405405;0.459459459459459
Control.SRR15539832;34;38;0.588235294117647;14;20;0.0882352941176471;0.411764705882353
Control.SRR15539832;29;38;0.344827586206897;19;10;0.155172413793103;0.344827586206897
Control.SRR15539832;34;38;0.529411764705882;16;18;0.0294117647058824;0.470588235294118
Control.SRR15539832;39;38;0.41025641025641;23;16;0.0897435897435898;0.41025641025641
Control.SRR15539832;38;38;0.473684210526316;20;18;0.0263157894736842;0.473684210526316
Control.SRR15539832;35;38;0.542857142857143;16;19;0.0428571428571428;0.457142857142857
Control.SRR15539832;38;38;0.578947368421053;16;22;0.0789473684210527;0.421052631578947
Control.SRR15539832;38;38;0.447368421052632;21;17;0.0526315789473684;0.447368421052632
Control.SRR15539832;32;38;0.5625;14;18;0.0625;0.4375
Control.SRR15539832;30;38;0.433333333333333;17;13;0.0666666666666667;0.433333333333333
Control.SRR15539832;37;38;0.513513513513513;18;19;0.0135135135135135;0.486486486486487
Control.SRR15539832;31;38;0.451612903225806;17;14;0.0483870967741936;0.451612903225806
Control.SRR15539832;36;38;0.583333333333333;15;21;0.0833333333333334;0.416666666666667
Control.SRR15539832;38;38;0.473684210526316;20;18;0.0263157894736842;0.473684210526316
Control.SRR15539832;30;38;0.5;15;15;0;0.5
Control.SRR15539832;29;38;0.586206896551724;12;17;0.0862068965517241;0.413793103448276
Control.SRR15539832;31;38;0.483870967741935;16;15;0.0161290322580645;0.483870967741935
Control.SRR15539832;29;38;0.620689655172414;11;18;0.120689655172414;0.379310344827586
Control.SRR15539832;30;38;0.4;18;12;0.1;0.4
Control.SRR15539832;31;38;0.516129032258065;15;16;0.0161290322580645;0.483870967741935
Control.SRR15539832;29;38;0.517241379310345;14;15;0.0172413793103449;0.482758620689655
Control.SRR15539832;35;38;0.571428571428571;15;20;0.0714285714285714;0.428571428571429
Control.SRR15539832;32;38;0.5;16;16;0;0.5
Control.SRR15539832;32;38;0.5625;14;18;0.0625;0.4375
Control.SRR15539832;35;38;0.542857142857143;16;19;0.0428571428571428;0.457142857142857
Control.SRR15539832;33;38;0.515151515151515;16;17;0.0151515151515151;0.484848484848485
Control.SRR15539832;35;38;0.428571428571429;20;15;0.0714285714285715;0.428571428571429
Control.SRR15539832;38;38;0.605263157894737;15;23;0.105263157894737;0.394736842105263
Control.SRR15539832;37;38;0.513513513513513;18;19;0.0135135135135135;0.486486486486487
Control.SRR15539832;36;38;0.333333333333333;24;12;0.166666666666667;0.333333333333333
Control.SRR15539832;37;38;0.459459459459459;20;17;0.0405405405405405;0.459459459459459
Control.SRR15539832;29;38;0.413793103448276;17;12;0.0862068965517241;0.413793103448276
Control.SRR15539832;32;38;0.53125;15;17;0.03125;0.46875
Control.SRR15539832;32;38;0.59375;13;19;0.09375;0.40625
Control.SRR15539832;33;38;0.606060606060606;13;20;0.106060606060606;0.393939393939394
Control.SRR15539832;33;38;0.515151515151515;16;17;0.0151515151515151;0.484848484848485
Control.SRR15539832;30;38;0.666666666666667;10;20;0.166666666666667;0.333333333333333
Control.SRR15539832;32;38;0.5;16;16;0;0.5
Control.SRR15539832;36;38;0.555555555555556;16;20;0.0555555555555556;0.444444444444444
Control.SRR15539832;37;38;0.540540540540541;17;20;0.0405405405405406;0.459459459459459
Control.SRR15539832;34;38;0.470588235294118;18;16;0.0294117647058824;0.470588235294118
Control.SRR15539832;35;38;0.514285714285714;17;18;0.0142857142857142;0.485714285714286
Control.SRR15539832;32;38;0.46875;17;15;0.03125;0.46875
Control.SRR15539832;39;38;0.58974358974359;16;23;0.0897435897435898;0.41025641025641
Control.SRR15539832;36;38;0.444444444444444;20;16;0.0555555555555556;0.444444444444444
Control.SRR15539832;31;38;0.451612903225806;17;14;0.0483870967741936;0.451612903225806
Control.SRR15539832;34;38;0.647058823529412;12;22;0.147058823529412;0.352941176470588
Control.SRR15539832;29;38;0.551724137931034;13;16;0.0517241379310345;0.448275862068966
Control.SRR15539832;39;38;0.41025641025641;23;16;0.0897435897435898;0.41025641025641
Control.SRR15539832;39;38;0.487179487179487;20;19;0.0128205128205128;0.487179487179487
Control.SRR15539832;33;38;0.606060606060606;13;20;0.106060606060606;0.393939393939394
Control.SRR15539832;36;38;0.444444444444444;20;16;0.0555555555555556;0.444444444444444
Control.SRR15539832;32;38;0.4375;18;14;0.0625;0.4375
Control.SRR15539832;36;38;0.527777777777778;17;19;0.0277777777777778;0.472222222222222
Control.SRR15539832;39;38;0.41025641025641;23;16;0.0897435897435898;0.41025641025641
Control.SRR15539832;37;38;0.459459459459459;20;17;0.0405405405405405;0.459459459459459
Control.SRR15539832;35;38;0.428571428571429;20;15;0.0714285714285715;0.428571428571429
Control.SRR15539832;37;38;0.648648648648649;13;24;0.148648648648649;0.351351351351351
Control.SRR15539832;36;38;0.5;18;18;0;0.5
Control.SRR15539832;37;38;0.432432432432432;21;16;0.0675675675675675;0.432432432432432
Control.SRR15539832;36;38;0.527777777777778;17;19;0.0277777777777778;0.472222222222222
Control.SRR15539832;31;38;0.516129032258065;15;16;0.0161290322580645;0.483870967741935
Control.SRR15539832;33;38;0.575757575757576;14;19;0.0757575757575758;0.424242424242424
Control.SRR15539832;37;38;0.513513513513513;18;19;0.0135135135135135;0.486486486486487
Control.SRR15539832;36;38;0.472222222222222;19;17;0.0277777777777778;0.472222222222222
Control.SRR15539832;31;38;0.516129032258065;15;16;0.0161290322580645;0.483870967741935
Control.SRR15539832;34;38;0.411764705882353;20;14;0.0882352941176471;0.411764705882353
Control.SRR15539832;29;38;0.517241379310345;14;15;0.0172413793103449;0.482758620689655
Control.SRR15539832;38;38;0.473684210526316;20;18;0.0263157894736842;0.473684210526316
Control.SRR15539832;34;38;0.441176470588235;19;15;0.0588235294117647;0.441176470588235
Control.SRR15539832;39;38;0.384615384615385;24;15;0.115384615384615;0.384615384615385
Control.SRR15539832;33;38;0.424242424242424;19;14;0.0757575757575757;0.424242424242424
Control.SRR15539832;33;38;0.545454545454545;15;18;0.0454545454545454;0.454545454545455
Control.SRR15539832;33;38;0.454545454545455;18;15;0.0454545454545455;0.454545454545455
Control.SRR15539832;38;38;0.526315789473684;18;20;0.0263157894736842;0.473684210526316
Control.SRR15539832;38;38;0.5;19;19;0;0.5
Control.SRR15539832;39;38;0.538461538461538;18;21;0.0384615384615384;0.461538461538462
Control.SRR15539832;38;38;0.447368421052632;21;17;0.0526315789473684;0.447368421052632
Control.SRR15539832;33;38;0.484848484848485;17;16;0.0151515151515151;0.484848484848485
Control.SRR15539832;38;38;0.631578947368421;14;24;0.131578947368421;0.368421052631579
Control.SRR15539832;33;38;0.454545454545455;18;15;0.0454545454545455;0.454545454545455
Control.SRR15539832;38;38;0.5;19;19;0;0.5
Control.SRR15539832;33;38;0.515151515151515;16;17;0.0151515151515151;0.484848484848485
Control.SRR15539832;36;38;0.388888888888889;22;14;0.111111111111111;0.388888888888889
Control.SRR15539832;36;38;0.5;18;18;0;0.5
Control.SRR15539832;35;38;0.457142857142857;19;16;0.0428571428571429;0.457142857142857
Control.SRR15539832;34;38;0.617647058823529;13;21;0.117647058823529;0.382352941176471
Control.SRR15539832;31;38;0.419354838709677;18;13;0.0806451612903226;0.419354838709677
Control.SRR15539832;29;38;0.482758620689655;15;14;0.0172413793103448;0.482758620689655
Control.SRR15539832;33;38;0.454545454545455;18;15;0.0454545454545455;0.454545454545455
Control.SRR15539832;30;38;0.466666666666667;16;14;0.0333333333333333;0.466666666666667
Control.SRR15539832;36;38;0.5;18;18;0;0.5
Control.SRR15539832;37;38;0.540540540540541;17;20;0.0405405405405406;0.459459459459459
Control.SRR15539832;37;38;0.459459459459459;20;17;0.0405405405405405;0.459459459459459
Control.SRR15539832;37;38;0.432432432432432;21;16;0.0675675675675675;0.432432432432432
Control.SRR15539832;32;38;0.375;20;12;0.125;0.375
Control.SRR15539832;31;38;0.32258064516129;21;10;0.17741935483871;0.32258064516129
Control.SRR15539832;35;38;0.485714285714286;18;17;0.0142857142857143;0.485714285714286
Control.SRR15539832;36;38;0.416666666666667;21;15;0.0833333333333333;0.416666666666667
Control.SRR15539832;37;38;0.540540540540541;17;20;0.0405405405405406;0.459459459459459
Control.SRR15539832;34;38;0.441176470588235;19;15;0.0588235294117647;0.441176470588235
Control.SRR15539832;35;38;0.457142857142857;19;16;0.0428571428571429;0.457142857142857
Control.SRR15539832;30;38;0.566666666666667;13;17;0.0666666666666667;0.433333333333333
Control.SRR15539832;33;38;0.454545454545455;18;15;0.0454545454545455;0.454545454545455
Control.SRR15539832;29;38;0.482758620689655;15;14;0.0172413793103448;0.482758620689655
Control.SRR15539832;35;38;0.428571428571429;20;15;0.0714285714285715;0.428571428571429
Control.SRR15539832;29;38;0.448275862068966;16;13;0.0517241379310345;0.448275862068966
Control.SRR15539832;35;38;0.457142857142857;19;16;0.0428571428571429;0.457142857142857
Control.SRR15539832;39;38;0.641025641025641;14;25;0.141025641025641;0.358974358974359
Control.SRR15539832;35;38;0.371428571428571;22;13;0.128571428571429;0.371428571428571
Control.SRR15539832;34;38;0.382352941176471;21;13;0.117647058823529;0.382352941176471
Control.SRR15539832;33;38;0.454545454545455;18;15;0.0454545454545455;0.454545454545455
Control.SRR15539832;34;38;0.735294117647059;9;25;0.235294117647059;0.264705882352941
Control.SRR15539832;33;38;0.606060606060606;13;20;0.106060606060606;0.393939393939394
Control.SRR15539832;31;38;0.548387096774194;14;17;0.0483870967741935;0.451612903225806
Control.SRR15539832;31;38;0.645161290322581;11;20;0.145161290322581;0.354838709677419
Control.SRR15539832;32;38;0.375;20;12;0.125;0.375
Control.SRR15539832;30;38;0.533333333333333;14;16;0.0333333333333333;0.466666666666667
Control.SRR15539832;34;38;0.529411764705882;16;18;0.0294117647058824;0.470588235294118
Control.SRR15539832;33;38;0.424242424242424;19;14;0.0757575757575757;0.424242424242424
Control.SRR15539832;31;38;0.580645161290323;13;18;0.0806451612903226;0.419354838709677
Control.SRR15539832;31;38;0.516129032258065;15;16;0.0161290322580645;0.483870967741935
Control.SRR15539832;29;38;0.551724137931034;13;16;0.0517241379310345;0.448275862068966
Control.SRR15539832;37;38;0.459459459459459;20;17;0.0405405405405405;0.459459459459459
Control.SRR15539832;36;38;0.5;18;18;0;0.5
Control.SRR15539832;34;38;0.529411764705882;16;18;0.0294117647058824;0.470588235294118
Control.SRR15539832;32;38;0.40625;19;13;0.09375;0.40625
Control.SRR15539832;33;38;0.515151515151515;16;17;0.0151515151515151;0.484848484848485
Control.SRR15539832;30;38;0.5;15;15;0;0.5
Control.SRR15539832;32;38;0.5;16;16;0;0.5
Control.SRR15539832;33;38;0.515151515151515;16;17;0.0151515151515151;0.484848484848485
Control.SRR15539832;37;38;0.567567567567568;16;21;0.0675675675675675;0.432432432432432
Control.SRR15539832;34;38;0.411764705882353;20;14;0.0882352941176471;0.411764705882353
Control.SRR15539832;35;38;0.485714285714286;18;17;0.0142857142857143;0.485714285714286
Control.SRR15539832;33;38;0.484848484848485;17;16;0.0151515151515151;0.484848484848485
Control.SRR15539832;31;38;0.548387096774194;14;17;0.0483870967741935;0.451612903225806
Control.SRR15539832;39;38;0.461538461538462;21;18;0.0384615384615384;0.461538461538462
Control.SRR15539832;36;38;0.583333333333333;15;21;0.0833333333333334;0.416666666666667
Control.SRR15539832;32;38;0.59375;13;19;0.09375;0.40625
Control.SRR15539832;36;38;0.472222222222222;19;17;0.0277777777777778;0.472222222222222
Control.SRR15539832;37;38;0.486486486486487;19;18;0.0135135135135135;0.486486486486487
Control.SRR15539832;38;38;0.5;19;19;0;0.5
Control.SRR15539832;30;38;0.5;15;15;0;0.5
Control.SRR15539832;34;38;0.558823529411765;15;19;0.0588235294117647;0.441176470588235
Control.SRR15539832;35;38;0.4;21;14;0.1;0.4
Control.SRR15539832;29;38;0.413793103448276;17;12;0.0862068965517241;0.413793103448276
Control.SRR15539832;29;38;0.517241379310345;14;15;0.0172413793103449;0.482758620689655
Control.SRR15539832;31;38;0.580645161290323;13;18;0.0806451612903226;0.419354838709677
Control.SRR15539832;30;38;0.533333333333333;14;16;0.0333333333333333;0.466666666666667
Control.SRR15539832;31;38;0.580645161290323;13;18;0.0806451612903226;0.419354838709677
Control.SRR15539832;37;38;0.594594594594595;15;22;0.0945945945945946;0.405405405405405
Control.SRR15539832;36;38;0.5;18;18;0;0.5
Control.SRR15539832;38;38;0.552631578947368;17;21;0.0526315789473685;0.447368421052632
Control.SRR15539832;34;38;0.470588235294118;18;16;0.0294117647058824;0.470588235294118
Control.SRR15539832;38;38;0.552631578947368;17;21;0.0526315789473685;0.447368421052632
Control.SRR15539832;37;38;0.459459459459459;20;17;0.0405405405405405;0.459459459459459
Control.SRR15539832;35;38;0.457142857142857;19;16;0.0428571428571429;0.457142857142857
Control.SRR15539832;37;38;0.432432432432432;21;16;0.0675675675675675;0.432432432432432
Control.SRR15539832;38;38;0.447368421052632;21;17;0.0526315789473684;0.447368421052632
Control.SRR15539832;31;38;0.451612903225806;17;14;0.0483870967741936;0.451612903225806
Control.SRR15539832;32;38;0.53125;15;17;0.03125;0.46875
Control.SRR15539832;33;38;0.484848484848485;17;16;0.0151515151515151;0.484848484848485
Control.SRR15539832;35;38;0.571428571428571;15;20;0.0714285714285714;0.428571428571429
Control.SRR15539832;38;38;0.578947368421053;16;22;0.0789473684210527;0.421052631578947
Control.SRR15539832;39;38;0.487179487179487;20;19;0.0128205128205128;0.487179487179487
Control.SRR15539832;37;38;0.594594594594595;15;22;0.0945945945945946;0.405405405405405
Control.SRR15539832;34;38;0.470588235294118;18;16;0.0294117647058824;0.470588235294118
Control.SRR15539832;32;38;0.46875;17;15;0.03125;0.46875
Control.SRR15539832;29;38;0.655172413793103;10;19;0.155172413793103;0.344827586206897
Control.SRR15539832;38;38;0.552631578947368;17;21;0.0526315789473685;0.447368421052632
Control.SRR15539832;30;38;0.533333333333333;14;16;0.0333333333333333;0.466666666666667
Control.SRR15539832;31;38;0.516129032258065;15;16;0.0161290322580645;0.483870967741935
Control.SRR15539832;39;38;0.461538461538462;21;18;0.0384615384615384;0.461538461538462
Control.SRR15539832;32;38;0.4375;18;14;0.0625;0.4375
Control.SRR15539832;33;38;0.363636363636364;21;12;0.136363636363636;0.363636363636364
Control.SRR15539832;39;38;0.384615384615385;24;15;0.115384615384615;0.384615384615385
Control.SRR15539832;38;38;0.605263157894737;15;23;0.105263157894737;0.394736842105263
Control.SRR15539832;38;38;0.552631578947368;17;21;0.0526315789473685;0.447368421052632
Control.SRR15539832;36;38;0.5;18;18;0;0.5
Control.SRR15539832;29;38;0.482758620689655;15;14;0.0172413793103448;0.482758620689655
Control.SRR15539832;34;38;0.441176470588235;19;15;0.0588235294117647;0.441176470588235
Control.SRR15539832;37;38;0.540540540540541;17;20;0.0405405405405406;0.459459459459459
Control.SRR15539832;29;38;0.586206896551724;12;17;0.0862068965517241;0.413793103448276
Control.SRR15539832;38;38;0.447368421052632;21;17;0.0526315789473684;0.447368421052632
Control.SRR15539832;29;38;0.517241379310345;14;15;0.0172413793103449;0.482758620689655
Control.SRR15539832;35;38;0.6;14;21;0.1;0.4
Control.SRR15539832;29;38;0.551724137931034;13;16;0.0517241379310345;0.448275862068966
Control.SRR15539832;35;38;0.514285714285714;17;18;0.0142857142857142;0.485714285714286
Control.SRR15539832;33;38;0.636363636363636;12;21;0.136363636363636;0.363636363636364
Control.SRR15539832;29;38;0.344827586206897;19;10;0.155172413793103;0.344827586206897
Control.SRR15539832;29;38;0.413793103448276;17;12;0.0862068965517241;0.413793103448276
Control.SRR15539832;33;38;0.545454545454545;15;18;0.0454545454545454;0.454545454545455
Control.SRR15539832;30;38;0.566666666666667;13;17;0.0666666666666667;0.433333333333333
Control.SRR15539832;33;38;0.454545454545455;18;15;0.0454545454545455;0.454545454545455
Control.SRR15539832;34;38;0.5;17;17;0;0.5
Control.SRR15539832;31;38;0.548387096774194;14;17;0.0483870967741935;0.451612903225806
Control.SRR15539832;33;38;0.515151515151515;16;17;0.0151515151515151;0.484848484848485
Control.SRR15539832;31;38;0.483870967741935;16;15;0.0161290322580645;0.483870967741935
Control.SRR15539832;36;38;0.638888888888889;13;23;0.138888888888889;0.361111111111111
Control.SRR15539832;30;38;0.433333333333333;17;13;0.0666666666666667;0.433333333333333
Control.SRR15539832;31;38;0.580645161290323;13;18;0.0806451612903226;0.419354838709677
Control.SRR15539832;34;38;0.529411764705882;16;18;0.0294117647058824;0.470588235294118
Control.SRR15539832;39;38;0.435897435897436;22;17;0.0641025641025641;0.435897435897436
Control.SRR15539832;29;38;0.551724137931034;13;16;0.0517241379310345;0.448275862068966
Control.SRR15539832;32;38;0.375;20;12;0.125;0.375
Control.SRR15539832;29;38;0.517241379310345;14;15;0.0172413793103449;0.482758620689655
Control.SRR15539832;35;38;0.457142857142857;19;16;0.0428571428571429;0.457142857142857
Control.SRR15539832;31;38;0.516129032258065;15;16;0.0161290322580645;0.483870967741935
Control.SRR15539832;39;38;0.564102564102564;17;22;0.0641025641025641;0.435897435897436
Control.SRR15539832;32;38;0.5625;14;18;0.0625;0.4375
Control.SRR15539832;30;38;0.5;15;15;0;0.5
Control.SRR15539832;34;38;0.411764705882353;20;14;0.0882352941176471;0.411764705882353
Control.SRR15539832;31;38;0.548387096774194;14;17;0.0483870967741935;0.451612903225806
Control.SRR15539832;36;38;0.416666666666667;21;15;0.0833333333333333;0.416666666666667
Control.SRR15539832;32;38;0.5625;14;18;0.0625;0.4375
Control.SRR15539832;32;38;0.40625;19;13;0.09375;0.40625
Control.SRR15539832;37;38;0.405405405405405;22;15;0.0945945945945946;0.405405405405405
Control.SRR15539832;39;38;0.384615384615385;24;15;0.115384615384615;0.384615384615385
Control.SRR15539832;36;38;0.472222222222222;19;17;0.0277777777777778;0.472222222222222
Control.SRR15539832;35;38;0.485714285714286;18;17;0.0142857142857143;0.485714285714286
Control.SRR15539832;33;38;0.393939393939394;20;13;0.106060606060606;0.393939393939394
Control.SRR15539832;35;38;0.457142857142857;19;16;0.0428571428571429;0.457142857142857
Control.SRR15539832;35;38;0.542857142857143;16;19;0.0428571428571428;0.457142857142857
Control.SRR15539832;29;38;0.379310344827586;18;11;0.120689655172414;0.379310344827586
Control.SRR15539832;33;38;0.484848484848485;17;16;0.0151515151515151;0.484848484848485
Control.SRR15539832;37;38;0.567567567567568;16;21;0.0675675675675675;0.432432432432432
Control.SRR15539832;36;38;0.388888888888889;22;14;0.111111111111111;0.388888888888889
Control.SRR15539832;32;38;0.59375;13;19;0.09375;0.40625
Control.SRR15539832;31;38;0.612903225806452;12;19;0.112903225806452;0.387096774193548
Control.SRR15539832;34;38;0.588235294117647;14;20;0.0882352941176471;0.411764705882353
Control.SRR15539832;38;38;0.421052631578947;22;16;0.0789473684210527;0.421052631578947
Control.SRR15539832;39;38;0.461538461538462;21;18;0.0384615384615384;0.461538461538462
Control.SRR15539832;30;38;0.566666666666667;13;17;0.0666666666666667;0.433333333333333
Control.SRR15539832;31;38;0.548387096774194;14;17;0.0483870967741935;0.451612903225806
Control.SRR15539832;34;38;0.647058823529412;12;22;0.147058823529412;0.352941176470588
Control.SRR15539832;39;38;0.564102564102564;17;22;0.0641025641025641;0.435897435897436
Control.SRR15539832;36;38;0.444444444444444;20;16;0.0555555555555556;0.444444444444444
Control.SRR15539832;37;38;0.513513513513513;18;19;0.0135135135135135;0.486486486486487
Control.SRR15539832;34;38;0.470588235294118;18;16;0.0294117647058824;0.470588235294118
Control.SRR15539832;29;38;0.344827586206897;19;10;0.155172413793103;0.344827586206897
Control.SRR15539832;33;38;0.454545454545455;18;15;0.0454545454545455;0.454545454545455
Control.SRR15539832;29;38;0.517241379310345;14;15;0.0172413793103449;0.482758620689655
Control.SRR15539832;29;38;0.413793103448276;17;12;0.0862068965517241;0.413793103448276
Control.SRR15539832;39;38;0.666666666666667;13;26;0.166666666666667;0.333333333333333
Control.SRR15539832;30;38;0.4;18;12;0.1;0.4
Control.SRR15539832;33;38;0.575757575757576;14;19;0.0757575757575758;0.424242424242424
Control.SRR15539832;35;38;0.571428571428571;15;20;0.0714285714285714;0.428571428571429
Control.SRR15539832;37;38;0.567567567567568;16;21;0.0675675675675675;0.432432432432432
Control.SRR15539832;37;38;0.459459459459459;20;17;0.0405405405405405;0.459459459459459
Control.SRR15539832;37;38;0.513513513513513;18;19;0.0135135135135135;0.486486486486487
Control.SRR15539832;33;38;0.515151515151515;16;17;0.0151515151515151;0.484848484848485
Control.SRR15539832;37;38;0.648648648648649;13;24;0.148648648648649;0.351351351351351
Control.SRR15539832;29;38;0.517241379310345;14;15;0.0172413793103449;0.482758620689655
Control.SRR15539832;30;38;0.5;15;15;0;0.5
Control.SRR15539832;39;38;0.564102564102564;17;22;0.0641025641025641;0.435897435897436
Control.SRR15539832;34;38;0.441176470588235;19;15;0.0588235294117647;0.441176470588235
Control.SRR15539832;29;38;0.482758620689655;15;14;0.0172413793103448;0.482758620689655
Control.SRR15539832;37;38;0.405405405405405;22;15;0.0945945945945946;0.405405405405405
Control.SRR15539832;36;38;0.5;18;18;0;0.5
Control.SRR15539832;30;38;0.333333333333333;20;10;0.166666666666667;0.333333333333333
Control.SRR15539832;38;38;0.421052631578947;22;16;0.0789473684210527;0.421052631578947
Control.SRR15539832;36;38;0.388888888888889;22;14;0.111111111111111;0.388888888888889
Control.SRR15539832;34;38;0.441176470588235;19;15;0.0588235294117647;0.441176470588235
Control.SRR15539832;39;38;0.461538461538462;21;18;0.0384615384615384;0.461538461538462
Control.SRR15539832;35;38;0.371428571428571;22;13;0.128571428571429;0.371428571428571
Control.SRR15539832;33;38;0.575757575757576;14;19;0.0757575757575758;0.424242424242424
Control.SRR15539832;38;38;0.552631578947368;17;21;0.0526315789473685;0.447368421052632
Control.SRR15539832;37;38;0.459459459459459;20;17;0.0405405405405405;0.459459459459459
Control.SRR15539832;30;38;0.466666666666667;16;14;0.0333333333333333;0.466666666666667
Control.SRR15539832;30;38;0.333333333333333;20;10;0.166666666666667;0.333333333333333
Control.SRR15539832;33;38;0.393939393939394;20;13;0.106060606060606;0.393939393939394
Control.SRR15539832;35;38;0.4;21;14;0.1;0.4
Control.SRR15539832;35;38;0.542857142857143;16;19;0.0428571428571428;0.457142857142857
Control.SRR15539832;33;38;0.484848484848485;17;16;0.0151515151515151;0.484848484848485
Control.SRR15539832;32;38;0.65625;11;21;0.15625;0.34375
Control.SRR15539832;31;38;0.451612903225806;17;14;0.0483870967741936;0.451612903225806
Control.SRR15539832;33;38;0.606060606060606;13;20;0.106060606060606;0.393939393939394
Control.SRR15539832;36;38;0.527777777777778;17;19;0.0277777777777778;0.472222222222222
Control.SRR15539832;32;38;0.625;12;20;0.125;0.375
Control.SRR15539832;30;38;0.5;15;15;0;0.5
Control.SRR15539832;32;38;0.4375;18;14;0.0625;0.4375
Control.SRR15539832;33;38;0.363636363636364;21;12;0.136363636363636;0.363636363636364
Control.SRR15539832;30;38;0.466666666666667;16;14;0.0333333333333333;0.466666666666667
Control.SRR15539832;35;38;0.685714285714286;11;24;0.185714285714286;0.314285714285714
Control.SRR15539832;30;38;0.466666666666667;16;14;0.0333333333333333;0.466666666666667
Control.SRR15539832;31;38;0.387096774193548;19;12;0.112903225806452;0.387096774193548
Control.SRR15539832;32;38;0.375;20;12;0.125;0.375
Control.SRR15539832;29;38;0.586206896551724;12;17;0.0862068965517241;0.413793103448276
Control.SRR15539832;30;38;0.466666666666667;16;14;0.0333333333333333;0.466666666666667
Control.SRR15539832;35;38;0.542857142857143;16;19;0.0428571428571428;0.457142857142857
Control.SRR15539832;38;38;0.578947368421053;16;22;0.0789473684210527;0.421052631578947
Control.SRR15539832;30;38;0.566666666666667;13;17;0.0666666666666667;0.433333333333333
Control.SRR15539832;33;38;0.484848484848485;17;16;0.0151515151515151;0.484848484848485
Control.SRR15539832;32;38;0.5625;14;18;0.0625;0.4375
Control.SRR15539832;34;38;0.5;17;17;0;0.5
Control.SRR15539832;37;38;0.594594594594595;15;22;0.0945945945945946;0.405405405405405
Control.SRR15539832;39;38;0.384615384615385;24;15;0.115384615384615;0.384615384615385
Control.SRR15539832;36;38;0.527777777777778;17;19;0.0277777777777778;0.472222222222222
Control.SRR15539832;32;38;0.65625;11;21;0.15625;0.34375
Control.SRR15539832;35;38;0.571428571428571;15;20;0.0714285714285714;0.428571428571429
Control.SRR15539832;33;38;0.454545454545455;18;15;0.0454545454545455;0.454545454545455
Control.SRR15539832;39;38;0.461538461538462;21;18;0.0384615384615384;0.461538461538462
Control.SRR15539832;30;38;0.6;12;18;0.1;0.4
Control.SRR15539832;36;38;0.361111111111111;23;13;0.138888888888889;0.361111111111111
Control.SRR15539832;36;38;0.555555555555556;16;20;0.0555555555555556;0.444444444444444
Control.SRR15539832;37;38;0.567567567567568;16;21;0.0675675675675675;0.432432432432432
Control.SRR15539832;29;38;0.482758620689655;15;14;0.0172413793103448;0.482758620689655
Control.SRR15539832;38;38;0.368421052631579;24;14;0.131578947368421;0.368421052631579
Control.SRR15539832;37;38;0.432432432432432;21;16;0.0675675675675675;0.432432432432432
Control.SRR15539832;35;38;0.6;14;21;0.1;0.4
Control.SRR15539832;36;38;0.611111111111111;14;22;0.111111111111111;0.388888888888889
Control.SRR15539832;36;38;0.527777777777778;17;19;0.0277777777777778;0.472222222222222
Control.SRR15539832;38;38;0.473684210526316;20;18;0.0263157894736842;0.473684210526316
Control.SRR15539832;35;38;0.514285714285714;17;18;0.0142857142857142;0.485714285714286
Control.SRR15539832;34;38;0.617647058823529;13;21;0.117647058823529;0.382352941176471
Control.SRR15539832;34;38;0.647058823529412;12;22;0.147058823529412;0.352941176470588
Control.SRR15539832;39;38;0.641025641025641;14;25;0.141025641025641;0.358974358974359
Control.SRR15539832;35;38;0.428571428571429;20;15;0.0714285714285715;0.428571428571429
Control.SRR15539832;35;38;0.542857142857143;16;19;0.0428571428571428;0.457142857142857
Control.SRR15539832;32;38;0.53125;15;17;0.03125;0.46875
Control.SRR15539832;36;38;0.555555555555556;16;20;0.0555555555555556;0.444444444444444
Control.SRR15539832;33;38;0.575757575757576;14;19;0.0757575757575758;0.424242424242424
Control.SRR15539832;38;38;0.421052631578947;22;16;0.0789473684210527;0.421052631578947
Control.SRR15539832;38;38;0.526315789473684;18;20;0.0263157894736842;0.473684210526316
Control.SRR15539832;39;38;0.538461538461538;18;21;0.0384615384615384;0.461538461538462
Control.SRR15539832;32;38;0.5625;14;18;0.0625;0.4375
Control.SRR15539832;34;38;0.617647058823529;13;21;0.117647058823529;0.382352941176471
Control.SRR15539832;32;38;0.59375;13;19;0.09375;0.40625
Control.SRR15539832;35;38;0.4;21;14;0.1;0.4
Control.SRR15539832;35;38;0.542857142857143;16;19;0.0428571428571428;0.457142857142857
Control.SRR15539832;38;38;0.289473684210526;27;11;0.210526315789474;0.289473684210526
Control.SRR15539832;32;38;0.53125;15;17;0.03125;0.46875
Control.SRR15539832;38;38;0.552631578947368;17;21;0.0526315789473685;0.447368421052632
Control.SRR15539832;30;38;0.633333333333333;11;19;0.133333333333333;0.366666666666667
Control.SRR15539832;33;38;0.515151515151515;16;17;0.0151515151515151;0.484848484848485
Control.SRR15539832;38;38;0.578947368421053;16;22;0.0789473684210527;0.421052631578947
Control.SRR15539832;33;38;0.515151515151515;16;17;0.0151515151515151;0.484848484848485
Control.SRR15539832;36;38;0.444444444444444;20;16;0.0555555555555556;0.444444444444444
Control.SRR15539832;36;38;0.305555555555556;25;11;0.194444444444444;0.305555555555556
Control.SRR15539832;32;38;0.53125;15;17;0.03125;0.46875
Control.SRR15539832;34;38;0.529411764705882;16;18;0.0294117647058824;0.470588235294118
Control.SRR15539832;34;38;0.5;17;17;0;0.5
Control.SRR15539832;35;38;0.542857142857143;16;19;0.0428571428571428;0.457142857142857
Control.SRR15539832;38;38;0.631578947368421;14;24;0.131578947368421;0.368421052631579
Control.SRR15539832;30;38;0.5;15;15;0;0.5
Control.SRR15539832;38;38;0.394736842105263;23;15;0.105263157894737;0.394736842105263
Control.SRR15539832;33;38;0.303030303030303;23;10;0.196969696969697;0.303030303030303
Control.SRR15539832;39;38;0.512820512820513;19;20;0.0128205128205128;0.487179487179487
Control.SRR15539832;29;38;0.620689655172414;11;18;0.120689655172414;0.379310344827586
Control.SRR15539832;29;38;0.482758620689655;15;14;0.0172413793103448;0.482758620689655
Control.SRR15539832;30;38;0.566666666666667;13;17;0.0666666666666667;0.433333333333333
Control.SRR15539832;35;38;0.342857142857143;23;12;0.157142857142857;0.342857142857143
Control.SRR15539832;32;38;0.46875;17;15;0.03125;0.46875
Control.SRR15539832;32;38;0.6875;10;22;0.1875;0.3125
Control.SRR15539832;32;38;0.65625;11;21;0.15625;0.34375
Control.SRR15539832;37;38;0.459459459459459;20;17;0.0405405405405405;0.459459459459459
Control.SRR15539832;37;38;0.594594594594595;15;22;0.0945945945945946;0.405405405405405
Control.SRR15539832;35;38;0.485714285714286;18;17;0.0142857142857143;0.485714285714286
Control.SRR15539832;33;38;0.424242424242424;19;14;0.0757575757575757;0.424242424242424
Control.SRR15539832;38;38;0.394736842105263;23;15;0.105263157894737;0.394736842105263
Control.SRR15539832;35;38;0.685714285714286;11;24;0.185714285714286;0.314285714285714
Control.SRR15539832;39;38;0.58974358974359;16;23;0.0897435897435898;0.41025641025641
Control.SRR15539832;37;38;0.378378378378378;23;14;0.121621621621622;0.378378378378378
Control.SRR15539832;32;38;0.53125;15;17;0.03125;0.46875
Control.SRR15539832;31;38;0.483870967741935;16;15;0.0161290322580645;0.483870967741935
Control.SRR15539832;29;38;0.413793103448276;17;12;0.0862068965517241;0.413793103448276
Control.SRR15539832;39;38;0.461538461538462;21;18;0.0384615384615384;0.461538461538462
Control.SRR15539832;33;38;0.575757575757576;14;19;0.0757575757575758;0.424242424242424
Control.SRR15539832;29;38;0.551724137931034;13;16;0.0517241379310345;0.448275862068966
Control.SRR15539832;35;38;0.628571428571429;13;22;0.128571428571429;0.371428571428571
Control.SRR15539832;36;38;0.416666666666667;21;15;0.0833333333333333;0.416666666666667
Control.SRR15539832;30;38;0.4;18;12;0.1;0.4
Control.SRR15539832;34;38;0.647058823529412;12;22;0.147058823529412;0.352941176470588
Control.SRR15539832;29;38;0.517241379310345;14;15;0.0172413793103449;0.482758620689655
Control.SRR15539832;37;38;0.594594594594595;15;22;0.0945945945945946;0.405405405405405
Control.SRR15539832;32;38;0.5;16;16;0;0.5
Control.SRR15539832;39;38;0.512820512820513;19;20;0.0128205128205128;0.487179487179487
Control.SRR15539832;38;38;0.605263157894737;15;23;0.105263157894737;0.394736842105263
Control.SRR15539832;37;38;0.621621621621622;14;23;0.121621621621622;0.378378378378378
Control.SRR15539832;30;38;0.533333333333333;14;16;0.0333333333333333;0.466666666666667
Control.SRR15539832;31;38;0.612903225806452;12;19;0.112903225806452;0.387096774193548
Control.SRR15539832;32;38;0.625;12;20;0.125;0.375
Control.SRR15539832;34;38;0.617647058823529;13;21;0.117647058823529;0.382352941176471
Control.SRR15539832;36;38;0.388888888888889;22;14;0.111111111111111;0.388888888888889
Control.SRR15539832;32;38;0.53125;15;17;0.03125;0.46875
Control.SRR15539832;34;38;0.470588235294118;18;16;0.0294117647058824;0.470588235294118
Control.SRR15539832;29;38;0.482758620689655;15;14;0.0172413793103448;0.482758620689655
Control.SRR15539832;38;38;0.5;19;19;0;0.5
Control.SRR15539832;35;38;0.457142857142857;19;16;0.0428571428571429;0.457142857142857
Control.SRR15539832;39;38;0.615384615384615;15;24;0.115384615384615;0.384615384615385
Control.SRR15539832;34;38;0.588235294117647;14;20;0.0882352941176471;0.411764705882353
Control.SRR15539832;29;38;0.482758620689655;15;14;0.0172413793103448;0.482758620689655
Control.SRR15539832;37;38;0.540540540540541;17;20;0.0405405405405406;0.459459459459459
Control.SRR15539832;38;38;0.421052631578947;22;16;0.0789473684210527;0.421052631578947
Control.SRR15539832;39;38;0.435897435897436;22;17;0.0641025641025641;0.435897435897436
Control.SRR15539832;37;38;0.432432432432432;21;16;0.0675675675675675;0.432432432432432
Control.SRR15539832;31;38;0.483870967741935;16;15;0.0161290322580645;0.483870967741935
Control.SRR15539832;33;38;0.575757575757576;14;19;0.0757575757575758;0.424242424242424
Control.SRR15539832;35;38;0.542857142857143;16;19;0.0428571428571428;0.457142857142857
Control.SRR15539832;32;38;0.53125;15;17;0.03125;0.46875
Control.SRR15539832;35;38;0.4;21;14;0.1;0.4
Control.SRR15539832;31;38;0.354838709677419;20;11;0.145161290322581;0.354838709677419
Control.SRR15539832;29;38;0.620689655172414;11;18;0.120689655172414;0.379310344827586
Control.SRR15539832;29;38;0.379310344827586;18;11;0.120689655172414;0.379310344827586
Control.SRR15539832;34;38;0.558823529411765;15;19;0.0588235294117647;0.441176470588235
Control.SRR15539832;36;38;0.444444444444444;20;16;0.0555555555555556;0.444444444444444
Control.SRR15539832;38;38;0.526315789473684;18;20;0.0263157894736842;0.473684210526316
Control.SRR15539832;31;38;0.645161290322581;11;20;0.145161290322581;0.354838709677419
Control.SRR15539832;33;38;0.545454545454545;15;18;0.0454545454545454;0.454545454545455
Control.SRR15539832;31;38;0.483870967741935;16;15;0.0161290322580645;0.483870967741935
Control.SRR15539832;35;38;0.6;14;21;0.1;0.4
Control.SRR15539832;37;38;0.432432432432432;21;16;0.0675675675675675;0.432432432432432
Control.SRR15539832;30;38;0.4;18;12;0.1;0.4
Control.SRR15539832;36;38;0.5;18;18;0;0.5
Control.SRR15539832;30;38;0.533333333333333;14;16;0.0333333333333333;0.466666666666667
Control.SRR15539832;32;38;0.53125;15;17;0.03125;0.46875
Control.SRR15539832;39;38;0.41025641025641;23;16;0.0897435897435898;0.41025641025641
Control.SRR15539832;36;38;0.472222222222222;19;17;0.0277777777777778;0.472222222222222
Control.SRR15539832;37;38;0.351351351351351;24;13;0.148648648648649;0.351351351351351
Control.SRR15539832;38;38;0.421052631578947;22;16;0.0789473684210527;0.421052631578947
Control.SRR15539832;32;38;0.59375;13;19;0.09375;0.40625
Control.SRR15539832;38;38;0.5;19;19;0;0.5
Control.SRR15539832;29;38;0.551724137931034;13;16;0.0517241379310345;0.448275862068966
Control.SRR15539832;33;38;0.393939393939394;20;13;0.106060606060606;0.393939393939394
Control.SRR15539832;36;38;0.5;18;18;0;0.5
Control.SRR15539832;29;38;0.655172413793103;10;19;0.155172413793103;0.344827586206897
Control.SRR15539832;29;38;0.655172413793103;10;19;0.155172413793103;0.344827586206897
Control.SRR15539832;37;38;0.648648648648649;13;24;0.148648648648649;0.351351351351351
Control.SRR15539832;39;38;0.512820512820513;19;20;0.0128205128205128;0.487179487179487
Control.SRR15539832;36;38;0.388888888888889;22;14;0.111111111111111;0.388888888888889
Control.SRR15539832;36;38;0.361111111111111;23;13;0.138888888888889;0.361111111111111
Control.SRR15539832;34;38;0.588235294117647;14;20;0.0882352941176471;0.411764705882353
Control.SRR15539832;29;38;0.724137931034483;8;21;0.224137931034483;0.275862068965517
Control.SRR15539832;31;38;0.419354838709677;18;13;0.0806451612903226;0.419354838709677
Control.SRR15539832;35;38;0.342857142857143;23;12;0.157142857142857;0.342857142857143
Control.SRR15539832;38;38;0.605263157894737;15;23;0.105263157894737;0.394736842105263
Control.SRR15539832;38;38;0.710526315789474;11;27;0.210526315789474;0.289473684210526
Control.SRR15539832;35;38;0.342857142857143;23;12;0.157142857142857;0.342857142857143
Control.SRR15539832;38;38;0.421052631578947;22;16;0.0789473684210527;0.421052631578947
Control.SRR15539832;32;38;0.34375;21;11;0.15625;0.34375
Control.SRR15539832;37;38;0.513513513513513;18;19;0.0135135135135135;0.486486486486487
Control.SRR15539832;31;38;0.612903225806452;12;19;0.112903225806452;0.387096774193548
Control.SRR15539832;32;38;0.4375;18;14;0.0625;0.4375
Control.SRR15539832;35;38;0.542857142857143;16;19;0.0428571428571428;0.457142857142857
Control.SRR15539832;32;38;0.59375;13;19;0.09375;0.40625
Control.SRR15539832;29;38;0.517241379310345;14;15;0.0172413793103449;0.482758620689655
Control.SRR15539832;38;38;0.552631578947368;17;21;0.0526315789473685;0.447368421052632
Control.SRR15539832;39;38;0.564102564102564;17;22;0.0641025641025641;0.435897435897436
Control.SRR15539832;32;38;0.65625;11;21;0.15625;0.34375
Control.SRR15539832;39;38;0.384615384615385;24;15;0.115384615384615;0.384615384615385
Control.SRR15539832;35;38;0.542857142857143;16;19;0.0428571428571428;0.457142857142857
Control.SRR15539832;39;38;0.538461538461538;18;21;0.0384615384615384;0.461538461538462
Control.SRR15539832;30;38;0.533333333333333;14;16;0.0333333333333333;0.466666666666667
Control.SRR15539832;29;38;0.551724137931034;13;16;0.0517241379310345;0.448275862068966
Control.SRR15539832;29;38;0.379310344827586;18;11;0.120689655172414;0.379310344827586
Control.SRR15539832;32;38;0.71875;9;23;0.21875;0.28125
Control.SRR15539832;36;38;0.5;18;18;0;0.5
Control.SRR15539832;37;38;0.459459459459459;20;17;0.0405405405405405;0.459459459459459
Control.SRR15539832;37;38;0.567567567567568;16;21;0.0675675675675675;0.432432432432432
Control.SRR15539832;30;38;0.366666666666667;19;11;0.133333333333333;0.366666666666667
Control.SRR15539832;32;38;0.6875;10;22;0.1875;0.3125
Control.SRR15539832;34;38;0.647058823529412;12;22;0.147058823529412;0.352941176470588
Control.SRR15539832;36;38;0.527777777777778;17;19;0.0277777777777778;0.472222222222222
Control.SRR15539832;38;38;0.421052631578947;22;16;0.0789473684210527;0.421052631578947
Control.SRR15539832;34;38;0.411764705882353;20;14;0.0882352941176471;0.411764705882353
Control.SRR15539832;36;38;0.388888888888889;22;14;0.111111111111111;0.388888888888889
Control.SRR15539832;30;38;0.5;15;15;0;0.5
Control.SRR15539832;31;38;0.451612903225806;17;14;0.0483870967741936;0.451612903225806
Control.SRR15539832;35;38;0.6;14;21;0.1;0.4
Control.SRR15539832;37;38;0.432432432432432;21;16;0.0675675675675675;0.432432432432432
Control.SRR15539832;29;38;0.344827586206897;19;10;0.155172413793103;0.344827586206897
Control.SRR15539832;33;38;0.454545454545455;18;15;0.0454545454545455;0.454545454545455
Control.SRR15539832;36;38;0.583333333333333;15;21;0.0833333333333334;0.416666666666667
Control.SRR15539832;37;38;0.486486486486487;19;18;0.0135135135135135;0.486486486486487
Control.SRR15539832;33;38;0.545454545454545;15;18;0.0454545454545454;0.454545454545455
Control.SRR15539832;34;38;0.382352941176471;21;13;0.117647058823529;0.382352941176471
Control.SRR15539832;36;38;0.333333333333333;24;12;0.166666666666667;0.333333333333333
Control.SRR15539832;36;38;0.527777777777778;17;19;0.0277777777777778;0.472222222222222
Control.SRR15539832;38;38;0.605263157894737;15;23;0.105263157894737;0.394736842105263
Control.SRR15539832;39;38;0.435897435897436;22;17;0.0641025641025641;0.435897435897436
Control.SRR15539832;36;38;0.277777777777778;26;10;0.222222222222222;0.277777777777778
Control.SRR15539832;30;38;0.466666666666667;16;14;0.0333333333333333;0.466666666666667
Control.SRR15539832;32;38;0.5625;14;18;0.0625;0.4375
Control.SRR15539832;31;38;0.483870967741935;16;15;0.0161290322580645;0.483870967741935
Control.SRR15539832;37;38;0.594594594594595;15;22;0.0945945945945946;0.405405405405405
Control.SRR15539832;34;38;0.529411764705882;16;18;0.0294117647058824;0.470588235294118
Control.SRR15539832;30;38;0.466666666666667;16;14;0.0333333333333333;0.466666666666667
Control.SRR15539832;35;38;0.571428571428571;15;20;0.0714285714285714;0.428571428571429
Control.SRR15539832;36;38;0.583333333333333;15;21;0.0833333333333334;0.416666666666667
Control.SRR15539832;38;38;0.5;19;19;0;0.5
Control.SRR15539832;37;38;0.72972972972973;10;27;0.22972972972973;0.27027027027027
Control.SRR15539832;30;38;0.466666666666667;16;14;0.0333333333333333;0.466666666666667
Control.SRR15539832;33;38;0.575757575757576;14;19;0.0757575757575758;0.424242424242424
Control.SRR15539832;35;38;0.371428571428571;22;13;0.128571428571429;0.371428571428571
Control.SRR15539832;29;38;0.310344827586207;20;9;0.189655172413793;0.310344827586207
Control.SRR15539832;39;38;0.564102564102564;17;22;0.0641025641025641;0.435897435897436
Control.SRR15539832;34;38;0.647058823529412;12;22;0.147058823529412;0.352941176470588
Control.SRR15539832;34;38;0.441176470588235;19;15;0.0588235294117647;0.441176470588235
Control.SRR15539832;37;38;0.432432432432432;21;16;0.0675675675675675;0.432432432432432
Control.SRR15539832;39;38;0.512820512820513;19;20;0.0128205128205128;0.487179487179487
Control.SRR15539832;38;38;0.552631578947368;17;21;0.0526315789473685;0.447368421052632
Control.SRR15539832;38;38;0.447368421052632;21;17;0.0526315789473684;0.447368421052632
Control.SRR15539832;37;38;0.513513513513513;18;19;0.0135135135135135;0.486486486486487
Control.SRR15539832;38;38;0.657894736842105;13;25;0.157894736842105;0.342105263157895
Control.SRR15539832;32;38;0.625;12;20;0.125;0.375
Control.SRR15539832;31;38;0.354838709677419;20;11;0.145161290322581;0.354838709677419
Control.SRR15539832;31;38;0.419354838709677;18;13;0.0806451612903226;0.419354838709677
Control.SRR15539832;33;38;0.575757575757576;14;19;0.0757575757575758;0.424242424242424
Control.SRR15539832;32;38;0.4375;18;14;0.0625;0.4375
Control.SRR15539832;36;38;0.444444444444444;20;16;0.0555555555555556;0.444444444444444
Control.SRR15539832;33;38;0.484848484848485;17;16;0.0151515151515151;0.484848484848485
Control.SRR15539832;29;38;0.344827586206897;19;10;0.155172413793103;0.344827586206897
Control.SRR15539832;32;38;0.59375;13;19;0.09375;0.40625
Control.SRR15539832;35;38;0.514285714285714;17;18;0.0142857142857142;0.485714285714286
Control.SRR15539832;31;38;0.580645161290323;13;18;0.0806451612903226;0.419354838709677
Control.SRR15539832;32;38;0.625;12;20;0.125;0.375
Control.SRR15539832;35;38;0.428571428571429;20;15;0.0714285714285715;0.428571428571429
Control.SRR15539832;36;38;0.611111111111111;14;22;0.111111111111111;0.388888888888889
Control.SRR15539832;34;38;0.529411764705882;16;18;0.0294117647058824;0.470588235294118
Control.SRR15539832;35;38;0.485714285714286;18;17;0.0142857142857143;0.485714285714286
Control.SRR15539832;32;38;0.3125;22;10;0.1875;0.3125
Control.SRR15539832;35;38;0.371428571428571;22;13;0.128571428571429;0.371428571428571
Control.SRR15539832;32;38;0.59375;13;19;0.09375;0.40625
Control.SRR15539832;35;38;0.514285714285714;17;18;0.0142857142857142;0.485714285714286
Control.SRR15539832;32;38;0.6875;10;22;0.1875;0.3125
Control.SRR15539832;32;38;0.625;12;20;0.125;0.375
Control.SRR15539832;38;38;0.421052631578947;22;16;0.0789473684210527;0.421052631578947
Control.SRR15539832;29;38;0.517241379310345;14;15;0.0172413793103449;0.482758620689655
Control.SRR15539832;34;38;0.617647058823529;13;21;0.117647058823529;0.382352941176471
Control.SRR15539832;38;38;0.526315789473684;18;20;0.0263157894736842;0.473684210526316
Control.SRR15539832;30;38;0.433333333333333;17;13;0.0666666666666667;0.433333333333333
Control.SRR15539832;29;38;0.482758620689655;15;14;0.0172413793103448;0.482758620689655
Control.SRR15539832;39;38;0.41025641025641;23;16;0.0897435897435898;0.41025641025641
Control.SRR15539832;34;38;0.411764705882353;20;14;0.0882352941176471;0.411764705882353
Control.SRR15539832;38;38;0.421052631578947;22;16;0.0789473684210527;0.421052631578947
Control.SRR15539832;37;38;0.540540540540541;17;20;0.0405405405405406;0.459459459459459
Control.SRR15539832;33;38;0.484848484848485;17;16;0.0151515151515151;0.484848484848485
Control.SRR15539832;30;38;0.466666666666667;16;14;0.0333333333333333;0.466666666666667
Control.SRR15539832;35;38;0.6;14;21;0.1;0.4
Control.SRR15539832;32;38;0.46875;17;15;0.03125;0.46875
Control.SRR15539832;31;38;0.516129032258065;15;16;0.0161290322580645;0.483870967741935
Control.SRR15539832;31;38;0.612903225806452;12;19;0.112903225806452;0.387096774193548
Control.SRR15539832;35;38;0.485714285714286;18;17;0.0142857142857143;0.485714285714286
Control.SRR15539832;35;38;0.428571428571429;20;15;0.0714285714285715;0.428571428571429
Control.SRR15539832;29;38;0.482758620689655;15;14;0.0172413793103448;0.482758620689655
Control.SRR15539832;29;38;0.413793103448276;17;12;0.0862068965517241;0.413793103448276
Control.SRR15539832;37;38;0.513513513513513;18;19;0.0135135135135135;0.486486486486487
Control.SRR15539832;29;38;0.448275862068966;16;13;0.0517241379310345;0.448275862068966
Control.SRR15539832;38;38;0.447368421052632;21;17;0.0526315789473684;0.447368421052632
Control.SRR15539832;36;38;0.333333333333333;24;12;0.166666666666667;0.333333333333333
Control.SRR15539832;29;38;0.482758620689655;15;14;0.0172413793103448;0.482758620689655
Control.SRR15539832;39;38;0.538461538461538;18;21;0.0384615384615384;0.461538461538462
Control.SRR15539832;34;38;0.529411764705882;16;18;0.0294117647058824;0.470588235294118
Control.SRR15539832;33;38;0.515151515151515;16;17;0.0151515151515151;0.484848484848485
Control.SRR15539832;38;38;0.447368421052632;21;17;0.0526315789473684;0.447368421052632
Control.SRR15539832;39;38;0.41025641025641;23;16;0.0897435897435898;0.41025641025641
Control.SRR15539832;35;38;0.571428571428571;15;20;0.0714285714285714;0.428571428571429
Control.SRR15539832;39;38;0.58974358974359;16;23;0.0897435897435898;0.41025641025641
Control.SRR15539832;35;38;0.457142857142857;19;16;0.0428571428571429;0.457142857142857
Control.SRR15539832;38;38;0.526315789473684;18;20;0.0263157894736842;0.473684210526316
Control.SRR15539832;36;38;0.5;18;18;0;0.5
Control.SRR15539832;30;38;0.5;15;15;0;0.5
Control.SRR15539832;34;38;0.382352941176471;21;13;0.117647058823529;0.382352941176471
Control.SRR15539832;31;38;0.451612903225806;17;14;0.0483870967741936;0.451612903225806
Control.SRR15539832;32;38;0.625;12;20;0.125;0.375
Control.SRR15539832;34;38;0.5;17;17;0;0.5
Control.SRR15539832;33;38;0.363636363636364;21;12;0.136363636363636;0.363636363636364
Control.SRR15539832;38;38;0.526315789473684;18;20;0.0263157894736842;0.473684210526316
Control.SRR15539832;34;38;0.529411764705882;16;18;0.0294117647058824;0.470588235294118
Control.SRR15539832;29;38;0.517241379310345;14;15;0.0172413793103449;0.482758620689655
Control.SRR15539832;32;38;0.5;16;16;0;0.5
Control.SRR15539832;34;38;0.558823529411765;15;19;0.0588235294117647;0.441176470588235
Control.SRR15539832;32;38;0.4375;18;14;0.0625;0.4375
Control.SRR15539832;34;38;0.529411764705882;16;18;0.0294117647058824;0.470588235294118
Control.SRR15539832;35;38;0.571428571428571;15;20;0.0714285714285714;0.428571428571429
Control.SRR15539832;32;38;0.5625;14;18;0.0625;0.4375
Control.SRR15539832;31;38;0.548387096774194;14;17;0.0483870967741935;0.451612903225806
Control.SRR15539832;29;38;0.344827586206897;19;10;0.155172413793103;0.344827586206897
Control.SRR15539832;35;38;0.6;14;21;0.1;0.4
Control.SRR15539832;36;38;0.416666666666667;21;15;0.0833333333333333;0.416666666666667
Control.SRR15539832;31;38;0.354838709677419;20;11;0.145161290322581;0.354838709677419
Control.SRR15539832;36;38;0.5;18;18;0;0.5
Control.SRR15539832;39;38;0.512820512820513;19;20;0.0128205128205128;0.487179487179487
Control.SRR15539832;38;38;0.552631578947368;17;21;0.0526315789473685;0.447368421052632
Control.SRR15539832;36;38;0.666666666666667;12;24;0.166666666666667;0.333333333333333
Control.SRR15539832;32;38;0.46875;17;15;0.03125;0.46875
Control.SRR15539832;38;38;0.5;19;19;0;0.5
Control.SRR15539832;32;38;0.5;16;16;0;0.5
Control.SRR15539832;39;38;0.538461538461538;18;21;0.0384615384615384;0.461538461538462
Control.SRR15539832;33;38;0.454545454545455;18;15;0.0454545454545455;0.454545454545455
Control.SRR15539832;31;38;0.580645161290323;13;18;0.0806451612903226;0.419354838709677
Control.SRR15539832;33;38;0.393939393939394;20;13;0.106060606060606;0.393939393939394
Control.SRR15539832;37;38;0.540540540540541;17;20;0.0405405405405406;0.459459459459459
Control.SRR15539832;31;38;0.645161290322581;11;20;0.145161290322581;0.354838709677419
Control.SRR15539832;30;38;0.6;12;18;0.1;0.4
Control.SRR15539832;36;38;0.5;18;18;0;0.5
Control.SRR15539832;36;38;0.333333333333333;24;12;0.166666666666667;0.333333333333333
Control.SRR15539832;31;38;0.67741935483871;10;21;0.17741935483871;0.32258064516129
Control.SRR15539832;30;38;0.333333333333333;20;10;0.166666666666667;0.333333333333333
Control.SRR15539832;35;38;0.342857142857143;23;12;0.157142857142857;0.342857142857143
Control.SRR15539832;39;38;0.58974358974359;16;23;0.0897435897435898;0.41025641025641
Control.SRR15539832;33;38;0.636363636363636;12;21;0.136363636363636;0.363636363636364
Control.SRR15539832;36;38;0.444444444444444;20;16;0.0555555555555556;0.444444444444444
Control.SRR15539832;34;38;0.617647058823529;13;21;0.117647058823529;0.382352941176471
Control.SRR15539832;38;38;0.473684210526316;20;18;0.0263157894736842;0.473684210526316
Control.SRR15539832;33;38;0.606060606060606;13;20;0.106060606060606;0.393939393939394
Control.SRR15539832;38;38;0.473684210526316;20;18;0.0263157894736842;0.473684210526316
Control.SRR15539832;35;38;0.4;21;14;0.1;0.4
Control.SRR15539832;32;38;0.5;16;16;0;0.5
Control.SRR15539832;39;38;0.461538461538462;21;18;0.0384615384615384;0.461538461538462
Control.SRR15539832;38;38;0.394736842105263;23;15;0.105263157894737;0.394736842105263
Control.SRR15539832;30;38;0.533333333333333;14;16;0.0333333333333333;0.466666666666667
Control.SRR15539832;36;38;0.5;18;18;0;0.5
Control.SRR15539832;36;38;0.444444444444444;20;16;0.0555555555555556;0.444444444444444
Control.SRR15539832;35;38;0.485714285714286;18;17;0.0142857142857143;0.485714285714286
Control.SRR15539832;33;38;0.545454545454545;15;18;0.0454545454545454;0.454545454545455
Control.SRR15539832;29;38;0.517241379310345;14;15;0.0172413793103449;0.482758620689655
Control.SRR15539832;33;38;0.454545454545455;18;15;0.0454545454545455;0.454545454545455
Control.SRR15539832;34;38;0.617647058823529;13;21;0.117647058823529;0.382352941176471
Control.SRR15539832;35;38;0.485714285714286;18;17;0.0142857142857143;0.485714285714286
Control.SRR15539832;35;38;0.514285714285714;17;18;0.0142857142857142;0.485714285714286
Control.SRR15539832;30;38;0.4;18;12;0.1;0.4
Control.SRR15539832;33;38;0.545454545454545;15;18;0.0454545454545454;0.454545454545455
Control.SRR15539832;38;38;0.473684210526316;20;18;0.0263157894736842;0.473684210526316
Control.SRR15539832;32;38;0.4375;18;14;0.0625;0.4375
Control.SRR15539832;30;38;0.6;12;18;0.1;0.4
Control.SRR15539832;34;38;0.382352941176471;21;13;0.117647058823529;0.382352941176471
Control.SRR15539832;38;38;0.394736842105263;23;15;0.105263157894737;0.394736842105263
Control.SRR15539832;38;38;0.394736842105263;23;15;0.105263157894737;0.394736842105263
Control.SRR15539832;29;38;0.586206896551724;12;17;0.0862068965517241;0.413793103448276
Control.SRR15539832;33;38;0.545454545454545;15;18;0.0454545454545454;0.454545454545455
Control.SRR15539832;31;38;0.354838709677419;20;11;0.145161290322581;0.354838709677419
Control.SRR15539832;32;38;0.40625;19;13;0.09375;0.40625
Control.SRR15539832;36;38;0.444444444444444;20;16;0.0555555555555556;0.444444444444444
Control.SRR15539832;29;38;0.689655172413793;9;20;0.189655172413793;0.310344827586207
Control.SRR15539832;29;38;0.310344827586207;20;9;0.189655172413793;0.310344827586207
Control.SRR15539832;38;38;0.5;19;19;0;0.5
Control.SRR15539832;37;38;0.432432432432432;21;16;0.0675675675675675;0.432432432432432
Control.SRR15539832;29;38;0.586206896551724;12;17;0.0862068965517241;0.413793103448276
Control.SRR15539832;34;38;0.411764705882353;20;14;0.0882352941176471;0.411764705882353
Control.SRR15539832;34;38;0.647058823529412;12;22;0.147058823529412;0.352941176470588
Control.SRR15539832;34;38;0.382352941176471;21;13;0.117647058823529;0.382352941176471
Control.SRR15539832;38;38;0.5;19;19;0;0.5
Control.SRR15539832;35;38;0.514285714285714;17;18;0.0142857142857142;0.485714285714286
Control.SRR15539832;31;38;0.451612903225806;17;14;0.0483870967741936;0.451612903225806
Control.SRR15539832;31;38;0.483870967741935;16;15;0.0161290322580645;0.483870967741935
Control.SRR15539832;32;38;0.53125;15;17;0.03125;0.46875
Control.SRR15539832;34;38;0.529411764705882;16;18;0.0294117647058824;0.470588235294118
Control.SRR15539832;35;38;0.6;14;21;0.1;0.4
Control.SRR15539832;37;38;0.297297297297297;26;11;0.202702702702703;0.297297297297297
Control.SRR15539832;38;38;0.552631578947368;17;21;0.0526315789473685;0.447368421052632
Control.SRR15539832;36;38;0.472222222222222;19;17;0.0277777777777778;0.472222222222222
Control.SRR15539832;36;38;0.555555555555556;16;20;0.0555555555555556;0.444444444444444
Control.SRR15539832;35;38;0.571428571428571;15;20;0.0714285714285714;0.428571428571429
Control.SRR15539832;38;38;0.473684210526316;20;18;0.0263157894736842;0.473684210526316
Control.SRR15539832;34;38;0.5;17;17;0;0.5
Control.SRR15539832;32;38;0.5;16;16;0;0.5
Control.SRR15539832;29;38;0.517241379310345;14;15;0.0172413793103449;0.482758620689655
Control.SRR15539832;30;38;0.466666666666667;16;14;0.0333333333333333;0.466666666666667
Control.SRR15539832;31;38;0.451612903225806;17;14;0.0483870967741936;0.451612903225806
Control.SRR15539832;30;38;0.566666666666667;13;17;0.0666666666666667;0.433333333333333
Control.SRR15539832;39;38;0.461538461538462;21;18;0.0384615384615384;0.461538461538462
Control.SRR15539832;37;38;0.432432432432432;21;16;0.0675675675675675;0.432432432432432
Control.SRR15539832;35;38;0.457142857142857;19;16;0.0428571428571429;0.457142857142857
Control.SRR15539832;31;38;0.451612903225806;17;14;0.0483870967741936;0.451612903225806
Control.SRR15539832;29;38;0.413793103448276;17;12;0.0862068965517241;0.413793103448276
Control.SRR15539832;39;38;0.435897435897436;22;17;0.0641025641025641;0.435897435897436
Control.SRR15539832;38;38;0.473684210526316;20;18;0.0263157894736842;0.473684210526316
Control.SRR15539832;36;38;0.5;18;18;0;0.5
Control.SRR15539832;30;38;0.366666666666667;19;11;0.133333333333333;0.366666666666667
Control.SRR15539832;35;38;0.457142857142857;19;16;0.0428571428571429;0.457142857142857
Control.SRR15539832;35;38;0.571428571428571;15;20;0.0714285714285714;0.428571428571429
Control.SRR15539832;29;38;0.482758620689655;15;14;0.0172413793103448;0.482758620689655
Control.SRR15539832;34;38;0.470588235294118;18;16;0.0294117647058824;0.470588235294118
Control.SRR15539832;38;38;0.5;19;19;0;0.5
Control.SRR15539832;38;38;0.631578947368421;14;24;0.131578947368421;0.368421052631579
Control.SRR15539832;38;38;0.5;19;19;0;0.5
Control.SRR15539832;31;38;0.516129032258065;15;16;0.0161290322580645;0.483870967741935
Control.SRR15539832;35;38;0.685714285714286;11;24;0.185714285714286;0.314285714285714
Control.SRR15539832;36;38;0.388888888888889;22;14;0.111111111111111;0.388888888888889
Control.SRR15539832;37;38;0.540540540540541;17;20;0.0405405405405406;0.459459459459459
Control.SRR15539832;33;38;0.484848484848485;17;16;0.0151515151515151;0.484848484848485
Control.SRR15539832;34;38;0.617647058823529;13;21;0.117647058823529;0.382352941176471
Control.SRR15539832;37;38;0.513513513513513;18;19;0.0135135135135135;0.486486486486487
Control.SRR15539832;32;38;0.4375;18;14;0.0625;0.4375
Control.SRR15539832;32;38;0.46875;17;15;0.03125;0.46875
Control.SRR15539832;30;38;0.533333333333333;14;16;0.0333333333333333;0.466666666666667
Control.SRR15539832;31;38;0.741935483870968;8;23;0.241935483870968;0.258064516129032
Control.SRR15539832;34;38;0.470588235294118;18;16;0.0294117647058824;0.470588235294118
Control.SRR15539832;37;38;0.540540540540541;17;20;0.0405405405405406;0.459459459459459
Control.SRR15539832;35;38;0.628571428571429;13;22;0.128571428571429;0.371428571428571
Control.SRR15539832;30;38;0.366666666666667;19;11;0.133333333333333;0.366666666666667
Control.SRR15539832;35;38;0.428571428571429;20;15;0.0714285714285715;0.428571428571429
Control.SRR15539832;36;38;0.472222222222222;19;17;0.0277777777777778;0.472222222222222
Control.SRR15539832;36;38;0.388888888888889;22;14;0.111111111111111;0.388888888888889
Control.SRR15539832;31;38;0.483870967741935;16;15;0.0161290322580645;0.483870967741935
Control.SRR15539832;38;38;0.447368421052632;21;17;0.0526315789473684;0.447368421052632
Control.SRR15539832;36;38;0.611111111111111;14;22;0.111111111111111;0.388888888888889
Control.SRR15539832;32;38;0.5625;14;18;0.0625;0.4375
Control.SRR15539832;30;38;0.633333333333333;11;19;0.133333333333333;0.366666666666667
Control.SRR15539832;35;38;0.6;14;21;0.1;0.4
Control.SRR15539832;29;38;0.172413793103448;24;5;0.327586206896552;0.172413793103448
Control.SRR15539832;38;38;0.447368421052632;21;17;0.0526315789473684;0.447368421052632
Control.SRR15539832;37;38;0.675675675675676;12;25;0.175675675675676;0.324324324324324
Control.SRR15539832;37;38;0.567567567567568;16;21;0.0675675675675675;0.432432432432432
Control.SRR15539832;30;38;0.533333333333333;14;16;0.0333333333333333;0.466666666666667
Control.SRR15539832;30;38;0.6;12;18;0.1;0.4
Control.SRR15539832;31;38;0.516129032258065;15;16;0.0161290322580645;0.483870967741935
Control.SRR15539832;32;38;0.5;16;16;0;0.5
Control.SRR15539832;39;38;0.333333333333333;26;13;0.166666666666667;0.333333333333333
Control.SRR15539832;35;38;0.342857142857143;23;12;0.157142857142857;0.342857142857143
Control.SRR15539832;30;38;0.4;18;12;0.1;0.4
Control.SRR15539832;33;38;0.606060606060606;13;20;0.106060606060606;0.393939393939394
Control.SRR15539832;34;38;0.5;17;17;0;0.5
Control.SRR15539832;34;38;0.529411764705882;16;18;0.0294117647058824;0.470588235294118
Control.SRR15539832;33;38;0.454545454545455;18;15;0.0454545454545455;0.454545454545455
Control.SRR15539832;33;38;0.393939393939394;20;13;0.106060606060606;0.393939393939394
Control.SRR15539832;30;38;0.5;15;15;0;0.5
Control.SRR15539832;33;38;0.454545454545455;18;15;0.0454545454545455;0.454545454545455
Control.SRR15539832;32;38;0.5;16;16;0;0.5
Control.SRR15539832;33;38;0.515151515151515;16;17;0.0151515151515151;0.484848484848485
Control.SRR15539832;31;38;0.451612903225806;17;14;0.0483870967741936;0.451612903225806
Control.SRR15539832;30;38;0.533333333333333;14;16;0.0333333333333333;0.466666666666667
Control.SRR15539832;36;38;0.472222222222222;19;17;0.0277777777777778;0.472222222222222
Control.SRR15539832;39;38;0.435897435897436;22;17;0.0641025641025641;0.435897435897436
Control.SRR15539832;29;38;0.310344827586207;20;9;0.189655172413793;0.310344827586207
Control.SRR15539832;32;38;0.5;16;16;0;0.5
Control.SRR15539832;29;38;0.379310344827586;18;11;0.120689655172414;0.379310344827586
Control.SRR15539832;30;38;0.466666666666667;16;14;0.0333333333333333;0.466666666666667
Control.SRR15539832;31;38;0.419354838709677;18;13;0.0806451612903226;0.419354838709677
Control.SRR15539832;34;38;0.411764705882353;20;14;0.0882352941176471;0.411764705882353
Control.SRR15539832;38;38;0.552631578947368;17;21;0.0526315789473685;0.447368421052632
Control.SRR15539832;34;38;0.470588235294118;18;16;0.0294117647058824;0.470588235294118
Control.SRR15539832;37;38;0.459459459459459;20;17;0.0405405405405405;0.459459459459459
Control.SRR15539832;39;38;0.538461538461538;18;21;0.0384615384615384;0.461538461538462
Control.SRR15539832;33;38;0.696969696969697;10;23;0.196969696969697;0.303030303030303
Control.SRR15539832;31;38;0.516129032258065;15;16;0.0161290322580645;0.483870967741935
Control.SRR15539832;37;38;0.432432432432432;21;16;0.0675675675675675;0.432432432432432
Control.SRR15539832;36;38;0.388888888888889;22;14;0.111111111111111;0.388888888888889
Control.SRR15539832;32;38;0.5625;14;18;0.0625;0.4375
Control.SRR15539832;38;38;0.473684210526316;20;18;0.0263157894736842;0.473684210526316
Control.SRR15539832;39;38;0.512820512820513;19;20;0.0128205128205128;0.487179487179487
Control.SRR15539832;31;38;0.548387096774194;14;17;0.0483870967741935;0.451612903225806
Control.SRR15539832;32;38;0.46875;17;15;0.03125;0.46875
Control.SRR15539832;34;38;0.470588235294118;18;16;0.0294117647058824;0.470588235294118
Control.SRR15539832;39;38;0.487179487179487;20;19;0.0128205128205128;0.487179487179487
Control.SRR15539832;38;38;0.526315789473684;18;20;0.0263157894736842;0.473684210526316
Control.SRR15539832;29;38;0.482758620689655;15;14;0.0172413793103448;0.482758620689655
Control.SRR15539832;39;38;0.512820512820513;19;20;0.0128205128205128;0.487179487179487
Control.SRR15539832;29;38;0.448275862068966;16;13;0.0517241379310345;0.448275862068966
Control.SRR15539832;34;38;0.529411764705882;16;18;0.0294117647058824;0.470588235294118
Control.SRR15539832;36;38;0.472222222222222;19;17;0.0277777777777778;0.472222222222222
Control.SRR15539832;34;38;0.5;17;17;0;0.5
Control.SRR15539832;29;38;0.586206896551724;12;17;0.0862068965517241;0.413793103448276
Control.SRR15539832;39;38;0.564102564102564;17;22;0.0641025641025641;0.435897435897436
Control.SRR15539832;35;38;0.428571428571429;20;15;0.0714285714285715;0.428571428571429
Control.SRR15539832;30;38;0.433333333333333;17;13;0.0666666666666667;0.433333333333333
Control.SRR15539832;37;38;0.351351351351351;24;13;0.148648648648649;0.351351351351351
Control.SRR15539832;32;38;0.59375;13;19;0.09375;0.40625
Control.SRR15539832;29;38;0.620689655172414;11;18;0.120689655172414;0.379310344827586
Control.SRR15539832;33;38;0.393939393939394;20;13;0.106060606060606;0.393939393939394
Control.SRR15539832;32;38;0.34375;21;11;0.15625;0.34375
Control.SRR15539832;30;38;0.5;15;15;0;0.5
Control.SRR15539832;30;38;0.433333333333333;17;13;0.0666666666666667;0.433333333333333
Control.SRR15539832;29;38;0.448275862068966;16;13;0.0517241379310345;0.448275862068966
Control.SRR15539832;34;38;0.529411764705882;16;18;0.0294117647058824;0.470588235294118
Control.SRR15539832;37;38;0.459459459459459;20;17;0.0405405405405405;0.459459459459459
Control.SRR15539832;32;38;0.375;20;12;0.125;0.375
Control.SRR15539832;36;38;0.444444444444444;20;16;0.0555555555555556;0.444444444444444
Control.SRR15539832;29;38;0.551724137931034;13;16;0.0517241379310345;0.448275862068966
Control.SRR15539832;29;38;0.448275862068966;16;13;0.0517241379310345;0.448275862068966
Control.SRR15539832;34;38;0.529411764705882;16;18;0.0294117647058824;0.470588235294118
Control.SRR15539832;31;38;0.32258064516129;21;10;0.17741935483871;0.32258064516129
Control.SRR15539832;38;38;0.447368421052632;21;17;0.0526315789473684;0.447368421052632
Control.SRR15539832;29;38;0.379310344827586;18;11;0.120689655172414;0.379310344827586
Control.SRR15539832;31;38;0.580645161290323;13;18;0.0806451612903226;0.419354838709677
Control.SRR15539832;33;38;0.333333333333333;22;11;0.166666666666667;0.333333333333333
Control.SRR15539832;32;38;0.375;20;12;0.125;0.375
Control.SRR15539832;36;38;0.527777777777778;17;19;0.0277777777777778;0.472222222222222
Control.SRR15539832;29;38;0.586206896551724;12;17;0.0862068965517241;0.413793103448276
Control.SRR15539832;33;38;0.636363636363636;12;21;0.136363636363636;0.363636363636364
Control.SRR15539832;35;38;0.457142857142857;19;16;0.0428571428571429;0.457142857142857
Control.SRR15539832;39;38;0.512820512820513;19;20;0.0128205128205128;0.487179487179487
Control.SRR15539832;34;38;0.352941176470588;22;12;0.147058823529412;0.352941176470588
Control.SRR15539832;37;38;0.594594594594595;15;22;0.0945945945945946;0.405405405405405
Control.SRR15539832;30;38;0.566666666666667;13;17;0.0666666666666667;0.433333333333333
Control.SRR15539832;31;38;0.580645161290323;13;18;0.0806451612903226;0.419354838709677
Control.SRR15539832;36;38;0.527777777777778;17;19;0.0277777777777778;0.472222222222222
Control.SRR15539832;31;38;0.548387096774194;14;17;0.0483870967741935;0.451612903225806
Control.SRR15539832;31;38;0.548387096774194;14;17;0.0483870967741935;0.451612903225806
Control.SRR15539832;32;38;0.5;16;16;0;0.5
Control.SRR15539832;29;38;0.517241379310345;14;15;0.0172413793103449;0.482758620689655
Control.SRR15539832;37;38;0.540540540540541;17;20;0.0405405405405406;0.459459459459459
Control.SRR15539832;36;38;0.444444444444444;20;16;0.0555555555555556;0.444444444444444
Control.SRR15539832;29;38;0.551724137931034;13;16;0.0517241379310345;0.448275862068966
Control.SRR15539832;39;38;0.487179487179487;20;19;0.0128205128205128;0.487179487179487
Control.SRR15539832;35;38;0.428571428571429;20;15;0.0714285714285715;0.428571428571429
Control.SRR15539832;32;38;0.46875;17;15;0.03125;0.46875
Control.SRR15539832;36;38;0.472222222222222;19;17;0.0277777777777778;0.472222222222222
Control.SRR15539832;30;38;0.533333333333333;14;16;0.0333333333333333;0.466666666666667
Control.SRR15539832;31;38;0.483870967741935;16;15;0.0161290322580645;0.483870967741935
Control.SRR15539832;32;38;0.4375;18;14;0.0625;0.4375
Control.SRR15539832;29;38;0.689655172413793;9;20;0.189655172413793;0.310344827586207
Control.SRR15539832;32;38;0.34375;21;11;0.15625;0.34375
Control.SRR15539832;36;38;0.472222222222222;19;17;0.0277777777777778;0.472222222222222
Control.SRR15539832;29;38;0.275862068965517;21;8;0.224137931034483;0.275862068965517
Control.SRR15539832;39;38;0.384615384615385;24;15;0.115384615384615;0.384615384615385
Control.SRR15539832;35;38;0.485714285714286;18;17;0.0142857142857143;0.485714285714286
Control.SRR15539832;38;38;0.631578947368421;14;24;0.131578947368421;0.368421052631579
Control.SRR15539832;33;38;0.515151515151515;16;17;0.0151515151515151;0.484848484848485
Control.SRR15539832;35;38;0.657142857142857;12;23;0.157142857142857;0.342857142857143
Control.SRR15539832;32;38;0.46875;17;15;0.03125;0.46875
Control.SRR15539832;29;38;0.517241379310345;14;15;0.0172413793103449;0.482758620689655
Control.SRR15539832;30;38;0.566666666666667;13;17;0.0666666666666667;0.433333333333333
Control.SRR15539832;31;38;0.451612903225806;17;14;0.0483870967741936;0.451612903225806
Control.SRR15539832;37;38;0.486486486486487;19;18;0.0135135135135135;0.486486486486487
Control.SRR15539832;34;38;0.529411764705882;16;18;0.0294117647058824;0.470588235294118
Control.SRR15539832;33;38;0.575757575757576;14;19;0.0757575757575758;0.424242424242424
Control.SRR15539832;31;38;0.387096774193548;19;12;0.112903225806452;0.387096774193548
Control.SRR15539832;32;38;0.5;16;16;0;0.5
Control.SRR15539832;34;38;0.352941176470588;22;12;0.147058823529412;0.352941176470588
Control.SRR15539832;31;38;0.419354838709677;18;13;0.0806451612903226;0.419354838709677
Control.SRR15539832;32;38;0.46875;17;15;0.03125;0.46875
Control.SRR15539832;31;38;0.516129032258065;15;16;0.0161290322580645;0.483870967741935
Control.SRR15539832;36;38;0.555555555555556;16;20;0.0555555555555556;0.444444444444444
Control.SRR15539832;34;38;0.441176470588235;19;15;0.0588235294117647;0.441176470588235
Control.SRR15539832;34;38;0.588235294117647;14;20;0.0882352941176471;0.411764705882353
Control.SRR15539832;33;38;0.515151515151515;16;17;0.0151515151515151;0.484848484848485
Control.SRR15539832;34;38;0.529411764705882;16;18;0.0294117647058824;0.470588235294118
Control.SRR15539832;34;38;0.441176470588235;19;15;0.0588235294117647;0.441176470588235
Control.SRR15539832;32;38;0.4375;18;14;0.0625;0.4375
Control.SRR15539832;32;38;0.5625;14;18;0.0625;0.4375
Control.SRR15539832;35;38;0.514285714285714;17;18;0.0142857142857142;0.485714285714286
Control.SRR15539832;29;38;0.310344827586207;20;9;0.189655172413793;0.310344827586207
Control.SRR15539832;32;38;0.59375;13;19;0.09375;0.40625
Control.SRR15539832;32;38;0.46875;17;15;0.03125;0.46875
Control.SRR15539832;39;38;0.538461538461538;18;21;0.0384615384615384;0.461538461538462
Control.SRR15539832;34;38;0.411764705882353;20;14;0.0882352941176471;0.411764705882353
Control.SRR15539832;34;38;0.5;17;17;0;0.5
Control.SRR15539832;36;38;0.416666666666667;21;15;0.0833333333333333;0.416666666666667
Control.SRR15539832;37;38;0.324324324324324;25;12;0.175675675675676;0.324324324324324
Control.SRR15539832;36;38;0.527777777777778;17;19;0.0277777777777778;0.472222222222222
Control.SRR15539832;31;38;0.387096774193548;19;12;0.112903225806452;0.387096774193548
Control.SRR15539832;35;38;0.457142857142857;19;16;0.0428571428571429;0.457142857142857
Control.SRR15539832;33;38;0.393939393939394;20;13;0.106060606060606;0.393939393939394
Control.SRR15539832;32;38;0.46875;17;15;0.03125;0.46875
Control.SRR15539832;32;38;0.59375;13;19;0.09375;0.40625
Control.SRR15539832;32;38;0.46875;17;15;0.03125;0.46875
Control.SRR15539832;31;38;0.67741935483871;10;21;0.17741935483871;0.32258064516129
Control.SRR15539832;37;38;0.675675675675676;12;25;0.175675675675676;0.324324324324324
Control.SRR15539832;35;38;0.428571428571429;20;15;0.0714285714285715;0.428571428571429
Control.SRR15539832;32;38;0.46875;17;15;0.03125;0.46875
Control.SRR15539832;34;38;0.411764705882353;20;14;0.0882352941176471;0.411764705882353
Control.SRR15539832;39;38;0.358974358974359;25;14;0.141025641025641;0.358974358974359
Control.SRR15539832;31;38;0.387096774193548;19;12;0.112903225806452;0.387096774193548
Control.SRR15539832;32;38;0.5625;14;18;0.0625;0.4375
Control.SRR15539832;33;38;0.575757575757576;14;19;0.0757575757575758;0.424242424242424
Control.SRR15539832;33;38;0.606060606060606;13;20;0.106060606060606;0.393939393939394
Control.SRR15539832;35;38;0.571428571428571;15;20;0.0714285714285714;0.428571428571429
Control.SRR15539832;37;38;0.216216216216216;29;8;0.283783783783784;0.216216216216216
Control.SRR15539832;30;38;0.733333333333333;8;22;0.233333333333333;0.266666666666667
Control.SRR15539832;38;38;0.578947368421053;16;22;0.0789473684210527;0.421052631578947
Control.SRR15539832;31;38;0.580645161290323;13;18;0.0806451612903226;0.419354838709677
Control.SRR15539832;33;38;0.757575757575758;8;25;0.257575757575758;0.242424242424242
Control.SRR15539832;32;38;0.53125;15;17;0.03125;0.46875
Control.SRR15539832;39;38;0.641025641025641;14;25;0.141025641025641;0.358974358974359
Control.SRR15539832;34;38;0.735294117647059;9;25;0.235294117647059;0.264705882352941
Control.SRR15539832;38;38;0.315789473684211;26;12;0.184210526315789;0.315789473684211
Control.SRR15539832;32;38;0.375;20;12;0.125;0.375
Control.SRR15539832;32;38;0.34375;21;11;0.15625;0.34375
Control.SRR15539832;30;38;0.633333333333333;11;19;0.133333333333333;0.366666666666667
Control.SRR15539832;30;38;0.533333333333333;14;16;0.0333333333333333;0.466666666666667
Control.SRR15539832;29;38;0.413793103448276;17;12;0.0862068965517241;0.413793103448276
Control.SRR15539832;32;38;0.5;16;16;0;0.5
Control.SRR15539832;38;38;0.394736842105263;23;15;0.105263157894737;0.394736842105263
Control.SRR15539832;30;38;0.5;15;15;0;0.5
Control.SRR15539832;35;38;0.457142857142857;19;16;0.0428571428571429;0.457142857142857
Control.SRR15539832;35;38;0.6;14;21;0.1;0.4
Control.SRR15539832;33;38;0.424242424242424;19;14;0.0757575757575757;0.424242424242424
Control.SRR15539832;29;38;0.586206896551724;12;17;0.0862068965517241;0.413793103448276
Control.SRR15539832;38;38;0.578947368421053;16;22;0.0789473684210527;0.421052631578947
Control.SRR15539832;30;38;0.533333333333333;14;16;0.0333333333333333;0.466666666666667
Control.SRR15539832;31;38;0.451612903225806;17;14;0.0483870967741936;0.451612903225806
Control.SRR15539832;30;38;0.466666666666667;16;14;0.0333333333333333;0.466666666666667
Control.SRR15539832;34;38;0.529411764705882;16;18;0.0294117647058824;0.470588235294118
Control.SRR15539832;36;38;0.583333333333333;15;21;0.0833333333333334;0.416666666666667
Control.SRR15539832;36;38;0.583333333333333;15;21;0.0833333333333334;0.416666666666667
Control.SRR15539832;37;38;0.540540540540541;17;20;0.0405405405405406;0.459459459459459
Control.SRR15539832;32;38;0.375;20;12;0.125;0.375
Control.SRR15539832;33;38;0.393939393939394;20;13;0.106060606060606;0.393939393939394
Control.SRR15539832;30;38;0.266666666666667;22;8;0.233333333333333;0.266666666666667
Control.SRR15539832;38;38;0.473684210526316;20;18;0.0263157894736842;0.473684210526316
Control.SRR15539832;37;38;0.459459459459459;20;17;0.0405405405405405;0.459459459459459
Control.SRR15539832;31;38;0.354838709677419;20;11;0.145161290322581;0.354838709677419
Control.SRR15539832;36;38;0.527777777777778;17;19;0.0277777777777778;0.472222222222222
Control.SRR15539832;34;38;0.5;17;17;0;0.5
Control.SRR15539832;33;38;0.545454545454545;15;18;0.0454545454545454;0.454545454545455
Control.SRR15539832;34;38;0.558823529411765;15;19;0.0588235294117647;0.441176470588235
Control.SRR15539832;33;38;0.545454545454545;15;18;0.0454545454545454;0.454545454545455
Control.SRR15539832;30;38;0.466666666666667;16;14;0.0333333333333333;0.466666666666667
Control.SRR15539832;31;38;0.483870967741935;16;15;0.0161290322580645;0.483870967741935
Control.SRR15539832;37;38;0.378378378378378;23;14;0.121621621621622;0.378378378378378
Control.SRR15539832;31;38;0.548387096774194;14;17;0.0483870967741935;0.451612903225806
Control.SRR15539832;29;38;0.620689655172414;11;18;0.120689655172414;0.379310344827586
Control.SRR15539832;34;38;0.647058823529412;12;22;0.147058823529412;0.352941176470588
Control.SRR15539832;37;38;0.594594594594595;15;22;0.0945945945945946;0.405405405405405
Control.SRR15539832;38;38;0.5;19;19;0;0.5
Control.SRR15539832;29;38;0.482758620689655;15;14;0.0172413793103448;0.482758620689655
Control.SRR15539832;30;38;0.633333333333333;11;19;0.133333333333333;0.366666666666667
Control.SRR15539832;30;38;0.5;15;15;0;0.5
Control.SRR15539832;30;38;0.533333333333333;14;16;0.0333333333333333;0.466666666666667
Control.SRR15539832;32;38;0.625;12;20;0.125;0.375
Control.SRR15539832;37;38;0.567567567567568;16;21;0.0675675675675675;0.432432432432432
Control.SRR15539832;32;38;0.625;12;20;0.125;0.375
Control.SRR15539832;38;38;0.5;19;19;0;0.5
Control.SRR15539832;36;38;0.527777777777778;17;19;0.0277777777777778;0.472222222222222
Control.SRR15539832;37;38;0.540540540540541;17;20;0.0405405405405406;0.459459459459459
Control.SRR15539832;35;38;0.514285714285714;17;18;0.0142857142857142;0.485714285714286
Control.SRR15539832;37;38;0.459459459459459;20;17;0.0405405405405405;0.459459459459459
Control.SRR15539832;29;38;0.517241379310345;14;15;0.0172413793103449;0.482758620689655
Control.SRR15539832;35;38;0.657142857142857;12;23;0.157142857142857;0.342857142857143
Control.SRR15539832;29;38;0.379310344827586;18;11;0.120689655172414;0.379310344827586
Control.SRR15539832;40;38;0.375;25;15;0.125;0.375
Control.SRR15539832;39;38;0.487179487179487;20;19;0.0128205128205128;0.487179487179487
Control.SRR15539832;40;38;0.4;24;16;0.1;0.4
Control.SRR15539832;36;38;0.638888888888889;13;23;0.138888888888889;0.361111111111111
Control.SRR15539832;42;38;0.547619047619048;19;23;0.0476190476190477;0.452380952380952
Control.SRR15539832;44;38;0.477272727272727;23;21;0.0227272727272727;0.477272727272727
Control.SRR15539832;41;38;0.48780487804878;21;20;0.0121951219512195;0.48780487804878
Control.SRR15539832;38;38;0.315789473684211;26;12;0.184210526315789;0.315789473684211
Control.SRR15539832;35;38;0.457142857142857;19;16;0.0428571428571429;0.457142857142857
Control.SRR15539832;36;38;0.555555555555556;16;20;0.0555555555555556;0.444444444444444
Control.SRR15539832;45;38;0.533333333333333;21;24;0.0333333333333333;0.466666666666667
Control.SRR15539832;37;38;0.648648648648649;13;24;0.148648648648649;0.351351351351351
Control.SRR15539832;45;38;0.666666666666667;15;30;0.166666666666667;0.333333333333333
Control.SRR15539832;37;38;0.540540540540541;17;20;0.0405405405405406;0.459459459459459
Control.SRR15539832;45;38;0.444444444444444;25;20;0.0555555555555556;0.444444444444444
Control.SRR15539832;38;38;0.526315789473684;18;20;0.0263157894736842;0.473684210526316
Control.SRR15539832;42;38;0.452380952380952;23;19;0.0476190476190476;0.452380952380952
Control.SRR15539832;45;38;0.6;18;27;0.1;0.4
Control.SRR15539832;40;38;0.525;19;21;0.025;0.475
Control.SRR15539832;40;38;0.55;18;22;0.05;0.45
Control.SRR15539832;40;38;0.375;25;15;0.125;0.375
Control.SRR15539832;41;38;0.439024390243902;23;18;0.0609756097560976;0.439024390243902
Control.SRR15539832;38;38;0.552631578947368;17;21;0.0526315789473685;0.447368421052632
Control.SRR15539832;38;38;0.526315789473684;18;20;0.0263157894736842;0.473684210526316
Control.SRR15539832;37;38;0.540540540540541;17;20;0.0405405405405406;0.459459459459459
Control.SRR15539832;36;38;0.361111111111111;23;13;0.138888888888889;0.361111111111111
Control.SRR15539832;35;38;0.514285714285714;17;18;0.0142857142857142;0.485714285714286
Control.SRR15539832;42;38;0.595238095238095;17;25;0.0952380952380952;0.404761904761905
Control.SRR15539832;40;38;0.425;23;17;0.075;0.425
Control.SRR15539832;38;38;0.578947368421053;16;22;0.0789473684210527;0.421052631578947
Control.SRR15539832;43;38;0.488372093023256;22;21;0.0116279069767442;0.488372093023256
Control.SRR15539832;36;38;0.555555555555556;16;20;0.0555555555555556;0.444444444444444
Control.SRR15539832;42;38;0.428571428571429;24;18;0.0714285714285715;0.428571428571429
Control.SRR15539832;39;38;0.538461538461538;18;21;0.0384615384615384;0.461538461538462
Control.SRR15539832;35;38;0.514285714285714;17;18;0.0142857142857142;0.485714285714286
Control.SRR15539832;40;38;0.55;18;22;0.05;0.45
Control.SRR15539832;37;38;0.540540540540541;17;20;0.0405405405405406;0.459459459459459
Control.SRR15539832;43;38;0.581395348837209;18;25;0.0813953488372093;0.418604651162791
Control.SRR15539832;35;38;0.485714285714286;18;17;0.0142857142857143;0.485714285714286
Control.SRR15539832;36;38;0.527777777777778;17;19;0.0277777777777778;0.472222222222222
Control.SRR15539832;46;38;0.543478260869565;21;25;0.0434782608695652;0.456521739130435
Control.SRR15539832;41;38;0.536585365853659;19;22;0.0365853658536586;0.463414634146341
Control.SRR15539832;36;38;0.527777777777778;17;19;0.0277777777777778;0.472222222222222
Control.SRR15539832;37;38;0.594594594594595;15;22;0.0945945945945946;0.405405405405405
Control.SRR15539832;36;38;0.527777777777778;17;19;0.0277777777777778;0.472222222222222
Control.SRR15539832;37;38;0.486486486486487;19;18;0.0135135135135135;0.486486486486487
Control.SRR15539832;45;38;0.488888888888889;23;22;0.0111111111111111;0.488888888888889
Control.SRR15539832;38;38;0.5;19;19;0;0.5
Control.SRR15539832;37;38;0.540540540540541;17;20;0.0405405405405406;0.459459459459459
Control.SRR15539832;41;38;0.585365853658537;17;24;0.0853658536585366;0.414634146341463
Control.SRR15539832;35;38;0.457142857142857;19;16;0.0428571428571429;0.457142857142857
Control.SRR15539832;39;38;0.666666666666667;13;26;0.166666666666667;0.333333333333333
Control.SRR15539832;36;38;0.527777777777778;17;19;0.0277777777777778;0.472222222222222
Control.SRR15539832;38;38;0.447368421052632;21;17;0.0526315789473684;0.447368421052632
Control.SRR15539832;40;38;0.5;20;20;0;0.5
Control.SRR15539832;44;38;0.431818181818182;25;19;0.0681818181818182;0.431818181818182
Control.SRR15539832;40;38;0.45;22;18;0.05;0.45
Control.SRR15539832;43;38;0.674418604651163;14;29;0.174418604651163;0.325581395348837
Control.SRR15539832;40;38;0.575;17;23;0.075;0.425
Control.SRR15539832;45;38;0.466666666666667;24;21;0.0333333333333333;0.466666666666667
Control.SRR15539832;43;38;0.511627906976744;21;22;0.0116279069767442;0.488372093023256
Control.SRR15539832;35;38;0.428571428571429;20;15;0.0714285714285715;0.428571428571429
Control.SRR15539832;40;38;0.6;16;24;0.1;0.4
Control.SRR15539832;42;38;0.595238095238095;17;25;0.0952380952380952;0.404761904761905
Control.SRR15539832;46;38;0.543478260869565;21;25;0.0434782608695652;0.456521739130435
Control.SRR15539832;38;38;0.578947368421053;16;22;0.0789473684210527;0.421052631578947
Control.SRR15539832;38;38;0.552631578947368;17;21;0.0526315789473685;0.447368421052632
Control.SRR15539832;41;38;0.536585365853659;19;22;0.0365853658536586;0.463414634146341
Control.SRR15539832;39;38;0.615384615384615;15;24;0.115384615384615;0.384615384615385
Control.SRR15539832;37;38;0.567567567567568;16;21;0.0675675675675675;0.432432432432432
Control.SRR15539832;46;38;0.5;23;23;0;0.5
Control.SRR15539832;35;38;0.371428571428571;22;13;0.128571428571429;0.371428571428571
Control.SRR15539832;41;38;0.439024390243902;23;18;0.0609756097560976;0.439024390243902
Control.SRR15539832;36;38;0.638888888888889;13;23;0.138888888888889;0.361111111111111
Control.SRR15539832;38;38;0.342105263157895;25;13;0.157894736842105;0.342105263157895
Control.SRR15539832;36;38;0.527777777777778;17;19;0.0277777777777778;0.472222222222222
Control.SRR15539832;38;38;0.526315789473684;18;20;0.0263157894736842;0.473684210526316
Control.SRR15539832;46;38;0.5;23;23;0;0.5
Control.SRR15539832;42;38;0.547619047619048;19;23;0.0476190476190477;0.452380952380952
Control.SRR15539832;38;38;0.368421052631579;24;14;0.131578947368421;0.368421052631579
Control.SRR15539832;43;38;0.604651162790698;17;26;0.104651162790698;0.395348837209302
Control.SRR15539832;38;38;0.605263157894737;15;23;0.105263157894737;0.394736842105263
Control.SRR15539832;36;38;0.472222222222222;19;17;0.0277777777777778;0.472222222222222
Control.SRR15539832;38;38;0.473684210526316;20;18;0.0263157894736842;0.473684210526316
Control.SRR15539832;41;38;0.439024390243902;23;18;0.0609756097560976;0.439024390243902
Control.SRR15539832;40;38;0.5;20;20;0;0.5
Control.SRR15539832;36;38;0.416666666666667;21;15;0.0833333333333333;0.416666666666667
Control.SRR15539832;43;38;0.604651162790698;17;26;0.104651162790698;0.395348837209302
Control.SRR15539832;40;38;0.5;20;20;0;0.5
Control.SRR15539832;36;38;0.583333333333333;15;21;0.0833333333333334;0.416666666666667
Control.SRR15539832;37;38;0.594594594594595;15;22;0.0945945945945946;0.405405405405405
Control.SRR15539832;36;38;0.25;27;9;0.25;0.25
Control.SRR15539832;43;38;0.558139534883721;19;24;0.0581395348837209;0.441860465116279
Control.SRR15539832;36;38;0.583333333333333;15;21;0.0833333333333334;0.416666666666667
Control.SRR15539832;39;38;0.435897435897436;22;17;0.0641025641025641;0.435897435897436
Control.SRR15539832;38;38;0.578947368421053;16;22;0.0789473684210527;0.421052631578947
Control.SRR15539832;36;38;0.472222222222222;19;17;0.0277777777777778;0.472222222222222
Control.SRR15539832;35;38;0.542857142857143;16;19;0.0428571428571428;0.457142857142857
Control.SRR15539832;35;38;0.485714285714286;18;17;0.0142857142857143;0.485714285714286
Control.SRR15539832;46;38;0.456521739130435;25;21;0.0434782608695652;0.456521739130435
Control.SRR15539832;41;38;0.536585365853659;19;22;0.0365853658536586;0.463414634146341
Control.SRR15539832;37;38;0.648648648648649;13;24;0.148648648648649;0.351351351351351
Control.SRR15539832;37;38;0.540540540540541;17;20;0.0405405405405406;0.459459459459459
Control.SRR15539832;37;38;0.486486486486487;19;18;0.0135135135135135;0.486486486486487
Control.SRR15539832;41;38;0.414634146341463;24;17;0.0853658536585366;0.414634146341463
Control.SRR15539832;43;38;0.488372093023256;22;21;0.0116279069767442;0.488372093023256
Control.SRR15539832;42;38;0.5;21;21;0;0.5
Control.SRR15539832;40;38;0.35;26;14;0.15;0.35
Control.SRR15539832;45;38;0.488888888888889;23;22;0.0111111111111111;0.488888888888889
Control.SRR15539832;42;38;0.476190476190476;22;20;0.0238095238095238;0.476190476190476
Control.SRR15539832;40;38;0.4;24;16;0.1;0.4
Control.SRR15539832;35;38;0.485714285714286;18;17;0.0142857142857143;0.485714285714286
Control.SRR15539832;35;38;0.657142857142857;12;23;0.157142857142857;0.342857142857143
Control.SRR15539832;42;38;0.476190476190476;22;20;0.0238095238095238;0.476190476190476
Control.SRR15539832;37;38;0.405405405405405;22;15;0.0945945945945946;0.405405405405405
Control.SRR15539832;41;38;0.463414634146341;22;19;0.0365853658536585;0.463414634146341
Control.SRR15539832;44;38;0.636363636363636;16;28;0.136363636363636;0.363636363636364
Control.SRR15539832;40;38;0.4;24;16;0.1;0.4
Control.SRR15539832;42;38;0.452380952380952;23;19;0.0476190476190476;0.452380952380952
Control.SRR15539832;37;38;0.513513513513513;18;19;0.0135135135135135;0.486486486486487
Control.SRR15539832;38;38;0.552631578947368;17;21;0.0526315789473685;0.447368421052632
Control.SRR15539832;42;38;0.476190476190476;22;20;0.0238095238095238;0.476190476190476
Control.SRR15539832;44;38;0.431818181818182;25;19;0.0681818181818182;0.431818181818182
Control.SRR15539832;36;38;0.472222222222222;19;17;0.0277777777777778;0.472222222222222
Control.SRR15539832;36;38;0.472222222222222;19;17;0.0277777777777778;0.472222222222222
Control.SRR15539832;37;38;0.459459459459459;20;17;0.0405405405405405;0.459459459459459
Control.SRR15539832;46;38;0.347826086956522;30;16;0.152173913043478;0.347826086956522
Control.SRR15539832;35;38;0.514285714285714;17;18;0.0142857142857142;0.485714285714286
Control.SRR15539832;36;38;0.527777777777778;17;19;0.0277777777777778;0.472222222222222
Control.SRR15539832;36;38;0.555555555555556;16;20;0.0555555555555556;0.444444444444444
Control.SRR15539832;38;38;0.342105263157895;25;13;0.157894736842105;0.342105263157895
Control.SRR15539832;41;38;0.658536585365854;14;27;0.158536585365854;0.341463414634146
Control.SRR15539832;38;38;0.342105263157895;25;13;0.157894736842105;0.342105263157895
Control.SRR15539832;44;38;0.431818181818182;25;19;0.0681818181818182;0.431818181818182
Control.SRR15539832;37;38;0.432432432432432;21;16;0.0675675675675675;0.432432432432432
Control.SRR15539832;37;38;0.486486486486487;19;18;0.0135135135135135;0.486486486486487
Control.SRR15539832;37;38;0.648648648648649;13;24;0.148648648648649;0.351351351351351
Control.SRR15539832;43;38;0.581395348837209;18;25;0.0813953488372093;0.418604651162791
Control.SRR15539832;39;38;0.564102564102564;17;22;0.0641025641025641;0.435897435897436
Control.SRR15539832;37;38;0.567567567567568;16;21;0.0675675675675675;0.432432432432432
Control.SRR15539832;45;38;0.488888888888889;23;22;0.0111111111111111;0.488888888888889
Control.SRR15539832;45;38;0.533333333333333;21;24;0.0333333333333333;0.466666666666667
Control.SRR15539832;38;38;0.394736842105263;23;15;0.105263157894737;0.394736842105263
Control.SRR15539832;39;38;0.487179487179487;20;19;0.0128205128205128;0.487179487179487
Control.SRR15539832;36;38;0.361111111111111;23;13;0.138888888888889;0.361111111111111
Control.SRR15539832;37;38;0.513513513513513;18;19;0.0135135135135135;0.486486486486487
Control.SRR15539832;45;38;0.511111111111111;22;23;0.0111111111111111;0.488888888888889
Control.SRR15539832;37;38;0.567567567567568;16;21;0.0675675675675675;0.432432432432432
Control.SRR15539832;37;38;0.405405405405405;22;15;0.0945945945945946;0.405405405405405
Control.SRR15539832;46;38;0.58695652173913;19;27;0.0869565217391305;0.41304347826087
Control.SRR15539832;36;38;0.472222222222222;19;17;0.0277777777777778;0.472222222222222
Control.SRR15539832;42;38;0.5;21;21;0;0.5
Control.SRR15539832;36;38;0.472222222222222;19;17;0.0277777777777778;0.472222222222222
Control.SRR15539832;36;38;0.416666666666667;21;15;0.0833333333333333;0.416666666666667
Control.SRR15539832;37;38;0.432432432432432;21;16;0.0675675675675675;0.432432432432432
Control.SRR15539832;36;38;0.5;18;18;0;0.5
Control.SRR15539832;43;38;0.511627906976744;21;22;0.0116279069767442;0.488372093023256
Control.SRR15539832;39;38;0.615384615384615;15;24;0.115384615384615;0.384615384615385
Control.SRR15539832;45;38;0.488888888888889;23;22;0.0111111111111111;0.488888888888889
Control.SRR15539832;39;38;0.461538461538462;21;18;0.0384615384615384;0.461538461538462
Control.SRR15539832;46;38;0.478260869565217;24;22;0.0217391304347826;0.478260869565217
Control.SRR15539832;40;38;0.35;26;14;0.15;0.35
Control.SRR15539832;36;38;0.361111111111111;23;13;0.138888888888889;0.361111111111111
Control.SRR15539832;35;38;0.428571428571429;20;15;0.0714285714285715;0.428571428571429
Control.SRR15539832;36;38;0.388888888888889;22;14;0.111111111111111;0.388888888888889
Control.SRR15539832;41;38;0.463414634146341;22;19;0.0365853658536585;0.463414634146341
Control.SRR15539832;38;38;0.631578947368421;14;24;0.131578947368421;0.368421052631579
Control.SRR15539832;38;38;0.552631578947368;17;21;0.0526315789473685;0.447368421052632
Control.SRR15539832;45;38;0.555555555555556;20;25;0.0555555555555556;0.444444444444444
Control.SRR15539832;39;38;0.615384615384615;15;24;0.115384615384615;0.384615384615385
Control.SRR15539832;37;38;0.513513513513513;18;19;0.0135135135135135;0.486486486486487
Control.SRR15539832;39;38;0.435897435897436;22;17;0.0641025641025641;0.435897435897436
Control.SRR15539832;44;38;0.5;22;22;0;0.5
Control.SRR15539832;40;38;0.4;24;16;0.1;0.4
Control.SRR15539832;41;38;0.536585365853659;19;22;0.0365853658536586;0.463414634146341
Control.SRR15539832;41;38;0.609756097560976;16;25;0.109756097560976;0.390243902439024
Control.SRR15539832;36;38;0.555555555555556;16;20;0.0555555555555556;0.444444444444444
Control.SRR15539832;44;38;0.454545454545455;24;20;0.0454545454545455;0.454545454545455
Control.SRR15539832;41;38;0.365853658536585;26;15;0.134146341463415;0.365853658536585
Control.SRR15539832;41;38;0.560975609756098;18;23;0.0609756097560976;0.439024390243902
Control.SRR15539832;38;38;0.552631578947368;17;21;0.0526315789473685;0.447368421052632
Control.SRR15539832;35;38;0.485714285714286;18;17;0.0142857142857143;0.485714285714286
Control.SRR15539832;37;38;0.459459459459459;20;17;0.0405405405405405;0.459459459459459
Control.SRR15539832;43;38;0.465116279069767;23;20;0.0348837209302326;0.465116279069767
Control.SRR15539832;39;38;0.538461538461538;18;21;0.0384615384615384;0.461538461538462
Control.SRR15539832;41;38;0.414634146341463;24;17;0.0853658536585366;0.414634146341463
Control.SRR15539832;37;38;0.702702702702703;11;26;0.202702702702703;0.297297297297297
Control.SRR15539832;41;38;0.51219512195122;20;21;0.0121951219512195;0.48780487804878
Control.SRR15539832;38;38;0.631578947368421;14;24;0.131578947368421;0.368421052631579
Control.SRR15539832;39;38;0.41025641025641;23;16;0.0897435897435898;0.41025641025641
Control.SRR15539832;44;38;0.568181818181818;19;25;0.0681818181818182;0.431818181818182
Control.SRR15539832;36;38;0.638888888888889;13;23;0.138888888888889;0.361111111111111
Control.SRR15539832;36;38;0.472222222222222;19;17;0.0277777777777778;0.472222222222222
Control.SRR15539832;40;38;0.6;16;24;0.1;0.4
Control.SRR15539832;38;38;0.394736842105263;23;15;0.105263157894737;0.394736842105263
Control.SRR15539832;44;38;0.659090909090909;15;29;0.159090909090909;0.340909090909091
Control.SRR15539832;35;38;0.628571428571429;13;22;0.128571428571429;0.371428571428571
Control.SRR15539832;38;38;0.657894736842105;13;25;0.157894736842105;0.342105263157895
Control.SRR15539832;37;38;0.513513513513513;18;19;0.0135135135135135;0.486486486486487
Control.SRR15539832;39;38;0.538461538461538;18;21;0.0384615384615384;0.461538461538462
Control.SRR15539832;43;38;0.534883720930233;20;23;0.0348837209302325;0.465116279069767
Control.SRR15539832;43;38;0.511627906976744;21;22;0.0116279069767442;0.488372093023256
Control.SRR15539832;35;38;0.657142857142857;12;23;0.157142857142857;0.342857142857143
Control.SRR15539832;39;38;0.435897435897436;22;17;0.0641025641025641;0.435897435897436
Control.SRR15539832;38;38;0.526315789473684;18;20;0.0263157894736842;0.473684210526316
Control.SRR15539832;40;38;0.425;23;17;0.075;0.425
Control.SRR15539832;38;38;0.657894736842105;13;25;0.157894736842105;0.342105263157895
Control.SRR15539832;38;38;0.394736842105263;23;15;0.105263157894737;0.394736842105263
Control.SRR15539832;42;38;0.428571428571429;24;18;0.0714285714285715;0.428571428571429
Control.SRR15539832;37;38;0.621621621621622;14;23;0.121621621621622;0.378378378378378
Control.SRR15539832;42;38;0.452380952380952;23;19;0.0476190476190476;0.452380952380952
Control.SRR15539832;45;38;0.422222222222222;26;19;0.0777777777777778;0.422222222222222
Control.SRR15539832;35;38;0.571428571428571;15;20;0.0714285714285714;0.428571428571429
Control.SRR15539832;41;38;0.414634146341463;24;17;0.0853658536585366;0.414634146341463
Control.SRR15539832;38;38;0.5;19;19;0;0.5
Control.SRR15539832;39;38;0.487179487179487;20;19;0.0128205128205128;0.487179487179487
Control.SRR15539832;37;38;0.486486486486487;19;18;0.0135135135135135;0.486486486486487
Control.SRR15539832;35;38;0.4;21;14;0.1;0.4
Control.SRR15539832;39;38;0.435897435897436;22;17;0.0641025641025641;0.435897435897436
Control.SRR15539832;46;38;0.543478260869565;21;25;0.0434782608695652;0.456521739130435
Control.SRR15539832;37;38;0.432432432432432;21;16;0.0675675675675675;0.432432432432432
Control.SRR15539832;35;38;0.542857142857143;16;19;0.0428571428571428;0.457142857142857
Control.SRR15539832;37;38;0.621621621621622;14;23;0.121621621621622;0.378378378378378
Control.SRR15539832;38;38;0.526315789473684;18;20;0.0263157894736842;0.473684210526316
Control.SRR15539832;38;38;0.473684210526316;20;18;0.0263157894736842;0.473684210526316
Control.SRR15539832;40;38;0.5;20;20;0;0.5
Control.SRR15539832;45;38;0.533333333333333;21;24;0.0333333333333333;0.466666666666667
Control.SRR15539832;46;38;0.391304347826087;28;18;0.108695652173913;0.391304347826087
Control.SRR15539832;43;38;0.441860465116279;24;19;0.0581395348837209;0.441860465116279
Control.SRR15539832;36;38;0.638888888888889;13;23;0.138888888888889;0.361111111111111
Control.SRR15539832;39;38;0.461538461538462;21;18;0.0384615384615384;0.461538461538462
Control.SRR15539832;35;38;0.628571428571429;13;22;0.128571428571429;0.371428571428571
Control.SRR15539832;37;38;0.540540540540541;17;20;0.0405405405405406;0.459459459459459
Control.SRR15539832;37;38;0.675675675675676;12;25;0.175675675675676;0.324324324324324
Control.SRR15539832;36;38;0.527777777777778;17;19;0.0277777777777778;0.472222222222222
Control.SRR15539832;35;38;0.485714285714286;18;17;0.0142857142857143;0.485714285714286
Control.SRR15539832;36;38;0.638888888888889;13;23;0.138888888888889;0.361111111111111
Control.SRR15539832;35;38;0.514285714285714;17;18;0.0142857142857142;0.485714285714286
Control.SRR15539832;36;38;0.555555555555556;16;20;0.0555555555555556;0.444444444444444
Control.SRR15539832;45;38;0.6;18;27;0.1;0.4
Control.SRR15539832;40;38;0.575;17;23;0.075;0.425
Control.SRR15539832;42;38;0.523809523809524;20;22;0.0238095238095238;0.476190476190476
Control.SRR15539832;43;38;0.395348837209302;26;17;0.104651162790698;0.395348837209302
Control.SRR15539832;37;38;0.459459459459459;20;17;0.0405405405405405;0.459459459459459
Control.SRR15539832;36;38;0.527777777777778;17;19;0.0277777777777778;0.472222222222222
Control.SRR15539832;36;38;0.305555555555556;25;11;0.194444444444444;0.305555555555556
Control.SRR15539832;45;38;0.488888888888889;23;22;0.0111111111111111;0.488888888888889
Control.SRR15539832;38;38;0.421052631578947;22;16;0.0789473684210527;0.421052631578947
Control.SRR15539832;35;38;0.4;21;14;0.1;0.4
Control.SRR15539832;37;38;0.594594594594595;15;22;0.0945945945945946;0.405405405405405
Control.SRR15539832;36;38;0.583333333333333;15;21;0.0833333333333334;0.416666666666667
Control.SRR15539832;36;38;0.5;18;18;0;0.5
Control.SRR15539832;43;38;0.581395348837209;18;25;0.0813953488372093;0.418604651162791
Control.SRR15539832;37;38;0.486486486486487;19;18;0.0135135135135135;0.486486486486487
Control.SRR15539832;40;38;0.55;18;22;0.05;0.45
Control.SRR15539832;38;38;0.552631578947368;17;21;0.0526315789473685;0.447368421052632
Control.SRR15539832;37;38;0.567567567567568;16;21;0.0675675675675675;0.432432432432432
Control.SRR15539832;35;38;0.542857142857143;16;19;0.0428571428571428;0.457142857142857
Control.SRR15539832;38;38;0.473684210526316;20;18;0.0263157894736842;0.473684210526316
Control.SRR15539832;40;38;0.575;17;23;0.075;0.425
Control.SRR15539832;46;38;0.630434782608696;17;29;0.130434782608696;0.369565217391304
Control.SRR15539832;37;38;0.621621621621622;14;23;0.121621621621622;0.378378378378378
Control.SRR15539832;40;38;0.575;17;23;0.075;0.425
Control.SRR15539832;39;38;0.512820512820513;19;20;0.0128205128205128;0.487179487179487
Control.SRR15539832;37;38;0.486486486486487;19;18;0.0135135135135135;0.486486486486487
Control.SRR15539832;37;38;0.621621621621622;14;23;0.121621621621622;0.378378378378378
Control.SRR15539832;38;38;0.289473684210526;27;11;0.210526315789474;0.289473684210526
Control.SRR15539832;38;38;0.368421052631579;24;14;0.131578947368421;0.368421052631579
Control.SRR15539832;43;38;0.511627906976744;21;22;0.0116279069767442;0.488372093023256
Control.SRR15539832;37;38;0.378378378378378;23;14;0.121621621621622;0.378378378378378
Control.SRR15539832;45;38;0.466666666666667;24;21;0.0333333333333333;0.466666666666667
Control.SRR15539832;39;38;0.487179487179487;20;19;0.0128205128205128;0.487179487179487
Control.SRR15539832;36;38;0.388888888888889;22;14;0.111111111111111;0.388888888888889
Control.SRR15539832;41;38;0.463414634146341;22;19;0.0365853658536585;0.463414634146341
Control.SRR15539832;37;38;0.459459459459459;20;17;0.0405405405405405;0.459459459459459
Control.SRR15539832;41;38;0.317073170731707;28;13;0.182926829268293;0.317073170731707
Control.SRR15539832;38;38;0.605263157894737;15;23;0.105263157894737;0.394736842105263
Control.SRR15539832;38;38;0.473684210526316;20;18;0.0263157894736842;0.473684210526316
Control.SRR15539832;35;38;0.428571428571429;20;15;0.0714285714285715;0.428571428571429
Control.SRR15539832;35;38;0.428571428571429;20;15;0.0714285714285715;0.428571428571429
Control.SRR15539832;46;38;0.434782608695652;26;20;0.0652173913043478;0.434782608695652
Control.SRR15539832;40;38;0.575;17;23;0.075;0.425
Control.SRR15539832;42;38;0.595238095238095;17;25;0.0952380952380952;0.404761904761905
Control.SRR15539832;41;38;0.585365853658537;17;24;0.0853658536585366;0.414634146341463
Control.SRR15539832;38;38;0.526315789473684;18;20;0.0263157894736842;0.473684210526316
Control.SRR15539832;40;38;0.45;22;18;0.05;0.45
Control.SRR15539832;39;38;0.512820512820513;19;20;0.0128205128205128;0.487179487179487
Control.SRR15539832;40;38;0.525;19;21;0.025;0.475
Control.SRR15539832;37;38;0.567567567567568;16;21;0.0675675675675675;0.432432432432432
Control.SRR15539832;41;38;0.390243902439024;25;16;0.109756097560976;0.390243902439024
Control.SRR15539832;41;38;0.585365853658537;17;24;0.0853658536585366;0.414634146341463
Control.SRR15539832;36;38;0.361111111111111;23;13;0.138888888888889;0.361111111111111
Control.SRR15539832;35;38;0.485714285714286;18;17;0.0142857142857143;0.485714285714286
Control.SRR15539832;41;38;0.585365853658537;17;24;0.0853658536585366;0.414634146341463
Control.SRR15539832;40;38;0.425;23;17;0.075;0.425
Control.SRR15539832;38;38;0.578947368421053;16;22;0.0789473684210527;0.421052631578947
Control.SRR15539832;38;38;0.526315789473684;18;20;0.0263157894736842;0.473684210526316
Control.SRR15539832;44;38;0.454545454545455;24;20;0.0454545454545455;0.454545454545455
Control.SRR15539832;45;38;0.533333333333333;21;24;0.0333333333333333;0.466666666666667
Control.SRR15539832;41;38;0.560975609756098;18;23;0.0609756097560976;0.439024390243902
Control.SRR15539832;43;38;0.441860465116279;24;19;0.0581395348837209;0.441860465116279
Control.SRR15539832;41;38;0.341463414634146;27;14;0.158536585365854;0.341463414634146
Control.SRR15539832;41;38;0.439024390243902;23;18;0.0609756097560976;0.439024390243902
Control.SRR15539832;35;38;0.542857142857143;16;19;0.0428571428571428;0.457142857142857
Control.SRR15539832;41;38;0.365853658536585;26;15;0.134146341463415;0.365853658536585
Control.SRR15539832;43;38;0.395348837209302;26;17;0.104651162790698;0.395348837209302
Control.SRR15539832;43;38;0.581395348837209;18;25;0.0813953488372093;0.418604651162791
Control.SRR15539832;40;38;0.575;17;23;0.075;0.425
Control.SRR15539832;38;38;0.421052631578947;22;16;0.0789473684210527;0.421052631578947
Control.SRR15539832;38;38;0.447368421052632;21;17;0.0526315789473684;0.447368421052632
Control.SRR15539832;36;38;0.5;18;18;0;0.5
Control.SRR15539832;37;38;0.405405405405405;22;15;0.0945945945945946;0.405405405405405
Control.SRR15539832;40;38;0.55;18;22;0.05;0.45
Control.SRR15539832;38;38;0.394736842105263;23;15;0.105263157894737;0.394736842105263
Control.SRR15539832;40;38;0.625;15;25;0.125;0.375
Control.SRR15539832;35;38;0.542857142857143;16;19;0.0428571428571428;0.457142857142857
Control.SRR15539832;35;38;0.4;21;14;0.1;0.4
Control.SRR15539832;43;38;0.511627906976744;21;22;0.0116279069767442;0.488372093023256
Control.SRR15539832;39;38;0.435897435897436;22;17;0.0641025641025641;0.435897435897436
Control.SRR15539832;40;38;0.55;18;22;0.05;0.45
Control.SRR15539832;41;38;0.609756097560976;16;25;0.109756097560976;0.390243902439024
Control.SRR15539832;40;38;0.525;19;21;0.025;0.475
Control.SRR15539832;36;38;0.416666666666667;21;15;0.0833333333333333;0.416666666666667
Control.SRR15539832;39;38;0.41025641025641;23;16;0.0897435897435898;0.41025641025641
Control.SRR15539832;38;38;0.473684210526316;20;18;0.0263157894736842;0.473684210526316
Control.SRR15539832;46;38;0.543478260869565;21;25;0.0434782608695652;0.456521739130435
Control.SRR15539832;41;38;0.560975609756098;18;23;0.0609756097560976;0.439024390243902
Control.SRR15539832;40;38;0.7;12;28;0.2;0.3
Control.SRR15539832;36;38;0.611111111111111;14;22;0.111111111111111;0.388888888888889
Control.SRR15539832;35;38;0.628571428571429;13;22;0.128571428571429;0.371428571428571
Control.SRR15539832;44;38;0.5;22;22;0;0.5
Control.SRR15539832;40;38;0.375;25;15;0.125;0.375
Control.SRR15539832;35;38;0.6;14;21;0.1;0.4
Control.SRR15539832;45;38;0.577777777777778;19;26;0.0777777777777777;0.422222222222222
Control.SRR15539832;39;38;0.641025641025641;14;25;0.141025641025641;0.358974358974359
Control.SRR15539832;37;38;0.567567567567568;16;21;0.0675675675675675;0.432432432432432
Control.SRR15539832;43;38;0.627906976744186;16;27;0.127906976744186;0.372093023255814
Control.SRR15539832;45;38;0.511111111111111;22;23;0.0111111111111111;0.488888888888889
Control.SRR15539832;44;38;0.5;22;22;0;0.5
Control.SRR15539832;45;38;0.533333333333333;21;24;0.0333333333333333;0.466666666666667
Control.SRR15539832;38;38;0.473684210526316;20;18;0.0263157894736842;0.473684210526316
Control.SRR15539832;38;38;0.684210526315789;12;26;0.184210526315789;0.315789473684211
Control.SRR15539832;42;38;0.452380952380952;23;19;0.0476190476190476;0.452380952380952
Control.SRR15539832;41;38;0.536585365853659;19;22;0.0365853658536586;0.463414634146341
Control.SRR15539832;41;38;0.560975609756098;18;23;0.0609756097560976;0.439024390243902
Control.SRR15539832;36;38;0.555555555555556;16;20;0.0555555555555556;0.444444444444444
Control.SRR15539832;45;38;0.444444444444444;25;20;0.0555555555555556;0.444444444444444
Control.SRR15539832;38;38;0.315789473684211;26;12;0.184210526315789;0.315789473684211
Control.SRR15539832;38;38;0.526315789473684;18;20;0.0263157894736842;0.473684210526316
Control.SRR15539832;44;38;0.431818181818182;25;19;0.0681818181818182;0.431818181818182
Control.SRR15539832;39;38;0.435897435897436;22;17;0.0641025641025641;0.435897435897436
Control.SRR15539832;42;38;0.404761904761905;25;17;0.0952380952380952;0.404761904761905
Control.SRR15539832;44;38;0.477272727272727;23;21;0.0227272727272727;0.477272727272727
Control.SRR15539832;41;38;0.609756097560976;16;25;0.109756097560976;0.390243902439024
Control.SRR15539832;44;38;0.431818181818182;25;19;0.0681818181818182;0.431818181818182
Control.SRR15539832;37;38;0.513513513513513;18;19;0.0135135135135135;0.486486486486487
Control.SRR15539832;41;38;0.439024390243902;23;18;0.0609756097560976;0.439024390243902
Control.SRR15539832;43;38;0.534883720930233;20;23;0.0348837209302325;0.465116279069767
Control.SRR15539832;46;38;0.565217391304348;20;26;0.0652173913043478;0.434782608695652
Control.SRR15539832;36;38;0.555555555555556;16;20;0.0555555555555556;0.444444444444444
Control.SRR15539832;45;38;0.4;27;18;0.1;0.4
Control.SRR15539832;42;38;0.428571428571429;24;18;0.0714285714285715;0.428571428571429
Control.SRR15539832;41;38;0.536585365853659;19;22;0.0365853658536586;0.463414634146341
Control.SRR15539832;37;38;0.540540540540541;17;20;0.0405405405405406;0.459459459459459
Control.SRR15539832;45;38;0.333333333333333;30;15;0.166666666666667;0.333333333333333
Control.SRR15539832;36;38;0.583333333333333;15;21;0.0833333333333334;0.416666666666667
Control.SRR15539832;44;38;0.454545454545455;24;20;0.0454545454545455;0.454545454545455
Control.SRR15539832;39;38;0.538461538461538;18;21;0.0384615384615384;0.461538461538462
Control.SRR15539832;41;38;0.414634146341463;24;17;0.0853658536585366;0.414634146341463
Control.SRR15539832;45;38;0.6;18;27;0.1;0.4
Control.SRR15539832;38;38;0.315789473684211;26;12;0.184210526315789;0.315789473684211
Control.SRR15539832;43;38;0.511627906976744;21;22;0.0116279069767442;0.488372093023256
Control.SRR15539832;35;38;0.457142857142857;19;16;0.0428571428571429;0.457142857142857
Control.SRR15539832;38;38;0.578947368421053;16;22;0.0789473684210527;0.421052631578947
Control.SRR15539832;44;38;0.431818181818182;25;19;0.0681818181818182;0.431818181818182
Control.SRR15539832;44;38;0.545454545454545;20;24;0.0454545454545454;0.454545454545455
Control.SRR15539832;40;38;0.5;20;20;0;0.5
Control.SRR15539832;45;38;0.466666666666667;24;21;0.0333333333333333;0.466666666666667
Control.SRR15539832;35;38;0.428571428571429;20;15;0.0714285714285715;0.428571428571429
Control.SRR15539832;39;38;0.384615384615385;24;15;0.115384615384615;0.384615384615385
Control.SRR15539832;42;38;0.523809523809524;20;22;0.0238095238095238;0.476190476190476
Control.SRR15539832;36;38;0.472222222222222;19;17;0.0277777777777778;0.472222222222222
Control.SRR15539832;35;38;0.342857142857143;23;12;0.157142857142857;0.342857142857143
Control.SRR15539832;36;38;0.5;18;18;0;0.5
Control.SRR15539832;42;38;0.428571428571429;24;18;0.0714285714285715;0.428571428571429
Control.SRR15539832;35;38;0.457142857142857;19;16;0.0428571428571429;0.457142857142857
Control.SRR15539832;44;38;0.636363636363636;16;28;0.136363636363636;0.363636363636364
Control.SRR15539832;37;38;0.486486486486487;19;18;0.0135135135135135;0.486486486486487
Control.SRR15539832;45;38;0.511111111111111;22;23;0.0111111111111111;0.488888888888889
Control.SRR15539832;41;38;0.51219512195122;20;21;0.0121951219512195;0.48780487804878
Control.SRR15539832;44;38;0.454545454545455;24;20;0.0454545454545455;0.454545454545455
Control.SRR15539832;45;38;0.577777777777778;19;26;0.0777777777777777;0.422222222222222
Control.SRR15539832;41;38;0.414634146341463;24;17;0.0853658536585366;0.414634146341463
Control.SRR15539832;42;38;0.476190476190476;22;20;0.0238095238095238;0.476190476190476
Control.SRR15539832;45;38;0.666666666666667;15;30;0.166666666666667;0.333333333333333
Control.SRR15539832;42;38;0.547619047619048;19;23;0.0476190476190477;0.452380952380952
Control.SRR15539832;43;38;0.395348837209302;26;17;0.104651162790698;0.395348837209302
Control.SRR15539832;36;38;0.5;18;18;0;0.5
Control.SRR15539832;39;38;0.512820512820513;19;20;0.0128205128205128;0.487179487179487
Control.SRR15539832;44;38;0.522727272727273;21;23;0.0227272727272727;0.477272727272727
Control.SRR15539832;42;38;0.571428571428571;18;24;0.0714285714285714;0.428571428571429
Control.SRR15539832;36;38;0.583333333333333;15;21;0.0833333333333334;0.416666666666667
Control.SRR15539832;45;38;0.533333333333333;21;24;0.0333333333333333;0.466666666666667
Control.SRR15539832;38;38;0.526315789473684;18;20;0.0263157894736842;0.473684210526316
Control.SRR15539832;38;38;0.394736842105263;23;15;0.105263157894737;0.394736842105263
Control.SRR15539832;39;38;0.384615384615385;24;15;0.115384615384615;0.384615384615385
Control.SRR15539832;43;38;0.581395348837209;18;25;0.0813953488372093;0.418604651162791
Control.SRR15539832;40;38;0.35;26;14;0.15;0.35
Control.SRR15539832;41;38;0.414634146341463;24;17;0.0853658536585366;0.414634146341463
Control.SRR15539832;40;38;0.575;17;23;0.075;0.425
Control.SRR15539832;37;38;0.594594594594595;15;22;0.0945945945945946;0.405405405405405
Control.SRR15539832;35;38;0.542857142857143;16;19;0.0428571428571428;0.457142857142857
Control.SRR15539832;42;38;0.666666666666667;14;28;0.166666666666667;0.333333333333333
Control.SRR15539832;45;38;0.466666666666667;24;21;0.0333333333333333;0.466666666666667
Control.SRR15539832;42;38;0.452380952380952;23;19;0.0476190476190476;0.452380952380952
Control.SRR15539832;36;38;0.333333333333333;24;12;0.166666666666667;0.333333333333333
Control.SRR15539832;44;38;0.431818181818182;25;19;0.0681818181818182;0.431818181818182
Control.SRR15539832;40;38;0.525;19;21;0.025;0.475
Control.SRR15539832;39;38;0.435897435897436;22;17;0.0641025641025641;0.435897435897436
Control.SRR15539832;42;38;0.380952380952381;26;16;0.119047619047619;0.380952380952381
Control.SRR15539832;42;38;0.5;21;21;0;0.5
Control.SRR15539832;40;38;0.5;20;20;0;0.5
Control.SRR15539832;42;38;0.619047619047619;16;26;0.119047619047619;0.380952380952381
Control.SRR15539832;38;38;0.526315789473684;18;20;0.0263157894736842;0.473684210526316
Control.SRR15539832;40;38;0.55;18;22;0.05;0.45
Control.SRR15539832;44;38;0.568181818181818;19;25;0.0681818181818182;0.431818181818182
Control.SRR15539832;36;38;0.555555555555556;16;20;0.0555555555555556;0.444444444444444
Control.SRR15539832;36;38;0.5;18;18;0;0.5
Control.SRR15539832;39;38;0.435897435897436;22;17;0.0641025641025641;0.435897435897436
Control.SRR15539832;42;38;0.571428571428571;18;24;0.0714285714285714;0.428571428571429
Control.SRR15539832;37;38;0.567567567567568;16;21;0.0675675675675675;0.432432432432432
Control.SRR15539832;39;38;0.564102564102564;17;22;0.0641025641025641;0.435897435897436
Control.SRR15539832;38;38;0.447368421052632;21;17;0.0526315789473684;0.447368421052632
Control.SRR15539832;40;38;0.425;23;17;0.075;0.425
Control.SRR15539832;43;38;0.348837209302326;28;15;0.151162790697674;0.348837209302326
Control.SRR15539832;40;38;0.55;18;22;0.05;0.45
Control.SRR15539832;44;38;0.431818181818182;25;19;0.0681818181818182;0.431818181818182
Control.SRR15539832;43;38;0.465116279069767;23;20;0.0348837209302326;0.465116279069767
Control.SRR15539832;40;38;0.5;20;20;0;0.5
Control.SRR15539832;40;38;0.675;13;27;0.175;0.325
Control.SRR15539832;39;38;0.487179487179487;20;19;0.0128205128205128;0.487179487179487
Control.SRR15539832;38;38;0.578947368421053;16;22;0.0789473684210527;0.421052631578947
Control.SRR15539832;39;38;0.487179487179487;20;19;0.0128205128205128;0.487179487179487
Control.SRR15539832;43;38;0.651162790697674;15;28;0.151162790697674;0.348837209302326
Control.SRR15539832;42;38;0.523809523809524;20;22;0.0238095238095238;0.476190476190476
Control.SRR15539832;41;38;0.51219512195122;20;21;0.0121951219512195;0.48780487804878
Control.SRR15539832;43;38;0.581395348837209;18;25;0.0813953488372093;0.418604651162791
Control.SRR15539832;46;38;0.58695652173913;19;27;0.0869565217391305;0.41304347826087
Control.SRR15539832;43;38;0.465116279069767;23;20;0.0348837209302326;0.465116279069767
Control.SRR15539832;41;38;0.609756097560976;16;25;0.109756097560976;0.390243902439024
Control.SRR15539832;45;38;0.444444444444444;25;20;0.0555555555555556;0.444444444444444
Control.SRR15539832;42;38;0.595238095238095;17;25;0.0952380952380952;0.404761904761905
Control.SRR15539832;42;38;0.69047619047619;13;29;0.19047619047619;0.30952380952381
Control.SRR15539832;41;38;0.560975609756098;18;23;0.0609756097560976;0.439024390243902
Control.SRR15539832;35;38;0.457142857142857;19;16;0.0428571428571429;0.457142857142857
Control.SRR15539832;35;38;0.485714285714286;18;17;0.0142857142857143;0.485714285714286
Control.SRR15539832;36;38;0.527777777777778;17;19;0.0277777777777778;0.472222222222222
Control.SRR15539832;41;38;0.51219512195122;20;21;0.0121951219512195;0.48780487804878
Control.SRR15539832;37;38;0.567567567567568;16;21;0.0675675675675675;0.432432432432432
Control.SRR15539832;37;38;0.459459459459459;20;17;0.0405405405405405;0.459459459459459
Control.SRR15539832;43;38;0.418604651162791;25;18;0.0813953488372093;0.418604651162791
Control.SRR15539832;37;38;0.459459459459459;20;17;0.0405405405405405;0.459459459459459
Control.SRR15539832;44;38;0.454545454545455;24;20;0.0454545454545455;0.454545454545455
Control.SRR15539832;43;38;0.418604651162791;25;18;0.0813953488372093;0.418604651162791
Control.SRR15539832;35;38;0.571428571428571;15;20;0.0714285714285714;0.428571428571429
Control.SRR15539832;37;38;0.675675675675676;12;25;0.175675675675676;0.324324324324324
Control.SRR15539832;38;38;0.394736842105263;23;15;0.105263157894737;0.394736842105263
Control.SRR15539832;43;38;0.534883720930233;20;23;0.0348837209302325;0.465116279069767
Control.SRR15539832;39;38;0.384615384615385;24;15;0.115384615384615;0.384615384615385
Control.SRR15539832;42;38;0.619047619047619;16;26;0.119047619047619;0.380952380952381
Control.SRR15539832;42;38;0.571428571428571;18;24;0.0714285714285714;0.428571428571429
Control.SRR15539832;40;38;0.6;16;24;0.1;0.4
Control.SRR15539832;39;38;0.461538461538462;21;18;0.0384615384615384;0.461538461538462
Control.SRR15539832;42;38;0.571428571428571;18;24;0.0714285714285714;0.428571428571429
Control.SRR15539832;35;38;0.314285714285714;24;11;0.185714285714286;0.314285714285714
Control.SRR15539832;36;38;0.611111111111111;14;22;0.111111111111111;0.388888888888889
Control.SRR15539832;35;38;0.457142857142857;19;16;0.0428571428571429;0.457142857142857
Control.SRR15539832;39;38;0.564102564102564;17;22;0.0641025641025641;0.435897435897436
Control.SRR15539832;40;38;0.425;23;17;0.075;0.425
Control.SRR15539832;41;38;0.48780487804878;21;20;0.0121951219512195;0.48780487804878
Control.SRR15539832;46;38;0.456521739130435;25;21;0.0434782608695652;0.456521739130435
Control.SRR15539832;41;38;0.463414634146341;22;19;0.0365853658536585;0.463414634146341
Control.SRR15539832;38;38;0.421052631578947;22;16;0.0789473684210527;0.421052631578947
Control.SRR15539832;40;38;0.45;22;18;0.05;0.45
Control.SRR15539832;40;38;0.475;21;19;0.025;0.475
Control.SRR15539832;46;38;0.456521739130435;25;21;0.0434782608695652;0.456521739130435
Control.SRR15539832;36;38;0.527777777777778;17;19;0.0277777777777778;0.472222222222222
Control.SRR15539832;35;38;0.685714285714286;11;24;0.185714285714286;0.314285714285714
Control.SRR15539832;43;38;0.627906976744186;16;27;0.127906976744186;0.372093023255814
Control.SRR15539832;44;38;0.477272727272727;23;21;0.0227272727272727;0.477272727272727
Control.SRR15539832;45;38;0.444444444444444;25;20;0.0555555555555556;0.444444444444444
Control.SRR15539832;43;38;0.441860465116279;24;19;0.0581395348837209;0.441860465116279
Control.SRR15539832;39;38;0.461538461538462;21;18;0.0384615384615384;0.461538461538462
Control.SRR15539832;39;38;0.512820512820513;19;20;0.0128205128205128;0.487179487179487
Control.SRR15539832;45;38;0.555555555555556;20;25;0.0555555555555556;0.444444444444444
Control.SRR15539832;37;38;0.675675675675676;12;25;0.175675675675676;0.324324324324324
Control.SRR15539832;37;38;0.459459459459459;20;17;0.0405405405405405;0.459459459459459
Control.SRR15539832;40;38;0.575;17;23;0.075;0.425
Control.SRR15539832;43;38;0.372093023255814;27;16;0.127906976744186;0.372093023255814
Control.SRR15539832;40;38;0.525;19;21;0.025;0.475
Control.SRR15539832;40;38;0.5;20;20;0;0.5
Control.SRR15539832;39;38;0.538461538461538;18;21;0.0384615384615384;0.461538461538462
Control.SRR15539832;44;38;0.477272727272727;23;21;0.0227272727272727;0.477272727272727
Control.SRR15539832;40;38;0.55;18;22;0.05;0.45
Control.SRR15539832;35;38;0.542857142857143;16;19;0.0428571428571428;0.457142857142857
Control.SRR15539832;41;38;0.439024390243902;23;18;0.0609756097560976;0.439024390243902
Control.SRR15539832;36;38;0.555555555555556;16;20;0.0555555555555556;0.444444444444444
Control.SRR15539832;36;38;0.472222222222222;19;17;0.0277777777777778;0.472222222222222
Control.SRR15539832;39;38;0.58974358974359;16;23;0.0897435897435898;0.41025641025641
Control.SRR15539832;44;38;0.613636363636364;17;27;0.113636363636364;0.386363636363636
Control.SRR15539832;38;38;0.447368421052632;21;17;0.0526315789473684;0.447368421052632
Control.SRR15539832;38;38;0.5;19;19;0;0.5
Control.SRR15539832;38;38;0.631578947368421;14;24;0.131578947368421;0.368421052631579
Control.SRR15539832;36;38;0.5;18;18;0;0.5
Control.SRR15539832;38;38;0.473684210526316;20;18;0.0263157894736842;0.473684210526316
Control.SRR15539832;37;38;0.432432432432432;21;16;0.0675675675675675;0.432432432432432
Control.SRR15539832;35;38;0.371428571428571;22;13;0.128571428571429;0.371428571428571
Control.SRR15539832;37;38;0.459459459459459;20;17;0.0405405405405405;0.459459459459459
Control.SRR15539832;46;38;0.652173913043478;16;30;0.152173913043478;0.347826086956522
Control.SRR15539832;42;38;0.523809523809524;20;22;0.0238095238095238;0.476190476190476
Control.SRR15539832;44;38;0.590909090909091;18;26;0.0909090909090909;0.409090909090909
Control.SRR15539832;35;38;0.428571428571429;20;15;0.0714285714285715;0.428571428571429
Control.SRR15539832;43;38;0.395348837209302;26;17;0.104651162790698;0.395348837209302
Control.SRR15539832;40;38;0.475;21;19;0.025;0.475
Control.SRR15539832;39;38;0.58974358974359;16;23;0.0897435897435898;0.41025641025641
Control.SRR15539832;41;38;0.536585365853659;19;22;0.0365853658536586;0.463414634146341
Control.SRR15539832;46;38;0.456521739130435;25;21;0.0434782608695652;0.456521739130435
Control.SRR15539832;35;38;0.4;21;14;0.1;0.4
Control.SRR15539832;45;38;0.555555555555556;20;25;0.0555555555555556;0.444444444444444
Control.SRR15539832;45;38;0.533333333333333;21;24;0.0333333333333333;0.466666666666667
Control.SRR15539832;36;38;0.5;18;18;0;0.5
Control.SRR15539832;38;38;0.263157894736842;28;10;0.236842105263158;0.263157894736842
Control.SRR15539832;41;38;0.51219512195122;20;21;0.0121951219512195;0.48780487804878
Control.SRR15539832;35;38;0.571428571428571;15;20;0.0714285714285714;0.428571428571429
Control.SRR15539832;41;38;0.536585365853659;19;22;0.0365853658536586;0.463414634146341
Control.SRR15539832;45;38;0.511111111111111;22;23;0.0111111111111111;0.488888888888889
Control.SRR15539832;39;38;0.461538461538462;21;18;0.0384615384615384;0.461538461538462
Control.SRR15539832;39;38;0.615384615384615;15;24;0.115384615384615;0.384615384615385
Control.SRR15539832;46;38;0.456521739130435;25;21;0.0434782608695652;0.456521739130435
Control.SRR15539832;37;38;0.621621621621622;14;23;0.121621621621622;0.378378378378378
Control.SRR15539832;35;38;0.542857142857143;16;19;0.0428571428571428;0.457142857142857
Control.SRR15539832;37;38;0.594594594594595;15;22;0.0945945945945946;0.405405405405405
Control.SRR15539832;46;38;0.543478260869565;21;25;0.0434782608695652;0.456521739130435
Control.SRR15539832;38;38;0.447368421052632;21;17;0.0526315789473684;0.447368421052632
Control.SRR15539832;38;38;0.5;19;19;0;0.5
Control.SRR15539832;42;38;0.428571428571429;24;18;0.0714285714285715;0.428571428571429
Control.SRR15539832;43;38;0.325581395348837;29;14;0.174418604651163;0.325581395348837
Control.SRR15539832;39;38;0.435897435897436;22;17;0.0641025641025641;0.435897435897436
Control.SRR15539832;38;38;0.526315789473684;18;20;0.0263157894736842;0.473684210526316
Control.SRR15539832;35;38;0.485714285714286;18;17;0.0142857142857143;0.485714285714286
Control.SRR15539832;36;38;0.5;18;18;0;0.5
Control.SRR15539832;38;38;0.578947368421053;16;22;0.0789473684210527;0.421052631578947
Control.SRR15539832;39;38;0.641025641025641;14;25;0.141025641025641;0.358974358974359
Control.SRR15539832;41;38;0.536585365853659;19;22;0.0365853658536586;0.463414634146341
Control.SRR15539832;41;38;0.48780487804878;21;20;0.0121951219512195;0.48780487804878
Control.SRR15539832;38;38;0.552631578947368;17;21;0.0526315789473685;0.447368421052632
Control.SRR15539832;42;38;0.5;21;21;0;0.5
Control.SRR15539832;44;38;0.636363636363636;16;28;0.136363636363636;0.363636363636364
Control.SRR15539832;42;38;0.547619047619048;19;23;0.0476190476190477;0.452380952380952
Control.SRR15539832;42;38;0.619047619047619;16;26;0.119047619047619;0.380952380952381
Control.SRR15539832;46;38;0.58695652173913;19;27;0.0869565217391305;0.41304347826087
Control.SRR15539832;45;38;0.488888888888889;23;22;0.0111111111111111;0.488888888888889
Control.SRR15539832;42;38;0.404761904761905;25;17;0.0952380952380952;0.404761904761905
Control.SRR15539832;41;38;0.439024390243902;23;18;0.0609756097560976;0.439024390243902
Control.SRR15539832;37;38;0.486486486486487;19;18;0.0135135135135135;0.486486486486487
Control.SRR15539832;43;38;0.395348837209302;26;17;0.104651162790698;0.395348837209302
Control.SRR15539832;45;38;0.488888888888889;23;22;0.0111111111111111;0.488888888888889
Control.SRR15539832;39;38;0.512820512820513;19;20;0.0128205128205128;0.487179487179487
Control.SRR15539832;44;38;0.545454545454545;20;24;0.0454545454545454;0.454545454545455
Control.SRR15539832;42;38;0.523809523809524;20;22;0.0238095238095238;0.476190476190476
Control.SRR15539832;40;38;0.575;17;23;0.075;0.425
Control.SRR15539832;37;38;0.486486486486487;19;18;0.0135135135135135;0.486486486486487
Control.SRR15539832;40;38;0.525;19;21;0.025;0.475
Control.SRR15539832;42;38;0.428571428571429;24;18;0.0714285714285715;0.428571428571429
Control.SRR15539832;36;38;0.472222222222222;19;17;0.0277777777777778;0.472222222222222
Control.SRR15539832;43;38;0.488372093023256;22;21;0.0116279069767442;0.488372093023256
Control.SRR15539832;36;38;0.333333333333333;24;12;0.166666666666667;0.333333333333333
Control.SRR15539832;43;38;0.581395348837209;18;25;0.0813953488372093;0.418604651162791
Control.SRR15539832;41;38;0.439024390243902;23;18;0.0609756097560976;0.439024390243902
Control.SRR15539832;44;38;0.454545454545455;24;20;0.0454545454545455;0.454545454545455
Control.SRR15539832;37;38;0.567567567567568;16;21;0.0675675675675675;0.432432432432432
Control.SRR15539832;37;38;0.459459459459459;20;17;0.0405405405405405;0.459459459459459
Control.SRR15539832;35;38;0.485714285714286;18;17;0.0142857142857143;0.485714285714286
Control.SRR15539832;45;38;0.466666666666667;24;21;0.0333333333333333;0.466666666666667
Control.SRR15539832;39;38;0.384615384615385;24;15;0.115384615384615;0.384615384615385
Control.SRR15539832;37;38;0.540540540540541;17;20;0.0405405405405406;0.459459459459459
Control.SRR15539832;37;38;0.540540540540541;17;20;0.0405405405405406;0.459459459459459
Control.SRR15539832;42;38;0.595238095238095;17;25;0.0952380952380952;0.404761904761905
Control.SRR15539832;46;38;0.58695652173913;19;27;0.0869565217391305;0.41304347826087
Control.SRR15539832;43;38;0.534883720930233;20;23;0.0348837209302325;0.465116279069767
Control.SRR15539832;41;38;0.48780487804878;21;20;0.0121951219512195;0.48780487804878
Control.SRR15539832;37;38;0.702702702702703;11;26;0.202702702702703;0.297297297297297
Control.SRR15539832;41;38;0.48780487804878;21;20;0.0121951219512195;0.48780487804878
Control.SRR15539832;39;38;0.435897435897436;22;17;0.0641025641025641;0.435897435897436
Control.SRR15539832;39;38;0.487179487179487;20;19;0.0128205128205128;0.487179487179487
Control.SRR15539832;43;38;0.418604651162791;25;18;0.0813953488372093;0.418604651162791
Control.SRR15539832;45;38;0.422222222222222;26;19;0.0777777777777778;0.422222222222222
Control.SRR15539832;41;38;0.585365853658537;17;24;0.0853658536585366;0.414634146341463
Control.SRR15539832;38;38;0.5;19;19;0;0.5
Control.SRR15539832;41;38;0.536585365853659;19;22;0.0365853658536586;0.463414634146341
Control.SRR15539832;36;38;0.555555555555556;16;20;0.0555555555555556;0.444444444444444
Control.SRR15539832;35;38;0.6;14;21;0.1;0.4
Control.SRR15539832;37;38;0.486486486486487;19;18;0.0135135135135135;0.486486486486487
Control.SRR15539832;35;38;0.514285714285714;17;18;0.0142857142857142;0.485714285714286
Control.SRR15539832;37;38;0.621621621621622;14;23;0.121621621621622;0.378378378378378
Control.SRR15539832;46;38;0.521739130434783;22;24;0.0217391304347826;0.478260869565217
Control.SRR15539832;37;38;0.486486486486487;19;18;0.0135135135135135;0.486486486486487
Control.SRR15539832;44;38;0.5;22;22;0;0.5
Control.SRR15539832;41;38;0.365853658536585;26;15;0.134146341463415;0.365853658536585
Control.SRR15539832;41;38;0.48780487804878;21;20;0.0121951219512195;0.48780487804878
Control.SRR15539832;41;38;0.585365853658537;17;24;0.0853658536585366;0.414634146341463
Control.SRR15539832;43;38;0.465116279069767;23;20;0.0348837209302326;0.465116279069767
Control.SRR15539832;44;38;0.454545454545455;24;20;0.0454545454545455;0.454545454545455
Control.SRR15539832;41;38;0.560975609756098;18;23;0.0609756097560976;0.439024390243902
Control.SRR15539832;39;38;0.41025641025641;23;16;0.0897435897435898;0.41025641025641
Control.SRR15539832;43;38;0.465116279069767;23;20;0.0348837209302326;0.465116279069767
Control.SRR15539832;43;38;0.581395348837209;18;25;0.0813953488372093;0.418604651162791
Control.SRR15539832;38;38;0.526315789473684;18;20;0.0263157894736842;0.473684210526316
Control.SRR15539832;46;38;0.456521739130435;25;21;0.0434782608695652;0.456521739130435
Control.SRR15539832;39;38;0.461538461538462;21;18;0.0384615384615384;0.461538461538462
Control.SRR15539832;38;38;0.421052631578947;22;16;0.0789473684210527;0.421052631578947
Control.SRR15539832;45;38;0.444444444444444;25;20;0.0555555555555556;0.444444444444444
Control.SRR15539832;46;38;0.58695652173913;19;27;0.0869565217391305;0.41304347826087
Control.SRR15539832;44;38;0.454545454545455;24;20;0.0454545454545455;0.454545454545455
Control.SRR15539832;45;38;0.511111111111111;22;23;0.0111111111111111;0.488888888888889
Control.SRR15539832;41;38;0.51219512195122;20;21;0.0121951219512195;0.48780487804878
Control.SRR15539832;46;38;0.608695652173913;18;28;0.108695652173913;0.391304347826087
Control.SRR15539832;45;38;0.577777777777778;19;26;0.0777777777777777;0.422222222222222
Control.SRR15539832;37;38;0.648648648648649;13;24;0.148648648648649;0.351351351351351
Control.SRR15539832;46;38;0.565217391304348;20;26;0.0652173913043478;0.434782608695652
Control.SRR15539832;45;38;0.444444444444444;25;20;0.0555555555555556;0.444444444444444
Control.SRR15539832;41;38;0.439024390243902;23;18;0.0609756097560976;0.439024390243902
Control.SRR15539832;35;38;0.371428571428571;22;13;0.128571428571429;0.371428571428571
Control.SRR15539832;45;38;0.6;18;27;0.1;0.4
Control.SRR15539832;42;38;0.452380952380952;23;19;0.0476190476190476;0.452380952380952
Control.SRR15539832;41;38;0.609756097560976;16;25;0.109756097560976;0.390243902439024
Control.SRR15539832;44;38;0.454545454545455;24;20;0.0454545454545455;0.454545454545455
Control.SRR15539832;40;38;0.5;20;20;0;0.5
Control.SRR15539832;39;38;0.487179487179487;20;19;0.0128205128205128;0.487179487179487
Control.SRR15539832;36;38;0.527777777777778;17;19;0.0277777777777778;0.472222222222222
Control.SRR15539832;35;38;0.514285714285714;17;18;0.0142857142857142;0.485714285714286
Control.SRR15539832;46;38;0.478260869565217;24;22;0.0217391304347826;0.478260869565217
Control.SRR15539832;39;38;0.435897435897436;22;17;0.0641025641025641;0.435897435897436
Control.SRR15539832;42;38;0.571428571428571;18;24;0.0714285714285714;0.428571428571429
Control.SRR15539832;42;38;0.595238095238095;17;25;0.0952380952380952;0.404761904761905
Control.SRR15539832;46;38;0.41304347826087;27;19;0.0869565217391304;0.41304347826087
Control.SRR15539832;35;38;0.457142857142857;19;16;0.0428571428571429;0.457142857142857
Control.SRR15539832;40;38;0.45;22;18;0.05;0.45
Control.SRR15539832;43;38;0.511627906976744;21;22;0.0116279069767442;0.488372093023256
Control.SRR15539832;41;38;0.51219512195122;20;21;0.0121951219512195;0.48780487804878
Control.SRR15539832;43;38;0.627906976744186;16;27;0.127906976744186;0.372093023255814
Control.SRR15539832;44;38;0.5;22;22;0;0.5
Control.SRR15539832;43;38;0.488372093023256;22;21;0.0116279069767442;0.488372093023256
Control.SRR15539832;43;38;0.511627906976744;21;22;0.0116279069767442;0.488372093023256
Control.SRR15539832;38;38;0.421052631578947;22;16;0.0789473684210527;0.421052631578947
Control.SRR15539832;36;38;0.611111111111111;14;22;0.111111111111111;0.388888888888889
Control.SRR15539832;39;38;0.512820512820513;19;20;0.0128205128205128;0.487179487179487
Control.SRR15539832;41;38;0.439024390243902;23;18;0.0609756097560976;0.439024390243902
Control.SRR15539832;39;38;0.641025641025641;14;25;0.141025641025641;0.358974358974359
Control.SRR15539832;45;38;0.555555555555556;20;25;0.0555555555555556;0.444444444444444
Control.SRR15539832;38;38;0.526315789473684;18;20;0.0263157894736842;0.473684210526316
Control.SRR15539832;41;38;0.560975609756098;18;23;0.0609756097560976;0.439024390243902
Control.SRR15539832;40;38;0.475;21;19;0.025;0.475
Control.SRR15539832;40;38;0.6;16;24;0.1;0.4
Control.SRR15539832;40;38;0.625;15;25;0.125;0.375
Control.SRR15539832;40;38;0.475;21;19;0.025;0.475
Control.SRR15539832;40;38;0.375;25;15;0.125;0.375
Control.SRR15539832;43;38;0.465116279069767;23;20;0.0348837209302326;0.465116279069767
Control.SRR15539832;41;38;0.536585365853659;19;22;0.0365853658536586;0.463414634146341
Control.SRR15539832;41;38;0.463414634146341;22;19;0.0365853658536585;0.463414634146341
Control.SRR15539832;44;38;0.363636363636364;28;16;0.136363636363636;0.363636363636364
Control.SRR15539832;40;38;0.475;21;19;0.025;0.475
Control.SRR15539832;37;38;0.513513513513513;18;19;0.0135135135135135;0.486486486486487
Control.SRR15539832;37;38;0.459459459459459;20;17;0.0405405405405405;0.459459459459459
Control.SRR15539832;43;38;0.511627906976744;21;22;0.0116279069767442;0.488372093023256
Control.SRR15539832;41;38;0.390243902439024;25;16;0.109756097560976;0.390243902439024
Control.SRR15539832;44;38;0.590909090909091;18;26;0.0909090909090909;0.409090909090909
Control.SRR15539832;43;38;0.534883720930233;20;23;0.0348837209302325;0.465116279069767
Control.SRR15539832;35;38;0.485714285714286;18;17;0.0142857142857143;0.485714285714286
Control.SRR15539832;39;38;0.512820512820513;19;20;0.0128205128205128;0.487179487179487
Control.SRR15539832;41;38;0.439024390243902;23;18;0.0609756097560976;0.439024390243902
Control.SRR15539832;44;38;0.545454545454545;20;24;0.0454545454545454;0.454545454545455
Control.SRR15539832;39;38;0.641025641025641;14;25;0.141025641025641;0.358974358974359
Control.SRR15539832;43;38;0.488372093023256;22;21;0.0116279069767442;0.488372093023256
Control.SRR15539832;41;38;0.536585365853659;19;22;0.0365853658536586;0.463414634146341
Control.SRR15539832;41;38;0.48780487804878;21;20;0.0121951219512195;0.48780487804878
Control.SRR15539832;39;38;0.333333333333333;26;13;0.166666666666667;0.333333333333333
Control.SRR15539832;37;38;0.567567567567568;16;21;0.0675675675675675;0.432432432432432
Control.SRR15539832;45;38;0.533333333333333;21;24;0.0333333333333333;0.466666666666667
Control.SRR15539832;37;38;0.486486486486487;19;18;0.0135135135135135;0.486486486486487
Control.SRR15539832;39;38;0.512820512820513;19;20;0.0128205128205128;0.487179487179487
Control.SRR15539832;41;38;0.463414634146341;22;19;0.0365853658536585;0.463414634146341
Control.SRR15539832;36;38;0.444444444444444;20;16;0.0555555555555556;0.444444444444444
Control.SRR15539832;36;38;0.5;18;18;0;0.5
Control.SRR15539832;45;38;0.488888888888889;23;22;0.0111111111111111;0.488888888888889
Control.SRR15539832;43;38;0.488372093023256;22;21;0.0116279069767442;0.488372093023256
Control.SRR15539832;41;38;0.536585365853659;19;22;0.0365853658536586;0.463414634146341
Control.SRR15539832;44;38;0.522727272727273;21;23;0.0227272727272727;0.477272727272727
Control.SRR15539832;41;38;0.317073170731707;28;13;0.182926829268293;0.317073170731707
Control.SRR15539832;36;38;0.722222222222222;10;26;0.222222222222222;0.277777777777778
Control.SRR15539832;42;38;0.380952380952381;26;16;0.119047619047619;0.380952380952381
Control.SRR15539832;44;38;0.659090909090909;15;29;0.159090909090909;0.340909090909091
Control.SRR15539832;46;38;0.565217391304348;20;26;0.0652173913043478;0.434782608695652
Control.SRR15539832;46;38;0.543478260869565;21;25;0.0434782608695652;0.456521739130435
Control.SRR15539832;39;38;0.512820512820513;19;20;0.0128205128205128;0.487179487179487
Control.SRR15539832;43;38;0.534883720930233;20;23;0.0348837209302325;0.465116279069767
Control.SRR15539832;44;38;0.409090909090909;26;18;0.0909090909090909;0.409090909090909
Control.SRR15539832;43;38;0.558139534883721;19;24;0.0581395348837209;0.441860465116279
Control.SRR15539832;40;38;0.45;22;18;0.05;0.45
Control.SRR15539832;37;38;0.648648648648649;13;24;0.148648648648649;0.351351351351351
Control.SRR15539832;46;38;0.652173913043478;16;30;0.152173913043478;0.347826086956522
Control.SRR15539832;45;38;0.644444444444444;16;29;0.144444444444444;0.355555555555556
Control.SRR15539832;44;38;0.340909090909091;29;15;0.159090909090909;0.340909090909091
Control.SRR15539832;41;38;0.51219512195122;20;21;0.0121951219512195;0.48780487804878
Control.SRR15539832;41;38;0.560975609756098;18;23;0.0609756097560976;0.439024390243902
Control.SRR15539832;36;38;0.555555555555556;16;20;0.0555555555555556;0.444444444444444
Control.SRR15539832;40;38;0.425;23;17;0.075;0.425
Control.SRR15539832;44;38;0.454545454545455;24;20;0.0454545454545455;0.454545454545455
Control.SRR15539832;38;38;0.447368421052632;21;17;0.0526315789473684;0.447368421052632
Control.SRR15539832;44;38;0.545454545454545;20;24;0.0454545454545454;0.454545454545455
Control.SRR15539832;41;38;0.439024390243902;23;18;0.0609756097560976;0.439024390243902
Control.SRR15539832;39;38;0.487179487179487;20;19;0.0128205128205128;0.487179487179487
Control.SRR15539832;45;38;0.444444444444444;25;20;0.0555555555555556;0.444444444444444
Control.SRR15539832;41;38;0.365853658536585;26;15;0.134146341463415;0.365853658536585
Control.SRR15539832;46;38;0.41304347826087;27;19;0.0869565217391304;0.41304347826087
Control.SRR15539832;45;38;0.511111111111111;22;23;0.0111111111111111;0.488888888888889
Control.SRR15539832;42;38;0.523809523809524;20;22;0.0238095238095238;0.476190476190476
Control.SRR15539832;43;38;0.488372093023256;22;21;0.0116279069767442;0.488372093023256
Control.SRR15539832;41;38;0.51219512195122;20;21;0.0121951219512195;0.48780487804878
Control.SRR15539832;39;38;0.41025641025641;23;16;0.0897435897435898;0.41025641025641
Control.SRR15539832;42;38;0.476190476190476;22;20;0.0238095238095238;0.476190476190476
Control.SRR15539832;42;38;0.523809523809524;20;22;0.0238095238095238;0.476190476190476
Control.SRR15539832;41;38;0.536585365853659;19;22;0.0365853658536586;0.463414634146341
Control.SRR15539832;36;38;0.472222222222222;19;17;0.0277777777777778;0.472222222222222
Control.SRR15539832;37;38;0.540540540540541;17;20;0.0405405405405406;0.459459459459459
Control.SRR15539832;41;38;0.390243902439024;25;16;0.109756097560976;0.390243902439024
Control.SRR15539832;35;38;0.628571428571429;13;22;0.128571428571429;0.371428571428571
Control.SRR15539832;40;38;0.525;19;21;0.025;0.475
Control.SRR15539832;42;38;0.380952380952381;26;16;0.119047619047619;0.380952380952381
Control.SRR15539832;43;38;0.697674418604651;13;30;0.197674418604651;0.302325581395349
Control.SRR15539832;43;38;0.441860465116279;24;19;0.0581395348837209;0.441860465116279
Control.SRR15539832;45;38;0.422222222222222;26;19;0.0777777777777778;0.422222222222222
Control.SRR15539832;45;38;0.6;18;27;0.1;0.4
Control.SRR15539832;43;38;0.395348837209302;26;17;0.104651162790698;0.395348837209302
Control.SRR15539832;37;38;0.405405405405405;22;15;0.0945945945945946;0.405405405405405
Control.SRR15539832;37;38;0.513513513513513;18;19;0.0135135135135135;0.486486486486487
Control.SRR15539832;43;38;0.534883720930233;20;23;0.0348837209302325;0.465116279069767
Control.SRR15539832;43;38;0.441860465116279;24;19;0.0581395348837209;0.441860465116279
Control.SRR15539832;36;38;0.472222222222222;19;17;0.0277777777777778;0.472222222222222
Control.SRR15539832;43;38;0.627906976744186;16;27;0.127906976744186;0.372093023255814
Control.SRR15539832;40;38;0.425;23;17;0.075;0.425
Control.SRR15539832;39;38;0.435897435897436;22;17;0.0641025641025641;0.435897435897436
Control.SRR15539832;45;38;0.488888888888889;23;22;0.0111111111111111;0.488888888888889
Control.SRR15539832;46;38;0.521739130434783;22;24;0.0217391304347826;0.478260869565217
Control.SRR15539832;37;38;0.594594594594595;15;22;0.0945945945945946;0.405405405405405
Control.SRR15539832;39;38;0.564102564102564;17;22;0.0641025641025641;0.435897435897436
Control.SRR15539832;45;38;0.444444444444444;25;20;0.0555555555555556;0.444444444444444
Control.SRR15539832;36;38;0.388888888888889;22;14;0.111111111111111;0.388888888888889
Control.SRR15539832;42;38;0.404761904761905;25;17;0.0952380952380952;0.404761904761905
Control.SRR15539832;36;38;0.638888888888889;13;23;0.138888888888889;0.361111111111111
Control.SRR15539832;43;38;0.558139534883721;19;24;0.0581395348837209;0.441860465116279
Control.SRR15539832;44;38;0.522727272727273;21;23;0.0227272727272727;0.477272727272727
Control.SRR15539832;44;38;0.545454545454545;20;24;0.0454545454545454;0.454545454545455
Control.SRR15539832;35;38;0.428571428571429;20;15;0.0714285714285715;0.428571428571429
Control.SRR15539832;44;38;0.454545454545455;24;20;0.0454545454545455;0.454545454545455
Control.SRR15539832;37;38;0.513513513513513;18;19;0.0135135135135135;0.486486486486487
Control.SRR15539832;38;38;0.447368421052632;21;17;0.0526315789473684;0.447368421052632
Control.SRR15539832;43;38;0.488372093023256;22;21;0.0116279069767442;0.488372093023256
Control.SRR15539832;46;38;0.478260869565217;24;22;0.0217391304347826;0.478260869565217
Control.SRR15539832;40;38;0.55;18;22;0.05;0.45
Control.SRR15539832;46;38;0.543478260869565;21;25;0.0434782608695652;0.456521739130435
Control.SRR15539832;40;38;0.5;20;20;0;0.5
Control.SRR15539832;36;38;0.361111111111111;23;13;0.138888888888889;0.361111111111111
Control.SRR15539832;39;38;0.487179487179487;20;19;0.0128205128205128;0.487179487179487
Control.SRR15539832;37;38;0.513513513513513;18;19;0.0135135135135135;0.486486486486487
Control.SRR15539832;36;38;0.472222222222222;19;17;0.0277777777777778;0.472222222222222
Control.SRR15539832;38;38;0.421052631578947;22;16;0.0789473684210527;0.421052631578947
Control.SRR15539832;44;38;0.454545454545455;24;20;0.0454545454545455;0.454545454545455
Control.SRR15539832;40;38;0.55;18;22;0.05;0.45
Control.SRR15539832;40;38;0.575;17;23;0.075;0.425
Control.SRR15539832;43;38;0.441860465116279;24;19;0.0581395348837209;0.441860465116279
Control.SRR15539832;38;38;0.394736842105263;23;15;0.105263157894737;0.394736842105263
Control.SRR15539832;38;38;0.526315789473684;18;20;0.0263157894736842;0.473684210526316
Control.SRR15539832;42;38;0.571428571428571;18;24;0.0714285714285714;0.428571428571429
Control.SRR15539832;43;38;0.255813953488372;32;11;0.244186046511628;0.255813953488372
Control.SRR15539832;44;38;0.590909090909091;18;26;0.0909090909090909;0.409090909090909
Control.SRR15539832;42;38;0.523809523809524;20;22;0.0238095238095238;0.476190476190476
Control.SRR15539832;46;38;0.326086956521739;31;15;0.173913043478261;0.326086956521739
Control.SRR15539832;43;38;0.488372093023256;22;21;0.0116279069767442;0.488372093023256
Control.SRR15539832;39;38;0.487179487179487;20;19;0.0128205128205128;0.487179487179487
Control.SRR15539832;45;38;0.444444444444444;25;20;0.0555555555555556;0.444444444444444
Control.SRR15539832;44;38;0.636363636363636;16;28;0.136363636363636;0.363636363636364
Control.SRR15539832;44;38;0.545454545454545;20;24;0.0454545454545454;0.454545454545455
Control.SRR15539832;40;38;0.5;20;20;0;0.5
Control.SRR15539832;41;38;0.51219512195122;20;21;0.0121951219512195;0.48780487804878
Control.SRR15539832;36;38;0.583333333333333;15;21;0.0833333333333334;0.416666666666667
Control.SRR15539832;39;38;0.461538461538462;21;18;0.0384615384615384;0.461538461538462
Control.SRR15539832;46;38;0.543478260869565;21;25;0.0434782608695652;0.456521739130435
Control.SRR15539832;41;38;0.463414634146341;22;19;0.0365853658536585;0.463414634146341
Control.SRR15539832;43;38;0.511627906976744;21;22;0.0116279069767442;0.488372093023256
Control.SRR15539832;38;38;0.552631578947368;17;21;0.0526315789473685;0.447368421052632
Control.SRR15539832;37;38;0.567567567567568;16;21;0.0675675675675675;0.432432432432432
Control.SRR15539832;41;38;0.463414634146341;22;19;0.0365853658536585;0.463414634146341
Control.SRR15539832;43;38;0.488372093023256;22;21;0.0116279069767442;0.488372093023256
Control.SRR15539832;37;38;0.486486486486487;19;18;0.0135135135135135;0.486486486486487
Control.SRR15539832;46;38;0.434782608695652;26;20;0.0652173913043478;0.434782608695652
Control.SRR15539832;45;38;0.555555555555556;20;25;0.0555555555555556;0.444444444444444
Control.SRR15539832;37;38;0.594594594594595;15;22;0.0945945945945946;0.405405405405405
Control.SRR15539832;45;38;0.488888888888889;23;22;0.0111111111111111;0.488888888888889
Control.SRR15539832;46;38;0.478260869565217;24;22;0.0217391304347826;0.478260869565217
Control.SRR15539832;42;38;0.476190476190476;22;20;0.0238095238095238;0.476190476190476
Control.SRR15539832;36;38;0.416666666666667;21;15;0.0833333333333333;0.416666666666667
Control.SRR15539832;46;38;0.543478260869565;21;25;0.0434782608695652;0.456521739130435
Control.SRR15539832;46;38;0.565217391304348;20;26;0.0652173913043478;0.434782608695652
Control.SRR15539832;42;38;0.523809523809524;20;22;0.0238095238095238;0.476190476190476
Control.SRR15539832;42;38;0.5;21;21;0;0.5
Control.SRR15539832;45;38;0.444444444444444;25;20;0.0555555555555556;0.444444444444444
Control.SRR15539832;37;38;0.486486486486487;19;18;0.0135135135135135;0.486486486486487
Control.SRR15539832;46;38;0.478260869565217;24;22;0.0217391304347826;0.478260869565217
Control.SRR15539832;41;38;0.463414634146341;22;19;0.0365853658536585;0.463414634146341
Control.SRR15539832;40;38;0.575;17;23;0.075;0.425
Control.SRR15539832;43;38;0.534883720930233;20;23;0.0348837209302325;0.465116279069767
Control.SRR15539832;43;38;0.558139534883721;19;24;0.0581395348837209;0.441860465116279
Control.SRR15539832;44;38;0.454545454545455;24;20;0.0454545454545455;0.454545454545455
Control.SRR15539832;45;38;0.466666666666667;24;21;0.0333333333333333;0.466666666666667
Control.SRR15539832;42;38;0.476190476190476;22;20;0.0238095238095238;0.476190476190476
Control.SRR15539832;45;38;0.577777777777778;19;26;0.0777777777777777;0.422222222222222
Control.SRR15539832;43;38;0.534883720930233;20;23;0.0348837209302325;0.465116279069767
Control.SRR15539832;39;38;0.538461538461538;18;21;0.0384615384615384;0.461538461538462
Control.SRR15539832;40;38;0.425;23;17;0.075;0.425
Control.SRR15539832;38;38;0.421052631578947;22;16;0.0789473684210527;0.421052631578947
Control.SRR15539832;35;38;0.628571428571429;13;22;0.128571428571429;0.371428571428571
Control.SRR15539832;40;38;0.65;14;26;0.15;0.35
Control.SRR15539832;45;38;0.444444444444444;25;20;0.0555555555555556;0.444444444444444
Control.SRR15539832;46;38;0.543478260869565;21;25;0.0434782608695652;0.456521739130435
Control.SRR15539832;39;38;0.538461538461538;18;21;0.0384615384615384;0.461538461538462
Control.SRR15539832;42;38;0.476190476190476;22;20;0.0238095238095238;0.476190476190476
Control.SRR15539832;42;38;0.571428571428571;18;24;0.0714285714285714;0.428571428571429
Control.SRR15539832;35;38;0.542857142857143;16;19;0.0428571428571428;0.457142857142857
Control.SRR15539832;45;38;0.6;18;27;0.1;0.4
Control.SRR15539832;38;38;0.5;19;19;0;0.5
Control.SRR15539832;46;38;0.543478260869565;21;25;0.0434782608695652;0.456521739130435
Control.SRR15539832;45;38;0.533333333333333;21;24;0.0333333333333333;0.466666666666667
Control.SRR15539832;44;38;0.522727272727273;21;23;0.0227272727272727;0.477272727272727
Control.SRR15539832;43;38;0.418604651162791;25;18;0.0813953488372093;0.418604651162791
Control.SRR15539832;39;38;0.564102564102564;17;22;0.0641025641025641;0.435897435897436
Control.SRR15539832;40;38;0.475;21;19;0.025;0.475
Control.SRR15539832;40;38;0.425;23;17;0.075;0.425
Control.SRR15539832;42;38;0.452380952380952;23;19;0.0476190476190476;0.452380952380952
Control.SRR15539832;37;38;0.513513513513513;18;19;0.0135135135135135;0.486486486486487
Control.SRR15539832;42;38;0.476190476190476;22;20;0.0238095238095238;0.476190476190476
Control.SRR15539832;40;38;0.45;22;18;0.05;0.45
Control.SRR15539832;44;38;0.431818181818182;25;19;0.0681818181818182;0.431818181818182
Control.SRR15539832;42;38;0.476190476190476;22;20;0.0238095238095238;0.476190476190476
Control.SRR15539832;35;38;0.342857142857143;23;12;0.157142857142857;0.342857142857143
Control.SRR15539832;44;38;0.5;22;22;0;0.5
Control.SRR15539832;43;38;0.418604651162791;25;18;0.0813953488372093;0.418604651162791
Control.SRR15539832;45;38;0.511111111111111;22;23;0.0111111111111111;0.488888888888889
Control.SRR15539832;43;38;0.604651162790698;17;26;0.104651162790698;0.395348837209302
Control.SRR15539832;36;38;0.333333333333333;24;12;0.166666666666667;0.333333333333333
Control.SRR15539832;46;38;0.565217391304348;20;26;0.0652173913043478;0.434782608695652
Control.SRR15539832;35;38;0.457142857142857;19;16;0.0428571428571429;0.457142857142857
Control.SRR15539832;38;38;0.5;19;19;0;0.5
Control.SRR15539832;41;38;0.439024390243902;23;18;0.0609756097560976;0.439024390243902
Control.SRR15539832;44;38;0.454545454545455;24;20;0.0454545454545455;0.454545454545455
Control.SRR15539832;37;38;0.351351351351351;24;13;0.148648648648649;0.351351351351351
Control.SRR15539832;39;38;0.512820512820513;19;20;0.0128205128205128;0.487179487179487
Control.SRR15539832;46;38;0.5;23;23;0;0.5
Control.SRR15539832;36;38;0.444444444444444;20;16;0.0555555555555556;0.444444444444444
Control.SRR15539832;44;38;0.454545454545455;24;20;0.0454545454545455;0.454545454545455
Control.SRR15539832;46;38;0.5;23;23;0;0.5
Control.SRR15539832;39;38;0.461538461538462;21;18;0.0384615384615384;0.461538461538462
Control.SRR15539832;46;38;0.478260869565217;24;22;0.0217391304347826;0.478260869565217
Control.SRR15539832;42;38;0.547619047619048;19;23;0.0476190476190477;0.452380952380952
Control.SRR15539832;46;38;0.543478260869565;21;25;0.0434782608695652;0.456521739130435
Control.SRR15539832;44;38;0.522727272727273;21;23;0.0227272727272727;0.477272727272727
Control.SRR15539832;45;38;0.4;27;18;0.1;0.4
Control.SRR15539832;43;38;0.534883720930233;20;23;0.0348837209302325;0.465116279069767
Control.SRR15539832;39;38;0.487179487179487;20;19;0.0128205128205128;0.487179487179487
Control.SRR15539832;46;38;0.630434782608696;17;29;0.130434782608696;0.369565217391304
Control.SRR15539832;35;38;0.571428571428571;15;20;0.0714285714285714;0.428571428571429
Control.SRR15539832;46;38;0.5;23;23;0;0.5
Control.SRR15539832;46;38;0.478260869565217;24;22;0.0217391304347826;0.478260869565217
Control.SRR15539832;37;38;0.486486486486487;19;18;0.0135135135135135;0.486486486486487
Control.SRR15539832;46;38;0.434782608695652;26;20;0.0652173913043478;0.434782608695652
Control.SRR15539832;45;38;0.444444444444444;25;20;0.0555555555555556;0.444444444444444
Control.SRR15539832;35;38;0.571428571428571;15;20;0.0714285714285714;0.428571428571429
Control.SRR15539832;37;38;0.297297297297297;26;11;0.202702702702703;0.297297297297297
Control.SRR15539832;42;38;0.547619047619048;19;23;0.0476190476190477;0.452380952380952
Control.SRR15539832;45;38;0.444444444444444;25;20;0.0555555555555556;0.444444444444444
Control.SRR15539832;40;38;0.5;20;20;0;0.5
Control.SRR15539832;39;38;0.487179487179487;20;19;0.0128205128205128;0.487179487179487
Control.SRR15539832;44;38;0.5;22;22;0;0.5
Control.SRR15539832;41;38;0.51219512195122;20;21;0.0121951219512195;0.48780487804878
Control.SRR15539832;43;38;0.418604651162791;25;18;0.0813953488372093;0.418604651162791
Control.SRR15539832;36;38;0.361111111111111;23;13;0.138888888888889;0.361111111111111
Control.SRR15539832;36;38;0.527777777777778;17;19;0.0277777777777778;0.472222222222222
Control.SRR15539832;36;38;0.5;18;18;0;0.5
Control.SRR15539832;40;38;0.325;27;13;0.175;0.325
Control.SRR15539832;37;38;0.432432432432432;21;16;0.0675675675675675;0.432432432432432
Control.SRR15539832;42;38;0.5;21;21;0;0.5
Control.SRR15539832;40;38;0.675;13;27;0.175;0.325
Control.SRR15539832;39;38;0.512820512820513;19;20;0.0128205128205128;0.487179487179487
Control.SRR15539832;45;38;0.511111111111111;22;23;0.0111111111111111;0.488888888888889
Control.SRR15539832;43;38;0.604651162790698;17;26;0.104651162790698;0.395348837209302
Control.SRR15539832;42;38;0.547619047619048;19;23;0.0476190476190477;0.452380952380952
Control.SRR15539832;37;38;0.432432432432432;21;16;0.0675675675675675;0.432432432432432
Control.SRR15539832;45;38;0.444444444444444;25;20;0.0555555555555556;0.444444444444444
Control.SRR15539832;39;38;0.538461538461538;18;21;0.0384615384615384;0.461538461538462
Control.SRR15539832;40;38;0.5;20;20;0;0.5
Control.SRR15539832;40;38;0.425;23;17;0.075;0.425
Control.SRR15539832;40;38;0.375;25;15;0.125;0.375
Control.SRR15539832;39;38;0.487179487179487;20;19;0.0128205128205128;0.487179487179487
Control.SRR15539832;44;38;0.431818181818182;25;19;0.0681818181818182;0.431818181818182
Control.SRR15539832;45;38;0.488888888888889;23;22;0.0111111111111111;0.488888888888889
Control.SRR15539832;38;38;0.578947368421053;16;22;0.0789473684210527;0.421052631578947
Control.SRR15539832;39;38;0.512820512820513;19;20;0.0128205128205128;0.487179487179487
Control.SRR15539832;36;38;0.638888888888889;13;23;0.138888888888889;0.361111111111111
Control.SRR15539832;37;38;0.621621621621622;14;23;0.121621621621622;0.378378378378378
Control.SRR15539832;36;38;0.472222222222222;19;17;0.0277777777777778;0.472222222222222
Control.SRR15539832;39;38;0.564102564102564;17;22;0.0641025641025641;0.435897435897436
Control.SRR15539832;38;38;0.447368421052632;21;17;0.0526315789473684;0.447368421052632
Control.SRR15539832;45;38;0.511111111111111;22;23;0.0111111111111111;0.488888888888889
Control.SRR15539832;45;38;0.511111111111111;22;23;0.0111111111111111;0.488888888888889
Control.SRR15539832;35;38;0.228571428571429;27;8;0.271428571428571;0.228571428571429
Control.SRR15539832;46;38;0.456521739130435;25;21;0.0434782608695652;0.456521739130435
Control.SRR15539832;46;38;0.434782608695652;26;20;0.0652173913043478;0.434782608695652
Control.SRR15539832;39;38;0.384615384615385;24;15;0.115384615384615;0.384615384615385
Control.SRR15539832;38;38;0.342105263157895;25;13;0.157894736842105;0.342105263157895
Control.SRR15539832;43;38;0.348837209302326;28;15;0.151162790697674;0.348837209302326
Control.SRR15539832;41;38;0.292682926829268;29;12;0.207317073170732;0.292682926829268
Control.SRR15539832;44;38;0.613636363636364;17;27;0.113636363636364;0.386363636363636
Control.SRR15539832;38;38;0.552631578947368;17;21;0.0526315789473685;0.447368421052632
Control.SRR15539832;39;38;0.641025641025641;14;25;0.141025641025641;0.358974358974359
Control.SRR15539832;45;38;0.466666666666667;24;21;0.0333333333333333;0.466666666666667
Control.SRR15539832;44;38;0.409090909090909;26;18;0.0909090909090909;0.409090909090909
Control.SRR15539832;37;38;0.432432432432432;21;16;0.0675675675675675;0.432432432432432
Control.SRR15539832;41;38;0.51219512195122;20;21;0.0121951219512195;0.48780487804878
Control.SRR15539832;41;38;0.48780487804878;21;20;0.0121951219512195;0.48780487804878
Control.SRR15539832;39;38;0.564102564102564;17;22;0.0641025641025641;0.435897435897436
Control.SRR15539832;41;38;0.317073170731707;28;13;0.182926829268293;0.317073170731707
Control.SRR15539832;38;38;0.552631578947368;17;21;0.0526315789473685;0.447368421052632
Control.SRR15539832;41;38;0.463414634146341;22;19;0.0365853658536585;0.463414634146341
Control.SRR15539832;37;38;0.405405405405405;22;15;0.0945945945945946;0.405405405405405
Control.SRR15539832;42;38;0.547619047619048;19;23;0.0476190476190477;0.452380952380952
Control.SRR15539832;44;38;0.454545454545455;24;20;0.0454545454545455;0.454545454545455
Control.SRR15539832;35;38;0.4;21;14;0.1;0.4
Control.SRR15539832;38;38;0.605263157894737;15;23;0.105263157894737;0.394736842105263
Control.SRR15539832;45;38;0.511111111111111;22;23;0.0111111111111111;0.488888888888889
Control.SRR15539832;43;38;0.372093023255814;27;16;0.127906976744186;0.372093023255814
Control.SRR15539832;42;38;0.523809523809524;20;22;0.0238095238095238;0.476190476190476
Control.SRR15539832;45;38;0.622222222222222;17;28;0.122222222222222;0.377777777777778
Control.SRR15539832;36;38;0.5;18;18;0;0.5
Control.SRR15539832;37;38;0.432432432432432;21;16;0.0675675675675675;0.432432432432432
Control.SRR15539832;37;38;0.405405405405405;22;15;0.0945945945945946;0.405405405405405
Control.SRR15539832;45;38;0.311111111111111;31;14;0.188888888888889;0.311111111111111
Control.SRR15539832;35;38;0.571428571428571;15;20;0.0714285714285714;0.428571428571429
Control.SRR15539832;39;38;0.487179487179487;20;19;0.0128205128205128;0.487179487179487
Control.SRR15539832;38;38;0.5;19;19;0;0.5
Control.SRR15539832;39;38;0.512820512820513;19;20;0.0128205128205128;0.487179487179487
Control.SRR15539832;45;38;0.555555555555556;20;25;0.0555555555555556;0.444444444444444
Control.SRR15539832;43;38;0.441860465116279;24;19;0.0581395348837209;0.441860465116279
Control.SRR15539832;37;38;0.459459459459459;20;17;0.0405405405405405;0.459459459459459
Control.SRR15539832;38;38;0.526315789473684;18;20;0.0263157894736842;0.473684210526316
Control.SRR15539832;43;38;0.465116279069767;23;20;0.0348837209302326;0.465116279069767
Control.SRR15539832;36;38;0.555555555555556;16;20;0.0555555555555556;0.444444444444444
Control.SRR15539832;42;38;0.69047619047619;13;29;0.19047619047619;0.30952380952381
Control.SRR15539832;36;38;0.666666666666667;12;24;0.166666666666667;0.333333333333333
Control.SRR15539832;40;38;0.575;17;23;0.075;0.425
Control.SRR15539832;41;38;0.414634146341463;24;17;0.0853658536585366;0.414634146341463
Control.SRR15539832;37;38;0.405405405405405;22;15;0.0945945945945946;0.405405405405405
Control.SRR15539832;42;38;0.5;21;21;0;0.5
Control.SRR15539832;40;38;0.525;19;21;0.025;0.475
Control.SRR15539832;37;38;0.567567567567568;16;21;0.0675675675675675;0.432432432432432
Control.SRR15539832;43;38;0.558139534883721;19;24;0.0581395348837209;0.441860465116279
Control.SRR15539832;39;38;0.512820512820513;19;20;0.0128205128205128;0.487179487179487
Control.SRR15539832;41;38;0.414634146341463;24;17;0.0853658536585366;0.414634146341463
Control.SRR15539832;37;38;0.513513513513513;18;19;0.0135135135135135;0.486486486486487
Control.SRR15539832;43;38;0.558139534883721;19;24;0.0581395348837209;0.441860465116279
Control.SRR15539832;40;38;0.575;17;23;0.075;0.425
Control.SRR15539832;43;38;0.604651162790698;17;26;0.104651162790698;0.395348837209302
Control.SRR15539832;43;38;0.651162790697674;15;28;0.151162790697674;0.348837209302326
Control.SRR15539832;44;38;0.477272727272727;23;21;0.0227272727272727;0.477272727272727
Control.SRR15539832;38;38;0.552631578947368;17;21;0.0526315789473685;0.447368421052632
Control.SRR15539832;35;38;0.6;14;21;0.1;0.4
Control.SRR15539832;35;38;0.428571428571429;20;15;0.0714285714285715;0.428571428571429
Control.SRR15539832;35;38;0.542857142857143;16;19;0.0428571428571428;0.457142857142857
Control.SRR15539832;46;38;0.41304347826087;27;19;0.0869565217391304;0.41304347826087
Control.SRR15539832;37;38;0.459459459459459;20;17;0.0405405405405405;0.459459459459459
Control.SRR15539832;43;38;0.511627906976744;21;22;0.0116279069767442;0.488372093023256
Control.SRR15539832;39;38;0.358974358974359;25;14;0.141025641025641;0.358974358974359
Control.SRR15539832;36;38;0.472222222222222;19;17;0.0277777777777778;0.472222222222222
Control.SRR15539832;36;38;0.416666666666667;21;15;0.0833333333333333;0.416666666666667
Control.SRR15539832;36;38;0.555555555555556;16;20;0.0555555555555556;0.444444444444444
Control.SRR15539832;45;38;0.533333333333333;21;24;0.0333333333333333;0.466666666666667
Control.SRR15539832;36;38;0.638888888888889;13;23;0.138888888888889;0.361111111111111
Control.SRR15539832;42;38;0.404761904761905;25;17;0.0952380952380952;0.404761904761905
Control.SRR15539832;45;38;0.533333333333333;21;24;0.0333333333333333;0.466666666666667
Control.SRR15539832;42;38;0.642857142857143;15;27;0.142857142857143;0.357142857142857
Control.SRR15539832;39;38;0.41025641025641;23;16;0.0897435897435898;0.41025641025641
Control.SRR15539832;44;38;0.5;22;22;0;0.5
Control.SRR15539832;45;38;0.555555555555556;20;25;0.0555555555555556;0.444444444444444
Control.SRR15539832;36;38;0.555555555555556;16;20;0.0555555555555556;0.444444444444444
Control.SRR15539832;39;38;0.41025641025641;23;16;0.0897435897435898;0.41025641025641
Control.SRR15539832;43;38;0.558139534883721;19;24;0.0581395348837209;0.441860465116279
Control.SRR15539832;38;38;0.447368421052632;21;17;0.0526315789473684;0.447368421052632
Control.SRR15539832;37;38;0.621621621621622;14;23;0.121621621621622;0.378378378378378
Control.SRR15539832;41;38;0.48780487804878;21;20;0.0121951219512195;0.48780487804878
Control.SRR15539832;37;38;0.432432432432432;21;16;0.0675675675675675;0.432432432432432
Control.SRR15539832;40;38;0.55;18;22;0.05;0.45
Control.SRR15539832;43;38;0.441860465116279;24;19;0.0581395348837209;0.441860465116279
Control.SRR15539832;44;38;0.386363636363636;27;17;0.113636363636364;0.386363636363636
Control.SRR15539832;35;38;0.485714285714286;18;17;0.0142857142857143;0.485714285714286
Control.SRR15539832;44;38;0.454545454545455;24;20;0.0454545454545455;0.454545454545455
Control.SRR15539832;40;38;0.525;19;21;0.025;0.475
Control.SRR15539832;42;38;0.476190476190476;22;20;0.0238095238095238;0.476190476190476
Control.SRR15539832;44;38;0.477272727272727;23;21;0.0227272727272727;0.477272727272727
Control.SRR15539832;45;38;0.577777777777778;19;26;0.0777777777777777;0.422222222222222
Control.SRR15539832;36;38;0.555555555555556;16;20;0.0555555555555556;0.444444444444444
Control.SRR15539832;43;38;0.441860465116279;24;19;0.0581395348837209;0.441860465116279
Control.SRR15539832;42;38;0.476190476190476;22;20;0.0238095238095238;0.476190476190476
Control.SRR15539832;42;38;0.571428571428571;18;24;0.0714285714285714;0.428571428571429
Control.SRR15539832;43;38;0.441860465116279;24;19;0.0581395348837209;0.441860465116279
Control.SRR15539832;38;38;0.289473684210526;27;11;0.210526315789474;0.289473684210526
Control.SRR15539832;40;38;0.425;23;17;0.075;0.425
Control.SRR15539832;42;38;0.380952380952381;26;16;0.119047619047619;0.380952380952381
Control.SRR15539832;44;38;0.568181818181818;19;25;0.0681818181818182;0.431818181818182
Control.SRR15539832;46;38;0.478260869565217;24;22;0.0217391304347826;0.478260869565217
Control.SRR15539832;35;38;0.457142857142857;19;16;0.0428571428571429;0.457142857142857
Control.SRR15539832;40;38;0.525;19;21;0.025;0.475
Control.SRR15539832;37;38;0.459459459459459;20;17;0.0405405405405405;0.459459459459459
Control.SRR15539832;39;38;0.564102564102564;17;22;0.0641025641025641;0.435897435897436
Control.SRR15539832;37;38;0.567567567567568;16;21;0.0675675675675675;0.432432432432432
Control.SRR15539832;36;38;0.444444444444444;20;16;0.0555555555555556;0.444444444444444
Control.SRR15539832;43;38;0.441860465116279;24;19;0.0581395348837209;0.441860465116279
Control.SRR15539832;36;38;0.527777777777778;17;19;0.0277777777777778;0.472222222222222
Control.SRR15539832;37;38;0.486486486486487;19;18;0.0135135135135135;0.486486486486487
Control.SRR15539832;42;38;0.547619047619048;19;23;0.0476190476190477;0.452380952380952
Control.SRR15539832;43;38;0.418604651162791;25;18;0.0813953488372093;0.418604651162791
Control.SRR15539832;42;38;0.452380952380952;23;19;0.0476190476190476;0.452380952380952
Control.SRR15539832;46;38;0.434782608695652;26;20;0.0652173913043478;0.434782608695652
Control.SRR15539832;44;38;0.5;22;22;0;0.5
Control.SRR15539832;37;38;0.594594594594595;15;22;0.0945945945945946;0.405405405405405
Control.SRR15539832;40;38;0.525;19;21;0.025;0.475
Control.SRR15539832;39;38;0.564102564102564;17;22;0.0641025641025641;0.435897435897436
Control.SRR15539832;38;38;0.631578947368421;14;24;0.131578947368421;0.368421052631579
Control.SRR15539832;44;38;0.5;22;22;0;0.5
Control.SRR15539832;38;38;0.394736842105263;23;15;0.105263157894737;0.394736842105263
Control.SRR15539832;41;38;0.560975609756098;18;23;0.0609756097560976;0.439024390243902
Control.SRR15539832;41;38;0.463414634146341;22;19;0.0365853658536585;0.463414634146341
Control.SRR15539832;42;38;0.523809523809524;20;22;0.0238095238095238;0.476190476190476
Control.SRR15539832;46;38;0.434782608695652;26;20;0.0652173913043478;0.434782608695652
Control.SRR15539832;36;38;0.555555555555556;16;20;0.0555555555555556;0.444444444444444
Control.SRR15539832;38;38;0.421052631578947;22;16;0.0789473684210527;0.421052631578947
Control.SRR15539832;42;38;0.428571428571429;24;18;0.0714285714285715;0.428571428571429
Control.SRR15539832;44;38;0.5;22;22;0;0.5
Control.SRR15539832;41;38;0.414634146341463;24;17;0.0853658536585366;0.414634146341463
Control.SRR15539832;44;38;0.522727272727273;21;23;0.0227272727272727;0.477272727272727
Control.SRR15539832;45;38;0.311111111111111;31;14;0.188888888888889;0.311111111111111
Control.SRR15539832;42;38;0.380952380952381;26;16;0.119047619047619;0.380952380952381
Control.SRR15539832;43;38;0.348837209302326;28;15;0.151162790697674;0.348837209302326
Control.SRR15539832;46;38;0.565217391304348;20;26;0.0652173913043478;0.434782608695652
Control.SRR15539832;38;38;0.657894736842105;13;25;0.157894736842105;0.342105263157895
Control.SRR15539832;38;38;0.657894736842105;13;25;0.157894736842105;0.342105263157895
Control.SRR15539832;42;38;0.595238095238095;17;25;0.0952380952380952;0.404761904761905
Control.SRR15539832;46;38;0.5;23;23;0;0.5
Control.SRR15539832;35;38;0.457142857142857;19;16;0.0428571428571429;0.457142857142857
Control.SRR15539832;43;38;0.395348837209302;26;17;0.104651162790698;0.395348837209302
Control.SRR15539832;45;38;0.577777777777778;19;26;0.0777777777777777;0.422222222222222
Control.SRR15539832;38;38;0.447368421052632;21;17;0.0526315789473684;0.447368421052632
Control.SRR15539832;36;38;0.5;18;18;0;0.5
Control.SRR15539832;38;38;0.578947368421053;16;22;0.0789473684210527;0.421052631578947
Control.SRR15539832;39;38;0.461538461538462;21;18;0.0384615384615384;0.461538461538462
Control.SRR15539832;38;38;0.447368421052632;21;17;0.0526315789473684;0.447368421052632
Control.SRR15539832;41;38;0.51219512195122;20;21;0.0121951219512195;0.48780487804878
Control.SRR15539832;39;38;0.538461538461538;18;21;0.0384615384615384;0.461538461538462
Control.SRR15539832;41;38;0.560975609756098;18;23;0.0609756097560976;0.439024390243902
Control.SRR15539832;45;38;0.511111111111111;22;23;0.0111111111111111;0.488888888888889
Control.SRR15539832;43;38;0.465116279069767;23;20;0.0348837209302326;0.465116279069767
Control.SRR15539832;43;38;0.465116279069767;23;20;0.0348837209302326;0.465116279069767
Control.SRR15539832;39;38;0.538461538461538;18;21;0.0384615384615384;0.461538461538462
Control.SRR15539832;40;38;0.55;18;22;0.05;0.45
Control.SRR15539832;36;38;0.555555555555556;16;20;0.0555555555555556;0.444444444444444
Control.SRR15539832;40;38;0.425;23;17;0.075;0.425
Control.SRR15539832;36;38;0.361111111111111;23;13;0.138888888888889;0.361111111111111
Control.SRR15539832;35;38;0.571428571428571;15;20;0.0714285714285714;0.428571428571429
Control.SRR15539832;39;38;0.41025641025641;23;16;0.0897435897435898;0.41025641025641
Control.SRR15539832;38;38;0.552631578947368;17;21;0.0526315789473685;0.447368421052632
Control.SRR15539832;37;38;0.621621621621622;14;23;0.121621621621622;0.378378378378378
Control.SRR15539832;41;38;0.390243902439024;25;16;0.109756097560976;0.390243902439024
Control.SRR15539832;39;38;0.615384615384615;15;24;0.115384615384615;0.384615384615385
Control.SRR15539832;42;38;0.642857142857143;15;27;0.142857142857143;0.357142857142857
Control.SRR15539832;38;38;0.5;19;19;0;0.5
Control.SRR15539832;44;38;0.545454545454545;20;24;0.0454545454545454;0.454545454545455
Control.SRR15539832;45;38;0.466666666666667;24;21;0.0333333333333333;0.466666666666667
Control.SRR15539832;41;38;0.658536585365854;14;27;0.158536585365854;0.341463414634146
Control.SRR15539832;40;38;0.475;21;19;0.025;0.475
Control.SRR15539832;37;38;0.567567567567568;16;21;0.0675675675675675;0.432432432432432
Control.SRR15539832;45;38;0.644444444444444;16;29;0.144444444444444;0.355555555555556
Control.SRR15539832;40;38;0.45;22;18;0.05;0.45
Control.SRR15539832;41;38;0.585365853658537;17;24;0.0853658536585366;0.414634146341463
Control.SRR15539832;38;38;0.605263157894737;15;23;0.105263157894737;0.394736842105263
Control.SRR15539832;45;38;0.4;27;18;0.1;0.4
Control.SRR15539832;38;38;0.5;19;19;0;0.5
Control.SRR15539832;44;38;0.522727272727273;21;23;0.0227272727272727;0.477272727272727
Control.SRR15539832;46;38;0.608695652173913;18;28;0.108695652173913;0.391304347826087
Control.SRR15539832;36;38;0.416666666666667;21;15;0.0833333333333333;0.416666666666667
Control.SRR15539832;42;38;0.571428571428571;18;24;0.0714285714285714;0.428571428571429
Control.SRR15539832;41;38;0.439024390243902;23;18;0.0609756097560976;0.439024390243902
Control.SRR15539832;46;38;0.630434782608696;17;29;0.130434782608696;0.369565217391304
Control.SRR15539832;35;38;0.457142857142857;19;16;0.0428571428571429;0.457142857142857
Control.SRR15539832;37;38;0.540540540540541;17;20;0.0405405405405406;0.459459459459459
Control.SRR15539832;38;38;0.447368421052632;21;17;0.0526315789473684;0.447368421052632
Control.SRR15539832;45;38;0.4;27;18;0.1;0.4
Control.SRR15539832;39;38;0.58974358974359;16;23;0.0897435897435898;0.41025641025641
Control.SRR15539832;36;38;0.5;18;18;0;0.5
Control.SRR15539832;36;38;0.333333333333333;24;12;0.166666666666667;0.333333333333333
Control.SRR15539832;44;38;0.545454545454545;20;24;0.0454545454545454;0.454545454545455
Control.SRR15539832;43;38;0.558139534883721;19;24;0.0581395348837209;0.441860465116279
Control.SRR15539832;37;38;0.486486486486487;19;18;0.0135135135135135;0.486486486486487
Control.SRR15539832;41;38;0.48780487804878;21;20;0.0121951219512195;0.48780487804878
Control.SRR15539832;36;38;0.5;18;18;0;0.5
Control.SRR15539832;37;38;0.297297297297297;26;11;0.202702702702703;0.297297297297297
Control.SRR15539832;42;38;0.452380952380952;23;19;0.0476190476190476;0.452380952380952
Control.SRR15539832;40;38;0.5;20;20;0;0.5
Control.SRR15539832;45;38;0.422222222222222;26;19;0.0777777777777778;0.422222222222222
Control.SRR15539832;44;38;0.5;22;22;0;0.5
Control.SRR15539832;40;38;0.45;22;18;0.05;0.45
Control.SRR15539832;40;38;0.475;21;19;0.025;0.475
Control.SRR15539832;43;38;0.465116279069767;23;20;0.0348837209302326;0.465116279069767
Control.SRR15539832;41;38;0.658536585365854;14;27;0.158536585365854;0.341463414634146
Control.SRR15539832;35;38;0.571428571428571;15;20;0.0714285714285714;0.428571428571429
Control.SRR15539832;39;38;0.641025641025641;14;25;0.141025641025641;0.358974358974359
Control.SRR15539832;41;38;0.463414634146341;22;19;0.0365853658536585;0.463414634146341
Control.SRR15539832;38;38;0.526315789473684;18;20;0.0263157894736842;0.473684210526316
Control.SRR15539832;40;38;0.475;21;19;0.025;0.475
Control.SRR15539832;36;38;0.5;18;18;0;0.5
Control.SRR15539832;37;38;0.486486486486487;19;18;0.0135135135135135;0.486486486486487
Control.SRR15539832;46;38;0.434782608695652;26;20;0.0652173913043478;0.434782608695652
Control.SRR15539832;43;38;0.651162790697674;15;28;0.151162790697674;0.348837209302326
Control.SRR15539832;39;38;0.487179487179487;20;19;0.0128205128205128;0.487179487179487
Control.SRR15539832;36;38;0.472222222222222;19;17;0.0277777777777778;0.472222222222222
Control.SRR15539832;44;38;0.454545454545455;24;20;0.0454545454545455;0.454545454545455
Control.SRR15539832;36;38;0.583333333333333;15;21;0.0833333333333334;0.416666666666667
Control.SRR15539832;41;38;0.463414634146341;22;19;0.0365853658536585;0.463414634146341
Control.SRR15539832;38;38;0.5;19;19;0;0.5
Control.SRR15539832;38;38;0.552631578947368;17;21;0.0526315789473685;0.447368421052632
Control.SRR15539832;36;38;0.416666666666667;21;15;0.0833333333333333;0.416666666666667
Control.SRR15539832;40;38;0.45;22;18;0.05;0.45
Control.SRR15539832;35;38;0.542857142857143;16;19;0.0428571428571428;0.457142857142857
Control.SRR15539832;42;38;0.571428571428571;18;24;0.0714285714285714;0.428571428571429
Control.SRR15539832;43;38;0.441860465116279;24;19;0.0581395348837209;0.441860465116279
Control.SRR15539832;38;38;0.447368421052632;21;17;0.0526315789473684;0.447368421052632
Control.SRR15539832;44;38;0.545454545454545;20;24;0.0454545454545454;0.454545454545455
Control.SRR15539832;38;38;0.447368421052632;21;17;0.0526315789473684;0.447368421052632
Control.SRR15539832;35;38;0.542857142857143;16;19;0.0428571428571428;0.457142857142857
Control.SRR15539832;39;38;0.58974358974359;16;23;0.0897435897435898;0.41025641025641
Control.SRR15539832;42;38;0.547619047619048;19;23;0.0476190476190477;0.452380952380952
Control.SRR15539832;38;38;0.368421052631579;24;14;0.131578947368421;0.368421052631579
Control.SRR15539832;36;38;0.472222222222222;19;17;0.0277777777777778;0.472222222222222
Control.SRR15539832;43;38;0.372093023255814;27;16;0.127906976744186;0.372093023255814
Control.SRR15539832;42;38;0.5;21;21;0;0.5
Control.SRR15539832;38;38;0.342105263157895;25;13;0.157894736842105;0.342105263157895
Control.SRR15539832;36;38;0.555555555555556;16;20;0.0555555555555556;0.444444444444444
Control.SRR15539832;42;38;0.5;21;21;0;0.5
Control.SRR15539832;38;38;0.342105263157895;25;13;0.157894736842105;0.342105263157895
Control.SRR15539832;38;38;0.526315789473684;18;20;0.0263157894736842;0.473684210526316
Control.SRR15539832;40;38;0.475;21;19;0.025;0.475
Control.SRR15539832;46;38;0.565217391304348;20;26;0.0652173913043478;0.434782608695652
Control.SRR15539832;44;38;0.522727272727273;21;23;0.0227272727272727;0.477272727272727
Control.SRR15539832;41;38;0.536585365853659;19;22;0.0365853658536586;0.463414634146341
Control.SRR15539832;46;38;0.543478260869565;21;25;0.0434782608695652;0.456521739130435
Control.SRR15539832;36;38;0.305555555555556;25;11;0.194444444444444;0.305555555555556
Control.SRR15539832;41;38;0.365853658536585;26;15;0.134146341463415;0.365853658536585
Control.SRR15539832;40;38;0.375;25;15;0.125;0.375
Control.SRR15539832;36;38;0.444444444444444;20;16;0.0555555555555556;0.444444444444444
Control.SRR15539832;35;38;0.457142857142857;19;16;0.0428571428571429;0.457142857142857
Control.SRR15539832;38;38;0.5;19;19;0;0.5
Control.SRR15539832;41;38;0.463414634146341;22;19;0.0365853658536585;0.463414634146341
Control.SRR15539832;35;38;0.514285714285714;17;18;0.0142857142857142;0.485714285714286
Control.SRR15539832;35;38;0.514285714285714;17;18;0.0142857142857142;0.485714285714286
Control.SRR15539832;43;38;0.534883720930233;20;23;0.0348837209302325;0.465116279069767
Control.SRR15539832;41;38;0.463414634146341;22;19;0.0365853658536585;0.463414634146341
Control.SRR15539832;41;38;0.585365853658537;17;24;0.0853658536585366;0.414634146341463
Control.SRR15539832;40;38;0.375;25;15;0.125;0.375
Control.SRR15539832;42;38;0.523809523809524;20;22;0.0238095238095238;0.476190476190476
Control.SRR15539832;39;38;0.41025641025641;23;16;0.0897435897435898;0.41025641025641
Control.SRR15539832;40;38;0.3;28;12;0.2;0.3
Control.SRR15539832;41;38;0.609756097560976;16;25;0.109756097560976;0.390243902439024
Control.SRR15539832;35;38;0.542857142857143;16;19;0.0428571428571428;0.457142857142857
Control.SRR15539832;36;38;0.388888888888889;22;14;0.111111111111111;0.388888888888889
Control.SRR15539832;39;38;0.564102564102564;17;22;0.0641025641025641;0.435897435897436
Control.SRR15539832;40;38;0.425;23;17;0.075;0.425
Control.SRR15539832;44;38;0.636363636363636;16;28;0.136363636363636;0.363636363636364
Control.SRR15539832;37;38;0.621621621621622;14;23;0.121621621621622;0.378378378378378
Control.SRR15539832;40;38;0.375;25;15;0.125;0.375
Control.SRR15539832;35;38;0.485714285714286;18;17;0.0142857142857143;0.485714285714286
Control.SRR15539832;43;38;0.488372093023256;22;21;0.0116279069767442;0.488372093023256
Control.SRR15539832;39;38;0.41025641025641;23;16;0.0897435897435898;0.41025641025641
Control.SRR15539832;37;38;0.459459459459459;20;17;0.0405405405405405;0.459459459459459
Control.SRR15539832;46;38;0.391304347826087;28;18;0.108695652173913;0.391304347826087
Control.SRR15539832;35;38;0.4;21;14;0.1;0.4
Control.SRR15539832;35;38;0.4;21;14;0.1;0.4
Control.SRR15539832;36;38;0.5;18;18;0;0.5
Control.SRR15539832;38;38;0.5;19;19;0;0.5
Control.SRR15539832;41;38;0.24390243902439;31;10;0.25609756097561;0.24390243902439
Control.SRR15539832;42;38;0.547619047619048;19;23;0.0476190476190477;0.452380952380952
Control.SRR15539832;36;38;0.638888888888889;13;23;0.138888888888889;0.361111111111111
Control.SRR15539832;42;38;0.523809523809524;20;22;0.0238095238095238;0.476190476190476
Control.SRR15539832;38;38;0.473684210526316;20;18;0.0263157894736842;0.473684210526316
Control.SRR15539832;38;38;0.5;19;19;0;0.5
Control.SRR15539832;38;38;0.631578947368421;14;24;0.131578947368421;0.368421052631579
Control.SRR15539832;38;38;0.421052631578947;22;16;0.0789473684210527;0.421052631578947
Control.SRR15539832;40;38;0.425;23;17;0.075;0.425
Control.SRR15539832;46;38;0.543478260869565;21;25;0.0434782608695652;0.456521739130435
Control.SRR15539832;37;38;0.513513513513513;18;19;0.0135135135135135;0.486486486486487
Control.SRR15539832;37;38;0.648648648648649;13;24;0.148648648648649;0.351351351351351
Control.SRR15539832;45;38;0.488888888888889;23;22;0.0111111111111111;0.488888888888889
Control.SRR15539832;37;38;0.621621621621622;14;23;0.121621621621622;0.378378378378378
Control.SRR15539832;41;38;0.341463414634146;27;14;0.158536585365854;0.341463414634146
Control.SRR15539832;44;38;0.522727272727273;21;23;0.0227272727272727;0.477272727272727
Control.SRR15539832;41;38;0.48780487804878;21;20;0.0121951219512195;0.48780487804878
Control.SRR15539832;38;38;0.605263157894737;15;23;0.105263157894737;0.394736842105263
Control.SRR15539832;38;38;0.5;19;19;0;0.5
Control.SRR15539832;36;38;0.444444444444444;20;16;0.0555555555555556;0.444444444444444
Control.SRR15539832;39;38;0.435897435897436;22;17;0.0641025641025641;0.435897435897436
Control.SRR15539832;35;38;0.457142857142857;19;16;0.0428571428571429;0.457142857142857
Control.SRR15539832;37;38;0.351351351351351;24;13;0.148648648648649;0.351351351351351
Control.SRR15539832;35;38;0.4;21;14;0.1;0.4
Control.SRR15539832;40;38;0.5;20;20;0;0.5
Control.SRR15539832;38;38;0.552631578947368;17;21;0.0526315789473685;0.447368421052632
Control.SRR15539832;35;38;0.485714285714286;18;17;0.0142857142857143;0.485714285714286
Control.SRR15539832;45;38;0.466666666666667;24;21;0.0333333333333333;0.466666666666667
Control.SRR15539832;43;38;0.581395348837209;18;25;0.0813953488372093;0.418604651162791
Control.SRR15539832;35;38;0.457142857142857;19;16;0.0428571428571429;0.457142857142857
Control.SRR15539832;40;38;0.5;20;20;0;0.5
Control.SRR15539832;35;38;0.457142857142857;19;16;0.0428571428571429;0.457142857142857
Control.SRR15539832;38;38;0.605263157894737;15;23;0.105263157894737;0.394736842105263
Control.SRR15539832;37;38;0.405405405405405;22;15;0.0945945945945946;0.405405405405405
Control.SRR15539832;43;38;0.627906976744186;16;27;0.127906976744186;0.372093023255814
Control.SRR15539832;40;38;0.4;24;16;0.1;0.4
Control.SRR15539832;42;38;0.428571428571429;24;18;0.0714285714285715;0.428571428571429
Control.SRR15539832;39;38;0.564102564102564;17;22;0.0641025641025641;0.435897435897436
Control.SRR15539832;35;38;0.6;14;21;0.1;0.4
Control.SRR15539832;40;38;0.525;19;21;0.025;0.475
Control.SRR15539832;40;38;0.45;22;18;0.05;0.45
Control.SRR15539832;45;38;0.533333333333333;21;24;0.0333333333333333;0.466666666666667
Control.SRR15539832;36;38;0.611111111111111;14;22;0.111111111111111;0.388888888888889
Control.SRR15539832;40;38;0.475;21;19;0.025;0.475
Control.SRR15539832;45;38;0.444444444444444;25;20;0.0555555555555556;0.444444444444444
Control.SRR15539832;40;38;0.5;20;20;0;0.5
Control.SRR15539832;46;38;0.58695652173913;19;27;0.0869565217391305;0.41304347826087
Control.SRR15539832;46;38;0.369565217391304;29;17;0.130434782608696;0.369565217391304
Control.SRR15539832;40;38;0.575;17;23;0.075;0.425
Control.SRR15539832;40;38;0.45;22;18;0.05;0.45
Control.SRR15539832;41;38;0.560975609756098;18;23;0.0609756097560976;0.439024390243902
Control.SRR15539832;36;38;0.5;18;18;0;0.5
Control.SRR15539832;40;38;0.525;19;21;0.025;0.475
Control.SRR15539832;43;38;0.604651162790698;17;26;0.104651162790698;0.395348837209302
Control.SRR15539832;39;38;0.487179487179487;20;19;0.0128205128205128;0.487179487179487
Control.SRR15539832;38;38;0.394736842105263;23;15;0.105263157894737;0.394736842105263
Control.SRR15539832;41;38;0.463414634146341;22;19;0.0365853658536585;0.463414634146341
Control.SRR15539832;46;38;0.434782608695652;26;20;0.0652173913043478;0.434782608695652
Control.SRR15539832;40;38;0.575;17;23;0.075;0.425
Control.SRR15539832;39;38;0.435897435897436;22;17;0.0641025641025641;0.435897435897436
Control.SRR15539832;42;38;0.571428571428571;18;24;0.0714285714285714;0.428571428571429
Control.SRR15539832;44;38;0.5;22;22;0;0.5
Control.SRR15539832;46;38;0.434782608695652;26;20;0.0652173913043478;0.434782608695652
Control.SRR15539832;39;38;0.487179487179487;20;19;0.0128205128205128;0.487179487179487
Control.SRR15539832;39;38;0.435897435897436;22;17;0.0641025641025641;0.435897435897436
Control.SRR15539832;40;38;0.55;18;22;0.05;0.45
Control.SRR15539832;41;38;0.536585365853659;19;22;0.0365853658536586;0.463414634146341
Control.SRR15539832;37;38;0.486486486486487;19;18;0.0135135135135135;0.486486486486487
Control.SRR15539832;41;38;0.268292682926829;30;11;0.231707317073171;0.268292682926829
Control.SRR15539832;37;38;0.567567567567568;16;21;0.0675675675675675;0.432432432432432
Control.SRR15539832;39;38;0.461538461538462;21;18;0.0384615384615384;0.461538461538462
Control.SRR15539832;36;38;0.472222222222222;19;17;0.0277777777777778;0.472222222222222
Control.SRR15539832;36;38;0.5;18;18;0;0.5
Control.SRR15539832;40;38;0.55;18;22;0.05;0.45
Control.SRR15539832;41;38;0.439024390243902;23;18;0.0609756097560976;0.439024390243902
Control.SRR15539832;43;38;0.511627906976744;21;22;0.0116279069767442;0.488372093023256
Control.SRR15539832;38;38;0.5;19;19;0;0.5
Control.SRR15539832;43;38;0.488372093023256;22;21;0.0116279069767442;0.488372093023256
Control.SRR15539832;42;38;0.547619047619048;19;23;0.0476190476190477;0.452380952380952
Control.SRR15539832;44;38;0.386363636363636;27;17;0.113636363636364;0.386363636363636
Control.SRR15539832;41;38;0.390243902439024;25;16;0.109756097560976;0.390243902439024
Control.SRR15539832;42;38;0.547619047619048;19;23;0.0476190476190477;0.452380952380952
Control.SRR15539832;36;38;0.472222222222222;19;17;0.0277777777777778;0.472222222222222
Control.SRR15539832;41;38;0.439024390243902;23;18;0.0609756097560976;0.439024390243902
Control.SRR15539832;41;38;0.414634146341463;24;17;0.0853658536585366;0.414634146341463
Control.SRR15539832;41;38;0.560975609756098;18;23;0.0609756097560976;0.439024390243902
Control.SRR15539832;43;38;0.674418604651163;14;29;0.174418604651163;0.325581395348837
Control.SRR15539832;38;38;0.473684210526316;20;18;0.0263157894736842;0.473684210526316
Control.SRR15539832;41;38;0.439024390243902;23;18;0.0609756097560976;0.439024390243902
Control.SRR15539832;43;38;0.581395348837209;18;25;0.0813953488372093;0.418604651162791
Control.SRR15539832;39;38;0.564102564102564;17;22;0.0641025641025641;0.435897435897436
Control.SRR15539832;37;38;0.432432432432432;21;16;0.0675675675675675;0.432432432432432
Control.SRR15539832;43;38;0.418604651162791;25;18;0.0813953488372093;0.418604651162791
Control.SRR15539832;42;38;0.571428571428571;18;24;0.0714285714285714;0.428571428571429
Control.SRR15539832;45;38;0.422222222222222;26;19;0.0777777777777778;0.422222222222222
Control.SRR15539832;42;38;0.428571428571429;24;18;0.0714285714285715;0.428571428571429
Control.SRR15539832;37;38;0.594594594594595;15;22;0.0945945945945946;0.405405405405405
Control.SRR15539832;43;38;0.418604651162791;25;18;0.0813953488372093;0.418604651162791
Control.SRR15539832;38;38;0.421052631578947;22;16;0.0789473684210527;0.421052631578947
Control.SRR15539832;42;38;0.547619047619048;19;23;0.0476190476190477;0.452380952380952
Control.SRR15539832;41;38;0.48780487804878;21;20;0.0121951219512195;0.48780487804878
Control.SRR15539832;40;38;0.35;26;14;0.15;0.35
Control.SRR15539832;39;38;0.461538461538462;21;18;0.0384615384615384;0.461538461538462
Control.SRR15539832;39;38;0.487179487179487;20;19;0.0128205128205128;0.487179487179487
Control.SRR15539832;38;38;0.526315789473684;18;20;0.0263157894736842;0.473684210526316
Control.SRR15539832;35;38;0.428571428571429;20;15;0.0714285714285715;0.428571428571429
Control.SRR15539832;35;38;0.314285714285714;24;11;0.185714285714286;0.314285714285714
Control.SRR15539832;46;38;0.5;23;23;0;0.5
Control.SRR15539832;38;38;0.5;19;19;0;0.5
Control.SRR15539832;35;38;0.6;14;21;0.1;0.4
Control.SRR15539832;38;38;0.631578947368421;14;24;0.131578947368421;0.368421052631579
Control.SRR15539832;42;38;0.452380952380952;23;19;0.0476190476190476;0.452380952380952
Control.SRR15539832;41;38;0.560975609756098;18;23;0.0609756097560976;0.439024390243902
Control.SRR15539832;35;38;0.685714285714286;11;24;0.185714285714286;0.314285714285714
Control.SRR15539832;41;38;0.560975609756098;18;23;0.0609756097560976;0.439024390243902
Control.SRR15539832;37;38;0.405405405405405;22;15;0.0945945945945946;0.405405405405405
Control.SRR15539832;43;38;0.534883720930233;20;23;0.0348837209302325;0.465116279069767
Control.SRR15539832;36;38;0.444444444444444;20;16;0.0555555555555556;0.444444444444444
Control.SRR15539832;38;38;0.447368421052632;21;17;0.0526315789473684;0.447368421052632
Control.SRR15539832;42;38;0.523809523809524;20;22;0.0238095238095238;0.476190476190476
Control.SRR15539832;39;38;0.384615384615385;24;15;0.115384615384615;0.384615384615385
Control.SRR15539832;39;38;0.487179487179487;20;19;0.0128205128205128;0.487179487179487
Control.SRR15539832;36;38;0.527777777777778;17;19;0.0277777777777778;0.472222222222222
Control.SRR15539832;46;38;0.478260869565217;24;22;0.0217391304347826;0.478260869565217
Control.SRR15539832;37;38;0.432432432432432;21;16;0.0675675675675675;0.432432432432432
Control.SRR15539832;35;38;0.628571428571429;13;22;0.128571428571429;0.371428571428571
Control.SRR15539832;41;38;0.585365853658537;17;24;0.0853658536585366;0.414634146341463
Control.SRR15539832;36;38;0.5;18;18;0;0.5
Control.SRR15539832;46;38;0.5;23;23;0;0.5
Control.SRR15539832;46;38;0.434782608695652;26;20;0.0652173913043478;0.434782608695652
Control.SRR15539832;37;38;0.567567567567568;16;21;0.0675675675675675;0.432432432432432
Control.SRR15539832;43;38;0.488372093023256;22;21;0.0116279069767442;0.488372093023256
Control.SRR15539832;41;38;0.414634146341463;24;17;0.0853658536585366;0.414634146341463
Control.SRR15539832;37;38;0.594594594594595;15;22;0.0945945945945946;0.405405405405405
Control.SRR15539832;36;38;0.388888888888889;22;14;0.111111111111111;0.388888888888889
Control.SRR15539832;44;38;0.272727272727273;32;12;0.227272727272727;0.272727272727273
Control.SRR15539832;36;38;0.444444444444444;20;16;0.0555555555555556;0.444444444444444
Control.SRR15539832;45;38;0.511111111111111;22;23;0.0111111111111111;0.488888888888889
Control.SRR15539832;40;38;0.625;15;25;0.125;0.375
Control.SRR15539832;35;38;0.542857142857143;16;19;0.0428571428571428;0.457142857142857
Control.SRR15539832;44;38;0.386363636363636;27;17;0.113636363636364;0.386363636363636
Control.SRR15539832;46;38;0.478260869565217;24;22;0.0217391304347826;0.478260869565217
Control.SRR15539832;46;38;0.41304347826087;27;19;0.0869565217391304;0.41304347826087
Control.SRR15539832;39;38;0.564102564102564;17;22;0.0641025641025641;0.435897435897436
Control.SRR15539832;36;38;0.555555555555556;16;20;0.0555555555555556;0.444444444444444
Control.SRR15539832;35;38;0.342857142857143;23;12;0.157142857142857;0.342857142857143
Control.SRR15539832;38;38;0.526315789473684;18;20;0.0263157894736842;0.473684210526316
Control.SRR15539832;46;38;0.434782608695652;26;20;0.0652173913043478;0.434782608695652
Control.SRR15539832;45;38;0.466666666666667;24;21;0.0333333333333333;0.466666666666667
Control.SRR15539832;39;38;0.487179487179487;20;19;0.0128205128205128;0.487179487179487
Control.SRR15539832;41;38;0.536585365853659;19;22;0.0365853658536586;0.463414634146341
Control.SRR15539832;43;38;0.488372093023256;22;21;0.0116279069767442;0.488372093023256
Control.SRR15539832;35;38;0.371428571428571;22;13;0.128571428571429;0.371428571428571
Control.SRR15539832;38;38;0.473684210526316;20;18;0.0263157894736842;0.473684210526316
Control.SRR15539832;45;38;0.466666666666667;24;21;0.0333333333333333;0.466666666666667
Control.SRR15539832;45;38;0.333333333333333;30;15;0.166666666666667;0.333333333333333
Control.SRR15539832;37;38;0.459459459459459;20;17;0.0405405405405405;0.459459459459459
Control.SRR15539832;43;38;0.558139534883721;19;24;0.0581395348837209;0.441860465116279
Control.SRR15539832;37;38;0.540540540540541;17;20;0.0405405405405406;0.459459459459459
Control.SRR15539832;46;38;0.5;23;23;0;0.5
Control.SRR15539832;44;38;0.681818181818182;14;30;0.181818181818182;0.318181818181818
Control.SRR15539832;37;38;0.648648648648649;13;24;0.148648648648649;0.351351351351351
Control.SRR15539832;38;38;0.394736842105263;23;15;0.105263157894737;0.394736842105263
Control.SRR15539832;37;38;0.567567567567568;16;21;0.0675675675675675;0.432432432432432
Control.SRR15539832;42;38;0.619047619047619;16;26;0.119047619047619;0.380952380952381
Control.SRR15539832;41;38;0.439024390243902;23;18;0.0609756097560976;0.439024390243902
Control.SRR15539832;35;38;0.485714285714286;18;17;0.0142857142857143;0.485714285714286
Control.SRR15539832;36;38;0.444444444444444;20;16;0.0555555555555556;0.444444444444444
Control.SRR15539832;40;38;0.625;15;25;0.125;0.375
Control.SRR15539832;43;38;0.558139534883721;19;24;0.0581395348837209;0.441860465116279
Control.SRR15539832;46;38;0.565217391304348;20;26;0.0652173913043478;0.434782608695652
Control.SRR15539832;37;38;0.486486486486487;19;18;0.0135135135135135;0.486486486486487
Control.SRR15539832;35;38;0.485714285714286;18;17;0.0142857142857143;0.485714285714286
Control.SRR15539832;39;38;0.58974358974359;16;23;0.0897435897435898;0.41025641025641
Control.SRR15539832;42;38;0.476190476190476;22;20;0.0238095238095238;0.476190476190476
Control.SRR15539832;36;38;0.444444444444444;20;16;0.0555555555555556;0.444444444444444
Control.SRR15539832;41;38;0.536585365853659;19;22;0.0365853658536586;0.463414634146341
Control.SRR15539832;35;38;0.628571428571429;13;22;0.128571428571429;0.371428571428571
Control.SRR15539832;39;38;0.384615384615385;24;15;0.115384615384615;0.384615384615385
Control.SRR15539832;40;38;0.575;17;23;0.075;0.425
Control.SRR15539832;43;38;0.511627906976744;21;22;0.0116279069767442;0.488372093023256
Control.SRR15539832;43;38;0.441860465116279;24;19;0.0581395348837209;0.441860465116279
Control.SRR15539832;44;38;0.522727272727273;21;23;0.0227272727272727;0.477272727272727
Control.SRR15539832;38;38;0.552631578947368;17;21;0.0526315789473685;0.447368421052632
Control.SRR15539832;36;38;0.472222222222222;19;17;0.0277777777777778;0.472222222222222
Control.SRR15539832;36;38;0.611111111111111;14;22;0.111111111111111;0.388888888888889
Control.SRR15539832;35;38;0.542857142857143;16;19;0.0428571428571428;0.457142857142857
Control.SRR15539832;42;38;0.571428571428571;18;24;0.0714285714285714;0.428571428571429
Control.SRR15539832;40;38;0.375;25;15;0.125;0.375
Control.SRR15539832;40;38;0.625;15;25;0.125;0.375
Control.SRR15539832;43;38;0.395348837209302;26;17;0.104651162790698;0.395348837209302
Control.SRR15539832;36;38;0.527777777777778;17;19;0.0277777777777778;0.472222222222222
Control.SRR15539832;45;38;0.422222222222222;26;19;0.0777777777777778;0.422222222222222
Control.SRR15539832;37;38;0.567567567567568;16;21;0.0675675675675675;0.432432432432432
Control.SRR15539832;42;38;0.5;21;21;0;0.5
Control.SRR15539832;37;38;0.513513513513513;18;19;0.0135135135135135;0.486486486486487
Control.SRR15539832;39;38;0.564102564102564;17;22;0.0641025641025641;0.435897435897436
Control.SRR15539832;42;38;0.642857142857143;15;27;0.142857142857143;0.357142857142857
Control.SRR15539832;37;38;0.243243243243243;28;9;0.256756756756757;0.243243243243243
Control.SRR15539832;41;38;0.51219512195122;20;21;0.0121951219512195;0.48780487804878
Control.SRR15539832;36;38;0.444444444444444;20;16;0.0555555555555556;0.444444444444444
Control.SRR15539832;35;38;0.542857142857143;16;19;0.0428571428571428;0.457142857142857
Control.SRR15539832;44;38;0.545454545454545;20;24;0.0454545454545454;0.454545454545455
Control.SRR15539832;41;38;0.51219512195122;20;21;0.0121951219512195;0.48780487804878
Control.SRR15539832;42;38;0.571428571428571;18;24;0.0714285714285714;0.428571428571429
Control.SRR15539832;38;38;0.605263157894737;15;23;0.105263157894737;0.394736842105263
Control.SRR15539832;37;38;0.513513513513513;18;19;0.0135135135135135;0.486486486486487
Control.SRR15539832;38;38;0.578947368421053;16;22;0.0789473684210527;0.421052631578947
Control.SRR15539832;38;38;0.578947368421053;16;22;0.0789473684210527;0.421052631578947
Control.SRR15539832;43;38;0.511627906976744;21;22;0.0116279069767442;0.488372093023256
Control.SRR15539832;40;38;0.5;20;20;0;0.5
Control.SRR15539832;42;38;0.547619047619048;19;23;0.0476190476190477;0.452380952380952
Control.SRR15539832;41;38;0.48780487804878;21;20;0.0121951219512195;0.48780487804878
Control.SRR15539832;45;38;0.511111111111111;22;23;0.0111111111111111;0.488888888888889
Control.SRR15539832;36;38;0.555555555555556;16;20;0.0555555555555556;0.444444444444444
Control.SRR15539832;43;38;0.325581395348837;29;14;0.174418604651163;0.325581395348837
Control.SRR15539832;41;38;0.51219512195122;20;21;0.0121951219512195;0.48780487804878
Control.SRR15539832;43;38;0.511627906976744;21;22;0.0116279069767442;0.488372093023256
Control.SRR15539832;40;38;0.575;17;23;0.075;0.425
Control.SRR15539832;42;38;0.5;21;21;0;0.5
Control.SRR15539832;38;38;0.421052631578947;22;16;0.0789473684210527;0.421052631578947
Control.SRR15539832;43;38;0.558139534883721;19;24;0.0581395348837209;0.441860465116279
Control.SRR15539832;42;38;0.452380952380952;23;19;0.0476190476190476;0.452380952380952
Control.SRR15539832;43;38;0.581395348837209;18;25;0.0813953488372093;0.418604651162791
Control.SRR15539832;43;38;0.348837209302326;28;15;0.151162790697674;0.348837209302326
Control.SRR15539832;37;38;0.540540540540541;17;20;0.0405405405405406;0.459459459459459
Control.SRR15539832;38;38;0.552631578947368;17;21;0.0526315789473685;0.447368421052632
Control.SRR15539832;38;38;0.421052631578947;22;16;0.0789473684210527;0.421052631578947
Control.SRR15539832;44;38;0.340909090909091;29;15;0.159090909090909;0.340909090909091
Control.SRR15539832;35;38;0.628571428571429;13;22;0.128571428571429;0.371428571428571
Control.SRR15539832;36;38;0.555555555555556;16;20;0.0555555555555556;0.444444444444444
Control.SRR15539832;35;38;0.457142857142857;19;16;0.0428571428571429;0.457142857142857
Control.SRR15539832;36;38;0.444444444444444;20;16;0.0555555555555556;0.444444444444444
Control.SRR15539832;35;38;0.714285714285714;10;25;0.214285714285714;0.285714285714286
Control.SRR15539832;42;38;0.5;21;21;0;0.5
Control.SRR15539832;43;38;0.465116279069767;23;20;0.0348837209302326;0.465116279069767
Control.SRR15539832;37;38;0.567567567567568;16;21;0.0675675675675675;0.432432432432432
Control.SRR15539832;43;38;0.511627906976744;21;22;0.0116279069767442;0.488372093023256
Control.SRR15539832;42;38;0.404761904761905;25;17;0.0952380952380952;0.404761904761905
Control.SRR15539832;42;38;0.380952380952381;26;16;0.119047619047619;0.380952380952381
Control.SRR15539832;36;38;0.5;18;18;0;0.5
Control.SRR15539832;37;38;0.513513513513513;18;19;0.0135135135135135;0.486486486486487
Control.SRR15539832;36;38;0.388888888888889;22;14;0.111111111111111;0.388888888888889
Control.SRR15539832;41;38;0.365853658536585;26;15;0.134146341463415;0.365853658536585
Control.SRR15539832;39;38;0.435897435897436;22;17;0.0641025641025641;0.435897435897436
Control.SRR15539832;43;38;0.627906976744186;16;27;0.127906976744186;0.372093023255814
Control.SRR15539832;38;38;0.421052631578947;22;16;0.0789473684210527;0.421052631578947
Control.SRR15539832;36;38;0.666666666666667;12;24;0.166666666666667;0.333333333333333
Control.SRR15539832;45;38;0.577777777777778;19;26;0.0777777777777777;0.422222222222222
Control.SRR15539832;44;38;0.568181818181818;19;25;0.0681818181818182;0.431818181818182
Control.SRR15539832;37;38;0.594594594594595;15;22;0.0945945945945946;0.405405405405405
Control.SRR15539832;44;38;0.454545454545455;24;20;0.0454545454545455;0.454545454545455
Control.SRR15539832;36;38;0.527777777777778;17;19;0.0277777777777778;0.472222222222222
Control.SRR15539832;38;38;0.578947368421053;16;22;0.0789473684210527;0.421052631578947
Control.SRR15539832;38;38;0.394736842105263;23;15;0.105263157894737;0.394736842105263
Control.SRR15539832;43;38;0.488372093023256;22;21;0.0116279069767442;0.488372093023256
Control.SRR15539832;37;38;0.405405405405405;22;15;0.0945945945945946;0.405405405405405
Control.SRR15539832;39;38;0.512820512820513;19;20;0.0128205128205128;0.487179487179487
Control.SRR15539832;40;38;0.525;19;21;0.025;0.475
Control.SRR15539832;41;38;0.48780487804878;21;20;0.0121951219512195;0.48780487804878
Control.SRR15539832;43;38;0.511627906976744;21;22;0.0116279069767442;0.488372093023256
Control.SRR15539832;35;38;0.371428571428571;22;13;0.128571428571429;0.371428571428571
Control.SRR15539832;41;38;0.634146341463415;15;26;0.134146341463415;0.365853658536585
Control.SRR15539832;39;38;0.538461538461538;18;21;0.0384615384615384;0.461538461538462
Control.SRR15539832;40;38;0.4;24;16;0.1;0.4
Control.SRR15539832;43;38;0.441860465116279;24;19;0.0581395348837209;0.441860465116279
Control.SRR15539832;41;38;0.463414634146341;22;19;0.0365853658536585;0.463414634146341
Control.SRR15539832;40;38;0.6;16;24;0.1;0.4
Control.SRR15539832;44;38;0.545454545454545;20;24;0.0454545454545454;0.454545454545455
Control.SRR15539832;40;38;0.45;22;18;0.05;0.45
Control.SRR15539832;42;38;0.619047619047619;16;26;0.119047619047619;0.380952380952381
Control.SRR15539832;44;38;0.409090909090909;26;18;0.0909090909090909;0.409090909090909
Control.SRR15539832;40;38;0.375;25;15;0.125;0.375
Control.SRR15539832;39;38;0.384615384615385;24;15;0.115384615384615;0.384615384615385
Control.SRR15539832;45;38;0.511111111111111;22;23;0.0111111111111111;0.488888888888889
Control.SRR15539832;40;38;0.5;20;20;0;0.5
Control.SRR15539832;37;38;0.486486486486487;19;18;0.0135135135135135;0.486486486486487
Control.SRR15539832;36;38;0.527777777777778;17;19;0.0277777777777778;0.472222222222222
Control.SRR15539832;42;38;0.5;21;21;0;0.5
Control.SRR15539832;44;38;0.409090909090909;26;18;0.0909090909090909;0.409090909090909
Control.SRR15539832;43;38;0.372093023255814;27;16;0.127906976744186;0.372093023255814
Control.SRR15539832;45;38;0.577777777777778;19;26;0.0777777777777777;0.422222222222222
Control.SRR15539832;41;38;0.585365853658537;17;24;0.0853658536585366;0.414634146341463
Control.SRR15539832;39;38;0.384615384615385;24;15;0.115384615384615;0.384615384615385
Control.SRR15539832;46;38;0.58695652173913;19;27;0.0869565217391305;0.41304347826087
Control.SRR15539832;43;38;0.604651162790698;17;26;0.104651162790698;0.395348837209302
Control.SRR15539832;42;38;0.452380952380952;23;19;0.0476190476190476;0.452380952380952
Control.SRR15539832;43;38;0.395348837209302;26;17;0.104651162790698;0.395348837209302
Control.SRR15539832;39;38;0.435897435897436;22;17;0.0641025641025641;0.435897435897436
Control.SRR15539832;37;38;0.432432432432432;21;16;0.0675675675675675;0.432432432432432
Control.SRR15539832;44;38;0.636363636363636;16;28;0.136363636363636;0.363636363636364
Control.SRR15539832;40;38;0.55;18;22;0.05;0.45
Control.SRR15539832;40;38;0.45;22;18;0.05;0.45
Control.SRR15539832;39;38;0.435897435897436;22;17;0.0641025641025641;0.435897435897436
Control.SRR15539832;38;38;0.394736842105263;23;15;0.105263157894737;0.394736842105263
Control.SRR15539832;35;38;0.371428571428571;22;13;0.128571428571429;0.371428571428571
Control.SRR15539832;35;38;0.4;21;14;0.1;0.4
Control.SRR15539832;43;38;0.511627906976744;21;22;0.0116279069767442;0.488372093023256
Control.SRR15539832;41;38;0.439024390243902;23;18;0.0609756097560976;0.439024390243902
Control.SRR15539832;40;38;0.525;19;21;0.025;0.475
Control.SRR15539832;37;38;0.594594594594595;15;22;0.0945945945945946;0.405405405405405
Control.SRR15539832;41;38;0.463414634146341;22;19;0.0365853658536585;0.463414634146341
Control.SRR15539832;41;38;0.560975609756098;18;23;0.0609756097560976;0.439024390243902
Control.SRR15539832;35;38;0.542857142857143;16;19;0.0428571428571428;0.457142857142857
Control.SRR15539832;38;38;0.578947368421053;16;22;0.0789473684210527;0.421052631578947
Control.SRR15539832;38;38;0.552631578947368;17;21;0.0526315789473685;0.447368421052632
Control.SRR15539832;45;38;0.422222222222222;26;19;0.0777777777777778;0.422222222222222
Control.SRR15539832;38;38;0.473684210526316;20;18;0.0263157894736842;0.473684210526316
Control.SRR15539832;42;38;0.476190476190476;22;20;0.0238095238095238;0.476190476190476
Control.SRR15539832;35;38;0.571428571428571;15;20;0.0714285714285714;0.428571428571429
Control.SRR15539832;38;38;0.5;19;19;0;0.5
Control.SRR15539832;46;38;0.608695652173913;18;28;0.108695652173913;0.391304347826087
Control.SRR15539832;35;38;0.485714285714286;18;17;0.0142857142857143;0.485714285714286
Control.SRR15539832;35;38;0.485714285714286;18;17;0.0142857142857143;0.485714285714286
Control.SRR15539832;35;38;0.628571428571429;13;22;0.128571428571429;0.371428571428571
Control.SRR15539832;42;38;0.619047619047619;16;26;0.119047619047619;0.380952380952381
Control.SRR15539832;39;38;0.487179487179487;20;19;0.0128205128205128;0.487179487179487
Control.SRR15539832;43;38;0.697674418604651;13;30;0.197674418604651;0.302325581395349
Control.SRR15539832;42;38;0.642857142857143;15;27;0.142857142857143;0.357142857142857
Control.SRR15539832;45;38;0.444444444444444;25;20;0.0555555555555556;0.444444444444444
Control.SRR15539832;38;38;0.394736842105263;23;15;0.105263157894737;0.394736842105263
Control.SRR15539832;40;38;0.5;20;20;0;0.5
Control.SRR15539832;43;38;0.558139534883721;19;24;0.0581395348837209;0.441860465116279
Control.SRR15539832;40;38;0.55;18;22;0.05;0.45
Control.SRR15539832;37;38;0.405405405405405;22;15;0.0945945945945946;0.405405405405405
Control.SRR15539832;38;38;0.394736842105263;23;15;0.105263157894737;0.394736842105263
Control.SRR15539832;39;38;0.512820512820513;19;20;0.0128205128205128;0.487179487179487
Control.SRR15539832;37;38;0.540540540540541;17;20;0.0405405405405406;0.459459459459459
Control.SRR15539832;39;38;0.487179487179487;20;19;0.0128205128205128;0.487179487179487
Control.SRR15539832;37;38;0.432432432432432;21;16;0.0675675675675675;0.432432432432432
Control.SRR15539832;42;38;0.404761904761905;25;17;0.0952380952380952;0.404761904761905
Control.SRR15539832;36;38;0.444444444444444;20;16;0.0555555555555556;0.444444444444444
Control.SRR15539832;35;38;0.542857142857143;16;19;0.0428571428571428;0.457142857142857
Control.SRR15539832;36;38;0.5;18;18;0;0.5
Control.SRR15539832;39;38;0.41025641025641;23;16;0.0897435897435898;0.41025641025641
Control.SRR15539832;43;38;0.534883720930233;20;23;0.0348837209302325;0.465116279069767
Control.SRR15539832;41;38;0.414634146341463;24;17;0.0853658536585366;0.414634146341463
Control.SRR15539832;39;38;0.538461538461538;18;21;0.0384615384615384;0.461538461538462
Control.SRR15539832;42;38;0.476190476190476;22;20;0.0238095238095238;0.476190476190476
Control.SRR15539832;43;38;0.488372093023256;22;21;0.0116279069767442;0.488372093023256
Control.SRR15539832;43;38;0.488372093023256;22;21;0.0116279069767442;0.488372093023256
Control.SRR15539832;37;38;0.486486486486487;19;18;0.0135135135135135;0.486486486486487
Control.SRR15539832;46;38;0.630434782608696;17;29;0.130434782608696;0.369565217391304
Control.SRR15539832;40;38;0.425;23;17;0.075;0.425
Control.SRR15539832;36;38;0.333333333333333;24;12;0.166666666666667;0.333333333333333
Control.SRR15539832;41;38;0.51219512195122;20;21;0.0121951219512195;0.48780487804878
Control.SRR15539832;42;38;0.476190476190476;22;20;0.0238095238095238;0.476190476190476
Control.SRR15539832;45;38;0.466666666666667;24;21;0.0333333333333333;0.466666666666667
Control.SRR15539832;40;38;0.55;18;22;0.05;0.45
Control.SRR15539832;39;38;0.487179487179487;20;19;0.0128205128205128;0.487179487179487
Control.SRR15539832;40;38;0.45;22;18;0.05;0.45
Control.SRR15539832;45;38;0.622222222222222;17;28;0.122222222222222;0.377777777777778
Control.SRR15539832;40;38;0.575;17;23;0.075;0.425
Control.SRR15539832;43;38;0.511627906976744;21;22;0.0116279069767442;0.488372093023256
Control.SRR15539832;37;38;0.621621621621622;14;23;0.121621621621622;0.378378378378378
Control.SRR15539832;40;38;0.575;17;23;0.075;0.425
Control.SRR15539832;39;38;0.384615384615385;24;15;0.115384615384615;0.384615384615385
Control.SRR15539832;43;38;0.604651162790698;17;26;0.104651162790698;0.395348837209302
Control.SRR15539832;45;38;0.577777777777778;19;26;0.0777777777777777;0.422222222222222
Control.SRR15539832;41;38;0.536585365853659;19;22;0.0365853658536586;0.463414634146341
Control.SRR15539832;44;38;0.5;22;22;0;0.5
Control.SRR15539832;46;38;0.652173913043478;16;30;0.152173913043478;0.347826086956522
Control.SRR15539832;41;38;0.658536585365854;14;27;0.158536585365854;0.341463414634146
Control.SRR15539832;45;38;0.377777777777778;28;17;0.122222222222222;0.377777777777778
Control.SRR15539832;46;38;0.391304347826087;28;18;0.108695652173913;0.391304347826087
Control.SRR15539832;43;38;0.604651162790698;17;26;0.104651162790698;0.395348837209302
Control.SRR15539832;36;38;0.444444444444444;20;16;0.0555555555555556;0.444444444444444
Control.SRR15539832;43;38;0.534883720930233;20;23;0.0348837209302325;0.465116279069767
Control.SRR15539832;45;38;0.466666666666667;24;21;0.0333333333333333;0.466666666666667
Control.SRR15539832;46;38;0.58695652173913;19;27;0.0869565217391305;0.41304347826087
Control.SRR15539832;46;38;0.434782608695652;26;20;0.0652173913043478;0.434782608695652
Control.SRR15539832;41;38;0.439024390243902;23;18;0.0609756097560976;0.439024390243902
Control.SRR15539832;42;38;0.333333333333333;28;14;0.166666666666667;0.333333333333333
Control.SRR15539832;42;38;0.547619047619048;19;23;0.0476190476190477;0.452380952380952
Control.SRR15539832;45;38;0.577777777777778;19;26;0.0777777777777777;0.422222222222222
Control.SRR15539832;37;38;0.324324324324324;25;12;0.175675675675676;0.324324324324324
Control.SRR15539832;39;38;0.307692307692308;27;12;0.192307692307692;0.307692307692308
Control.SRR15539832;39;38;0.384615384615385;24;15;0.115384615384615;0.384615384615385
Control.SRR15539832;36;38;0.555555555555556;16;20;0.0555555555555556;0.444444444444444
Control.SRR15539832;38;38;0.684210526315789;12;26;0.184210526315789;0.315789473684211
Control.SRR15539832;37;38;0.459459459459459;20;17;0.0405405405405405;0.459459459459459
Control.SRR15539832;39;38;0.487179487179487;20;19;0.0128205128205128;0.487179487179487
Control.SRR15539832;45;38;0.466666666666667;24;21;0.0333333333333333;0.466666666666667
Control.SRR15539832;45;38;0.577777777777778;19;26;0.0777777777777777;0.422222222222222
Control.SRR15539832;37;38;0.405405405405405;22;15;0.0945945945945946;0.405405405405405
Control.SRR15539832;36;38;0.527777777777778;17;19;0.0277777777777778;0.472222222222222
Control.SRR15539832;35;38;0.485714285714286;18;17;0.0142857142857143;0.485714285714286
Control.SRR15539832;36;38;0.555555555555556;16;20;0.0555555555555556;0.444444444444444
Control.SRR15539832;36;38;0.444444444444444;20;16;0.0555555555555556;0.444444444444444
Control.SRR15539832;39;38;0.435897435897436;22;17;0.0641025641025641;0.435897435897436
Control.SRR15539832;37;38;0.486486486486487;19;18;0.0135135135135135;0.486486486486487
Control.SRR15539832;38;38;0.368421052631579;24;14;0.131578947368421;0.368421052631579
Control.SRR15539832;43;38;0.418604651162791;25;18;0.0813953488372093;0.418604651162791
Control.SRR15539832;35;38;0.457142857142857;19;16;0.0428571428571429;0.457142857142857
Control.SRR15539832;40;38;0.55;18;22;0.05;0.45
Control.SRR15539832;38;38;0.552631578947368;17;21;0.0526315789473685;0.447368421052632
Control.SRR15539832;44;38;0.363636363636364;28;16;0.136363636363636;0.363636363636364
Control.SRR15539832;40;38;0.575;17;23;0.075;0.425
Control.SRR15539832;41;38;0.439024390243902;23;18;0.0609756097560976;0.439024390243902
Control.SRR15539832;36;38;0.416666666666667;21;15;0.0833333333333333;0.416666666666667
Control.SRR15539832;41;38;0.48780487804878;21;20;0.0121951219512195;0.48780487804878
Control.SRR15539832;40;38;0.575;17;23;0.075;0.425
Control.SRR15539832;41;38;0.536585365853659;19;22;0.0365853658536586;0.463414634146341
Control.SRR15539832;42;38;0.333333333333333;28;14;0.166666666666667;0.333333333333333
Control.SRR15539832;39;38;0.384615384615385;24;15;0.115384615384615;0.384615384615385
Control.SRR15539832;38;38;0.473684210526316;20;18;0.0263157894736842;0.473684210526316
Control.SRR15539832;39;38;0.461538461538462;21;18;0.0384615384615384;0.461538461538462
Control.SRR15539832;46;38;0.58695652173913;19;27;0.0869565217391305;0.41304347826087
Control.SRR15539832;40;38;0.5;20;20;0;0.5
Control.SRR15539832;38;38;0.552631578947368;17;21;0.0526315789473685;0.447368421052632
Control.SRR15539832;46;38;0.41304347826087;27;19;0.0869565217391304;0.41304347826087
Control.SRR15539832;44;38;0.477272727272727;23;21;0.0227272727272727;0.477272727272727
Control.SRR15539832;38;38;0.421052631578947;22;16;0.0789473684210527;0.421052631578947
Control.SRR15539832;37;38;0.405405405405405;22;15;0.0945945945945946;0.405405405405405
Control.SRR15539832;42;38;0.595238095238095;17;25;0.0952380952380952;0.404761904761905
Control.SRR15539832;37;38;0.405405405405405;22;15;0.0945945945945946;0.405405405405405
Control.SRR15539832;41;38;0.48780487804878;21;20;0.0121951219512195;0.48780487804878
Control.SRR15539832;41;38;0.51219512195122;20;21;0.0121951219512195;0.48780487804878
Control.SRR15539832;37;38;0.513513513513513;18;19;0.0135135135135135;0.486486486486487
Control.SRR15539832;37;38;0.405405405405405;22;15;0.0945945945945946;0.405405405405405
Control.SRR15539832;41;38;0.585365853658537;17;24;0.0853658536585366;0.414634146341463
Control.SRR15539832;41;38;0.536585365853659;19;22;0.0365853658536586;0.463414634146341
Control.SRR15539832;36;38;0.5;18;18;0;0.5
Control.SRR15539832;41;38;0.48780487804878;21;20;0.0121951219512195;0.48780487804878
Control.SRR15539832;39;38;0.333333333333333;26;13;0.166666666666667;0.333333333333333
Control.SRR15539832;42;38;0.476190476190476;22;20;0.0238095238095238;0.476190476190476
Control.SRR15539832;43;38;0.441860465116279;24;19;0.0581395348837209;0.441860465116279
Control.SRR15539832;45;38;0.511111111111111;22;23;0.0111111111111111;0.488888888888889
Control.SRR15539832;37;38;0.567567567567568;16;21;0.0675675675675675;0.432432432432432
Control.SRR15539832;41;38;0.439024390243902;23;18;0.0609756097560976;0.439024390243902
Control.SRR15539832;44;38;0.659090909090909;15;29;0.159090909090909;0.340909090909091
Control.SRR15539832;36;38;0.444444444444444;20;16;0.0555555555555556;0.444444444444444
Control.SRR15539832;43;38;0.488372093023256;22;21;0.0116279069767442;0.488372093023256
Control.SRR15539832;40;38;0.525;19;21;0.025;0.475
Control.SRR15539832;37;38;0.486486486486487;19;18;0.0135135135135135;0.486486486486487
Control.SRR15539832;43;38;0.465116279069767;23;20;0.0348837209302326;0.465116279069767
Control.SRR15539832;46;38;0.58695652173913;19;27;0.0869565217391305;0.41304347826087
Control.SRR15539832;38;38;0.578947368421053;16;22;0.0789473684210527;0.421052631578947
Control.SRR15539832;44;38;0.454545454545455;24;20;0.0454545454545455;0.454545454545455
Control.SRR15539832;40;38;0.45;22;18;0.05;0.45
Control.SRR15539832;42;38;0.642857142857143;15;27;0.142857142857143;0.357142857142857
Control.SRR15539832;45;38;0.688888888888889;14;31;0.188888888888889;0.311111111111111
Control.SRR15539832;43;38;0.511627906976744;21;22;0.0116279069767442;0.488372093023256
Control.SRR15539832;40;38;0.4;24;16;0.1;0.4
Control.SRR15539832;42;38;0.404761904761905;25;17;0.0952380952380952;0.404761904761905
Control.SRR15539832;41;38;0.585365853658537;17;24;0.0853658536585366;0.414634146341463
Control.SRR15539832;45;38;0.511111111111111;22;23;0.0111111111111111;0.488888888888889
Control.SRR15539832;44;38;0.409090909090909;26;18;0.0909090909090909;0.409090909090909
Control.SRR15539832;42;38;0.523809523809524;20;22;0.0238095238095238;0.476190476190476
Control.SRR15539832;45;38;0.466666666666667;24;21;0.0333333333333333;0.466666666666667
Control.SRR15539832;44;38;0.545454545454545;20;24;0.0454545454545454;0.454545454545455
Control.SRR15539832;46;38;0.478260869565217;24;22;0.0217391304347826;0.478260869565217
Control.SRR15539832;36;38;0.5;18;18;0;0.5
Control.SRR15539832;45;38;0.444444444444444;25;20;0.0555555555555556;0.444444444444444
Control.SRR15539832;43;38;0.348837209302326;28;15;0.151162790697674;0.348837209302326
Control.SRR15539832;45;38;0.6;18;27;0.1;0.4
Control.SRR15539832;44;38;0.568181818181818;19;25;0.0681818181818182;0.431818181818182
Control.SRR15539832;36;38;0.527777777777778;17;19;0.0277777777777778;0.472222222222222
Control.SRR15539832;36;38;0.638888888888889;13;23;0.138888888888889;0.361111111111111
Control.SRR15539832;35;38;0.485714285714286;18;17;0.0142857142857143;0.485714285714286
Control.SRR15539832;39;38;0.487179487179487;20;19;0.0128205128205128;0.487179487179487
Control.SRR15539832;45;38;0.6;18;27;0.1;0.4
Control.SRR15539832;45;38;0.577777777777778;19;26;0.0777777777777777;0.422222222222222
Control.SRR15539832;35;38;0.628571428571429;13;22;0.128571428571429;0.371428571428571
Control.SRR15539832;41;38;0.536585365853659;19;22;0.0365853658536586;0.463414634146341
Control.SRR15539832;46;38;0.456521739130435;25;21;0.0434782608695652;0.456521739130435
Control.SRR15539832;46;38;0.521739130434783;22;24;0.0217391304347826;0.478260869565217
Control.SRR15539832;45;38;0.466666666666667;24;21;0.0333333333333333;0.466666666666667
Control.SRR15539832;41;38;0.414634146341463;24;17;0.0853658536585366;0.414634146341463
Control.SRR15539832;36;38;0.555555555555556;16;20;0.0555555555555556;0.444444444444444
Control.SRR15539832;43;38;0.465116279069767;23;20;0.0348837209302326;0.465116279069767
Control.SRR15539832;35;38;0.628571428571429;13;22;0.128571428571429;0.371428571428571
Control.SRR15539832;40;38;0.45;22;18;0.05;0.45
Control.SRR15539832;39;38;0.58974358974359;16;23;0.0897435897435898;0.41025641025641
Control.SRR15539832;39;38;0.538461538461538;18;21;0.0384615384615384;0.461538461538462
Control.SRR15539832;40;38;0.525;19;21;0.025;0.475
Control.SRR15539832;37;38;0.459459459459459;20;17;0.0405405405405405;0.459459459459459
Control.SRR15539832;41;38;0.560975609756098;18;23;0.0609756097560976;0.439024390243902
Control.SRR15539832;37;38;0.378378378378378;23;14;0.121621621621622;0.378378378378378
Control.SRR15539832;45;38;0.444444444444444;25;20;0.0555555555555556;0.444444444444444
Control.SRR15539832;44;38;0.590909090909091;18;26;0.0909090909090909;0.409090909090909
Control.SRR15539832;36;38;0.5;18;18;0;0.5
Control.SRR15539832;45;38;0.511111111111111;22;23;0.0111111111111111;0.488888888888889
Control.SRR15539832;39;38;0.487179487179487;20;19;0.0128205128205128;0.487179487179487
Control.SRR15539832;42;38;0.428571428571429;24;18;0.0714285714285715;0.428571428571429
Control.SRR15539832;44;38;0.545454545454545;20;24;0.0454545454545454;0.454545454545455
Control.SRR15539832;45;38;0.466666666666667;24;21;0.0333333333333333;0.466666666666667
Control.SRR15539832;39;38;0.435897435897436;22;17;0.0641025641025641;0.435897435897436
Control.SRR15539832;41;38;0.536585365853659;19;22;0.0365853658536586;0.463414634146341
Control.SRR15539832;43;38;0.534883720930233;20;23;0.0348837209302325;0.465116279069767
Control.SRR15539832;41;38;0.51219512195122;20;21;0.0121951219512195;0.48780487804878
Control.SRR15539832;39;38;0.58974358974359;16;23;0.0897435897435898;0.41025641025641
Control.SRR15539832;42;38;0.404761904761905;25;17;0.0952380952380952;0.404761904761905
Control.SRR15539832;36;38;0.5;18;18;0;0.5
Control.SRR15539832;38;38;0.421052631578947;22;16;0.0789473684210527;0.421052631578947
Control.SRR15539832;42;38;0.404761904761905;25;17;0.0952380952380952;0.404761904761905
Control.SRR15539832;37;38;0.702702702702703;11;26;0.202702702702703;0.297297297297297
Control.SRR15539832;38;38;0.368421052631579;24;14;0.131578947368421;0.368421052631579
Control.SRR15539832;41;38;0.439024390243902;23;18;0.0609756097560976;0.439024390243902
Control.SRR15539832;37;38;0.540540540540541;17;20;0.0405405405405406;0.459459459459459
Control.SRR15539832;39;38;0.538461538461538;18;21;0.0384615384615384;0.461538461538462
Control.SRR15539832;41;38;0.439024390243902;23;18;0.0609756097560976;0.439024390243902
Control.SRR15539832;46;38;0.652173913043478;16;30;0.152173913043478;0.347826086956522
Control.SRR15539832;38;38;0.5;19;19;0;0.5
Control.SRR15539832;35;38;0.485714285714286;18;17;0.0142857142857143;0.485714285714286
Control.SRR15539832;36;38;0.527777777777778;17;19;0.0277777777777778;0.472222222222222
Control.SRR15539832;46;38;0.434782608695652;26;20;0.0652173913043478;0.434782608695652
Control.SRR15539832;35;38;0.571428571428571;15;20;0.0714285714285714;0.428571428571429
Control.SRR15539832;39;38;0.615384615384615;15;24;0.115384615384615;0.384615384615385
Control.SRR15539832;41;38;0.585365853658537;17;24;0.0853658536585366;0.414634146341463
Control.SRR15539832;39;38;0.58974358974359;16;23;0.0897435897435898;0.41025641025641
Control.SRR15539832;39;38;0.487179487179487;20;19;0.0128205128205128;0.487179487179487
Control.SRR15539832;37;38;0.459459459459459;20;17;0.0405405405405405;0.459459459459459
Control.SRR15539832;36;38;0.555555555555556;16;20;0.0555555555555556;0.444444444444444
Control.SRR15539832;37;38;0.459459459459459;20;17;0.0405405405405405;0.459459459459459
Control.SRR15539832;43;38;0.488372093023256;22;21;0.0116279069767442;0.488372093023256
Control.SRR15539832;37;38;0.567567567567568;16;21;0.0675675675675675;0.432432432432432
Control.SRR15539832;38;38;0.605263157894737;15;23;0.105263157894737;0.394736842105263
Control.SRR15539832;36;38;0.361111111111111;23;13;0.138888888888889;0.361111111111111
Control.SRR15539832;35;38;0.485714285714286;18;17;0.0142857142857143;0.485714285714286
Control.SRR15539832;44;38;0.363636363636364;28;16;0.136363636363636;0.363636363636364
Control.SRR15539832;42;38;0.619047619047619;16;26;0.119047619047619;0.380952380952381
Control.SRR15539832;39;38;0.666666666666667;13;26;0.166666666666667;0.333333333333333
Control.SRR15539832;42;38;0.666666666666667;14;28;0.166666666666667;0.333333333333333
Control.SRR15539832;44;38;0.454545454545455;24;20;0.0454545454545455;0.454545454545455
Control.SRR15539832;41;38;0.585365853658537;17;24;0.0853658536585366;0.414634146341463
Control.SRR15539832;41;38;0.536585365853659;19;22;0.0365853658536586;0.463414634146341
Control.SRR15539832;43;38;0.465116279069767;23;20;0.0348837209302326;0.465116279069767
Control.SRR15539832;40;38;0.425;23;17;0.075;0.425
Control.SRR15539832;40;38;0.525;19;21;0.025;0.475
Control.SRR15539832;40;38;0.675;13;27;0.175;0.325
Control.SRR15539832;35;38;0.457142857142857;19;16;0.0428571428571429;0.457142857142857
Control.SRR15539832;35;38;0.542857142857143;16;19;0.0428571428571428;0.457142857142857
Control.SRR15539832;41;38;0.585365853658537;17;24;0.0853658536585366;0.414634146341463
Control.SRR15539832;41;38;0.609756097560976;16;25;0.109756097560976;0.390243902439024
Control.SRR15539832;35;38;0.628571428571429;13;22;0.128571428571429;0.371428571428571
Control.SRR15539832;45;38;0.488888888888889;23;22;0.0111111111111111;0.488888888888889
Control.SRR15539832;43;38;0.534883720930233;20;23;0.0348837209302325;0.465116279069767
Control.SRR15539832;44;38;0.590909090909091;18;26;0.0909090909090909;0.409090909090909
Control.SRR15539832;45;38;0.622222222222222;17;28;0.122222222222222;0.377777777777778
Control.SRR15539832;41;38;0.560975609756098;18;23;0.0609756097560976;0.439024390243902
Control.SRR15539832;38;38;0.526315789473684;18;20;0.0263157894736842;0.473684210526316
Control.SRR15539832;37;38;0.378378378378378;23;14;0.121621621621622;0.378378378378378
Control.SRR15539832;43;38;0.581395348837209;18;25;0.0813953488372093;0.418604651162791
Control.SRR15539832;45;38;0.577777777777778;19;26;0.0777777777777777;0.422222222222222
Control.SRR15539832;42;38;0.357142857142857;27;15;0.142857142857143;0.357142857142857
Control.SRR15539832;43;38;0.372093023255814;27;16;0.127906976744186;0.372093023255814
Control.SRR15539832;41;38;0.48780487804878;21;20;0.0121951219512195;0.48780487804878
Control.SRR15539832;42;38;0.476190476190476;22;20;0.0238095238095238;0.476190476190476
Control.SRR15539832;38;38;0.447368421052632;21;17;0.0526315789473684;0.447368421052632
Control.SRR15539832;45;38;0.555555555555556;20;25;0.0555555555555556;0.444444444444444
Control.SRR15539832;46;38;0.58695652173913;19;27;0.0869565217391305;0.41304347826087
Control.SRR15539832;42;38;0.452380952380952;23;19;0.0476190476190476;0.452380952380952
Control.SRR15539832;43;38;0.581395348837209;18;25;0.0813953488372093;0.418604651162791
Control.SRR15539832;36;38;0.416666666666667;21;15;0.0833333333333333;0.416666666666667
Control.SRR15539832;41;38;0.609756097560976;16;25;0.109756097560976;0.390243902439024
Control.SRR15539832;39;38;0.512820512820513;19;20;0.0128205128205128;0.487179487179487
Control.SRR15539832;44;38;0.409090909090909;26;18;0.0909090909090909;0.409090909090909
Control.SRR15539832;43;38;0.558139534883721;19;24;0.0581395348837209;0.441860465116279
Control.SRR15539832;43;38;0.581395348837209;18;25;0.0813953488372093;0.418604651162791
Control.SRR15539832;37;38;0.540540540540541;17;20;0.0405405405405406;0.459459459459459
Control.SRR15539832;39;38;0.615384615384615;15;24;0.115384615384615;0.384615384615385
Control.SRR15539832;42;38;0.5;21;21;0;0.5
Control.SRR15539832;44;38;0.409090909090909;26;18;0.0909090909090909;0.409090909090909
Control.SRR15539832;44;38;0.409090909090909;26;18;0.0909090909090909;0.409090909090909
Control.SRR15539832;40;38;0.625;15;25;0.125;0.375
Control.SRR15539832;40;38;0.5;20;20;0;0.5
Control.SRR15539832;40;38;0.65;14;26;0.15;0.35
Control.SRR15539832;46;38;0.5;23;23;0;0.5
Control.SRR15539832;40;38;0.65;14;26;0.15;0.35
Control.SRR15539832;35;38;0.514285714285714;17;18;0.0142857142857142;0.485714285714286
Control.SRR15539832;39;38;0.435897435897436;22;17;0.0641025641025641;0.435897435897436
Control.SRR15539832;42;38;0.547619047619048;19;23;0.0476190476190477;0.452380952380952
Control.SRR15539832;42;38;0.547619047619048;19;23;0.0476190476190477;0.452380952380952
Control.SRR15539832;42;38;0.595238095238095;17;25;0.0952380952380952;0.404761904761905
Control.SRR15539832;38;38;0.552631578947368;17;21;0.0526315789473685;0.447368421052632
Control.SRR15539832;36;38;0.527777777777778;17;19;0.0277777777777778;0.472222222222222
Control.SRR15539832;40;38;0.475;21;19;0.025;0.475
Control.SRR15539832;41;38;0.536585365853659;19;22;0.0365853658536586;0.463414634146341
Control.SRR15539832;40;38;0.5;20;20;0;0.5
Control.SRR15539832;40;38;0.575;17;23;0.075;0.425
Control.SRR15539832;46;38;0.434782608695652;26;20;0.0652173913043478;0.434782608695652
Control.SRR15539832;40;38;0.575;17;23;0.075;0.425
Control.SRR15539832;39;38;0.461538461538462;21;18;0.0384615384615384;0.461538461538462
Control.SRR15539832;45;38;0.511111111111111;22;23;0.0111111111111111;0.488888888888889
Control.SRR15539832;37;38;0.432432432432432;21;16;0.0675675675675675;0.432432432432432
Control.SRR15539832;40;38;0.475;21;19;0.025;0.475
Control.SRR15539832;43;38;0.488372093023256;22;21;0.0116279069767442;0.488372093023256
Control.SRR15539832;42;38;0.404761904761905;25;17;0.0952380952380952;0.404761904761905
Control.SRR15539832;40;38;0.575;17;23;0.075;0.425
Control.SRR15539832;38;38;0.421052631578947;22;16;0.0789473684210527;0.421052631578947
Control.SRR15539832;38;38;0.368421052631579;24;14;0.131578947368421;0.368421052631579
Control.SRR15539832;37;38;0.621621621621622;14;23;0.121621621621622;0.378378378378378
Control.SRR15539832;42;38;0.357142857142857;27;15;0.142857142857143;0.357142857142857
Control.SRR15539832;39;38;0.358974358974359;25;14;0.141025641025641;0.358974358974359
Control.SRR15539832;40;38;0.425;23;17;0.075;0.425
Control.SRR15539832;45;38;0.533333333333333;21;24;0.0333333333333333;0.466666666666667
Control.SRR15539832;40;38;0.625;15;25;0.125;0.375
Control.SRR15539832;42;38;0.571428571428571;18;24;0.0714285714285714;0.428571428571429
Control.SRR15539832;44;38;0.545454545454545;20;24;0.0454545454545454;0.454545454545455
Control.SRR15539832;43;38;0.441860465116279;24;19;0.0581395348837209;0.441860465116279
Control.SRR15539832;39;38;0.487179487179487;20;19;0.0128205128205128;0.487179487179487
Control.SRR15539832;39;38;0.512820512820513;19;20;0.0128205128205128;0.487179487179487
Control.SRR15539832;40;38;0.5;20;20;0;0.5
Control.SRR15539832;42;38;0.452380952380952;23;19;0.0476190476190476;0.452380952380952
Control.SRR15539832;42;38;0.595238095238095;17;25;0.0952380952380952;0.404761904761905
Control.SRR15539832;39;38;0.538461538461538;18;21;0.0384615384615384;0.461538461538462
Control.SRR15539832;45;38;0.555555555555556;20;25;0.0555555555555556;0.444444444444444
Control.SRR15539832;43;38;0.558139534883721;19;24;0.0581395348837209;0.441860465116279
Control.SRR15539832;43;38;0.418604651162791;25;18;0.0813953488372093;0.418604651162791
Control.SRR15539832;45;38;0.644444444444444;16;29;0.144444444444444;0.355555555555556
Control.SRR15539832;35;38;0.457142857142857;19;16;0.0428571428571429;0.457142857142857
Control.SRR15539832;39;38;0.41025641025641;23;16;0.0897435897435898;0.41025641025641
Control.SRR15539832;43;38;0.441860465116279;24;19;0.0581395348837209;0.441860465116279
Control.SRR15539832;39;38;0.435897435897436;22;17;0.0641025641025641;0.435897435897436
Control.SRR15539832;42;38;0.5;21;21;0;0.5
Control.SRR15539832;43;38;0.488372093023256;22;21;0.0116279069767442;0.488372093023256
Control.SRR15539832;40;38;0.5;20;20;0;0.5
Control.SRR15539832;39;38;0.435897435897436;22;17;0.0641025641025641;0.435897435897436
Control.SRR15539832;37;38;0.459459459459459;20;17;0.0405405405405405;0.459459459459459
Control.SRR15539832;37;38;0.540540540540541;17;20;0.0405405405405406;0.459459459459459
Control.SRR15539832;39;38;0.487179487179487;20;19;0.0128205128205128;0.487179487179487
Control.SRR15539832;42;38;0.619047619047619;16;26;0.119047619047619;0.380952380952381
Control.SRR15539832;37;38;0.351351351351351;24;13;0.148648648648649;0.351351351351351
Control.SRR15539832;36;38;0.388888888888889;22;14;0.111111111111111;0.388888888888889
Control.SRR15539832;37;38;0.567567567567568;16;21;0.0675675675675675;0.432432432432432
Control.SRR15539832;38;38;0.578947368421053;16;22;0.0789473684210527;0.421052631578947
Control.SRR15539832;43;38;0.465116279069767;23;20;0.0348837209302326;0.465116279069767
Control.SRR15539832;40;38;0.425;23;17;0.075;0.425
Control.SRR15539832;46;38;0.478260869565217;24;22;0.0217391304347826;0.478260869565217
Control.SRR15539832;36;38;0.583333333333333;15;21;0.0833333333333334;0.416666666666667
Control.SRR15539832;35;38;0.428571428571429;20;15;0.0714285714285715;0.428571428571429
Control.SRR15539832;40;38;0.5;20;20;0;0.5
Control.SRR15539832;41;38;0.609756097560976;16;25;0.109756097560976;0.390243902439024
Control.SRR15539832;36;38;0.527777777777778;17;19;0.0277777777777778;0.472222222222222
Control.SRR15539832;35;38;0.485714285714286;18;17;0.0142857142857143;0.485714285714286
Control.SRR15539832;44;38;0.613636363636364;17;27;0.113636363636364;0.386363636363636
Control.SRR15539832;36;38;0.444444444444444;20;16;0.0555555555555556;0.444444444444444
Control.SRR15539832;40;38;0.475;21;19;0.025;0.475
Control.SRR15539832;41;38;0.414634146341463;24;17;0.0853658536585366;0.414634146341463
Control.SRR15539832;35;38;0.342857142857143;23;12;0.157142857142857;0.342857142857143
Control.SRR15539832;38;38;0.447368421052632;21;17;0.0526315789473684;0.447368421052632
Control.SRR15539832;43;38;0.558139534883721;19;24;0.0581395348837209;0.441860465116279
Control.SRR15539832;42;38;0.428571428571429;24;18;0.0714285714285715;0.428571428571429
Control.SRR15539832;45;38;0.488888888888889;23;22;0.0111111111111111;0.488888888888889
Control.SRR15539832;44;38;0.545454545454545;20;24;0.0454545454545454;0.454545454545455
Control.SRR15539832;43;38;0.465116279069767;23;20;0.0348837209302326;0.465116279069767
Control.SRR15539832;46;38;0.630434782608696;17;29;0.130434782608696;0.369565217391304
Control.SRR15539832;35;38;0.4;21;14;0.1;0.4
Control.SRR15539832;42;38;0.5;21;21;0;0.5
Control.SRR15539832;46;38;0.478260869565217;24;22;0.0217391304347826;0.478260869565217
Control.SRR15539832;43;38;0.511627906976744;21;22;0.0116279069767442;0.488372093023256
Control.SRR15539832;41;38;0.463414634146341;22;19;0.0365853658536585;0.463414634146341
Control.SRR15539832;35;38;0.314285714285714;24;11;0.185714285714286;0.314285714285714
Control.SRR15539832;45;38;0.6;18;27;0.1;0.4
Control.SRR15539832;42;38;0.5;21;21;0;0.5
Control.SRR15539832;37;38;0.459459459459459;20;17;0.0405405405405405;0.459459459459459
Control.SRR15539832;41;38;0.51219512195122;20;21;0.0121951219512195;0.48780487804878
Control.SRR15539832;40;38;0.5;20;20;0;0.5
Control.SRR15539832;41;38;0.51219512195122;20;21;0.0121951219512195;0.48780487804878
Control.SRR15539832;43;38;0.558139534883721;19;24;0.0581395348837209;0.441860465116279
Control.SRR15539832;38;38;0.526315789473684;18;20;0.0263157894736842;0.473684210526316
Control.SRR15539832;39;38;0.384615384615385;24;15;0.115384615384615;0.384615384615385
Control.SRR15539832;37;38;0.675675675675676;12;25;0.175675675675676;0.324324324324324
Control.SRR15539832;41;38;0.317073170731707;28;13;0.182926829268293;0.317073170731707
Control.SRR15539832;43;38;0.465116279069767;23;20;0.0348837209302326;0.465116279069767
Control.SRR15539832;42;38;0.476190476190476;22;20;0.0238095238095238;0.476190476190476
Control.SRR15539832;39;38;0.487179487179487;20;19;0.0128205128205128;0.487179487179487
Control.SRR15539832;37;38;0.459459459459459;20;17;0.0405405405405405;0.459459459459459
Control.SRR15539832;45;38;0.355555555555556;29;16;0.144444444444444;0.355555555555556
Control.SRR15539832;44;38;0.568181818181818;19;25;0.0681818181818182;0.431818181818182
Control.SRR15539832;43;38;0.581395348837209;18;25;0.0813953488372093;0.418604651162791
Control.SRR15539832;40;38;0.55;18;22;0.05;0.45
Control.SRR15539832;36;38;0.361111111111111;23;13;0.138888888888889;0.361111111111111
Control.SRR15539832;36;38;0.555555555555556;16;20;0.0555555555555556;0.444444444444444
Control.SRR15539832;37;38;0.459459459459459;20;17;0.0405405405405405;0.459459459459459
Control.SRR15539832;43;38;0.697674418604651;13;30;0.197674418604651;0.302325581395349
Control.SRR15539832;45;38;0.555555555555556;20;25;0.0555555555555556;0.444444444444444
Control.SRR15539832;43;38;0.325581395348837;29;14;0.174418604651163;0.325581395348837
Control.SRR15539832;45;38;0.622222222222222;17;28;0.122222222222222;0.377777777777778
Control.SRR15539832;45;38;0.466666666666667;24;21;0.0333333333333333;0.466666666666667
Control.SRR15539832;40;38;0.55;18;22;0.05;0.45
Control.SRR15539832;46;38;0.521739130434783;22;24;0.0217391304347826;0.478260869565217
Control.SRR15539832;39;38;0.564102564102564;17;22;0.0641025641025641;0.435897435897436
Control.SRR15539832;39;38;0.435897435897436;22;17;0.0641025641025641;0.435897435897436
Control.SRR15539832;43;38;0.488372093023256;22;21;0.0116279069767442;0.488372093023256
Control.SRR15539832;44;38;0.545454545454545;20;24;0.0454545454545454;0.454545454545455
Control.SRR15539832;43;38;0.441860465116279;24;19;0.0581395348837209;0.441860465116279
Control.SRR15539832;41;38;0.560975609756098;18;23;0.0609756097560976;0.439024390243902
Control.SRR15539832;44;38;0.590909090909091;18;26;0.0909090909090909;0.409090909090909
Control.SRR15539832;45;38;0.622222222222222;17;28;0.122222222222222;0.377777777777778
Control.SRR15539832;36;38;0.555555555555556;16;20;0.0555555555555556;0.444444444444444
Control.SRR15539832;35;38;0.428571428571429;20;15;0.0714285714285715;0.428571428571429
Control.SRR15539832;45;38;0.511111111111111;22;23;0.0111111111111111;0.488888888888889
Control.SRR15539832;46;38;0.434782608695652;26;20;0.0652173913043478;0.434782608695652
Control.SRR15539832;40;38;0.475;21;19;0.025;0.475
Control.SRR15539832;36;38;0.472222222222222;19;17;0.0277777777777778;0.472222222222222
Control.SRR15539832;40;38;0.475;21;19;0.025;0.475
Control.SRR15539832;43;38;0.581395348837209;18;25;0.0813953488372093;0.418604651162791
Control.SRR15539832;41;38;0.48780487804878;21;20;0.0121951219512195;0.48780487804878
Control.SRR15539832;46;38;0.543478260869565;21;25;0.0434782608695652;0.456521739130435
Control.SRR15539832;45;38;0.577777777777778;19;26;0.0777777777777777;0.422222222222222
Control.SRR15539832;40;38;0.625;15;25;0.125;0.375
Control.SRR15539832;45;38;0.533333333333333;21;24;0.0333333333333333;0.466666666666667
Control.SRR15539832;45;38;0.377777777777778;28;17;0.122222222222222;0.377777777777778
Control.SRR15539832;45;38;0.444444444444444;25;20;0.0555555555555556;0.444444444444444
Control.SRR15539832;42;38;0.428571428571429;24;18;0.0714285714285715;0.428571428571429
Control.SRR15539832;40;38;0.5;20;20;0;0.5
Control.SRR15539832;46;38;0.5;23;23;0;0.5
Control.SRR15539832;43;38;0.511627906976744;21;22;0.0116279069767442;0.488372093023256
Control.SRR15539832;36;38;0.388888888888889;22;14;0.111111111111111;0.388888888888889
Control.SRR15539832;41;38;0.390243902439024;25;16;0.109756097560976;0.390243902439024
Control.SRR15539832;45;38;0.333333333333333;30;15;0.166666666666667;0.333333333333333
Control.SRR15539832;46;38;0.58695652173913;19;27;0.0869565217391305;0.41304347826087
Control.SRR15539832;43;38;0.558139534883721;19;24;0.0581395348837209;0.441860465116279
Control.SRR15539832;40;38;0.6;16;24;0.1;0.4
Control.SRR15539832;42;38;0.5;21;21;0;0.5
Control.SRR15539832;39;38;0.641025641025641;14;25;0.141025641025641;0.358974358974359
Control.SRR15539832;36;38;0.388888888888889;22;14;0.111111111111111;0.388888888888889
Control.SRR15539832;36;38;0.611111111111111;14;22;0.111111111111111;0.388888888888889
Control.SRR15539832;39;38;0.512820512820513;19;20;0.0128205128205128;0.487179487179487
Control.SRR15539832;44;38;0.431818181818182;25;19;0.0681818181818182;0.431818181818182
Control.SRR15539832;41;38;0.536585365853659;19;22;0.0365853658536586;0.463414634146341
Control.SRR15539832;42;38;0.5;21;21;0;0.5
Control.SRR15539832;46;38;0.58695652173913;19;27;0.0869565217391305;0.41304347826087
Control.SRR15539832;46;38;0.456521739130435;25;21;0.0434782608695652;0.456521739130435
Control.SRR15539832;45;38;0.533333333333333;21;24;0.0333333333333333;0.466666666666667
Control.SRR15539832;44;38;0.409090909090909;26;18;0.0909090909090909;0.409090909090909
Control.SRR15539832;46;38;0.434782608695652;26;20;0.0652173913043478;0.434782608695652
Control.SRR15539832;45;38;0.6;18;27;0.1;0.4
Control.SRR15539832;42;38;0.571428571428571;18;24;0.0714285714285714;0.428571428571429
Control.SRR15539832;41;38;0.560975609756098;18;23;0.0609756097560976;0.439024390243902
Control.SRR15539832;35;38;0.485714285714286;18;17;0.0142857142857143;0.485714285714286
Control.SRR15539832;39;38;0.461538461538462;21;18;0.0384615384615384;0.461538461538462
Control.SRR15539832;42;38;0.5;21;21;0;0.5
Control.SRR15539832;39;38;0.512820512820513;19;20;0.0128205128205128;0.487179487179487
Control.SRR15539832;35;38;0.542857142857143;16;19;0.0428571428571428;0.457142857142857
Control.SRR15539832;46;38;0.347826086956522;30;16;0.152173913043478;0.347826086956522
Control.SRR15539832;44;38;0.568181818181818;19;25;0.0681818181818182;0.431818181818182
Control.SRR15539832;40;38;0.425;23;17;0.075;0.425
Control.SRR15539832;39;38;0.487179487179487;20;19;0.0128205128205128;0.487179487179487
Control.SRR15539832;45;38;0.333333333333333;30;15;0.166666666666667;0.333333333333333
Control.SRR15539832;44;38;0.454545454545455;24;20;0.0454545454545455;0.454545454545455
Control.SRR15539832;44;38;0.477272727272727;23;21;0.0227272727272727;0.477272727272727
Control.SRR15539832;36;38;0.416666666666667;21;15;0.0833333333333333;0.416666666666667
Control.SRR15539832;36;38;0.583333333333333;15;21;0.0833333333333334;0.416666666666667
Control.SRR15539832;36;38;0.388888888888889;22;14;0.111111111111111;0.388888888888889
Control.SRR15539832;38;38;0.394736842105263;23;15;0.105263157894737;0.394736842105263
Control.SRR15539832;46;38;0.58695652173913;19;27;0.0869565217391305;0.41304347826087
Control.SRR15539832;44;38;0.386363636363636;27;17;0.113636363636364;0.386363636363636
Control.SRR15539832;40;38;0.525;19;21;0.025;0.475
Control.SRR15539832;37;38;0.459459459459459;20;17;0.0405405405405405;0.459459459459459
Control.SRR15539832;41;38;0.439024390243902;23;18;0.0609756097560976;0.439024390243902
Control.SRR15539832;41;38;0.536585365853659;19;22;0.0365853658536586;0.463414634146341
Control.SRR15539832;40;38;0.55;18;22;0.05;0.45
Control.SRR15539832;46;38;0.304347826086957;32;14;0.195652173913043;0.304347826086957
Control.SRR15539832;35;38;0.371428571428571;22;13;0.128571428571429;0.371428571428571
Control.SRR15539832;39;38;0.461538461538462;21;18;0.0384615384615384;0.461538461538462
Control.SRR15539832;44;38;0.5;22;22;0;0.5
Control.SRR15539832;42;38;0.452380952380952;23;19;0.0476190476190476;0.452380952380952
Control.SRR15539832;35;38;0.485714285714286;18;17;0.0142857142857143;0.485714285714286
Control.SRR15539832;43;38;0.395348837209302;26;17;0.104651162790698;0.395348837209302
Control.SRR15539832;35;38;0.628571428571429;13;22;0.128571428571429;0.371428571428571
Control.SRR15539832;45;38;0.511111111111111;22;23;0.0111111111111111;0.488888888888889
Control.SRR15539832;38;38;0.578947368421053;16;22;0.0789473684210527;0.421052631578947
Control.SRR15539832;44;38;0.477272727272727;23;21;0.0227272727272727;0.477272727272727
Control.SRR15539832;46;38;0.521739130434783;22;24;0.0217391304347826;0.478260869565217
Control.SRR15539832;46;38;0.5;23;23;0;0.5
Control.SRR15539832;41;38;0.560975609756098;18;23;0.0609756097560976;0.439024390243902
Control.SRR15539832;35;38;0.571428571428571;15;20;0.0714285714285714;0.428571428571429
Control.SRR15539832;36;38;0.555555555555556;16;20;0.0555555555555556;0.444444444444444
Control.SRR15539832;38;38;0.578947368421053;16;22;0.0789473684210527;0.421052631578947
Control.SRR15539832;37;38;0.486486486486487;19;18;0.0135135135135135;0.486486486486487
Control.SRR15539832;35;38;0.514285714285714;17;18;0.0142857142857142;0.485714285714286
Control.SRR15539832;37;38;0.513513513513513;18;19;0.0135135135135135;0.486486486486487
Control.SRR15539832;42;38;0.666666666666667;14;28;0.166666666666667;0.333333333333333
Control.SRR15539832;39;38;0.487179487179487;20;19;0.0128205128205128;0.487179487179487
Control.SRR15539832;38;38;0.5;19;19;0;0.5
Control.SRR15539832;36;38;0.527777777777778;17;19;0.0277777777777778;0.472222222222222
Control.SRR15539832;35;38;0.457142857142857;19;16;0.0428571428571429;0.457142857142857
Control.SRR15539832;37;38;0.513513513513513;18;19;0.0135135135135135;0.486486486486487
Control.SRR15539832;42;38;0.595238095238095;17;25;0.0952380952380952;0.404761904761905
Control.SRR15539832;45;38;0.488888888888889;23;22;0.0111111111111111;0.488888888888889
Control.SRR15539832;40;38;0.425;23;17;0.075;0.425
Control.SRR15539832;44;38;0.454545454545455;24;20;0.0454545454545455;0.454545454545455
Control.SRR15539832;39;38;0.384615384615385;24;15;0.115384615384615;0.384615384615385
Control.SRR15539832;40;38;0.425;23;17;0.075;0.425
Control.SRR15539832;39;38;0.461538461538462;21;18;0.0384615384615384;0.461538461538462
Control.SRR15539832;41;38;0.51219512195122;20;21;0.0121951219512195;0.48780487804878
Control.SRR15539832;35;38;0.571428571428571;15;20;0.0714285714285714;0.428571428571429
Control.SRR15539832;37;38;0.567567567567568;16;21;0.0675675675675675;0.432432432432432
Control.SRR15539832;43;38;0.511627906976744;21;22;0.0116279069767442;0.488372093023256
Control.SRR15539832;35;38;0.514285714285714;17;18;0.0142857142857142;0.485714285714286
Control.SRR15539832;46;38;0.543478260869565;21;25;0.0434782608695652;0.456521739130435
Control.SRR15539832;41;38;0.414634146341463;24;17;0.0853658536585366;0.414634146341463
Control.SRR15539832;44;38;0.545454545454545;20;24;0.0454545454545454;0.454545454545455
Control.SRR15539832;37;38;0.486486486486487;19;18;0.0135135135135135;0.486486486486487
Control.SRR15539832;38;38;0.447368421052632;21;17;0.0526315789473684;0.447368421052632
Control.SRR15539832;37;38;0.540540540540541;17;20;0.0405405405405406;0.459459459459459
Control.SRR15539832;36;38;0.666666666666667;12;24;0.166666666666667;0.333333333333333
Control.SRR15539832;35;38;0.457142857142857;19;16;0.0428571428571429;0.457142857142857
Control.SRR15539832;37;38;0.459459459459459;20;17;0.0405405405405405;0.459459459459459
Control.SRR15539832;46;38;0.456521739130435;25;21;0.0434782608695652;0.456521739130435
Control.SRR15539832;43;38;0.604651162790698;17;26;0.104651162790698;0.395348837209302
Control.SRR15539832;46;38;0.391304347826087;28;18;0.108695652173913;0.391304347826087
Control.SRR15539832;41;38;0.51219512195122;20;21;0.0121951219512195;0.48780487804878
Control.SRR15539832;45;38;0.511111111111111;22;23;0.0111111111111111;0.488888888888889
Control.SRR15539832;40;38;0.55;18;22;0.05;0.45
Control.SRR15539832;40;38;0.3;28;12;0.2;0.3
Control.SRR15539832;36;38;0.583333333333333;15;21;0.0833333333333334;0.416666666666667
Control.SRR15539832;37;38;0.567567567567568;16;21;0.0675675675675675;0.432432432432432
Control.SRR15539832;37;38;0.405405405405405;22;15;0.0945945945945946;0.405405405405405
Control.SRR15539832;38;38;0.368421052631579;24;14;0.131578947368421;0.368421052631579
Control.SRR15539832;42;38;0.404761904761905;25;17;0.0952380952380952;0.404761904761905
Control.SRR15539832;38;38;0.394736842105263;23;15;0.105263157894737;0.394736842105263
Control.SRR15539832;39;38;0.538461538461538;18;21;0.0384615384615384;0.461538461538462
Control.SRR15539832;45;38;0.511111111111111;22;23;0.0111111111111111;0.488888888888889
Control.SRR15539832;37;38;0.459459459459459;20;17;0.0405405405405405;0.459459459459459
Control.SRR15539832;40;38;0.475;21;19;0.025;0.475
Control.SRR15539832;40;38;0.575;17;23;0.075;0.425
Control.SRR15539832;42;38;0.523809523809524;20;22;0.0238095238095238;0.476190476190476
Control.SRR15539832;46;38;0.543478260869565;21;25;0.0434782608695652;0.456521739130435
Control.SRR15539832;35;38;0.542857142857143;16;19;0.0428571428571428;0.457142857142857
Control.SRR15539832;39;38;0.615384615384615;15;24;0.115384615384615;0.384615384615385
Control.SRR15539832;42;38;0.428571428571429;24;18;0.0714285714285715;0.428571428571429
Control.SRR15539832;38;38;0.473684210526316;20;18;0.0263157894736842;0.473684210526316
Control.SRR15539832;40;38;0.6;16;24;0.1;0.4
Control.SRR15539832;45;38;0.6;18;27;0.1;0.4
Control.SRR15539832;44;38;0.545454545454545;20;24;0.0454545454545454;0.454545454545455
Control.SRR15539832;36;38;0.5;18;18;0;0.5
Control.SRR15539832;39;38;0.487179487179487;20;19;0.0128205128205128;0.487179487179487
Control.SRR15539832;46;38;0.543478260869565;21;25;0.0434782608695652;0.456521739130435
Control.SRR15539832;43;38;0.511627906976744;21;22;0.0116279069767442;0.488372093023256
Control.SRR15539832;39;38;0.461538461538462;21;18;0.0384615384615384;0.461538461538462
Control.SRR15539832;43;38;0.488372093023256;22;21;0.0116279069767442;0.488372093023256
Control.SRR15539832;46;38;0.58695652173913;19;27;0.0869565217391305;0.41304347826087
Control.SRR15539832;46;38;0.565217391304348;20;26;0.0652173913043478;0.434782608695652
Control.SRR15539832;36;38;0.583333333333333;15;21;0.0833333333333334;0.416666666666667
Control.SRR15539832;40;38;0.475;21;19;0.025;0.475
Control.SRR15539832;44;38;0.5;22;22;0;0.5
Control.SRR15539832;35;38;0.485714285714286;18;17;0.0142857142857143;0.485714285714286
Control.SRR15539832;44;38;0.545454545454545;20;24;0.0454545454545454;0.454545454545455
Control.SRR15539832;36;38;0.472222222222222;19;17;0.0277777777777778;0.472222222222222
Control.SRR15539832;37;38;0.567567567567568;16;21;0.0675675675675675;0.432432432432432
Control.SRR15539832;39;38;0.564102564102564;17;22;0.0641025641025641;0.435897435897436
Control.SRR15539832;41;38;0.439024390243902;23;18;0.0609756097560976;0.439024390243902
Control.SRR15539832;41;38;0.439024390243902;23;18;0.0609756097560976;0.439024390243902
Control.SRR15539832;40;38;0.375;25;15;0.125;0.375
Control.SRR15539832;43;38;0.488372093023256;22;21;0.0116279069767442;0.488372093023256
Control.SRR15539832;37;38;0.648648648648649;13;24;0.148648648648649;0.351351351351351
Control.SRR15539832;35;38;0.457142857142857;19;16;0.0428571428571429;0.457142857142857
Control.SRR15539832;45;38;0.511111111111111;22;23;0.0111111111111111;0.488888888888889
Control.SRR15539832;46;38;0.478260869565217;24;22;0.0217391304347826;0.478260869565217
Control.SRR15539832;38;38;0.5;19;19;0;0.5
Control.SRR15539832;43;38;0.488372093023256;22;21;0.0116279069767442;0.488372093023256
Control.SRR15539832;43;38;0.674418604651163;14;29;0.174418604651163;0.325581395348837
Control.SRR15539832;42;38;0.428571428571429;24;18;0.0714285714285715;0.428571428571429
Control.SRR15539832;42;38;0.571428571428571;18;24;0.0714285714285714;0.428571428571429
Control.SRR15539832;42;38;0.547619047619048;19;23;0.0476190476190477;0.452380952380952
Control.SRR15539832;37;38;0.432432432432432;21;16;0.0675675675675675;0.432432432432432
Control.SRR15539832;45;38;0.488888888888889;23;22;0.0111111111111111;0.488888888888889
Control.SRR15539832;35;38;0.485714285714286;18;17;0.0142857142857143;0.485714285714286
Control.SRR15539832;38;38;0.447368421052632;21;17;0.0526315789473684;0.447368421052632
Control.SRR15539832;44;38;0.409090909090909;26;18;0.0909090909090909;0.409090909090909
Control.SRR15539832;38;38;0.657894736842105;13;25;0.157894736842105;0.342105263157895
Control.SRR15539832;37;38;0.459459459459459;20;17;0.0405405405405405;0.459459459459459
Control.SRR15539832;41;38;0.48780487804878;21;20;0.0121951219512195;0.48780487804878
Control.SRR15539832;35;38;0.628571428571429;13;22;0.128571428571429;0.371428571428571
Control.SRR15539832;36;38;0.527777777777778;17;19;0.0277777777777778;0.472222222222222
Control.SRR15539832;38;38;0.578947368421053;16;22;0.0789473684210527;0.421052631578947
Control.SRR15539832;38;38;0.631578947368421;14;24;0.131578947368421;0.368421052631579
Control.SRR15539832;37;38;0.459459459459459;20;17;0.0405405405405405;0.459459459459459
Control.SRR15539832;39;38;0.641025641025641;14;25;0.141025641025641;0.358974358974359
Control.SRR15539832;44;38;0.590909090909091;18;26;0.0909090909090909;0.409090909090909
Control.SRR15539832;46;38;0.478260869565217;24;22;0.0217391304347826;0.478260869565217
Control.SRR15539832;36;38;0.527777777777778;17;19;0.0277777777777778;0.472222222222222
Control.SRR15539832;46;38;0.434782608695652;26;20;0.0652173913043478;0.434782608695652
Control.SRR15539832;38;38;0.473684210526316;20;18;0.0263157894736842;0.473684210526316
Control.SRR15539832;39;38;0.564102564102564;17;22;0.0641025641025641;0.435897435897436
Control.SRR15539832;37;38;0.459459459459459;20;17;0.0405405405405405;0.459459459459459
Control.SRR15539832;42;38;0.404761904761905;25;17;0.0952380952380952;0.404761904761905
Control.SRR15539832;42;38;0.5;21;21;0;0.5
Control.SRR15539832;46;38;0.478260869565217;24;22;0.0217391304347826;0.478260869565217
Control.SRR15539832;36;38;0.5;18;18;0;0.5
Control.SRR15539832;37;38;0.513513513513513;18;19;0.0135135135135135;0.486486486486487
Control.SRR15539832;39;38;0.564102564102564;17;22;0.0641025641025641;0.435897435897436
Control.SRR15539832;36;38;0.472222222222222;19;17;0.0277777777777778;0.472222222222222
Control.SRR15539832;39;38;0.512820512820513;19;20;0.0128205128205128;0.487179487179487
Control.SRR15539832;44;38;0.454545454545455;24;20;0.0454545454545455;0.454545454545455
Control.SRR15539832;42;38;0.428571428571429;24;18;0.0714285714285715;0.428571428571429
Control.SRR15539832;37;38;0.756756756756757;9;28;0.256756756756757;0.243243243243243
Control.SRR15539832;40;38;0.5;20;20;0;0.5
Control.SRR15539832;46;38;0.5;23;23;0;0.5
Control.SRR15539832;35;38;0.485714285714286;18;17;0.0142857142857143;0.485714285714286
Control.SRR15539832;42;38;0.380952380952381;26;16;0.119047619047619;0.380952380952381
Control.SRR15539832;41;38;0.390243902439024;25;16;0.109756097560976;0.390243902439024
Control.SRR15539832;39;38;0.384615384615385;24;15;0.115384615384615;0.384615384615385
Control.SRR15539832;41;38;0.560975609756098;18;23;0.0609756097560976;0.439024390243902
Control.SRR15539832;40;38;0.65;14;26;0.15;0.35
Control.SRR15539832;43;38;0.465116279069767;23;20;0.0348837209302326;0.465116279069767
Control.SRR15539832;44;38;0.386363636363636;27;17;0.113636363636364;0.386363636363636
Control.SRR15539832;43;38;0.511627906976744;21;22;0.0116279069767442;0.488372093023256
Control.SRR15539832;42;38;0.547619047619048;19;23;0.0476190476190477;0.452380952380952
Control.SRR15539832;36;38;0.666666666666667;12;24;0.166666666666667;0.333333333333333
Control.SRR15539832;35;38;0.485714285714286;18;17;0.0142857142857143;0.485714285714286
Control.SRR15539832;42;38;0.404761904761905;25;17;0.0952380952380952;0.404761904761905
Control.SRR15539832;45;38;0.511111111111111;22;23;0.0111111111111111;0.488888888888889
Control.SRR15539832;46;38;0.543478260869565;21;25;0.0434782608695652;0.456521739130435
Control.SRR15539832;40;38;0.575;17;23;0.075;0.425
Control.SRR15539832;41;38;0.536585365853659;19;22;0.0365853658536586;0.463414634146341
Control.SRR15539832;39;38;0.41025641025641;23;16;0.0897435897435898;0.41025641025641
Control.SRR15539832;44;38;0.568181818181818;19;25;0.0681818181818182;0.431818181818182
Control.SRR15539832;37;38;0.459459459459459;20;17;0.0405405405405405;0.459459459459459
Control.SRR15539832;46;38;0.434782608695652;26;20;0.0652173913043478;0.434782608695652
Control.SRR15539832;35;38;0.4;21;14;0.1;0.4
Control.SRR15539832;42;38;0.428571428571429;24;18;0.0714285714285715;0.428571428571429
Control.SRR15539832;46;38;0.543478260869565;21;25;0.0434782608695652;0.456521739130435
Control.SRR15539832;36;38;0.444444444444444;20;16;0.0555555555555556;0.444444444444444
Control.SRR15539832;43;38;0.465116279069767;23;20;0.0348837209302326;0.465116279069767
Control.SRR15539832;37;38;0.648648648648649;13;24;0.148648648648649;0.351351351351351
Control.SRR15539832;44;38;0.5;22;22;0;0.5
Control.SRR15539832;41;38;0.585365853658537;17;24;0.0853658536585366;0.414634146341463
Control.SRR15539832;36;38;0.444444444444444;20;16;0.0555555555555556;0.444444444444444
Control.SRR15539832;44;38;0.295454545454545;31;13;0.204545454545455;0.295454545454545
Control.SRR15539832;45;38;0.355555555555556;29;16;0.144444444444444;0.355555555555556
Control.SRR15539832;36;38;0.583333333333333;15;21;0.0833333333333334;0.416666666666667
Control.SRR15539832;40;38;0.425;23;17;0.075;0.425
Control.SRR15539832;46;38;0.521739130434783;22;24;0.0217391304347826;0.478260869565217
Control.SRR15539832;43;38;0.581395348837209;18;25;0.0813953488372093;0.418604651162791
Control.SRR15539832;42;38;0.547619047619048;19;23;0.0476190476190477;0.452380952380952
Control.SRR15539832;38;38;0.473684210526316;20;18;0.0263157894736842;0.473684210526316
Control.SRR15539832;35;38;0.571428571428571;15;20;0.0714285714285714;0.428571428571429
Control.SRR15539832;45;38;0.422222222222222;26;19;0.0777777777777778;0.422222222222222
Control.SRR15539832;43;38;0.395348837209302;26;17;0.104651162790698;0.395348837209302
Control.SRR15539832;45;38;0.466666666666667;24;21;0.0333333333333333;0.466666666666667
Control.SRR15539832;41;38;0.536585365853659;19;22;0.0365853658536586;0.463414634146341
Control.SRR15539832;39;38;0.538461538461538;18;21;0.0384615384615384;0.461538461538462
Control.SRR15539832;37;38;0.486486486486487;19;18;0.0135135135135135;0.486486486486487
Control.SRR15539832;40;38;0.6;16;24;0.1;0.4
Control.SRR15539832;39;38;0.666666666666667;13;26;0.166666666666667;0.333333333333333
Control.SRR15539832;43;38;0.465116279069767;23;20;0.0348837209302326;0.465116279069767
Control.SRR15539832;38;38;0.526315789473684;18;20;0.0263157894736842;0.473684210526316
Control.SRR15539832;41;38;0.585365853658537;17;24;0.0853658536585366;0.414634146341463
Control.SRR15539832;43;38;0.604651162790698;17;26;0.104651162790698;0.395348837209302
Control.SRR15539832;42;38;0.5;21;21;0;0.5
Control.SRR15539832;45;38;0.6;18;27;0.1;0.4
Control.SRR15539832;41;38;0.560975609756098;18;23;0.0609756097560976;0.439024390243902
Control.SRR15539832;40;38;0.5;20;20;0;0.5
Control.SRR15539832;36;38;0.527777777777778;17;19;0.0277777777777778;0.472222222222222
Control.SRR15539832;38;38;0.5;19;19;0;0.5
Control.SRR15539832;40;38;0.525;19;21;0.025;0.475
Control.SRR15539832;38;38;0.368421052631579;24;14;0.131578947368421;0.368421052631579
Control.SRR15539832;35;38;0.6;14;21;0.1;0.4
Control.SRR15539832;46;38;0.521739130434783;22;24;0.0217391304347826;0.478260869565217
Control.SRR15539832;37;38;0.486486486486487;19;18;0.0135135135135135;0.486486486486487
Control.SRR15539832;39;38;0.564102564102564;17;22;0.0641025641025641;0.435897435897436
Control.SRR15539832;45;38;0.555555555555556;20;25;0.0555555555555556;0.444444444444444
Control.SRR15539832;35;38;0.514285714285714;17;18;0.0142857142857142;0.485714285714286
Control.SRR15539832;39;38;0.666666666666667;13;26;0.166666666666667;0.333333333333333
Control.SRR15539832;36;38;0.583333333333333;15;21;0.0833333333333334;0.416666666666667
Control.SRR15539832;41;38;0.414634146341463;24;17;0.0853658536585366;0.414634146341463
Control.SRR15539832;35;38;0.428571428571429;20;15;0.0714285714285715;0.428571428571429
Control.SRR15539832;37;38;0.540540540540541;17;20;0.0405405405405406;0.459459459459459
Control.SRR15539832;36;38;0.25;27;9;0.25;0.25
Control.SRR15539832;37;38;0.459459459459459;20;17;0.0405405405405405;0.459459459459459
Control.SRR15539832;37;38;0.567567567567568;16;21;0.0675675675675675;0.432432432432432
Control.SRR15539832;40;38;0.425;23;17;0.075;0.425
Control.SRR15539832;40;38;0.575;17;23;0.075;0.425
Control.SRR15539832;41;38;0.365853658536585;26;15;0.134146341463415;0.365853658536585
Control.SRR15539832;43;38;0.488372093023256;22;21;0.0116279069767442;0.488372093023256
Control.SRR15539832;41;38;0.48780487804878;21;20;0.0121951219512195;0.48780487804878
Control.SRR15539832;39;38;0.538461538461538;18;21;0.0384615384615384;0.461538461538462
Control.SRR15539832;38;38;0.473684210526316;20;18;0.0263157894736842;0.473684210526316
Control.SRR15539832;40;38;0.525;19;21;0.025;0.475
Control.SRR15539832;46;38;0.565217391304348;20;26;0.0652173913043478;0.434782608695652
Control.SRR15539832;44;38;0.363636363636364;28;16;0.136363636363636;0.363636363636364
Control.SRR15539832;37;38;0.513513513513513;18;19;0.0135135135135135;0.486486486486487
Control.SRR15539832;42;38;0.404761904761905;25;17;0.0952380952380952;0.404761904761905
Control.SRR15539832;39;38;0.564102564102564;17;22;0.0641025641025641;0.435897435897436
Control.SRR15539832;35;38;0.428571428571429;20;15;0.0714285714285715;0.428571428571429
Control.SRR15539832;36;38;0.444444444444444;20;16;0.0555555555555556;0.444444444444444
Control.SRR15539832;36;38;0.5;18;18;0;0.5
Control.SRR15539832;38;38;0.473684210526316;20;18;0.0263157894736842;0.473684210526316
Control.SRR15539832;41;38;0.390243902439024;25;16;0.109756097560976;0.390243902439024
Control.SRR15539832;46;38;0.478260869565217;24;22;0.0217391304347826;0.478260869565217
Control.SRR15539832;37;38;0.486486486486487;19;18;0.0135135135135135;0.486486486486487
Control.SRR15539832;42;38;0.5;21;21;0;0.5
Control.SRR15539832;42;38;0.476190476190476;22;20;0.0238095238095238;0.476190476190476
Control.SRR15539832;42;38;0.428571428571429;24;18;0.0714285714285715;0.428571428571429
Control.SRR15539832;35;38;0.514285714285714;17;18;0.0142857142857142;0.485714285714286
Control.SRR15539832;37;38;0.432432432432432;21;16;0.0675675675675675;0.432432432432432
Control.SRR15539832;37;38;0.486486486486487;19;18;0.0135135135135135;0.486486486486487
Control.SRR15539832;45;38;0.488888888888889;23;22;0.0111111111111111;0.488888888888889
Control.SRR15539832;38;38;0.421052631578947;22;16;0.0789473684210527;0.421052631578947
Control.SRR15539832;38;38;0.552631578947368;17;21;0.0526315789473685;0.447368421052632
Control.SRR15539832;35;38;0.314285714285714;24;11;0.185714285714286;0.314285714285714
Control.SRR15539832;35;38;0.457142857142857;19;16;0.0428571428571429;0.457142857142857
Control.SRR15539832;40;38;0.525;19;21;0.025;0.475
Control.SRR15539832;45;38;0.466666666666667;24;21;0.0333333333333333;0.466666666666667
Control.SRR15539832;45;38;0.466666666666667;24;21;0.0333333333333333;0.466666666666667
Control.SRR15539832;39;38;0.564102564102564;17;22;0.0641025641025641;0.435897435897436
Control.SRR15539832;40;38;0.475;21;19;0.025;0.475
Control.SRR15539832;41;38;0.439024390243902;23;18;0.0609756097560976;0.439024390243902
Control.SRR15539832;42;38;0.523809523809524;20;22;0.0238095238095238;0.476190476190476
Control.SRR15539832;35;38;0.571428571428571;15;20;0.0714285714285714;0.428571428571429
Control.SRR15539832;35;38;0.485714285714286;18;17;0.0142857142857143;0.485714285714286
Control.SRR15539832;42;38;0.452380952380952;23;19;0.0476190476190476;0.452380952380952
Control.SRR15539832;40;38;0.475;21;19;0.025;0.475
Control.SRR15539832;36;38;0.444444444444444;20;16;0.0555555555555556;0.444444444444444
Control.SRR15539832;39;38;0.58974358974359;16;23;0.0897435897435898;0.41025641025641
Control.SRR15539832;36;38;0.5;18;18;0;0.5
Control.SRR15539832;45;38;0.533333333333333;21;24;0.0333333333333333;0.466666666666667
Control.SRR15539832;43;38;0.418604651162791;25;18;0.0813953488372093;0.418604651162791
Control.SRR15539832;42;38;0.428571428571429;24;18;0.0714285714285715;0.428571428571429
Control.SRR15539832;41;38;0.48780487804878;21;20;0.0121951219512195;0.48780487804878
Control.SRR15539832;40;38;0.6;16;24;0.1;0.4
Control.SRR15539832;39;38;0.487179487179487;20;19;0.0128205128205128;0.487179487179487
Control.SRR15539832;40;38;0.7;12;28;0.2;0.3
Control.SRR15539832;35;38;0.571428571428571;15;20;0.0714285714285714;0.428571428571429
Control.SRR15539832;39;38;0.58974358974359;16;23;0.0897435897435898;0.41025641025641
Control.SRR15539832;40;38;0.475;21;19;0.025;0.475
Control.SRR15539832;35;38;0.314285714285714;24;11;0.185714285714286;0.314285714285714
Control.SRR15539832;40;38;0.55;18;22;0.05;0.45
Control.SRR15539832;38;38;0.315789473684211;26;12;0.184210526315789;0.315789473684211
Control.SRR15539832;38;38;0.631578947368421;14;24;0.131578947368421;0.368421052631579
Control.SRR15539832;42;38;0.476190476190476;22;20;0.0238095238095238;0.476190476190476
Control.SRR15539832;42;38;0.476190476190476;22;20;0.0238095238095238;0.476190476190476
Control.SRR15539832;39;38;0.358974358974359;25;14;0.141025641025641;0.358974358974359
Control.SRR15539832;41;38;0.609756097560976;16;25;0.109756097560976;0.390243902439024
Control.SRR15539832;42;38;0.547619047619048;19;23;0.0476190476190477;0.452380952380952
Control.SRR15539832;38;38;0.421052631578947;22;16;0.0789473684210527;0.421052631578947
Control.SRR15539832;46;38;0.5;23;23;0;0.5
Control.SRR15539832;36;38;0.472222222222222;19;17;0.0277777777777778;0.472222222222222
Control.SRR15539832;46;38;0.630434782608696;17;29;0.130434782608696;0.369565217391304
Control.SRR15539832;40;38;0.55;18;22;0.05;0.45
Control.SRR15539832;36;38;0.583333333333333;15;21;0.0833333333333334;0.416666666666667
Control.SRR15539832;40;38;0.425;23;17;0.075;0.425
Control.SRR15539832;41;38;0.634146341463415;15;26;0.134146341463415;0.365853658536585
Control.SRR15539832;39;38;0.564102564102564;17;22;0.0641025641025641;0.435897435897436
Control.SRR15539832;38;38;0.526315789473684;18;20;0.0263157894736842;0.473684210526316
Control.SRR15539832;35;38;0.542857142857143;16;19;0.0428571428571428;0.457142857142857
Control.SRR15539832;37;38;0.567567567567568;16;21;0.0675675675675675;0.432432432432432
Control.SRR15539832;44;38;0.568181818181818;19;25;0.0681818181818182;0.431818181818182
Control.SRR15539832;36;38;0.444444444444444;20;16;0.0555555555555556;0.444444444444444
Control.SRR15539832;42;38;0.404761904761905;25;17;0.0952380952380952;0.404761904761905
Control.SRR15539832;39;38;0.487179487179487;20;19;0.0128205128205128;0.487179487179487
Control.SRR15539832;38;38;0.552631578947368;17;21;0.0526315789473685;0.447368421052632
Control.SRR15539832;45;38;0.4;27;18;0.1;0.4
Control.SRR15539832;40;38;0.375;25;15;0.125;0.375
Control.SRR15539832;40;38;0.55;18;22;0.05;0.45
Control.SRR15539832;45;38;0.488888888888889;23;22;0.0111111111111111;0.488888888888889
Control.SRR15539832;42;38;0.5;21;21;0;0.5
Control.SRR15539832;39;38;0.333333333333333;26;13;0.166666666666667;0.333333333333333
Control.SRR15539832;45;38;0.555555555555556;20;25;0.0555555555555556;0.444444444444444
Control.SRR15539832;37;38;0.432432432432432;21;16;0.0675675675675675;0.432432432432432
Control.SRR15539832;45;38;0.422222222222222;26;19;0.0777777777777778;0.422222222222222
Control.SRR15539832;35;38;0.457142857142857;19;16;0.0428571428571429;0.457142857142857
Control.SRR15539832;38;38;0.5;19;19;0;0.5
Control.SRR15539832;38;38;0.473684210526316;20;18;0.0263157894736842;0.473684210526316
Control.SRR15539832;39;38;0.384615384615385;24;15;0.115384615384615;0.384615384615385
Control.SRR15539832;35;38;0.4;21;14;0.1;0.4
Control.SRR15539832;46;38;0.565217391304348;20;26;0.0652173913043478;0.434782608695652
Control.SRR15539832;43;38;0.558139534883721;19;24;0.0581395348837209;0.441860465116279
Control.SRR15539832;39;38;0.358974358974359;25;14;0.141025641025641;0.358974358974359
Control.SRR15539832;37;38;0.432432432432432;21;16;0.0675675675675675;0.432432432432432
Control.SRR15539832;41;38;0.609756097560976;16;25;0.109756097560976;0.390243902439024
Control.SRR15539832;43;38;0.511627906976744;21;22;0.0116279069767442;0.488372093023256
Control.SRR15539832;40;38;0.425;23;17;0.075;0.425
Control.SRR15539832;45;38;0.577777777777778;19;26;0.0777777777777777;0.422222222222222
Control.SRR15539832;46;38;0.326086956521739;31;15;0.173913043478261;0.326086956521739
Control.SRR15539832;37;38;0.540540540540541;17;20;0.0405405405405406;0.459459459459459
Control.SRR15539832;43;38;0.534883720930233;20;23;0.0348837209302325;0.465116279069767
Control.SRR15539832;44;38;0.590909090909091;18;26;0.0909090909090909;0.409090909090909
Control.SRR15539832;40;38;0.45;22;18;0.05;0.45
Control.SRR15539832;43;38;0.511627906976744;21;22;0.0116279069767442;0.488372093023256
Control.SRR15539832;42;38;0.404761904761905;25;17;0.0952380952380952;0.404761904761905
Control.SRR15539832;46;38;0.521739130434783;22;24;0.0217391304347826;0.478260869565217
Control.SRR15539832;35;38;0.457142857142857;19;16;0.0428571428571429;0.457142857142857
Control.SRR15539832;39;38;0.487179487179487;20;19;0.0128205128205128;0.487179487179487
Control.SRR15539832;43;38;0.581395348837209;18;25;0.0813953488372093;0.418604651162791
Control.SRR15539832;35;38;0.371428571428571;22;13;0.128571428571429;0.371428571428571
Control.SRR15539832;42;38;0.452380952380952;23;19;0.0476190476190476;0.452380952380952
Control.SRR15539832;41;38;0.51219512195122;20;21;0.0121951219512195;0.48780487804878
Control.SRR15539832;42;38;0.333333333333333;28;14;0.166666666666667;0.333333333333333
Control.SRR15539832;42;38;0.523809523809524;20;22;0.0238095238095238;0.476190476190476
Control.SRR15539832;41;38;0.48780487804878;21;20;0.0121951219512195;0.48780487804878
Control.SRR15539832;35;38;0.371428571428571;22;13;0.128571428571429;0.371428571428571
Control.SRR15539832;46;38;0.347826086956522;30;16;0.152173913043478;0.347826086956522
Control.SRR15539832;43;38;0.511627906976744;21;22;0.0116279069767442;0.488372093023256
Control.SRR15539832;38;38;0.447368421052632;21;17;0.0526315789473684;0.447368421052632
Control.SRR15539832;43;38;0.372093023255814;27;16;0.127906976744186;0.372093023255814
Control.SRR15539832;38;38;0.394736842105263;23;15;0.105263157894737;0.394736842105263
Control.SRR15539832;37;38;0.540540540540541;17;20;0.0405405405405406;0.459459459459459
Control.SRR15539832;35;38;0.314285714285714;24;11;0.185714285714286;0.314285714285714
Control.SRR15539832;36;38;0.5;18;18;0;0.5
Control.SRR15539832;36;38;0.333333333333333;24;12;0.166666666666667;0.333333333333333
Control.SRR15539832;40;38;0.475;21;19;0.025;0.475
Control.SRR15539832;46;38;0.456521739130435;25;21;0.0434782608695652;0.456521739130435
Control.SRR15539832;44;38;0.545454545454545;20;24;0.0454545454545454;0.454545454545455
Control.SRR15539832;39;38;0.615384615384615;15;24;0.115384615384615;0.384615384615385
Control.SRR15539832;35;38;0.514285714285714;17;18;0.0142857142857142;0.485714285714286
Control.SRR15539832;38;38;0.552631578947368;17;21;0.0526315789473685;0.447368421052632
Control.SRR15539832;36;38;0.5;18;18;0;0.5
Control.SRR15539832;41;38;0.682926829268293;13;28;0.182926829268293;0.317073170731707
Control.SRR15539832;38;38;0.473684210526316;20;18;0.0263157894736842;0.473684210526316
Control.SRR15539832;42;38;0.404761904761905;25;17;0.0952380952380952;0.404761904761905
Control.SRR15539832;44;38;0.681818181818182;14;30;0.181818181818182;0.318181818181818
Control.SRR15539832;42;38;0.523809523809524;20;22;0.0238095238095238;0.476190476190476
Control.SRR15539832;35;38;0.571428571428571;15;20;0.0714285714285714;0.428571428571429
Control.SRR15539832;36;38;0.527777777777778;17;19;0.0277777777777778;0.472222222222222
Control.SRR15539832;39;38;0.461538461538462;21;18;0.0384615384615384;0.461538461538462
Control.SRR15539832;45;38;0.666666666666667;15;30;0.166666666666667;0.333333333333333
Control.SRR15539832;43;38;0.465116279069767;23;20;0.0348837209302326;0.465116279069767
Control.SRR15539832;42;38;0.595238095238095;17;25;0.0952380952380952;0.404761904761905
Control.SRR15539832;41;38;0.634146341463415;15;26;0.134146341463415;0.365853658536585
Control.SRR15539832;44;38;0.681818181818182;14;30;0.181818181818182;0.318181818181818
Control.SRR15539832;39;38;0.564102564102564;17;22;0.0641025641025641;0.435897435897436
Control.SRR15539832;39;38;0.435897435897436;22;17;0.0641025641025641;0.435897435897436
Control.SRR15539832;45;38;0.555555555555556;20;25;0.0555555555555556;0.444444444444444
Control.SRR15539832;38;38;0.447368421052632;21;17;0.0526315789473684;0.447368421052632
Control.SRR15539832;37;38;0.594594594594595;15;22;0.0945945945945946;0.405405405405405
Control.SRR15539832;35;38;0.485714285714286;18;17;0.0142857142857143;0.485714285714286
Control.SRR15539832;40;38;0.525;19;21;0.025;0.475
Control.SRR15539832;43;38;0.488372093023256;22;21;0.0116279069767442;0.488372093023256
Control.SRR15539832;44;38;0.568181818181818;19;25;0.0681818181818182;0.431818181818182
Control.SRR15539832;42;38;0.571428571428571;18;24;0.0714285714285714;0.428571428571429
Control.SRR15539832;38;38;0.578947368421053;16;22;0.0789473684210527;0.421052631578947
Control.SRR15539832;35;38;0.514285714285714;17;18;0.0142857142857142;0.485714285714286
Control.SRR15539832;36;38;0.666666666666667;12;24;0.166666666666667;0.333333333333333
Control.SRR15539832;37;38;0.459459459459459;20;17;0.0405405405405405;0.459459459459459
Control.SRR15539832;36;38;0.416666666666667;21;15;0.0833333333333333;0.416666666666667
Control.SRR15539832;36;38;0.5;18;18;0;0.5
Control.SRR15539832;37;38;0.432432432432432;21;16;0.0675675675675675;0.432432432432432
Control.SRR15539832;43;38;0.395348837209302;26;17;0.104651162790698;0.395348837209302
Control.SRR15539832;43;38;0.372093023255814;27;16;0.127906976744186;0.372093023255814
Control.SRR15539832;35;38;0.457142857142857;19;16;0.0428571428571429;0.457142857142857
Control.SRR15539832;45;38;0.533333333333333;21;24;0.0333333333333333;0.466666666666667
Control.SRR15539832;45;38;0.4;27;18;0.1;0.4
Control.SRR15539832;36;38;0.583333333333333;15;21;0.0833333333333334;0.416666666666667
Control.SRR15539832;39;38;0.512820512820513;19;20;0.0128205128205128;0.487179487179487
Control.SRR15539832;39;38;0.435897435897436;22;17;0.0641025641025641;0.435897435897436
Control.SRR15539832;36;38;0.472222222222222;19;17;0.0277777777777778;0.472222222222222
Control.SRR15539832;42;38;0.595238095238095;17;25;0.0952380952380952;0.404761904761905
Control.SRR15539832;41;38;0.390243902439024;25;16;0.109756097560976;0.390243902439024
Control.SRR15539832;38;38;0.421052631578947;22;16;0.0789473684210527;0.421052631578947
Control.SRR15539832;38;38;0.473684210526316;20;18;0.0263157894736842;0.473684210526316
Control.SRR15539832;37;38;0.432432432432432;21;16;0.0675675675675675;0.432432432432432
Control.SRR15539832;35;38;0.285714285714286;25;10;0.214285714285714;0.285714285714286
Control.SRR15539832;35;38;0.428571428571429;20;15;0.0714285714285715;0.428571428571429
Control.SRR15539832;35;38;0.457142857142857;19;16;0.0428571428571429;0.457142857142857
Control.SRR15539832;38;38;0.368421052631579;24;14;0.131578947368421;0.368421052631579
Control.SRR15539832;35;38;0.485714285714286;18;17;0.0142857142857143;0.485714285714286
Control.SRR15539832;42;38;0.619047619047619;16;26;0.119047619047619;0.380952380952381
Control.SRR15539832;37;38;0.459459459459459;20;17;0.0405405405405405;0.459459459459459
Control.SRR15539832;44;38;0.477272727272727;23;21;0.0227272727272727;0.477272727272727
Control.SRR15539832;42;38;0.380952380952381;26;16;0.119047619047619;0.380952380952381
Control.SRR15539832;40;38;0.55;18;22;0.05;0.45
Control.SRR15539832;35;38;0.571428571428571;15;20;0.0714285714285714;0.428571428571429
Control.SRR15539832;35;38;0.571428571428571;15;20;0.0714285714285714;0.428571428571429
Control.SRR15539832;35;38;0.428571428571429;20;15;0.0714285714285715;0.428571428571429
Control.SRR15539832;45;38;0.4;27;18;0.1;0.4
Control.SRR15539832;38;38;0.473684210526316;20;18;0.0263157894736842;0.473684210526316
Control.SRR15539832;44;38;0.454545454545455;24;20;0.0454545454545455;0.454545454545455
Control.SRR15539832;38;38;0.631578947368421;14;24;0.131578947368421;0.368421052631579
Control.SRR15539832;46;38;0.608695652173913;18;28;0.108695652173913;0.391304347826087
Control.SRR15539832;38;38;0.473684210526316;20;18;0.0263157894736842;0.473684210526316
Control.SRR15539832;44;38;0.545454545454545;20;24;0.0454545454545454;0.454545454545455
Control.SRR15539832;46;38;0.434782608695652;26;20;0.0652173913043478;0.434782608695652
Control.SRR15539832;42;38;0.5;21;21;0;0.5
Control.SRR15539832;46;38;0.521739130434783;22;24;0.0217391304347826;0.478260869565217
Control.SRR15539832;43;38;0.534883720930233;20;23;0.0348837209302325;0.465116279069767
Control.SRR15539832;39;38;0.512820512820513;19;20;0.0128205128205128;0.487179487179487
Control.SRR15539832;46;38;0.434782608695652;26;20;0.0652173913043478;0.434782608695652
Control.SRR15539832;43;38;0.581395348837209;18;25;0.0813953488372093;0.418604651162791
Control.SRR15539832;36;38;0.416666666666667;21;15;0.0833333333333333;0.416666666666667
Control.SRR15539832;35;38;0.514285714285714;17;18;0.0142857142857142;0.485714285714286
Control.SRR15539832;43;38;0.581395348837209;18;25;0.0813953488372093;0.418604651162791
Control.SRR15539832;42;38;0.595238095238095;17;25;0.0952380952380952;0.404761904761905
Control.SRR15539832;35;38;0.514285714285714;17;18;0.0142857142857142;0.485714285714286
Control.SRR15539832;35;38;0.6;14;21;0.1;0.4
Control.SRR15539832;36;38;0.388888888888889;22;14;0.111111111111111;0.388888888888889
Control.SRR15539832;38;38;0.5;19;19;0;0.5
Control.SRR15539832;41;38;0.463414634146341;22;19;0.0365853658536585;0.463414634146341
Control.SRR15539832;37;38;0.513513513513513;18;19;0.0135135135135135;0.486486486486487
Control.SRR15539832;45;38;0.555555555555556;20;25;0.0555555555555556;0.444444444444444
Control.SRR15539832;38;38;0.5;19;19;0;0.5
Control.SRR15539832;36;38;0.5;18;18;0;0.5
Control.SRR15539832;43;38;0.534883720930233;20;23;0.0348837209302325;0.465116279069767
Control.SRR15539832;43;38;0.511627906976744;21;22;0.0116279069767442;0.488372093023256
Control.SRR15539832;39;38;0.41025641025641;23;16;0.0897435897435898;0.41025641025641
Control.SRR15539832;38;38;0.5;19;19;0;0.5
Control.SRR15539832;43;38;0.441860465116279;24;19;0.0581395348837209;0.441860465116279
Control.SRR15539832;42;38;0.595238095238095;17;25;0.0952380952380952;0.404761904761905
Control.SRR15539832;38;38;0.447368421052632;21;17;0.0526315789473684;0.447368421052632
Control.SRR15539832;44;38;0.409090909090909;26;18;0.0909090909090909;0.409090909090909
Control.SRR15539832;38;38;0.552631578947368;17;21;0.0526315789473685;0.447368421052632
Control.SRR15539832;37;38;0.567567567567568;16;21;0.0675675675675675;0.432432432432432
Control.SRR15539832;35;38;0.542857142857143;16;19;0.0428571428571428;0.457142857142857
Control.SRR15539832;38;38;0.605263157894737;15;23;0.105263157894737;0.394736842105263
Control.SRR15539832;46;38;0.434782608695652;26;20;0.0652173913043478;0.434782608695652
Control.SRR15539832;35;38;0.6;14;21;0.1;0.4
Control.SRR15539832;40;38;0.475;21;19;0.025;0.475
Control.SRR15539832;42;38;0.5;21;21;0;0.5
Control.SRR15539832;44;38;0.454545454545455;24;20;0.0454545454545455;0.454545454545455
Control.SRR15539832;38;38;0.5;19;19;0;0.5
Control.SRR15539832;45;38;0.444444444444444;25;20;0.0555555555555556;0.444444444444444
Control.SRR15539832;43;38;0.558139534883721;19;24;0.0581395348837209;0.441860465116279
Control.SRR15539832;38;38;0.447368421052632;21;17;0.0526315789473684;0.447368421052632
Control.SRR15539832;41;38;0.585365853658537;17;24;0.0853658536585366;0.414634146341463
Control.SRR15539832;35;38;0.514285714285714;17;18;0.0142857142857142;0.485714285714286
Control.SRR15539832;46;38;0.478260869565217;24;22;0.0217391304347826;0.478260869565217
Control.SRR15539832;37;38;0.567567567567568;16;21;0.0675675675675675;0.432432432432432
Control.SRR15539832;40;38;0.675;13;27;0.175;0.325
Control.SRR15539832;36;38;0.527777777777778;17;19;0.0277777777777778;0.472222222222222
Control.SRR15539832;39;38;0.58974358974359;16;23;0.0897435897435898;0.41025641025641
Control.SRR15539832;42;38;0.595238095238095;17;25;0.0952380952380952;0.404761904761905
Control.SRR15539832;42;38;0.547619047619048;19;23;0.0476190476190477;0.452380952380952
Control.SRR15539832;43;38;0.465116279069767;23;20;0.0348837209302326;0.465116279069767
Control.SRR15539832;35;38;0.685714285714286;11;24;0.185714285714286;0.314285714285714
Control.SRR15539832;35;38;0.542857142857143;16;19;0.0428571428571428;0.457142857142857
Control.SRR15539832;46;38;0.478260869565217;24;22;0.0217391304347826;0.478260869565217
Control.SRR15539832;44;38;0.545454545454545;20;24;0.0454545454545454;0.454545454545455
Control.SRR15539832;37;38;0.405405405405405;22;15;0.0945945945945946;0.405405405405405
Control.SRR15539832;39;38;0.58974358974359;16;23;0.0897435897435898;0.41025641025641
Control.SRR15539832;45;38;0.333333333333333;30;15;0.166666666666667;0.333333333333333
Control.SRR15539832;43;38;0.418604651162791;25;18;0.0813953488372093;0.418604651162791
Control.SRR15539832;42;38;0.380952380952381;26;16;0.119047619047619;0.380952380952381
Control.SRR15539832;38;38;0.394736842105263;23;15;0.105263157894737;0.394736842105263
Control.SRR15539832;39;38;0.358974358974359;25;14;0.141025641025641;0.358974358974359
Control.SRR15539832;39;38;0.512820512820513;19;20;0.0128205128205128;0.487179487179487
Control.SRR15539832;38;38;0.447368421052632;21;17;0.0526315789473684;0.447368421052632
Control.SRR15539832;39;38;0.461538461538462;21;18;0.0384615384615384;0.461538461538462
Control.SRR15539832;36;38;0.5;18;18;0;0.5
Control.SRR15539832;44;38;0.454545454545455;24;20;0.0454545454545455;0.454545454545455
Control.SRR15539832;40;38;0.6;16;24;0.1;0.4
Control.SRR15539832;40;38;0.425;23;17;0.075;0.425
Control.SRR15539832;44;38;0.409090909090909;26;18;0.0909090909090909;0.409090909090909
Control.SRR15539832;40;38;0.6;16;24;0.1;0.4
Control.SRR15539832;42;38;0.380952380952381;26;16;0.119047619047619;0.380952380952381
Control.SRR15539832;42;38;0.357142857142857;27;15;0.142857142857143;0.357142857142857
Control.SRR15539832;38;38;0.473684210526316;20;18;0.0263157894736842;0.473684210526316
Control.SRR15539832;38;38;0.5;19;19;0;0.5
Control.SRR15539832;36;38;0.388888888888889;22;14;0.111111111111111;0.388888888888889
Control.SRR15539832;39;38;0.487179487179487;20;19;0.0128205128205128;0.487179487179487
Control.SRR15539832;40;38;0.525;19;21;0.025;0.475
Control.SRR15539832;36;38;0.555555555555556;16;20;0.0555555555555556;0.444444444444444
Control.SRR15539832;36;38;0.5;18;18;0;0.5
Control.SRR15539832;39;38;0.358974358974359;25;14;0.141025641025641;0.358974358974359
Control.SRR15539832;44;38;0.568181818181818;19;25;0.0681818181818182;0.431818181818182
Control.SRR15539832;43;38;0.558139534883721;19;24;0.0581395348837209;0.441860465116279
Control.SRR15539832;39;38;0.564102564102564;17;22;0.0641025641025641;0.435897435897436
Control.SRR15539832;41;38;0.24390243902439;31;10;0.25609756097561;0.24390243902439
Control.SRR15539832;41;38;0.51219512195122;20;21;0.0121951219512195;0.48780487804878
Control.SRR15539832;45;38;0.4;27;18;0.1;0.4
Control.SRR15539832;46;38;0.58695652173913;19;27;0.0869565217391305;0.41304347826087
Control.SRR15539832;38;38;0.578947368421053;16;22;0.0789473684210527;0.421052631578947
Control.SRR15539832;46;38;0.608695652173913;18;28;0.108695652173913;0.391304347826087
Control.SRR15539832;39;38;0.512820512820513;19;20;0.0128205128205128;0.487179487179487
Control.SRR15539832;36;38;0.444444444444444;20;16;0.0555555555555556;0.444444444444444
Control.SRR15539832;37;38;0.621621621621622;14;23;0.121621621621622;0.378378378378378
Control.SRR15539832;42;38;0.571428571428571;18;24;0.0714285714285714;0.428571428571429
Control.SRR15539832;43;38;0.395348837209302;26;17;0.104651162790698;0.395348837209302
Control.SRR15539832;40;38;0.45;22;18;0.05;0.45
Control.SRR15539832;41;38;0.390243902439024;25;16;0.109756097560976;0.390243902439024
Control.SRR15539832;39;38;0.461538461538462;21;18;0.0384615384615384;0.461538461538462
Control.SRR15539832;41;38;0.51219512195122;20;21;0.0121951219512195;0.48780487804878
Control.SRR15539832;41;38;0.585365853658537;17;24;0.0853658536585366;0.414634146341463
Control.SRR15539832;44;38;0.522727272727273;21;23;0.0227272727272727;0.477272727272727
Control.SRR15539832;39;38;0.512820512820513;19;20;0.0128205128205128;0.487179487179487
