Sample;coverage;median_coverage;ALTF;RDR;RDA;Complexity;MAF
Control.SRR15539829;50;45;0.58;21;29;0.08;0.42
Control.SRR15539829;49;45;0.489795918367347;25;24;0.0102040816326531;0.489795918367347
Control.SRR15539829;40;45;0.475;21;19;0.025;0.475
Control.SRR15539829;40;45;0.375;25;15;0.125;0.375
Control.SRR15539829;45;45;0.488888888888889;23;22;0.0111111111111111;0.488888888888889
Control.SRR15539829;42;45;0.523809523809524;20;22;0.0238095238095238;0.476190476190476
Control.SRR15539829;49;45;0.408163265306122;29;20;0.0918367346938775;0.408163265306122
Control.SRR15539829;44;45;0.636363636363636;16;28;0.136363636363636;0.363636363636364
Control.SRR15539829;49;45;0.448979591836735;27;22;0.0510204081632653;0.448979591836735
Control.SRR15539829;50;45;0.52;24;26;0.02;0.48
Control.SRR15539829;48;45;0.5625;21;27;0.0625;0.4375
Control.SRR15539829;49;45;0.63265306122449;18;31;0.13265306122449;0.36734693877551
Control.SRR15539829;41;45;0.51219512195122;20;21;0.0121951219512195;0.48780487804878
Control.SRR15539829;45;45;0.444444444444444;25;20;0.0555555555555556;0.444444444444444
Control.SRR15539829;46;45;0.369565217391304;29;17;0.130434782608696;0.369565217391304
Control.SRR15539829;40;45;0.4;24;16;0.1;0.4
Control.SRR15539829;38;45;0.5;19;19;0;0.5
Control.SRR15539829;45;45;0.622222222222222;17;28;0.122222222222222;0.377777777777778
Control.SRR15539829;43;45;0.465116279069767;23;20;0.0348837209302326;0.465116279069767
Control.SRR15539829;48;45;0.520833333333333;23;25;0.0208333333333334;0.479166666666667
Control.SRR15539829;40;45;0.5;20;20;0;0.5
Control.SRR15539829;39;45;0.512820512820513;19;20;0.0128205128205128;0.487179487179487
Control.SRR15539829;42;45;0.476190476190476;22;20;0.0238095238095238;0.476190476190476
Control.SRR15539829;40;45;0.4;24;16;0.1;0.4
Control.SRR15539829;42;45;0.476190476190476;22;20;0.0238095238095238;0.476190476190476
Control.SRR15539829;40;45;0.55;18;22;0.05;0.45
Control.SRR15539829;40;45;0.525;19;21;0.025;0.475
Control.SRR15539829;45;45;0.466666666666667;24;21;0.0333333333333333;0.466666666666667
Control.SRR15539829;46;45;0.326086956521739;31;15;0.173913043478261;0.326086956521739
Control.SRR15539829;39;45;0.538461538461538;18;21;0.0384615384615384;0.461538461538462
Control.SRR15539829;47;45;0.638297872340426;17;30;0.138297872340426;0.361702127659574
Control.SRR15539829;50;45;0.5;25;25;0;0.5
Control.SRR15539829;39;45;0.538461538461538;18;21;0.0384615384615384;0.461538461538462
Control.SRR15539829;50;45;0.62;19;31;0.12;0.38
Control.SRR15539829;42;45;0.547619047619048;19;23;0.0476190476190477;0.452380952380952
Control.SRR15539829;38;45;0.473684210526316;20;18;0.0263157894736842;0.473684210526316
Control.SRR15539829;43;45;0.534883720930233;20;23;0.0348837209302325;0.465116279069767
Control.SRR15539829;42;45;0.666666666666667;14;28;0.166666666666667;0.333333333333333
Control.SRR15539829;45;45;0.488888888888889;23;22;0.0111111111111111;0.488888888888889
Control.SRR15539829;50;45;0.58;21;29;0.08;0.42
Control.SRR15539829;49;45;0.489795918367347;25;24;0.0102040816326531;0.489795918367347
Control.SRR15539829;45;45;0.488888888888889;23;22;0.0111111111111111;0.488888888888889
Control.SRR15539829;42;45;0.571428571428571;18;24;0.0714285714285714;0.428571428571429
Control.SRR15539829;39;45;0.461538461538462;21;18;0.0384615384615384;0.461538461538462
Control.SRR15539829;43;45;0.581395348837209;18;25;0.0813953488372093;0.418604651162791
Control.SRR15539829;41;45;0.707317073170732;12;29;0.207317073170732;0.292682926829268
Control.SRR15539829;44;45;0.613636363636364;17;27;0.113636363636364;0.386363636363636
Control.SRR15539829;38;45;0.394736842105263;23;15;0.105263157894737;0.394736842105263
Control.SRR15539829;43;45;0.558139534883721;19;24;0.0581395348837209;0.441860465116279
Control.SRR15539829;43;45;0.302325581395349;30;13;0.197674418604651;0.302325581395349
Control.SRR15539829;48;45;0.625;18;30;0.125;0.375
Control.SRR15539829;49;45;0.530612244897959;23;26;0.0306122448979592;0.469387755102041
Control.SRR15539829;39;45;0.564102564102564;17;22;0.0641025641025641;0.435897435897436
Control.SRR15539829;48;45;0.479166666666667;25;23;0.0208333333333333;0.479166666666667
Control.SRR15539829;40;45;0.45;22;18;0.05;0.45
Control.SRR15539829;41;45;0.560975609756098;18;23;0.0609756097560976;0.439024390243902
Control.SRR15539829;38;45;0.473684210526316;20;18;0.0263157894736842;0.473684210526316
Control.SRR15539829;50;45;0.4;30;20;0.1;0.4
Control.SRR15539829;38;45;0.631578947368421;14;24;0.131578947368421;0.368421052631579
Control.SRR15539829;40;45;0.625;15;25;0.125;0.375
Control.SRR15539829;49;45;0.387755102040816;30;19;0.112244897959184;0.387755102040816
Control.SRR15539829;43;45;0.488372093023256;22;21;0.0116279069767442;0.488372093023256
Control.SRR15539829;45;45;0.4;27;18;0.1;0.4
Control.SRR15539829;49;45;0.448979591836735;27;22;0.0510204081632653;0.448979591836735
Control.SRR15539829;44;45;0.613636363636364;17;27;0.113636363636364;0.386363636363636
Control.SRR15539829;39;45;0.41025641025641;23;16;0.0897435897435898;0.41025641025641
Control.SRR15539829;50;45;0.54;23;27;0.04;0.46
Control.SRR15539829;50;45;0.46;27;23;0.04;0.46
Control.SRR15539829;48;45;0.5625;21;27;0.0625;0.4375
Control.SRR15539829;41;45;0.51219512195122;20;21;0.0121951219512195;0.48780487804878
Control.SRR15539829;49;45;0.469387755102041;26;23;0.0306122448979592;0.469387755102041
Control.SRR15539829;47;45;0.51063829787234;23;24;0.0106382978723404;0.48936170212766
Control.SRR15539829;44;45;0.590909090909091;18;26;0.0909090909090909;0.409090909090909
Control.SRR15539829;40;45;0.45;22;18;0.05;0.45
Control.SRR15539829;41;45;0.439024390243902;23;18;0.0609756097560976;0.439024390243902
Control.SRR15539829;49;45;0.510204081632653;24;25;0.0102040816326531;0.489795918367347
Control.SRR15539829;50;45;0.4;30;20;0.1;0.4
Control.SRR15539829;46;45;0.5;23;23;0;0.5
Control.SRR15539829;40;45;0.5;20;20;0;0.5
Control.SRR15539829;42;45;0.547619047619048;19;23;0.0476190476190477;0.452380952380952
Control.SRR15539829;41;45;0.536585365853659;19;22;0.0365853658536586;0.463414634146341
Control.SRR15539829;38;45;0.447368421052632;21;17;0.0526315789473684;0.447368421052632
Control.SRR15539829;42;45;0.380952380952381;26;16;0.119047619047619;0.380952380952381
Control.SRR15539829;41;45;0.414634146341463;24;17;0.0853658536585366;0.414634146341463
Control.SRR15539829;43;45;0.511627906976744;21;22;0.0116279069767442;0.488372093023256
Control.SRR15539829;50;45;0.48;26;24;0.02;0.48
Control.SRR15539829;39;45;0.487179487179487;20;19;0.0128205128205128;0.487179487179487
Control.SRR15539829;40;45;0.425;23;17;0.075;0.425
Control.SRR15539829;49;45;0.571428571428571;21;28;0.0714285714285714;0.428571428571429
Control.SRR15539829;46;45;0.434782608695652;26;20;0.0652173913043478;0.434782608695652
Control.SRR15539829;47;45;0.382978723404255;29;18;0.117021276595745;0.382978723404255
Control.SRR15539829;45;45;0.444444444444444;25;20;0.0555555555555556;0.444444444444444
Control.SRR15539829;40;45;0.6;16;24;0.1;0.4
Control.SRR15539829;50;45;0.62;19;31;0.12;0.38
Control.SRR15539829;44;45;0.431818181818182;25;19;0.0681818181818182;0.431818181818182
Control.SRR15539829;38;45;0.342105263157895;25;13;0.157894736842105;0.342105263157895
Control.SRR15539829;44;45;0.477272727272727;23;21;0.0227272727272727;0.477272727272727
Control.SRR15539829;45;45;0.577777777777778;19;26;0.0777777777777777;0.422222222222222
Control.SRR15539829;42;45;0.476190476190476;22;20;0.0238095238095238;0.476190476190476
Control.SRR15539829;46;45;0.5;23;23;0;0.5
Control.SRR15539829;43;45;0.627906976744186;16;27;0.127906976744186;0.372093023255814
Control.SRR15539829;41;45;0.390243902439024;25;16;0.109756097560976;0.390243902439024
Control.SRR15539829;46;45;0.434782608695652;26;20;0.0652173913043478;0.434782608695652
Control.SRR15539829;50;45;0.54;23;27;0.04;0.46
Control.SRR15539829;45;45;0.555555555555556;20;25;0.0555555555555556;0.444444444444444
Control.SRR15539829;46;45;0.58695652173913;19;27;0.0869565217391305;0.41304347826087
Control.SRR15539829;40;45;0.45;22;18;0.05;0.45
Control.SRR15539829;45;45;0.488888888888889;23;22;0.0111111111111111;0.488888888888889
Control.SRR15539829;43;45;0.534883720930233;20;23;0.0348837209302325;0.465116279069767
Control.SRR15539829;42;45;0.404761904761905;25;17;0.0952380952380952;0.404761904761905
Control.SRR15539829;49;45;0.551020408163265;22;27;0.0510204081632653;0.448979591836735
Control.SRR15539829;48;45;0.354166666666667;31;17;0.145833333333333;0.354166666666667
Control.SRR15539829;48;45;0.479166666666667;25;23;0.0208333333333333;0.479166666666667
Control.SRR15539829;44;45;0.5;22;22;0;0.5
Control.SRR15539829;46;45;0.5;23;23;0;0.5
Control.SRR15539829;49;45;0.469387755102041;26;23;0.0306122448979592;0.469387755102041
Control.SRR15539829;43;45;0.418604651162791;25;18;0.0813953488372093;0.418604651162791
Control.SRR15539829;48;45;0.520833333333333;23;25;0.0208333333333334;0.479166666666667
Control.SRR15539829;47;45;0.404255319148936;28;19;0.0957446808510639;0.404255319148936
Control.SRR15539829;45;45;0.488888888888889;23;22;0.0111111111111111;0.488888888888889
Control.SRR15539829;39;45;0.487179487179487;20;19;0.0128205128205128;0.487179487179487
Control.SRR15539829;49;45;0.448979591836735;27;22;0.0510204081632653;0.448979591836735
Control.SRR15539829;44;45;0.5;22;22;0;0.5
Control.SRR15539829;43;45;0.418604651162791;25;18;0.0813953488372093;0.418604651162791
Control.SRR15539829;46;45;0.478260869565217;24;22;0.0217391304347826;0.478260869565217
Control.SRR15539829;47;45;0.595744680851064;19;28;0.0957446808510638;0.404255319148936
Control.SRR15539829;47;45;0.553191489361702;21;26;0.0531914893617021;0.446808510638298
Control.SRR15539829;40;45;0.65;14;26;0.15;0.35
Control.SRR15539829;41;45;0.439024390243902;23;18;0.0609756097560976;0.439024390243902
Control.SRR15539829;48;45;0.479166666666667;25;23;0.0208333333333333;0.479166666666667
Control.SRR15539829;45;45;0.511111111111111;22;23;0.0111111111111111;0.488888888888889
Control.SRR15539829;43;45;0.581395348837209;18;25;0.0813953488372093;0.418604651162791
Control.SRR15539829;44;45;0.568181818181818;19;25;0.0681818181818182;0.431818181818182
Control.SRR15539829;38;45;0.5;19;19;0;0.5
Control.SRR15539829;50;45;0.46;27;23;0.04;0.46
Control.SRR15539829;43;45;0.395348837209302;26;17;0.104651162790698;0.395348837209302
Control.SRR15539829;45;45;0.6;18;27;0.1;0.4
Control.SRR15539829;47;45;0.468085106382979;25;22;0.0319148936170213;0.468085106382979
Control.SRR15539829;45;45;0.555555555555556;20;25;0.0555555555555556;0.444444444444444
Control.SRR15539829;49;45;0.510204081632653;24;25;0.0102040816326531;0.489795918367347
Control.SRR15539829;38;45;0.552631578947368;17;21;0.0526315789473685;0.447368421052632
Control.SRR15539829;48;45;0.541666666666667;22;26;0.0416666666666666;0.458333333333333
Control.SRR15539829;38;45;0.473684210526316;20;18;0.0263157894736842;0.473684210526316
Control.SRR15539829;49;45;0.408163265306122;29;20;0.0918367346938775;0.408163265306122
Control.SRR15539829;41;45;0.414634146341463;24;17;0.0853658536585366;0.414634146341463
Control.SRR15539829;38;45;0.5;19;19;0;0.5
Control.SRR15539829;43;45;0.488372093023256;22;21;0.0116279069767442;0.488372093023256
Control.SRR15539829;44;45;0.454545454545455;24;20;0.0454545454545455;0.454545454545455
Control.SRR15539829;39;45;0.461538461538462;21;18;0.0384615384615384;0.461538461538462
Control.SRR15539829;45;45;0.6;18;27;0.1;0.4
Control.SRR15539829;45;45;0.533333333333333;21;24;0.0333333333333333;0.466666666666667
Control.SRR15539829;45;45;0.6;18;27;0.1;0.4
Control.SRR15539829;40;45;0.475;21;19;0.025;0.475
Control.SRR15539829;47;45;0.574468085106383;20;27;0.074468085106383;0.425531914893617
Control.SRR15539829;40;45;0.525;19;21;0.025;0.475
Control.SRR15539829;41;45;0.536585365853659;19;22;0.0365853658536586;0.463414634146341
Control.SRR15539829;48;45;0.4375;27;21;0.0625;0.4375
Control.SRR15539829;38;45;0.447368421052632;21;17;0.0526315789473684;0.447368421052632
Control.SRR15539829;38;45;0.578947368421053;16;22;0.0789473684210527;0.421052631578947
Control.SRR15539829;45;45;0.555555555555556;20;25;0.0555555555555556;0.444444444444444
Control.SRR15539829;41;45;0.414634146341463;24;17;0.0853658536585366;0.414634146341463
Control.SRR15539829;50;45;0.64;18;32;0.14;0.36
Control.SRR15539829;45;45;0.444444444444444;25;20;0.0555555555555556;0.444444444444444
Control.SRR15539829;41;45;0.439024390243902;23;18;0.0609756097560976;0.439024390243902
Control.SRR15539829;39;45;0.512820512820513;19;20;0.0128205128205128;0.487179487179487
Control.SRR15539829;48;45;0.5625;21;27;0.0625;0.4375
Control.SRR15539829;48;45;0.458333333333333;26;22;0.0416666666666667;0.458333333333333
Control.SRR15539829;42;45;0.357142857142857;27;15;0.142857142857143;0.357142857142857
Control.SRR15539829;41;45;0.560975609756098;18;23;0.0609756097560976;0.439024390243902
Control.SRR15539829;38;45;0.526315789473684;18;20;0.0263157894736842;0.473684210526316
Control.SRR15539829;39;45;0.58974358974359;16;23;0.0897435897435898;0.41025641025641
Control.SRR15539829;47;45;0.531914893617021;22;25;0.0319148936170213;0.468085106382979
Control.SRR15539829;38;45;0.473684210526316;20;18;0.0263157894736842;0.473684210526316
Control.SRR15539829;45;45;0.4;27;18;0.1;0.4
Control.SRR15539829;39;45;0.641025641025641;14;25;0.141025641025641;0.358974358974359
Control.SRR15539829;41;45;0.560975609756098;18;23;0.0609756097560976;0.439024390243902
Control.SRR15539829;40;45;0.5;20;20;0;0.5
Control.SRR15539829;48;45;0.4375;27;21;0.0625;0.4375
Control.SRR15539829;42;45;0.428571428571429;24;18;0.0714285714285715;0.428571428571429
Control.SRR15539829;46;45;0.58695652173913;19;27;0.0869565217391305;0.41304347826087
Control.SRR15539829;48;45;0.4375;27;21;0.0625;0.4375
Control.SRR15539829;44;45;0.454545454545455;24;20;0.0454545454545455;0.454545454545455
Control.SRR15539829;48;45;0.4375;27;21;0.0625;0.4375
Control.SRR15539829;44;45;0.409090909090909;26;18;0.0909090909090909;0.409090909090909
Control.SRR15539829;46;45;0.456521739130435;25;21;0.0434782608695652;0.456521739130435
Control.SRR15539829;48;45;0.583333333333333;20;28;0.0833333333333334;0.416666666666667
Control.SRR15539829;49;45;0.469387755102041;26;23;0.0306122448979592;0.469387755102041
Control.SRR15539829;41;45;0.48780487804878;21;20;0.0121951219512195;0.48780487804878
Control.SRR15539829;41;45;0.585365853658537;17;24;0.0853658536585366;0.414634146341463
Control.SRR15539829;49;45;0.612244897959184;19;30;0.112244897959184;0.387755102040816
Control.SRR15539829;48;45;0.479166666666667;25;23;0.0208333333333333;0.479166666666667
Control.SRR15539829;42;45;0.476190476190476;22;20;0.0238095238095238;0.476190476190476
Control.SRR15539829;45;45;0.622222222222222;17;28;0.122222222222222;0.377777777777778
Control.SRR15539829;50;45;0.52;24;26;0.02;0.48
Control.SRR15539829;43;45;0.534883720930233;20;23;0.0348837209302325;0.465116279069767
Control.SRR15539829;42;45;0.476190476190476;22;20;0.0238095238095238;0.476190476190476
Control.SRR15539829;39;45;0.564102564102564;17;22;0.0641025641025641;0.435897435897436
Control.SRR15539829;39;45;0.41025641025641;23;16;0.0897435897435898;0.41025641025641
Control.SRR15539829;50;45;0.46;27;23;0.04;0.46
Control.SRR15539829;47;45;0.51063829787234;23;24;0.0106382978723404;0.48936170212766
Control.SRR15539829;45;45;0.422222222222222;26;19;0.0777777777777778;0.422222222222222
Control.SRR15539829;45;45;0.533333333333333;21;24;0.0333333333333333;0.466666666666667
Control.SRR15539829;47;45;0.404255319148936;28;19;0.0957446808510639;0.404255319148936
Control.SRR15539829;47;45;0.48936170212766;24;23;0.0106382978723404;0.48936170212766
Control.SRR15539829;43;45;0.465116279069767;23;20;0.0348837209302326;0.465116279069767
Control.SRR15539829;38;45;0.526315789473684;18;20;0.0263157894736842;0.473684210526316
Control.SRR15539829;38;45;0.5;19;19;0;0.5
Control.SRR15539829;48;45;0.583333333333333;20;28;0.0833333333333334;0.416666666666667
Control.SRR15539829;49;45;0.408163265306122;29;20;0.0918367346938775;0.408163265306122
Control.SRR15539829;46;45;0.58695652173913;19;27;0.0869565217391305;0.41304347826087
Control.SRR15539829;40;45;0.45;22;18;0.05;0.45
Control.SRR15539829;44;45;0.477272727272727;23;21;0.0227272727272727;0.477272727272727
Control.SRR15539829;41;45;0.439024390243902;23;18;0.0609756097560976;0.439024390243902
Control.SRR15539829;41;45;0.51219512195122;20;21;0.0121951219512195;0.48780487804878
Control.SRR15539829;43;45;0.604651162790698;17;26;0.104651162790698;0.395348837209302
Control.SRR15539829;49;45;0.469387755102041;26;23;0.0306122448979592;0.469387755102041
Control.SRR15539829;43;45;0.441860465116279;24;19;0.0581395348837209;0.441860465116279
Control.SRR15539829;45;45;0.511111111111111;22;23;0.0111111111111111;0.488888888888889
Control.SRR15539829;42;45;0.428571428571429;24;18;0.0714285714285715;0.428571428571429
Control.SRR15539829;43;45;0.395348837209302;26;17;0.104651162790698;0.395348837209302
Control.SRR15539829;43;45;0.348837209302326;28;15;0.151162790697674;0.348837209302326
Control.SRR15539829;41;45;0.560975609756098;18;23;0.0609756097560976;0.439024390243902
Control.SRR15539829;46;45;0.521739130434783;22;24;0.0217391304347826;0.478260869565217
Control.SRR15539829;43;45;0.465116279069767;23;20;0.0348837209302326;0.465116279069767
Control.SRR15539829;49;45;0.591836734693878;20;29;0.0918367346938775;0.408163265306122
Control.SRR15539829;41;45;0.341463414634146;27;14;0.158536585365854;0.341463414634146
Control.SRR15539829;38;45;0.631578947368421;14;24;0.131578947368421;0.368421052631579
Control.SRR15539829;39;45;0.384615384615385;24;15;0.115384615384615;0.384615384615385
Control.SRR15539829;45;45;0.533333333333333;21;24;0.0333333333333333;0.466666666666667
Control.SRR15539829;50;45;0.64;18;32;0.14;0.36
Control.SRR15539829;49;45;0.510204081632653;24;25;0.0102040816326531;0.489795918367347
Control.SRR15539829;44;45;0.5;22;22;0;0.5
Control.SRR15539829;40;45;0.675;13;27;0.175;0.325
Control.SRR15539829;41;45;0.439024390243902;23;18;0.0609756097560976;0.439024390243902
Control.SRR15539829;44;45;0.568181818181818;19;25;0.0681818181818182;0.431818181818182
Control.SRR15539829;41;45;0.414634146341463;24;17;0.0853658536585366;0.414634146341463
Control.SRR15539829;45;45;0.533333333333333;21;24;0.0333333333333333;0.466666666666667
Control.SRR15539829;45;45;0.555555555555556;20;25;0.0555555555555556;0.444444444444444
Control.SRR15539829;48;45;0.583333333333333;20;28;0.0833333333333334;0.416666666666667
Control.SRR15539829;43;45;0.604651162790698;17;26;0.104651162790698;0.395348837209302
Control.SRR15539829;45;45;0.511111111111111;22;23;0.0111111111111111;0.488888888888889
Control.SRR15539829;44;45;0.454545454545455;24;20;0.0454545454545455;0.454545454545455
Control.SRR15539829;48;45;0.604166666666667;19;29;0.104166666666667;0.395833333333333
Control.SRR15539829;49;45;0.63265306122449;18;31;0.13265306122449;0.36734693877551
Control.SRR15539829;42;45;0.404761904761905;25;17;0.0952380952380952;0.404761904761905
Control.SRR15539829;46;45;0.478260869565217;24;22;0.0217391304347826;0.478260869565217
Control.SRR15539829;48;45;0.5625;21;27;0.0625;0.4375
Control.SRR15539829;42;45;0.619047619047619;16;26;0.119047619047619;0.380952380952381
Control.SRR15539829;46;45;0.434782608695652;26;20;0.0652173913043478;0.434782608695652
Control.SRR15539829;45;45;0.511111111111111;22;23;0.0111111111111111;0.488888888888889
Control.SRR15539829;39;45;0.564102564102564;17;22;0.0641025641025641;0.435897435897436
Control.SRR15539829;39;45;0.512820512820513;19;20;0.0128205128205128;0.487179487179487
Control.SRR15539829;44;45;0.477272727272727;23;21;0.0227272727272727;0.477272727272727
Control.SRR15539829;43;45;0.511627906976744;21;22;0.0116279069767442;0.488372093023256
Control.SRR15539829;47;45;0.468085106382979;25;22;0.0319148936170213;0.468085106382979
Control.SRR15539829;50;45;0.4;30;20;0.1;0.4
Control.SRR15539829;44;45;0.545454545454545;20;24;0.0454545454545454;0.454545454545455
Control.SRR15539829;45;45;0.311111111111111;31;14;0.188888888888889;0.311111111111111
Control.SRR15539829;46;45;0.478260869565217;24;22;0.0217391304347826;0.478260869565217
Control.SRR15539829;41;45;0.390243902439024;25;16;0.109756097560976;0.390243902439024
Control.SRR15539829;39;45;0.512820512820513;19;20;0.0128205128205128;0.487179487179487
Control.SRR15539829;43;45;0.488372093023256;22;21;0.0116279069767442;0.488372093023256
Control.SRR15539829;38;45;0.447368421052632;21;17;0.0526315789473684;0.447368421052632
Control.SRR15539829;41;45;0.48780487804878;21;20;0.0121951219512195;0.48780487804878
Control.SRR15539829;44;45;0.522727272727273;21;23;0.0227272727272727;0.477272727272727
Control.SRR15539829;44;45;0.5;22;22;0;0.5
Control.SRR15539829;48;45;0.5625;21;27;0.0625;0.4375
Control.SRR15539829;44;45;0.431818181818182;25;19;0.0681818181818182;0.431818181818182
Control.SRR15539829;43;45;0.534883720930233;20;23;0.0348837209302325;0.465116279069767
Control.SRR15539829;49;45;0.448979591836735;27;22;0.0510204081632653;0.448979591836735
Control.SRR15539829;47;45;0.48936170212766;24;23;0.0106382978723404;0.48936170212766
Control.SRR15539829;49;45;0.448979591836735;27;22;0.0510204081632653;0.448979591836735
Control.SRR15539829;44;45;0.386363636363636;27;17;0.113636363636364;0.386363636363636
Control.SRR15539829;43;45;0.511627906976744;21;22;0.0116279069767442;0.488372093023256
Control.SRR15539829;41;45;0.48780487804878;21;20;0.0121951219512195;0.48780487804878
Control.SRR15539829;41;45;0.609756097560976;16;25;0.109756097560976;0.390243902439024
Control.SRR15539829;47;45;0.425531914893617;27;20;0.074468085106383;0.425531914893617
Control.SRR15539829;48;45;0.395833333333333;29;19;0.104166666666667;0.395833333333333
Control.SRR15539829;44;45;0.545454545454545;20;24;0.0454545454545454;0.454545454545455
Control.SRR15539829;39;45;0.512820512820513;19;20;0.0128205128205128;0.487179487179487
Control.SRR15539829;47;45;0.340425531914894;31;16;0.159574468085106;0.340425531914894
Control.SRR15539829;48;45;0.479166666666667;25;23;0.0208333333333333;0.479166666666667
Control.SRR15539829;41;45;0.560975609756098;18;23;0.0609756097560976;0.439024390243902
Control.SRR15539829;44;45;0.431818181818182;25;19;0.0681818181818182;0.431818181818182
Control.SRR15539829;46;45;0.391304347826087;28;18;0.108695652173913;0.391304347826087
Control.SRR15539829;48;45;0.416666666666667;28;20;0.0833333333333333;0.416666666666667
Control.SRR15539829;46;45;0.5;23;23;0;0.5
Control.SRR15539829;46;45;0.58695652173913;19;27;0.0869565217391305;0.41304347826087
Control.SRR15539829;47;45;0.446808510638298;26;21;0.0531914893617021;0.446808510638298
Control.SRR15539829;47;45;0.595744680851064;19;28;0.0957446808510638;0.404255319148936
Control.SRR15539829;49;45;0.530612244897959;23;26;0.0306122448979592;0.469387755102041
Control.SRR15539829;44;45;0.545454545454545;20;24;0.0454545454545454;0.454545454545455
Control.SRR15539829;47;45;0.574468085106383;20;27;0.074468085106383;0.425531914893617
Control.SRR15539829;48;45;0.4375;27;21;0.0625;0.4375
Control.SRR15539829;40;45;0.575;17;23;0.075;0.425
Control.SRR15539829;40;45;0.575;17;23;0.075;0.425
Control.SRR15539829;39;45;0.512820512820513;19;20;0.0128205128205128;0.487179487179487
Control.SRR15539829;46;45;0.478260869565217;24;22;0.0217391304347826;0.478260869565217
Control.SRR15539829;47;45;0.425531914893617;27;20;0.074468085106383;0.425531914893617
Control.SRR15539829;41;45;0.51219512195122;20;21;0.0121951219512195;0.48780487804878
Control.SRR15539829;38;45;0.447368421052632;21;17;0.0526315789473684;0.447368421052632
Control.SRR15539829;42;45;0.595238095238095;17;25;0.0952380952380952;0.404761904761905
Control.SRR15539829;49;45;0.653061224489796;17;32;0.153061224489796;0.346938775510204
Control.SRR15539829;50;45;0.46;27;23;0.04;0.46
Control.SRR15539829;42;45;0.571428571428571;18;24;0.0714285714285714;0.428571428571429
Control.SRR15539829;50;45;0.46;27;23;0.04;0.46
Control.SRR15539829;49;45;0.551020408163265;22;27;0.0510204081632653;0.448979591836735
Control.SRR15539829;39;45;0.512820512820513;19;20;0.0128205128205128;0.487179487179487
Control.SRR15539829;50;45;0.44;28;22;0.06;0.44
Control.SRR15539829;48;45;0.479166666666667;25;23;0.0208333333333333;0.479166666666667
Control.SRR15539829;46;45;0.391304347826087;28;18;0.108695652173913;0.391304347826087
Control.SRR15539829;41;45;0.536585365853659;19;22;0.0365853658536586;0.463414634146341
Control.SRR15539829;43;45;0.465116279069767;23;20;0.0348837209302326;0.465116279069767
Control.SRR15539829;38;45;0.5;19;19;0;0.5
Control.SRR15539829;46;45;0.543478260869565;21;25;0.0434782608695652;0.456521739130435
Control.SRR15539829;50;45;0.64;18;32;0.14;0.36
Control.SRR15539829;38;45;0.473684210526316;20;18;0.0263157894736842;0.473684210526316
Control.SRR15539829;46;45;0.434782608695652;26;20;0.0652173913043478;0.434782608695652
Control.SRR15539829;45;45;0.444444444444444;25;20;0.0555555555555556;0.444444444444444
Control.SRR15539829;41;45;0.609756097560976;16;25;0.109756097560976;0.390243902439024
Control.SRR15539829;42;45;0.5;21;21;0;0.5
Control.SRR15539829;41;45;0.414634146341463;24;17;0.0853658536585366;0.414634146341463
Control.SRR15539829;38;45;0.447368421052632;21;17;0.0526315789473684;0.447368421052632
Control.SRR15539829;38;45;0.736842105263158;10;28;0.236842105263158;0.263157894736842
Control.SRR15539829;39;45;0.564102564102564;17;22;0.0641025641025641;0.435897435897436
Control.SRR15539829;41;45;0.390243902439024;25;16;0.109756097560976;0.390243902439024
Control.SRR15539829;44;45;0.454545454545455;24;20;0.0454545454545455;0.454545454545455
Control.SRR15539829;48;45;0.5;24;24;0;0.5
Control.SRR15539829;50;45;0.56;22;28;0.0600000000000001;0.44
Control.SRR15539829;39;45;0.512820512820513;19;20;0.0128205128205128;0.487179487179487
Control.SRR15539829;44;45;0.454545454545455;24;20;0.0454545454545455;0.454545454545455
Control.SRR15539829;44;45;0.431818181818182;25;19;0.0681818181818182;0.431818181818182
Control.SRR15539829;41;45;0.414634146341463;24;17;0.0853658536585366;0.414634146341463
Control.SRR15539829;44;45;0.522727272727273;21;23;0.0227272727272727;0.477272727272727
Control.SRR15539829;48;45;0.645833333333333;17;31;0.145833333333333;0.354166666666667
Control.SRR15539829;43;45;0.511627906976744;21;22;0.0116279069767442;0.488372093023256
Control.SRR15539829;39;45;0.564102564102564;17;22;0.0641025641025641;0.435897435897436
Control.SRR15539829;44;45;0.568181818181818;19;25;0.0681818181818182;0.431818181818182
Control.SRR15539829;49;45;0.571428571428571;21;28;0.0714285714285714;0.428571428571429
Control.SRR15539829;38;45;0.473684210526316;20;18;0.0263157894736842;0.473684210526316
Control.SRR15539829;38;45;0.421052631578947;22;16;0.0789473684210527;0.421052631578947
Control.SRR15539829;48;45;0.5;24;24;0;0.5
Control.SRR15539829;49;45;0.469387755102041;26;23;0.0306122448979592;0.469387755102041
Control.SRR15539829;46;45;0.347826086956522;30;16;0.152173913043478;0.347826086956522
Control.SRR15539829;49;45;0.591836734693878;20;29;0.0918367346938775;0.408163265306122
Control.SRR15539829;40;45;0.45;22;18;0.05;0.45
Control.SRR15539829;41;45;0.439024390243902;23;18;0.0609756097560976;0.439024390243902
Control.SRR15539829;49;45;0.469387755102041;26;23;0.0306122448979592;0.469387755102041
Control.SRR15539829;42;45;0.523809523809524;20;22;0.0238095238095238;0.476190476190476
Control.SRR15539829;46;45;0.543478260869565;21;25;0.0434782608695652;0.456521739130435
Control.SRR15539829;49;45;0.469387755102041;26;23;0.0306122448979592;0.469387755102041
Control.SRR15539829;48;45;0.4375;27;21;0.0625;0.4375
Control.SRR15539829;47;45;0.404255319148936;28;19;0.0957446808510639;0.404255319148936
Control.SRR15539829;50;45;0.54;23;27;0.04;0.46
Control.SRR15539829;38;45;0.394736842105263;23;15;0.105263157894737;0.394736842105263
Control.SRR15539829;41;45;0.439024390243902;23;18;0.0609756097560976;0.439024390243902
Control.SRR15539829;49;45;0.428571428571429;28;21;0.0714285714285715;0.428571428571429
Control.SRR15539829;49;45;0.469387755102041;26;23;0.0306122448979592;0.469387755102041
Control.SRR15539829;44;45;0.568181818181818;19;25;0.0681818181818182;0.431818181818182
Control.SRR15539829;38;45;0.5;19;19;0;0.5
Control.SRR15539829;43;45;0.558139534883721;19;24;0.0581395348837209;0.441860465116279
Control.SRR15539829;39;45;0.487179487179487;20;19;0.0128205128205128;0.487179487179487
Control.SRR15539829;44;45;0.5;22;22;0;0.5
Control.SRR15539829;49;45;0.571428571428571;21;28;0.0714285714285714;0.428571428571429
Control.SRR15539829;46;45;0.326086956521739;31;15;0.173913043478261;0.326086956521739
Control.SRR15539829;46;45;0.543478260869565;21;25;0.0434782608695652;0.456521739130435
Control.SRR15539829;47;45;0.404255319148936;28;19;0.0957446808510639;0.404255319148936
Control.SRR15539829;49;45;0.428571428571429;28;21;0.0714285714285715;0.428571428571429
Control.SRR15539829;50;45;0.52;24;26;0.02;0.48
Control.SRR15539829;50;45;0.52;24;26;0.02;0.48
Control.SRR15539829;47;45;0.617021276595745;18;29;0.117021276595745;0.382978723404255
Control.SRR15539829;46;45;0.434782608695652;26;20;0.0652173913043478;0.434782608695652
Control.SRR15539829;49;45;0.469387755102041;26;23;0.0306122448979592;0.469387755102041
Control.SRR15539829;38;45;0.421052631578947;22;16;0.0789473684210527;0.421052631578947
Control.SRR15539829;49;45;0.428571428571429;28;21;0.0714285714285715;0.428571428571429
Control.SRR15539829;46;45;0.521739130434783;22;24;0.0217391304347826;0.478260869565217
Control.SRR15539829;46;45;0.369565217391304;29;17;0.130434782608696;0.369565217391304
Control.SRR15539829;48;45;0.541666666666667;22;26;0.0416666666666666;0.458333333333333
Control.SRR15539829;40;45;0.575;17;23;0.075;0.425
Control.SRR15539829;42;45;0.523809523809524;20;22;0.0238095238095238;0.476190476190476
Control.SRR15539829;42;45;0.571428571428571;18;24;0.0714285714285714;0.428571428571429
Control.SRR15539829;44;45;0.431818181818182;25;19;0.0681818181818182;0.431818181818182
Control.SRR15539829;46;45;0.652173913043478;16;30;0.152173913043478;0.347826086956522
Control.SRR15539829;50;45;0.44;28;22;0.06;0.44
Control.SRR15539829;41;45;0.51219512195122;20;21;0.0121951219512195;0.48780487804878
Control.SRR15539829;41;45;0.536585365853659;19;22;0.0365853658536586;0.463414634146341
Control.SRR15539829;48;45;0.4375;27;21;0.0625;0.4375
Control.SRR15539829;47;45;0.553191489361702;21;26;0.0531914893617021;0.446808510638298
Control.SRR15539829;55;45;0.472727272727273;29;26;0.0272727272727273;0.472727272727273
Control.SRR15539829;50;45;0.42;29;21;0.08;0.42
Control.SRR15539829;53;45;0.490566037735849;27;26;0.00943396226415094;0.490566037735849
Control.SRR15539829;53;45;0.547169811320755;24;29;0.0471698113207547;0.452830188679245
Control.SRR15539829;52;45;0.576923076923077;22;30;0.0769230769230769;0.423076923076923
Control.SRR15539829;52;45;0.403846153846154;31;21;0.0961538461538461;0.403846153846154
Control.SRR15539829;51;45;0.529411764705882;24;27;0.0294117647058824;0.470588235294118
Control.SRR15539829;55;45;0.454545454545455;30;25;0.0454545454545455;0.454545454545455
Control.SRR15539829;46;45;0.543478260869565;21;25;0.0434782608695652;0.456521739130435
Control.SRR15539829;47;45;0.553191489361702;21;26;0.0531914893617021;0.446808510638298
Control.SRR15539829;41;45;0.585365853658537;17;24;0.0853658536585366;0.414634146341463
Control.SRR15539829;44;45;0.386363636363636;27;17;0.113636363636364;0.386363636363636
Control.SRR15539829;43;45;0.674418604651163;14;29;0.174418604651163;0.325581395348837
Control.SRR15539829;48;45;0.604166666666667;19;29;0.104166666666667;0.395833333333333
Control.SRR15539829;46;45;0.630434782608696;17;29;0.130434782608696;0.369565217391304
Control.SRR15539829;53;45;0.584905660377358;22;31;0.0849056603773585;0.415094339622642
Control.SRR15539829;43;45;0.441860465116279;24;19;0.0581395348837209;0.441860465116279
Control.SRR15539829;49;45;0.551020408163265;22;27;0.0510204081632653;0.448979591836735
Control.SRR15539829;51;45;0.509803921568627;25;26;0.00980392156862742;0.490196078431373
Control.SRR15539829;55;45;0.381818181818182;34;21;0.118181818181818;0.381818181818182
Control.SRR15539829;51;45;0.509803921568627;25;26;0.00980392156862742;0.490196078431373
Control.SRR15539829;43;45;0.558139534883721;19;24;0.0581395348837209;0.441860465116279
Control.SRR15539829;45;45;0.377777777777778;28;17;0.122222222222222;0.377777777777778
Control.SRR15539829;49;45;0.530612244897959;23;26;0.0306122448979592;0.469387755102041
Control.SRR15539829;54;45;0.518518518518518;26;28;0.0185185185185185;0.481481481481481
Control.SRR15539829;44;45;0.5;22;22;0;0.5
Control.SRR15539829;52;45;0.5;26;26;0;0.5
Control.SRR15539829;46;45;0.5;23;23;0;0.5
Control.SRR15539829;45;45;0.577777777777778;19;26;0.0777777777777777;0.422222222222222
Control.SRR15539829;42;45;0.5;21;21;0;0.5
Control.SRR15539829;44;45;0.454545454545455;24;20;0.0454545454545455;0.454545454545455
Control.SRR15539829;43;45;0.465116279069767;23;20;0.0348837209302326;0.465116279069767
Control.SRR15539829;41;45;0.560975609756098;18;23;0.0609756097560976;0.439024390243902
Control.SRR15539829;43;45;0.511627906976744;21;22;0.0116279069767442;0.488372093023256
Control.SRR15539829;43;45;0.395348837209302;26;17;0.104651162790698;0.395348837209302
Control.SRR15539829;44;45;0.613636363636364;17;27;0.113636363636364;0.386363636363636
Control.SRR15539829;41;45;0.658536585365854;14;27;0.158536585365854;0.341463414634146
Control.SRR15539829;41;45;0.560975609756098;18;23;0.0609756097560976;0.439024390243902
Control.SRR15539829;49;45;0.530612244897959;23;26;0.0306122448979592;0.469387755102041
Control.SRR15539829;48;45;0.520833333333333;23;25;0.0208333333333334;0.479166666666667
Control.SRR15539829;45;45;0.444444444444444;25;20;0.0555555555555556;0.444444444444444
Control.SRR15539829;49;45;0.448979591836735;27;22;0.0510204081632653;0.448979591836735
Control.SRR15539829;55;45;0.527272727272727;26;29;0.0272727272727272;0.472727272727273
Control.SRR15539829;55;45;0.345454545454545;36;19;0.154545454545455;0.345454545454545
Control.SRR15539829;55;45;0.6;22;33;0.1;0.4
Control.SRR15539829;42;45;0.5;21;21;0;0.5
Control.SRR15539829;48;45;0.604166666666667;19;29;0.104166666666667;0.395833333333333
Control.SRR15539829;41;45;0.536585365853659;19;22;0.0365853658536586;0.463414634146341
Control.SRR15539829;43;45;0.511627906976744;21;22;0.0116279069767442;0.488372093023256
Control.SRR15539829;47;45;0.48936170212766;24;23;0.0106382978723404;0.48936170212766
Control.SRR15539829;42;45;0.619047619047619;16;26;0.119047619047619;0.380952380952381
Control.SRR15539829;41;45;0.51219512195122;20;21;0.0121951219512195;0.48780487804878
Control.SRR15539829;44;45;0.590909090909091;18;26;0.0909090909090909;0.409090909090909
Control.SRR15539829;43;45;0.627906976744186;16;27;0.127906976744186;0.372093023255814
Control.SRR15539829;50;45;0.48;26;24;0.02;0.48
Control.SRR15539829;54;45;0.462962962962963;29;25;0.037037037037037;0.462962962962963
Control.SRR15539829;47;45;0.574468085106383;20;27;0.074468085106383;0.425531914893617
Control.SRR15539829;49;45;0.489795918367347;25;24;0.0102040816326531;0.489795918367347
Control.SRR15539829;52;45;0.557692307692308;23;29;0.0576923076923077;0.442307692307692
Control.SRR15539829;48;45;0.354166666666667;31;17;0.145833333333333;0.354166666666667
Control.SRR15539829;43;45;0.604651162790698;17;26;0.104651162790698;0.395348837209302
Control.SRR15539829;48;45;0.479166666666667;25;23;0.0208333333333333;0.479166666666667
Control.SRR15539829;45;45;0.377777777777778;28;17;0.122222222222222;0.377777777777778
Control.SRR15539829;41;45;0.585365853658537;17;24;0.0853658536585366;0.414634146341463
Control.SRR15539829;48;45;0.5;24;24;0;0.5
Control.SRR15539829;51;45;0.470588235294118;27;24;0.0294117647058824;0.470588235294118
Control.SRR15539829;46;45;0.543478260869565;21;25;0.0434782608695652;0.456521739130435
Control.SRR15539829;41;45;0.585365853658537;17;24;0.0853658536585366;0.414634146341463
Control.SRR15539829;43;45;0.581395348837209;18;25;0.0813953488372093;0.418604651162791
Control.SRR15539829;55;45;0.6;22;33;0.1;0.4
Control.SRR15539829;52;45;0.5;26;26;0;0.5
Control.SRR15539829;54;45;0.37037037037037;34;20;0.12962962962963;0.37037037037037
Control.SRR15539829;48;45;0.625;18;30;0.125;0.375
Control.SRR15539829;49;45;0.551020408163265;22;27;0.0510204081632653;0.448979591836735
Control.SRR15539829;50;45;0.56;22;28;0.0600000000000001;0.44
Control.SRR15539829;46;45;0.58695652173913;19;27;0.0869565217391305;0.41304347826087
Control.SRR15539829;52;45;0.576923076923077;22;30;0.0769230769230769;0.423076923076923
Control.SRR15539829;41;45;0.585365853658537;17;24;0.0853658536585366;0.414634146341463
Control.SRR15539829;46;45;0.456521739130435;25;21;0.0434782608695652;0.456521739130435
Control.SRR15539829;45;45;0.466666666666667;24;21;0.0333333333333333;0.466666666666667
Control.SRR15539829;52;45;0.461538461538462;28;24;0.0384615384615384;0.461538461538462
Control.SRR15539829;42;45;0.476190476190476;22;20;0.0238095238095238;0.476190476190476
Control.SRR15539829;54;45;0.555555555555556;24;30;0.0555555555555556;0.444444444444444
Control.SRR15539829;47;45;0.48936170212766;24;23;0.0106382978723404;0.48936170212766
Control.SRR15539829;49;45;0.612244897959184;19;30;0.112244897959184;0.387755102040816
Control.SRR15539829;53;45;0.509433962264151;26;27;0.00943396226415094;0.490566037735849
Control.SRR15539829;48;45;0.479166666666667;25;23;0.0208333333333333;0.479166666666667
Control.SRR15539829;55;45;0.436363636363636;31;24;0.0636363636363637;0.436363636363636
Control.SRR15539829;46;45;0.608695652173913;18;28;0.108695652173913;0.391304347826087
Control.SRR15539829;46;45;0.478260869565217;24;22;0.0217391304347826;0.478260869565217
Control.SRR15539829;54;45;0.5;27;27;0;0.5
Control.SRR15539829;54;45;0.574074074074074;23;31;0.0740740740740741;0.425925925925926
Control.SRR15539829;46;45;0.478260869565217;24;22;0.0217391304347826;0.478260869565217
Control.SRR15539829;49;45;0.469387755102041;26;23;0.0306122448979592;0.469387755102041
Control.SRR15539829;45;45;0.466666666666667;24;21;0.0333333333333333;0.466666666666667
Control.SRR15539829;47;45;0.531914893617021;22;25;0.0319148936170213;0.468085106382979
Control.SRR15539829;47;45;0.51063829787234;23;24;0.0106382978723404;0.48936170212766
Control.SRR15539829;43;45;0.418604651162791;25;18;0.0813953488372093;0.418604651162791
Control.SRR15539829;51;45;0.490196078431373;26;25;0.00980392156862747;0.490196078431373
Control.SRR15539829;44;45;0.454545454545455;24;20;0.0454545454545455;0.454545454545455
Control.SRR15539829;53;45;0.433962264150943;30;23;0.0660377358490566;0.433962264150943
Control.SRR15539829;49;45;0.428571428571429;28;21;0.0714285714285715;0.428571428571429
Control.SRR15539829;49;45;0.489795918367347;25;24;0.0102040816326531;0.489795918367347
Control.SRR15539829;42;45;0.357142857142857;27;15;0.142857142857143;0.357142857142857
Control.SRR15539829;41;45;0.585365853658537;17;24;0.0853658536585366;0.414634146341463
Control.SRR15539829;48;45;0.541666666666667;22;26;0.0416666666666666;0.458333333333333
Control.SRR15539829;43;45;0.558139534883721;19;24;0.0581395348837209;0.441860465116279
Control.SRR15539829;46;45;0.543478260869565;21;25;0.0434782608695652;0.456521739130435
Control.SRR15539829;46;45;0.543478260869565;21;25;0.0434782608695652;0.456521739130435
Control.SRR15539829;48;45;0.395833333333333;29;19;0.104166666666667;0.395833333333333
Control.SRR15539829;45;45;0.311111111111111;31;14;0.188888888888889;0.311111111111111
Control.SRR15539829;43;45;0.488372093023256;22;21;0.0116279069767442;0.488372093023256
Control.SRR15539829;54;45;0.481481481481481;28;26;0.0185185185185185;0.481481481481481
Control.SRR15539829;52;45;0.538461538461538;24;28;0.0384615384615384;0.461538461538462
Control.SRR15539829;52;45;0.557692307692308;23;29;0.0576923076923077;0.442307692307692
Control.SRR15539829;45;45;0.488888888888889;23;22;0.0111111111111111;0.488888888888889
Control.SRR15539829;51;45;0.529411764705882;24;27;0.0294117647058824;0.470588235294118
Control.SRR15539829;47;45;0.574468085106383;20;27;0.074468085106383;0.425531914893617
Control.SRR15539829;43;45;0.558139534883721;19;24;0.0581395348837209;0.441860465116279
Control.SRR15539829;55;45;0.618181818181818;21;34;0.118181818181818;0.381818181818182
Control.SRR15539829;48;45;0.541666666666667;22;26;0.0416666666666666;0.458333333333333
Control.SRR15539829;44;45;0.568181818181818;19;25;0.0681818181818182;0.431818181818182
Control.SRR15539829;46;45;0.282608695652174;33;13;0.217391304347826;0.282608695652174
Control.SRR15539829;48;45;0.458333333333333;26;22;0.0416666666666667;0.458333333333333
Control.SRR15539829;41;45;0.414634146341463;24;17;0.0853658536585366;0.414634146341463
Control.SRR15539829;51;45;0.549019607843137;23;28;0.0490196078431373;0.450980392156863
Control.SRR15539829;48;45;0.354166666666667;31;17;0.145833333333333;0.354166666666667
Control.SRR15539829;42;45;0.5;21;21;0;0.5
Control.SRR15539829;48;45;0.479166666666667;25;23;0.0208333333333333;0.479166666666667
Control.SRR15539829;44;45;0.477272727272727;23;21;0.0227272727272727;0.477272727272727
Control.SRR15539829;45;45;0.444444444444444;25;20;0.0555555555555556;0.444444444444444
Control.SRR15539829;55;45;0.581818181818182;23;32;0.0818181818181818;0.418181818181818
Control.SRR15539829;46;45;0.608695652173913;18;28;0.108695652173913;0.391304347826087
Control.SRR15539829;55;45;0.527272727272727;26;29;0.0272727272727272;0.472727272727273
Control.SRR15539829;52;45;0.403846153846154;31;21;0.0961538461538461;0.403846153846154
Control.SRR15539829;48;45;0.541666666666667;22;26;0.0416666666666666;0.458333333333333
Control.SRR15539829;47;45;0.48936170212766;24;23;0.0106382978723404;0.48936170212766
Control.SRR15539829;44;45;0.477272727272727;23;21;0.0227272727272727;0.477272727272727
Control.SRR15539829;54;45;0.444444444444444;30;24;0.0555555555555556;0.444444444444444
Control.SRR15539829;51;45;0.450980392156863;28;23;0.0490196078431372;0.450980392156863
Control.SRR15539829;41;45;0.48780487804878;21;20;0.0121951219512195;0.48780487804878
Control.SRR15539829;41;45;0.48780487804878;21;20;0.0121951219512195;0.48780487804878
Control.SRR15539829;55;45;0.4;33;22;0.1;0.4
Control.SRR15539829;55;45;0.618181818181818;21;34;0.118181818181818;0.381818181818182
Control.SRR15539829;54;45;0.481481481481481;28;26;0.0185185185185185;0.481481481481481
Control.SRR15539829;55;45;0.418181818181818;32;23;0.0818181818181818;0.418181818181818
Control.SRR15539829;51;45;0.490196078431373;26;25;0.00980392156862747;0.490196078431373
Control.SRR15539829;50;45;0.54;23;27;0.04;0.46
Control.SRR15539829;54;45;0.518518518518518;26;28;0.0185185185185185;0.481481481481481
Control.SRR15539829;49;45;0.530612244897959;23;26;0.0306122448979592;0.469387755102041
Control.SRR15539829;46;45;0.543478260869565;21;25;0.0434782608695652;0.456521739130435
Control.SRR15539829;50;45;0.56;22;28;0.0600000000000001;0.44
Control.SRR15539829;43;45;0.465116279069767;23;20;0.0348837209302326;0.465116279069767
Control.SRR15539829;42;45;0.523809523809524;20;22;0.0238095238095238;0.476190476190476
Control.SRR15539829;44;45;0.431818181818182;25;19;0.0681818181818182;0.431818181818182
Control.SRR15539829;51;45;0.450980392156863;28;23;0.0490196078431372;0.450980392156863
Control.SRR15539829;45;45;0.4;27;18;0.1;0.4
Control.SRR15539829;50;45;0.48;26;24;0.02;0.48
Control.SRR15539829;47;45;0.340425531914894;31;16;0.159574468085106;0.340425531914894
Control.SRR15539829;48;45;0.541666666666667;22;26;0.0416666666666666;0.458333333333333
Control.SRR15539829;49;45;0.510204081632653;24;25;0.0102040816326531;0.489795918367347
Control.SRR15539829;51;45;0.411764705882353;30;21;0.0882352941176471;0.411764705882353
Control.SRR15539829;49;45;0.448979591836735;27;22;0.0510204081632653;0.448979591836735
Control.SRR15539829;48;45;0.4375;27;21;0.0625;0.4375
Control.SRR15539829;45;45;0.466666666666667;24;21;0.0333333333333333;0.466666666666667
Control.SRR15539829;41;45;0.48780487804878;21;20;0.0121951219512195;0.48780487804878
Control.SRR15539829;53;45;0.358490566037736;34;19;0.141509433962264;0.358490566037736
Control.SRR15539829;46;45;0.543478260869565;21;25;0.0434782608695652;0.456521739130435
Control.SRR15539829;52;45;0.461538461538462;28;24;0.0384615384615384;0.461538461538462
Control.SRR15539829;46;45;0.543478260869565;21;25;0.0434782608695652;0.456521739130435
Control.SRR15539829;54;45;0.555555555555556;24;30;0.0555555555555556;0.444444444444444
Control.SRR15539829;47;45;0.553191489361702;21;26;0.0531914893617021;0.446808510638298
Control.SRR15539829;49;45;0.63265306122449;18;31;0.13265306122449;0.36734693877551
Control.SRR15539829;44;45;0.5;22;22;0;0.5
Control.SRR15539829;44;45;0.545454545454545;20;24;0.0454545454545454;0.454545454545455
Control.SRR15539829;52;45;0.5;26;26;0;0.5
Control.SRR15539829;49;45;0.63265306122449;18;31;0.13265306122449;0.36734693877551
Control.SRR15539829;46;45;0.5;23;23;0;0.5
Control.SRR15539829;50;45;0.64;18;32;0.14;0.36
Control.SRR15539829;54;45;0.314814814814815;37;17;0.185185185185185;0.314814814814815
Control.SRR15539829;41;45;0.585365853658537;17;24;0.0853658536585366;0.414634146341463
Control.SRR15539829;48;45;0.395833333333333;29;19;0.104166666666667;0.395833333333333
Control.SRR15539829;47;45;0.553191489361702;21;26;0.0531914893617021;0.446808510638298
Control.SRR15539829;55;45;0.6;22;33;0.1;0.4
Control.SRR15539829;55;45;0.454545454545455;30;25;0.0454545454545455;0.454545454545455
Control.SRR15539829;51;45;0.568627450980392;22;29;0.0686274509803921;0.431372549019608
Control.SRR15539829;50;45;0.58;21;29;0.08;0.42
Control.SRR15539829;53;45;0.415094339622642;31;22;0.0849056603773585;0.415094339622642
Control.SRR15539829;50;45;0.48;26;24;0.02;0.48
Control.SRR15539829;45;45;0.488888888888889;23;22;0.0111111111111111;0.488888888888889
Control.SRR15539829;48;45;0.479166666666667;25;23;0.0208333333333333;0.479166666666667
Control.SRR15539829;48;45;0.354166666666667;31;17;0.145833333333333;0.354166666666667
Control.SRR15539829;48;45;0.5;24;24;0;0.5
Control.SRR15539829;47;45;0.553191489361702;21;26;0.0531914893617021;0.446808510638298
Control.SRR15539829;45;45;0.422222222222222;26;19;0.0777777777777778;0.422222222222222
Control.SRR15539829;53;45;0.471698113207547;28;25;0.0283018867924528;0.471698113207547
Control.SRR15539829;42;45;0.523809523809524;20;22;0.0238095238095238;0.476190476190476
Control.SRR15539829;54;45;0.481481481481481;28;26;0.0185185185185185;0.481481481481481
Control.SRR15539829;43;45;0.465116279069767;23;20;0.0348837209302326;0.465116279069767
Control.SRR15539829;45;45;0.511111111111111;22;23;0.0111111111111111;0.488888888888889
Control.SRR15539829;44;45;0.409090909090909;26;18;0.0909090909090909;0.409090909090909
Control.SRR15539829;50;45;0.52;24;26;0.02;0.48
Control.SRR15539829;47;45;0.446808510638298;26;21;0.0531914893617021;0.446808510638298
Control.SRR15539829;49;45;0.36734693877551;31;18;0.13265306122449;0.36734693877551
Control.SRR15539829;47;45;0.425531914893617;27;20;0.074468085106383;0.425531914893617
Control.SRR15539829;45;45;0.466666666666667;24;21;0.0333333333333333;0.466666666666667
Control.SRR15539829;48;45;0.5625;21;27;0.0625;0.4375
Control.SRR15539829;47;45;0.468085106382979;25;22;0.0319148936170213;0.468085106382979
Control.SRR15539829;45;45;0.577777777777778;19;26;0.0777777777777777;0.422222222222222
Control.SRR15539829;42;45;0.452380952380952;23;19;0.0476190476190476;0.452380952380952
Control.SRR15539829;48;45;0.5;24;24;0;0.5
Control.SRR15539829;45;45;0.6;18;27;0.1;0.4
Control.SRR15539829;55;45;0.472727272727273;29;26;0.0272727272727273;0.472727272727273
Control.SRR15539829;54;45;0.592592592592593;22;32;0.0925925925925926;0.407407407407407
Control.SRR15539829;49;45;0.530612244897959;23;26;0.0306122448979592;0.469387755102041
Control.SRR15539829;50;45;0.5;25;25;0;0.5
Control.SRR15539829;48;45;0.5625;21;27;0.0625;0.4375
Control.SRR15539829;49;45;0.489795918367347;25;24;0.0102040816326531;0.489795918367347
Control.SRR15539829;50;45;0.6;20;30;0.1;0.4
Control.SRR15539829;41;45;0.51219512195122;20;21;0.0121951219512195;0.48780487804878
Control.SRR15539829;55;45;0.509090909090909;27;28;0.00909090909090904;0.490909090909091
Control.SRR15539829;52;45;0.576923076923077;22;30;0.0769230769230769;0.423076923076923
Control.SRR15539829;47;45;0.425531914893617;27;20;0.074468085106383;0.425531914893617
Control.SRR15539829;43;45;0.372093023255814;27;16;0.127906976744186;0.372093023255814
Control.SRR15539829;50;45;0.36;32;18;0.14;0.36
Control.SRR15539829;44;45;0.340909090909091;29;15;0.159090909090909;0.340909090909091
Control.SRR15539829;47;45;0.382978723404255;29;18;0.117021276595745;0.382978723404255
Control.SRR15539829;52;45;0.461538461538462;28;24;0.0384615384615384;0.461538461538462
Control.SRR15539829;53;45;0.528301886792453;25;28;0.0283018867924528;0.471698113207547
Control.SRR15539829;50;45;0.6;20;30;0.1;0.4
Control.SRR15539829;43;45;0.441860465116279;24;19;0.0581395348837209;0.441860465116279
Control.SRR15539829;53;45;0.584905660377358;22;31;0.0849056603773585;0.415094339622642
Control.SRR15539829;46;45;0.565217391304348;20;26;0.0652173913043478;0.434782608695652
Control.SRR15539829;50;45;0.54;23;27;0.04;0.46
Control.SRR15539829;55;45;0.381818181818182;34;21;0.118181818181818;0.381818181818182
Control.SRR15539829;49;45;0.469387755102041;26;23;0.0306122448979592;0.469387755102041
Control.SRR15539829;44;45;0.522727272727273;21;23;0.0227272727272727;0.477272727272727
Control.SRR15539829;47;45;0.574468085106383;20;27;0.074468085106383;0.425531914893617
Control.SRR15539829;50;45;0.4;30;20;0.1;0.4
Control.SRR15539829;43;45;0.441860465116279;24;19;0.0581395348837209;0.441860465116279
Control.SRR15539829;49;45;0.469387755102041;26;23;0.0306122448979592;0.469387755102041
Control.SRR15539829;48;45;0.520833333333333;23;25;0.0208333333333334;0.479166666666667
Control.SRR15539829;47;45;0.425531914893617;27;20;0.074468085106383;0.425531914893617
Control.SRR15539829;53;45;0.490566037735849;27;26;0.00943396226415094;0.490566037735849
Control.SRR15539829;52;45;0.423076923076923;30;22;0.0769230769230769;0.423076923076923
Control.SRR15539829;50;45;0.44;28;22;0.06;0.44
Control.SRR15539829;52;45;0.480769230769231;27;25;0.0192307692307692;0.480769230769231
Control.SRR15539829;51;45;0.470588235294118;27;24;0.0294117647058824;0.470588235294118
Control.SRR15539829;50;45;0.54;23;27;0.04;0.46
Control.SRR15539829;50;45;0.56;22;28;0.0600000000000001;0.44
Control.SRR15539829;47;45;0.531914893617021;22;25;0.0319148936170213;0.468085106382979
Control.SRR15539829;49;45;0.489795918367347;25;24;0.0102040816326531;0.489795918367347
Control.SRR15539829;42;45;0.619047619047619;16;26;0.119047619047619;0.380952380952381
Control.SRR15539829;43;45;0.604651162790698;17;26;0.104651162790698;0.395348837209302
Control.SRR15539829;53;45;0.452830188679245;29;24;0.0471698113207547;0.452830188679245
Control.SRR15539829;47;45;0.595744680851064;19;28;0.0957446808510638;0.404255319148936
Control.SRR15539829;49;45;0.469387755102041;26;23;0.0306122448979592;0.469387755102041
Control.SRR15539829;48;45;0.5;24;24;0;0.5
Control.SRR15539829;50;45;0.34;33;17;0.16;0.34
Control.SRR15539829;44;45;0.431818181818182;25;19;0.0681818181818182;0.431818181818182
Control.SRR15539829;48;45;0.5;24;24;0;0.5
Control.SRR15539829;41;45;0.390243902439024;25;16;0.109756097560976;0.390243902439024
Control.SRR15539829;44;45;0.477272727272727;23;21;0.0227272727272727;0.477272727272727
Control.SRR15539829;54;45;0.555555555555556;24;30;0.0555555555555556;0.444444444444444
Control.SRR15539829;47;45;0.553191489361702;21;26;0.0531914893617021;0.446808510638298
Control.SRR15539829;46;45;0.5;23;23;0;0.5
Control.SRR15539829;46;45;0.434782608695652;26;20;0.0652173913043478;0.434782608695652
Control.SRR15539829;43;45;0.395348837209302;26;17;0.104651162790698;0.395348837209302
Control.SRR15539829;46;45;0.434782608695652;26;20;0.0652173913043478;0.434782608695652
Control.SRR15539829;48;45;0.458333333333333;26;22;0.0416666666666667;0.458333333333333
Control.SRR15539829;47;45;0.425531914893617;27;20;0.074468085106383;0.425531914893617
Control.SRR15539829;53;45;0.471698113207547;28;25;0.0283018867924528;0.471698113207547
Control.SRR15539829;42;45;0.357142857142857;27;15;0.142857142857143;0.357142857142857
Control.SRR15539829;43;45;0.488372093023256;22;21;0.0116279069767442;0.488372093023256
Control.SRR15539829;55;45;0.6;22;33;0.1;0.4
Control.SRR15539829;42;45;0.476190476190476;22;20;0.0238095238095238;0.476190476190476
Control.SRR15539829;43;45;0.465116279069767;23;20;0.0348837209302326;0.465116279069767
Control.SRR15539829;53;45;0.509433962264151;26;27;0.00943396226415094;0.490566037735849
Control.SRR15539829;41;45;0.463414634146341;22;19;0.0365853658536585;0.463414634146341
Control.SRR15539829;50;45;0.42;29;21;0.08;0.42
Control.SRR15539829;52;45;0.519230769230769;25;27;0.0192307692307693;0.480769230769231
Control.SRR15539829;53;45;0.490566037735849;27;26;0.00943396226415094;0.490566037735849
Control.SRR15539829;54;45;0.481481481481481;28;26;0.0185185185185185;0.481481481481481
Control.SRR15539829;55;45;0.527272727272727;26;29;0.0272727272727272;0.472727272727273
Control.SRR15539829;46;45;0.478260869565217;24;22;0.0217391304347826;0.478260869565217
Control.SRR15539829;45;45;0.533333333333333;21;24;0.0333333333333333;0.466666666666667
Control.SRR15539829;46;45;0.391304347826087;28;18;0.108695652173913;0.391304347826087
Control.SRR15539829;48;45;0.520833333333333;23;25;0.0208333333333334;0.479166666666667
Control.SRR15539829;49;45;0.489795918367347;25;24;0.0102040816326531;0.489795918367347
Control.SRR15539829;45;45;0.644444444444444;16;29;0.144444444444444;0.355555555555556
Control.SRR15539829;46;45;0.5;23;23;0;0.5
Control.SRR15539829;43;45;0.488372093023256;22;21;0.0116279069767442;0.488372093023256
Control.SRR15539829;43;45;0.488372093023256;22;21;0.0116279069767442;0.488372093023256
Control.SRR15539829;46;45;0.521739130434783;22;24;0.0217391304347826;0.478260869565217
Control.SRR15539829;49;45;0.551020408163265;22;27;0.0510204081632653;0.448979591836735
Control.SRR15539829;46;45;0.456521739130435;25;21;0.0434782608695652;0.456521739130435
Control.SRR15539829;45;45;0.488888888888889;23;22;0.0111111111111111;0.488888888888889
Control.SRR15539829;42;45;0.476190476190476;22;20;0.0238095238095238;0.476190476190476
Control.SRR15539829;51;45;0.411764705882353;30;21;0.0882352941176471;0.411764705882353
Control.SRR15539829;42;45;0.547619047619048;19;23;0.0476190476190477;0.452380952380952
Control.SRR15539829;43;45;0.558139534883721;19;24;0.0581395348837209;0.441860465116279
Control.SRR15539829;48;45;0.645833333333333;17;31;0.145833333333333;0.354166666666667
Control.SRR15539829;52;45;0.461538461538462;28;24;0.0384615384615384;0.461538461538462
Control.SRR15539829;46;45;0.565217391304348;20;26;0.0652173913043478;0.434782608695652
Control.SRR15539829;48;45;0.625;18;30;0.125;0.375
Control.SRR15539829;49;45;0.530612244897959;23;26;0.0306122448979592;0.469387755102041
Control.SRR15539829;49;45;0.448979591836735;27;22;0.0510204081632653;0.448979591836735
Control.SRR15539829;47;45;0.531914893617021;22;25;0.0319148936170213;0.468085106382979
Control.SRR15539829;48;45;0.520833333333333;23;25;0.0208333333333334;0.479166666666667
Control.SRR15539829;50;45;0.62;19;31;0.12;0.38
Control.SRR15539829;42;45;0.404761904761905;25;17;0.0952380952380952;0.404761904761905
Control.SRR15539829;52;45;0.346153846153846;34;18;0.153846153846154;0.346153846153846
Control.SRR15539829;50;45;0.48;26;24;0.02;0.48
Control.SRR15539829;50;45;0.48;26;24;0.02;0.48
Control.SRR15539829;55;45;0.472727272727273;29;26;0.0272727272727273;0.472727272727273
Control.SRR15539829;46;45;0.565217391304348;20;26;0.0652173913043478;0.434782608695652
Control.SRR15539829;46;45;0.5;23;23;0;0.5
Control.SRR15539829;50;45;0.54;23;27;0.04;0.46
Control.SRR15539829;48;45;0.479166666666667;25;23;0.0208333333333333;0.479166666666667
Control.SRR15539829;41;45;0.536585365853659;19;22;0.0365853658536586;0.463414634146341
Control.SRR15539829;45;45;0.444444444444444;25;20;0.0555555555555556;0.444444444444444
Control.SRR15539829;50;45;0.4;30;20;0.1;0.4
Control.SRR15539829;52;45;0.384615384615385;32;20;0.115384615384615;0.384615384615385
Control.SRR15539829;41;45;0.585365853658537;17;24;0.0853658536585366;0.414634146341463
Control.SRR15539829;42;45;0.619047619047619;16;26;0.119047619047619;0.380952380952381
Control.SRR15539829;51;45;0.568627450980392;22;29;0.0686274509803921;0.431372549019608
Control.SRR15539829;46;45;0.565217391304348;20;26;0.0652173913043478;0.434782608695652
Control.SRR15539829;53;45;0.547169811320755;24;29;0.0471698113207547;0.452830188679245
Control.SRR15539829;43;45;0.558139534883721;19;24;0.0581395348837209;0.441860465116279
Control.SRR15539829;53;45;0.490566037735849;27;26;0.00943396226415094;0.490566037735849
Control.SRR15539829;53;45;0.528301886792453;25;28;0.0283018867924528;0.471698113207547
Control.SRR15539829;53;45;0.452830188679245;29;24;0.0471698113207547;0.452830188679245
Control.SRR15539829;45;45;0.555555555555556;20;25;0.0555555555555556;0.444444444444444
Control.SRR15539829;55;45;0.472727272727273;29;26;0.0272727272727273;0.472727272727273
Control.SRR15539829;52;45;0.596153846153846;21;31;0.0961538461538461;0.403846153846154
Control.SRR15539829;47;45;0.446808510638298;26;21;0.0531914893617021;0.446808510638298
Control.SRR15539829;48;45;0.416666666666667;28;20;0.0833333333333333;0.416666666666667
Control.SRR15539829;48;45;0.5;24;24;0;0.5
Control.SRR15539829;55;45;0.472727272727273;29;26;0.0272727272727273;0.472727272727273
Control.SRR15539829;46;45;0.543478260869565;21;25;0.0434782608695652;0.456521739130435
Control.SRR15539829;45;45;0.511111111111111;22;23;0.0111111111111111;0.488888888888889
Control.SRR15539829;51;45;0.411764705882353;30;21;0.0882352941176471;0.411764705882353
Control.SRR15539829;50;45;0.46;27;23;0.04;0.46
Control.SRR15539829;47;45;0.51063829787234;23;24;0.0106382978723404;0.48936170212766
Control.SRR15539829;53;45;0.433962264150943;30;23;0.0660377358490566;0.433962264150943
Control.SRR15539829;46;45;0.391304347826087;28;18;0.108695652173913;0.391304347826087
Control.SRR15539829;42;45;0.595238095238095;17;25;0.0952380952380952;0.404761904761905
Control.SRR15539829;46;45;0.478260869565217;24;22;0.0217391304347826;0.478260869565217
Control.SRR15539829;48;45;0.5;24;24;0;0.5
Control.SRR15539829;53;45;0.528301886792453;25;28;0.0283018867924528;0.471698113207547
Control.SRR15539829;47;45;0.382978723404255;29;18;0.117021276595745;0.382978723404255
Control.SRR15539829;49;45;0.551020408163265;22;27;0.0510204081632653;0.448979591836735
Control.SRR15539829;55;45;0.509090909090909;27;28;0.00909090909090904;0.490909090909091
Control.SRR15539829;52;45;0.442307692307692;29;23;0.0576923076923077;0.442307692307692
Control.SRR15539829;52;45;0.615384615384615;20;32;0.115384615384615;0.384615384615385
Control.SRR15539829;51;45;0.509803921568627;25;26;0.00980392156862742;0.490196078431373
Control.SRR15539829;48;45;0.416666666666667;28;20;0.0833333333333333;0.416666666666667
Control.SRR15539829;51;45;0.490196078431373;26;25;0.00980392156862747;0.490196078431373
Control.SRR15539829;42;45;0.547619047619048;19;23;0.0476190476190477;0.452380952380952
Control.SRR15539829;47;45;0.553191489361702;21;26;0.0531914893617021;0.446808510638298
Control.SRR15539829;42;45;0.642857142857143;15;27;0.142857142857143;0.357142857142857
Control.SRR15539829;46;45;0.565217391304348;20;26;0.0652173913043478;0.434782608695652
Control.SRR15539829;48;45;0.395833333333333;29;19;0.104166666666667;0.395833333333333
Control.SRR15539829;41;45;0.51219512195122;20;21;0.0121951219512195;0.48780487804878
Control.SRR15539829;54;45;0.574074074074074;23;31;0.0740740740740741;0.425925925925926
Control.SRR15539829;51;45;0.509803921568627;25;26;0.00980392156862742;0.490196078431373
Control.SRR15539829;53;45;0.39622641509434;32;21;0.10377358490566;0.39622641509434
Control.SRR15539829;46;45;0.478260869565217;24;22;0.0217391304347826;0.478260869565217
Control.SRR15539829;42;45;0.595238095238095;17;25;0.0952380952380952;0.404761904761905
Control.SRR15539829;49;45;0.469387755102041;26;23;0.0306122448979592;0.469387755102041
Control.SRR15539829;47;45;0.446808510638298;26;21;0.0531914893617021;0.446808510638298
Control.SRR15539829;44;45;0.590909090909091;18;26;0.0909090909090909;0.409090909090909
Control.SRR15539829;53;45;0.377358490566038;33;20;0.122641509433962;0.377358490566038
Control.SRR15539829;49;45;0.612244897959184;19;30;0.112244897959184;0.387755102040816
Control.SRR15539829;51;45;0.490196078431373;26;25;0.00980392156862747;0.490196078431373
Control.SRR15539829;48;45;0.395833333333333;29;19;0.104166666666667;0.395833333333333
Control.SRR15539829;43;45;0.325581395348837;29;14;0.174418604651163;0.325581395348837
Control.SRR15539829;55;45;0.345454545454545;36;19;0.154545454545455;0.345454545454545
Control.SRR15539829;47;45;0.531914893617021;22;25;0.0319148936170213;0.468085106382979
Control.SRR15539829;47;45;0.468085106382979;25;22;0.0319148936170213;0.468085106382979
Control.SRR15539829;42;45;0.476190476190476;22;20;0.0238095238095238;0.476190476190476
Control.SRR15539829;49;45;0.428571428571429;28;21;0.0714285714285715;0.428571428571429
Control.SRR15539829;42;45;0.523809523809524;20;22;0.0238095238095238;0.476190476190476
Control.SRR15539829;52;45;0.480769230769231;27;25;0.0192307692307692;0.480769230769231
Control.SRR15539829;44;45;0.454545454545455;24;20;0.0454545454545455;0.454545454545455
Control.SRR15539829;47;45;0.468085106382979;25;22;0.0319148936170213;0.468085106382979
Control.SRR15539829;46;45;0.543478260869565;21;25;0.0434782608695652;0.456521739130435
Control.SRR15539829;52;45;0.557692307692308;23;29;0.0576923076923077;0.442307692307692
Control.SRR15539829;44;45;0.454545454545455;24;20;0.0454545454545455;0.454545454545455
Control.SRR15539829;44;45;0.545454545454545;20;24;0.0454545454545454;0.454545454545455
Control.SRR15539829;50;45;0.52;24;26;0.02;0.48
Control.SRR15539829;43;45;0.418604651162791;25;18;0.0813953488372093;0.418604651162791
Control.SRR15539829;44;45;0.545454545454545;20;24;0.0454545454545454;0.454545454545455
Control.SRR15539829;47;45;0.48936170212766;24;23;0.0106382978723404;0.48936170212766
Control.SRR15539829;41;45;0.463414634146341;22;19;0.0365853658536585;0.463414634146341
Control.SRR15539829;44;45;0.477272727272727;23;21;0.0227272727272727;0.477272727272727
Control.SRR15539829;41;45;0.414634146341463;24;17;0.0853658536585366;0.414634146341463
Control.SRR15539829;55;45;0.436363636363636;31;24;0.0636363636363637;0.436363636363636
Control.SRR15539829;44;45;0.454545454545455;24;20;0.0454545454545455;0.454545454545455
Control.SRR15539829;42;45;0.595238095238095;17;25;0.0952380952380952;0.404761904761905
Control.SRR15539829;49;45;0.469387755102041;26;23;0.0306122448979592;0.469387755102041
Control.SRR15539829;45;45;0.444444444444444;25;20;0.0555555555555556;0.444444444444444
Control.SRR15539829;51;45;0.431372549019608;29;22;0.0686274509803921;0.431372549019608
Control.SRR15539829;52;45;0.615384615384615;20;32;0.115384615384615;0.384615384615385
Control.SRR15539829;42;45;0.428571428571429;24;18;0.0714285714285715;0.428571428571429
Control.SRR15539829;48;45;0.520833333333333;23;25;0.0208333333333334;0.479166666666667
Control.SRR15539829;44;45;0.545454545454545;20;24;0.0454545454545454;0.454545454545455
Control.SRR15539829;48;45;0.5625;21;27;0.0625;0.4375
Control.SRR15539829;45;45;0.422222222222222;26;19;0.0777777777777778;0.422222222222222
Control.SRR15539829;48;45;0.5625;21;27;0.0625;0.4375
Control.SRR15539829;45;45;0.422222222222222;26;19;0.0777777777777778;0.422222222222222
Control.SRR15539829;52;45;0.5;26;26;0;0.5
Control.SRR15539829;51;45;0.490196078431373;26;25;0.00980392156862747;0.490196078431373
Control.SRR15539829;52;45;0.461538461538462;28;24;0.0384615384615384;0.461538461538462
Control.SRR15539829;45;45;0.422222222222222;26;19;0.0777777777777778;0.422222222222222
Control.SRR15539829;40;45;0.525;19;21;0.025;0.475
Control.SRR15539829;51;45;0.490196078431373;26;25;0.00980392156862747;0.490196078431373
Control.SRR15539829;51;45;0.372549019607843;32;19;0.127450980392157;0.372549019607843
Control.SRR15539829;42;45;0.69047619047619;13;29;0.19047619047619;0.30952380952381
Control.SRR15539829;40;45;0.55;18;22;0.05;0.45
Control.SRR15539829;48;45;0.520833333333333;23;25;0.0208333333333334;0.479166666666667
Control.SRR15539829;45;45;0.422222222222222;26;19;0.0777777777777778;0.422222222222222
Control.SRR15539829;48;45;0.416666666666667;28;20;0.0833333333333333;0.416666666666667
Control.SRR15539829;44;45;0.522727272727273;21;23;0.0227272727272727;0.477272727272727
Control.SRR15539829;40;45;0.55;18;22;0.05;0.45
Control.SRR15539829;49;45;0.428571428571429;28;21;0.0714285714285715;0.428571428571429
Control.SRR15539829;43;45;0.720930232558139;12;31;0.220930232558139;0.27906976744186
Control.SRR15539829;41;45;0.560975609756098;18;23;0.0609756097560976;0.439024390243902
Control.SRR15539829;40;45;0.575;17;23;0.075;0.425
Control.SRR15539829;48;45;0.458333333333333;26;22;0.0416666666666667;0.458333333333333
Control.SRR15539829;51;45;0.470588235294118;27;24;0.0294117647058824;0.470588235294118
Control.SRR15539829;49;45;0.530612244897959;23;26;0.0306122448979592;0.469387755102041
Control.SRR15539829;45;45;0.422222222222222;26;19;0.0777777777777778;0.422222222222222
Control.SRR15539829;47;45;0.531914893617021;22;25;0.0319148936170213;0.468085106382979
Control.SRR15539829;40;45;0.625;15;25;0.125;0.375
Control.SRR15539829;42;45;0.333333333333333;28;14;0.166666666666667;0.333333333333333
Control.SRR15539829;48;45;0.520833333333333;23;25;0.0208333333333334;0.479166666666667
Control.SRR15539829;41;45;0.536585365853659;19;22;0.0365853658536586;0.463414634146341
Control.SRR15539829;47;45;0.48936170212766;24;23;0.0106382978723404;0.48936170212766
Control.SRR15539829;51;45;0.549019607843137;23;28;0.0490196078431373;0.450980392156863
Control.SRR15539829;45;45;0.4;27;18;0.1;0.4
Control.SRR15539829;50;45;0.4;30;20;0.1;0.4
Control.SRR15539829;50;45;0.36;32;18;0.14;0.36
Control.SRR15539829;43;45;0.534883720930233;20;23;0.0348837209302325;0.465116279069767
Control.SRR15539829;50;45;0.48;26;24;0.02;0.48
Control.SRR15539829;48;45;0.520833333333333;23;25;0.0208333333333334;0.479166666666667
Control.SRR15539829;42;45;0.547619047619048;19;23;0.0476190476190477;0.452380952380952
Control.SRR15539829;47;45;0.468085106382979;25;22;0.0319148936170213;0.468085106382979
Control.SRR15539829;46;45;0.369565217391304;29;17;0.130434782608696;0.369565217391304
Control.SRR15539829;45;45;0.533333333333333;21;24;0.0333333333333333;0.466666666666667
Control.SRR15539829;48;45;0.5;24;24;0;0.5
Control.SRR15539829;49;45;0.591836734693878;20;29;0.0918367346938775;0.408163265306122
Control.SRR15539829;42;45;0.404761904761905;25;17;0.0952380952380952;0.404761904761905
Control.SRR15539829;49;45;0.469387755102041;26;23;0.0306122448979592;0.469387755102041
Control.SRR15539829;52;45;0.5;26;26;0;0.5
Control.SRR15539829;42;45;0.619047619047619;16;26;0.119047619047619;0.380952380952381
Control.SRR15539829;51;45;0.529411764705882;24;27;0.0294117647058824;0.470588235294118
Control.SRR15539829;45;45;0.644444444444444;16;29;0.144444444444444;0.355555555555556
Control.SRR15539829;43;45;0.534883720930233;20;23;0.0348837209302325;0.465116279069767
Control.SRR15539829;41;45;0.463414634146341;22;19;0.0365853658536585;0.463414634146341
Control.SRR15539829;45;45;0.6;18;27;0.1;0.4
Control.SRR15539829;42;45;0.404761904761905;25;17;0.0952380952380952;0.404761904761905
Control.SRR15539829;50;45;0.48;26;24;0.02;0.48
Control.SRR15539829;46;45;0.478260869565217;24;22;0.0217391304347826;0.478260869565217
Control.SRR15539829;44;45;0.522727272727273;21;23;0.0227272727272727;0.477272727272727
Control.SRR15539829;49;45;0.469387755102041;26;23;0.0306122448979592;0.469387755102041
Control.SRR15539829;41;45;0.536585365853659;19;22;0.0365853658536586;0.463414634146341
Control.SRR15539829;51;45;0.529411764705882;24;27;0.0294117647058824;0.470588235294118
Control.SRR15539829;49;45;0.469387755102041;26;23;0.0306122448979592;0.469387755102041
Control.SRR15539829;49;45;0.469387755102041;26;23;0.0306122448979592;0.469387755102041
Control.SRR15539829;42;45;0.642857142857143;15;27;0.142857142857143;0.357142857142857
Control.SRR15539829;52;45;0.403846153846154;31;21;0.0961538461538461;0.403846153846154
Control.SRR15539829;46;45;0.5;23;23;0;0.5
Control.SRR15539829;50;45;0.48;26;24;0.02;0.48
Control.SRR15539829;52;45;0.442307692307692;29;23;0.0576923076923077;0.442307692307692
Control.SRR15539829;45;45;0.533333333333333;21;24;0.0333333333333333;0.466666666666667
Control.SRR15539829;44;45;0.522727272727273;21;23;0.0227272727272727;0.477272727272727
Control.SRR15539829;49;45;0.489795918367347;25;24;0.0102040816326531;0.489795918367347
Control.SRR15539829;41;45;0.48780487804878;21;20;0.0121951219512195;0.48780487804878
Control.SRR15539829;47;45;0.574468085106383;20;27;0.074468085106383;0.425531914893617
Control.SRR15539829;50;45;0.44;28;22;0.06;0.44
Control.SRR15539829;43;45;0.441860465116279;24;19;0.0581395348837209;0.441860465116279
Control.SRR15539829;48;45;0.541666666666667;22;26;0.0416666666666666;0.458333333333333
Control.SRR15539829;47;45;0.531914893617021;22;25;0.0319148936170213;0.468085106382979
Control.SRR15539829;51;45;0.568627450980392;22;29;0.0686274509803921;0.431372549019608
Control.SRR15539829;41;45;0.536585365853659;19;22;0.0365853658536586;0.463414634146341
Control.SRR15539829;46;45;0.478260869565217;24;22;0.0217391304347826;0.478260869565217
Control.SRR15539829;40;45;0.625;15;25;0.125;0.375
Control.SRR15539829;47;45;0.51063829787234;23;24;0.0106382978723404;0.48936170212766
Control.SRR15539829;45;45;0.488888888888889;23;22;0.0111111111111111;0.488888888888889
Control.SRR15539829;44;45;0.5;22;22;0;0.5
Control.SRR15539829;41;45;0.390243902439024;25;16;0.109756097560976;0.390243902439024
Control.SRR15539829;44;45;0.386363636363636;27;17;0.113636363636364;0.386363636363636
Control.SRR15539829;48;45;0.375;30;18;0.125;0.375
Control.SRR15539829;45;45;0.6;18;27;0.1;0.4
Control.SRR15539829;52;45;0.480769230769231;27;25;0.0192307692307692;0.480769230769231
Control.SRR15539829;47;45;0.553191489361702;21;26;0.0531914893617021;0.446808510638298
Control.SRR15539829;47;45;0.531914893617021;22;25;0.0319148936170213;0.468085106382979
Control.SRR15539829;50;45;0.42;29;21;0.08;0.42
Control.SRR15539829;45;45;0.577777777777778;19;26;0.0777777777777777;0.422222222222222
Control.SRR15539829;48;45;0.458333333333333;26;22;0.0416666666666667;0.458333333333333
Control.SRR15539829;43;45;0.581395348837209;18;25;0.0813953488372093;0.418604651162791
Control.SRR15539829;50;45;0.46;27;23;0.04;0.46
Control.SRR15539829;49;45;0.469387755102041;26;23;0.0306122448979592;0.469387755102041
Control.SRR15539829;45;45;0.577777777777778;19;26;0.0777777777777777;0.422222222222222
Control.SRR15539829;48;45;0.5625;21;27;0.0625;0.4375
Control.SRR15539829;44;45;0.409090909090909;26;18;0.0909090909090909;0.409090909090909
Control.SRR15539829;50;45;0.46;27;23;0.04;0.46
Control.SRR15539829;46;45;0.434782608695652;26;20;0.0652173913043478;0.434782608695652
Control.SRR15539829;44;45;0.522727272727273;21;23;0.0227272727272727;0.477272727272727
Control.SRR15539829;43;45;0.441860465116279;24;19;0.0581395348837209;0.441860465116279
Control.SRR15539829;48;45;0.541666666666667;22;26;0.0416666666666666;0.458333333333333
Control.SRR15539829;43;45;0.441860465116279;24;19;0.0581395348837209;0.441860465116279
Control.SRR15539829;45;45;0.488888888888889;23;22;0.0111111111111111;0.488888888888889
Control.SRR15539829;52;45;0.480769230769231;27;25;0.0192307692307692;0.480769230769231
Control.SRR15539829;40;45;0.525;19;21;0.025;0.475
Control.SRR15539829;46;45;0.434782608695652;26;20;0.0652173913043478;0.434782608695652
Control.SRR15539829;46;45;0.456521739130435;25;21;0.0434782608695652;0.456521739130435
Control.SRR15539829;47;45;0.553191489361702;21;26;0.0531914893617021;0.446808510638298
Control.SRR15539829;49;45;0.469387755102041;26;23;0.0306122448979592;0.469387755102041
Control.SRR15539829;52;45;0.5;26;26;0;0.5
Control.SRR15539829;50;45;0.52;24;26;0.02;0.48
Control.SRR15539829;49;45;0.571428571428571;21;28;0.0714285714285714;0.428571428571429
Control.SRR15539829;45;45;0.555555555555556;20;25;0.0555555555555556;0.444444444444444
Control.SRR15539829;44;45;0.5;22;22;0;0.5
Control.SRR15539829;49;45;0.530612244897959;23;26;0.0306122448979592;0.469387755102041
Control.SRR15539829;48;45;0.479166666666667;25;23;0.0208333333333333;0.479166666666667
Control.SRR15539829;49;45;0.448979591836735;27;22;0.0510204081632653;0.448979591836735
Control.SRR15539829;45;45;0.577777777777778;19;26;0.0777777777777777;0.422222222222222
Control.SRR15539829;49;45;0.510204081632653;24;25;0.0102040816326531;0.489795918367347
Control.SRR15539829;43;45;0.511627906976744;21;22;0.0116279069767442;0.488372093023256
Control.SRR15539829;41;45;0.609756097560976;16;25;0.109756097560976;0.390243902439024
Control.SRR15539829;49;45;0.510204081632653;24;25;0.0102040816326531;0.489795918367347
Control.SRR15539829;48;45;0.416666666666667;28;20;0.0833333333333333;0.416666666666667
Control.SRR15539829;45;45;0.466666666666667;24;21;0.0333333333333333;0.466666666666667
Control.SRR15539829;43;45;0.488372093023256;22;21;0.0116279069767442;0.488372093023256
Control.SRR15539829;47;45;0.659574468085106;16;31;0.159574468085106;0.340425531914894
Control.SRR15539829;50;45;0.52;24;26;0.02;0.48
Control.SRR15539829;50;45;0.4;30;20;0.1;0.4
Control.SRR15539829;42;45;0.547619047619048;19;23;0.0476190476190477;0.452380952380952
Control.SRR15539829;47;45;0.531914893617021;22;25;0.0319148936170213;0.468085106382979
Control.SRR15539829;41;45;0.439024390243902;23;18;0.0609756097560976;0.439024390243902
Control.SRR15539829;46;45;0.41304347826087;27;19;0.0869565217391304;0.41304347826087
Control.SRR15539829;48;45;0.4375;27;21;0.0625;0.4375
Control.SRR15539829;48;45;0.520833333333333;23;25;0.0208333333333334;0.479166666666667
Control.SRR15539829;40;45;0.45;22;18;0.05;0.45
Control.SRR15539829;52;45;0.596153846153846;21;31;0.0961538461538461;0.403846153846154
Control.SRR15539829;42;45;0.5;21;21;0;0.5
Control.SRR15539829;43;45;0.534883720930233;20;23;0.0348837209302325;0.465116279069767
Control.SRR15539829;44;45;0.386363636363636;27;17;0.113636363636364;0.386363636363636
Control.SRR15539829;45;45;0.511111111111111;22;23;0.0111111111111111;0.488888888888889
Control.SRR15539829;48;45;0.541666666666667;22;26;0.0416666666666666;0.458333333333333
Control.SRR15539829;52;45;0.5;26;26;0;0.5
Control.SRR15539829;49;45;0.448979591836735;27;22;0.0510204081632653;0.448979591836735
Control.SRR15539829;51;45;0.490196078431373;26;25;0.00980392156862747;0.490196078431373
Control.SRR15539829;51;45;0.490196078431373;26;25;0.00980392156862747;0.490196078431373
Control.SRR15539829;41;45;0.51219512195122;20;21;0.0121951219512195;0.48780487804878
Control.SRR15539829;49;45;0.510204081632653;24;25;0.0102040816326531;0.489795918367347
Control.SRR15539829;43;45;0.534883720930233;20;23;0.0348837209302325;0.465116279069767
Control.SRR15539829;46;45;0.608695652173913;18;28;0.108695652173913;0.391304347826087
Control.SRR15539829;45;45;0.377777777777778;28;17;0.122222222222222;0.377777777777778
Control.SRR15539829;51;45;0.627450980392157;19;32;0.127450980392157;0.372549019607843
Control.SRR15539829;41;45;0.463414634146341;22;19;0.0365853658536585;0.463414634146341
Control.SRR15539829;49;45;0.510204081632653;24;25;0.0102040816326531;0.489795918367347
Control.SRR15539829;48;45;0.4375;27;21;0.0625;0.4375
Control.SRR15539829;45;45;0.466666666666667;24;21;0.0333333333333333;0.466666666666667
Control.SRR15539829;50;45;0.68;16;34;0.18;0.32
Control.SRR15539829;49;45;0.428571428571429;28;21;0.0714285714285715;0.428571428571429
Control.SRR15539829;47;45;0.553191489361702;21;26;0.0531914893617021;0.446808510638298
Control.SRR15539829;47;45;0.48936170212766;24;23;0.0106382978723404;0.48936170212766
Control.SRR15539829;46;45;0.521739130434783;22;24;0.0217391304347826;0.478260869565217
Control.SRR15539829;47;45;0.468085106382979;25;22;0.0319148936170213;0.468085106382979
Control.SRR15539829;50;45;0.58;21;29;0.08;0.42
Control.SRR15539829;49;45;0.571428571428571;21;28;0.0714285714285714;0.428571428571429
Control.SRR15539829;50;45;0.54;23;27;0.04;0.46
Control.SRR15539829;50;45;0.42;29;21;0.08;0.42
Control.SRR15539829;52;45;0.538461538461538;24;28;0.0384615384615384;0.461538461538462
Control.SRR15539829;50;45;0.46;27;23;0.04;0.46
Control.SRR15539829;46;45;0.58695652173913;19;27;0.0869565217391305;0.41304347826087
Control.SRR15539829;40;45;0.425;23;17;0.075;0.425
Control.SRR15539829;41;45;0.390243902439024;25;16;0.109756097560976;0.390243902439024
Control.SRR15539829;52;45;0.480769230769231;27;25;0.0192307692307692;0.480769230769231
Control.SRR15539829;52;45;0.461538461538462;28;24;0.0384615384615384;0.461538461538462
Control.SRR15539829;45;45;0.555555555555556;20;25;0.0555555555555556;0.444444444444444
Control.SRR15539829;48;45;0.645833333333333;17;31;0.145833333333333;0.354166666666667
Control.SRR15539829;43;45;0.441860465116279;24;19;0.0581395348837209;0.441860465116279
Control.SRR15539829;51;45;0.490196078431373;26;25;0.00980392156862747;0.490196078431373
Control.SRR15539829;45;45;0.466666666666667;24;21;0.0333333333333333;0.466666666666667
Control.SRR15539829;41;45;0.560975609756098;18;23;0.0609756097560976;0.439024390243902
Control.SRR15539829;43;45;0.604651162790698;17;26;0.104651162790698;0.395348837209302
Control.SRR15539829;45;45;0.488888888888889;23;22;0.0111111111111111;0.488888888888889
Control.SRR15539829;40;45;0.625;15;25;0.125;0.375
Control.SRR15539829;43;45;0.651162790697674;15;28;0.151162790697674;0.348837209302326
Control.SRR15539829;44;45;0.522727272727273;21;23;0.0227272727272727;0.477272727272727
Control.SRR15539829;48;45;0.583333333333333;20;28;0.0833333333333334;0.416666666666667
Control.SRR15539829;43;45;0.465116279069767;23;20;0.0348837209302326;0.465116279069767
Control.SRR15539829;48;45;0.458333333333333;26;22;0.0416666666666667;0.458333333333333
Control.SRR15539829;44;45;0.363636363636364;28;16;0.136363636363636;0.363636363636364
Control.SRR15539829;48;45;0.479166666666667;25;23;0.0208333333333333;0.479166666666667
Control.SRR15539829;47;45;0.51063829787234;23;24;0.0106382978723404;0.48936170212766
Control.SRR15539829;48;45;0.5625;21;27;0.0625;0.4375
Control.SRR15539829;43;45;0.651162790697674;15;28;0.151162790697674;0.348837209302326
Control.SRR15539829;44;45;0.568181818181818;19;25;0.0681818181818182;0.431818181818182
Control.SRR15539829;43;45;0.395348837209302;26;17;0.104651162790698;0.395348837209302
Control.SRR15539829;48;45;0.4375;27;21;0.0625;0.4375
Control.SRR15539829;48;45;0.583333333333333;20;28;0.0833333333333334;0.416666666666667
Control.SRR15539829;42;45;0.452380952380952;23;19;0.0476190476190476;0.452380952380952
Control.SRR15539829;51;45;0.490196078431373;26;25;0.00980392156862747;0.490196078431373
Control.SRR15539829;42;45;0.428571428571429;24;18;0.0714285714285715;0.428571428571429
Control.SRR15539829;41;45;0.560975609756098;18;23;0.0609756097560976;0.439024390243902
Control.SRR15539829;46;45;0.478260869565217;24;22;0.0217391304347826;0.478260869565217
Control.SRR15539829;47;45;0.446808510638298;26;21;0.0531914893617021;0.446808510638298
Control.SRR15539829;48;45;0.458333333333333;26;22;0.0416666666666667;0.458333333333333
Control.SRR15539829;50;45;0.48;26;24;0.02;0.48
Control.SRR15539829;50;45;0.48;26;24;0.02;0.48
Control.SRR15539829;49;45;0.551020408163265;22;27;0.0510204081632653;0.448979591836735
Control.SRR15539829;40;45;0.625;15;25;0.125;0.375
Control.SRR15539829;49;45;0.489795918367347;25;24;0.0102040816326531;0.489795918367347
Control.SRR15539829;44;45;0.5;22;22;0;0.5
Control.SRR15539829;42;45;0.404761904761905;25;17;0.0952380952380952;0.404761904761905
Control.SRR15539829;41;45;0.463414634146341;22;19;0.0365853658536585;0.463414634146341
Control.SRR15539829;49;45;0.612244897959184;19;30;0.112244897959184;0.387755102040816
Control.SRR15539829;47;45;0.723404255319149;13;34;0.223404255319149;0.276595744680851
Control.SRR15539829;48;45;0.5625;21;27;0.0625;0.4375
Control.SRR15539829;47;45;0.404255319148936;28;19;0.0957446808510639;0.404255319148936
Control.SRR15539829;43;45;0.534883720930233;20;23;0.0348837209302325;0.465116279069767
Control.SRR15539829;45;45;0.6;18;27;0.1;0.4
Control.SRR15539829;47;45;0.553191489361702;21;26;0.0531914893617021;0.446808510638298
Control.SRR15539829;41;45;0.439024390243902;23;18;0.0609756097560976;0.439024390243902
Control.SRR15539829;51;45;0.470588235294118;27;24;0.0294117647058824;0.470588235294118
Control.SRR15539829;41;45;0.51219512195122;20;21;0.0121951219512195;0.48780487804878
Control.SRR15539829;49;45;0.551020408163265;22;27;0.0510204081632653;0.448979591836735
Control.SRR15539829;50;45;0.42;29;21;0.08;0.42
Control.SRR15539829;49;45;0.551020408163265;22;27;0.0510204081632653;0.448979591836735
Control.SRR15539829;47;45;0.468085106382979;25;22;0.0319148936170213;0.468085106382979
Control.SRR15539829;46;45;0.521739130434783;22;24;0.0217391304347826;0.478260869565217
Control.SRR15539829;51;45;0.607843137254902;20;31;0.107843137254902;0.392156862745098
Control.SRR15539829;52;45;0.403846153846154;31;21;0.0961538461538461;0.403846153846154
Control.SRR15539829;40;45;0.45;22;18;0.05;0.45
Control.SRR15539829;44;45;0.522727272727273;21;23;0.0227272727272727;0.477272727272727
Control.SRR15539829;44;45;0.454545454545455;24;20;0.0454545454545455;0.454545454545455
Control.SRR15539829;40;45;0.3;28;12;0.2;0.3
Control.SRR15539829;52;45;0.673076923076923;17;35;0.173076923076923;0.326923076923077
Control.SRR15539829;44;45;0.522727272727273;21;23;0.0227272727272727;0.477272727272727
Control.SRR15539829;46;45;0.5;23;23;0;0.5
Control.SRR15539829;51;45;0.549019607843137;23;28;0.0490196078431373;0.450980392156863
Control.SRR15539829;48;45;0.4375;27;21;0.0625;0.4375
Control.SRR15539829;42;45;0.571428571428571;18;24;0.0714285714285714;0.428571428571429
Control.SRR15539829;40;45;0.5;20;20;0;0.5
Control.SRR15539829;48;45;0.541666666666667;22;26;0.0416666666666666;0.458333333333333
Control.SRR15539829;52;45;0.442307692307692;29;23;0.0576923076923077;0.442307692307692
Control.SRR15539829;47;45;0.574468085106383;20;27;0.074468085106383;0.425531914893617
Control.SRR15539829;43;45;0.511627906976744;21;22;0.0116279069767442;0.488372093023256
Control.SRR15539829;45;45;0.466666666666667;24;21;0.0333333333333333;0.466666666666667
Control.SRR15539829;46;45;0.5;23;23;0;0.5
Control.SRR15539829;43;45;0.441860465116279;24;19;0.0581395348837209;0.441860465116279
Control.SRR15539829;47;45;0.595744680851064;19;28;0.0957446808510638;0.404255319148936
Control.SRR15539829;44;45;0.431818181818182;25;19;0.0681818181818182;0.431818181818182
Control.SRR15539829;51;45;0.529411764705882;24;27;0.0294117647058824;0.470588235294118
Control.SRR15539829;46;45;0.434782608695652;26;20;0.0652173913043478;0.434782608695652
Control.SRR15539829;46;45;0.695652173913043;14;32;0.195652173913043;0.304347826086957
Control.SRR15539829;47;45;0.468085106382979;25;22;0.0319148936170213;0.468085106382979
Control.SRR15539829;49;45;0.510204081632653;24;25;0.0102040816326531;0.489795918367347
Control.SRR15539829;51;45;0.588235294117647;21;30;0.0882352941176471;0.411764705882353
Control.SRR15539829;46;45;0.326086956521739;31;15;0.173913043478261;0.326086956521739
Control.SRR15539829;44;45;0.318181818181818;30;14;0.181818181818182;0.318181818181818
Control.SRR15539829;47;45;0.617021276595745;18;29;0.117021276595745;0.382978723404255
Control.SRR15539829;43;45;0.441860465116279;24;19;0.0581395348837209;0.441860465116279
Control.SRR15539829;47;45;0.425531914893617;27;20;0.074468085106383;0.425531914893617
Control.SRR15539829;48;45;0.375;30;18;0.125;0.375
Control.SRR15539829;47;45;0.553191489361702;21;26;0.0531914893617021;0.446808510638298
Control.SRR15539829;46;45;0.456521739130435;25;21;0.0434782608695652;0.456521739130435
Control.SRR15539829;45;45;0.555555555555556;20;25;0.0555555555555556;0.444444444444444
Control.SRR15539829;47;45;0.553191489361702;21;26;0.0531914893617021;0.446808510638298
Control.SRR15539829;50;45;0.46;27;23;0.04;0.46
Control.SRR15539829;48;45;0.5;24;24;0;0.5
Control.SRR15539829;43;45;0.348837209302326;28;15;0.151162790697674;0.348837209302326
Control.SRR15539829;51;45;0.509803921568627;25;26;0.00980392156862742;0.490196078431373
Control.SRR15539829;43;45;0.511627906976744;21;22;0.0116279069767442;0.488372093023256
Control.SRR15539829;52;45;0.384615384615385;32;20;0.115384615384615;0.384615384615385
Control.SRR15539829;40;45;0.425;23;17;0.075;0.425
Control.SRR15539829;51;45;0.470588235294118;27;24;0.0294117647058824;0.470588235294118
Control.SRR15539829;40;45;0.7;12;28;0.2;0.3
Control.SRR15539829;40;45;0.45;22;18;0.05;0.45
Control.SRR15539829;43;45;0.558139534883721;19;24;0.0581395348837209;0.441860465116279
Control.SRR15539829;42;45;0.5;21;21;0;0.5
Control.SRR15539829;45;45;0.444444444444444;25;20;0.0555555555555556;0.444444444444444
Control.SRR15539829;41;45;0.634146341463415;15;26;0.134146341463415;0.365853658536585
Control.SRR15539829;49;45;0.428571428571429;28;21;0.0714285714285715;0.428571428571429
Control.SRR15539829;42;45;0.571428571428571;18;24;0.0714285714285714;0.428571428571429
Control.SRR15539829;44;45;0.5;22;22;0;0.5
Control.SRR15539829;46;45;0.58695652173913;19;27;0.0869565217391305;0.41304347826087
Control.SRR15539829;48;45;0.541666666666667;22;26;0.0416666666666666;0.458333333333333
Control.SRR15539829;40;45;0.5;20;20;0;0.5
Control.SRR15539829;42;45;0.476190476190476;22;20;0.0238095238095238;0.476190476190476
Control.SRR15539829;44;45;0.454545454545455;24;20;0.0454545454545455;0.454545454545455
Control.SRR15539829;44;45;0.5;22;22;0;0.5
Control.SRR15539829;42;45;0.5;21;21;0;0.5
Control.SRR15539829;52;45;0.557692307692308;23;29;0.0576923076923077;0.442307692307692
Control.SRR15539829;49;45;0.551020408163265;22;27;0.0510204081632653;0.448979591836735
Control.SRR15539829;43;45;0.558139534883721;19;24;0.0581395348837209;0.441860465116279
Control.SRR15539829;51;45;0.333333333333333;34;17;0.166666666666667;0.333333333333333
Control.SRR15539829;43;45;0.418604651162791;25;18;0.0813953488372093;0.418604651162791
Control.SRR15539829;43;45;0.418604651162791;25;18;0.0813953488372093;0.418604651162791
Control.SRR15539829;43;45;0.441860465116279;24;19;0.0581395348837209;0.441860465116279
Control.SRR15539829;49;45;0.571428571428571;21;28;0.0714285714285714;0.428571428571429
Control.SRR15539829;49;45;0.469387755102041;26;23;0.0306122448979592;0.469387755102041
Control.SRR15539829;50;45;0.38;31;19;0.12;0.38
Control.SRR15539829;45;45;0.466666666666667;24;21;0.0333333333333333;0.466666666666667
Control.SRR15539829;44;45;0.454545454545455;24;20;0.0454545454545455;0.454545454545455
Control.SRR15539829;47;45;0.48936170212766;24;23;0.0106382978723404;0.48936170212766
Control.SRR15539829;42;45;0.523809523809524;20;22;0.0238095238095238;0.476190476190476
Control.SRR15539829;50;45;0.54;23;27;0.04;0.46
Control.SRR15539829;46;45;0.58695652173913;19;27;0.0869565217391305;0.41304347826087
Control.SRR15539829;41;45;0.585365853658537;17;24;0.0853658536585366;0.414634146341463
Control.SRR15539829;46;45;0.456521739130435;25;21;0.0434782608695652;0.456521739130435
Control.SRR15539829;44;45;0.5;22;22;0;0.5
Control.SRR15539829;43;45;0.465116279069767;23;20;0.0348837209302326;0.465116279069767
Control.SRR15539829;51;45;0.490196078431373;26;25;0.00980392156862747;0.490196078431373
Control.SRR15539829;48;45;0.479166666666667;25;23;0.0208333333333333;0.479166666666667
Control.SRR15539829;42;45;0.595238095238095;17;25;0.0952380952380952;0.404761904761905
Control.SRR15539829;48;45;0.5;24;24;0;0.5
Control.SRR15539829;52;45;0.538461538461538;24;28;0.0384615384615384;0.461538461538462
Control.SRR15539829;48;45;0.520833333333333;23;25;0.0208333333333334;0.479166666666667
Control.SRR15539829;51;45;0.470588235294118;27;24;0.0294117647058824;0.470588235294118
Control.SRR15539829;50;45;0.64;18;32;0.14;0.36
Control.SRR15539829;41;45;0.585365853658537;17;24;0.0853658536585366;0.414634146341463
Control.SRR15539829;50;45;0.58;21;29;0.08;0.42
Control.SRR15539829;52;45;0.519230769230769;25;27;0.0192307692307693;0.480769230769231
Control.SRR15539829;40;45;0.45;22;18;0.05;0.45
Control.SRR15539829;40;45;0.525;19;21;0.025;0.475
Control.SRR15539829;43;45;0.581395348837209;18;25;0.0813953488372093;0.418604651162791
Control.SRR15539829;43;45;0.441860465116279;24;19;0.0581395348837209;0.441860465116279
Control.SRR15539829;50;45;0.52;24;26;0.02;0.48
Control.SRR15539829;52;45;0.480769230769231;27;25;0.0192307692307692;0.480769230769231
Control.SRR15539829;47;45;0.468085106382979;25;22;0.0319148936170213;0.468085106382979
Control.SRR15539829;52;45;0.365384615384615;33;19;0.134615384615385;0.365384615384615
Control.SRR15539829;41;45;0.48780487804878;21;20;0.0121951219512195;0.48780487804878
Control.SRR15539829;52;45;0.596153846153846;21;31;0.0961538461538461;0.403846153846154
Control.SRR15539829;47;45;0.531914893617021;22;25;0.0319148936170213;0.468085106382979
Control.SRR15539829;47;45;0.680851063829787;15;32;0.180851063829787;0.319148936170213
Control.SRR15539829;46;45;0.347826086956522;30;16;0.152173913043478;0.347826086956522
Control.SRR15539829;41;45;0.560975609756098;18;23;0.0609756097560976;0.439024390243902
Control.SRR15539829;44;45;0.522727272727273;21;23;0.0227272727272727;0.477272727272727
Control.SRR15539829;48;45;0.458333333333333;26;22;0.0416666666666667;0.458333333333333
Control.SRR15539829;51;45;0.470588235294118;27;24;0.0294117647058824;0.470588235294118
Control.SRR15539829;40;45;0.525;19;21;0.025;0.475
Control.SRR15539829;51;45;0.411764705882353;30;21;0.0882352941176471;0.411764705882353
Control.SRR15539829;42;45;0.452380952380952;23;19;0.0476190476190476;0.452380952380952
Control.SRR15539829;45;45;0.488888888888889;23;22;0.0111111111111111;0.488888888888889
Control.SRR15539829;45;45;0.488888888888889;23;22;0.0111111111111111;0.488888888888889
Control.SRR15539829;47;45;0.48936170212766;24;23;0.0106382978723404;0.48936170212766
Control.SRR15539829;40;45;0.45;22;18;0.05;0.45
Control.SRR15539829;42;45;0.404761904761905;25;17;0.0952380952380952;0.404761904761905
Control.SRR15539829;41;45;0.365853658536585;26;15;0.134146341463415;0.365853658536585
Control.SRR15539829;45;45;0.466666666666667;24;21;0.0333333333333333;0.466666666666667
Control.SRR15539829;46;45;0.391304347826087;28;18;0.108695652173913;0.391304347826087
Control.SRR15539829;47;45;0.51063829787234;23;24;0.0106382978723404;0.48936170212766
Control.SRR15539829;44;45;0.477272727272727;23;21;0.0227272727272727;0.477272727272727
Control.SRR15539829;43;45;0.534883720930233;20;23;0.0348837209302325;0.465116279069767
Control.SRR15539829;41;45;0.414634146341463;24;17;0.0853658536585366;0.414634146341463
Control.SRR15539829;48;45;0.479166666666667;25;23;0.0208333333333333;0.479166666666667
Control.SRR15539829;46;45;0.434782608695652;26;20;0.0652173913043478;0.434782608695652
Control.SRR15539829;51;45;0.568627450980392;22;29;0.0686274509803921;0.431372549019608
Control.SRR15539829;46;45;0.608695652173913;18;28;0.108695652173913;0.391304347826087
Control.SRR15539829;42;45;0.595238095238095;17;25;0.0952380952380952;0.404761904761905
Control.SRR15539829;51;45;0.450980392156863;28;23;0.0490196078431372;0.450980392156863
Control.SRR15539829;48;45;0.333333333333333;32;16;0.166666666666667;0.333333333333333
Control.SRR15539829;45;45;0.6;18;27;0.1;0.4
Control.SRR15539829;44;45;0.431818181818182;25;19;0.0681818181818182;0.431818181818182
Control.SRR15539829;50;45;0.38;31;19;0.12;0.38
Control.SRR15539829;45;45;0.511111111111111;22;23;0.0111111111111111;0.488888888888889
Control.SRR15539829;40;45;0.45;22;18;0.05;0.45
Control.SRR15539829;42;45;0.571428571428571;18;24;0.0714285714285714;0.428571428571429
Control.SRR15539829;45;45;0.6;18;27;0.1;0.4
Control.SRR15539829;48;45;0.395833333333333;29;19;0.104166666666667;0.395833333333333
Control.SRR15539829;41;45;0.51219512195122;20;21;0.0121951219512195;0.48780487804878
Control.SRR15539829;49;45;0.510204081632653;24;25;0.0102040816326531;0.489795918367347
Control.SRR15539829;46;45;0.456521739130435;25;21;0.0434782608695652;0.456521739130435
Control.SRR15539829;48;45;0.583333333333333;20;28;0.0833333333333334;0.416666666666667
Control.SRR15539829;43;45;0.488372093023256;22;21;0.0116279069767442;0.488372093023256
Control.SRR15539829;45;45;0.333333333333333;30;15;0.166666666666667;0.333333333333333
Control.SRR15539829;51;45;0.431372549019608;29;22;0.0686274509803921;0.431372549019608
Control.SRR15539829;43;45;0.604651162790698;17;26;0.104651162790698;0.395348837209302
Control.SRR15539829;46;45;0.478260869565217;24;22;0.0217391304347826;0.478260869565217
Control.SRR15539829;43;45;0.511627906976744;21;22;0.0116279069767442;0.488372093023256
Control.SRR15539829;47;45;0.404255319148936;28;19;0.0957446808510639;0.404255319148936
Control.SRR15539829;47;45;0.531914893617021;22;25;0.0319148936170213;0.468085106382979
Control.SRR15539829;43;45;0.534883720930233;20;23;0.0348837209302325;0.465116279069767
Control.SRR15539829;41;45;0.536585365853659;19;22;0.0365853658536586;0.463414634146341
Control.SRR15539829;40;45;0.525;19;21;0.025;0.475
Control.SRR15539829;42;45;0.547619047619048;19;23;0.0476190476190477;0.452380952380952
Control.SRR15539829;48;45;0.5625;21;27;0.0625;0.4375
Control.SRR15539829;51;45;0.450980392156863;28;23;0.0490196078431372;0.450980392156863
Control.SRR15539829;41;45;0.51219512195122;20;21;0.0121951219512195;0.48780487804878
Control.SRR15539829;45;45;0.288888888888889;32;13;0.211111111111111;0.288888888888889
Control.SRR15539829;41;45;0.390243902439024;25;16;0.109756097560976;0.390243902439024
Control.SRR15539829;44;45;0.454545454545455;24;20;0.0454545454545455;0.454545454545455
Control.SRR15539829;49;45;0.551020408163265;22;27;0.0510204081632653;0.448979591836735
Control.SRR15539829;42;45;0.619047619047619;16;26;0.119047619047619;0.380952380952381
Control.SRR15539829;47;45;0.446808510638298;26;21;0.0531914893617021;0.446808510638298
Control.SRR15539829;50;45;0.5;25;25;0;0.5
Control.SRR15539829;46;45;0.521739130434783;22;24;0.0217391304347826;0.478260869565217
Control.SRR15539829;48;45;0.5;24;24;0;0.5
Control.SRR15539829;46;45;0.58695652173913;19;27;0.0869565217391305;0.41304347826087
Control.SRR15539829;43;45;0.488372093023256;22;21;0.0116279069767442;0.488372093023256
Control.SRR15539829;47;45;0.446808510638298;26;21;0.0531914893617021;0.446808510638298
Control.SRR15539829;42;45;0.452380952380952;23;19;0.0476190476190476;0.452380952380952
Control.SRR15539829;52;45;0.519230769230769;25;27;0.0192307692307693;0.480769230769231
Control.SRR15539829;50;45;0.56;22;28;0.0600000000000001;0.44
Control.SRR15539829;52;45;0.403846153846154;31;21;0.0961538461538461;0.403846153846154
Control.SRR15539829;45;45;0.488888888888889;23;22;0.0111111111111111;0.488888888888889
Control.SRR15539829;43;45;0.302325581395349;30;13;0.197674418604651;0.302325581395349
Control.SRR15539829;52;45;0.538461538461538;24;28;0.0384615384615384;0.461538461538462
Control.SRR15539829;50;45;0.58;21;29;0.08;0.42
Control.SRR15539829;47;45;0.425531914893617;27;20;0.074468085106383;0.425531914893617
Control.SRR15539829;51;45;0.470588235294118;27;24;0.0294117647058824;0.470588235294118
Control.SRR15539829;50;45;0.56;22;28;0.0600000000000001;0.44
Control.SRR15539829;51;45;0.549019607843137;23;28;0.0490196078431373;0.450980392156863
Control.SRR15539829;52;45;0.461538461538462;28;24;0.0384615384615384;0.461538461538462
Control.SRR15539829;42;45;0.5;21;21;0;0.5
Control.SRR15539829;53;45;0.471698113207547;28;25;0.0283018867924528;0.471698113207547
Control.SRR15539829;52;45;0.442307692307692;29;23;0.0576923076923077;0.442307692307692
Control.SRR15539829;48;45;0.5;24;24;0;0.5
Control.SRR15539829;53;45;0.358490566037736;34;19;0.141509433962264;0.358490566037736
Control.SRR15539829;46;45;0.434782608695652;26;20;0.0652173913043478;0.434782608695652
Control.SRR15539829;47;45;0.553191489361702;21;26;0.0531914893617021;0.446808510638298
Control.SRR15539829;46;45;0.521739130434783;22;24;0.0217391304347826;0.478260869565217
Control.SRR15539829;46;45;0.521739130434783;22;24;0.0217391304347826;0.478260869565217
Control.SRR15539829;40;45;0.5;20;20;0;0.5
Control.SRR15539829;49;45;0.510204081632653;24;25;0.0102040816326531;0.489795918367347
Control.SRR15539829;47;45;0.702127659574468;14;33;0.202127659574468;0.297872340425532
Control.SRR15539829;43;45;0.441860465116279;24;19;0.0581395348837209;0.441860465116279
Control.SRR15539829;47;45;0.468085106382979;25;22;0.0319148936170213;0.468085106382979
Control.SRR15539829;41;45;0.609756097560976;16;25;0.109756097560976;0.390243902439024
Control.SRR15539829;42;45;0.571428571428571;18;24;0.0714285714285714;0.428571428571429
Control.SRR15539829;46;45;0.521739130434783;22;24;0.0217391304347826;0.478260869565217
Control.SRR15539829;48;45;0.458333333333333;26;22;0.0416666666666667;0.458333333333333
Control.SRR15539829;54;45;0.444444444444444;30;24;0.0555555555555556;0.444444444444444
Control.SRR15539829;45;45;0.555555555555556;20;25;0.0555555555555556;0.444444444444444
Control.SRR15539829;48;45;0.479166666666667;25;23;0.0208333333333333;0.479166666666667
Control.SRR15539829;51;45;0.470588235294118;27;24;0.0294117647058824;0.470588235294118
Control.SRR15539829;45;45;0.555555555555556;20;25;0.0555555555555556;0.444444444444444
Control.SRR15539829;53;45;0.547169811320755;24;29;0.0471698113207547;0.452830188679245
Control.SRR15539829;53;45;0.490566037735849;27;26;0.00943396226415094;0.490566037735849
Control.SRR15539829;45;45;0.555555555555556;20;25;0.0555555555555556;0.444444444444444
Control.SRR15539829;41;45;0.560975609756098;18;23;0.0609756097560976;0.439024390243902
Control.SRR15539829;40;45;0.625;15;25;0.125;0.375
Control.SRR15539829;50;45;0.54;23;27;0.04;0.46
Control.SRR15539829;52;45;0.519230769230769;25;27;0.0192307692307693;0.480769230769231
Control.SRR15539829;54;45;0.481481481481481;28;26;0.0185185185185185;0.481481481481481
Control.SRR15539829;40;45;0.475;21;19;0.025;0.475
Control.SRR15539829;46;45;0.369565217391304;29;17;0.130434782608696;0.369565217391304
Control.SRR15539829;43;45;0.465116279069767;23;20;0.0348837209302326;0.465116279069767
Control.SRR15539829;51;45;0.490196078431373;26;25;0.00980392156862747;0.490196078431373
Control.SRR15539829;47;45;0.446808510638298;26;21;0.0531914893617021;0.446808510638298
Control.SRR15539829;43;45;0.465116279069767;23;20;0.0348837209302326;0.465116279069767
Control.SRR15539829;43;45;0.488372093023256;22;21;0.0116279069767442;0.488372093023256
Control.SRR15539829;48;45;0.375;30;18;0.125;0.375
Control.SRR15539829;42;45;0.452380952380952;23;19;0.0476190476190476;0.452380952380952
Control.SRR15539829;40;45;0.425;23;17;0.075;0.425
Control.SRR15539829;42;45;0.428571428571429;24;18;0.0714285714285715;0.428571428571429
Control.SRR15539829;44;45;0.5;22;22;0;0.5
Control.SRR15539829;42;45;0.428571428571429;24;18;0.0714285714285715;0.428571428571429
Control.SRR15539829;48;45;0.354166666666667;31;17;0.145833333333333;0.354166666666667
Control.SRR15539829;41;45;0.390243902439024;25;16;0.109756097560976;0.390243902439024
Control.SRR15539829;50;45;0.42;29;21;0.08;0.42
Control.SRR15539829;51;45;0.549019607843137;23;28;0.0490196078431373;0.450980392156863
Control.SRR15539829;47;45;0.574468085106383;20;27;0.074468085106383;0.425531914893617
Control.SRR15539829;45;45;0.488888888888889;23;22;0.0111111111111111;0.488888888888889
Control.SRR15539829;45;45;0.4;27;18;0.1;0.4
Control.SRR15539829;41;45;0.390243902439024;25;16;0.109756097560976;0.390243902439024
Control.SRR15539829;50;45;0.44;28;22;0.06;0.44
Control.SRR15539829;46;45;0.521739130434783;22;24;0.0217391304347826;0.478260869565217
Control.SRR15539829;40;45;0.525;19;21;0.025;0.475
Control.SRR15539829;40;45;0.525;19;21;0.025;0.475
Control.SRR15539829;48;45;0.5625;21;27;0.0625;0.4375
Control.SRR15539829;43;45;0.465116279069767;23;20;0.0348837209302326;0.465116279069767
Control.SRR15539829;40;45;0.45;22;18;0.05;0.45
Control.SRR15539829;46;45;0.434782608695652;26;20;0.0652173913043478;0.434782608695652
Control.SRR15539829;46;45;0.434782608695652;26;20;0.0652173913043478;0.434782608695652
Control.SRR15539829;50;45;0.62;19;31;0.12;0.38
Control.SRR15539829;42;45;0.452380952380952;23;19;0.0476190476190476;0.452380952380952
Control.SRR15539829;45;45;0.333333333333333;30;15;0.166666666666667;0.333333333333333
Control.SRR15539829;43;45;0.441860465116279;24;19;0.0581395348837209;0.441860465116279
Control.SRR15539829;43;45;0.534883720930233;20;23;0.0348837209302325;0.465116279069767
Control.SRR15539829;46;45;0.608695652173913;18;28;0.108695652173913;0.391304347826087
Control.SRR15539829;42;45;0.547619047619048;19;23;0.0476190476190477;0.452380952380952
Control.SRR15539829;47;45;0.468085106382979;25;22;0.0319148936170213;0.468085106382979
Control.SRR15539829;52;45;0.423076923076923;30;22;0.0769230769230769;0.423076923076923
Control.SRR15539829;40;45;0.375;25;15;0.125;0.375
Control.SRR15539829;41;45;0.292682926829268;29;12;0.207317073170732;0.292682926829268
Control.SRR15539829;40;45;0.475;21;19;0.025;0.475
Control.SRR15539829;42;45;0.619047619047619;16;26;0.119047619047619;0.380952380952381
Control.SRR15539829;45;45;0.533333333333333;21;24;0.0333333333333333;0.466666666666667
Control.SRR15539829;48;45;0.416666666666667;28;20;0.0833333333333333;0.416666666666667
Control.SRR15539829;54;45;0.62962962962963;20;34;0.12962962962963;0.37037037037037
Control.SRR15539829;46;45;0.543478260869565;21;25;0.0434782608695652;0.456521739130435
Control.SRR15539829;50;45;0.44;28;22;0.06;0.44
Control.SRR15539829;51;45;0.470588235294118;27;24;0.0294117647058824;0.470588235294118
Control.SRR15539829;40;45;0.4;24;16;0.1;0.4
Control.SRR15539829;52;45;0.519230769230769;25;27;0.0192307692307693;0.480769230769231
Control.SRR15539829;51;45;0.529411764705882;24;27;0.0294117647058824;0.470588235294118
Control.SRR15539829;48;45;0.395833333333333;29;19;0.104166666666667;0.395833333333333
Control.SRR15539829;49;45;0.571428571428571;21;28;0.0714285714285714;0.428571428571429
Control.SRR15539829;45;45;0.488888888888889;23;22;0.0111111111111111;0.488888888888889
Control.SRR15539829;45;45;0.577777777777778;19;26;0.0777777777777777;0.422222222222222
Control.SRR15539829;44;45;0.568181818181818;19;25;0.0681818181818182;0.431818181818182
Control.SRR15539829;45;45;0.622222222222222;17;28;0.122222222222222;0.377777777777778
Control.SRR15539829;52;45;0.557692307692308;23;29;0.0576923076923077;0.442307692307692
Control.SRR15539829;43;45;0.27906976744186;31;12;0.22093023255814;0.27906976744186
Control.SRR15539829;44;45;0.545454545454545;20;24;0.0454545454545454;0.454545454545455
Control.SRR15539829;53;45;0.452830188679245;29;24;0.0471698113207547;0.452830188679245
Control.SRR15539829;43;45;0.581395348837209;18;25;0.0813953488372093;0.418604651162791
Control.SRR15539829;48;45;0.5;24;24;0;0.5
Control.SRR15539829;52;45;0.403846153846154;31;21;0.0961538461538461;0.403846153846154
Control.SRR15539829;53;45;0.528301886792453;25;28;0.0283018867924528;0.471698113207547
Control.SRR15539829;48;45;0.4375;27;21;0.0625;0.4375
Control.SRR15539829;46;45;0.456521739130435;25;21;0.0434782608695652;0.456521739130435
Control.SRR15539829;50;45;0.42;29;21;0.08;0.42
Control.SRR15539829;46;45;0.565217391304348;20;26;0.0652173913043478;0.434782608695652
Control.SRR15539829;49;45;0.408163265306122;29;20;0.0918367346938775;0.408163265306122
Control.SRR15539829;40;45;0.575;17;23;0.075;0.425
Control.SRR15539829;52;45;0.557692307692308;23;29;0.0576923076923077;0.442307692307692
Control.SRR15539829;50;45;0.48;26;24;0.02;0.48
Control.SRR15539829;49;45;0.469387755102041;26;23;0.0306122448979592;0.469387755102041
Control.SRR15539829;46;45;0.456521739130435;25;21;0.0434782608695652;0.456521739130435
Control.SRR15539829;44;45;0.454545454545455;24;20;0.0454545454545455;0.454545454545455
Control.SRR15539829;47;45;0.51063829787234;23;24;0.0106382978723404;0.48936170212766
Control.SRR15539829;52;45;0.519230769230769;25;27;0.0192307692307693;0.480769230769231
Control.SRR15539829;52;45;0.442307692307692;29;23;0.0576923076923077;0.442307692307692
Control.SRR15539829;49;45;0.408163265306122;29;20;0.0918367346938775;0.408163265306122
Control.SRR15539829;46;45;0.456521739130435;25;21;0.0434782608695652;0.456521739130435
Control.SRR15539829;51;45;0.470588235294118;27;24;0.0294117647058824;0.470588235294118
Control.SRR15539829;47;45;0.51063829787234;23;24;0.0106382978723404;0.48936170212766
Control.SRR15539829;54;45;0.518518518518518;26;28;0.0185185185185185;0.481481481481481
Control.SRR15539829;51;45;0.450980392156863;28;23;0.0490196078431372;0.450980392156863
Control.SRR15539829;44;45;0.477272727272727;23;21;0.0227272727272727;0.477272727272727
Control.SRR15539829;46;45;0.347826086956522;30;16;0.152173913043478;0.347826086956522
Control.SRR15539829;41;45;0.463414634146341;22;19;0.0365853658536585;0.463414634146341
Control.SRR15539829;46;45;0.41304347826087;27;19;0.0869565217391304;0.41304347826087
Control.SRR15539829;54;45;0.555555555555556;24;30;0.0555555555555556;0.444444444444444
Control.SRR15539829;52;45;0.442307692307692;29;23;0.0576923076923077;0.442307692307692
Control.SRR15539829;45;45;0.6;18;27;0.1;0.4
Control.SRR15539829;52;45;0.615384615384615;20;32;0.115384615384615;0.384615384615385
Control.SRR15539829;53;45;0.547169811320755;24;29;0.0471698113207547;0.452830188679245
Control.SRR15539829;52;45;0.596153846153846;21;31;0.0961538461538461;0.403846153846154
Control.SRR15539829;40;45;0.55;18;22;0.05;0.45
Control.SRR15539829;49;45;0.346938775510204;32;17;0.153061224489796;0.346938775510204
Control.SRR15539829;52;45;0.519230769230769;25;27;0.0192307692307693;0.480769230769231
Control.SRR15539829;48;45;0.458333333333333;26;22;0.0416666666666667;0.458333333333333
Control.SRR15539829;46;45;0.369565217391304;29;17;0.130434782608696;0.369565217391304
Control.SRR15539829;40;45;0.575;17;23;0.075;0.425
Control.SRR15539829;47;45;0.48936170212766;24;23;0.0106382978723404;0.48936170212766
Control.SRR15539829;45;45;0.466666666666667;24;21;0.0333333333333333;0.466666666666667
Control.SRR15539829;54;45;0.518518518518518;26;28;0.0185185185185185;0.481481481481481
Control.SRR15539829;43;45;0.581395348837209;18;25;0.0813953488372093;0.418604651162791
Control.SRR15539829;45;45;0.577777777777778;19;26;0.0777777777777777;0.422222222222222
Control.SRR15539829;41;45;0.48780487804878;21;20;0.0121951219512195;0.48780487804878
Control.SRR15539829;44;45;0.590909090909091;18;26;0.0909090909090909;0.409090909090909
Control.SRR15539829;46;45;0.58695652173913;19;27;0.0869565217391305;0.41304347826087
Control.SRR15539829;48;45;0.4375;27;21;0.0625;0.4375
Control.SRR15539829;46;45;0.565217391304348;20;26;0.0652173913043478;0.434782608695652
Control.SRR15539829;45;45;0.666666666666667;15;30;0.166666666666667;0.333333333333333
Control.SRR15539829;47;45;0.531914893617021;22;25;0.0319148936170213;0.468085106382979
Control.SRR15539829;53;45;0.509433962264151;26;27;0.00943396226415094;0.490566037735849
Control.SRR15539829;48;45;0.375;30;18;0.125;0.375
Control.SRR15539829;41;45;0.560975609756098;18;23;0.0609756097560976;0.439024390243902
Control.SRR15539829;50;45;0.42;29;21;0.08;0.42
Control.SRR15539829;45;45;0.511111111111111;22;23;0.0111111111111111;0.488888888888889
Control.SRR15539829;41;45;0.51219512195122;20;21;0.0121951219512195;0.48780487804878
Control.SRR15539829;47;45;0.553191489361702;21;26;0.0531914893617021;0.446808510638298
Control.SRR15539829;43;45;0.511627906976744;21;22;0.0116279069767442;0.488372093023256
Control.SRR15539829;41;45;0.585365853658537;17;24;0.0853658536585366;0.414634146341463
Control.SRR15539829;46;45;0.41304347826087;27;19;0.0869565217391304;0.41304347826087
Control.SRR15539829;41;45;0.536585365853659;19;22;0.0365853658536586;0.463414634146341
Control.SRR15539829;49;45;0.489795918367347;25;24;0.0102040816326531;0.489795918367347
Control.SRR15539829;54;45;0.425925925925926;31;23;0.0740740740740741;0.425925925925926
Control.SRR15539829;44;45;0.477272727272727;23;21;0.0227272727272727;0.477272727272727
Control.SRR15539829;46;45;0.41304347826087;27;19;0.0869565217391304;0.41304347826087
Control.SRR15539829;45;45;0.444444444444444;25;20;0.0555555555555556;0.444444444444444
Control.SRR15539829;47;45;0.361702127659574;30;17;0.138297872340426;0.361702127659574
Control.SRR15539829;47;45;0.48936170212766;24;23;0.0106382978723404;0.48936170212766
Control.SRR15539829;48;45;0.5625;21;27;0.0625;0.4375
Control.SRR15539829;51;45;0.607843137254902;20;31;0.107843137254902;0.392156862745098
Control.SRR15539829;51;45;0.509803921568627;25;26;0.00980392156862742;0.490196078431373
Control.SRR15539829;48;45;0.5625;21;27;0.0625;0.4375
Control.SRR15539829;46;45;0.543478260869565;21;25;0.0434782608695652;0.456521739130435
Control.SRR15539829;41;45;0.51219512195122;20;21;0.0121951219512195;0.48780487804878
Control.SRR15539829;44;45;0.363636363636364;28;16;0.136363636363636;0.363636363636364
Control.SRR15539829;40;45;0.45;22;18;0.05;0.45
Control.SRR15539829;51;45;0.549019607843137;23;28;0.0490196078431373;0.450980392156863
Control.SRR15539829;51;45;0.529411764705882;24;27;0.0294117647058824;0.470588235294118
Control.SRR15539829;40;45;0.5;20;20;0;0.5
Control.SRR15539829;47;45;0.702127659574468;14;33;0.202127659574468;0.297872340425532
Control.SRR15539829;40;45;0.575;17;23;0.075;0.425
Control.SRR15539829;51;45;0.647058823529412;18;33;0.147058823529412;0.352941176470588
Control.SRR15539829;54;45;0.574074074074074;23;31;0.0740740740740741;0.425925925925926
Control.SRR15539829;53;45;0.60377358490566;21;32;0.10377358490566;0.39622641509434
Control.SRR15539829;54;45;0.462962962962963;29;25;0.037037037037037;0.462962962962963
Control.SRR15539829;50;45;0.44;28;22;0.06;0.44
Control.SRR15539829;42;45;0.547619047619048;19;23;0.0476190476190477;0.452380952380952
Control.SRR15539829;53;45;0.509433962264151;26;27;0.00943396226415094;0.490566037735849
Control.SRR15539829;53;45;0.415094339622642;31;22;0.0849056603773585;0.415094339622642
Control.SRR15539829;42;45;0.547619047619048;19;23;0.0476190476190477;0.452380952380952
Control.SRR15539829;50;45;0.48;26;24;0.02;0.48
Control.SRR15539829;43;45;0.488372093023256;22;21;0.0116279069767442;0.488372093023256
Control.SRR15539829;43;45;0.441860465116279;24;19;0.0581395348837209;0.441860465116279
Control.SRR15539829;50;45;0.68;16;34;0.18;0.32
Control.SRR15539829;48;45;0.520833333333333;23;25;0.0208333333333334;0.479166666666667
Control.SRR15539829;47;45;0.531914893617021;22;25;0.0319148936170213;0.468085106382979
Control.SRR15539829;50;45;0.54;23;27;0.04;0.46
Control.SRR15539829;47;45;0.531914893617021;22;25;0.0319148936170213;0.468085106382979
Control.SRR15539829;46;45;0.434782608695652;26;20;0.0652173913043478;0.434782608695652
Control.SRR15539829;51;45;0.411764705882353;30;21;0.0882352941176471;0.411764705882353
Control.SRR15539829;44;45;0.5;22;22;0;0.5
Control.SRR15539829;53;45;0.415094339622642;31;22;0.0849056603773585;0.415094339622642
Control.SRR15539829;50;45;0.52;24;26;0.02;0.48
Control.SRR15539829;45;45;0.466666666666667;24;21;0.0333333333333333;0.466666666666667
Control.SRR15539829;45;45;0.533333333333333;21;24;0.0333333333333333;0.466666666666667
Control.SRR15539829;50;45;0.6;20;30;0.1;0.4
Control.SRR15539829;41;45;0.414634146341463;24;17;0.0853658536585366;0.414634146341463
Control.SRR15539829;50;45;0.48;26;24;0.02;0.48
Control.SRR15539829;47;45;0.48936170212766;24;23;0.0106382978723404;0.48936170212766
Control.SRR15539829;54;45;0.425925925925926;31;23;0.0740740740740741;0.425925925925926
Control.SRR15539829;50;45;0.36;32;18;0.14;0.36
Control.SRR15539829;48;45;0.645833333333333;17;31;0.145833333333333;0.354166666666667
Control.SRR15539829;54;45;0.407407407407407;32;22;0.0925925925925926;0.407407407407407
Control.SRR15539829;44;45;0.5;22;22;0;0.5
Control.SRR15539829;51;45;0.509803921568627;25;26;0.00980392156862742;0.490196078431373
Control.SRR15539829;54;45;0.444444444444444;30;24;0.0555555555555556;0.444444444444444
Control.SRR15539829;53;45;0.471698113207547;28;25;0.0283018867924528;0.471698113207547
Control.SRR15539829;40;45;0.65;14;26;0.15;0.35
Control.SRR15539829;49;45;0.387755102040816;30;19;0.112244897959184;0.387755102040816
Control.SRR15539829;47;45;0.404255319148936;28;19;0.0957446808510639;0.404255319148936
Control.SRR15539829;46;45;0.5;23;23;0;0.5
Control.SRR15539829;43;45;0.441860465116279;24;19;0.0581395348837209;0.441860465116279
Control.SRR15539829;43;45;0.348837209302326;28;15;0.151162790697674;0.348837209302326
Control.SRR15539829;44;45;0.386363636363636;27;17;0.113636363636364;0.386363636363636
Control.SRR15539829;50;45;0.48;26;24;0.02;0.48
Control.SRR15539829;49;45;0.551020408163265;22;27;0.0510204081632653;0.448979591836735
Control.SRR15539829;48;45;0.5;24;24;0;0.5
Control.SRR15539829;42;45;0.5;21;21;0;0.5
Control.SRR15539829;49;45;0.408163265306122;29;20;0.0918367346938775;0.408163265306122
Control.SRR15539829;50;45;0.54;23;27;0.04;0.46
Control.SRR15539829;52;45;0.615384615384615;20;32;0.115384615384615;0.384615384615385
Control.SRR15539829;53;45;0.60377358490566;21;32;0.10377358490566;0.39622641509434
Control.SRR15539829;53;45;0.490566037735849;27;26;0.00943396226415094;0.490566037735849
Control.SRR15539829;43;45;0.465116279069767;23;20;0.0348837209302326;0.465116279069767
Control.SRR15539829;42;45;0.476190476190476;22;20;0.0238095238095238;0.476190476190476
Control.SRR15539829;51;45;0.529411764705882;24;27;0.0294117647058824;0.470588235294118
Control.SRR15539829;52;45;0.557692307692308;23;29;0.0576923076923077;0.442307692307692
Control.SRR15539829;40;45;0.55;18;22;0.05;0.45
Control.SRR15539829;41;45;0.365853658536585;26;15;0.134146341463415;0.365853658536585
Control.SRR15539829;53;45;0.547169811320755;24;29;0.0471698113207547;0.452830188679245
Control.SRR15539829;43;45;0.511627906976744;21;22;0.0116279069767442;0.488372093023256
Control.SRR15539829;49;45;0.448979591836735;27;22;0.0510204081632653;0.448979591836735
Control.SRR15539829;48;45;0.354166666666667;31;17;0.145833333333333;0.354166666666667
Control.SRR15539829;45;45;0.444444444444444;25;20;0.0555555555555556;0.444444444444444
Control.SRR15539829;47;45;0.404255319148936;28;19;0.0957446808510639;0.404255319148936
Control.SRR15539829;45;45;0.466666666666667;24;21;0.0333333333333333;0.466666666666667
Control.SRR15539829;42;45;0.5;21;21;0;0.5
Control.SRR15539829;47;45;0.553191489361702;21;26;0.0531914893617021;0.446808510638298
Control.SRR15539829;46;45;0.5;23;23;0;0.5
Control.SRR15539829;51;45;0.529411764705882;24;27;0.0294117647058824;0.470588235294118
Control.SRR15539829;46;45;0.630434782608696;17;29;0.130434782608696;0.369565217391304
Control.SRR15539829;46;45;0.565217391304348;20;26;0.0652173913043478;0.434782608695652
Control.SRR15539829;52;45;0.461538461538462;28;24;0.0384615384615384;0.461538461538462
Control.SRR15539829;45;45;0.444444444444444;25;20;0.0555555555555556;0.444444444444444
Control.SRR15539829;40;45;0.35;26;14;0.15;0.35
Control.SRR15539829;45;45;0.577777777777778;19;26;0.0777777777777777;0.422222222222222
Control.SRR15539829;40;45;0.425;23;17;0.075;0.425
Control.SRR15539829;46;45;0.434782608695652;26;20;0.0652173913043478;0.434782608695652
Control.SRR15539829;41;45;0.365853658536585;26;15;0.134146341463415;0.365853658536585
Control.SRR15539829;47;45;0.425531914893617;27;20;0.074468085106383;0.425531914893617
Control.SRR15539829;40;45;0.575;17;23;0.075;0.425
Control.SRR15539829;42;45;0.428571428571429;24;18;0.0714285714285715;0.428571428571429
Control.SRR15539829;40;45;0.5;20;20;0;0.5
Control.SRR15539829;52;45;0.423076923076923;30;22;0.0769230769230769;0.423076923076923
Control.SRR15539829;53;45;0.471698113207547;28;25;0.0283018867924528;0.471698113207547
Control.SRR15539829;48;45;0.5;24;24;0;0.5
Control.SRR15539829;48;45;0.520833333333333;23;25;0.0208333333333334;0.479166666666667
Control.SRR15539829;44;45;0.590909090909091;18;26;0.0909090909090909;0.409090909090909
Control.SRR15539829;44;45;0.590909090909091;18;26;0.0909090909090909;0.409090909090909
Control.SRR15539829;47;45;0.531914893617021;22;25;0.0319148936170213;0.468085106382979
Control.SRR15539829;47;45;0.446808510638298;26;21;0.0531914893617021;0.446808510638298
Control.SRR15539829;41;45;0.414634146341463;24;17;0.0853658536585366;0.414634146341463
Control.SRR15539829;40;45;0.425;23;17;0.075;0.425
Control.SRR15539829;44;45;0.318181818181818;30;14;0.181818181818182;0.318181818181818
Control.SRR15539829;54;45;0.481481481481481;28;26;0.0185185185185185;0.481481481481481
Control.SRR15539829;52;45;0.615384615384615;20;32;0.115384615384615;0.384615384615385
Control.SRR15539829;47;45;0.51063829787234;23;24;0.0106382978723404;0.48936170212766
Control.SRR15539829;43;45;0.511627906976744;21;22;0.0116279069767442;0.488372093023256
Control.SRR15539829;54;45;0.425925925925926;31;23;0.0740740740740741;0.425925925925926
Control.SRR15539829;43;45;0.441860465116279;24;19;0.0581395348837209;0.441860465116279
Control.SRR15539829;54;45;0.611111111111111;21;33;0.111111111111111;0.388888888888889
Control.SRR15539829;52;45;0.480769230769231;27;25;0.0192307692307692;0.480769230769231
Control.SRR15539829;52;45;0.557692307692308;23;29;0.0576923076923077;0.442307692307692
Control.SRR15539829;41;45;0.414634146341463;24;17;0.0853658536585366;0.414634146341463
Control.SRR15539829;48;45;0.541666666666667;22;26;0.0416666666666666;0.458333333333333
Control.SRR15539829;54;45;0.518518518518518;26;28;0.0185185185185185;0.481481481481481
Control.SRR15539829;47;45;0.51063829787234;23;24;0.0106382978723404;0.48936170212766
Control.SRR15539829;43;45;0.604651162790698;17;26;0.104651162790698;0.395348837209302
Control.SRR15539829;43;45;0.418604651162791;25;18;0.0813953488372093;0.418604651162791
Control.SRR15539829;41;45;0.48780487804878;21;20;0.0121951219512195;0.48780487804878
Control.SRR15539829;41;45;0.560975609756098;18;23;0.0609756097560976;0.439024390243902
Control.SRR15539829;49;45;0.530612244897959;23;26;0.0306122448979592;0.469387755102041
Control.SRR15539829;40;45;0.475;21;19;0.025;0.475
Control.SRR15539829;47;45;0.531914893617021;22;25;0.0319148936170213;0.468085106382979
Control.SRR15539829;52;45;0.461538461538462;28;24;0.0384615384615384;0.461538461538462
Control.SRR15539829;46;45;0.5;23;23;0;0.5
Control.SRR15539829;46;45;0.521739130434783;22;24;0.0217391304347826;0.478260869565217
Control.SRR15539829;52;45;0.442307692307692;29;23;0.0576923076923077;0.442307692307692
Control.SRR15539829;51;45;0.529411764705882;24;27;0.0294117647058824;0.470588235294118
Control.SRR15539829;48;45;0.541666666666667;22;26;0.0416666666666666;0.458333333333333
Control.SRR15539829;49;45;0.36734693877551;31;18;0.13265306122449;0.36734693877551
Control.SRR15539829;42;45;0.5;21;21;0;0.5
Control.SRR15539829;53;45;0.377358490566038;33;20;0.122641509433962;0.377358490566038
Control.SRR15539829;54;45;0.5;27;27;0;0.5
Control.SRR15539829;53;45;0.566037735849057;23;30;0.0660377358490566;0.433962264150943
Control.SRR15539829;48;45;0.5625;21;27;0.0625;0.4375
Control.SRR15539829;47;45;0.531914893617021;22;25;0.0319148936170213;0.468085106382979
Control.SRR15539829;41;45;0.51219512195122;20;21;0.0121951219512195;0.48780487804878
Control.SRR15539829;53;45;0.547169811320755;24;29;0.0471698113207547;0.452830188679245
Control.SRR15539829;43;45;0.372093023255814;27;16;0.127906976744186;0.372093023255814
Control.SRR15539829;49;45;0.551020408163265;22;27;0.0510204081632653;0.448979591836735
Control.SRR15539829;47;45;0.382978723404255;29;18;0.117021276595745;0.382978723404255
Control.SRR15539829;48;45;0.479166666666667;25;23;0.0208333333333333;0.479166666666667
Control.SRR15539829;53;45;0.528301886792453;25;28;0.0283018867924528;0.471698113207547
Control.SRR15539829;47;45;0.51063829787234;23;24;0.0106382978723404;0.48936170212766
Control.SRR15539829;50;45;0.34;33;17;0.16;0.34
Control.SRR15539829;50;45;0.42;29;21;0.08;0.42
Control.SRR15539829;52;45;0.480769230769231;27;25;0.0192307692307692;0.480769230769231
Control.SRR15539829;48;45;0.4375;27;21;0.0625;0.4375
Control.SRR15539829;49;45;0.510204081632653;24;25;0.0102040816326531;0.489795918367347
Control.SRR15539829;52;45;0.480769230769231;27;25;0.0192307692307692;0.480769230769231
Control.SRR15539829;48;45;0.479166666666667;25;23;0.0208333333333333;0.479166666666667
Control.SRR15539829;46;45;0.608695652173913;18;28;0.108695652173913;0.391304347826087
Control.SRR15539829;48;45;0.479166666666667;25;23;0.0208333333333333;0.479166666666667
Control.SRR15539829;43;45;0.511627906976744;21;22;0.0116279069767442;0.488372093023256
Control.SRR15539829;43;45;0.441860465116279;24;19;0.0581395348837209;0.441860465116279
Control.SRR15539829;54;45;0.481481481481481;28;26;0.0185185185185185;0.481481481481481
Control.SRR15539829;40;45;0.475;21;19;0.025;0.475
Control.SRR15539829;45;45;0.511111111111111;22;23;0.0111111111111111;0.488888888888889
Control.SRR15539829;51;45;0.509803921568627;25;26;0.00980392156862742;0.490196078431373
Control.SRR15539829;47;45;0.51063829787234;23;24;0.0106382978723404;0.48936170212766
Control.SRR15539829;40;45;0.55;18;22;0.05;0.45
Control.SRR15539829;51;45;0.647058823529412;18;33;0.147058823529412;0.352941176470588
Control.SRR15539829;52;45;0.480769230769231;27;25;0.0192307692307692;0.480769230769231
Control.SRR15539829;41;45;0.585365853658537;17;24;0.0853658536585366;0.414634146341463
Control.SRR15539829;42;45;0.523809523809524;20;22;0.0238095238095238;0.476190476190476
Control.SRR15539829;51;45;0.450980392156863;28;23;0.0490196078431372;0.450980392156863
Control.SRR15539829;41;45;0.560975609756098;18;23;0.0609756097560976;0.439024390243902
Control.SRR15539829;44;45;0.454545454545455;24;20;0.0454545454545455;0.454545454545455
Control.SRR15539829;47;45;0.48936170212766;24;23;0.0106382978723404;0.48936170212766
Control.SRR15539829;46;45;0.58695652173913;19;27;0.0869565217391305;0.41304347826087
Control.SRR15539829;40;45;0.55;18;22;0.05;0.45
Control.SRR15539829;40;45;0.4;24;16;0.1;0.4
Control.SRR15539829;54;45;0.407407407407407;32;22;0.0925925925925926;0.407407407407407
Control.SRR15539829;52;45;0.538461538461538;24;28;0.0384615384615384;0.461538461538462
Control.SRR15539829;45;45;0.422222222222222;26;19;0.0777777777777778;0.422222222222222
Control.SRR15539829;52;45;0.5;26;26;0;0.5
Control.SRR15539829;48;45;0.520833333333333;23;25;0.0208333333333334;0.479166666666667
Control.SRR15539829;51;45;0.450980392156863;28;23;0.0490196078431372;0.450980392156863
Control.SRR15539829;54;45;0.518518518518518;26;28;0.0185185185185185;0.481481481481481
Control.SRR15539829;47;45;0.595744680851064;19;28;0.0957446808510638;0.404255319148936
Control.SRR15539829;46;45;0.5;23;23;0;0.5
Control.SRR15539829;44;45;0.522727272727273;21;23;0.0227272727272727;0.477272727272727
Control.SRR15539829;50;45;0.54;23;27;0.04;0.46
Control.SRR15539829;44;45;0.409090909090909;26;18;0.0909090909090909;0.409090909090909
Control.SRR15539829;44;45;0.5;22;22;0;0.5
Control.SRR15539829;44;45;0.681818181818182;14;30;0.181818181818182;0.318181818181818
Control.SRR15539829;46;45;0.543478260869565;21;25;0.0434782608695652;0.456521739130435
Control.SRR15539829;52;45;0.519230769230769;25;27;0.0192307692307693;0.480769230769231
Control.SRR15539829;50;45;0.56;22;28;0.0600000000000001;0.44
Control.SRR15539829;48;45;0.604166666666667;19;29;0.104166666666667;0.395833333333333
Control.SRR15539829;51;45;0.392156862745098;31;20;0.107843137254902;0.392156862745098
Control.SRR15539829;45;45;0.466666666666667;24;21;0.0333333333333333;0.466666666666667
Control.SRR15539829;51;45;0.509803921568627;25;26;0.00980392156862742;0.490196078431373
Control.SRR15539829;43;45;0.558139534883721;19;24;0.0581395348837209;0.441860465116279
Control.SRR15539829;45;45;0.555555555555556;20;25;0.0555555555555556;0.444444444444444
Control.SRR15539829;44;45;0.545454545454545;20;24;0.0454545454545454;0.454545454545455
Control.SRR15539829;42;45;0.571428571428571;18;24;0.0714285714285714;0.428571428571429
Control.SRR15539829;45;45;0.555555555555556;20;25;0.0555555555555556;0.444444444444444
Control.SRR15539829;48;45;0.541666666666667;22;26;0.0416666666666666;0.458333333333333
Control.SRR15539829;51;45;0.568627450980392;22;29;0.0686274509803921;0.431372549019608
Control.SRR15539829;40;45;0.55;18;22;0.05;0.45
Control.SRR15539829;51;45;0.470588235294118;27;24;0.0294117647058824;0.470588235294118
Control.SRR15539829;51;45;0.588235294117647;21;30;0.0882352941176471;0.411764705882353
Control.SRR15539829;54;45;0.611111111111111;21;33;0.111111111111111;0.388888888888889
Control.SRR15539829;42;45;0.5;21;21;0;0.5
Control.SRR15539829;41;45;0.536585365853659;19;22;0.0365853658536586;0.463414634146341
Control.SRR15539829;40;45;0.55;18;22;0.05;0.45
Control.SRR15539829;43;45;0.627906976744186;16;27;0.127906976744186;0.372093023255814
Control.SRR15539829;41;45;0.536585365853659;19;22;0.0365853658536586;0.463414634146341
Control.SRR15539829;43;45;0.441860465116279;24;19;0.0581395348837209;0.441860465116279
Control.SRR15539829;52;45;0.442307692307692;29;23;0.0576923076923077;0.442307692307692
Control.SRR15539829;44;45;0.568181818181818;19;25;0.0681818181818182;0.431818181818182
Control.SRR15539829;41;45;0.634146341463415;15;26;0.134146341463415;0.365853658536585
Control.SRR15539829;54;45;0.62962962962963;20;34;0.12962962962963;0.37037037037037
Control.SRR15539829;43;45;0.488372093023256;22;21;0.0116279069767442;0.488372093023256
Control.SRR15539829;47;45;0.48936170212766;24;23;0.0106382978723404;0.48936170212766
Control.SRR15539829;51;45;0.490196078431373;26;25;0.00980392156862747;0.490196078431373
Control.SRR15539829;49;45;0.591836734693878;20;29;0.0918367346938775;0.408163265306122
Control.SRR15539829;46;45;0.478260869565217;24;22;0.0217391304347826;0.478260869565217
Control.SRR15539829;41;45;0.463414634146341;22;19;0.0365853658536585;0.463414634146341
Control.SRR15539829;45;45;0.555555555555556;20;25;0.0555555555555556;0.444444444444444
Control.SRR15539829;51;45;0.509803921568627;25;26;0.00980392156862742;0.490196078431373
Control.SRR15539829;48;45;0.5625;21;27;0.0625;0.4375
Control.SRR15539829;49;45;0.551020408163265;22;27;0.0510204081632653;0.448979591836735
Control.SRR15539829;52;45;0.557692307692308;23;29;0.0576923076923077;0.442307692307692
Control.SRR15539829;50;45;0.46;27;23;0.04;0.46
Control.SRR15539829;43;45;0.511627906976744;21;22;0.0116279069767442;0.488372093023256
Control.SRR15539829;50;45;0.58;21;29;0.08;0.42
Control.SRR15539829;50;45;0.4;30;20;0.1;0.4
Control.SRR15539829;51;45;0.490196078431373;26;25;0.00980392156862747;0.490196078431373
Control.SRR15539829;49;45;0.591836734693878;20;29;0.0918367346938775;0.408163265306122
Control.SRR15539829;40;45;0.675;13;27;0.175;0.325
Control.SRR15539829;51;45;0.450980392156863;28;23;0.0490196078431372;0.450980392156863
Control.SRR15539829;45;45;0.622222222222222;17;28;0.122222222222222;0.377777777777778
Control.SRR15539829;48;45;0.583333333333333;20;28;0.0833333333333334;0.416666666666667
Control.SRR15539829;52;45;0.5;26;26;0;0.5
Control.SRR15539829;42;45;0.523809523809524;20;22;0.0238095238095238;0.476190476190476
Control.SRR15539829;48;45;0.625;18;30;0.125;0.375
Control.SRR15539829;48;45;0.416666666666667;28;20;0.0833333333333333;0.416666666666667
Control.SRR15539829;48;45;0.5;24;24;0;0.5
Control.SRR15539829;47;45;0.574468085106383;20;27;0.074468085106383;0.425531914893617
Control.SRR15539829;49;45;0.510204081632653;24;25;0.0102040816326531;0.489795918367347
Control.SRR15539829;40;45;0.55;18;22;0.05;0.45
Control.SRR15539829;49;45;0.510204081632653;24;25;0.0102040816326531;0.489795918367347
Control.SRR15539829;46;45;0.456521739130435;25;21;0.0434782608695652;0.456521739130435
Control.SRR15539829;46;45;0.5;23;23;0;0.5
Control.SRR15539829;51;45;0.588235294117647;21;30;0.0882352941176471;0.411764705882353
Control.SRR15539829;43;45;0.581395348837209;18;25;0.0813953488372093;0.418604651162791
Control.SRR15539829;44;45;0.522727272727273;21;23;0.0227272727272727;0.477272727272727
Control.SRR15539829;52;45;0.596153846153846;21;31;0.0961538461538461;0.403846153846154
Control.SRR15539829;50;45;0.5;25;25;0;0.5
Control.SRR15539829;52;45;0.596153846153846;21;31;0.0961538461538461;0.403846153846154
Control.SRR15539829;47;45;0.446808510638298;26;21;0.0531914893617021;0.446808510638298
Control.SRR15539829;47;45;0.404255319148936;28;19;0.0957446808510639;0.404255319148936
Control.SRR15539829;49;45;0.489795918367347;25;24;0.0102040816326531;0.489795918367347
Control.SRR15539829;46;45;0.543478260869565;21;25;0.0434782608695652;0.456521739130435
Control.SRR15539829;48;45;0.458333333333333;26;22;0.0416666666666667;0.458333333333333
Control.SRR15539829;49;45;0.448979591836735;27;22;0.0510204081632653;0.448979591836735
Control.SRR15539829;47;45;0.48936170212766;24;23;0.0106382978723404;0.48936170212766
Control.SRR15539829;48;45;0.5;24;24;0;0.5
Control.SRR15539829;51;45;0.450980392156863;28;23;0.0490196078431372;0.450980392156863
Control.SRR15539829;48;45;0.416666666666667;28;20;0.0833333333333333;0.416666666666667
Control.SRR15539829;50;45;0.44;28;22;0.06;0.44
Control.SRR15539829;45;45;0.533333333333333;21;24;0.0333333333333333;0.466666666666667
Control.SRR15539829;49;45;0.571428571428571;21;28;0.0714285714285714;0.428571428571429
Control.SRR15539829;42;45;0.619047619047619;16;26;0.119047619047619;0.380952380952381
Control.SRR15539829;50;45;0.44;28;22;0.06;0.44
Control.SRR15539829;50;45;0.46;27;23;0.04;0.46
Control.SRR15539829;40;45;0.475;21;19;0.025;0.475
Control.SRR15539829;49;45;0.510204081632653;24;25;0.0102040816326531;0.489795918367347
Control.SRR15539829;48;45;0.479166666666667;25;23;0.0208333333333333;0.479166666666667
Control.SRR15539829;49;45;0.489795918367347;25;24;0.0102040816326531;0.489795918367347
Control.SRR15539829;54;45;0.425925925925926;31;23;0.0740740740740741;0.425925925925926
Control.SRR15539829;42;45;0.571428571428571;18;24;0.0714285714285714;0.428571428571429
Control.SRR15539829;45;45;0.377777777777778;28;17;0.122222222222222;0.377777777777778
Control.SRR15539829;49;45;0.489795918367347;25;24;0.0102040816326531;0.489795918367347
Control.SRR15539829;41;45;0.439024390243902;23;18;0.0609756097560976;0.439024390243902
Control.SRR15539829;51;45;0.450980392156863;28;23;0.0490196078431372;0.450980392156863
Control.SRR15539829;45;45;0.466666666666667;24;21;0.0333333333333333;0.466666666666667
Control.SRR15539829;49;45;0.489795918367347;25;24;0.0102040816326531;0.489795918367347
Control.SRR15539829;40;45;0.475;21;19;0.025;0.475
Control.SRR15539829;54;45;0.518518518518518;26;28;0.0185185185185185;0.481481481481481
Control.SRR15539829;52;45;0.5;26;26;0;0.5
Control.SRR15539829;45;45;0.4;27;18;0.1;0.4
Control.SRR15539829;41;45;0.585365853658537;17;24;0.0853658536585366;0.414634146341463
Control.SRR15539829;47;45;0.48936170212766;24;23;0.0106382978723404;0.48936170212766
Control.SRR15539829;40;45;0.625;15;25;0.125;0.375
Control.SRR15539829;46;45;0.608695652173913;18;28;0.108695652173913;0.391304347826087
Control.SRR15539829;46;45;0.391304347826087;28;18;0.108695652173913;0.391304347826087
Control.SRR15539829;46;45;0.521739130434783;22;24;0.0217391304347826;0.478260869565217
Control.SRR15539829;44;45;0.454545454545455;24;20;0.0454545454545455;0.454545454545455
Control.SRR15539829;47;45;0.425531914893617;27;20;0.074468085106383;0.425531914893617
Control.SRR15539829;46;45;0.565217391304348;20;26;0.0652173913043478;0.434782608695652
Control.SRR15539829;40;45;0.55;18;22;0.05;0.45
Control.SRR15539829;45;45;0.511111111111111;22;23;0.0111111111111111;0.488888888888889
Control.SRR15539829;49;45;0.612244897959184;19;30;0.112244897959184;0.387755102040816
Control.SRR15539829;40;45;0.525;19;21;0.025;0.475
Control.SRR15539829;50;45;0.44;28;22;0.06;0.44
Control.SRR15539829;48;45;0.416666666666667;28;20;0.0833333333333333;0.416666666666667
Control.SRR15539829;42;45;0.619047619047619;16;26;0.119047619047619;0.380952380952381
Control.SRR15539829;43;45;0.627906976744186;16;27;0.127906976744186;0.372093023255814
Control.SRR15539829;43;45;0.674418604651163;14;29;0.174418604651163;0.325581395348837
Control.SRR15539829;42;45;0.571428571428571;18;24;0.0714285714285714;0.428571428571429
Control.SRR15539829;50;45;0.4;30;20;0.1;0.4
Control.SRR15539829;52;45;0.384615384615385;32;20;0.115384615384615;0.384615384615385
Control.SRR15539829;45;45;0.533333333333333;21;24;0.0333333333333333;0.466666666666667
Control.SRR15539829;48;45;0.625;18;30;0.125;0.375
Control.SRR15539829;44;45;0.386363636363636;27;17;0.113636363636364;0.386363636363636
Control.SRR15539829;41;45;0.560975609756098;18;23;0.0609756097560976;0.439024390243902
Control.SRR15539829;50;45;0.56;22;28;0.0600000000000001;0.44
Control.SRR15539829;48;45;0.395833333333333;29;19;0.104166666666667;0.395833333333333
Control.SRR15539829;44;45;0.454545454545455;24;20;0.0454545454545455;0.454545454545455
Control.SRR15539829;42;45;0.452380952380952;23;19;0.0476190476190476;0.452380952380952
Control.SRR15539829;44;45;0.431818181818182;25;19;0.0681818181818182;0.431818181818182
Control.SRR15539829;52;45;0.730769230769231;14;38;0.230769230769231;0.269230769230769
Control.SRR15539829;52;45;0.403846153846154;31;21;0.0961538461538461;0.403846153846154
Control.SRR15539829;42;45;0.666666666666667;14;28;0.166666666666667;0.333333333333333
Control.SRR15539829;41;45;0.560975609756098;18;23;0.0609756097560976;0.439024390243902
Control.SRR15539829;50;45;0.5;25;25;0;0.5
Control.SRR15539829;42;45;0.476190476190476;22;20;0.0238095238095238;0.476190476190476
Control.SRR15539829;43;45;0.581395348837209;18;25;0.0813953488372093;0.418604651162791
Control.SRR15539829;46;45;0.521739130434783;22;24;0.0217391304347826;0.478260869565217
Control.SRR15539829;51;45;0.392156862745098;31;20;0.107843137254902;0.392156862745098
Control.SRR15539829;43;45;0.488372093023256;22;21;0.0116279069767442;0.488372093023256
Control.SRR15539829;45;45;0.444444444444444;25;20;0.0555555555555556;0.444444444444444
Control.SRR15539829;41;45;0.414634146341463;24;17;0.0853658536585366;0.414634146341463
Control.SRR15539829;49;45;0.530612244897959;23;26;0.0306122448979592;0.469387755102041
Control.SRR15539829;53;45;0.471698113207547;28;25;0.0283018867924528;0.471698113207547
Control.SRR15539829;52;45;0.519230769230769;25;27;0.0192307692307693;0.480769230769231
Control.SRR15539829;45;45;0.444444444444444;25;20;0.0555555555555556;0.444444444444444
Control.SRR15539829;49;45;0.551020408163265;22;27;0.0510204081632653;0.448979591836735
Control.SRR15539829;41;45;0.463414634146341;22;19;0.0365853658536585;0.463414634146341
Control.SRR15539829;41;45;0.463414634146341;22;19;0.0365853658536585;0.463414634146341
Control.SRR15539829;46;45;0.565217391304348;20;26;0.0652173913043478;0.434782608695652
Control.SRR15539829;45;45;0.622222222222222;17;28;0.122222222222222;0.377777777777778
Control.SRR15539829;47;45;0.531914893617021;22;25;0.0319148936170213;0.468085106382979
Control.SRR15539829;45;45;0.511111111111111;22;23;0.0111111111111111;0.488888888888889
Control.SRR15539829;47;45;0.48936170212766;24;23;0.0106382978723404;0.48936170212766
Control.SRR15539829;43;45;0.488372093023256;22;21;0.0116279069767442;0.488372093023256
Control.SRR15539829;47;45;0.48936170212766;24;23;0.0106382978723404;0.48936170212766
Control.SRR15539829;48;45;0.625;18;30;0.125;0.375
Control.SRR15539829;41;45;0.48780487804878;21;20;0.0121951219512195;0.48780487804878
Control.SRR15539829;47;45;0.446808510638298;26;21;0.0531914893617021;0.446808510638298
Control.SRR15539829;52;45;0.5;26;26;0;0.5
Control.SRR15539829;51;45;0.529411764705882;24;27;0.0294117647058824;0.470588235294118
Control.SRR15539829;44;45;0.568181818181818;19;25;0.0681818181818182;0.431818181818182
Control.SRR15539829;41;45;0.48780487804878;21;20;0.0121951219512195;0.48780487804878
Control.SRR15539829;50;45;0.38;31;19;0.12;0.38
Control.SRR15539829;49;45;0.489795918367347;25;24;0.0102040816326531;0.489795918367347
Control.SRR15539829;44;45;0.431818181818182;25;19;0.0681818181818182;0.431818181818182
Control.SRR15539829;41;45;0.463414634146341;22;19;0.0365853658536585;0.463414634146341
Control.SRR15539829;41;45;0.414634146341463;24;17;0.0853658536585366;0.414634146341463
Control.SRR15539829;43;45;0.581395348837209;18;25;0.0813953488372093;0.418604651162791
Control.SRR15539829;52;45;0.442307692307692;29;23;0.0576923076923077;0.442307692307692
Control.SRR15539829;49;45;0.653061224489796;17;32;0.153061224489796;0.346938775510204
Control.SRR15539829;51;45;0.588235294117647;21;30;0.0882352941176471;0.411764705882353
Control.SRR15539829;51;45;0.588235294117647;21;30;0.0882352941176471;0.411764705882353
Control.SRR15539829;42;45;0.547619047619048;19;23;0.0476190476190477;0.452380952380952
Control.SRR15539829;44;45;0.5;22;22;0;0.5
Control.SRR15539829;50;45;0.58;21;29;0.08;0.42
Control.SRR15539829;45;45;0.622222222222222;17;28;0.122222222222222;0.377777777777778
Control.SRR15539829;49;45;0.469387755102041;26;23;0.0306122448979592;0.469387755102041
Control.SRR15539829;41;45;0.51219512195122;20;21;0.0121951219512195;0.48780487804878
Control.SRR15539829;41;45;0.536585365853659;19;22;0.0365853658536586;0.463414634146341
Control.SRR15539829;45;45;0.488888888888889;23;22;0.0111111111111111;0.488888888888889
Control.SRR15539829;46;45;0.41304347826087;27;19;0.0869565217391304;0.41304347826087
Control.SRR15539829;41;45;0.585365853658537;17;24;0.0853658536585366;0.414634146341463
Control.SRR15539829;41;45;0.585365853658537;17;24;0.0853658536585366;0.414634146341463
Control.SRR15539829;40;45;0.525;19;21;0.025;0.475
Control.SRR15539829;47;45;0.531914893617021;22;25;0.0319148936170213;0.468085106382979
Control.SRR15539829;45;45;0.466666666666667;24;21;0.0333333333333333;0.466666666666667
Control.SRR15539829;50;45;0.42;29;21;0.08;0.42
Control.SRR15539829;45;45;0.444444444444444;25;20;0.0555555555555556;0.444444444444444
Control.SRR15539829;51;45;0.588235294117647;21;30;0.0882352941176471;0.411764705882353
Control.SRR15539829;53;45;0.490566037735849;27;26;0.00943396226415094;0.490566037735849
Control.SRR15539829;50;45;0.46;27;23;0.04;0.46
Control.SRR15539829;44;45;0.568181818181818;19;25;0.0681818181818182;0.431818181818182
Control.SRR15539829;48;45;0.5;24;24;0;0.5
Control.SRR15539829;48;45;0.5625;21;27;0.0625;0.4375
Control.SRR15539829;52;45;0.384615384615385;32;20;0.115384615384615;0.384615384615385
Control.SRR15539829;48;45;0.520833333333333;23;25;0.0208333333333334;0.479166666666667
Control.SRR15539829;46;45;0.478260869565217;24;22;0.0217391304347826;0.478260869565217
Control.SRR15539829;49;45;0.469387755102041;26;23;0.0306122448979592;0.469387755102041
Control.SRR15539829;52;45;0.442307692307692;29;23;0.0576923076923077;0.442307692307692
Control.SRR15539829;53;45;0.622641509433962;20;33;0.122641509433962;0.377358490566038
Control.SRR15539829;47;45;0.382978723404255;29;18;0.117021276595745;0.382978723404255
Control.SRR15539829;44;45;0.522727272727273;21;23;0.0227272727272727;0.477272727272727
Control.SRR15539829;48;45;0.583333333333333;20;28;0.0833333333333334;0.416666666666667
Control.SRR15539829;48;45;0.541666666666667;22;26;0.0416666666666666;0.458333333333333
Control.SRR15539829;48;45;0.604166666666667;19;29;0.104166666666667;0.395833333333333
Control.SRR15539829;52;45;0.576923076923077;22;30;0.0769230769230769;0.423076923076923
Control.SRR15539829;47;45;0.446808510638298;26;21;0.0531914893617021;0.446808510638298
Control.SRR15539829;47;45;0.468085106382979;25;22;0.0319148936170213;0.468085106382979
Control.SRR15539829;40;45;0.6;16;24;0.1;0.4
Control.SRR15539829;41;45;0.48780487804878;21;20;0.0121951219512195;0.48780487804878
Control.SRR15539829;43;45;0.534883720930233;20;23;0.0348837209302325;0.465116279069767
Control.SRR15539829;42;45;0.476190476190476;22;20;0.0238095238095238;0.476190476190476
Control.SRR15539829;50;45;0.52;24;26;0.02;0.48
Control.SRR15539829;40;45;0.45;22;18;0.05;0.45
Control.SRR15539829;50;45;0.5;25;25;0;0.5
Control.SRR15539829;49;45;0.469387755102041;26;23;0.0306122448979592;0.469387755102041
Control.SRR15539829;47;45;0.51063829787234;23;24;0.0106382978723404;0.48936170212766
Control.SRR15539829;50;45;0.5;25;25;0;0.5
Control.SRR15539829;46;45;0.391304347826087;28;18;0.108695652173913;0.391304347826087
Control.SRR15539829;52;45;0.423076923076923;30;22;0.0769230769230769;0.423076923076923
Control.SRR15539829;44;45;0.522727272727273;21;23;0.0227272727272727;0.477272727272727
Control.SRR15539829;45;45;0.488888888888889;23;22;0.0111111111111111;0.488888888888889
Control.SRR15539829;44;45;0.522727272727273;21;23;0.0227272727272727;0.477272727272727
Control.SRR15539829;47;45;0.51063829787234;23;24;0.0106382978723404;0.48936170212766
Control.SRR15539829;43;45;0.488372093023256;22;21;0.0116279069767442;0.488372093023256
Control.SRR15539829;44;45;0.545454545454545;20;24;0.0454545454545454;0.454545454545455
Control.SRR15539829;52;45;0.461538461538462;28;24;0.0384615384615384;0.461538461538462
Control.SRR15539829;48;45;0.4375;27;21;0.0625;0.4375
Control.SRR15539829;48;45;0.520833333333333;23;25;0.0208333333333334;0.479166666666667
Control.SRR15539829;45;45;0.577777777777778;19;26;0.0777777777777777;0.422222222222222
Control.SRR15539829;47;45;0.48936170212766;24;23;0.0106382978723404;0.48936170212766
Control.SRR15539829;48;45;0.395833333333333;29;19;0.104166666666667;0.395833333333333
Control.SRR15539829;49;45;0.530612244897959;23;26;0.0306122448979592;0.469387755102041
Control.SRR15539829;48;45;0.4375;27;21;0.0625;0.4375
Control.SRR15539829;47;45;0.553191489361702;21;26;0.0531914893617021;0.446808510638298
Control.SRR15539829;47;45;0.446808510638298;26;21;0.0531914893617021;0.446808510638298
Control.SRR15539829;40;45;0.475;21;19;0.025;0.475
Control.SRR15539829;53;45;0.452830188679245;29;24;0.0471698113207547;0.452830188679245
Control.SRR15539829;48;45;0.583333333333333;20;28;0.0833333333333334;0.416666666666667
Control.SRR15539829;49;45;0.408163265306122;29;20;0.0918367346938775;0.408163265306122
Control.SRR15539829;52;45;0.538461538461538;24;28;0.0384615384615384;0.461538461538462
Control.SRR15539829;52;45;0.480769230769231;27;25;0.0192307692307692;0.480769230769231
Control.SRR15539829;41;45;0.463414634146341;22;19;0.0365853658536585;0.463414634146341
Control.SRR15539829;49;45;0.387755102040816;30;19;0.112244897959184;0.387755102040816
Control.SRR15539829;52;45;0.538461538461538;24;28;0.0384615384615384;0.461538461538462
Control.SRR15539829;46;45;0.58695652173913;19;27;0.0869565217391305;0.41304347826087
Control.SRR15539829;45;45;0.488888888888889;23;22;0.0111111111111111;0.488888888888889
Control.SRR15539829;40;45;0.6;16;24;0.1;0.4
Control.SRR15539829;47;45;0.531914893617021;22;25;0.0319148936170213;0.468085106382979
Control.SRR15539829;46;45;0.543478260869565;21;25;0.0434782608695652;0.456521739130435
Control.SRR15539829;44;45;0.522727272727273;21;23;0.0227272727272727;0.477272727272727
Control.SRR15539829;42;45;0.523809523809524;20;22;0.0238095238095238;0.476190476190476
Control.SRR15539829;50;45;0.66;17;33;0.16;0.34
Control.SRR15539829;44;45;0.454545454545455;24;20;0.0454545454545455;0.454545454545455
Control.SRR15539829;41;45;0.48780487804878;21;20;0.0121951219512195;0.48780487804878
Control.SRR15539829;50;45;0.46;27;23;0.04;0.46
Control.SRR15539829;44;45;0.454545454545455;24;20;0.0454545454545455;0.454545454545455
Control.SRR15539829;44;45;0.477272727272727;23;21;0.0227272727272727;0.477272727272727
Control.SRR15539829;45;45;0.577777777777778;19;26;0.0777777777777777;0.422222222222222
Control.SRR15539829;42;45;0.380952380952381;26;16;0.119047619047619;0.380952380952381
Control.SRR15539829;40;45;0.5;20;20;0;0.5
Control.SRR15539829;47;45;0.446808510638298;26;21;0.0531914893617021;0.446808510638298
Control.SRR15539829;42;45;0.380952380952381;26;16;0.119047619047619;0.380952380952381
Control.SRR15539829;41;45;0.51219512195122;20;21;0.0121951219512195;0.48780487804878
Control.SRR15539829;51;45;0.431372549019608;29;22;0.0686274509803921;0.431372549019608
Control.SRR15539829;40;45;0.525;19;21;0.025;0.475
Control.SRR15539829;48;45;0.416666666666667;28;20;0.0833333333333333;0.416666666666667
Control.SRR15539829;49;45;0.469387755102041;26;23;0.0306122448979592;0.469387755102041
Control.SRR15539829;45;45;0.577777777777778;19;26;0.0777777777777777;0.422222222222222
Control.SRR15539829;41;45;0.414634146341463;24;17;0.0853658536585366;0.414634146341463
Control.SRR15539829;53;45;0.471698113207547;28;25;0.0283018867924528;0.471698113207547
Control.SRR15539829;43;45;0.441860465116279;24;19;0.0581395348837209;0.441860465116279
Control.SRR15539829;44;45;0.477272727272727;23;21;0.0227272727272727;0.477272727272727
Control.SRR15539829;45;45;0.488888888888889;23;22;0.0111111111111111;0.488888888888889
Control.SRR15539829;44;45;0.522727272727273;21;23;0.0227272727272727;0.477272727272727
Control.SRR15539829;47;45;0.425531914893617;27;20;0.074468085106383;0.425531914893617
Control.SRR15539829;49;45;0.489795918367347;25;24;0.0102040816326531;0.489795918367347
Control.SRR15539829;40;45;0.5;20;20;0;0.5
Control.SRR15539829;42;45;0.428571428571429;24;18;0.0714285714285715;0.428571428571429
Control.SRR15539829;48;45;0.5;24;24;0;0.5
Control.SRR15539829;43;45;0.581395348837209;18;25;0.0813953488372093;0.418604651162791
Control.SRR15539829;45;45;0.555555555555556;20;25;0.0555555555555556;0.444444444444444
Control.SRR15539829;43;45;0.465116279069767;23;20;0.0348837209302326;0.465116279069767
Control.SRR15539829;40;45;0.475;21;19;0.025;0.475
Control.SRR15539829;49;45;0.551020408163265;22;27;0.0510204081632653;0.448979591836735
Control.SRR15539829;42;45;0.571428571428571;18;24;0.0714285714285714;0.428571428571429
Control.SRR15539829;42;45;0.523809523809524;20;22;0.0238095238095238;0.476190476190476
Control.SRR15539829;47;45;0.468085106382979;25;22;0.0319148936170213;0.468085106382979
Control.SRR15539829;47;45;0.51063829787234;23;24;0.0106382978723404;0.48936170212766
Control.SRR15539829;44;45;0.522727272727273;21;23;0.0227272727272727;0.477272727272727
Control.SRR15539829;41;45;0.48780487804878;21;20;0.0121951219512195;0.48780487804878
Control.SRR15539829;48;45;0.5;24;24;0;0.5
Control.SRR15539829;49;45;0.489795918367347;25;24;0.0102040816326531;0.489795918367347
Control.SRR15539829;41;45;0.682926829268293;13;28;0.182926829268293;0.317073170731707
Control.SRR15539829;53;45;0.471698113207547;28;25;0.0283018867924528;0.471698113207547
Control.SRR15539829;40;45;0.6;16;24;0.1;0.4
Control.SRR15539829;53;45;0.490566037735849;27;26;0.00943396226415094;0.490566037735849
Control.SRR15539829;51;45;0.490196078431373;26;25;0.00980392156862747;0.490196078431373
Control.SRR15539829;41;45;0.439024390243902;23;18;0.0609756097560976;0.439024390243902
Control.SRR15539829;42;45;0.547619047619048;19;23;0.0476190476190477;0.452380952380952
Control.SRR15539829;42;45;0.523809523809524;20;22;0.0238095238095238;0.476190476190476
Control.SRR15539829;47;45;0.468085106382979;25;22;0.0319148936170213;0.468085106382979
Control.SRR15539829;46;45;0.456521739130435;25;21;0.0434782608695652;0.456521739130435
Control.SRR15539829;48;45;0.5;24;24;0;0.5
Control.SRR15539829;53;45;0.528301886792453;25;28;0.0283018867924528;0.471698113207547
Control.SRR15539829;49;45;0.612244897959184;19;30;0.112244897959184;0.387755102040816
Control.SRR15539829;43;45;0.604651162790698;17;26;0.104651162790698;0.395348837209302
Control.SRR15539829;46;45;0.5;23;23;0;0.5
Control.SRR15539829;41;45;0.51219512195122;20;21;0.0121951219512195;0.48780487804878
Control.SRR15539829;49;45;0.448979591836735;27;22;0.0510204081632653;0.448979591836735
Control.SRR15539829;40;45;0.425;23;17;0.075;0.425
Control.SRR15539829;42;45;0.357142857142857;27;15;0.142857142857143;0.357142857142857
Control.SRR15539829;42;45;0.523809523809524;20;22;0.0238095238095238;0.476190476190476
Control.SRR15539829;45;45;0.488888888888889;23;22;0.0111111111111111;0.488888888888889
Control.SRR15539829;41;45;0.609756097560976;16;25;0.109756097560976;0.390243902439024
Control.SRR15539829;45;45;0.377777777777778;28;17;0.122222222222222;0.377777777777778
Control.SRR15539829;42;45;0.547619047619048;19;23;0.0476190476190477;0.452380952380952
Control.SRR15539829;53;45;0.547169811320755;24;29;0.0471698113207547;0.452830188679245
Control.SRR15539829;45;45;0.577777777777778;19;26;0.0777777777777777;0.422222222222222
Control.SRR15539829;48;45;0.541666666666667;22;26;0.0416666666666666;0.458333333333333
Control.SRR15539829;49;45;0.448979591836735;27;22;0.0510204081632653;0.448979591836735
Control.SRR15539829;50;45;0.58;21;29;0.08;0.42
Control.SRR15539829;46;45;0.673913043478261;15;31;0.173913043478261;0.326086956521739
Control.SRR15539829;41;45;0.463414634146341;22;19;0.0365853658536585;0.463414634146341
Control.SRR15539829;40;45;0.35;26;14;0.15;0.35
Control.SRR15539829;48;45;0.645833333333333;17;31;0.145833333333333;0.354166666666667
Control.SRR15539829;52;45;0.538461538461538;24;28;0.0384615384615384;0.461538461538462
Control.SRR15539829;53;45;0.490566037735849;27;26;0.00943396226415094;0.490566037735849
Control.SRR15539829;42;45;0.476190476190476;22;20;0.0238095238095238;0.476190476190476
Control.SRR15539829;44;45;0.568181818181818;19;25;0.0681818181818182;0.431818181818182
Control.SRR15539829;44;45;0.431818181818182;25;19;0.0681818181818182;0.431818181818182
Control.SRR15539829;50;45;0.42;29;21;0.08;0.42
Control.SRR15539829;48;45;0.458333333333333;26;22;0.0416666666666667;0.458333333333333
Control.SRR15539829;45;45;0.511111111111111;22;23;0.0111111111111111;0.488888888888889
Control.SRR15539829;50;45;0.52;24;26;0.02;0.48
Control.SRR15539829;51;45;0.568627450980392;22;29;0.0686274509803921;0.431372549019608
Control.SRR15539829;48;45;0.5;24;24;0;0.5
Control.SRR15539829;43;45;0.558139534883721;19;24;0.0581395348837209;0.441860465116279
Control.SRR15539829;49;45;0.551020408163265;22;27;0.0510204081632653;0.448979591836735
Control.SRR15539829;49;45;0.408163265306122;29;20;0.0918367346938775;0.408163265306122
Control.SRR15539829;50;45;0.52;24;26;0.02;0.48
Control.SRR15539829;51;45;0.509803921568627;25;26;0.00980392156862742;0.490196078431373
Control.SRR15539829;45;45;0.533333333333333;21;24;0.0333333333333333;0.466666666666667
Control.SRR15539829;43;45;0.488372093023256;22;21;0.0116279069767442;0.488372093023256
Control.SRR15539829;51;45;0.627450980392157;19;32;0.127450980392157;0.372549019607843
Control.SRR15539829;51;45;0.411764705882353;30;21;0.0882352941176471;0.411764705882353
Control.SRR15539829;49;45;0.489795918367347;25;24;0.0102040816326531;0.489795918367347
Control.SRR15539829;41;45;0.439024390243902;23;18;0.0609756097560976;0.439024390243902
Control.SRR15539829;46;45;0.41304347826087;27;19;0.0869565217391304;0.41304347826087
Control.SRR15539829;46;45;0.565217391304348;20;26;0.0652173913043478;0.434782608695652
Control.SRR15539829;49;45;0.489795918367347;25;24;0.0102040816326531;0.489795918367347
Control.SRR15539829;44;45;0.522727272727273;21;23;0.0227272727272727;0.477272727272727
Control.SRR15539829;42;45;0.333333333333333;28;14;0.166666666666667;0.333333333333333
Control.SRR15539829;44;45;0.454545454545455;24;20;0.0454545454545455;0.454545454545455
Control.SRR15539829;45;45;0.466666666666667;24;21;0.0333333333333333;0.466666666666667
Control.SRR15539829;49;45;0.530612244897959;23;26;0.0306122448979592;0.469387755102041
Control.SRR15539829;42;45;0.428571428571429;24;18;0.0714285714285715;0.428571428571429
Control.SRR15539829;48;45;0.333333333333333;32;16;0.166666666666667;0.333333333333333
Control.SRR15539829;48;45;0.5625;21;27;0.0625;0.4375
Control.SRR15539829;51;45;0.529411764705882;24;27;0.0294117647058824;0.470588235294118
Control.SRR15539829;49;45;0.489795918367347;25;24;0.0102040816326531;0.489795918367347
Control.SRR15539829;51;45;0.431372549019608;29;22;0.0686274509803921;0.431372549019608
Control.SRR15539829;42;45;0.476190476190476;22;20;0.0238095238095238;0.476190476190476
Control.SRR15539829;46;45;0.58695652173913;19;27;0.0869565217391305;0.41304347826087
Control.SRR15539829;52;45;0.519230769230769;25;27;0.0192307692307693;0.480769230769231
Control.SRR15539829;52;45;0.384615384615385;32;20;0.115384615384615;0.384615384615385
Control.SRR15539829;50;45;0.48;26;24;0.02;0.48
Control.SRR15539829;45;45;0.511111111111111;22;23;0.0111111111111111;0.488888888888889
Control.SRR15539829;49;45;0.510204081632653;24;25;0.0102040816326531;0.489795918367347
Control.SRR15539829;48;45;0.395833333333333;29;19;0.104166666666667;0.395833333333333
Control.SRR15539829;49;45;0.469387755102041;26;23;0.0306122448979592;0.469387755102041
Control.SRR15539829;47;45;0.446808510638298;26;21;0.0531914893617021;0.446808510638298
Control.SRR15539829;45;45;0.422222222222222;26;19;0.0777777777777778;0.422222222222222
Control.SRR15539829;53;45;0.547169811320755;24;29;0.0471698113207547;0.452830188679245
Control.SRR15539829;51;45;0.411764705882353;30;21;0.0882352941176471;0.411764705882353
Control.SRR15539829;49;45;0.408163265306122;29;20;0.0918367346938775;0.408163265306122
Control.SRR15539829;43;45;0.488372093023256;22;21;0.0116279069767442;0.488372093023256
Control.SRR15539829;45;45;0.6;18;27;0.1;0.4
Control.SRR15539829;49;45;0.469387755102041;26;23;0.0306122448979592;0.469387755102041
Control.SRR15539829;40;45;0.525;19;21;0.025;0.475
Control.SRR15539829;46;45;0.5;23;23;0;0.5
Control.SRR15539829;52;45;0.538461538461538;24;28;0.0384615384615384;0.461538461538462
Control.SRR15539829;52;45;0.538461538461538;24;28;0.0384615384615384;0.461538461538462
Control.SRR15539829;50;45;0.48;26;24;0.02;0.48
Control.SRR15539829;45;45;0.377777777777778;28;17;0.122222222222222;0.377777777777778
Control.SRR15539829;43;45;0.395348837209302;26;17;0.104651162790698;0.395348837209302
Control.SRR15539829;45;45;0.488888888888889;23;22;0.0111111111111111;0.488888888888889
Control.SRR15539829;47;45;0.468085106382979;25;22;0.0319148936170213;0.468085106382979
Control.SRR15539829;52;45;0.596153846153846;21;31;0.0961538461538461;0.403846153846154
Control.SRR15539829;46;45;0.5;23;23;0;0.5
Control.SRR15539829;45;45;0.466666666666667;24;21;0.0333333333333333;0.466666666666667
Control.SRR15539829;49;45;0.510204081632653;24;25;0.0102040816326531;0.489795918367347
Control.SRR15539829;42;45;0.30952380952381;29;13;0.19047619047619;0.30952380952381
Control.SRR15539829;48;45;0.604166666666667;19;29;0.104166666666667;0.395833333333333
Control.SRR15539829;53;45;0.509433962264151;26;27;0.00943396226415094;0.490566037735849
Control.SRR15539829;46;45;0.391304347826087;28;18;0.108695652173913;0.391304347826087
Control.SRR15539829;51;45;0.411764705882353;30;21;0.0882352941176471;0.411764705882353
Control.SRR15539829;41;45;0.390243902439024;25;16;0.109756097560976;0.390243902439024
Control.SRR15539829;50;45;0.46;27;23;0.04;0.46
Control.SRR15539829;52;45;0.5;26;26;0;0.5
Control.SRR15539829;42;45;0.476190476190476;22;20;0.0238095238095238;0.476190476190476
Control.SRR15539829;47;45;0.446808510638298;26;21;0.0531914893617021;0.446808510638298
Control.SRR15539829;52;45;0.596153846153846;21;31;0.0961538461538461;0.403846153846154
Control.SRR15539829;40;45;0.5;20;20;0;0.5
Control.SRR15539829;43;45;0.511627906976744;21;22;0.0116279069767442;0.488372093023256
Control.SRR15539829;41;45;0.463414634146341;22;19;0.0365853658536585;0.463414634146341
Control.SRR15539829;48;45;0.604166666666667;19;29;0.104166666666667;0.395833333333333
Control.SRR15539829;40;45;0.45;22;18;0.05;0.45
Control.SRR15539829;46;45;0.543478260869565;21;25;0.0434782608695652;0.456521739130435
Control.SRR15539829;45;45;0.488888888888889;23;22;0.0111111111111111;0.488888888888889
Control.SRR15539829;45;45;0.511111111111111;22;23;0.0111111111111111;0.488888888888889
Control.SRR15539829;47;45;0.446808510638298;26;21;0.0531914893617021;0.446808510638298
Control.SRR15539829;47;45;0.574468085106383;20;27;0.074468085106383;0.425531914893617
Control.SRR15539829;52;45;0.615384615384615;20;32;0.115384615384615;0.384615384615385
Control.SRR15539829;52;45;0.519230769230769;25;27;0.0192307692307693;0.480769230769231
Control.SRR15539829;52;45;0.596153846153846;21;31;0.0961538461538461;0.403846153846154
Control.SRR15539829;46;45;0.347826086956522;30;16;0.152173913043478;0.347826086956522
Control.SRR15539829;48;45;0.5;24;24;0;0.5
Control.SRR15539829;45;45;0.511111111111111;22;23;0.0111111111111111;0.488888888888889
Control.SRR15539829;46;45;0.630434782608696;17;29;0.130434782608696;0.369565217391304
Control.SRR15539829;42;45;0.5;21;21;0;0.5
Control.SRR15539829;50;45;0.46;27;23;0.04;0.46
Control.SRR15539829;45;45;0.511111111111111;22;23;0.0111111111111111;0.488888888888889
Control.SRR15539829;43;45;0.441860465116279;24;19;0.0581395348837209;0.441860465116279
Control.SRR15539829;49;45;0.551020408163265;22;27;0.0510204081632653;0.448979591836735
Control.SRR15539829;49;45;0.591836734693878;20;29;0.0918367346938775;0.408163265306122
Control.SRR15539829;48;45;0.604166666666667;19;29;0.104166666666667;0.395833333333333
Control.SRR15539829;49;45;0.551020408163265;22;27;0.0510204081632653;0.448979591836735
Control.SRR15539829;48;45;0.395833333333333;29;19;0.104166666666667;0.395833333333333
Control.SRR15539829;50;45;0.5;25;25;0;0.5
Control.SRR15539829;44;45;0.522727272727273;21;23;0.0227272727272727;0.477272727272727
Control.SRR15539829;45;45;0.444444444444444;25;20;0.0555555555555556;0.444444444444444
Control.SRR15539829;53;45;0.471698113207547;28;25;0.0283018867924528;0.471698113207547
Control.SRR15539829;47;45;0.574468085106383;20;27;0.074468085106383;0.425531914893617
Control.SRR15539829;46;45;0.58695652173913;19;27;0.0869565217391305;0.41304347826087
Control.SRR15539829;44;45;0.545454545454545;20;24;0.0454545454545454;0.454545454545455
Control.SRR15539829;40;45;0.675;13;27;0.175;0.325
Control.SRR15539829;51;45;0.509803921568627;25;26;0.00980392156862742;0.490196078431373
Control.SRR15539829;53;45;0.433962264150943;30;23;0.0660377358490566;0.433962264150943
Control.SRR15539829;46;45;0.565217391304348;20;26;0.0652173913043478;0.434782608695652
Control.SRR15539829;42;45;0.428571428571429;24;18;0.0714285714285715;0.428571428571429
Control.SRR15539829;49;45;0.448979591836735;27;22;0.0510204081632653;0.448979591836735
Control.SRR15539829;50;45;0.42;29;21;0.08;0.42
Control.SRR15539829;49;45;0.448979591836735;27;22;0.0510204081632653;0.448979591836735
Control.SRR15539829;45;45;0.488888888888889;23;22;0.0111111111111111;0.488888888888889
Control.SRR15539829;47;45;0.446808510638298;26;21;0.0531914893617021;0.446808510638298
Control.SRR15539829;53;45;0.39622641509434;32;21;0.10377358490566;0.39622641509434
Control.SRR15539829;53;45;0.452830188679245;29;24;0.0471698113207547;0.452830188679245
Control.SRR15539829;45;45;0.533333333333333;21;24;0.0333333333333333;0.466666666666667
Control.SRR15539829;44;45;0.613636363636364;17;27;0.113636363636364;0.386363636363636
Control.SRR15539829;50;45;0.56;22;28;0.0600000000000001;0.44
Control.SRR15539829;53;45;0.471698113207547;28;25;0.0283018867924528;0.471698113207547
Control.SRR15539829;44;45;0.363636363636364;28;16;0.136363636363636;0.363636363636364
Control.SRR15539829;41;45;0.585365853658537;17;24;0.0853658536585366;0.414634146341463
Control.SRR15539829;48;45;0.479166666666667;25;23;0.0208333333333333;0.479166666666667
Control.SRR15539829;47;45;0.48936170212766;24;23;0.0106382978723404;0.48936170212766
Control.SRR15539829;53;45;0.584905660377358;22;31;0.0849056603773585;0.415094339622642
Control.SRR15539829;51;45;0.411764705882353;30;21;0.0882352941176471;0.411764705882353
Control.SRR15539829;50;45;0.52;24;26;0.02;0.48
Control.SRR15539829;42;45;0.452380952380952;23;19;0.0476190476190476;0.452380952380952
Control.SRR15539829;46;45;0.478260869565217;24;22;0.0217391304347826;0.478260869565217
Control.SRR15539829;45;45;0.555555555555556;20;25;0.0555555555555556;0.444444444444444
Control.SRR15539829;49;45;0.469387755102041;26;23;0.0306122448979592;0.469387755102041
Control.SRR15539829;41;45;0.51219512195122;20;21;0.0121951219512195;0.48780487804878
Control.SRR15539829;40;45;0.575;17;23;0.075;0.425
Control.SRR15539829;46;45;0.369565217391304;29;17;0.130434782608696;0.369565217391304
Control.SRR15539829;48;45;0.395833333333333;29;19;0.104166666666667;0.395833333333333
Control.SRR15539829;52;45;0.423076923076923;30;22;0.0769230769230769;0.423076923076923
Control.SRR15539829;41;45;0.439024390243902;23;18;0.0609756097560976;0.439024390243902
Control.SRR15539829;42;45;0.428571428571429;24;18;0.0714285714285715;0.428571428571429
Control.SRR15539829;41;45;0.439024390243902;23;18;0.0609756097560976;0.439024390243902
Control.SRR15539829;50;45;0.6;20;30;0.1;0.4
Control.SRR15539829;52;45;0.576923076923077;22;30;0.0769230769230769;0.423076923076923
Control.SRR15539829;52;45;0.596153846153846;21;31;0.0961538461538461;0.403846153846154
Control.SRR15539829;49;45;0.469387755102041;26;23;0.0306122448979592;0.469387755102041
Control.SRR15539829;49;45;0.571428571428571;21;28;0.0714285714285714;0.428571428571429
Control.SRR15539829;49;45;0.530612244897959;23;26;0.0306122448979592;0.469387755102041
Control.SRR15539829;49;45;0.448979591836735;27;22;0.0510204081632653;0.448979591836735
Control.SRR15539829;53;45;0.320754716981132;36;17;0.179245283018868;0.320754716981132
Control.SRR15539829;47;45;0.468085106382979;25;22;0.0319148936170213;0.468085106382979
Control.SRR15539829;52;45;0.461538461538462;28;24;0.0384615384615384;0.461538461538462
Control.SRR15539829;45;45;0.444444444444444;25;20;0.0555555555555556;0.444444444444444
Control.SRR15539829;42;45;0.571428571428571;18;24;0.0714285714285714;0.428571428571429
Control.SRR15539829;45;45;0.533333333333333;21;24;0.0333333333333333;0.466666666666667
Control.SRR15539829;48;45;0.395833333333333;29;19;0.104166666666667;0.395833333333333
Control.SRR15539829;40;45;0.425;23;17;0.075;0.425
Control.SRR15539829;45;45;0.577777777777778;19;26;0.0777777777777777;0.422222222222222
Control.SRR15539829;43;45;0.395348837209302;26;17;0.104651162790698;0.395348837209302
Control.SRR15539829;46;45;0.5;23;23;0;0.5
Control.SRR15539829;45;45;0.355555555555556;29;16;0.144444444444444;0.355555555555556
Control.SRR15539829;49;45;0.469387755102041;26;23;0.0306122448979592;0.469387755102041
Control.SRR15539829;42;45;0.5;21;21;0;0.5
Control.SRR15539829;41;45;0.365853658536585;26;15;0.134146341463415;0.365853658536585
Control.SRR15539829;49;45;0.673469387755102;16;33;0.173469387755102;0.326530612244898
Control.SRR15539829;44;45;0.409090909090909;26;18;0.0909090909090909;0.409090909090909
Control.SRR15539829;42;45;0.5;21;21;0;0.5
Control.SRR15539829;45;45;0.466666666666667;24;21;0.0333333333333333;0.466666666666667
Control.SRR15539829;43;45;0.348837209302326;28;15;0.151162790697674;0.348837209302326
Control.SRR15539829;47;45;0.553191489361702;21;26;0.0531914893617021;0.446808510638298
Control.SRR15539829;45;45;0.622222222222222;17;28;0.122222222222222;0.377777777777778
Control.SRR15539829;50;45;0.48;26;24;0.02;0.48
Control.SRR15539829;44;45;0.477272727272727;23;21;0.0227272727272727;0.477272727272727
Control.SRR15539829;43;45;0.488372093023256;22;21;0.0116279069767442;0.488372093023256
Control.SRR15539829;49;45;0.408163265306122;29;20;0.0918367346938775;0.408163265306122
Control.SRR15539829;44;45;0.477272727272727;23;21;0.0227272727272727;0.477272727272727
Control.SRR15539829;48;45;0.5625;21;27;0.0625;0.4375
Control.SRR15539829;40;45;0.475;21;19;0.025;0.475
Control.SRR15539829;51;45;0.529411764705882;24;27;0.0294117647058824;0.470588235294118
Control.SRR15539829;49;45;0.489795918367347;25;24;0.0102040816326531;0.489795918367347
Control.SRR15539829;46;45;0.391304347826087;28;18;0.108695652173913;0.391304347826087
Control.SRR15539829;53;45;0.377358490566038;33;20;0.122641509433962;0.377358490566038
Control.SRR15539829;47;45;0.531914893617021;22;25;0.0319148936170213;0.468085106382979
Control.SRR15539829;47;45;0.51063829787234;23;24;0.0106382978723404;0.48936170212766
Control.SRR15539829;50;45;0.5;25;25;0;0.5
Control.SRR15539829;50;45;0.44;28;22;0.06;0.44
Control.SRR15539829;51;45;0.490196078431373;26;25;0.00980392156862747;0.490196078431373
Control.SRR15539829;47;45;0.531914893617021;22;25;0.0319148936170213;0.468085106382979
Control.SRR15539829;53;45;0.377358490566038;33;20;0.122641509433962;0.377358490566038
Control.SRR15539829;49;45;0.489795918367347;25;24;0.0102040816326531;0.489795918367347
Control.SRR15539829;40;45;0.45;22;18;0.05;0.45
Control.SRR15539829;46;45;0.565217391304348;20;26;0.0652173913043478;0.434782608695652
Control.SRR15539829;47;45;0.404255319148936;28;19;0.0957446808510639;0.404255319148936
Control.SRR15539829;53;45;0.509433962264151;26;27;0.00943396226415094;0.490566037735849
Control.SRR15539829;47;45;0.48936170212766;24;23;0.0106382978723404;0.48936170212766
Control.SRR15539829;46;45;0.456521739130435;25;21;0.0434782608695652;0.456521739130435
Control.SRR15539829;48;45;0.375;30;18;0.125;0.375
Control.SRR15539829;50;45;0.58;21;29;0.08;0.42
Control.SRR15539829;43;45;0.511627906976744;21;22;0.0116279069767442;0.488372093023256
Control.SRR15539829;47;45;0.468085106382979;25;22;0.0319148936170213;0.468085106382979
Control.SRR15539829;41;45;0.634146341463415;15;26;0.134146341463415;0.365853658536585
Control.SRR15539829;45;45;0.311111111111111;31;14;0.188888888888889;0.311111111111111
Control.SRR15539829;43;45;0.581395348837209;18;25;0.0813953488372093;0.418604651162791
Control.SRR15539829;48;45;0.583333333333333;20;28;0.0833333333333334;0.416666666666667
Control.SRR15539829;51;45;0.568627450980392;22;29;0.0686274509803921;0.431372549019608
Control.SRR15539829;53;45;0.509433962264151;26;27;0.00943396226415094;0.490566037735849
Control.SRR15539829;51;45;0.627450980392157;19;32;0.127450980392157;0.372549019607843
Control.SRR15539829;50;45;0.42;29;21;0.08;0.42
Control.SRR15539829;51;45;0.588235294117647;21;30;0.0882352941176471;0.411764705882353
Control.SRR15539829;49;45;0.448979591836735;27;22;0.0510204081632653;0.448979591836735
Control.SRR15539829;43;45;0.488372093023256;22;21;0.0116279069767442;0.488372093023256
Control.SRR15539829;41;45;0.51219512195122;20;21;0.0121951219512195;0.48780487804878
Control.SRR15539829;46;45;0.58695652173913;19;27;0.0869565217391305;0.41304347826087
Control.SRR15539829;40;45;0.425;23;17;0.075;0.425
Control.SRR15539829;47;45;0.340425531914894;31;16;0.159574468085106;0.340425531914894
Control.SRR15539829;42;45;0.333333333333333;28;14;0.166666666666667;0.333333333333333
Control.SRR15539829;44;45;0.454545454545455;24;20;0.0454545454545455;0.454545454545455
Control.SRR15539829;44;45;0.477272727272727;23;21;0.0227272727272727;0.477272727272727
Control.SRR15539829;49;45;0.489795918367347;25;24;0.0102040816326531;0.489795918367347
Control.SRR15539829;40;45;0.525;19;21;0.025;0.475
Control.SRR15539829;42;45;0.5;21;21;0;0.5
Control.SRR15539829;44;45;0.431818181818182;25;19;0.0681818181818182;0.431818181818182
Control.SRR15539829;42;45;0.523809523809524;20;22;0.0238095238095238;0.476190476190476
Control.SRR15539829;40;45;0.45;22;18;0.05;0.45
Control.SRR15539829;40;45;0.575;17;23;0.075;0.425
Control.SRR15539829;40;45;0.5;20;20;0;0.5
Control.SRR15539829;49;45;0.612244897959184;19;30;0.112244897959184;0.387755102040816
Control.SRR15539829;48;45;0.541666666666667;22;26;0.0416666666666666;0.458333333333333
Control.SRR15539829;52;45;0.461538461538462;28;24;0.0384615384615384;0.461538461538462
Control.SRR15539829;48;45;0.583333333333333;20;28;0.0833333333333334;0.416666666666667
Control.SRR15539829;46;45;0.478260869565217;24;22;0.0217391304347826;0.478260869565217
Control.SRR15539829;48;45;0.541666666666667;22;26;0.0416666666666666;0.458333333333333
Control.SRR15539829;47;45;0.468085106382979;25;22;0.0319148936170213;0.468085106382979
Control.SRR15539829;49;45;0.469387755102041;26;23;0.0306122448979592;0.469387755102041
Control.SRR15539829;45;45;0.488888888888889;23;22;0.0111111111111111;0.488888888888889
Control.SRR15539829;52;45;0.538461538461538;24;28;0.0384615384615384;0.461538461538462
Control.SRR15539829;44;45;0.477272727272727;23;21;0.0227272727272727;0.477272727272727
Control.SRR15539829;40;45;0.5;20;20;0;0.5
Control.SRR15539829;49;45;0.571428571428571;21;28;0.0714285714285714;0.428571428571429
Control.SRR15539829;51;45;0.450980392156863;28;23;0.0490196078431372;0.450980392156863
Control.SRR15539829;51;45;0.450980392156863;28;23;0.0490196078431372;0.450980392156863
Control.SRR15539829;50;45;0.38;31;19;0.12;0.38
Control.SRR15539829;41;45;0.48780487804878;21;20;0.0121951219512195;0.48780487804878
Control.SRR15539829;44;45;0.477272727272727;23;21;0.0227272727272727;0.477272727272727
Control.SRR15539829;44;45;0.522727272727273;21;23;0.0227272727272727;0.477272727272727
Control.SRR15539829;42;45;0.452380952380952;23;19;0.0476190476190476;0.452380952380952
Control.SRR15539829;51;45;0.529411764705882;24;27;0.0294117647058824;0.470588235294118
Control.SRR15539829;44;45;0.477272727272727;23;21;0.0227272727272727;0.477272727272727
Control.SRR15539829;45;45;0.644444444444444;16;29;0.144444444444444;0.355555555555556
Control.SRR15539829;51;45;0.490196078431373;26;25;0.00980392156862747;0.490196078431373
Control.SRR15539829;47;45;0.468085106382979;25;22;0.0319148936170213;0.468085106382979
Control.SRR15539829;49;45;0.469387755102041;26;23;0.0306122448979592;0.469387755102041
Control.SRR15539829;47;45;0.340425531914894;31;16;0.159574468085106;0.340425531914894
Control.SRR15539829;49;45;0.510204081632653;24;25;0.0102040816326531;0.489795918367347
Control.SRR15539829;49;45;0.387755102040816;30;19;0.112244897959184;0.387755102040816
Control.SRR15539829;44;45;0.431818181818182;25;19;0.0681818181818182;0.431818181818182
Control.SRR15539829;51;45;0.509803921568627;25;26;0.00980392156862742;0.490196078431373
Control.SRR15539829;49;45;0.571428571428571;21;28;0.0714285714285714;0.428571428571429
Control.SRR15539829;49;45;0.387755102040816;30;19;0.112244897959184;0.387755102040816
Control.SRR15539829;49;45;0.489795918367347;25;24;0.0102040816326531;0.489795918367347
Control.SRR15539829;47;45;0.531914893617021;22;25;0.0319148936170213;0.468085106382979
Control.SRR15539829;42;45;0.380952380952381;26;16;0.119047619047619;0.380952380952381
Control.SRR15539829;40;45;0.525;19;21;0.025;0.475
Control.SRR15539829;43;45;0.395348837209302;26;17;0.104651162790698;0.395348837209302
Control.SRR15539829;47;45;0.574468085106383;20;27;0.074468085106383;0.425531914893617
Control.SRR15539829;43;45;0.27906976744186;31;12;0.22093023255814;0.27906976744186
Control.SRR15539829;43;45;0.534883720930233;20;23;0.0348837209302325;0.465116279069767
Control.SRR15539829;40;45;0.525;19;21;0.025;0.475
Control.SRR15539829;49;45;0.469387755102041;26;23;0.0306122448979592;0.469387755102041
Control.SRR15539829;52;45;0.576923076923077;22;30;0.0769230769230769;0.423076923076923
Control.SRR15539829;52;45;0.480769230769231;27;25;0.0192307692307692;0.480769230769231
Control.SRR15539829;46;45;0.434782608695652;26;20;0.0652173913043478;0.434782608695652
Control.SRR15539829;52;45;0.461538461538462;28;24;0.0384615384615384;0.461538461538462
Control.SRR15539829;49;45;0.489795918367347;25;24;0.0102040816326531;0.489795918367347
Control.SRR15539829;51;45;0.549019607843137;23;28;0.0490196078431373;0.450980392156863
Control.SRR15539829;50;45;0.44;28;22;0.06;0.44
Control.SRR15539829;50;45;0.66;17;33;0.16;0.34
Control.SRR15539829;41;45;0.560975609756098;18;23;0.0609756097560976;0.439024390243902
Control.SRR15539829;49;45;0.571428571428571;21;28;0.0714285714285714;0.428571428571429
Control.SRR15539829;48;45;0.5;24;24;0;0.5
Control.SRR15539829;45;45;0.466666666666667;24;21;0.0333333333333333;0.466666666666667
Control.SRR15539829;43;45;0.348837209302326;28;15;0.151162790697674;0.348837209302326
Control.SRR15539829;44;45;0.5;22;22;0;0.5
Control.SRR15539829;47;45;0.553191489361702;21;26;0.0531914893617021;0.446808510638298
Control.SRR15539829;46;45;0.347826086956522;30;16;0.152173913043478;0.347826086956522
Control.SRR15539829;45;45;0.488888888888889;23;22;0.0111111111111111;0.488888888888889
Control.SRR15539829;47;45;0.51063829787234;23;24;0.0106382978723404;0.48936170212766
Control.SRR15539829;45;45;0.444444444444444;25;20;0.0555555555555556;0.444444444444444
Control.SRR15539829;47;45;0.553191489361702;21;26;0.0531914893617021;0.446808510638298
Control.SRR15539829;41;45;0.439024390243902;23;18;0.0609756097560976;0.439024390243902
Control.SRR15539829;52;45;0.615384615384615;20;32;0.115384615384615;0.384615384615385
Control.SRR15539829;48;45;0.4375;27;21;0.0625;0.4375
Control.SRR15539829;51;45;0.529411764705882;24;27;0.0294117647058824;0.470588235294118
Control.SRR15539829;42;45;0.595238095238095;17;25;0.0952380952380952;0.404761904761905
Control.SRR15539829;41;45;0.414634146341463;24;17;0.0853658536585366;0.414634146341463
Control.SRR15539829;42;45;0.571428571428571;18;24;0.0714285714285714;0.428571428571429
Control.SRR15539829;50;45;0.56;22;28;0.0600000000000001;0.44
Control.SRR15539829;47;45;0.531914893617021;22;25;0.0319148936170213;0.468085106382979
Control.SRR15539829;49;45;0.448979591836735;27;22;0.0510204081632653;0.448979591836735
Control.SRR15539829;41;45;0.51219512195122;20;21;0.0121951219512195;0.48780487804878
Control.SRR15539829;49;45;0.448979591836735;27;22;0.0510204081632653;0.448979591836735
Control.SRR15539829;46;45;0.347826086956522;30;16;0.152173913043478;0.347826086956522
Control.SRR15539829;47;45;0.468085106382979;25;22;0.0319148936170213;0.468085106382979
Control.SRR15539829;50;45;0.48;26;24;0.02;0.48
Control.SRR15539829;46;45;0.478260869565217;24;22;0.0217391304347826;0.478260869565217
Control.SRR15539829;49;45;0.448979591836735;27;22;0.0510204081632653;0.448979591836735
Control.SRR15539829;48;45;0.5;24;24;0;0.5
Control.SRR15539829;48;45;0.458333333333333;26;22;0.0416666666666667;0.458333333333333
Control.SRR15539829;51;45;0.470588235294118;27;24;0.0294117647058824;0.470588235294118
Control.SRR15539829;46;45;0.434782608695652;26;20;0.0652173913043478;0.434782608695652
Control.SRR15539829;45;45;0.533333333333333;21;24;0.0333333333333333;0.466666666666667
Control.SRR15539829;47;45;0.51063829787234;23;24;0.0106382978723404;0.48936170212766
Control.SRR15539829;48;45;0.541666666666667;22;26;0.0416666666666666;0.458333333333333
Control.SRR15539829;48;45;0.333333333333333;32;16;0.166666666666667;0.333333333333333
Control.SRR15539829;49;45;0.510204081632653;24;25;0.0102040816326531;0.489795918367347
Control.SRR15539829;50;45;0.44;28;22;0.06;0.44
Control.SRR15539829;40;45;0.425;23;17;0.075;0.425
Control.SRR15539829;48;45;0.479166666666667;25;23;0.0208333333333333;0.479166666666667
Control.SRR15539829;49;45;0.448979591836735;27;22;0.0510204081632653;0.448979591836735
Control.SRR15539829;51;45;0.529411764705882;24;27;0.0294117647058824;0.470588235294118
Control.SRR15539829;47;45;0.595744680851064;19;28;0.0957446808510638;0.404255319148936
Control.SRR15539829;41;45;0.51219512195122;20;21;0.0121951219512195;0.48780487804878
Control.SRR15539829;43;45;0.488372093023256;22;21;0.0116279069767442;0.488372093023256
Control.SRR15539829;45;45;0.4;27;18;0.1;0.4
Control.SRR15539829;52;45;0.480769230769231;27;25;0.0192307692307692;0.480769230769231
Control.SRR15539829;46;45;0.41304347826087;27;19;0.0869565217391304;0.41304347826087
Control.SRR15539829;46;45;0.456521739130435;25;21;0.0434782608695652;0.456521739130435
Control.SRR15539829;44;45;0.431818181818182;25;19;0.0681818181818182;0.431818181818182
Control.SRR15539829;52;45;0.384615384615385;32;20;0.115384615384615;0.384615384615385
Control.SRR15539829;50;45;0.44;28;22;0.06;0.44
Control.SRR15539829;50;45;0.58;21;29;0.08;0.42
Control.SRR15539829;50;45;0.44;28;22;0.06;0.44
Control.SRR15539829;47;45;0.404255319148936;28;19;0.0957446808510639;0.404255319148936
Control.SRR15539829;50;45;0.44;28;22;0.06;0.44
Control.SRR15539829;42;45;0.452380952380952;23;19;0.0476190476190476;0.452380952380952
Control.SRR15539829;42;45;0.5;21;21;0;0.5
Control.SRR15539829;53;45;0.566037735849057;23;30;0.0660377358490566;0.433962264150943
Control.SRR15539829;44;45;0.522727272727273;21;23;0.0227272727272727;0.477272727272727
Control.SRR15539829;44;45;0.522727272727273;21;23;0.0227272727272727;0.477272727272727
Control.SRR15539829;41;45;0.51219512195122;20;21;0.0121951219512195;0.48780487804878
Control.SRR15539829;45;45;0.355555555555556;29;16;0.144444444444444;0.355555555555556
Control.SRR15539829;42;45;0.428571428571429;24;18;0.0714285714285715;0.428571428571429
Control.SRR15539829;44;45;0.590909090909091;18;26;0.0909090909090909;0.409090909090909
Control.SRR15539829;45;45;0.444444444444444;25;20;0.0555555555555556;0.444444444444444
Control.SRR15539829;52;45;0.480769230769231;27;25;0.0192307692307692;0.480769230769231
Control.SRR15539829;41;45;0.48780487804878;21;20;0.0121951219512195;0.48780487804878
Control.SRR15539829;51;45;0.509803921568627;25;26;0.00980392156862742;0.490196078431373
Control.SRR15539829;41;45;0.439024390243902;23;18;0.0609756097560976;0.439024390243902
Control.SRR15539829;45;45;0.577777777777778;19;26;0.0777777777777777;0.422222222222222
Control.SRR15539829;49;45;0.428571428571429;28;21;0.0714285714285715;0.428571428571429
Control.SRR15539829;47;45;0.404255319148936;28;19;0.0957446808510639;0.404255319148936
Control.SRR15539829;48;45;0.479166666666667;25;23;0.0208333333333333;0.479166666666667
Control.SRR15539829;42;45;0.523809523809524;20;22;0.0238095238095238;0.476190476190476
Control.SRR15539829;41;45;0.51219512195122;20;21;0.0121951219512195;0.48780487804878
Control.SRR15539829;52;45;0.442307692307692;29;23;0.0576923076923077;0.442307692307692
Control.SRR15539829;50;45;0.48;26;24;0.02;0.48
Control.SRR15539829;48;45;0.541666666666667;22;26;0.0416666666666666;0.458333333333333
Control.SRR15539829;49;45;0.510204081632653;24;25;0.0102040816326531;0.489795918367347
Control.SRR15539829;45;45;0.511111111111111;22;23;0.0111111111111111;0.488888888888889
Control.SRR15539829;41;45;0.365853658536585;26;15;0.134146341463415;0.365853658536585
Control.SRR15539829;48;45;0.458333333333333;26;22;0.0416666666666667;0.458333333333333
Control.SRR15539829;42;45;0.69047619047619;13;29;0.19047619047619;0.30952380952381
Control.SRR15539829;44;45;0.454545454545455;24;20;0.0454545454545455;0.454545454545455
Control.SRR15539829;47;45;0.702127659574468;14;33;0.202127659574468;0.297872340425532
Control.SRR15539829;45;45;0.6;18;27;0.1;0.4
Control.SRR15539829;53;45;0.415094339622642;31;22;0.0849056603773585;0.415094339622642
Control.SRR15539829;41;45;0.463414634146341;22;19;0.0365853658536585;0.463414634146341
Control.SRR15539829;43;45;0.558139534883721;19;24;0.0581395348837209;0.441860465116279
Control.SRR15539829;50;45;0.46;27;23;0.04;0.46
Control.SRR15539829;40;45;0.625;15;25;0.125;0.375
Control.SRR15539829;47;45;0.638297872340426;17;30;0.138297872340426;0.361702127659574
Control.SRR15539829;42;45;0.523809523809524;20;22;0.0238095238095238;0.476190476190476
Control.SRR15539829;41;45;0.365853658536585;26;15;0.134146341463415;0.365853658536585
Control.SRR15539829;40;45;0.525;19;21;0.025;0.475
Control.SRR15539829;42;45;0.476190476190476;22;20;0.0238095238095238;0.476190476190476
Control.SRR15539829;47;45;0.51063829787234;23;24;0.0106382978723404;0.48936170212766
Control.SRR15539829;49;45;0.551020408163265;22;27;0.0510204081632653;0.448979591836735
Control.SRR15539829;49;45;0.571428571428571;21;28;0.0714285714285714;0.428571428571429
Control.SRR15539829;46;45;0.565217391304348;20;26;0.0652173913043478;0.434782608695652
Control.SRR15539829;45;45;0.533333333333333;21;24;0.0333333333333333;0.466666666666667
Control.SRR15539829;46;45;0.58695652173913;19;27;0.0869565217391305;0.41304347826087
Control.SRR15539829;53;45;0.490566037735849;27;26;0.00943396226415094;0.490566037735849
Control.SRR15539829;51;45;0.450980392156863;28;23;0.0490196078431372;0.450980392156863
Control.SRR15539829;45;45;0.422222222222222;26;19;0.0777777777777778;0.422222222222222
Control.SRR15539829;53;45;0.471698113207547;28;25;0.0283018867924528;0.471698113207547
Control.SRR15539829;52;45;0.480769230769231;27;25;0.0192307692307692;0.480769230769231
Control.SRR15539829;49;45;0.408163265306122;29;20;0.0918367346938775;0.408163265306122
Control.SRR15539829;45;45;0.511111111111111;22;23;0.0111111111111111;0.488888888888889
Control.SRR15539829;42;45;0.571428571428571;18;24;0.0714285714285714;0.428571428571429
Control.SRR15539829;50;45;0.54;23;27;0.04;0.46
Control.SRR15539829;50;45;0.5;25;25;0;0.5
Control.SRR15539829;45;45;0.577777777777778;19;26;0.0777777777777777;0.422222222222222
Control.SRR15539829;51;45;0.490196078431373;26;25;0.00980392156862747;0.490196078431373
Control.SRR15539829;48;45;0.5625;21;27;0.0625;0.4375
Control.SRR15539829;50;45;0.46;27;23;0.04;0.46
Control.SRR15539829;47;45;0.48936170212766;24;23;0.0106382978723404;0.48936170212766
Control.SRR15539829;52;45;0.538461538461538;24;28;0.0384615384615384;0.461538461538462
Control.SRR15539829;46;45;0.565217391304348;20;26;0.0652173913043478;0.434782608695652
Control.SRR15539829;41;45;0.51219512195122;20;21;0.0121951219512195;0.48780487804878
Control.SRR15539829;44;45;0.454545454545455;24;20;0.0454545454545455;0.454545454545455
Control.SRR15539829;46;45;0.543478260869565;21;25;0.0434782608695652;0.456521739130435
Control.SRR15539829;43;45;0.465116279069767;23;20;0.0348837209302326;0.465116279069767
Control.SRR15539829;47;45;0.382978723404255;29;18;0.117021276595745;0.382978723404255
Control.SRR15539829;51;45;0.470588235294118;27;24;0.0294117647058824;0.470588235294118
Control.SRR15539829;49;45;0.612244897959184;19;30;0.112244897959184;0.387755102040816
Control.SRR15539829;43;45;0.465116279069767;23;20;0.0348837209302326;0.465116279069767
Control.SRR15539829;43;45;0.441860465116279;24;19;0.0581395348837209;0.441860465116279
Control.SRR15539829;42;45;0.428571428571429;24;18;0.0714285714285715;0.428571428571429
Control.SRR15539829;44;45;0.386363636363636;27;17;0.113636363636364;0.386363636363636
Control.SRR15539829;52;45;0.615384615384615;20;32;0.115384615384615;0.384615384615385
Control.SRR15539829;41;45;0.536585365853659;19;22;0.0365853658536586;0.463414634146341
Control.SRR15539829;43;45;0.558139534883721;19;24;0.0581395348837209;0.441860465116279
Control.SRR15539829;50;45;0.64;18;32;0.14;0.36
Control.SRR15539829;44;45;0.590909090909091;18;26;0.0909090909090909;0.409090909090909
Control.SRR15539829;42;45;0.595238095238095;17;25;0.0952380952380952;0.404761904761905
Control.SRR15539829;45;45;0.488888888888889;23;22;0.0111111111111111;0.488888888888889
Control.SRR15539829;42;45;0.357142857142857;27;15;0.142857142857143;0.357142857142857
Control.SRR15539829;43;45;0.488372093023256;22;21;0.0116279069767442;0.488372093023256
Control.SRR15539829;45;45;0.422222222222222;26;19;0.0777777777777778;0.422222222222222
Control.SRR15539829;44;45;0.545454545454545;20;24;0.0454545454545454;0.454545454545455
Control.SRR15539829;48;45;0.520833333333333;23;25;0.0208333333333334;0.479166666666667
Control.SRR15539829;52;45;0.423076923076923;30;22;0.0769230769230769;0.423076923076923
Control.SRR15539829;49;45;0.571428571428571;21;28;0.0714285714285714;0.428571428571429
Control.SRR15539829;52;45;0.442307692307692;29;23;0.0576923076923077;0.442307692307692
Control.SRR15539829;46;45;0.434782608695652;26;20;0.0652173913043478;0.434782608695652
Control.SRR15539829;43;45;0.465116279069767;23;20;0.0348837209302326;0.465116279069767
Control.SRR15539829;43;45;0.581395348837209;18;25;0.0813953488372093;0.418604651162791
Control.SRR15539829;50;45;0.58;21;29;0.08;0.42
Control.SRR15539829;42;45;0.69047619047619;13;29;0.19047619047619;0.30952380952381
Control.SRR15539829;40;45;0.45;22;18;0.05;0.45
Control.SRR15539829;42;45;0.452380952380952;23;19;0.0476190476190476;0.452380952380952
Control.SRR15539829;49;45;0.489795918367347;25;24;0.0102040816326531;0.489795918367347
Control.SRR15539829;47;45;0.595744680851064;19;28;0.0957446808510638;0.404255319148936
Control.SRR15539829;52;45;0.461538461538462;28;24;0.0384615384615384;0.461538461538462
Control.SRR15539829;45;45;0.355555555555556;29;16;0.144444444444444;0.355555555555556
Control.SRR15539829;42;45;0.523809523809524;20;22;0.0238095238095238;0.476190476190476
Control.SRR15539829;43;45;0.511627906976744;21;22;0.0116279069767442;0.488372093023256
Control.SRR15539829;47;45;0.531914893617021;22;25;0.0319148936170213;0.468085106382979
Control.SRR15539829;48;45;0.541666666666667;22;26;0.0416666666666666;0.458333333333333
Control.SRR15539829;41;45;0.560975609756098;18;23;0.0609756097560976;0.439024390243902
Control.SRR15539829;53;45;0.60377358490566;21;32;0.10377358490566;0.39622641509434
Control.SRR15539829;49;45;0.510204081632653;24;25;0.0102040816326531;0.489795918367347
Control.SRR15539829;46;45;0.5;23;23;0;0.5
Control.SRR15539829;53;45;0.509433962264151;26;27;0.00943396226415094;0.490566037735849
Control.SRR15539829;41;45;0.609756097560976;16;25;0.109756097560976;0.390243902439024
Control.SRR15539829;43;45;0.465116279069767;23;20;0.0348837209302326;0.465116279069767
Control.SRR15539829;50;45;0.62;19;31;0.12;0.38
Control.SRR15539829;43;45;0.627906976744186;16;27;0.127906976744186;0.372093023255814
Control.SRR15539829;40;45;0.525;19;21;0.025;0.475
Control.SRR15539829;45;45;0.644444444444444;16;29;0.144444444444444;0.355555555555556
Control.SRR15539829;44;45;0.5;22;22;0;0.5
Control.SRR15539829;48;45;0.666666666666667;16;32;0.166666666666667;0.333333333333333
Control.SRR15539829;49;45;0.469387755102041;26;23;0.0306122448979592;0.469387755102041
Control.SRR15539829;53;45;0.528301886792453;25;28;0.0283018867924528;0.471698113207547
Control.SRR15539829;43;45;0.395348837209302;26;17;0.104651162790698;0.395348837209302
Control.SRR15539829;53;45;0.509433962264151;26;27;0.00943396226415094;0.490566037735849
Control.SRR15539829;41;45;0.609756097560976;16;25;0.109756097560976;0.390243902439024
Control.SRR15539829;42;45;0.595238095238095;17;25;0.0952380952380952;0.404761904761905
Control.SRR15539829;48;45;0.354166666666667;31;17;0.145833333333333;0.354166666666667
Control.SRR15539829;46;45;0.434782608695652;26;20;0.0652173913043478;0.434782608695652
Control.SRR15539829;43;45;0.465116279069767;23;20;0.0348837209302326;0.465116279069767
Control.SRR15539829;42;45;0.523809523809524;20;22;0.0238095238095238;0.476190476190476
Control.SRR15539829;43;45;0.511627906976744;21;22;0.0116279069767442;0.488372093023256
Control.SRR15539829;41;45;0.439024390243902;23;18;0.0609756097560976;0.439024390243902
Control.SRR15539829;47;45;0.446808510638298;26;21;0.0531914893617021;0.446808510638298
Control.SRR15539829;40;45;0.6;16;24;0.1;0.4
Control.SRR15539829;43;45;0.441860465116279;24;19;0.0581395348837209;0.441860465116279
Control.SRR15539829;43;45;0.627906976744186;16;27;0.127906976744186;0.372093023255814
Control.SRR15539829;43;45;0.511627906976744;21;22;0.0116279069767442;0.488372093023256
Control.SRR15539829;44;45;0.568181818181818;19;25;0.0681818181818182;0.431818181818182
Control.SRR15539829;40;45;0.425;23;17;0.075;0.425
Control.SRR15539829;42;45;0.619047619047619;16;26;0.119047619047619;0.380952380952381
Control.SRR15539829;49;45;0.469387755102041;26;23;0.0306122448979592;0.469387755102041
Control.SRR15539829;46;45;0.521739130434783;22;24;0.0217391304347826;0.478260869565217
Control.SRR15539829;47;45;0.595744680851064;19;28;0.0957446808510638;0.404255319148936
Control.SRR15539829;46;45;0.478260869565217;24;22;0.0217391304347826;0.478260869565217
Control.SRR15539829;48;45;0.520833333333333;23;25;0.0208333333333334;0.479166666666667
Control.SRR15539829;50;45;0.6;20;30;0.1;0.4
Control.SRR15539829;52;45;0.461538461538462;28;24;0.0384615384615384;0.461538461538462
Control.SRR15539829;49;45;0.591836734693878;20;29;0.0918367346938775;0.408163265306122
Control.SRR15539829;40;45;0.45;22;18;0.05;0.45
Control.SRR15539829;43;45;0.418604651162791;25;18;0.0813953488372093;0.418604651162791
Control.SRR15539829;50;45;0.6;20;30;0.1;0.4
Control.SRR15539829;51;45;0.411764705882353;30;21;0.0882352941176471;0.411764705882353
Control.SRR15539829;52;45;0.480769230769231;27;25;0.0192307692307692;0.480769230769231
Control.SRR15539829;50;45;0.52;24;26;0.02;0.48
Control.SRR15539829;50;45;0.56;22;28;0.0600000000000001;0.44
Control.SRR15539829;45;45;0.577777777777778;19;26;0.0777777777777777;0.422222222222222
Control.SRR15539829;46;45;0.5;23;23;0;0.5
Control.SRR15539829;44;45;0.522727272727273;21;23;0.0227272727272727;0.477272727272727
Control.SRR15539829;47;45;0.48936170212766;24;23;0.0106382978723404;0.48936170212766
Control.SRR15539829;50;45;0.52;24;26;0.02;0.48
Control.SRR15539829;53;45;0.584905660377358;22;31;0.0849056603773585;0.415094339622642
Control.SRR15539829;41;45;0.439024390243902;23;18;0.0609756097560976;0.439024390243902
Control.SRR15539829;50;45;0.52;24;26;0.02;0.48
Control.SRR15539829;46;45;0.521739130434783;22;24;0.0217391304347826;0.478260869565217
Control.SRR15539829;44;45;0.5;22;22;0;0.5
Control.SRR15539829;50;45;0.52;24;26;0.02;0.48
Control.SRR15539829;41;45;0.390243902439024;25;16;0.109756097560976;0.390243902439024
Control.SRR15539829;49;45;0.428571428571429;28;21;0.0714285714285715;0.428571428571429
Control.SRR15539829;42;45;0.547619047619048;19;23;0.0476190476190477;0.452380952380952
Control.SRR15539829;42;45;0.5;21;21;0;0.5
Control.SRR15539829;53;45;0.509433962264151;26;27;0.00943396226415094;0.490566037735849
Control.SRR15539829;42;45;0.428571428571429;24;18;0.0714285714285715;0.428571428571429
Control.SRR15539829;46;45;0.41304347826087;27;19;0.0869565217391304;0.41304347826087
Control.SRR15539829;53;45;0.490566037735849;27;26;0.00943396226415094;0.490566037735849
Control.SRR15539829;48;45;0.5625;21;27;0.0625;0.4375
Control.SRR15539829;40;45;0.575;17;23;0.075;0.425
Control.SRR15539829;51;45;0.450980392156863;28;23;0.0490196078431372;0.450980392156863
Control.SRR15539829;41;45;0.48780487804878;21;20;0.0121951219512195;0.48780487804878
Control.SRR15539829;48;45;0.479166666666667;25;23;0.0208333333333333;0.479166666666667
Control.SRR15539829;45;45;0.511111111111111;22;23;0.0111111111111111;0.488888888888889
Control.SRR15539829;45;45;0.555555555555556;20;25;0.0555555555555556;0.444444444444444
Control.SRR15539829;45;45;0.377777777777778;28;17;0.122222222222222;0.377777777777778
Control.SRR15539829;50;45;0.58;21;29;0.08;0.42
Control.SRR15539829;42;45;0.523809523809524;20;22;0.0238095238095238;0.476190476190476
Control.SRR15539829;48;45;0.520833333333333;23;25;0.0208333333333334;0.479166666666667
Control.SRR15539829;42;45;0.523809523809524;20;22;0.0238095238095238;0.476190476190476
Control.SRR15539829;40;45;0.475;21;19;0.025;0.475
Control.SRR15539829;42;45;0.357142857142857;27;15;0.142857142857143;0.357142857142857
Control.SRR15539829;46;45;0.543478260869565;21;25;0.0434782608695652;0.456521739130435
Control.SRR15539829;52;45;0.461538461538462;28;24;0.0384615384615384;0.461538461538462
Control.SRR15539829;41;45;0.48780487804878;21;20;0.0121951219512195;0.48780487804878
Control.SRR15539829;49;45;0.408163265306122;29;20;0.0918367346938775;0.408163265306122
Control.SRR15539829;43;45;0.488372093023256;22;21;0.0116279069767442;0.488372093023256
Control.SRR15539829;53;45;0.433962264150943;30;23;0.0660377358490566;0.433962264150943
Control.SRR15539829;41;45;0.365853658536585;26;15;0.134146341463415;0.365853658536585
Control.SRR15539829;42;45;0.571428571428571;18;24;0.0714285714285714;0.428571428571429
Control.SRR15539829;47;45;0.404255319148936;28;19;0.0957446808510639;0.404255319148936
Control.SRR15539829;52;45;0.596153846153846;21;31;0.0961538461538461;0.403846153846154
Control.SRR15539829;51;45;0.568627450980392;22;29;0.0686274509803921;0.431372549019608
Control.SRR15539829;45;45;0.644444444444444;16;29;0.144444444444444;0.355555555555556
Control.SRR15539829;41;45;0.414634146341463;24;17;0.0853658536585366;0.414634146341463
Control.SRR15539829;41;45;0.414634146341463;24;17;0.0853658536585366;0.414634146341463
Control.SRR15539829;40;45;0.425;23;17;0.075;0.425
Control.SRR15539829;50;45;0.48;26;24;0.02;0.48
Control.SRR15539829;48;45;0.541666666666667;22;26;0.0416666666666666;0.458333333333333
Control.SRR15539829;51;45;0.490196078431373;26;25;0.00980392156862747;0.490196078431373
Control.SRR15539829;43;45;0.558139534883721;19;24;0.0581395348837209;0.441860465116279
Control.SRR15539829;44;45;0.386363636363636;27;17;0.113636363636364;0.386363636363636
Control.SRR15539829;49;45;0.530612244897959;23;26;0.0306122448979592;0.469387755102041
Control.SRR15539829;48;45;0.5625;21;27;0.0625;0.4375
Control.SRR15539829;44;45;0.568181818181818;19;25;0.0681818181818182;0.431818181818182
Control.SRR15539829;44;45;0.386363636363636;27;17;0.113636363636364;0.386363636363636
Control.SRR15539829;48;45;0.5;24;24;0;0.5
Control.SRR15539829;53;45;0.490566037735849;27;26;0.00943396226415094;0.490566037735849
Control.SRR15539829;52;45;0.538461538461538;24;28;0.0384615384615384;0.461538461538462
Control.SRR15539829;49;45;0.428571428571429;28;21;0.0714285714285715;0.428571428571429
Control.SRR15539829;51;45;0.490196078431373;26;25;0.00980392156862747;0.490196078431373
Control.SRR15539829;51;45;0.490196078431373;26;25;0.00980392156862747;0.490196078431373
Control.SRR15539829;50;45;0.48;26;24;0.02;0.48
Control.SRR15539829;53;45;0.433962264150943;30;23;0.0660377358490566;0.433962264150943
Control.SRR15539829;48;45;0.4375;27;21;0.0625;0.4375
Control.SRR15539829;42;45;0.69047619047619;13;29;0.19047619047619;0.30952380952381
Control.SRR15539829;52;45;0.403846153846154;31;21;0.0961538461538461;0.403846153846154
Control.SRR15539829;49;45;0.530612244897959;23;26;0.0306122448979592;0.469387755102041
Control.SRR15539829;43;45;0.511627906976744;21;22;0.0116279069767442;0.488372093023256
Control.SRR15539829;49;45;0.469387755102041;26;23;0.0306122448979592;0.469387755102041
Control.SRR15539829;48;45;0.395833333333333;29;19;0.104166666666667;0.395833333333333
Control.SRR15539829;42;45;0.452380952380952;23;19;0.0476190476190476;0.452380952380952
Control.SRR15539829;40;45;0.575;17;23;0.075;0.425
Control.SRR15539829;44;45;0.386363636363636;27;17;0.113636363636364;0.386363636363636
Control.SRR15539829;41;45;0.439024390243902;23;18;0.0609756097560976;0.439024390243902
Control.SRR15539829;53;45;0.471698113207547;28;25;0.0283018867924528;0.471698113207547
Control.SRR15539829;54;45;0.444444444444444;30;24;0.0555555555555556;0.444444444444444
Control.SRR15539829;54;45;0.444444444444444;30;24;0.0555555555555556;0.444444444444444
Control.SRR15539829;47;45;0.553191489361702;21;26;0.0531914893617021;0.446808510638298
Control.SRR15539829;45;45;0.466666666666667;24;21;0.0333333333333333;0.466666666666667
Control.SRR15539829;49;45;0.591836734693878;20;29;0.0918367346938775;0.408163265306122
Control.SRR15539829;43;45;0.465116279069767;23;20;0.0348837209302326;0.465116279069767
Control.SRR15539829;40;45;0.625;15;25;0.125;0.375
Control.SRR15539829;44;45;0.386363636363636;27;17;0.113636363636364;0.386363636363636
Control.SRR15539829;47;45;0.595744680851064;19;28;0.0957446808510638;0.404255319148936
Control.SRR15539829;52;45;0.365384615384615;33;19;0.134615384615385;0.365384615384615
Control.SRR15539829;48;45;0.4375;27;21;0.0625;0.4375
Control.SRR15539829;51;45;0.470588235294118;27;24;0.0294117647058824;0.470588235294118
Control.SRR15539829;49;45;0.653061224489796;17;32;0.153061224489796;0.346938775510204
Control.SRR15539829;52;45;0.557692307692308;23;29;0.0576923076923077;0.442307692307692
Control.SRR15539829;41;45;0.51219512195122;20;21;0.0121951219512195;0.48780487804878
Control.SRR15539829;48;45;0.479166666666667;25;23;0.0208333333333333;0.479166666666667
Control.SRR15539829;44;45;0.318181818181818;30;14;0.181818181818182;0.318181818181818
Control.SRR15539829;47;45;0.51063829787234;23;24;0.0106382978723404;0.48936170212766
Control.SRR15539829;53;45;0.490566037735849;27;26;0.00943396226415094;0.490566037735849
Control.SRR15539829;46;45;0.391304347826087;28;18;0.108695652173913;0.391304347826087
Control.SRR15539829;43;45;0.418604651162791;25;18;0.0813953488372093;0.418604651162791
Control.SRR15539829;50;45;0.46;27;23;0.04;0.46
Control.SRR15539829;43;45;0.627906976744186;16;27;0.127906976744186;0.372093023255814
Control.SRR15539829;54;45;0.462962962962963;29;25;0.037037037037037;0.462962962962963
Control.SRR15539829;50;45;0.5;25;25;0;0.5
Control.SRR15539829;41;45;0.609756097560976;16;25;0.109756097560976;0.390243902439024
Control.SRR15539829;52;45;0.423076923076923;30;22;0.0769230769230769;0.423076923076923
Control.SRR15539829;54;45;0.592592592592593;22;32;0.0925925925925926;0.407407407407407
Control.SRR15539829;44;45;0.454545454545455;24;20;0.0454545454545455;0.454545454545455
Control.SRR15539829;44;45;0.522727272727273;21;23;0.0227272727272727;0.477272727272727
Control.SRR15539829;49;45;0.469387755102041;26;23;0.0306122448979592;0.469387755102041
Control.SRR15539829;52;45;0.461538461538462;28;24;0.0384615384615384;0.461538461538462
Control.SRR15539829;42;45;0.476190476190476;22;20;0.0238095238095238;0.476190476190476
Control.SRR15539829;52;45;0.480769230769231;27;25;0.0192307692307692;0.480769230769231
Control.SRR15539829;52;45;0.480769230769231;27;25;0.0192307692307692;0.480769230769231
Control.SRR15539829;53;45;0.528301886792453;25;28;0.0283018867924528;0.471698113207547
Control.SRR15539829;45;45;0.444444444444444;25;20;0.0555555555555556;0.444444444444444
Control.SRR15539829;45;45;0.555555555555556;20;25;0.0555555555555556;0.444444444444444
Control.SRR15539829;42;45;0.357142857142857;27;15;0.142857142857143;0.357142857142857
Control.SRR15539829;51;45;0.529411764705882;24;27;0.0294117647058824;0.470588235294118
Control.SRR15539829;48;45;0.5;24;24;0;0.5
Control.SRR15539829;45;45;0.488888888888889;23;22;0.0111111111111111;0.488888888888889
Control.SRR15539829;50;45;0.46;27;23;0.04;0.46
Control.SRR15539829;42;45;0.5;21;21;0;0.5
Control.SRR15539829;48;45;0.541666666666667;22;26;0.0416666666666666;0.458333333333333
Control.SRR15539829;42;45;0.452380952380952;23;19;0.0476190476190476;0.452380952380952
Control.SRR15539829;44;45;0.386363636363636;27;17;0.113636363636364;0.386363636363636
Control.SRR15539829;52;45;0.423076923076923;30;22;0.0769230769230769;0.423076923076923
Control.SRR15539829;49;45;0.551020408163265;22;27;0.0510204081632653;0.448979591836735
Control.SRR15539829;51;45;0.509803921568627;25;26;0.00980392156862742;0.490196078431373
Control.SRR15539829;48;45;0.5;24;24;0;0.5
Control.SRR15539829;51;45;0.509803921568627;25;26;0.00980392156862742;0.490196078431373
Control.SRR15539829;50;45;0.4;30;20;0.1;0.4
Control.SRR15539829;50;45;0.52;24;26;0.02;0.48
Control.SRR15539829;41;45;0.536585365853659;19;22;0.0365853658536586;0.463414634146341
Control.SRR15539829;54;45;0.481481481481481;28;26;0.0185185185185185;0.481481481481481
Control.SRR15539829;54;45;0.5;27;27;0;0.5
Control.SRR15539829;41;45;0.414634146341463;24;17;0.0853658536585366;0.414634146341463
Control.SRR15539829;51;45;0.529411764705882;24;27;0.0294117647058824;0.470588235294118
Control.SRR15539829;41;45;0.439024390243902;23;18;0.0609756097560976;0.439024390243902
Control.SRR15539829;42;45;0.452380952380952;23;19;0.0476190476190476;0.452380952380952
Control.SRR15539829;43;45;0.534883720930233;20;23;0.0348837209302325;0.465116279069767
Control.SRR15539829;43;45;0.441860465116279;24;19;0.0581395348837209;0.441860465116279
Control.SRR15539829;49;45;0.448979591836735;27;22;0.0510204081632653;0.448979591836735
Control.SRR15539829;44;45;0.386363636363636;27;17;0.113636363636364;0.386363636363636
Control.SRR15539829;47;45;0.425531914893617;27;20;0.074468085106383;0.425531914893617
Control.SRR15539829;52;45;0.480769230769231;27;25;0.0192307692307692;0.480769230769231
Control.SRR15539829;49;45;0.489795918367347;25;24;0.0102040816326531;0.489795918367347
Control.SRR15539829;40;45;0.675;13;27;0.175;0.325
Control.SRR15539829;45;45;0.511111111111111;22;23;0.0111111111111111;0.488888888888889
Control.SRR15539829;42;45;0.642857142857143;15;27;0.142857142857143;0.357142857142857
Control.SRR15539829;45;45;0.511111111111111;22;23;0.0111111111111111;0.488888888888889
Control.SRR15539829;44;45;0.568181818181818;19;25;0.0681818181818182;0.431818181818182
Control.SRR15539829;51;45;0.431372549019608;29;22;0.0686274509803921;0.431372549019608
Control.SRR15539829;52;45;0.365384615384615;33;19;0.134615384615385;0.365384615384615
Control.SRR15539829;51;45;0.352941176470588;33;18;0.147058823529412;0.352941176470588
Control.SRR15539829;42;45;0.595238095238095;17;25;0.0952380952380952;0.404761904761905
Control.SRR15539829;40;45;0.575;17;23;0.075;0.425
Control.SRR15539829;49;45;0.408163265306122;29;20;0.0918367346938775;0.408163265306122
Control.SRR15539829;41;45;0.536585365853659;19;22;0.0365853658536586;0.463414634146341
Control.SRR15539829;49;45;0.510204081632653;24;25;0.0102040816326531;0.489795918367347
Control.SRR15539829;46;45;0.608695652173913;18;28;0.108695652173913;0.391304347826087
Control.SRR15539829;43;45;0.395348837209302;26;17;0.104651162790698;0.395348837209302
Control.SRR15539829;49;45;0.489795918367347;25;24;0.0102040816326531;0.489795918367347
Control.SRR15539829;48;45;0.541666666666667;22;26;0.0416666666666666;0.458333333333333
Control.SRR15539829;52;45;0.442307692307692;29;23;0.0576923076923077;0.442307692307692
Control.SRR15539829;46;45;0.543478260869565;21;25;0.0434782608695652;0.456521739130435
Control.SRR15539829;45;45;0.511111111111111;22;23;0.0111111111111111;0.488888888888889
Control.SRR15539829;52;45;0.461538461538462;28;24;0.0384615384615384;0.461538461538462
Control.SRR15539829;50;45;0.42;29;21;0.08;0.42
Control.SRR15539829;51;45;0.450980392156863;28;23;0.0490196078431372;0.450980392156863
Control.SRR15539829;49;45;0.551020408163265;22;27;0.0510204081632653;0.448979591836735
Control.SRR15539829;43;45;0.441860465116279;24;19;0.0581395348837209;0.441860465116279
Control.SRR15539829;41;45;0.536585365853659;19;22;0.0365853658536586;0.463414634146341
Control.SRR15539829;49;45;0.469387755102041;26;23;0.0306122448979592;0.469387755102041
Control.SRR15539829;51;45;0.333333333333333;34;17;0.166666666666667;0.333333333333333
Control.SRR15539829;49;45;0.469387755102041;26;23;0.0306122448979592;0.469387755102041
Control.SRR15539829;53;45;0.471698113207547;28;25;0.0283018867924528;0.471698113207547
Control.SRR15539829;43;45;0.651162790697674;15;28;0.151162790697674;0.348837209302326
Control.SRR15539829;50;45;0.56;22;28;0.0600000000000001;0.44
Control.SRR15539829;50;45;0.44;28;22;0.06;0.44
Control.SRR15539829;44;45;0.477272727272727;23;21;0.0227272727272727;0.477272727272727
Control.SRR15539829;43;45;0.511627906976744;21;22;0.0116279069767442;0.488372093023256
Control.SRR15539829;47;45;0.702127659574468;14;33;0.202127659574468;0.297872340425532
Control.SRR15539829;45;45;0.688888888888889;14;31;0.188888888888889;0.311111111111111
Control.SRR15539829;54;45;0.537037037037037;25;29;0.0370370370370371;0.462962962962963
Control.SRR15539829;40;45;0.475;21;19;0.025;0.475
Control.SRR15539829;43;45;0.511627906976744;21;22;0.0116279069767442;0.488372093023256
Control.SRR15539829;42;45;0.5;21;21;0;0.5
Control.SRR15539829;47;45;0.446808510638298;26;21;0.0531914893617021;0.446808510638298
Control.SRR15539829;46;45;0.41304347826087;27;19;0.0869565217391304;0.41304347826087
Control.SRR15539829;52;45;0.384615384615385;32;20;0.115384615384615;0.384615384615385
Control.SRR15539829;46;45;0.58695652173913;19;27;0.0869565217391305;0.41304347826087
Control.SRR15539829;40;45;0.475;21;19;0.025;0.475
Control.SRR15539829;40;45;0.5;20;20;0;0.5
Control.SRR15539829;44;45;0.522727272727273;21;23;0.0227272727272727;0.477272727272727
Control.SRR15539829;43;45;0.558139534883721;19;24;0.0581395348837209;0.441860465116279
Control.SRR15539829;41;45;0.390243902439024;25;16;0.109756097560976;0.390243902439024
Control.SRR15539829;47;45;0.574468085106383;20;27;0.074468085106383;0.425531914893617
Control.SRR15539829;49;45;0.63265306122449;18;31;0.13265306122449;0.36734693877551
Control.SRR15539829;41;45;0.365853658536585;26;15;0.134146341463415;0.365853658536585
Control.SRR15539829;54;45;0.518518518518518;26;28;0.0185185185185185;0.481481481481481
Control.SRR15539829;49;45;0.510204081632653;24;25;0.0102040816326531;0.489795918367347
Control.SRR15539829;51;45;0.509803921568627;25;26;0.00980392156862742;0.490196078431373
Control.SRR15539829;47;45;0.425531914893617;27;20;0.074468085106383;0.425531914893617
Control.SRR15539829;54;45;0.425925925925926;31;23;0.0740740740740741;0.425925925925926
Control.SRR15539829;40;45;0.425;23;17;0.075;0.425
Control.SRR15539829;48;45;0.479166666666667;25;23;0.0208333333333333;0.479166666666667
Control.SRR15539829;53;45;0.528301886792453;25;28;0.0283018867924528;0.471698113207547
Control.SRR15539829;53;45;0.528301886792453;25;28;0.0283018867924528;0.471698113207547
Control.SRR15539829;46;45;0.608695652173913;18;28;0.108695652173913;0.391304347826087
Control.SRR15539829;42;45;0.476190476190476;22;20;0.0238095238095238;0.476190476190476
Control.SRR15539829;41;45;0.51219512195122;20;21;0.0121951219512195;0.48780487804878
Control.SRR15539829;46;45;0.5;23;23;0;0.5
Control.SRR15539829;48;45;0.4375;27;21;0.0625;0.4375
Control.SRR15539829;42;45;0.595238095238095;17;25;0.0952380952380952;0.404761904761905
Control.SRR15539829;40;45;0.475;21;19;0.025;0.475
Control.SRR15539829;40;45;0.4;24;16;0.1;0.4
Control.SRR15539829;46;45;0.521739130434783;22;24;0.0217391304347826;0.478260869565217
Control.SRR15539829;40;45;0.375;25;15;0.125;0.375
Control.SRR15539829;45;45;0.533333333333333;21;24;0.0333333333333333;0.466666666666667
Control.SRR15539829;48;45;0.479166666666667;25;23;0.0208333333333333;0.479166666666667
Control.SRR15539829;47;45;0.468085106382979;25;22;0.0319148936170213;0.468085106382979
Control.SRR15539829;46;45;0.347826086956522;30;16;0.152173913043478;0.347826086956522
Control.SRR15539829;53;45;0.566037735849057;23;30;0.0660377358490566;0.433962264150943
Control.SRR15539829;51;45;0.431372549019608;29;22;0.0686274509803921;0.431372549019608
Control.SRR15539829;47;45;0.48936170212766;24;23;0.0106382978723404;0.48936170212766
Control.SRR15539829;44;45;0.522727272727273;21;23;0.0227272727272727;0.477272727272727
Control.SRR15539829;41;45;0.682926829268293;13;28;0.182926829268293;0.317073170731707
Control.SRR15539829;50;45;0.48;26;24;0.02;0.48
Control.SRR15539829;48;45;0.541666666666667;22;26;0.0416666666666666;0.458333333333333
Control.SRR15539829;44;45;0.454545454545455;24;20;0.0454545454545455;0.454545454545455
Control.SRR15539829;50;45;0.52;24;26;0.02;0.48
Control.SRR15539829;50;45;0.52;24;26;0.02;0.48
Control.SRR15539829;54;45;0.462962962962963;29;25;0.037037037037037;0.462962962962963
Control.SRR15539829;43;45;0.534883720930233;20;23;0.0348837209302325;0.465116279069767
Control.SRR15539829;45;45;0.444444444444444;25;20;0.0555555555555556;0.444444444444444
Control.SRR15539829;42;45;0.547619047619048;19;23;0.0476190476190477;0.452380952380952
Control.SRR15539829;53;45;0.584905660377358;22;31;0.0849056603773585;0.415094339622642
Control.SRR15539829;44;45;0.5;22;22;0;0.5
Control.SRR15539829;52;45;0.519230769230769;25;27;0.0192307692307693;0.480769230769231
Control.SRR15539829;44;45;0.5;22;22;0;0.5
Control.SRR15539829;52;45;0.538461538461538;24;28;0.0384615384615384;0.461538461538462
Control.SRR15539829;53;45;0.471698113207547;28;25;0.0283018867924528;0.471698113207547
Control.SRR15539829;40;45;0.6;16;24;0.1;0.4
Control.SRR15539829;46;45;0.456521739130435;25;21;0.0434782608695652;0.456521739130435
Control.SRR15539829;42;45;0.523809523809524;20;22;0.0238095238095238;0.476190476190476
Control.SRR15539829;45;45;0.466666666666667;24;21;0.0333333333333333;0.466666666666667
Control.SRR15539829;54;45;0.481481481481481;28;26;0.0185185185185185;0.481481481481481
Control.SRR15539829;43;45;0.558139534883721;19;24;0.0581395348837209;0.441860465116279
Control.SRR15539829;53;45;0.509433962264151;26;27;0.00943396226415094;0.490566037735849
Control.SRR15539829;46;45;0.58695652173913;19;27;0.0869565217391305;0.41304347826087
Control.SRR15539829;43;45;0.465116279069767;23;20;0.0348837209302326;0.465116279069767
Control.SRR15539829;42;45;0.5;21;21;0;0.5
Control.SRR15539829;54;45;0.462962962962963;29;25;0.037037037037037;0.462962962962963
Control.SRR15539829;43;45;0.604651162790698;17;26;0.104651162790698;0.395348837209302
Control.SRR15539829;44;45;0.545454545454545;20;24;0.0454545454545454;0.454545454545455
Control.SRR15539829;48;45;0.4375;27;21;0.0625;0.4375
Control.SRR15539829;41;45;0.48780487804878;21;20;0.0121951219512195;0.48780487804878
Control.SRR15539829;41;45;0.48780487804878;21;20;0.0121951219512195;0.48780487804878
Control.SRR15539829;50;45;0.48;26;24;0.02;0.48
Control.SRR15539829;54;45;0.518518518518518;26;28;0.0185185185185185;0.481481481481481
Control.SRR15539829;51;45;0.647058823529412;18;33;0.147058823529412;0.352941176470588
Control.SRR15539829;44;45;0.363636363636364;28;16;0.136363636363636;0.363636363636364
Control.SRR15539829;44;45;0.431818181818182;25;19;0.0681818181818182;0.431818181818182
Control.SRR15539829;50;45;0.38;31;19;0.12;0.38
Control.SRR15539829;42;45;0.452380952380952;23;19;0.0476190476190476;0.452380952380952
Control.SRR15539829;47;45;0.617021276595745;18;29;0.117021276595745;0.382978723404255
Control.SRR15539829;44;45;0.454545454545455;24;20;0.0454545454545455;0.454545454545455
Control.SRR15539829;47;45;0.595744680851064;19;28;0.0957446808510638;0.404255319148936
Control.SRR15539829;44;45;0.454545454545455;24;20;0.0454545454545455;0.454545454545455
Control.SRR15539829;47;45;0.531914893617021;22;25;0.0319148936170213;0.468085106382979
Control.SRR15539829;51;45;0.490196078431373;26;25;0.00980392156862747;0.490196078431373
Control.SRR15539829;52;45;0.423076923076923;30;22;0.0769230769230769;0.423076923076923
Control.SRR15539829;51;45;0.549019607843137;23;28;0.0490196078431373;0.450980392156863
Control.SRR15539829;48;45;0.416666666666667;28;20;0.0833333333333333;0.416666666666667
Control.SRR15539829;50;45;0.48;26;24;0.02;0.48
Control.SRR15539829;48;45;0.5;24;24;0;0.5
Control.SRR15539829;42;45;0.523809523809524;20;22;0.0238095238095238;0.476190476190476
Control.SRR15539829;44;45;0.522727272727273;21;23;0.0227272727272727;0.477272727272727
Control.SRR15539829;44;45;0.363636363636364;28;16;0.136363636363636;0.363636363636364
Control.SRR15539829;47;45;0.553191489361702;21;26;0.0531914893617021;0.446808510638298
Control.SRR15539829;41;45;0.439024390243902;23;18;0.0609756097560976;0.439024390243902
Control.SRR15539829;43;45;0.325581395348837;29;14;0.174418604651163;0.325581395348837
Control.SRR15539829;50;45;0.5;25;25;0;0.5
Control.SRR15539829;50;45;0.54;23;27;0.04;0.46
Control.SRR15539829;46;45;0.434782608695652;26;20;0.0652173913043478;0.434782608695652
Control.SRR15539829;52;45;0.519230769230769;25;27;0.0192307692307693;0.480769230769231
Control.SRR15539829;49;45;0.489795918367347;25;24;0.0102040816326531;0.489795918367347
Control.SRR15539829;54;45;0.537037037037037;25;29;0.0370370370370371;0.462962962962963
Control.SRR15539829;53;45;0.471698113207547;28;25;0.0283018867924528;0.471698113207547
Control.SRR15539829;46;45;0.521739130434783;22;24;0.0217391304347826;0.478260869565217
Control.SRR15539829;52;45;0.519230769230769;25;27;0.0192307692307693;0.480769230769231
Control.SRR15539829;45;45;0.6;18;27;0.1;0.4
Control.SRR15539829;49;45;0.551020408163265;22;27;0.0510204081632653;0.448979591836735
Control.SRR15539829;48;45;0.520833333333333;23;25;0.0208333333333334;0.479166666666667
Control.SRR15539829;45;45;0.377777777777778;28;17;0.122222222222222;0.377777777777778
Control.SRR15539829;53;45;0.584905660377358;22;31;0.0849056603773585;0.415094339622642
Control.SRR15539829;54;45;0.5;27;27;0;0.5
Control.SRR15539829;54;45;0.481481481481481;28;26;0.0185185185185185;0.481481481481481
Control.SRR15539829;47;45;0.48936170212766;24;23;0.0106382978723404;0.48936170212766
Control.SRR15539829;49;45;0.36734693877551;31;18;0.13265306122449;0.36734693877551
Control.SRR15539829;50;45;0.54;23;27;0.04;0.46
Control.SRR15539829;50;45;0.52;24;26;0.02;0.48
Control.SRR15539829;45;45;0.577777777777778;19;26;0.0777777777777777;0.422222222222222
Control.SRR15539829;40;45;0.525;19;21;0.025;0.475
Control.SRR15539829;46;45;0.5;23;23;0;0.5
Control.SRR15539829;45;45;0.488888888888889;23;22;0.0111111111111111;0.488888888888889
Control.SRR15539829;50;45;0.5;25;25;0;0.5
Control.SRR15539829;52;45;0.423076923076923;30;22;0.0769230769230769;0.423076923076923
Control.SRR15539829;51;45;0.549019607843137;23;28;0.0490196078431373;0.450980392156863
Control.SRR15539829;50;45;0.52;24;26;0.02;0.48
Control.SRR15539829;40;45;0.475;21;19;0.025;0.475
Control.SRR15539829;46;45;0.478260869565217;24;22;0.0217391304347826;0.478260869565217
Control.SRR15539829;41;45;0.463414634146341;22;19;0.0365853658536585;0.463414634146341
Control.SRR15539829;43;45;0.395348837209302;26;17;0.104651162790698;0.395348837209302
Control.SRR15539829;47;45;0.446808510638298;26;21;0.0531914893617021;0.446808510638298
Control.SRR15539829;40;45;0.525;19;21;0.025;0.475
Control.SRR15539829;42;45;0.547619047619048;19;23;0.0476190476190477;0.452380952380952
Control.SRR15539829;46;45;0.521739130434783;22;24;0.0217391304347826;0.478260869565217
Control.SRR15539829;49;45;0.530612244897959;23;26;0.0306122448979592;0.469387755102041
Control.SRR15539829;43;45;0.488372093023256;22;21;0.0116279069767442;0.488372093023256
Control.SRR15539829;47;45;0.638297872340426;17;30;0.138297872340426;0.361702127659574
Control.SRR15539829;52;45;0.480769230769231;27;25;0.0192307692307692;0.480769230769231
Control.SRR15539829;43;45;0.534883720930233;20;23;0.0348837209302325;0.465116279069767
Control.SRR15539829;46;45;0.5;23;23;0;0.5
Control.SRR15539829;41;45;0.609756097560976;16;25;0.109756097560976;0.390243902439024
Control.SRR15539829;40;45;0.55;18;22;0.05;0.45
Control.SRR15539829;48;45;0.541666666666667;22;26;0.0416666666666666;0.458333333333333
Control.SRR15539829;53;45;0.490566037735849;27;26;0.00943396226415094;0.490566037735849
Control.SRR15539829;52;45;0.461538461538462;28;24;0.0384615384615384;0.461538461538462
Control.SRR15539829;46;45;0.434782608695652;26;20;0.0652173913043478;0.434782608695652
Control.SRR15539829;54;45;0.592592592592593;22;32;0.0925925925925926;0.407407407407407
Control.SRR15539829;42;45;0.547619047619048;19;23;0.0476190476190477;0.452380952380952
Control.SRR15539829;43;45;0.534883720930233;20;23;0.0348837209302325;0.465116279069767
Control.SRR15539829;50;45;0.62;19;31;0.12;0.38
Control.SRR15539829;49;45;0.530612244897959;23;26;0.0306122448979592;0.469387755102041
Control.SRR15539829;46;45;0.58695652173913;19;27;0.0869565217391305;0.41304347826087
Control.SRR15539829;42;45;0.452380952380952;23;19;0.0476190476190476;0.452380952380952
Control.SRR15539829;40;45;0.625;15;25;0.125;0.375
Control.SRR15539829;46;45;0.434782608695652;26;20;0.0652173913043478;0.434782608695652
Control.SRR15539829;46;45;0.41304347826087;27;19;0.0869565217391304;0.41304347826087
Control.SRR15539829;42;45;0.571428571428571;18;24;0.0714285714285714;0.428571428571429
Control.SRR15539829;42;45;0.571428571428571;18;24;0.0714285714285714;0.428571428571429
Control.SRR15539829;48;45;0.479166666666667;25;23;0.0208333333333333;0.479166666666667
Control.SRR15539829;48;45;0.458333333333333;26;22;0.0416666666666667;0.458333333333333
Control.SRR15539829;40;45;0.625;15;25;0.125;0.375
Control.SRR15539829;45;45;0.533333333333333;21;24;0.0333333333333333;0.466666666666667
Control.SRR15539829;44;45;0.477272727272727;23;21;0.0227272727272727;0.477272727272727
Control.SRR15539829;54;45;0.407407407407407;32;22;0.0925925925925926;0.407407407407407
Control.SRR15539829;53;45;0.490566037735849;27;26;0.00943396226415094;0.490566037735849
Control.SRR15539829;43;45;0.534883720930233;20;23;0.0348837209302325;0.465116279069767
Control.SRR15539829;43;45;0.511627906976744;21;22;0.0116279069767442;0.488372093023256
Control.SRR15539829;43;45;0.465116279069767;23;20;0.0348837209302326;0.465116279069767
Control.SRR15539829;41;45;0.658536585365854;14;27;0.158536585365854;0.341463414634146
Control.SRR15539829;42;45;0.452380952380952;23;19;0.0476190476190476;0.452380952380952
Control.SRR15539829;47;45;0.468085106382979;25;22;0.0319148936170213;0.468085106382979
Control.SRR15539829;54;45;0.5;27;27;0;0.5
Control.SRR15539829;50;45;0.42;29;21;0.08;0.42
Control.SRR15539829;54;45;0.5;27;27;0;0.5
Control.SRR15539829;43;45;0.441860465116279;24;19;0.0581395348837209;0.441860465116279
Control.SRR15539829;42;45;0.476190476190476;22;20;0.0238095238095238;0.476190476190476
Control.SRR15539829;41;45;0.560975609756098;18;23;0.0609756097560976;0.439024390243902
Control.SRR15539829;43;45;0.697674418604651;13;30;0.197674418604651;0.302325581395349
Control.SRR15539829;43;45;0.511627906976744;21;22;0.0116279069767442;0.488372093023256
Control.SRR15539829;53;45;0.547169811320755;24;29;0.0471698113207547;0.452830188679245
Control.SRR15539829;53;45;0.547169811320755;24;29;0.0471698113207547;0.452830188679245
Control.SRR15539829;49;45;0.510204081632653;24;25;0.0102040816326531;0.489795918367347
Control.SRR15539829;53;45;0.528301886792453;25;28;0.0283018867924528;0.471698113207547
Control.SRR15539829;43;45;0.558139534883721;19;24;0.0581395348837209;0.441860465116279
Control.SRR15539829;46;45;0.565217391304348;20;26;0.0652173913043478;0.434782608695652
Control.SRR15539829;46;45;0.543478260869565;21;25;0.0434782608695652;0.456521739130435
Control.SRR15539829;48;45;0.625;18;30;0.125;0.375
Control.SRR15539829;54;45;0.462962962962963;29;25;0.037037037037037;0.462962962962963
Control.SRR15539829;44;45;0.431818181818182;25;19;0.0681818181818182;0.431818181818182
Control.SRR15539829;42;45;0.452380952380952;23;19;0.0476190476190476;0.452380952380952
Control.SRR15539829;45;45;0.466666666666667;24;21;0.0333333333333333;0.466666666666667
Control.SRR15539829;50;45;0.48;26;24;0.02;0.48
Control.SRR15539829;42;45;0.5;21;21;0;0.5
Control.SRR15539829;42;45;0.428571428571429;24;18;0.0714285714285715;0.428571428571429
Control.SRR15539829;47;45;0.404255319148936;28;19;0.0957446808510639;0.404255319148936
Control.SRR15539829;47;45;0.48936170212766;24;23;0.0106382978723404;0.48936170212766
Control.SRR15539829;41;45;0.463414634146341;22;19;0.0365853658536585;0.463414634146341
Control.SRR15539829;49;45;0.510204081632653;24;25;0.0102040816326531;0.489795918367347
Control.SRR15539829;45;45;0.555555555555556;20;25;0.0555555555555556;0.444444444444444
Control.SRR15539829;53;45;0.471698113207547;28;25;0.0283018867924528;0.471698113207547
Control.SRR15539829;54;45;0.5;27;27;0;0.5
Control.SRR15539829;42;45;0.523809523809524;20;22;0.0238095238095238;0.476190476190476
Control.SRR15539829;49;45;0.612244897959184;19;30;0.112244897959184;0.387755102040816
Control.SRR15539829;49;45;0.387755102040816;30;19;0.112244897959184;0.387755102040816
Control.SRR15539829;54;45;0.481481481481481;28;26;0.0185185185185185;0.481481481481481
Control.SRR15539829;46;45;0.521739130434783;22;24;0.0217391304347826;0.478260869565217
Control.SRR15539829;45;45;0.666666666666667;15;30;0.166666666666667;0.333333333333333
Control.SRR15539829;42;45;0.428571428571429;24;18;0.0714285714285715;0.428571428571429
Control.SRR15539829;42;45;0.404761904761905;25;17;0.0952380952380952;0.404761904761905
Control.SRR15539829;48;45;0.479166666666667;25;23;0.0208333333333333;0.479166666666667
Control.SRR15539829;48;45;0.479166666666667;25;23;0.0208333333333333;0.479166666666667
Control.SRR15539829;47;45;0.468085106382979;25;22;0.0319148936170213;0.468085106382979
Control.SRR15539829;50;45;0.34;33;17;0.16;0.34
Control.SRR15539829;50;45;0.44;28;22;0.06;0.44
Control.SRR15539829;54;45;0.555555555555556;24;30;0.0555555555555556;0.444444444444444
Control.SRR15539829;54;45;0.5;27;27;0;0.5
Control.SRR15539829;46;45;0.565217391304348;20;26;0.0652173913043478;0.434782608695652
Control.SRR15539829;41;45;0.463414634146341;22;19;0.0365853658536585;0.463414634146341
Control.SRR15539829;46;45;0.521739130434783;22;24;0.0217391304347826;0.478260869565217
Control.SRR15539829;43;45;0.488372093023256;22;21;0.0116279069767442;0.488372093023256
Control.SRR15539829;49;45;0.489795918367347;25;24;0.0102040816326531;0.489795918367347
Control.SRR15539829;43;45;0.534883720930233;20;23;0.0348837209302325;0.465116279069767
Control.SRR15539829;47;45;0.276595744680851;34;13;0.223404255319149;0.276595744680851
Control.SRR15539829;46;45;0.565217391304348;20;26;0.0652173913043478;0.434782608695652
Control.SRR15539829;51;45;0.392156862745098;31;20;0.107843137254902;0.392156862745098
Control.SRR15539829;51;45;0.588235294117647;21;30;0.0882352941176471;0.411764705882353
Control.SRR15539829;50;45;0.52;24;26;0.02;0.48
Control.SRR15539829;51;45;0.568627450980392;22;29;0.0686274509803921;0.431372549019608
Control.SRR15539829;48;45;0.625;18;30;0.125;0.375
Control.SRR15539829;51;45;0.549019607843137;23;28;0.0490196078431373;0.450980392156863
Control.SRR15539829;42;45;0.428571428571429;24;18;0.0714285714285715;0.428571428571429
Control.SRR15539829;47;45;0.553191489361702;21;26;0.0531914893617021;0.446808510638298
Control.SRR15539829;44;45;0.477272727272727;23;21;0.0227272727272727;0.477272727272727
Control.SRR15539829;45;45;0.355555555555556;29;16;0.144444444444444;0.355555555555556
Control.SRR15539829;41;45;0.609756097560976;16;25;0.109756097560976;0.390243902439024
Control.SRR15539829;54;45;0.425925925925926;31;23;0.0740740740740741;0.425925925925926
Control.SRR15539829;41;45;0.658536585365854;14;27;0.158536585365854;0.341463414634146
Control.SRR15539829;50;45;0.5;25;25;0;0.5
Control.SRR15539829;45;45;0.511111111111111;22;23;0.0111111111111111;0.488888888888889
Control.SRR15539829;54;45;0.555555555555556;24;30;0.0555555555555556;0.444444444444444
Control.SRR15539829;53;45;0.584905660377358;22;31;0.0849056603773585;0.415094339622642
Control.SRR15539829;54;45;0.611111111111111;21;33;0.111111111111111;0.388888888888889
Control.SRR15539829;45;45;0.533333333333333;21;24;0.0333333333333333;0.466666666666667
Control.SRR15539829;51;45;0.607843137254902;20;31;0.107843137254902;0.392156862745098
Control.SRR15539829;48;45;0.520833333333333;23;25;0.0208333333333334;0.479166666666667
Control.SRR15539829;45;45;0.4;27;18;0.1;0.4
Control.SRR15539829;42;45;0.642857142857143;15;27;0.142857142857143;0.357142857142857
Control.SRR15539829;47;45;0.574468085106383;20;27;0.074468085106383;0.425531914893617
Control.SRR15539829;43;45;0.372093023255814;27;16;0.127906976744186;0.372093023255814
Control.SRR15539829;41;45;0.463414634146341;22;19;0.0365853658536585;0.463414634146341
Control.SRR15539829;47;45;0.446808510638298;26;21;0.0531914893617021;0.446808510638298
Control.SRR15539829;42;45;0.5;21;21;0;0.5
Control.SRR15539829;53;45;0.471698113207547;28;25;0.0283018867924528;0.471698113207547
Control.SRR15539829;42;45;0.547619047619048;19;23;0.0476190476190477;0.452380952380952
Control.SRR15539829;49;45;0.571428571428571;21;28;0.0714285714285714;0.428571428571429
Control.SRR15539829;47;45;0.595744680851064;19;28;0.0957446808510638;0.404255319148936
Control.SRR15539829;52;45;0.596153846153846;21;31;0.0961538461538461;0.403846153846154
Control.SRR15539829;46;45;0.5;23;23;0;0.5
Control.SRR15539829;44;45;0.568181818181818;19;25;0.0681818181818182;0.431818181818182
Control.SRR15539829;51;45;0.607843137254902;20;31;0.107843137254902;0.392156862745098
Control.SRR15539829;46;45;0.41304347826087;27;19;0.0869565217391304;0.41304347826087
Control.SRR15539829;51;45;0.372549019607843;32;19;0.127450980392157;0.372549019607843
Control.SRR15539829;52;45;0.5;26;26;0;0.5
Control.SRR15539829;45;45;0.555555555555556;20;25;0.0555555555555556;0.444444444444444
Control.SRR15539829;43;45;0.372093023255814;27;16;0.127906976744186;0.372093023255814
Control.SRR15539829;45;45;0.511111111111111;22;23;0.0111111111111111;0.488888888888889
Control.SRR15539829;44;45;0.431818181818182;25;19;0.0681818181818182;0.431818181818182
Control.SRR15539829;44;45;0.636363636363636;16;28;0.136363636363636;0.363636363636364
Control.SRR15539829;50;45;0.66;17;33;0.16;0.34
Control.SRR15539829;52;45;0.403846153846154;31;21;0.0961538461538461;0.403846153846154
Control.SRR15539829;46;45;0.456521739130435;25;21;0.0434782608695652;0.456521739130435
Control.SRR15539829;40;45;0.575;17;23;0.075;0.425
Control.SRR15539829;45;45;0.444444444444444;25;20;0.0555555555555556;0.444444444444444
Control.SRR15539829;52;45;0.519230769230769;25;27;0.0192307692307693;0.480769230769231
Control.SRR15539829;49;45;0.530612244897959;23;26;0.0306122448979592;0.469387755102041
Control.SRR15539829;46;45;0.478260869565217;24;22;0.0217391304347826;0.478260869565217
Control.SRR15539829;48;45;0.5625;21;27;0.0625;0.4375
Control.SRR15539829;43;45;0.651162790697674;15;28;0.151162790697674;0.348837209302326
Control.SRR15539829;50;45;0.48;26;24;0.02;0.48
Control.SRR15539829;50;45;0.5;25;25;0;0.5
Control.SRR15539829;53;45;0.528301886792453;25;28;0.0283018867924528;0.471698113207547
Control.SRR15539829;51;45;0.627450980392157;19;32;0.127450980392157;0.372549019607843
Control.SRR15539829;46;45;0.326086956521739;31;15;0.173913043478261;0.326086956521739
Control.SRR15539829;44;45;0.545454545454545;20;24;0.0454545454545454;0.454545454545455
Control.SRR15539829;42;45;0.547619047619048;19;23;0.0476190476190477;0.452380952380952
Control.SRR15539829;50;45;0.62;19;31;0.12;0.38
Control.SRR15539829;54;45;0.518518518518518;26;28;0.0185185185185185;0.481481481481481
Control.SRR15539829;44;45;0.545454545454545;20;24;0.0454545454545454;0.454545454545455
Control.SRR15539829;42;45;0.380952380952381;26;16;0.119047619047619;0.380952380952381
Control.SRR15539829;48;45;0.4375;27;21;0.0625;0.4375
Control.SRR15539829;48;45;0.541666666666667;22;26;0.0416666666666666;0.458333333333333
Control.SRR15539829;50;45;0.44;28;22;0.06;0.44
Control.SRR15539829;48;45;0.541666666666667;22;26;0.0416666666666666;0.458333333333333
Control.SRR15539829;42;45;0.476190476190476;22;20;0.0238095238095238;0.476190476190476
Control.SRR15539829;54;45;0.37037037037037;34;20;0.12962962962963;0.37037037037037
Control.SRR15539829;50;45;0.5;25;25;0;0.5
Control.SRR15539829;45;45;0.6;18;27;0.1;0.4
Control.SRR15539829;43;45;0.558139534883721;19;24;0.0581395348837209;0.441860465116279
Control.SRR15539829;48;45;0.375;30;18;0.125;0.375
Control.SRR15539829;54;45;0.444444444444444;30;24;0.0555555555555556;0.444444444444444
Control.SRR15539829;47;45;0.468085106382979;25;22;0.0319148936170213;0.468085106382979
Control.SRR15539829;42;45;0.523809523809524;20;22;0.0238095238095238;0.476190476190476
Control.SRR15539829;49;45;0.469387755102041;26;23;0.0306122448979592;0.469387755102041
Control.SRR15539829;43;45;0.395348837209302;26;17;0.104651162790698;0.395348837209302
Control.SRR15539829;41;45;0.48780487804878;21;20;0.0121951219512195;0.48780487804878
Control.SRR15539829;40;45;0.375;25;15;0.125;0.375
Control.SRR15539829;45;45;0.511111111111111;22;23;0.0111111111111111;0.488888888888889
Control.SRR15539829;42;45;0.619047619047619;16;26;0.119047619047619;0.380952380952381
Control.SRR15539829;46;45;0.456521739130435;25;21;0.0434782608695652;0.456521739130435
Control.SRR15539829;54;45;0.574074074074074;23;31;0.0740740740740741;0.425925925925926
Control.SRR15539829;43;45;0.441860465116279;24;19;0.0581395348837209;0.441860465116279
Control.SRR15539829;40;45;0.45;22;18;0.05;0.45
Control.SRR15539829;53;45;0.490566037735849;27;26;0.00943396226415094;0.490566037735849
Control.SRR15539829;41;45;0.390243902439024;25;16;0.109756097560976;0.390243902439024
Control.SRR15539829;50;45;0.66;17;33;0.16;0.34
Control.SRR15539829;51;45;0.490196078431373;26;25;0.00980392156862747;0.490196078431373
Control.SRR15539829;54;45;0.555555555555556;24;30;0.0555555555555556;0.444444444444444
Control.SRR15539829;47;45;0.531914893617021;22;25;0.0319148936170213;0.468085106382979
Control.SRR15539829;49;45;0.469387755102041;26;23;0.0306122448979592;0.469387755102041
Control.SRR15539829;51;45;0.568627450980392;22;29;0.0686274509803921;0.431372549019608
Control.SRR15539829;47;45;0.48936170212766;24;23;0.0106382978723404;0.48936170212766
Control.SRR15539829;46;45;0.5;23;23;0;0.5
Control.SRR15539829;44;45;0.522727272727273;21;23;0.0227272727272727;0.477272727272727
Control.SRR15539829;46;45;0.543478260869565;21;25;0.0434782608695652;0.456521739130435
Control.SRR15539829;49;45;0.448979591836735;27;22;0.0510204081632653;0.448979591836735
Control.SRR15539829;47;45;0.553191489361702;21;26;0.0531914893617021;0.446808510638298
Control.SRR15539829;48;45;0.583333333333333;20;28;0.0833333333333334;0.416666666666667
Control.SRR15539829;50;45;0.54;23;27;0.04;0.46
Control.SRR15539829;48;45;0.5;24;24;0;0.5
Control.SRR15539829;48;45;0.583333333333333;20;28;0.0833333333333334;0.416666666666667
Control.SRR15539829;54;45;0.592592592592593;22;32;0.0925925925925926;0.407407407407407
Control.SRR15539829;40;45;0.55;18;22;0.05;0.45
Control.SRR15539829;41;45;0.560975609756098;18;23;0.0609756097560976;0.439024390243902
Control.SRR15539829;40;45;0.475;21;19;0.025;0.475
Control.SRR15539829;45;45;0.466666666666667;24;21;0.0333333333333333;0.466666666666667
Control.SRR15539829;54;45;0.518518518518518;26;28;0.0185185185185185;0.481481481481481
Control.SRR15539829;51;45;0.450980392156863;28;23;0.0490196078431372;0.450980392156863
Control.SRR15539829;52;45;0.538461538461538;24;28;0.0384615384615384;0.461538461538462
Control.SRR15539829;51;45;0.450980392156863;28;23;0.0490196078431372;0.450980392156863
Control.SRR15539829;43;45;0.418604651162791;25;18;0.0813953488372093;0.418604651162791
Control.SRR15539829;54;45;0.537037037037037;25;29;0.0370370370370371;0.462962962962963
Control.SRR15539829;53;45;0.452830188679245;29;24;0.0471698113207547;0.452830188679245
Control.SRR15539829;54;45;0.5;27;27;0;0.5
Control.SRR15539829;49;45;0.571428571428571;21;28;0.0714285714285714;0.428571428571429
Control.SRR15539829;42;45;0.547619047619048;19;23;0.0476190476190477;0.452380952380952
Control.SRR15539829;44;45;0.522727272727273;21;23;0.0227272727272727;0.477272727272727
Control.SRR15539829;44;45;0.636363636363636;16;28;0.136363636363636;0.363636363636364
Control.SRR15539829;41;45;0.658536585365854;14;27;0.158536585365854;0.341463414634146
Control.SRR15539829;40;45;0.525;19;21;0.025;0.475
Control.SRR15539829;48;45;0.395833333333333;29;19;0.104166666666667;0.395833333333333
Control.SRR15539829;51;45;0.666666666666667;17;34;0.166666666666667;0.333333333333333
Control.SRR15539829;43;45;0.651162790697674;15;28;0.151162790697674;0.348837209302326
Control.SRR15539829;45;45;0.488888888888889;23;22;0.0111111111111111;0.488888888888889
Control.SRR15539829;42;45;0.404761904761905;25;17;0.0952380952380952;0.404761904761905
Control.SRR15539829;40;45;0.675;13;27;0.175;0.325
Control.SRR15539829;46;45;0.41304347826087;27;19;0.0869565217391304;0.41304347826087
Control.SRR15539829;45;45;0.488888888888889;23;22;0.0111111111111111;0.488888888888889
Control.SRR15539829;44;45;0.568181818181818;19;25;0.0681818181818182;0.431818181818182
Control.SRR15539829;50;45;0.54;23;27;0.04;0.46
Control.SRR15539829;50;45;0.52;24;26;0.02;0.48
Control.SRR15539829;49;45;0.489795918367347;25;24;0.0102040816326531;0.489795918367347
Control.SRR15539829;49;45;0.63265306122449;18;31;0.13265306122449;0.36734693877551
Control.SRR15539829;44;45;0.613636363636364;17;27;0.113636363636364;0.386363636363636
Control.SRR15539829;48;45;0.458333333333333;26;22;0.0416666666666667;0.458333333333333
Control.SRR15539829;48;45;0.5;24;24;0;0.5
Control.SRR15539829;50;45;0.44;28;22;0.06;0.44
Control.SRR15539829;46;45;0.478260869565217;24;22;0.0217391304347826;0.478260869565217
Control.SRR15539829;52;45;0.557692307692308;23;29;0.0576923076923077;0.442307692307692
Control.SRR15539829;51;45;0.431372549019608;29;22;0.0686274509803921;0.431372549019608
Control.SRR15539829;47;45;0.531914893617021;22;25;0.0319148936170213;0.468085106382979
Control.SRR15539829;40;45;0.5;20;20;0;0.5
Control.SRR15539829;47;45;0.468085106382979;25;22;0.0319148936170213;0.468085106382979
Control.SRR15539829;44;45;0.522727272727273;21;23;0.0227272727272727;0.477272727272727
Control.SRR15539829;40;45;0.4;24;16;0.1;0.4
Control.SRR15539829;41;45;0.439024390243902;23;18;0.0609756097560976;0.439024390243902
Control.SRR15539829;48;45;0.5;24;24;0;0.5
Control.SRR15539829;52;45;0.480769230769231;27;25;0.0192307692307692;0.480769230769231
Control.SRR15539829;54;45;0.537037037037037;25;29;0.0370370370370371;0.462962962962963
Control.SRR15539829;40;45;0.575;17;23;0.075;0.425
Control.SRR15539829;46;45;0.41304347826087;27;19;0.0869565217391304;0.41304347826087
Control.SRR15539829;42;45;0.523809523809524;20;22;0.0238095238095238;0.476190476190476
Control.SRR15539829;42;45;0.333333333333333;28;14;0.166666666666667;0.333333333333333
Control.SRR15539829;45;45;0.266666666666667;33;12;0.233333333333333;0.266666666666667
Control.SRR15539829;42;45;0.476190476190476;22;20;0.0238095238095238;0.476190476190476
Control.SRR15539829;46;45;0.434782608695652;26;20;0.0652173913043478;0.434782608695652
Control.SRR15539829;49;45;0.653061224489796;17;32;0.153061224489796;0.346938775510204
Control.SRR15539829;50;45;0.44;28;22;0.06;0.44
Control.SRR15539829;42;45;0.571428571428571;18;24;0.0714285714285714;0.428571428571429
Control.SRR15539829;49;45;0.510204081632653;24;25;0.0102040816326531;0.489795918367347
Control.SRR15539829;48;45;0.5;24;24;0;0.5
Control.SRR15539829;44;45;0.386363636363636;27;17;0.113636363636364;0.386363636363636
Control.SRR15539829;50;45;0.5;25;25;0;0.5
Control.SRR15539829;43;45;0.488372093023256;22;21;0.0116279069767442;0.488372093023256
Control.SRR15539829;44;45;0.5;22;22;0;0.5
Control.SRR15539829;48;45;0.583333333333333;20;28;0.0833333333333334;0.416666666666667
Control.SRR15539829;45;45;0.511111111111111;22;23;0.0111111111111111;0.488888888888889
Control.SRR15539829;45;45;0.6;18;27;0.1;0.4
Control.SRR15539829;46;45;0.456521739130435;25;21;0.0434782608695652;0.456521739130435
Control.SRR15539829;47;45;0.48936170212766;24;23;0.0106382978723404;0.48936170212766
Control.SRR15539829;52;45;0.480769230769231;27;25;0.0192307692307692;0.480769230769231
Control.SRR15539829;51;45;0.647058823529412;18;33;0.147058823529412;0.352941176470588
Control.SRR15539829;47;45;0.446808510638298;26;21;0.0531914893617021;0.446808510638298
Control.SRR15539829;48;45;0.458333333333333;26;22;0.0416666666666667;0.458333333333333
Control.SRR15539829;42;45;0.547619047619048;19;23;0.0476190476190477;0.452380952380952
Control.SRR15539829;40;45;0.55;18;22;0.05;0.45
Control.SRR15539829;46;45;0.608695652173913;18;28;0.108695652173913;0.391304347826087
Control.SRR15539829;41;45;0.48780487804878;21;20;0.0121951219512195;0.48780487804878
Control.SRR15539829;40;45;0.5;20;20;0;0.5
Control.SRR15539829;43;45;0.395348837209302;26;17;0.104651162790698;0.395348837209302
Control.SRR15539829;46;45;0.478260869565217;24;22;0.0217391304347826;0.478260869565217
Control.SRR15539829;50;45;0.48;26;24;0.02;0.48
Control.SRR15539829;53;45;0.584905660377358;22;31;0.0849056603773585;0.415094339622642
Control.SRR15539829;52;45;0.615384615384615;20;32;0.115384615384615;0.384615384615385
Control.SRR15539829;47;45;0.531914893617021;22;25;0.0319148936170213;0.468085106382979
Control.SRR15539829;50;45;0.5;25;25;0;0.5
Control.SRR15539829;41;45;0.560975609756098;18;23;0.0609756097560976;0.439024390243902
Control.SRR15539829;45;45;0.377777777777778;28;17;0.122222222222222;0.377777777777778
Control.SRR15539829;46;45;0.521739130434783;22;24;0.0217391304347826;0.478260869565217
Control.SRR15539829;48;45;0.333333333333333;32;16;0.166666666666667;0.333333333333333
Control.SRR15539829;40;45;0.5;20;20;0;0.5
Control.SRR15539829;53;45;0.415094339622642;31;22;0.0849056603773585;0.415094339622642
Control.SRR15539829;50;45;0.42;29;21;0.08;0.42
Control.SRR15539829;46;45;0.695652173913043;14;32;0.195652173913043;0.304347826086957
Control.SRR15539829;46;45;0.5;23;23;0;0.5
Control.SRR15539829;45;45;0.444444444444444;25;20;0.0555555555555556;0.444444444444444
Control.SRR15539829;45;45;0.4;27;18;0.1;0.4
Control.SRR15539829;44;45;0.522727272727273;21;23;0.0227272727272727;0.477272727272727
Control.SRR15539829;51;45;0.509803921568627;25;26;0.00980392156862742;0.490196078431373
Control.SRR15539829;50;45;0.42;29;21;0.08;0.42
Control.SRR15539829;54;45;0.555555555555556;24;30;0.0555555555555556;0.444444444444444
Control.SRR15539829;49;45;0.612244897959184;19;30;0.112244897959184;0.387755102040816
Control.SRR15539829;48;45;0.520833333333333;23;25;0.0208333333333334;0.479166666666667
Control.SRR15539829;43;45;0.581395348837209;18;25;0.0813953488372093;0.418604651162791
Control.SRR15539829;46;45;0.608695652173913;18;28;0.108695652173913;0.391304347826087
Control.SRR15539829;44;45;0.454545454545455;24;20;0.0454545454545455;0.454545454545455
Control.SRR15539829;48;45;0.5625;21;27;0.0625;0.4375
Control.SRR15539829;54;45;0.462962962962963;29;25;0.037037037037037;0.462962962962963
Control.SRR15539829;54;45;0.462962962962963;29;25;0.037037037037037;0.462962962962963
Control.SRR15539829;47;45;0.574468085106383;20;27;0.074468085106383;0.425531914893617
Control.SRR15539829;43;45;0.395348837209302;26;17;0.104651162790698;0.395348837209302
Control.SRR15539829;42;45;0.547619047619048;19;23;0.0476190476190477;0.452380952380952
Control.SRR15539829;46;45;0.565217391304348;20;26;0.0652173913043478;0.434782608695652
Control.SRR15539829;47;45;0.595744680851064;19;28;0.0957446808510638;0.404255319148936
Control.SRR15539829;43;45;0.348837209302326;28;15;0.151162790697674;0.348837209302326
Control.SRR15539829;53;45;0.566037735849057;23;30;0.0660377358490566;0.433962264150943
Control.SRR15539829;42;45;0.452380952380952;23;19;0.0476190476190476;0.452380952380952
Control.SRR15539829;53;45;0.584905660377358;22;31;0.0849056603773585;0.415094339622642
Control.SRR15539829;54;45;0.5;27;27;0;0.5
Control.SRR15539829;48;45;0.458333333333333;26;22;0.0416666666666667;0.458333333333333
Control.SRR15539829;48;45;0.375;30;18;0.125;0.375
Control.SRR15539829;43;45;0.488372093023256;22;21;0.0116279069767442;0.488372093023256
Control.SRR15539829;42;45;0.547619047619048;19;23;0.0476190476190477;0.452380952380952
Control.SRR15539829;47;45;0.531914893617021;22;25;0.0319148936170213;0.468085106382979
Control.SRR15539829;48;45;0.520833333333333;23;25;0.0208333333333334;0.479166666666667
Control.SRR15539829;50;45;0.52;24;26;0.02;0.48
Control.SRR15539829;42;45;0.452380952380952;23;19;0.0476190476190476;0.452380952380952
Control.SRR15539829;41;45;0.439024390243902;23;18;0.0609756097560976;0.439024390243902
Control.SRR15539829;48;45;0.354166666666667;31;17;0.145833333333333;0.354166666666667
Control.SRR15539829;44;45;0.477272727272727;23;21;0.0227272727272727;0.477272727272727
Control.SRR15539829;48;45;0.5;24;24;0;0.5
Control.SRR15539829;47;45;0.553191489361702;21;26;0.0531914893617021;0.446808510638298
Control.SRR15539829;44;45;0.272727272727273;32;12;0.227272727272727;0.272727272727273
Control.SRR15539829;41;45;0.463414634146341;22;19;0.0365853658536585;0.463414634146341
Control.SRR15539829;51;45;0.490196078431373;26;25;0.00980392156862747;0.490196078431373
Control.SRR15539829;52;45;0.519230769230769;25;27;0.0192307692307693;0.480769230769231
Control.SRR15539829;40;45;0.5;20;20;0;0.5
Control.SRR15539829;48;45;0.604166666666667;19;29;0.104166666666667;0.395833333333333
Control.SRR15539829;40;45;0.55;18;22;0.05;0.45
Control.SRR15539829;45;45;0.577777777777778;19;26;0.0777777777777777;0.422222222222222
Control.SRR15539829;47;45;0.595744680851064;19;28;0.0957446808510638;0.404255319148936
Control.SRR15539829;46;45;0.565217391304348;20;26;0.0652173913043478;0.434782608695652
Control.SRR15539829;43;45;0.511627906976744;21;22;0.0116279069767442;0.488372093023256
Control.SRR15539829;42;45;0.547619047619048;19;23;0.0476190476190477;0.452380952380952
Control.SRR15539829;48;45;0.5625;21;27;0.0625;0.4375
Control.SRR15539829;40;45;0.375;25;15;0.125;0.375
Control.SRR15539829;47;45;0.574468085106383;20;27;0.074468085106383;0.425531914893617
Control.SRR15539829;48;45;0.479166666666667;25;23;0.0208333333333333;0.479166666666667
Control.SRR15539829;48;45;0.5625;21;27;0.0625;0.4375
Control.SRR15539829;49;45;0.510204081632653;24;25;0.0102040816326531;0.489795918367347
Control.SRR15539829;50;45;0.62;19;31;0.12;0.38
Control.SRR15539829;43;45;0.511627906976744;21;22;0.0116279069767442;0.488372093023256
Control.SRR15539829;51;45;0.431372549019608;29;22;0.0686274509803921;0.431372549019608
Control.SRR15539829;53;45;0.547169811320755;24;29;0.0471698113207547;0.452830188679245
Control.SRR15539829;51;45;0.549019607843137;23;28;0.0490196078431373;0.450980392156863
Control.SRR15539829;51;45;0.549019607843137;23;28;0.0490196078431373;0.450980392156863
Control.SRR15539829;42;45;0.595238095238095;17;25;0.0952380952380952;0.404761904761905
Control.SRR15539829;44;45;0.5;22;22;0;0.5
Control.SRR15539829;50;45;0.36;32;18;0.14;0.36
Control.SRR15539829;45;45;0.577777777777778;19;26;0.0777777777777777;0.422222222222222
Control.SRR15539829;52;45;0.403846153846154;31;21;0.0961538461538461;0.403846153846154
Control.SRR15539829;47;45;0.340425531914894;31;16;0.159574468085106;0.340425531914894
Control.SRR15539829;54;45;0.574074074074074;23;31;0.0740740740740741;0.425925925925926
Control.SRR15539829;54;45;0.611111111111111;21;33;0.111111111111111;0.388888888888889
Control.SRR15539829;46;45;0.347826086956522;30;16;0.152173913043478;0.347826086956522
Control.SRR15539829;48;45;0.416666666666667;28;20;0.0833333333333333;0.416666666666667
Control.SRR15539829;51;45;0.509803921568627;25;26;0.00980392156862742;0.490196078431373
Control.SRR15539829;54;45;0.537037037037037;25;29;0.0370370370370371;0.462962962962963
Control.SRR15539829;43;45;0.465116279069767;23;20;0.0348837209302326;0.465116279069767
Control.SRR15539829;46;45;0.5;23;23;0;0.5
Control.SRR15539829;54;45;0.425925925925926;31;23;0.0740740740740741;0.425925925925926
Control.SRR15539829;49;45;0.510204081632653;24;25;0.0102040816326531;0.489795918367347
Control.SRR15539829;48;45;0.375;30;18;0.125;0.375
Control.SRR15539829;42;45;0.452380952380952;23;19;0.0476190476190476;0.452380952380952
Control.SRR15539829;49;45;0.489795918367347;25;24;0.0102040816326531;0.489795918367347
Control.SRR15539829;43;45;0.465116279069767;23;20;0.0348837209302326;0.465116279069767
Control.SRR15539829;40;45;0.425;23;17;0.075;0.425
Control.SRR15539829;53;45;0.509433962264151;26;27;0.00943396226415094;0.490566037735849
Control.SRR15539829;52;45;0.461538461538462;28;24;0.0384615384615384;0.461538461538462
Control.SRR15539829;46;45;0.478260869565217;24;22;0.0217391304347826;0.478260869565217
Control.SRR15539829;49;45;0.551020408163265;22;27;0.0510204081632653;0.448979591836735
Control.SRR15539829;41;45;0.463414634146341;22;19;0.0365853658536585;0.463414634146341
Control.SRR15539829;43;45;0.418604651162791;25;18;0.0813953488372093;0.418604651162791
Control.SRR15539829;40;45;0.6;16;24;0.1;0.4
Control.SRR15539829;44;45;0.590909090909091;18;26;0.0909090909090909;0.409090909090909
Control.SRR15539829;44;45;0.477272727272727;23;21;0.0227272727272727;0.477272727272727
Control.SRR15539829;43;45;0.465116279069767;23;20;0.0348837209302326;0.465116279069767
Control.SRR15539829;47;45;0.595744680851064;19;28;0.0957446808510638;0.404255319148936
Control.SRR15539829;54;45;0.611111111111111;21;33;0.111111111111111;0.388888888888889
Control.SRR15539829;53;45;0.584905660377358;22;31;0.0849056603773585;0.415094339622642
Control.SRR15539829;48;45;0.5625;21;27;0.0625;0.4375
Control.SRR15539829;52;45;0.5;26;26;0;0.5
Control.SRR15539829;51;45;0.392156862745098;31;20;0.107843137254902;0.392156862745098
Control.SRR15539829;54;45;0.481481481481481;28;26;0.0185185185185185;0.481481481481481
Control.SRR15539829;43;45;0.651162790697674;15;28;0.151162790697674;0.348837209302326
Control.SRR15539829;42;45;0.380952380952381;26;16;0.119047619047619;0.380952380952381
Control.SRR15539829;52;45;0.557692307692308;23;29;0.0576923076923077;0.442307692307692
Control.SRR15539829;49;45;0.551020408163265;22;27;0.0510204081632653;0.448979591836735
Control.SRR15539829;47;45;0.48936170212766;24;23;0.0106382978723404;0.48936170212766
Control.SRR15539829;50;45;0.46;27;23;0.04;0.46
Control.SRR15539829;43;45;0.395348837209302;26;17;0.104651162790698;0.395348837209302
Control.SRR15539829;43;45;0.511627906976744;21;22;0.0116279069767442;0.488372093023256
Control.SRR15539829;43;45;0.418604651162791;25;18;0.0813953488372093;0.418604651162791
Control.SRR15539829;44;45;0.386363636363636;27;17;0.113636363636364;0.386363636363636
Control.SRR15539829;41;45;0.536585365853659;19;22;0.0365853658536586;0.463414634146341
Control.SRR15539829;51;45;0.490196078431373;26;25;0.00980392156862747;0.490196078431373
Control.SRR15539829;45;45;0.6;18;27;0.1;0.4
Control.SRR15539829;49;45;0.551020408163265;22;27;0.0510204081632653;0.448979591836735
Control.SRR15539829;45;45;0.488888888888889;23;22;0.0111111111111111;0.488888888888889
Control.SRR15539829;47;45;0.617021276595745;18;29;0.117021276595745;0.382978723404255
Control.SRR15539829;50;45;0.44;28;22;0.06;0.44
Control.SRR15539829;44;45;0.590909090909091;18;26;0.0909090909090909;0.409090909090909
Control.SRR15539829;41;45;0.463414634146341;22;19;0.0365853658536585;0.463414634146341
Control.SRR15539829;50;45;0.5;25;25;0;0.5
Control.SRR15539829;48;45;0.479166666666667;25;23;0.0208333333333333;0.479166666666667
Control.SRR15539829;50;45;0.54;23;27;0.04;0.46
Control.SRR15539829;49;45;0.571428571428571;21;28;0.0714285714285714;0.428571428571429
Control.SRR15539829;47;45;0.553191489361702;21;26;0.0531914893617021;0.446808510638298
Control.SRR15539829;43;45;0.604651162790698;17;26;0.104651162790698;0.395348837209302
Control.SRR15539829;49;45;0.489795918367347;25;24;0.0102040816326531;0.489795918367347
Control.SRR15539829;48;45;0.604166666666667;19;29;0.104166666666667;0.395833333333333
Control.SRR15539829;43;45;0.558139534883721;19;24;0.0581395348837209;0.441860465116279
Control.SRR15539829;39;45;0.461538461538462;21;18;0.0384615384615384;0.461538461538462
Control.SRR15539829;47;45;0.553191489361702;21;26;0.0531914893617021;0.446808510638298
Control.SRR15539829;45;45;0.488888888888889;23;22;0.0111111111111111;0.488888888888889
Control.SRR15539829;50;45;0.56;22;28;0.0600000000000001;0.44
Control.SRR15539829;51;45;0.529411764705882;24;27;0.0294117647058824;0.470588235294118
Control.SRR15539829;45;45;0.688888888888889;14;31;0.188888888888889;0.311111111111111
Control.SRR15539829;45;45;0.444444444444444;25;20;0.0555555555555556;0.444444444444444
Control.SRR15539829;48;45;0.395833333333333;29;19;0.104166666666667;0.395833333333333
Control.SRR15539829;50;45;0.58;21;29;0.08;0.42
Control.SRR15539829;49;45;0.346938775510204;32;17;0.153061224489796;0.346938775510204
Control.SRR15539829;40;45;0.5;20;20;0;0.5
Control.SRR15539829;44;45;0.409090909090909;26;18;0.0909090909090909;0.409090909090909
Control.SRR15539829;48;45;0.395833333333333;29;19;0.104166666666667;0.395833333333333
Control.SRR15539829;45;45;0.4;27;18;0.1;0.4
Control.SRR15539829;50;45;0.62;19;31;0.12;0.38
Control.SRR15539829;39;45;0.512820512820513;19;20;0.0128205128205128;0.487179487179487
Control.SRR15539829;43;45;0.558139534883721;19;24;0.0581395348837209;0.441860465116279
Control.SRR15539829;41;45;0.560975609756098;18;23;0.0609756097560976;0.439024390243902
Control.SRR15539829;40;45;0.325;27;13;0.175;0.325
Control.SRR15539829;49;45;0.428571428571429;28;21;0.0714285714285715;0.428571428571429
Control.SRR15539829;45;45;0.511111111111111;22;23;0.0111111111111111;0.488888888888889
Control.SRR15539829;49;45;0.469387755102041;26;23;0.0306122448979592;0.469387755102041
Control.SRR15539829;47;45;0.425531914893617;27;20;0.074468085106383;0.425531914893617
Control.SRR15539829;44;45;0.409090909090909;26;18;0.0909090909090909;0.409090909090909
Control.SRR15539829;42;45;0.5;21;21;0;0.5
Control.SRR15539829;51;45;0.431372549019608;29;22;0.0686274509803921;0.431372549019608
Control.SRR15539829;43;45;0.627906976744186;16;27;0.127906976744186;0.372093023255814
Control.SRR15539829;49;45;0.387755102040816;30;19;0.112244897959184;0.387755102040816
Control.SRR15539829;41;45;0.536585365853659;19;22;0.0365853658536586;0.463414634146341
Control.SRR15539829;51;45;0.568627450980392;22;29;0.0686274509803921;0.431372549019608
Control.SRR15539829;49;45;0.530612244897959;23;26;0.0306122448979592;0.469387755102041
Control.SRR15539829;47;45;0.468085106382979;25;22;0.0319148936170213;0.468085106382979
Control.SRR15539829;49;45;0.489795918367347;25;24;0.0102040816326531;0.489795918367347
Control.SRR15539829;44;45;0.477272727272727;23;21;0.0227272727272727;0.477272727272727
Control.SRR15539829;43;45;0.418604651162791;25;18;0.0813953488372093;0.418604651162791
Control.SRR15539829;50;45;0.5;25;25;0;0.5
Control.SRR15539829;51;45;0.431372549019608;29;22;0.0686274509803921;0.431372549019608
Control.SRR15539829;50;45;0.46;27;23;0.04;0.46
Control.SRR15539829;41;45;0.463414634146341;22;19;0.0365853658536585;0.463414634146341
Control.SRR15539829;40;45;0.425;23;17;0.075;0.425
Control.SRR15539829;47;45;0.574468085106383;20;27;0.074468085106383;0.425531914893617
Control.SRR15539829;46;45;0.456521739130435;25;21;0.0434782608695652;0.456521739130435
Control.SRR15539829;44;45;0.568181818181818;19;25;0.0681818181818182;0.431818181818182
Control.SRR15539829;49;45;0.612244897959184;19;30;0.112244897959184;0.387755102040816
Control.SRR15539829;39;45;0.487179487179487;20;19;0.0128205128205128;0.487179487179487
Control.SRR15539829;40;45;0.55;18;22;0.05;0.45
Control.SRR15539829;45;45;0.577777777777778;19;26;0.0777777777777777;0.422222222222222
Control.SRR15539829;50;45;0.48;26;24;0.02;0.48
Control.SRR15539829;47;45;0.361702127659574;30;17;0.138297872340426;0.361702127659574
Control.SRR15539829;47;45;0.404255319148936;28;19;0.0957446808510639;0.404255319148936
Control.SRR15539829;48;45;0.583333333333333;20;28;0.0833333333333334;0.416666666666667
Control.SRR15539829;45;45;0.555555555555556;20;25;0.0555555555555556;0.444444444444444
Control.SRR15539829;50;45;0.44;28;22;0.06;0.44
Control.SRR15539829;45;45;0.533333333333333;21;24;0.0333333333333333;0.466666666666667
Control.SRR15539829;50;45;0.46;27;23;0.04;0.46
Control.SRR15539829;45;45;0.488888888888889;23;22;0.0111111111111111;0.488888888888889
Control.SRR15539829;47;45;0.468085106382979;25;22;0.0319148936170213;0.468085106382979
Control.SRR15539829;43;45;0.534883720930233;20;23;0.0348837209302325;0.465116279069767
Control.SRR15539829;50;45;0.58;21;29;0.08;0.42
Control.SRR15539829;49;45;0.408163265306122;29;20;0.0918367346938775;0.408163265306122
Control.SRR15539829;44;45;0.568181818181818;19;25;0.0681818181818182;0.431818181818182
Control.SRR15539829;42;45;0.428571428571429;24;18;0.0714285714285715;0.428571428571429
Control.SRR15539829;48;45;0.458333333333333;26;22;0.0416666666666667;0.458333333333333
Control.SRR15539829;44;45;0.681818181818182;14;30;0.181818181818182;0.318181818181818
Control.SRR15539829;42;45;0.333333333333333;28;14;0.166666666666667;0.333333333333333
Control.SRR15539829;50;45;0.56;22;28;0.0600000000000001;0.44
Control.SRR15539829;47;45;0.319148936170213;32;15;0.180851063829787;0.319148936170213
Control.SRR15539829;42;45;0.595238095238095;17;25;0.0952380952380952;0.404761904761905
Control.SRR15539829;40;45;0.6;16;24;0.1;0.4
Control.SRR15539829;46;45;0.41304347826087;27;19;0.0869565217391304;0.41304347826087
Control.SRR15539829;45;45;0.577777777777778;19;26;0.0777777777777777;0.422222222222222
Control.SRR15539829;46;45;0.652173913043478;16;30;0.152173913043478;0.347826086956522
Control.SRR15539829;44;45;0.590909090909091;18;26;0.0909090909090909;0.409090909090909
Control.SRR15539829;39;45;0.487179487179487;20;19;0.0128205128205128;0.487179487179487
Control.SRR15539829;44;45;0.477272727272727;23;21;0.0227272727272727;0.477272727272727
Control.SRR15539829;45;45;0.577777777777778;19;26;0.0777777777777777;0.422222222222222
Control.SRR15539829;48;45;0.5;24;24;0;0.5
Control.SRR15539829;40;45;0.5;20;20;0;0.5
Control.SRR15539829;40;45;0.525;19;21;0.025;0.475
Control.SRR15539829;44;45;0.477272727272727;23;21;0.0227272727272727;0.477272727272727
Control.SRR15539829;39;45;0.435897435897436;22;17;0.0641025641025641;0.435897435897436
Control.SRR15539829;40;45;0.525;19;21;0.025;0.475
Control.SRR15539829;50;45;0.4;30;20;0.1;0.4
Control.SRR15539829;46;45;0.565217391304348;20;26;0.0652173913043478;0.434782608695652
Control.SRR15539829;45;45;0.466666666666667;24;21;0.0333333333333333;0.466666666666667
Control.SRR15539829;41;45;0.585365853658537;17;24;0.0853658536585366;0.414634146341463
Control.SRR15539829;45;45;0.444444444444444;25;20;0.0555555555555556;0.444444444444444
Control.SRR15539829;41;45;0.51219512195122;20;21;0.0121951219512195;0.48780487804878
Control.SRR15539829;51;45;0.431372549019608;29;22;0.0686274509803921;0.431372549019608
Control.SRR15539829;43;45;0.534883720930233;20;23;0.0348837209302325;0.465116279069767
Control.SRR15539829;49;45;0.530612244897959;23;26;0.0306122448979592;0.469387755102041
Control.SRR15539829;47;45;0.468085106382979;25;22;0.0319148936170213;0.468085106382979
Control.SRR15539829;47;45;0.574468085106383;20;27;0.074468085106383;0.425531914893617
Control.SRR15539829;50;45;0.58;21;29;0.08;0.42
Control.SRR15539829;48;45;0.5625;21;27;0.0625;0.4375
Control.SRR15539829;51;45;0.509803921568627;25;26;0.00980392156862742;0.490196078431373
Control.SRR15539829;44;45;0.477272727272727;23;21;0.0227272727272727;0.477272727272727
Control.SRR15539829;42;45;0.523809523809524;20;22;0.0238095238095238;0.476190476190476
Control.SRR15539829;41;45;0.365853658536585;26;15;0.134146341463415;0.365853658536585
Control.SRR15539829;39;45;0.461538461538462;21;18;0.0384615384615384;0.461538461538462
Control.SRR15539829;40;45;0.45;22;18;0.05;0.45
Control.SRR15539829;51;45;0.549019607843137;23;28;0.0490196078431373;0.450980392156863
Control.SRR15539829;47;45;0.446808510638298;26;21;0.0531914893617021;0.446808510638298
Control.SRR15539829;45;45;0.422222222222222;26;19;0.0777777777777778;0.422222222222222
Control.SRR15539829;48;45;0.520833333333333;23;25;0.0208333333333334;0.479166666666667
Control.SRR15539829;42;45;0.476190476190476;22;20;0.0238095238095238;0.476190476190476
Control.SRR15539829;48;45;0.604166666666667;19;29;0.104166666666667;0.395833333333333
Control.SRR15539829;46;45;0.521739130434783;22;24;0.0217391304347826;0.478260869565217
Control.SRR15539829;51;45;0.313725490196078;35;16;0.186274509803922;0.313725490196078
Control.SRR15539829;44;45;0.409090909090909;26;18;0.0909090909090909;0.409090909090909
Control.SRR15539829;47;45;0.425531914893617;27;20;0.074468085106383;0.425531914893617
Control.SRR15539829;45;45;0.533333333333333;21;24;0.0333333333333333;0.466666666666667
Control.SRR15539829;42;45;0.452380952380952;23;19;0.0476190476190476;0.452380952380952
Control.SRR15539829;50;45;0.5;25;25;0;0.5
Control.SRR15539829;50;45;0.48;26;24;0.02;0.48
Control.SRR15539829;47;45;0.404255319148936;28;19;0.0957446808510639;0.404255319148936
Control.SRR15539829;51;45;0.392156862745098;31;20;0.107843137254902;0.392156862745098
Control.SRR15539829;50;45;0.44;28;22;0.06;0.44
Control.SRR15539829;51;45;0.549019607843137;23;28;0.0490196078431373;0.450980392156863
Control.SRR15539829;46;45;0.456521739130435;25;21;0.0434782608695652;0.456521739130435
Control.SRR15539829;42;45;0.595238095238095;17;25;0.0952380952380952;0.404761904761905
Control.SRR15539829;41;45;0.439024390243902;23;18;0.0609756097560976;0.439024390243902
Control.SRR15539829;44;45;0.454545454545455;24;20;0.0454545454545455;0.454545454545455
Control.SRR15539829;41;45;0.609756097560976;16;25;0.109756097560976;0.390243902439024
Control.SRR15539829;41;45;0.536585365853659;19;22;0.0365853658536586;0.463414634146341
Control.SRR15539829;48;45;0.541666666666667;22;26;0.0416666666666666;0.458333333333333
Control.SRR15539829;46;45;0.391304347826087;28;18;0.108695652173913;0.391304347826087
Control.SRR15539829;42;45;0.428571428571429;24;18;0.0714285714285715;0.428571428571429
Control.SRR15539829;46;45;0.478260869565217;24;22;0.0217391304347826;0.478260869565217
Control.SRR15539829;44;45;0.454545454545455;24;20;0.0454545454545455;0.454545454545455
Control.SRR15539829;47;45;0.425531914893617;27;20;0.074468085106383;0.425531914893617
Control.SRR15539829;45;45;0.622222222222222;17;28;0.122222222222222;0.377777777777778
Control.SRR15539829;51;45;0.549019607843137;23;28;0.0490196078431373;0.450980392156863
Control.SRR15539829;40;45;0.425;23;17;0.075;0.425
Control.SRR15539829;50;45;0.54;23;27;0.04;0.46
Control.SRR15539829;44;45;0.5;22;22;0;0.5
Control.SRR15539829;40;45;0.45;22;18;0.05;0.45
Control.SRR15539829;39;45;0.461538461538462;21;18;0.0384615384615384;0.461538461538462
Control.SRR15539829;45;45;0.533333333333333;21;24;0.0333333333333333;0.466666666666667
Control.SRR15539829;48;45;0.625;18;30;0.125;0.375
Control.SRR15539829;51;45;0.549019607843137;23;28;0.0490196078431373;0.450980392156863
Control.SRR15539829;40;45;0.4;24;16;0.1;0.4
Control.SRR15539829;46;45;0.565217391304348;20;26;0.0652173913043478;0.434782608695652
Control.SRR15539829;47;45;0.553191489361702;21;26;0.0531914893617021;0.446808510638298
Control.SRR15539829;47;45;0.468085106382979;25;22;0.0319148936170213;0.468085106382979
Control.SRR15539829;42;45;0.5;21;21;0;0.5
Control.SRR15539829;41;45;0.414634146341463;24;17;0.0853658536585366;0.414634146341463
Control.SRR15539829;40;45;0.525;19;21;0.025;0.475
Control.SRR15539829;42;45;0.523809523809524;20;22;0.0238095238095238;0.476190476190476
Control.SRR15539829;40;45;0.525;19;21;0.025;0.475
Control.SRR15539829;39;45;0.512820512820513;19;20;0.0128205128205128;0.487179487179487
Control.SRR15539829;39;45;0.487179487179487;20;19;0.0128205128205128;0.487179487179487
Control.SRR15539829;48;45;0.479166666666667;25;23;0.0208333333333333;0.479166666666667
Control.SRR15539829;42;45;0.452380952380952;23;19;0.0476190476190476;0.452380952380952
Control.SRR15539829;44;45;0.545454545454545;20;24;0.0454545454545454;0.454545454545455
Control.SRR15539829;39;45;0.512820512820513;19;20;0.0128205128205128;0.487179487179487
Control.SRR15539829;49;45;0.448979591836735;27;22;0.0510204081632653;0.448979591836735
Control.SRR15539829;48;45;0.5;24;24;0;0.5
Control.SRR15539829;44;45;0.522727272727273;21;23;0.0227272727272727;0.477272727272727
Control.SRR15539829;49;45;0.551020408163265;22;27;0.0510204081632653;0.448979591836735
Control.SRR15539829;45;45;0.444444444444444;25;20;0.0555555555555556;0.444444444444444
Control.SRR15539829;49;45;0.530612244897959;23;26;0.0306122448979592;0.469387755102041
Control.SRR15539829;47;45;0.617021276595745;18;29;0.117021276595745;0.382978723404255
Control.SRR15539829;49;45;0.551020408163265;22;27;0.0510204081632653;0.448979591836735
Control.SRR15539829;45;45;0.422222222222222;26;19;0.0777777777777778;0.422222222222222
Control.SRR15539829;48;45;0.458333333333333;26;22;0.0416666666666667;0.458333333333333
Control.SRR15539829;44;45;0.590909090909091;18;26;0.0909090909090909;0.409090909090909
Control.SRR15539829;44;45;0.340909090909091;29;15;0.159090909090909;0.340909090909091
Control.SRR15539829;46;45;0.630434782608696;17;29;0.130434782608696;0.369565217391304
Control.SRR15539829;39;45;0.487179487179487;20;19;0.0128205128205128;0.487179487179487
Control.SRR15539829;42;45;0.547619047619048;19;23;0.0476190476190477;0.452380952380952
Control.SRR15539829;39;45;0.358974358974359;25;14;0.141025641025641;0.358974358974359
Control.SRR15539829;43;45;0.488372093023256;22;21;0.0116279069767442;0.488372093023256
Control.SRR15539829;41;45;0.463414634146341;22;19;0.0365853658536585;0.463414634146341
Control.SRR15539829;51;45;0.450980392156863;28;23;0.0490196078431372;0.450980392156863
Control.SRR15539829;46;45;0.456521739130435;25;21;0.0434782608695652;0.456521739130435
Control.SRR15539829;45;45;0.466666666666667;24;21;0.0333333333333333;0.466666666666667
Control.SRR15539829;41;45;0.390243902439024;25;16;0.109756097560976;0.390243902439024
Control.SRR15539829;39;45;0.512820512820513;19;20;0.0128205128205128;0.487179487179487
Control.SRR15539829;49;45;0.612244897959184;19;30;0.112244897959184;0.387755102040816
Control.SRR15539829;40;45;0.425;23;17;0.075;0.425
Control.SRR15539829;46;45;0.543478260869565;21;25;0.0434782608695652;0.456521739130435
Control.SRR15539829;39;45;0.538461538461538;18;21;0.0384615384615384;0.461538461538462
Control.SRR15539829;45;45;0.577777777777778;19;26;0.0777777777777777;0.422222222222222
Control.SRR15539829;47;45;0.446808510638298;26;21;0.0531914893617021;0.446808510638298
Control.SRR15539829;45;45;0.466666666666667;24;21;0.0333333333333333;0.466666666666667
Control.SRR15539829;41;45;0.317073170731707;28;13;0.182926829268293;0.317073170731707
Control.SRR15539829;41;45;0.390243902439024;25;16;0.109756097560976;0.390243902439024
Control.SRR15539829;43;45;0.302325581395349;30;13;0.197674418604651;0.302325581395349
Control.SRR15539829;50;45;0.42;29;21;0.08;0.42
Control.SRR15539829;39;45;0.615384615384615;15;24;0.115384615384615;0.384615384615385
Control.SRR15539829;49;45;0.714285714285714;14;35;0.214285714285714;0.285714285714286
Control.SRR15539829;40;45;0.425;23;17;0.075;0.425
Control.SRR15539829;41;45;0.536585365853659;19;22;0.0365853658536586;0.463414634146341
Control.SRR15539829;39;45;0.487179487179487;20;19;0.0128205128205128;0.487179487179487
Control.SRR15539829;45;45;0.444444444444444;25;20;0.0555555555555556;0.444444444444444
Control.SRR15539829;45;45;0.466666666666667;24;21;0.0333333333333333;0.466666666666667
Control.SRR15539829;42;45;0.452380952380952;23;19;0.0476190476190476;0.452380952380952
Control.SRR15539829;45;45;0.4;27;18;0.1;0.4
Control.SRR15539829;43;45;0.511627906976744;21;22;0.0116279069767442;0.488372093023256
Control.SRR15539829;44;45;0.568181818181818;19;25;0.0681818181818182;0.431818181818182
Control.SRR15539829;48;45;0.5;24;24;0;0.5
Control.SRR15539829;46;45;0.608695652173913;18;28;0.108695652173913;0.391304347826087
Control.SRR15539829;41;45;0.51219512195122;20;21;0.0121951219512195;0.48780487804878
Control.SRR15539829;40;45;0.55;18;22;0.05;0.45
Control.SRR15539829;40;45;0.525;19;21;0.025;0.475
Control.SRR15539829;41;45;0.536585365853659;19;22;0.0365853658536586;0.463414634146341
Control.SRR15539829;41;45;0.536585365853659;19;22;0.0365853658536586;0.463414634146341
Control.SRR15539829;45;45;0.466666666666667;24;21;0.0333333333333333;0.466666666666667
Control.SRR15539829;51;45;0.470588235294118;27;24;0.0294117647058824;0.470588235294118
Control.SRR15539829;48;45;0.541666666666667;22;26;0.0416666666666666;0.458333333333333
Control.SRR15539829;40;45;0.425;23;17;0.075;0.425
Control.SRR15539829;46;45;0.456521739130435;25;21;0.0434782608695652;0.456521739130435
Control.SRR15539829;41;45;0.48780487804878;21;20;0.0121951219512195;0.48780487804878
Control.SRR15539829;49;45;0.591836734693878;20;29;0.0918367346938775;0.408163265306122
Control.SRR15539829;43;45;0.651162790697674;15;28;0.151162790697674;0.348837209302326
Control.SRR15539829;41;45;0.609756097560976;16;25;0.109756097560976;0.390243902439024
Control.SRR15539829;42;45;0.523809523809524;20;22;0.0238095238095238;0.476190476190476
Control.SRR15539829;41;45;0.51219512195122;20;21;0.0121951219512195;0.48780487804878
Control.SRR15539829;41;45;0.439024390243902;23;18;0.0609756097560976;0.439024390243902
Control.SRR15539829;41;45;0.414634146341463;24;17;0.0853658536585366;0.414634146341463
Control.SRR15539829;48;45;0.4375;27;21;0.0625;0.4375
Control.SRR15539829;46;45;0.478260869565217;24;22;0.0217391304347826;0.478260869565217
Control.SRR15539829;51;45;0.450980392156863;28;23;0.0490196078431372;0.450980392156863
Control.SRR15539829;44;45;0.545454545454545;20;24;0.0454545454545454;0.454545454545455
Control.SRR15539829;47;45;0.425531914893617;27;20;0.074468085106383;0.425531914893617
Control.SRR15539829;47;45;0.617021276595745;18;29;0.117021276595745;0.382978723404255
Control.SRR15539829;40;45;0.5;20;20;0;0.5
Control.SRR15539829;40;45;0.475;21;19;0.025;0.475
Control.SRR15539829;48;45;0.4375;27;21;0.0625;0.4375
Control.SRR15539829;46;45;0.717391304347826;13;33;0.217391304347826;0.282608695652174
Control.SRR15539829;48;45;0.5625;21;27;0.0625;0.4375
Control.SRR15539829;44;45;0.340909090909091;29;15;0.159090909090909;0.340909090909091
Control.SRR15539829;45;45;0.4;27;18;0.1;0.4
Control.SRR15539829;44;45;0.477272727272727;23;21;0.0227272727272727;0.477272727272727
Control.SRR15539829;46;45;0.652173913043478;16;30;0.152173913043478;0.347826086956522
Control.SRR15539829;51;45;0.392156862745098;31;20;0.107843137254902;0.392156862745098
Control.SRR15539829;41;45;0.560975609756098;18;23;0.0609756097560976;0.439024390243902
Control.SRR15539829;44;45;0.568181818181818;19;25;0.0681818181818182;0.431818181818182
Control.SRR15539829;41;45;0.463414634146341;22;19;0.0365853658536585;0.463414634146341
Control.SRR15539829;40;45;0.4;24;16;0.1;0.4
Control.SRR15539829;46;45;0.543478260869565;21;25;0.0434782608695652;0.456521739130435
Control.SRR15539829;51;45;0.549019607843137;23;28;0.0490196078431373;0.450980392156863
Control.SRR15539829;47;45;0.404255319148936;28;19;0.0957446808510639;0.404255319148936
Control.SRR15539829;47;45;0.446808510638298;26;21;0.0531914893617021;0.446808510638298
Control.SRR15539829;41;45;0.463414634146341;22;19;0.0365853658536585;0.463414634146341
Control.SRR15539829;42;45;0.5;21;21;0;0.5
Control.SRR15539829;45;45;0.444444444444444;25;20;0.0555555555555556;0.444444444444444
Control.SRR15539829;42;45;0.476190476190476;22;20;0.0238095238095238;0.476190476190476
Control.SRR15539829;45;45;0.444444444444444;25;20;0.0555555555555556;0.444444444444444
Control.SRR15539829;49;45;0.571428571428571;21;28;0.0714285714285714;0.428571428571429
Control.SRR15539829;51;45;0.470588235294118;27;24;0.0294117647058824;0.470588235294118
Control.SRR15539829;43;45;0.488372093023256;22;21;0.0116279069767442;0.488372093023256
Control.SRR15539829;42;45;0.619047619047619;16;26;0.119047619047619;0.380952380952381
Control.SRR15539829;44;45;0.409090909090909;26;18;0.0909090909090909;0.409090909090909
Control.SRR15539829;43;45;0.511627906976744;21;22;0.0116279069767442;0.488372093023256
Control.SRR15539829;44;45;0.522727272727273;21;23;0.0227272727272727;0.477272727272727
Control.SRR15539829;44;45;0.590909090909091;18;26;0.0909090909090909;0.409090909090909
Control.SRR15539829;40;45;0.5;20;20;0;0.5
Control.SRR15539829;45;45;0.577777777777778;19;26;0.0777777777777777;0.422222222222222
Control.SRR15539829;43;45;0.395348837209302;26;17;0.104651162790698;0.395348837209302
Control.SRR15539829;48;45;0.583333333333333;20;28;0.0833333333333334;0.416666666666667
Control.SRR15539829;48;45;0.604166666666667;19;29;0.104166666666667;0.395833333333333
Control.SRR15539829;47;45;0.617021276595745;18;29;0.117021276595745;0.382978723404255
Control.SRR15539829;44;45;0.545454545454545;20;24;0.0454545454545454;0.454545454545455
Control.SRR15539829;46;45;0.58695652173913;19;27;0.0869565217391305;0.41304347826087
Control.SRR15539829;39;45;0.307692307692308;27;12;0.192307692307692;0.307692307692308
Control.SRR15539829;43;45;0.534883720930233;20;23;0.0348837209302325;0.465116279069767
Control.SRR15539829;41;45;0.585365853658537;17;24;0.0853658536585366;0.414634146341463
Control.SRR15539829;44;45;0.5;22;22;0;0.5
Control.SRR15539829;41;45;0.48780487804878;21;20;0.0121951219512195;0.48780487804878
Control.SRR15539829;51;45;0.392156862745098;31;20;0.107843137254902;0.392156862745098
Control.SRR15539829;39;45;0.564102564102564;17;22;0.0641025641025641;0.435897435897436
Control.SRR15539829;40;45;0.475;21;19;0.025;0.475
Control.SRR15539829;50;45;0.48;26;24;0.02;0.48
Control.SRR15539829;45;45;0.688888888888889;14;31;0.188888888888889;0.311111111111111
Control.SRR15539829;43;45;0.511627906976744;21;22;0.0116279069767442;0.488372093023256
Control.SRR15539829;50;45;0.46;27;23;0.04;0.46
Control.SRR15539829;43;45;0.441860465116279;24;19;0.0581395348837209;0.441860465116279
Control.SRR15539829;41;45;0.585365853658537;17;24;0.0853658536585366;0.414634146341463
Control.SRR15539829;43;45;0.488372093023256;22;21;0.0116279069767442;0.488372093023256
Control.SRR15539829;39;45;0.538461538461538;18;21;0.0384615384615384;0.461538461538462
Control.SRR15539829;48;45;0.458333333333333;26;22;0.0416666666666667;0.458333333333333
Control.SRR15539829;46;45;0.521739130434783;22;24;0.0217391304347826;0.478260869565217
Control.SRR15539829;42;45;0.571428571428571;18;24;0.0714285714285714;0.428571428571429
Control.SRR15539829;46;45;0.5;23;23;0;0.5
Control.SRR15539829;45;45;0.488888888888889;23;22;0.0111111111111111;0.488888888888889
Control.SRR15539829;42;45;0.595238095238095;17;25;0.0952380952380952;0.404761904761905
Control.SRR15539829;44;45;0.613636363636364;17;27;0.113636363636364;0.386363636363636
Control.SRR15539829;43;45;0.581395348837209;18;25;0.0813953488372093;0.418604651162791
Control.SRR15539829;41;45;0.414634146341463;24;17;0.0853658536585366;0.414634146341463
Control.SRR15539829;47;45;0.553191489361702;21;26;0.0531914893617021;0.446808510638298
Control.SRR15539829;44;45;0.522727272727273;21;23;0.0227272727272727;0.477272727272727
Control.SRR15539829;42;45;0.476190476190476;22;20;0.0238095238095238;0.476190476190476
Control.SRR15539829;39;45;0.41025641025641;23;16;0.0897435897435898;0.41025641025641
Control.SRR15539829;45;45;0.511111111111111;22;23;0.0111111111111111;0.488888888888889
Control.SRR15539829;51;45;0.529411764705882;24;27;0.0294117647058824;0.470588235294118
Control.SRR15539829;40;45;0.45;22;18;0.05;0.45
Control.SRR15539829;48;45;0.645833333333333;17;31;0.145833333333333;0.354166666666667
Control.SRR15539829;47;45;0.51063829787234;23;24;0.0106382978723404;0.48936170212766
Control.SRR15539829;51;45;0.450980392156863;28;23;0.0490196078431372;0.450980392156863
Control.SRR15539829;50;45;0.62;19;31;0.12;0.38
Control.SRR15539829;51;45;0.529411764705882;24;27;0.0294117647058824;0.470588235294118
Control.SRR15539829;41;45;0.365853658536585;26;15;0.134146341463415;0.365853658536585
Control.SRR15539829;44;45;0.545454545454545;20;24;0.0454545454545454;0.454545454545455
Control.SRR15539829;50;45;0.56;22;28;0.0600000000000001;0.44
Control.SRR15539829;41;45;0.48780487804878;21;20;0.0121951219512195;0.48780487804878
Control.SRR15539829;45;45;0.533333333333333;21;24;0.0333333333333333;0.466666666666667
Control.SRR15539829;47;45;0.404255319148936;28;19;0.0957446808510639;0.404255319148936
Control.SRR15539829;40;45;0.55;18;22;0.05;0.45
Control.SRR15539829;42;45;0.523809523809524;20;22;0.0238095238095238;0.476190476190476
Control.SRR15539829;50;45;0.46;27;23;0.04;0.46
Control.SRR15539829;46;45;0.58695652173913;19;27;0.0869565217391305;0.41304347826087
Control.SRR15539829;49;45;0.448979591836735;27;22;0.0510204081632653;0.448979591836735
Control.SRR15539829;44;45;0.5;22;22;0;0.5
Control.SRR15539829;39;45;0.538461538461538;18;21;0.0384615384615384;0.461538461538462
Control.SRR15539829;44;45;0.431818181818182;25;19;0.0681818181818182;0.431818181818182
Control.SRR15539829;43;45;0.534883720930233;20;23;0.0348837209302325;0.465116279069767
Control.SRR15539829;43;45;0.441860465116279;24;19;0.0581395348837209;0.441860465116279
Control.SRR15539829;39;45;0.538461538461538;18;21;0.0384615384615384;0.461538461538462
Control.SRR15539829;49;45;0.591836734693878;20;29;0.0918367346938775;0.408163265306122
Control.SRR15539829;39;45;0.538461538461538;18;21;0.0384615384615384;0.461538461538462
Control.SRR15539829;41;45;0.414634146341463;24;17;0.0853658536585366;0.414634146341463
Control.SRR15539829;48;45;0.541666666666667;22;26;0.0416666666666666;0.458333333333333
Control.SRR15539829;48;45;0.541666666666667;22;26;0.0416666666666666;0.458333333333333
Control.SRR15539829;39;45;0.564102564102564;17;22;0.0641025641025641;0.435897435897436
Control.SRR15539829;46;45;0.434782608695652;26;20;0.0652173913043478;0.434782608695652
Control.SRR15539829;39;45;0.461538461538462;21;18;0.0384615384615384;0.461538461538462
Control.SRR15539829;50;45;0.42;29;21;0.08;0.42
Control.SRR15539829;41;45;0.585365853658537;17;24;0.0853658536585366;0.414634146341463
Control.SRR15539829;49;45;0.571428571428571;21;28;0.0714285714285714;0.428571428571429
Control.SRR15539829;49;45;0.489795918367347;25;24;0.0102040816326531;0.489795918367347
Control.SRR15539829;44;45;0.454545454545455;24;20;0.0454545454545455;0.454545454545455
Control.SRR15539829;40;45;0.45;22;18;0.05;0.45
Control.SRR15539829;42;45;0.619047619047619;16;26;0.119047619047619;0.380952380952381
Control.SRR15539829;44;45;0.386363636363636;27;17;0.113636363636364;0.386363636363636
Control.SRR15539829;43;45;0.674418604651163;14;29;0.174418604651163;0.325581395348837
Control.SRR15539829;45;45;0.622222222222222;17;28;0.122222222222222;0.377777777777778
Control.SRR15539829;42;45;0.5;21;21;0;0.5
Control.SRR15539829;44;45;0.431818181818182;25;19;0.0681818181818182;0.431818181818182
Control.SRR15539829;45;45;0.577777777777778;19;26;0.0777777777777777;0.422222222222222
Control.SRR15539829;49;45;0.428571428571429;28;21;0.0714285714285715;0.428571428571429
Control.SRR15539829;44;45;0.340909090909091;29;15;0.159090909090909;0.340909090909091
Control.SRR15539829;46;45;0.5;23;23;0;0.5
Control.SRR15539829;48;45;0.5;24;24;0;0.5
Control.SRR15539829;40;45;0.525;19;21;0.025;0.475
Control.SRR15539829;40;45;0.525;19;21;0.025;0.475
Control.SRR15539829;39;45;0.512820512820513;19;20;0.0128205128205128;0.487179487179487
Control.SRR15539829;49;45;0.530612244897959;23;26;0.0306122448979592;0.469387755102041
Control.SRR15539829;49;45;0.530612244897959;23;26;0.0306122448979592;0.469387755102041
Control.SRR15539829;41;45;0.414634146341463;24;17;0.0853658536585366;0.414634146341463
Control.SRR15539829;50;45;0.54;23;27;0.04;0.46
Control.SRR15539829;49;45;0.448979591836735;27;22;0.0510204081632653;0.448979591836735
Control.SRR15539829;50;45;0.46;27;23;0.04;0.46
Control.SRR15539829;45;45;0.577777777777778;19;26;0.0777777777777777;0.422222222222222
Control.SRR15539829;46;45;0.521739130434783;22;24;0.0217391304347826;0.478260869565217
Control.SRR15539829;48;45;0.479166666666667;25;23;0.0208333333333333;0.479166666666667
Control.SRR15539829;47;45;0.553191489361702;21;26;0.0531914893617021;0.446808510638298
Control.SRR15539829;46;45;0.58695652173913;19;27;0.0869565217391305;0.41304347826087
Control.SRR15539829;43;45;0.441860465116279;24;19;0.0581395348837209;0.441860465116279
Control.SRR15539829;42;45;0.5;21;21;0;0.5
Control.SRR15539829;47;45;0.553191489361702;21;26;0.0531914893617021;0.446808510638298
Control.SRR15539829;44;45;0.568181818181818;19;25;0.0681818181818182;0.431818181818182
Control.SRR15539829;49;45;0.571428571428571;21;28;0.0714285714285714;0.428571428571429
Control.SRR15539829;51;45;0.431372549019608;29;22;0.0686274509803921;0.431372549019608
Control.SRR15539829;44;45;0.454545454545455;24;20;0.0454545454545455;0.454545454545455
Control.SRR15539829;43;45;0.465116279069767;23;20;0.0348837209302326;0.465116279069767
Control.SRR15539829;46;45;0.434782608695652;26;20;0.0652173913043478;0.434782608695652
Control.SRR15539829;40;45;0.575;17;23;0.075;0.425
Control.SRR15539829;45;45;0.555555555555556;20;25;0.0555555555555556;0.444444444444444
Control.SRR15539829;41;45;0.560975609756098;18;23;0.0609756097560976;0.439024390243902
Control.SRR15539829;46;45;0.478260869565217;24;22;0.0217391304347826;0.478260869565217
Control.SRR15539829;46;45;0.543478260869565;21;25;0.0434782608695652;0.456521739130435
Control.SRR15539829;39;45;0.641025641025641;14;25;0.141025641025641;0.358974358974359
Control.SRR15539829;47;45;0.425531914893617;27;20;0.074468085106383;0.425531914893617
Control.SRR15539829;39;45;0.641025641025641;14;25;0.141025641025641;0.358974358974359
Control.SRR15539829;40;45;0.6;16;24;0.1;0.4
Control.SRR15539829;42;45;0.5;21;21;0;0.5
Control.SRR15539829;47;45;0.553191489361702;21;26;0.0531914893617021;0.446808510638298
Control.SRR15539829;43;45;0.511627906976744;21;22;0.0116279069767442;0.488372093023256
Control.SRR15539829;45;45;0.666666666666667;15;30;0.166666666666667;0.333333333333333
Control.SRR15539829;44;45;0.590909090909091;18;26;0.0909090909090909;0.409090909090909
Control.SRR15539829;47;45;0.595744680851064;19;28;0.0957446808510638;0.404255319148936
Control.SRR15539829;50;45;0.5;25;25;0;0.5
Control.SRR15539829;47;45;0.51063829787234;23;24;0.0106382978723404;0.48936170212766
Control.SRR15539829;44;45;0.613636363636364;17;27;0.113636363636364;0.386363636363636
Control.SRR15539829;49;45;0.653061224489796;17;32;0.153061224489796;0.346938775510204
Control.SRR15539829;41;45;0.439024390243902;23;18;0.0609756097560976;0.439024390243902
Control.SRR15539829;46;45;0.456521739130435;25;21;0.0434782608695652;0.456521739130435
Control.SRR15539829;41;45;0.51219512195122;20;21;0.0121951219512195;0.48780487804878
Control.SRR15539829;39;45;0.58974358974359;16;23;0.0897435897435898;0.41025641025641
Control.SRR15539829;46;45;0.608695652173913;18;28;0.108695652173913;0.391304347826087
Control.SRR15539829;45;45;0.488888888888889;23;22;0.0111111111111111;0.488888888888889
Control.SRR15539829;43;45;0.488372093023256;22;21;0.0116279069767442;0.488372093023256
Control.SRR15539829;42;45;0.547619047619048;19;23;0.0476190476190477;0.452380952380952
Control.SRR15539829;40;45;0.6;16;24;0.1;0.4
Control.SRR15539829;44;45;0.431818181818182;25;19;0.0681818181818182;0.431818181818182
Control.SRR15539829;43;45;0.348837209302326;28;15;0.151162790697674;0.348837209302326
Control.SRR15539829;43;45;0.604651162790698;17;26;0.104651162790698;0.395348837209302
Control.SRR15539829;43;45;0.441860465116279;24;19;0.0581395348837209;0.441860465116279
Control.SRR15539829;44;45;0.5;22;22;0;0.5
Control.SRR15539829;43;45;0.534883720930233;20;23;0.0348837209302325;0.465116279069767
Control.SRR15539829;41;45;0.463414634146341;22;19;0.0365853658536585;0.463414634146341
Control.SRR15539829;47;45;0.574468085106383;20;27;0.074468085106383;0.425531914893617
Control.SRR15539829;46;45;0.456521739130435;25;21;0.0434782608695652;0.456521739130435
Control.SRR15539829;50;45;0.52;24;26;0.02;0.48
Control.SRR15539829;45;45;0.577777777777778;19;26;0.0777777777777777;0.422222222222222
Control.SRR15539829;49;45;0.551020408163265;22;27;0.0510204081632653;0.448979591836735
Control.SRR15539829;41;45;0.439024390243902;23;18;0.0609756097560976;0.439024390243902
Control.SRR15539829;46;45;0.58695652173913;19;27;0.0869565217391305;0.41304347826087
Control.SRR15539829;41;45;0.634146341463415;15;26;0.134146341463415;0.365853658536585
Control.SRR15539829;42;45;0.619047619047619;16;26;0.119047619047619;0.380952380952381
Control.SRR15539829;50;45;0.48;26;24;0.02;0.48
Control.SRR15539829;40;45;0.5;20;20;0;0.5
Control.SRR15539829;46;45;0.391304347826087;28;18;0.108695652173913;0.391304347826087
Control.SRR15539829;49;45;0.408163265306122;29;20;0.0918367346938775;0.408163265306122
Control.SRR15539829;44;45;0.522727272727273;21;23;0.0227272727272727;0.477272727272727
Control.SRR15539829;42;45;0.476190476190476;22;20;0.0238095238095238;0.476190476190476
Control.SRR15539829;42;45;0.428571428571429;24;18;0.0714285714285715;0.428571428571429
Control.SRR15539829;45;45;0.488888888888889;23;22;0.0111111111111111;0.488888888888889
Control.SRR15539829;49;45;0.346938775510204;32;17;0.153061224489796;0.346938775510204
Control.SRR15539829;50;45;0.52;24;26;0.02;0.48
Control.SRR15539829;52;45;0.557692307692308;23;29;0.0576923076923077;0.442307692307692
Control.SRR15539829;50;45;0.5;25;25;0;0.5
Control.SRR15539829;49;45;0.571428571428571;21;28;0.0714285714285714;0.428571428571429
Control.SRR15539829;45;45;0.622222222222222;17;28;0.122222222222222;0.377777777777778
Control.SRR15539829;51;45;0.588235294117647;21;30;0.0882352941176471;0.411764705882353
Control.SRR15539829;43;45;0.558139534883721;19;24;0.0581395348837209;0.441860465116279
Control.SRR15539829;45;45;0.533333333333333;21;24;0.0333333333333333;0.466666666666667
Control.SRR15539829;48;45;0.666666666666667;16;32;0.166666666666667;0.333333333333333
Control.SRR15539829;53;45;0.509433962264151;26;27;0.00943396226415094;0.490566037735849
Control.SRR15539829;45;45;0.533333333333333;21;24;0.0333333333333333;0.466666666666667
Control.SRR15539829;45;45;0.533333333333333;21;24;0.0333333333333333;0.466666666666667
Control.SRR15539829;41;45;0.317073170731707;28;13;0.182926829268293;0.317073170731707
Control.SRR15539829;47;45;0.48936170212766;24;23;0.0106382978723404;0.48936170212766
Control.SRR15539829;42;45;0.476190476190476;22;20;0.0238095238095238;0.476190476190476
Control.SRR15539829;44;45;0.568181818181818;19;25;0.0681818181818182;0.431818181818182
Control.SRR15539829;46;45;0.478260869565217;24;22;0.0217391304347826;0.478260869565217
Control.SRR15539829;51;45;0.509803921568627;25;26;0.00980392156862742;0.490196078431373
Control.SRR15539829;50;45;0.54;23;27;0.04;0.46
Control.SRR15539829;43;45;0.674418604651163;14;29;0.174418604651163;0.325581395348837
Control.SRR15539829;53;45;0.547169811320755;24;29;0.0471698113207547;0.452830188679245
Control.SRR15539829;41;45;0.536585365853659;19;22;0.0365853658536586;0.463414634146341
Control.SRR15539829;43;45;0.534883720930233;20;23;0.0348837209302325;0.465116279069767
Control.SRR15539829;50;45;0.52;24;26;0.02;0.48
Control.SRR15539829;43;45;0.627906976744186;16;27;0.127906976744186;0.372093023255814
Control.SRR15539829;52;45;0.480769230769231;27;25;0.0192307692307692;0.480769230769231
Control.SRR15539829;52;45;0.538461538461538;24;28;0.0384615384615384;0.461538461538462
Control.SRR15539829;49;45;0.489795918367347;25;24;0.0102040816326531;0.489795918367347
Control.SRR15539829;44;45;0.454545454545455;24;20;0.0454545454545455;0.454545454545455
Control.SRR15539829;50;45;0.48;26;24;0.02;0.48
Control.SRR15539829;42;45;0.595238095238095;17;25;0.0952380952380952;0.404761904761905
Control.SRR15539829;42;45;0.476190476190476;22;20;0.0238095238095238;0.476190476190476
Control.SRR15539829;42;45;0.595238095238095;17;25;0.0952380952380952;0.404761904761905
Control.SRR15539829;50;45;0.44;28;22;0.06;0.44
Control.SRR15539829;49;45;0.551020408163265;22;27;0.0510204081632653;0.448979591836735
Control.SRR15539829;45;45;0.422222222222222;26;19;0.0777777777777778;0.422222222222222
Control.SRR15539829;48;45;0.458333333333333;26;22;0.0416666666666667;0.458333333333333
Control.SRR15539829;49;45;0.469387755102041;26;23;0.0306122448979592;0.469387755102041
Control.SRR15539829;51;45;0.431372549019608;29;22;0.0686274509803921;0.431372549019608
Control.SRR15539829;42;45;0.547619047619048;19;23;0.0476190476190477;0.452380952380952
Control.SRR15539829;45;45;0.555555555555556;20;25;0.0555555555555556;0.444444444444444
Control.SRR15539829;42;45;0.404761904761905;25;17;0.0952380952380952;0.404761904761905
Control.SRR15539829;46;45;0.456521739130435;25;21;0.0434782608695652;0.456521739130435
Control.SRR15539829;47;45;0.51063829787234;23;24;0.0106382978723404;0.48936170212766
Control.SRR15539829;51;45;0.411764705882353;30;21;0.0882352941176471;0.411764705882353
Control.SRR15539829;47;45;0.404255319148936;28;19;0.0957446808510639;0.404255319148936
Control.SRR15539829;45;45;0.444444444444444;25;20;0.0555555555555556;0.444444444444444
Control.SRR15539829;51;45;0.568627450980392;22;29;0.0686274509803921;0.431372549019608
Control.SRR15539829;50;45;0.56;22;28;0.0600000000000001;0.44
Control.SRR15539829;46;45;0.478260869565217;24;22;0.0217391304347826;0.478260869565217
Control.SRR15539829;45;45;0.511111111111111;22;23;0.0111111111111111;0.488888888888889
Control.SRR15539829;40;45;0.45;22;18;0.05;0.45
Control.SRR15539829;44;45;0.568181818181818;19;25;0.0681818181818182;0.431818181818182
Control.SRR15539829;46;45;0.5;23;23;0;0.5
Control.SRR15539829;43;45;0.511627906976744;21;22;0.0116279069767442;0.488372093023256
Control.SRR15539829;45;45;0.577777777777778;19;26;0.0777777777777777;0.422222222222222
Control.SRR15539829;45;45;0.511111111111111;22;23;0.0111111111111111;0.488888888888889
Control.SRR15539829;44;45;0.431818181818182;25;19;0.0681818181818182;0.431818181818182
Control.SRR15539829;47;45;0.531914893617021;22;25;0.0319148936170213;0.468085106382979
Control.SRR15539829;45;45;0.444444444444444;25;20;0.0555555555555556;0.444444444444444
Control.SRR15539829;53;45;0.39622641509434;32;21;0.10377358490566;0.39622641509434
Control.SRR15539829;53;45;0.509433962264151;26;27;0.00943396226415094;0.490566037735849
Control.SRR15539829;51;45;0.529411764705882;24;27;0.0294117647058824;0.470588235294118
Control.SRR15539829;42;45;0.619047619047619;16;26;0.119047619047619;0.380952380952381
Control.SRR15539829;49;45;0.469387755102041;26;23;0.0306122448979592;0.469387755102041
Control.SRR15539829;51;45;0.490196078431373;26;25;0.00980392156862747;0.490196078431373
Control.SRR15539829;40;45;0.45;22;18;0.05;0.45
Control.SRR15539829;46;45;0.478260869565217;24;22;0.0217391304347826;0.478260869565217
Control.SRR15539829;42;45;0.5;21;21;0;0.5
Control.SRR15539829;46;45;0.565217391304348;20;26;0.0652173913043478;0.434782608695652
Control.SRR15539829;45;45;0.511111111111111;22;23;0.0111111111111111;0.488888888888889
Control.SRR15539829;43;45;0.534883720930233;20;23;0.0348837209302325;0.465116279069767
Control.SRR15539829;49;45;0.571428571428571;21;28;0.0714285714285714;0.428571428571429
Control.SRR15539829;53;45;0.547169811320755;24;29;0.0471698113207547;0.452830188679245
Control.SRR15539829;46;45;0.391304347826087;28;18;0.108695652173913;0.391304347826087
Control.SRR15539829;46;45;0.565217391304348;20;26;0.0652173913043478;0.434782608695652
Control.SRR15539829;45;45;0.533333333333333;21;24;0.0333333333333333;0.466666666666667
Control.SRR15539829;53;45;0.60377358490566;21;32;0.10377358490566;0.39622641509434
Control.SRR15539829;49;45;0.428571428571429;28;21;0.0714285714285715;0.428571428571429
Control.SRR15539829;46;45;0.58695652173913;19;27;0.0869565217391305;0.41304347826087
Control.SRR15539829;40;45;0.45;22;18;0.05;0.45
Control.SRR15539829;50;45;0.52;24;26;0.02;0.48
Control.SRR15539829;42;45;0.523809523809524;20;22;0.0238095238095238;0.476190476190476
Control.SRR15539829;47;45;0.51063829787234;23;24;0.0106382978723404;0.48936170212766
Control.SRR15539829;43;45;0.441860465116279;24;19;0.0581395348837209;0.441860465116279
Control.SRR15539829;43;45;0.441860465116279;24;19;0.0581395348837209;0.441860465116279
Control.SRR15539829;51;45;0.450980392156863;28;23;0.0490196078431372;0.450980392156863
Control.SRR15539829;45;45;0.311111111111111;31;14;0.188888888888889;0.311111111111111
Control.SRR15539829;49;45;0.469387755102041;26;23;0.0306122448979592;0.469387755102041
Control.SRR15539829;46;45;0.521739130434783;22;24;0.0217391304347826;0.478260869565217
Control.SRR15539829;41;45;0.195121951219512;33;8;0.304878048780488;0.195121951219512
Control.SRR15539829;44;45;0.477272727272727;23;21;0.0227272727272727;0.477272727272727
Control.SRR15539829;42;45;0.547619047619048;19;23;0.0476190476190477;0.452380952380952
Control.SRR15539829;53;45;0.60377358490566;21;32;0.10377358490566;0.39622641509434
Control.SRR15539829;53;45;0.547169811320755;24;29;0.0471698113207547;0.452830188679245
Control.SRR15539829;51;45;0.529411764705882;24;27;0.0294117647058824;0.470588235294118
Control.SRR15539829;46;45;0.543478260869565;21;25;0.0434782608695652;0.456521739130435
Control.SRR15539829;46;45;0.434782608695652;26;20;0.0652173913043478;0.434782608695652
Control.SRR15539829;50;45;0.42;29;21;0.08;0.42
Control.SRR15539829;43;45;0.418604651162791;25;18;0.0813953488372093;0.418604651162791
Control.SRR15539829;47;45;0.446808510638298;26;21;0.0531914893617021;0.446808510638298
Control.SRR15539829;40;45;0.525;19;21;0.025;0.475
Control.SRR15539829;48;45;0.479166666666667;25;23;0.0208333333333333;0.479166666666667
Control.SRR15539829;49;45;0.591836734693878;20;29;0.0918367346938775;0.408163265306122
Control.SRR15539829;44;45;0.590909090909091;18;26;0.0909090909090909;0.409090909090909
Control.SRR15539829;41;45;0.51219512195122;20;21;0.0121951219512195;0.48780487804878
Control.SRR15539829;44;45;0.431818181818182;25;19;0.0681818181818182;0.431818181818182
Control.SRR15539829;47;45;0.425531914893617;27;20;0.074468085106383;0.425531914893617
Control.SRR15539829;42;45;0.452380952380952;23;19;0.0476190476190476;0.452380952380952
Control.SRR15539829;42;45;0.428571428571429;24;18;0.0714285714285715;0.428571428571429
Control.SRR15539829;47;45;0.425531914893617;27;20;0.074468085106383;0.425531914893617
Control.SRR15539829;45;45;0.377777777777778;28;17;0.122222222222222;0.377777777777778
Control.SRR15539829;53;45;0.584905660377358;22;31;0.0849056603773585;0.415094339622642
Control.SRR15539829;42;45;0.595238095238095;17;25;0.0952380952380952;0.404761904761905
Control.SRR15539829;53;45;0.433962264150943;30;23;0.0660377358490566;0.433962264150943
Control.SRR15539829;53;45;0.528301886792453;25;28;0.0283018867924528;0.471698113207547
Control.SRR15539829;47;45;0.51063829787234;23;24;0.0106382978723404;0.48936170212766
Control.SRR15539829;51;45;0.411764705882353;30;21;0.0882352941176471;0.411764705882353
Control.SRR15539829;50;45;0.58;21;29;0.08;0.42
Control.SRR15539829;45;45;0.488888888888889;23;22;0.0111111111111111;0.488888888888889
Control.SRR15539829;53;45;0.433962264150943;30;23;0.0660377358490566;0.433962264150943
Control.SRR15539829;48;45;0.4375;27;21;0.0625;0.4375
Control.SRR15539829;50;45;0.36;32;18;0.14;0.36
Control.SRR15539829;45;45;0.444444444444444;25;20;0.0555555555555556;0.444444444444444
Control.SRR15539829;51;45;0.568627450980392;22;29;0.0686274509803921;0.431372549019608
Control.SRR15539829;42;45;0.547619047619048;19;23;0.0476190476190477;0.452380952380952
Control.SRR15539829;48;45;0.541666666666667;22;26;0.0416666666666666;0.458333333333333
Control.SRR15539829;41;45;0.463414634146341;22;19;0.0365853658536585;0.463414634146341
Control.SRR15539829;51;45;0.529411764705882;24;27;0.0294117647058824;0.470588235294118
Control.SRR15539829;45;45;0.511111111111111;22;23;0.0111111111111111;0.488888888888889
Control.SRR15539829;53;45;0.547169811320755;24;29;0.0471698113207547;0.452830188679245
Control.SRR15539829;51;45;0.529411764705882;24;27;0.0294117647058824;0.470588235294118
Control.SRR15539829;47;45;0.48936170212766;24;23;0.0106382978723404;0.48936170212766
Control.SRR15539829;50;45;0.46;27;23;0.04;0.46
Control.SRR15539829;51;45;0.529411764705882;24;27;0.0294117647058824;0.470588235294118
Control.SRR15539829;49;45;0.428571428571429;28;21;0.0714285714285715;0.428571428571429
Control.SRR15539829;52;45;0.557692307692308;23;29;0.0576923076923077;0.442307692307692
Control.SRR15539829;51;45;0.568627450980392;22;29;0.0686274509803921;0.431372549019608
Control.SRR15539829;49;45;0.489795918367347;25;24;0.0102040816326531;0.489795918367347
Control.SRR15539829;51;45;0.490196078431373;26;25;0.00980392156862747;0.490196078431373
Control.SRR15539829;50;45;0.56;22;28;0.0600000000000001;0.44
Control.SRR15539829;46;45;0.543478260869565;21;25;0.0434782608695652;0.456521739130435
Control.SRR15539829;53;45;0.584905660377358;22;31;0.0849056603773585;0.415094339622642
Control.SRR15539829;44;45;0.386363636363636;27;17;0.113636363636364;0.386363636363636
Control.SRR15539829;43;45;0.534883720930233;20;23;0.0348837209302325;0.465116279069767
Control.SRR15539829;44;45;0.704545454545455;13;31;0.204545454545455;0.295454545454545
Control.SRR15539829;41;45;0.51219512195122;20;21;0.0121951219512195;0.48780487804878
Control.SRR15539829;42;45;0.666666666666667;14;28;0.166666666666667;0.333333333333333
Control.SRR15539829;52;45;0.5;26;26;0;0.5
Control.SRR15539829;47;45;0.468085106382979;25;22;0.0319148936170213;0.468085106382979
Control.SRR15539829;40;45;0.475;21;19;0.025;0.475
Control.SRR15539829;47;45;0.468085106382979;25;22;0.0319148936170213;0.468085106382979
Control.SRR15539829;48;45;0.625;18;30;0.125;0.375
Control.SRR15539829;53;45;0.60377358490566;21;32;0.10377358490566;0.39622641509434
Control.SRR15539829;44;45;0.454545454545455;24;20;0.0454545454545455;0.454545454545455
Control.SRR15539829;42;45;0.547619047619048;19;23;0.0476190476190477;0.452380952380952
Control.SRR15539829;51;45;0.431372549019608;29;22;0.0686274509803921;0.431372549019608
Control.SRR15539829;52;45;0.557692307692308;23;29;0.0576923076923077;0.442307692307692
Control.SRR15539829;50;45;0.48;26;24;0.02;0.48
Control.SRR15539829;47;45;0.574468085106383;20;27;0.074468085106383;0.425531914893617
Control.SRR15539829;43;45;0.511627906976744;21;22;0.0116279069767442;0.488372093023256
Control.SRR15539829;52;45;0.461538461538462;28;24;0.0384615384615384;0.461538461538462
Control.SRR15539829;45;45;0.577777777777778;19;26;0.0777777777777777;0.422222222222222
Control.SRR15539829;48;45;0.479166666666667;25;23;0.0208333333333333;0.479166666666667
Control.SRR15539829;47;45;0.574468085106383;20;27;0.074468085106383;0.425531914893617
Control.SRR15539829;43;45;0.395348837209302;26;17;0.104651162790698;0.395348837209302
Control.SRR15539829;50;45;0.48;26;24;0.02;0.48
Control.SRR15539829;45;45;0.555555555555556;20;25;0.0555555555555556;0.444444444444444
Control.SRR15539829;46;45;0.434782608695652;26;20;0.0652173913043478;0.434782608695652
Control.SRR15539829;49;45;0.448979591836735;27;22;0.0510204081632653;0.448979591836735
Control.SRR15539829;52;45;0.423076923076923;30;22;0.0769230769230769;0.423076923076923
Control.SRR15539829;47;45;0.468085106382979;25;22;0.0319148936170213;0.468085106382979
Control.SRR15539829;42;45;0.452380952380952;23;19;0.0476190476190476;0.452380952380952
Control.SRR15539829;45;45;0.422222222222222;26;19;0.0777777777777778;0.422222222222222
Control.SRR15539829;48;45;0.479166666666667;25;23;0.0208333333333333;0.479166666666667
Control.SRR15539829;44;45;0.681818181818182;14;30;0.181818181818182;0.318181818181818
Control.SRR15539829;42;45;0.571428571428571;18;24;0.0714285714285714;0.428571428571429
Control.SRR15539829;53;45;0.433962264150943;30;23;0.0660377358490566;0.433962264150943
Control.SRR15539829;47;45;0.531914893617021;22;25;0.0319148936170213;0.468085106382979
Control.SRR15539829;41;45;0.463414634146341;22;19;0.0365853658536585;0.463414634146341
Control.SRR15539829;43;45;0.465116279069767;23;20;0.0348837209302326;0.465116279069767
Control.SRR15539829;50;45;0.54;23;27;0.04;0.46
Control.SRR15539829;53;45;0.566037735849057;23;30;0.0660377358490566;0.433962264150943
Control.SRR15539829;52;45;0.5;26;26;0;0.5
Control.SRR15539829;48;45;0.5;24;24;0;0.5
Control.SRR15539829;44;45;0.409090909090909;26;18;0.0909090909090909;0.409090909090909
Control.SRR15539829;43;45;0.627906976744186;16;27;0.127906976744186;0.372093023255814
Control.SRR15539829;51;45;0.529411764705882;24;27;0.0294117647058824;0.470588235294118
Control.SRR15539829;50;45;0.42;29;21;0.08;0.42
Control.SRR15539829;48;45;0.5;24;24;0;0.5
Control.SRR15539829;42;45;0.452380952380952;23;19;0.0476190476190476;0.452380952380952
Control.SRR15539829;50;45;0.5;25;25;0;0.5
Control.SRR15539829;49;45;0.387755102040816;30;19;0.112244897959184;0.387755102040816
Control.SRR15539829;41;45;0.365853658536585;26;15;0.134146341463415;0.365853658536585
Control.SRR15539829;52;45;0.5;26;26;0;0.5
Control.SRR15539829;46;45;0.456521739130435;25;21;0.0434782608695652;0.456521739130435
Control.SRR15539829;43;45;0.465116279069767;23;20;0.0348837209302326;0.465116279069767
Control.SRR15539829;46;45;0.543478260869565;21;25;0.0434782608695652;0.456521739130435
Control.SRR15539829;49;45;0.469387755102041;26;23;0.0306122448979592;0.469387755102041
Control.SRR15539829;42;45;0.595238095238095;17;25;0.0952380952380952;0.404761904761905
Control.SRR15539829;49;45;0.469387755102041;26;23;0.0306122448979592;0.469387755102041
Control.SRR15539829;47;45;0.446808510638298;26;21;0.0531914893617021;0.446808510638298
Control.SRR15539829;41;45;0.51219512195122;20;21;0.0121951219512195;0.48780487804878
Control.SRR15539829;47;45;0.553191489361702;21;26;0.0531914893617021;0.446808510638298
Control.SRR15539829;46;45;0.456521739130435;25;21;0.0434782608695652;0.456521739130435
Control.SRR15539829;42;45;0.595238095238095;17;25;0.0952380952380952;0.404761904761905
Control.SRR15539829;45;45;0.466666666666667;24;21;0.0333333333333333;0.466666666666667
Control.SRR15539829;49;45;0.510204081632653;24;25;0.0102040816326531;0.489795918367347
Control.SRR15539829;47;45;0.425531914893617;27;20;0.074468085106383;0.425531914893617
Control.SRR15539829;50;45;0.52;24;26;0.02;0.48
Control.SRR15539829;52;45;0.442307692307692;29;23;0.0576923076923077;0.442307692307692
Control.SRR15539829;51;45;0.470588235294118;27;24;0.0294117647058824;0.470588235294118
Control.SRR15539829;48;45;0.541666666666667;22;26;0.0416666666666666;0.458333333333333
Control.SRR15539829;53;45;0.39622641509434;32;21;0.10377358490566;0.39622641509434
Control.SRR15539829;53;45;0.490566037735849;27;26;0.00943396226415094;0.490566037735849
Control.SRR15539829;44;45;0.477272727272727;23;21;0.0227272727272727;0.477272727272727
Control.SRR15539829;50;45;0.54;23;27;0.04;0.46
Control.SRR15539829;51;45;0.431372549019608;29;22;0.0686274509803921;0.431372549019608
Control.SRR15539829;42;45;0.428571428571429;24;18;0.0714285714285715;0.428571428571429
Control.SRR15539829;53;45;0.584905660377358;22;31;0.0849056603773585;0.415094339622642
Control.SRR15539829;44;45;0.568181818181818;19;25;0.0681818181818182;0.431818181818182
Control.SRR15539829;49;45;0.571428571428571;21;28;0.0714285714285714;0.428571428571429
Control.SRR15539829;51;45;0.549019607843137;23;28;0.0490196078431373;0.450980392156863
Control.SRR15539829;50;45;0.56;22;28;0.0600000000000001;0.44
Control.SRR15539829;43;45;0.441860465116279;24;19;0.0581395348837209;0.441860465116279
Control.SRR15539829;40;45;0.625;15;25;0.125;0.375
Control.SRR15539829;45;45;0.422222222222222;26;19;0.0777777777777778;0.422222222222222
Control.SRR15539829;43;45;0.511627906976744;21;22;0.0116279069767442;0.488372093023256
Control.SRR15539829;48;45;0.5;24;24;0;0.5
Control.SRR15539829;51;45;0.549019607843137;23;28;0.0490196078431373;0.450980392156863
Control.SRR15539829;43;45;0.488372093023256;22;21;0.0116279069767442;0.488372093023256
Control.SRR15539829;42;45;0.523809523809524;20;22;0.0238095238095238;0.476190476190476
Control.SRR15539829;45;45;0.6;18;27;0.1;0.4
Control.SRR15539829;40;45;0.475;21;19;0.025;0.475
Control.SRR15539829;41;45;0.536585365853659;19;22;0.0365853658536586;0.463414634146341
Control.SRR15539829;49;45;0.387755102040816;30;19;0.112244897959184;0.387755102040816
Control.SRR15539829;51;45;0.568627450980392;22;29;0.0686274509803921;0.431372549019608
Control.SRR15539829;49;45;0.510204081632653;24;25;0.0102040816326531;0.489795918367347
Control.SRR15539829;45;45;0.6;18;27;0.1;0.4
Control.SRR15539829;41;45;0.463414634146341;22;19;0.0365853658536585;0.463414634146341
Control.SRR15539829;51;45;0.529411764705882;24;27;0.0294117647058824;0.470588235294118
Control.SRR15539829;42;45;0.523809523809524;20;22;0.0238095238095238;0.476190476190476
Control.SRR15539829;50;45;0.5;25;25;0;0.5
Control.SRR15539829;51;45;0.411764705882353;30;21;0.0882352941176471;0.411764705882353
Control.SRR15539829;50;45;0.48;26;24;0.02;0.48
Control.SRR15539829;52;45;0.557692307692308;23;29;0.0576923076923077;0.442307692307692
Control.SRR15539829;49;45;0.469387755102041;26;23;0.0306122448979592;0.469387755102041
Control.SRR15539829;41;45;0.536585365853659;19;22;0.0365853658536586;0.463414634146341
Control.SRR15539829;51;45;0.431372549019608;29;22;0.0686274509803921;0.431372549019608
Control.SRR15539829;53;45;0.471698113207547;28;25;0.0283018867924528;0.471698113207547
Control.SRR15539829;48;45;0.5625;21;27;0.0625;0.4375
Control.SRR15539829;46;45;0.456521739130435;25;21;0.0434782608695652;0.456521739130435
Control.SRR15539829;44;45;0.568181818181818;19;25;0.0681818181818182;0.431818181818182
Control.SRR15539829;45;45;0.466666666666667;24;21;0.0333333333333333;0.466666666666667
Control.SRR15539829;53;45;0.528301886792453;25;28;0.0283018867924528;0.471698113207547
Control.SRR15539829;50;45;0.56;22;28;0.0600000000000001;0.44
Control.SRR15539829;44;45;0.568181818181818;19;25;0.0681818181818182;0.431818181818182
Control.SRR15539829;48;45;0.458333333333333;26;22;0.0416666666666667;0.458333333333333
Control.SRR15539829;52;45;0.442307692307692;29;23;0.0576923076923077;0.442307692307692
Control.SRR15539829;47;45;0.51063829787234;23;24;0.0106382978723404;0.48936170212766
Control.SRR15539829;46;45;0.478260869565217;24;22;0.0217391304347826;0.478260869565217
Control.SRR15539829;42;45;0.547619047619048;19;23;0.0476190476190477;0.452380952380952
Control.SRR15539829;52;45;0.461538461538462;28;24;0.0384615384615384;0.461538461538462
Control.SRR15539829;42;45;0.476190476190476;22;20;0.0238095238095238;0.476190476190476
Control.SRR15539829;45;45;0.555555555555556;20;25;0.0555555555555556;0.444444444444444
Control.SRR15539829;49;45;0.489795918367347;25;24;0.0102040816326531;0.489795918367347
Control.SRR15539829;50;45;0.52;24;26;0.02;0.48
Control.SRR15539829;52;45;0.519230769230769;25;27;0.0192307692307693;0.480769230769231
Control.SRR15539829;42;45;0.452380952380952;23;19;0.0476190476190476;0.452380952380952
Control.SRR15539829;45;45;0.488888888888889;23;22;0.0111111111111111;0.488888888888889
Control.SRR15539829;44;45;0.545454545454545;20;24;0.0454545454545454;0.454545454545455
Control.SRR15539829;46;45;0.5;23;23;0;0.5
Control.SRR15539829;49;45;0.489795918367347;25;24;0.0102040816326531;0.489795918367347
Control.SRR15539829;50;45;0.5;25;25;0;0.5
Control.SRR15539829;46;45;0.543478260869565;21;25;0.0434782608695652;0.456521739130435
Control.SRR15539829;46;45;0.478260869565217;24;22;0.0217391304347826;0.478260869565217
Control.SRR15539829;53;45;0.584905660377358;22;31;0.0849056603773585;0.415094339622642
Control.SRR15539829;40;45;0.4;24;16;0.1;0.4
Control.SRR15539829;41;45;0.536585365853659;19;22;0.0365853658536586;0.463414634146341
Control.SRR15539829;42;45;0.5;21;21;0;0.5
Control.SRR15539829;46;45;0.543478260869565;21;25;0.0434782608695652;0.456521739130435
Control.SRR15539829;49;45;0.489795918367347;25;24;0.0102040816326531;0.489795918367347
Control.SRR15539829;40;45;0.6;16;24;0.1;0.4
Control.SRR15539829;47;45;0.531914893617021;22;25;0.0319148936170213;0.468085106382979
Control.SRR15539829;50;45;0.5;25;25;0;0.5
Control.SRR15539829;45;45;0.555555555555556;20;25;0.0555555555555556;0.444444444444444
Control.SRR15539829;44;45;0.5;22;22;0;0.5
Control.SRR15539829;49;45;0.428571428571429;28;21;0.0714285714285715;0.428571428571429
Control.SRR15539829;40;45;0.475;21;19;0.025;0.475
Control.SRR15539829;48;45;0.479166666666667;25;23;0.0208333333333333;0.479166666666667
Control.SRR15539829;53;45;0.415094339622642;31;22;0.0849056603773585;0.415094339622642
Control.SRR15539829;44;45;0.545454545454545;20;24;0.0454545454545454;0.454545454545455
Control.SRR15539829;41;45;0.536585365853659;19;22;0.0365853658536586;0.463414634146341
Control.SRR15539829;45;45;0.533333333333333;21;24;0.0333333333333333;0.466666666666667
Control.SRR15539829;48;45;0.416666666666667;28;20;0.0833333333333333;0.416666666666667
Control.SRR15539829;50;45;0.58;21;29;0.08;0.42
Control.SRR15539829;48;45;0.4375;27;21;0.0625;0.4375
Control.SRR15539829;49;45;0.428571428571429;28;21;0.0714285714285715;0.428571428571429
Control.SRR15539829;46;45;0.434782608695652;26;20;0.0652173913043478;0.434782608695652
Control.SRR15539829;46;45;0.565217391304348;20;26;0.0652173913043478;0.434782608695652
Control.SRR15539829;53;45;0.584905660377358;22;31;0.0849056603773585;0.415094339622642
Control.SRR15539829;53;45;0.584905660377358;22;31;0.0849056603773585;0.415094339622642
Control.SRR15539829;40;45;0.525;19;21;0.025;0.475
Control.SRR15539829;47;45;0.446808510638298;26;21;0.0531914893617021;0.446808510638298
Control.SRR15539829;46;45;0.630434782608696;17;29;0.130434782608696;0.369565217391304
Control.SRR15539829;41;45;0.536585365853659;19;22;0.0365853658536586;0.463414634146341
Control.SRR15539829;50;45;0.62;19;31;0.12;0.38
Control.SRR15539829;45;45;0.444444444444444;25;20;0.0555555555555556;0.444444444444444
Control.SRR15539829;48;45;0.604166666666667;19;29;0.104166666666667;0.395833333333333
Control.SRR15539829;53;45;0.69811320754717;16;37;0.19811320754717;0.30188679245283
Control.SRR15539829;45;45;0.377777777777778;28;17;0.122222222222222;0.377777777777778
Control.SRR15539829;41;45;0.585365853658537;17;24;0.0853658536585366;0.414634146341463
Control.SRR15539829;44;45;0.363636363636364;28;16;0.136363636363636;0.363636363636364
Control.SRR15539829;48;45;0.4375;27;21;0.0625;0.4375
Control.SRR15539829;50;45;0.56;22;28;0.0600000000000001;0.44
Control.SRR15539829;40;45;0.55;18;22;0.05;0.45
Control.SRR15539829;43;45;0.395348837209302;26;17;0.104651162790698;0.395348837209302
Control.SRR15539829;47;45;0.574468085106383;20;27;0.074468085106383;0.425531914893617
Control.SRR15539829;45;45;0.511111111111111;22;23;0.0111111111111111;0.488888888888889
Control.SRR15539829;43;45;0.372093023255814;27;16;0.127906976744186;0.372093023255814
Control.SRR15539829;49;45;0.571428571428571;21;28;0.0714285714285714;0.428571428571429
Control.SRR15539829;50;45;0.42;29;21;0.08;0.42
Control.SRR15539829;48;45;0.479166666666667;25;23;0.0208333333333333;0.479166666666667
Control.SRR15539829;52;45;0.653846153846154;18;34;0.153846153846154;0.346153846153846
Control.SRR15539829;47;45;0.468085106382979;25;22;0.0319148936170213;0.468085106382979
Control.SRR15539829;41;45;0.560975609756098;18;23;0.0609756097560976;0.439024390243902
Control.SRR15539829;46;45;0.434782608695652;26;20;0.0652173913043478;0.434782608695652
Control.SRR15539829;46;45;0.369565217391304;29;17;0.130434782608696;0.369565217391304
Control.SRR15539829;43;45;0.395348837209302;26;17;0.104651162790698;0.395348837209302
Control.SRR15539829;50;45;0.58;21;29;0.08;0.42
Control.SRR15539829;50;45;0.52;24;26;0.02;0.48
Control.SRR15539829;40;45;0.425;23;17;0.075;0.425
Control.SRR15539829;45;45;0.533333333333333;21;24;0.0333333333333333;0.466666666666667
Control.SRR15539829;43;45;0.465116279069767;23;20;0.0348837209302326;0.465116279069767
Control.SRR15539829;49;45;0.510204081632653;24;25;0.0102040816326531;0.489795918367347
Control.SRR15539829;52;45;0.557692307692308;23;29;0.0576923076923077;0.442307692307692
Control.SRR15539829;53;45;0.433962264150943;30;23;0.0660377358490566;0.433962264150943
Control.SRR15539829;46;45;0.478260869565217;24;22;0.0217391304347826;0.478260869565217
Control.SRR15539829;52;45;0.519230769230769;25;27;0.0192307692307693;0.480769230769231
Control.SRR15539829;47;45;0.553191489361702;21;26;0.0531914893617021;0.446808510638298
Control.SRR15539829;42;45;0.571428571428571;18;24;0.0714285714285714;0.428571428571429
Control.SRR15539829;46;45;0.456521739130435;25;21;0.0434782608695652;0.456521739130435
Control.SRR15539829;47;45;0.468085106382979;25;22;0.0319148936170213;0.468085106382979
Control.SRR15539829;49;45;0.510204081632653;24;25;0.0102040816326531;0.489795918367347
Control.SRR15539829;50;45;0.3;35;15;0.2;0.3
Control.SRR15539829;47;45;0.468085106382979;25;22;0.0319148936170213;0.468085106382979
Control.SRR15539829;50;45;0.64;18;32;0.14;0.36
Control.SRR15539829;50;45;0.58;21;29;0.08;0.42
Control.SRR15539829;42;45;0.571428571428571;18;24;0.0714285714285714;0.428571428571429
Control.SRR15539829;42;45;0.619047619047619;16;26;0.119047619047619;0.380952380952381
Control.SRR15539829;40;45;0.425;23;17;0.075;0.425
Control.SRR15539829;45;45;0.6;18;27;0.1;0.4
Control.SRR15539829;48;45;0.520833333333333;23;25;0.0208333333333334;0.479166666666667
Control.SRR15539829;48;45;0.479166666666667;25;23;0.0208333333333333;0.479166666666667
Control.SRR15539829;52;45;0.538461538461538;24;28;0.0384615384615384;0.461538461538462
Control.SRR15539829;44;45;0.5;22;22;0;0.5
Control.SRR15539829;46;45;0.521739130434783;22;24;0.0217391304347826;0.478260869565217
Control.SRR15539829;53;45;0.452830188679245;29;24;0.0471698113207547;0.452830188679245
Control.SRR15539829;46;45;0.456521739130435;25;21;0.0434782608695652;0.456521739130435
Control.SRR15539829;44;45;0.477272727272727;23;21;0.0227272727272727;0.477272727272727
Control.SRR15539829;43;45;0.465116279069767;23;20;0.0348837209302326;0.465116279069767
Control.SRR15539829;43;45;0.325581395348837;29;14;0.174418604651163;0.325581395348837
Control.SRR15539829;49;45;0.530612244897959;23;26;0.0306122448979592;0.469387755102041
Control.SRR15539829;51;45;0.490196078431373;26;25;0.00980392156862747;0.490196078431373
Control.SRR15539829;49;45;0.571428571428571;21;28;0.0714285714285714;0.428571428571429
Control.SRR15539829;52;45;0.442307692307692;29;23;0.0576923076923077;0.442307692307692
Control.SRR15539829;50;45;0.6;20;30;0.1;0.4
Control.SRR15539829;47;45;0.446808510638298;26;21;0.0531914893617021;0.446808510638298
Control.SRR15539829;40;45;0.45;22;18;0.05;0.45
Control.SRR15539829;45;45;0.511111111111111;22;23;0.0111111111111111;0.488888888888889
Control.SRR15539829;48;45;0.583333333333333;20;28;0.0833333333333334;0.416666666666667
Control.SRR15539829;50;45;0.4;30;20;0.1;0.4
Control.SRR15539829;44;45;0.454545454545455;24;20;0.0454545454545455;0.454545454545455
Control.SRR15539829;53;45;0.528301886792453;25;28;0.0283018867924528;0.471698113207547
Control.SRR15539829;48;45;0.5;24;24;0;0.5
Control.SRR15539829;46;45;0.608695652173913;18;28;0.108695652173913;0.391304347826087
Control.SRR15539829;50;45;0.4;30;20;0.1;0.4
Control.SRR15539829;41;45;0.463414634146341;22;19;0.0365853658536585;0.463414634146341
Control.SRR15539829;52;45;0.480769230769231;27;25;0.0192307692307692;0.480769230769231
Control.SRR15539829;49;45;0.530612244897959;23;26;0.0306122448979592;0.469387755102041
Control.SRR15539829;44;45;0.568181818181818;19;25;0.0681818181818182;0.431818181818182
Control.SRR15539829;46;45;0.543478260869565;21;25;0.0434782608695652;0.456521739130435
Control.SRR15539829;52;45;0.519230769230769;25;27;0.0192307692307693;0.480769230769231
Control.SRR15539829;49;45;0.530612244897959;23;26;0.0306122448979592;0.469387755102041
Control.SRR15539829;53;45;0.641509433962264;19;34;0.141509433962264;0.358490566037736
Control.SRR15539829;40;45;0.575;17;23;0.075;0.425
Control.SRR15539829;45;45;0.488888888888889;23;22;0.0111111111111111;0.488888888888889
Control.SRR15539829;44;45;0.431818181818182;25;19;0.0681818181818182;0.431818181818182
Control.SRR15539829;49;45;0.591836734693878;20;29;0.0918367346938775;0.408163265306122
Control.SRR15539829;43;45;0.488372093023256;22;21;0.0116279069767442;0.488372093023256
Control.SRR15539829;40;45;0.45;22;18;0.05;0.45
Control.SRR15539829;46;45;0.521739130434783;22;24;0.0217391304347826;0.478260869565217
Control.SRR15539829;49;45;0.530612244897959;23;26;0.0306122448979592;0.469387755102041
Control.SRR15539829;43;45;0.488372093023256;22;21;0.0116279069767442;0.488372093023256
Control.SRR15539829;52;45;0.461538461538462;28;24;0.0384615384615384;0.461538461538462
Control.SRR15539829;49;45;0.489795918367347;25;24;0.0102040816326531;0.489795918367347
Control.SRR15539829;43;45;0.511627906976744;21;22;0.0116279069767442;0.488372093023256
Control.SRR15539829;49;45;0.653061224489796;17;32;0.153061224489796;0.346938775510204
Control.SRR15539829;47;45;0.48936170212766;24;23;0.0106382978723404;0.48936170212766
Control.SRR15539829;50;45;0.52;24;26;0.02;0.48
Control.SRR15539829;42;45;0.428571428571429;24;18;0.0714285714285715;0.428571428571429
Control.SRR15539829;40;45;0.45;22;18;0.05;0.45
Control.SRR15539829;47;45;0.446808510638298;26;21;0.0531914893617021;0.446808510638298
Control.SRR15539829;50;45;0.48;26;24;0.02;0.48
Control.SRR15539829;49;45;0.408163265306122;29;20;0.0918367346938775;0.408163265306122
Control.SRR15539829;42;45;0.5;21;21;0;0.5
Control.SRR15539829;41;45;0.536585365853659;19;22;0.0365853658536586;0.463414634146341
Control.SRR15539829;41;45;0.51219512195122;20;21;0.0121951219512195;0.48780487804878
Control.SRR15539829;49;45;0.469387755102041;26;23;0.0306122448979592;0.469387755102041
Control.SRR15539829;48;45;0.416666666666667;28;20;0.0833333333333333;0.416666666666667
Control.SRR15539829;47;45;0.531914893617021;22;25;0.0319148936170213;0.468085106382979
Control.SRR15539829;51;45;0.588235294117647;21;30;0.0882352941176471;0.411764705882353
Control.SRR15539829;49;45;0.510204081632653;24;25;0.0102040816326531;0.489795918367347
Control.SRR15539829;48;45;0.479166666666667;25;23;0.0208333333333333;0.479166666666667
Control.SRR15539829;45;45;0.555555555555556;20;25;0.0555555555555556;0.444444444444444
Control.SRR15539829;51;45;0.333333333333333;34;17;0.166666666666667;0.333333333333333
Control.SRR15539829;46;45;0.456521739130435;25;21;0.0434782608695652;0.456521739130435
Control.SRR15539829;46;45;0.521739130434783;22;24;0.0217391304347826;0.478260869565217
Control.SRR15539829;45;45;0.533333333333333;21;24;0.0333333333333333;0.466666666666667
Control.SRR15539829;49;45;0.571428571428571;21;28;0.0714285714285714;0.428571428571429
Control.SRR15539829;40;45;0.5;20;20;0;0.5
Control.SRR15539829;47;45;0.574468085106383;20;27;0.074468085106383;0.425531914893617
Control.SRR15539829;52;45;0.461538461538462;28;24;0.0384615384615384;0.461538461538462
Control.SRR15539829;43;45;0.488372093023256;22;21;0.0116279069767442;0.488372093023256
Control.SRR15539829;46;45;0.478260869565217;24;22;0.0217391304347826;0.478260869565217
Control.SRR15539829;47;45;0.531914893617021;22;25;0.0319148936170213;0.468085106382979
Control.SRR15539829;47;45;0.425531914893617;27;20;0.074468085106383;0.425531914893617
Control.SRR15539829;41;45;0.609756097560976;16;25;0.109756097560976;0.390243902439024
Control.SRR15539829;41;45;0.414634146341463;24;17;0.0853658536585366;0.414634146341463
Control.SRR15539829;43;45;0.558139534883721;19;24;0.0581395348837209;0.441860465116279
Control.SRR15539829;42;45;0.547619047619048;19;23;0.0476190476190477;0.452380952380952
Control.SRR15539829;43;45;0.418604651162791;25;18;0.0813953488372093;0.418604651162791
Control.SRR15539829;52;45;0.403846153846154;31;21;0.0961538461538461;0.403846153846154
Control.SRR15539829;51;45;0.509803921568627;25;26;0.00980392156862742;0.490196078431373
Control.SRR15539829;53;45;0.528301886792453;25;28;0.0283018867924528;0.471698113207547
Control.SRR15539829;41;45;0.609756097560976;16;25;0.109756097560976;0.390243902439024
Control.SRR15539829;41;45;0.560975609756098;18;23;0.0609756097560976;0.439024390243902
Control.SRR15539829;44;45;0.454545454545455;24;20;0.0454545454545455;0.454545454545455
Control.SRR15539829;49;45;0.408163265306122;29;20;0.0918367346938775;0.408163265306122
Control.SRR15539829;46;45;0.565217391304348;20;26;0.0652173913043478;0.434782608695652
Control.SRR15539829;41;45;0.48780487804878;21;20;0.0121951219512195;0.48780487804878
Control.SRR15539829;42;45;0.523809523809524;20;22;0.0238095238095238;0.476190476190476
Control.SRR15539829;45;45;0.422222222222222;26;19;0.0777777777777778;0.422222222222222
Control.SRR15539829;43;45;0.604651162790698;17;26;0.104651162790698;0.395348837209302
Control.SRR15539829;46;45;0.41304347826087;27;19;0.0869565217391304;0.41304347826087
Control.SRR15539829;51;45;0.509803921568627;25;26;0.00980392156862742;0.490196078431373
Control.SRR15539829;50;45;0.46;27;23;0.04;0.46
Control.SRR15539829;48;45;0.604166666666667;19;29;0.104166666666667;0.395833333333333
Control.SRR15539829;40;45;0.675;13;27;0.175;0.325
Control.SRR15539829;43;45;0.627906976744186;16;27;0.127906976744186;0.372093023255814
Control.SRR15539829;47;45;0.361702127659574;30;17;0.138297872340426;0.361702127659574
Control.SRR15539829;53;45;0.377358490566038;33;20;0.122641509433962;0.377358490566038
Control.SRR15539829;41;45;0.51219512195122;20;21;0.0121951219512195;0.48780487804878
Control.SRR15539829;44;45;0.477272727272727;23;21;0.0227272727272727;0.477272727272727
Control.SRR15539829;43;45;0.511627906976744;21;22;0.0116279069767442;0.488372093023256
Control.SRR15539829;49;45;0.448979591836735;27;22;0.0510204081632653;0.448979591836735
Control.SRR15539829;40;45;0.65;14;26;0.15;0.35
Control.SRR15539829;40;45;0.525;19;21;0.025;0.475
Control.SRR15539829;44;45;0.613636363636364;17;27;0.113636363636364;0.386363636363636
Control.SRR15539829;52;45;0.538461538461538;24;28;0.0384615384615384;0.461538461538462
Control.SRR15539829;43;45;0.651162790697674;15;28;0.151162790697674;0.348837209302326
Control.SRR15539829;44;45;0.568181818181818;19;25;0.0681818181818182;0.431818181818182
Control.SRR15539829;43;45;0.325581395348837;29;14;0.174418604651163;0.325581395348837
Control.SRR15539829;43;45;0.325581395348837;29;14;0.174418604651163;0.325581395348837
Control.SRR15539829;45;45;0.488888888888889;23;22;0.0111111111111111;0.488888888888889
Control.SRR15539829;49;45;0.63265306122449;18;31;0.13265306122449;0.36734693877551
Control.SRR15539829;52;45;0.461538461538462;28;24;0.0384615384615384;0.461538461538462
Control.SRR15539829;49;45;0.489795918367347;25;24;0.0102040816326531;0.489795918367347
Control.SRR15539829;49;45;0.551020408163265;22;27;0.0510204081632653;0.448979591836735
Control.SRR15539829;41;45;0.560975609756098;18;23;0.0609756097560976;0.439024390243902
Control.SRR15539829;53;45;0.528301886792453;25;28;0.0283018867924528;0.471698113207547
Control.SRR15539829;44;45;0.5;22;22;0;0.5
Control.SRR15539829;49;45;0.448979591836735;27;22;0.0510204081632653;0.448979591836735
Control.SRR15539829;48;45;0.4375;27;21;0.0625;0.4375
Control.SRR15539829;41;45;0.48780487804878;21;20;0.0121951219512195;0.48780487804878
Control.SRR15539829;41;45;0.634146341463415;15;26;0.134146341463415;0.365853658536585
Control.SRR15539829;51;45;0.588235294117647;21;30;0.0882352941176471;0.411764705882353
Control.SRR15539829;46;45;0.478260869565217;24;22;0.0217391304347826;0.478260869565217
Control.SRR15539829;40;45;0.55;18;22;0.05;0.45
Control.SRR15539829;51;45;0.588235294117647;21;30;0.0882352941176471;0.411764705882353
Control.SRR15539829;41;45;0.560975609756098;18;23;0.0609756097560976;0.439024390243902
Control.SRR15539829;44;45;0.522727272727273;21;23;0.0227272727272727;0.477272727272727
Control.SRR15539829;47;45;0.595744680851064;19;28;0.0957446808510638;0.404255319148936
Control.SRR15539829;48;45;0.541666666666667;22;26;0.0416666666666666;0.458333333333333
Control.SRR15539829;40;45;0.525;19;21;0.025;0.475
Control.SRR15539829;46;45;0.41304347826087;27;19;0.0869565217391304;0.41304347826087
Control.SRR15539829;45;45;0.577777777777778;19;26;0.0777777777777777;0.422222222222222
Control.SRR15539829;47;45;0.51063829787234;23;24;0.0106382978723404;0.48936170212766
Control.SRR15539829;44;45;0.454545454545455;24;20;0.0454545454545455;0.454545454545455
Control.SRR15539829;45;45;0.6;18;27;0.1;0.4
Control.SRR15539829;40;45;0.575;17;23;0.075;0.425
Control.SRR15539829;46;45;0.478260869565217;24;22;0.0217391304347826;0.478260869565217
Control.SRR15539829;46;45;0.5;23;23;0;0.5
Control.SRR15539829;46;45;0.434782608695652;26;20;0.0652173913043478;0.434782608695652
Control.SRR15539829;41;45;0.439024390243902;23;18;0.0609756097560976;0.439024390243902
Control.SRR15539829;43;45;0.465116279069767;23;20;0.0348837209302326;0.465116279069767
Control.SRR15539829;47;45;0.74468085106383;12;35;0.24468085106383;0.25531914893617
Control.SRR15539829;52;45;0.346153846153846;34;18;0.153846153846154;0.346153846153846
Control.SRR15539829;41;45;0.51219512195122;20;21;0.0121951219512195;0.48780487804878
Control.SRR15539829;43;45;0.697674418604651;13;30;0.197674418604651;0.302325581395349
Control.SRR15539829;50;45;0.48;26;24;0.02;0.48
Control.SRR15539829;51;45;0.450980392156863;28;23;0.0490196078431372;0.450980392156863
Control.SRR15539829;44;45;0.568181818181818;19;25;0.0681818181818182;0.431818181818182
Control.SRR15539829;45;45;0.466666666666667;24;21;0.0333333333333333;0.466666666666667
Control.SRR15539829;42;45;0.642857142857143;15;27;0.142857142857143;0.357142857142857
Control.SRR15539829;45;45;0.511111111111111;22;23;0.0111111111111111;0.488888888888889
Control.SRR15539829;49;45;0.428571428571429;28;21;0.0714285714285715;0.428571428571429
Control.SRR15539829;42;45;0.428571428571429;24;18;0.0714285714285715;0.428571428571429
Control.SRR15539829;52;45;0.480769230769231;27;25;0.0192307692307692;0.480769230769231
Control.SRR15539829;49;45;0.489795918367347;25;24;0.0102040816326531;0.489795918367347
Control.SRR15539829;48;45;0.583333333333333;20;28;0.0833333333333334;0.416666666666667
Control.SRR15539829;50;45;0.42;29;21;0.08;0.42
Control.SRR15539829;41;45;0.682926829268293;13;28;0.182926829268293;0.317073170731707
Control.SRR15539829;40;45;0.575;17;23;0.075;0.425
Control.SRR15539829;50;45;0.46;27;23;0.04;0.46
Control.SRR15539829;44;45;0.545454545454545;20;24;0.0454545454545454;0.454545454545455
Control.SRR15539829;42;45;0.547619047619048;19;23;0.0476190476190477;0.452380952380952
Control.SRR15539829;49;45;0.469387755102041;26;23;0.0306122448979592;0.469387755102041
Control.SRR15539829;40;45;0.4;24;16;0.1;0.4
Control.SRR15539829;51;45;0.588235294117647;21;30;0.0882352941176471;0.411764705882353
Control.SRR15539829;50;45;0.52;24;26;0.02;0.48
Control.SRR15539829;48;45;0.479166666666667;25;23;0.0208333333333333;0.479166666666667
Control.SRR15539829;40;45;0.425;23;17;0.075;0.425
Control.SRR15539829;49;45;0.693877551020408;15;34;0.193877551020408;0.306122448979592
Control.SRR15539829;44;45;0.409090909090909;26;18;0.0909090909090909;0.409090909090909
Control.SRR15539829;53;45;0.490566037735849;27;26;0.00943396226415094;0.490566037735849
Control.SRR15539829;41;45;0.51219512195122;20;21;0.0121951219512195;0.48780487804878
Control.SRR15539829;52;45;0.365384615384615;33;19;0.134615384615385;0.365384615384615
Control.SRR15539829;50;45;0.52;24;26;0.02;0.48
Control.SRR15539829;44;45;0.477272727272727;23;21;0.0227272727272727;0.477272727272727
Control.SRR15539829;46;45;0.5;23;23;0;0.5
Control.SRR15539829;44;45;0.636363636363636;16;28;0.136363636363636;0.363636363636364
Control.SRR15539829;41;45;0.439024390243902;23;18;0.0609756097560976;0.439024390243902
Control.SRR15539829;53;45;0.433962264150943;30;23;0.0660377358490566;0.433962264150943
Control.SRR15539829;43;45;0.465116279069767;23;20;0.0348837209302326;0.465116279069767
Control.SRR15539829;43;45;0.488372093023256;22;21;0.0116279069767442;0.488372093023256
Control.SRR15539829;53;45;0.433962264150943;30;23;0.0660377358490566;0.433962264150943
Control.SRR15539829;40;45;0.625;15;25;0.125;0.375
Control.SRR15539829;51;45;0.647058823529412;18;33;0.147058823529412;0.352941176470588
Control.SRR15539829;42;45;0.547619047619048;19;23;0.0476190476190477;0.452380952380952
Control.SRR15539829;52;45;0.423076923076923;30;22;0.0769230769230769;0.423076923076923
Control.SRR15539829;49;45;0.510204081632653;24;25;0.0102040816326531;0.489795918367347
Control.SRR15539829;46;45;0.543478260869565;21;25;0.0434782608695652;0.456521739130435
Control.SRR15539829;48;45;0.520833333333333;23;25;0.0208333333333334;0.479166666666667
Control.SRR15539829;45;45;0.644444444444444;16;29;0.144444444444444;0.355555555555556
Control.SRR15539829;39;45;0.487179487179487;20;19;0.0128205128205128;0.487179487179487
Control.SRR15539829;40;45;0.525;19;21;0.025;0.475
Control.SRR15539829;50;45;0.5;25;25;0;0.5
Control.SRR15539829;42;45;0.5;21;21;0;0.5
Control.SRR15539829;42;45;0.5;21;21;0;0.5
Control.SRR15539829;43;45;0.465116279069767;23;20;0.0348837209302326;0.465116279069767
Control.SRR15539829;49;45;0.448979591836735;27;22;0.0510204081632653;0.448979591836735
Control.SRR15539829;42;45;0.428571428571429;24;18;0.0714285714285715;0.428571428571429
Control.SRR15539829;49;45;0.448979591836735;27;22;0.0510204081632653;0.448979591836735
Control.SRR15539829;42;45;0.595238095238095;17;25;0.0952380952380952;0.404761904761905
Control.SRR15539829;45;45;0.333333333333333;30;15;0.166666666666667;0.333333333333333
Control.SRR15539829;46;45;0.391304347826087;28;18;0.108695652173913;0.391304347826087
Control.SRR15539829;50;45;0.48;26;24;0.02;0.48
Control.SRR15539829;46;45;0.347826086956522;30;16;0.152173913043478;0.347826086956522
Control.SRR15539829;45;45;0.444444444444444;25;20;0.0555555555555556;0.444444444444444
Control.SRR15539829;48;45;0.520833333333333;23;25;0.0208333333333334;0.479166666666667
Control.SRR15539829;39;45;0.358974358974359;25;14;0.141025641025641;0.358974358974359
Control.SRR15539829;43;45;0.465116279069767;23;20;0.0348837209302326;0.465116279069767
Control.SRR15539829;40;45;0.525;19;21;0.025;0.475
Control.SRR15539829;45;45;0.466666666666667;24;21;0.0333333333333333;0.466666666666667
Control.SRR15539829;47;45;0.51063829787234;23;24;0.0106382978723404;0.48936170212766
Control.SRR15539829;49;45;0.489795918367347;25;24;0.0102040816326531;0.489795918367347
Control.SRR15539829;40;45;0.375;25;15;0.125;0.375
Control.SRR15539829;43;45;0.488372093023256;22;21;0.0116279069767442;0.488372093023256
Control.SRR15539829;44;45;0.477272727272727;23;21;0.0227272727272727;0.477272727272727
Control.SRR15539829;46;45;0.434782608695652;26;20;0.0652173913043478;0.434782608695652
Control.SRR15539829;39;45;0.461538461538462;21;18;0.0384615384615384;0.461538461538462
Control.SRR15539829;40;45;0.425;23;17;0.075;0.425
Control.SRR15539829;41;45;0.560975609756098;18;23;0.0609756097560976;0.439024390243902
Control.SRR15539829;46;45;0.608695652173913;18;28;0.108695652173913;0.391304347826087
Control.SRR15539829;43;45;0.488372093023256;22;21;0.0116279069767442;0.488372093023256
Control.SRR15539829;45;45;0.488888888888889;23;22;0.0111111111111111;0.488888888888889
Control.SRR15539829;40;45;0.475;21;19;0.025;0.475
Control.SRR15539829;42;45;0.380952380952381;26;16;0.119047619047619;0.380952380952381
Control.SRR15539829;40;45;0.575;17;23;0.075;0.425
Control.SRR15539829;45;45;0.644444444444444;16;29;0.144444444444444;0.355555555555556
Control.SRR15539829;46;45;0.608695652173913;18;28;0.108695652173913;0.391304347826087
Control.SRR15539829;42;45;0.452380952380952;23;19;0.0476190476190476;0.452380952380952
Control.SRR15539829;44;45;0.454545454545455;24;20;0.0454545454545455;0.454545454545455
Control.SRR15539829;47;45;0.553191489361702;21;26;0.0531914893617021;0.446808510638298
Control.SRR15539829;45;45;0.533333333333333;21;24;0.0333333333333333;0.466666666666667
Control.SRR15539829;38;45;0.578947368421053;16;22;0.0789473684210527;0.421052631578947
Control.SRR15539829;38;45;0.447368421052632;21;17;0.0526315789473684;0.447368421052632
Control.SRR15539829;50;45;0.6;20;30;0.1;0.4
Control.SRR15539829;49;45;0.510204081632653;24;25;0.0102040816326531;0.489795918367347
Control.SRR15539829;50;45;0.6;20;30;0.1;0.4
Control.SRR15539829;40;45;0.5;20;20;0;0.5
Control.SRR15539829;40;45;0.65;14;26;0.15;0.35
Control.SRR15539829;48;45;0.479166666666667;25;23;0.0208333333333333;0.479166666666667
Control.SRR15539829;41;45;0.51219512195122;20;21;0.0121951219512195;0.48780487804878
Control.SRR15539829;41;45;0.560975609756098;18;23;0.0609756097560976;0.439024390243902
Control.SRR15539829;41;45;0.463414634146341;22;19;0.0365853658536585;0.463414634146341
Control.SRR15539829;38;45;0.526315789473684;18;20;0.0263157894736842;0.473684210526316
Control.SRR15539829;41;45;0.560975609756098;18;23;0.0609756097560976;0.439024390243902
Control.SRR15539829;39;45;0.461538461538462;21;18;0.0384615384615384;0.461538461538462
Control.SRR15539829;44;45;0.5;22;22;0;0.5
Control.SRR15539829;41;45;0.682926829268293;13;28;0.182926829268293;0.317073170731707
Control.SRR15539829;40;45;0.375;25;15;0.125;0.375
Control.SRR15539829;45;45;0.4;27;18;0.1;0.4
Control.SRR15539829;46;45;0.478260869565217;24;22;0.0217391304347826;0.478260869565217
Control.SRR15539829;39;45;0.461538461538462;21;18;0.0384615384615384;0.461538461538462
Control.SRR15539829;41;45;0.560975609756098;18;23;0.0609756097560976;0.439024390243902
Control.SRR15539829;39;45;0.358974358974359;25;14;0.141025641025641;0.358974358974359
Control.SRR15539829;41;45;0.463414634146341;22;19;0.0365853658536585;0.463414634146341
Control.SRR15539829;38;45;0.526315789473684;18;20;0.0263157894736842;0.473684210526316
Control.SRR15539829;47;45;0.531914893617021;22;25;0.0319148936170213;0.468085106382979
Control.SRR15539829;40;45;0.5;20;20;0;0.5
Control.SRR15539829;45;45;0.422222222222222;26;19;0.0777777777777778;0.422222222222222
Control.SRR15539829;45;45;0.533333333333333;21;24;0.0333333333333333;0.466666666666667
Control.SRR15539829;49;45;0.530612244897959;23;26;0.0306122448979592;0.469387755102041
Control.SRR15539829;44;45;0.5;22;22;0;0.5
Control.SRR15539829;44;45;0.409090909090909;26;18;0.0909090909090909;0.409090909090909
Control.SRR15539829;44;45;0.386363636363636;27;17;0.113636363636364;0.386363636363636
Control.SRR15539829;44;45;0.613636363636364;17;27;0.113636363636364;0.386363636363636
Control.SRR15539829;45;45;0.533333333333333;21;24;0.0333333333333333;0.466666666666667
Control.SRR15539829;46;45;0.521739130434783;22;24;0.0217391304347826;0.478260869565217
Control.SRR15539829;44;45;0.5;22;22;0;0.5
Control.SRR15539829;40;45;0.55;18;22;0.05;0.45
Control.SRR15539829;39;45;0.58974358974359;16;23;0.0897435897435898;0.41025641025641
Control.SRR15539829;48;45;0.5;24;24;0;0.5
Control.SRR15539829;49;45;0.326530612244898;33;16;0.173469387755102;0.326530612244898
Control.SRR15539829;40;45;0.675;13;27;0.175;0.325
Control.SRR15539829;47;45;0.617021276595745;18;29;0.117021276595745;0.382978723404255
Control.SRR15539829;43;45;0.418604651162791;25;18;0.0813953488372093;0.418604651162791
Control.SRR15539829;48;45;0.4375;27;21;0.0625;0.4375
Control.SRR15539829;42;45;0.523809523809524;20;22;0.0238095238095238;0.476190476190476
Control.SRR15539829;39;45;0.564102564102564;17;22;0.0641025641025641;0.435897435897436
Control.SRR15539829;44;45;0.340909090909091;29;15;0.159090909090909;0.340909090909091
Control.SRR15539829;50;45;0.38;31;19;0.12;0.38
Control.SRR15539829;44;45;0.5;22;22;0;0.5
Control.SRR15539829;45;45;0.622222222222222;17;28;0.122222222222222;0.377777777777778
Control.SRR15539829;43;45;0.465116279069767;23;20;0.0348837209302326;0.465116279069767
Control.SRR15539829;42;45;0.5;21;21;0;0.5
Control.SRR15539829;39;45;0.461538461538462;21;18;0.0384615384615384;0.461538461538462
Control.SRR15539829;44;45;0.522727272727273;21;23;0.0227272727272727;0.477272727272727
Control.SRR15539829;40;45;0.5;20;20;0;0.5
Control.SRR15539829;43;45;0.511627906976744;21;22;0.0116279069767442;0.488372093023256
Control.SRR15539829;45;45;0.488888888888889;23;22;0.0111111111111111;0.488888888888889
Control.SRR15539829;49;45;0.571428571428571;21;28;0.0714285714285714;0.428571428571429
Control.SRR15539829;46;45;0.478260869565217;24;22;0.0217391304347826;0.478260869565217
Control.SRR15539829;46;45;0.521739130434783;22;24;0.0217391304347826;0.478260869565217
Control.SRR15539829;46;45;0.543478260869565;21;25;0.0434782608695652;0.456521739130435
Control.SRR15539829;41;45;0.585365853658537;17;24;0.0853658536585366;0.414634146341463
Control.SRR15539829;40;45;0.6;16;24;0.1;0.4
Control.SRR15539829;42;45;0.523809523809524;20;22;0.0238095238095238;0.476190476190476
Control.SRR15539829;39;45;0.564102564102564;17;22;0.0641025641025641;0.435897435897436
Control.SRR15539829;39;45;0.538461538461538;18;21;0.0384615384615384;0.461538461538462
Control.SRR15539829;48;45;0.5;24;24;0;0.5
Control.SRR15539829;38;45;0.342105263157895;25;13;0.157894736842105;0.342105263157895
Control.SRR15539829;38;45;0.605263157894737;15;23;0.105263157894737;0.394736842105263
Control.SRR15539829;40;45;0.525;19;21;0.025;0.475
Control.SRR15539829;50;45;0.46;27;23;0.04;0.46
Control.SRR15539829;40;45;0.625;15;25;0.125;0.375
Control.SRR15539829;49;45;0.469387755102041;26;23;0.0306122448979592;0.469387755102041
Control.SRR15539829;40;45;0.525;19;21;0.025;0.475
Control.SRR15539829;42;45;0.476190476190476;22;20;0.0238095238095238;0.476190476190476
Control.SRR15539829;43;45;0.534883720930233;20;23;0.0348837209302325;0.465116279069767
Control.SRR15539829;44;45;0.409090909090909;26;18;0.0909090909090909;0.409090909090909
Control.SRR15539829;43;45;0.465116279069767;23;20;0.0348837209302326;0.465116279069767
Control.SRR15539829;48;45;0.395833333333333;29;19;0.104166666666667;0.395833333333333
Control.SRR15539829;50;45;0.5;25;25;0;0.5
Control.SRR15539829;48;45;0.479166666666667;25;23;0.0208333333333333;0.479166666666667
Control.SRR15539829;49;45;0.448979591836735;27;22;0.0510204081632653;0.448979591836735
Control.SRR15539829;42;45;0.619047619047619;16;26;0.119047619047619;0.380952380952381
Control.SRR15539829;39;45;0.615384615384615;15;24;0.115384615384615;0.384615384615385
Control.SRR15539829;42;45;0.523809523809524;20;22;0.0238095238095238;0.476190476190476
Control.SRR15539829;47;45;0.382978723404255;29;18;0.117021276595745;0.382978723404255
Control.SRR15539829;47;45;0.48936170212766;24;23;0.0106382978723404;0.48936170212766
Control.SRR15539829;46;45;0.478260869565217;24;22;0.0217391304347826;0.478260869565217
Control.SRR15539829;49;45;0.551020408163265;22;27;0.0510204081632653;0.448979591836735
Control.SRR15539829;40;45;0.575;17;23;0.075;0.425
Control.SRR15539829;50;45;0.56;22;28;0.0600000000000001;0.44
Control.SRR15539829;47;45;0.468085106382979;25;22;0.0319148936170213;0.468085106382979
Control.SRR15539829;45;45;0.533333333333333;21;24;0.0333333333333333;0.466666666666667
Control.SRR15539829;43;45;0.441860465116279;24;19;0.0581395348837209;0.441860465116279
Control.SRR15539829;43;45;0.604651162790698;17;26;0.104651162790698;0.395348837209302
Control.SRR15539829;43;45;0.441860465116279;24;19;0.0581395348837209;0.441860465116279
Control.SRR15539829;49;45;0.489795918367347;25;24;0.0102040816326531;0.489795918367347
Control.SRR15539829;43;45;0.418604651162791;25;18;0.0813953488372093;0.418604651162791
Control.SRR15539829;45;45;0.422222222222222;26;19;0.0777777777777778;0.422222222222222
Control.SRR15539829;41;45;0.536585365853659;19;22;0.0365853658536586;0.463414634146341
Control.SRR15539829;43;45;0.534883720930233;20;23;0.0348837209302325;0.465116279069767
Control.SRR15539829;43;45;0.674418604651163;14;29;0.174418604651163;0.325581395348837
Control.SRR15539829;44;45;0.477272727272727;23;21;0.0227272727272727;0.477272727272727
Control.SRR15539829;44;45;0.431818181818182;25;19;0.0681818181818182;0.431818181818182
Control.SRR15539829;45;45;0.422222222222222;26;19;0.0777777777777778;0.422222222222222
Control.SRR15539829;44;45;0.522727272727273;21;23;0.0227272727272727;0.477272727272727
Control.SRR15539829;41;45;0.536585365853659;19;22;0.0365853658536586;0.463414634146341
Control.SRR15539829;39;45;0.41025641025641;23;16;0.0897435897435898;0.41025641025641
Control.SRR15539829;38;45;0.605263157894737;15;23;0.105263157894737;0.394736842105263
Control.SRR15539829;39;45;0.538461538461538;18;21;0.0384615384615384;0.461538461538462
Control.SRR15539829;44;45;0.636363636363636;16;28;0.136363636363636;0.363636363636364
Control.SRR15539829;49;45;0.408163265306122;29;20;0.0918367346938775;0.408163265306122
Control.SRR15539829;49;45;0.510204081632653;24;25;0.0102040816326531;0.489795918367347
Control.SRR15539829;49;45;0.551020408163265;22;27;0.0510204081632653;0.448979591836735
Control.SRR15539829;39;45;0.487179487179487;20;19;0.0128205128205128;0.487179487179487
Control.SRR15539829;43;45;0.488372093023256;22;21;0.0116279069767442;0.488372093023256
Control.SRR15539829;46;45;0.58695652173913;19;27;0.0869565217391305;0.41304347826087
Control.SRR15539829;40;45;0.425;23;17;0.075;0.425
Control.SRR15539829;41;45;0.658536585365854;14;27;0.158536585365854;0.341463414634146
Control.SRR15539829;39;45;0.58974358974359;16;23;0.0897435897435898;0.41025641025641
Control.SRR15539829;45;45;0.466666666666667;24;21;0.0333333333333333;0.466666666666667
Control.SRR15539829;47;45;0.468085106382979;25;22;0.0319148936170213;0.468085106382979
Control.SRR15539829;47;45;0.425531914893617;27;20;0.074468085106383;0.425531914893617
Control.SRR15539829;47;45;0.468085106382979;25;22;0.0319148936170213;0.468085106382979
Control.SRR15539829;46;45;0.673913043478261;15;31;0.173913043478261;0.326086956521739
Control.SRR15539829;48;45;0.5625;21;27;0.0625;0.4375
Control.SRR15539829;50;45;0.56;22;28;0.0600000000000001;0.44
Control.SRR15539829;39;45;0.58974358974359;16;23;0.0897435897435898;0.41025641025641
Control.SRR15539829;46;45;0.41304347826087;27;19;0.0869565217391304;0.41304347826087
Control.SRR15539829;49;45;0.63265306122449;18;31;0.13265306122449;0.36734693877551
Control.SRR15539829;41;45;0.414634146341463;24;17;0.0853658536585366;0.414634146341463
Control.SRR15539829;48;45;0.583333333333333;20;28;0.0833333333333334;0.416666666666667
Control.SRR15539829;46;45;0.5;23;23;0;0.5
Control.SRR15539829;46;45;0.565217391304348;20;26;0.0652173913043478;0.434782608695652
Control.SRR15539829;39;45;0.333333333333333;26;13;0.166666666666667;0.333333333333333
Control.SRR15539829;44;45;0.545454545454545;20;24;0.0454545454545454;0.454545454545455
Control.SRR15539829;49;45;0.530612244897959;23;26;0.0306122448979592;0.469387755102041
Control.SRR15539829;47;45;0.553191489361702;21;26;0.0531914893617021;0.446808510638298
Control.SRR15539829;50;45;0.44;28;22;0.06;0.44
Control.SRR15539829;42;45;0.452380952380952;23;19;0.0476190476190476;0.452380952380952
Control.SRR15539829;48;45;0.4375;27;21;0.0625;0.4375
Control.SRR15539829;48;45;0.541666666666667;22;26;0.0416666666666666;0.458333333333333
Control.SRR15539829;49;45;0.408163265306122;29;20;0.0918367346938775;0.408163265306122
Control.SRR15539829;41;45;0.536585365853659;19;22;0.0365853658536586;0.463414634146341
Control.SRR15539829;39;45;0.307692307692308;27;12;0.192307692307692;0.307692307692308
Control.SRR15539829;48;45;0.479166666666667;25;23;0.0208333333333333;0.479166666666667
Control.SRR15539829;41;45;0.48780487804878;21;20;0.0121951219512195;0.48780487804878
Control.SRR15539829;42;45;0.5;21;21;0;0.5
Control.SRR15539829;50;45;0.38;31;19;0.12;0.38
Control.SRR15539829;43;45;0.418604651162791;25;18;0.0813953488372093;0.418604651162791
Control.SRR15539829;39;45;0.58974358974359;16;23;0.0897435897435898;0.41025641025641
Control.SRR15539829;44;45;0.522727272727273;21;23;0.0227272727272727;0.477272727272727
Control.SRR15539829;39;45;0.41025641025641;23;16;0.0897435897435898;0.41025641025641
Control.SRR15539829;41;45;0.414634146341463;24;17;0.0853658536585366;0.414634146341463
Control.SRR15539829;44;45;0.545454545454545;20;24;0.0454545454545454;0.454545454545455
Control.SRR15539829;48;45;0.458333333333333;26;22;0.0416666666666667;0.458333333333333
Control.SRR15539829;48;45;0.520833333333333;23;25;0.0208333333333334;0.479166666666667
Control.SRR15539829;48;45;0.520833333333333;23;25;0.0208333333333334;0.479166666666667
Control.SRR15539829;40;45;0.6;16;24;0.1;0.4
Control.SRR15539829;48;45;0.458333333333333;26;22;0.0416666666666667;0.458333333333333
Control.SRR15539829;47;45;0.595744680851064;19;28;0.0957446808510638;0.404255319148936
Control.SRR15539829;40;45;0.5;20;20;0;0.5
Control.SRR15539829;44;45;0.590909090909091;18;26;0.0909090909090909;0.409090909090909
Control.SRR15539829;42;45;0.571428571428571;18;24;0.0714285714285714;0.428571428571429
Control.SRR15539829;48;45;0.5;24;24;0;0.5
Control.SRR15539829;42;45;0.452380952380952;23;19;0.0476190476190476;0.452380952380952
Control.SRR15539829;42;45;0.452380952380952;23;19;0.0476190476190476;0.452380952380952
Control.SRR15539829;44;45;0.454545454545455;24;20;0.0454545454545455;0.454545454545455
Control.SRR15539829;41;45;0.414634146341463;24;17;0.0853658536585366;0.414634146341463
Control.SRR15539829;45;45;0.444444444444444;25;20;0.0555555555555556;0.444444444444444
Control.SRR15539829;45;45;0.511111111111111;22;23;0.0111111111111111;0.488888888888889
Control.SRR15539829;38;45;0.526315789473684;18;20;0.0263157894736842;0.473684210526316
Control.SRR15539829;44;45;0.545454545454545;20;24;0.0454545454545454;0.454545454545455
Control.SRR15539829;40;45;0.425;23;17;0.075;0.425
Control.SRR15539829;44;45;0.5;22;22;0;0.5
Control.SRR15539829;43;45;0.558139534883721;19;24;0.0581395348837209;0.441860465116279
Control.SRR15539829;49;45;0.571428571428571;21;28;0.0714285714285714;0.428571428571429
Control.SRR15539829;47;45;0.48936170212766;24;23;0.0106382978723404;0.48936170212766
Control.SRR15539829;47;45;0.48936170212766;24;23;0.0106382978723404;0.48936170212766
Control.SRR15539829;45;45;0.6;18;27;0.1;0.4
Control.SRR15539829;46;45;0.41304347826087;27;19;0.0869565217391304;0.41304347826087
Control.SRR15539829;48;45;0.5;24;24;0;0.5
Control.SRR15539829;50;45;0.4;30;20;0.1;0.4
Control.SRR15539829;50;45;0.42;29;21;0.08;0.42
Control.SRR15539829;40;45;0.475;21;19;0.025;0.475
Control.SRR15539829;40;45;0.5;20;20;0;0.5
Control.SRR15539829;47;45;0.574468085106383;20;27;0.074468085106383;0.425531914893617
Control.SRR15539829;50;45;0.5;25;25;0;0.5
Control.SRR15539829;41;45;0.609756097560976;16;25;0.109756097560976;0.390243902439024
Control.SRR15539829;50;45;0.52;24;26;0.02;0.48
Control.SRR15539829;38;45;0.5;19;19;0;0.5
Control.SRR15539829;45;45;0.511111111111111;22;23;0.0111111111111111;0.488888888888889
Control.SRR15539829;47;45;0.425531914893617;27;20;0.074468085106383;0.425531914893617
Control.SRR15539829;50;45;0.56;22;28;0.0600000000000001;0.44
Control.SRR15539829;47;45;0.382978723404255;29;18;0.117021276595745;0.382978723404255
Control.SRR15539829;39;45;0.615384615384615;15;24;0.115384615384615;0.384615384615385
Control.SRR15539829;43;45;0.604651162790698;17;26;0.104651162790698;0.395348837209302
Control.SRR15539829;47;45;0.51063829787234;23;24;0.0106382978723404;0.48936170212766
Control.SRR15539829;42;45;0.571428571428571;18;24;0.0714285714285714;0.428571428571429
Control.SRR15539829;39;45;0.384615384615385;24;15;0.115384615384615;0.384615384615385
Control.SRR15539829;49;45;0.469387755102041;26;23;0.0306122448979592;0.469387755102041
Control.SRR15539829;44;45;0.409090909090909;26;18;0.0909090909090909;0.409090909090909
Control.SRR15539829;42;45;0.5;21;21;0;0.5
Control.SRR15539829;49;45;0.448979591836735;27;22;0.0510204081632653;0.448979591836735
Control.SRR15539829;47;45;0.468085106382979;25;22;0.0319148936170213;0.468085106382979
Control.SRR15539829;41;45;0.609756097560976;16;25;0.109756097560976;0.390243902439024
Control.SRR15539829;46;45;0.478260869565217;24;22;0.0217391304347826;0.478260869565217
Control.SRR15539829;46;45;0.652173913043478;16;30;0.152173913043478;0.347826086956522
Control.SRR15539829;40;45;0.4;24;16;0.1;0.4
Control.SRR15539829;50;45;0.48;26;24;0.02;0.48
Control.SRR15539829;48;45;0.583333333333333;20;28;0.0833333333333334;0.416666666666667
Control.SRR15539829;45;45;0.511111111111111;22;23;0.0111111111111111;0.488888888888889
Control.SRR15539829;43;45;0.558139534883721;19;24;0.0581395348837209;0.441860465116279
Control.SRR15539829;44;45;0.409090909090909;26;18;0.0909090909090909;0.409090909090909
Control.SRR15539829;42;45;0.452380952380952;23;19;0.0476190476190476;0.452380952380952
Control.SRR15539829;38;45;0.447368421052632;21;17;0.0526315789473684;0.447368421052632
Control.SRR15539829;39;45;0.435897435897436;22;17;0.0641025641025641;0.435897435897436
Control.SRR15539829;41;45;0.365853658536585;26;15;0.134146341463415;0.365853658536585
Control.SRR15539829;45;45;0.377777777777778;28;17;0.122222222222222;0.377777777777778
Control.SRR15539829;39;45;0.487179487179487;20;19;0.0128205128205128;0.487179487179487
Control.SRR15539829;46;45;0.565217391304348;20;26;0.0652173913043478;0.434782608695652
Control.SRR15539829;45;45;0.577777777777778;19;26;0.0777777777777777;0.422222222222222
Control.SRR15539829;48;45;0.458333333333333;26;22;0.0416666666666667;0.458333333333333
Control.SRR15539829;46;45;0.41304347826087;27;19;0.0869565217391304;0.41304347826087
Control.SRR15539829;48;45;0.5625;21;27;0.0625;0.4375
Control.SRR15539829;46;45;0.608695652173913;18;28;0.108695652173913;0.391304347826087
Control.SRR15539829;46;45;0.478260869565217;24;22;0.0217391304347826;0.478260869565217
Control.SRR15539829;43;45;0.395348837209302;26;17;0.104651162790698;0.395348837209302
Control.SRR15539829;50;45;0.46;27;23;0.04;0.46
Control.SRR15539829;48;45;0.5;24;24;0;0.5
Control.SRR15539829;43;45;0.604651162790698;17;26;0.104651162790698;0.395348837209302
Control.SRR15539829;44;45;0.545454545454545;20;24;0.0454545454545454;0.454545454545455
Control.SRR15539829;49;45;0.408163265306122;29;20;0.0918367346938775;0.408163265306122
Control.SRR15539829;48;45;0.458333333333333;26;22;0.0416666666666667;0.458333333333333
Control.SRR15539829;47;45;0.531914893617021;22;25;0.0319148936170213;0.468085106382979
Control.SRR15539829;41;45;0.707317073170732;12;29;0.207317073170732;0.292682926829268
Control.SRR15539829;42;45;0.547619047619048;19;23;0.0476190476190477;0.452380952380952
Control.SRR15539829;44;45;0.477272727272727;23;21;0.0227272727272727;0.477272727272727
Control.SRR15539829;50;45;0.42;29;21;0.08;0.42
Control.SRR15539829;46;45;0.543478260869565;21;25;0.0434782608695652;0.456521739130435
Control.SRR15539829;48;45;0.604166666666667;19;29;0.104166666666667;0.395833333333333
Control.SRR15539829;46;45;0.478260869565217;24;22;0.0217391304347826;0.478260869565217
Control.SRR15539829;46;45;0.565217391304348;20;26;0.0652173913043478;0.434782608695652
Control.SRR15539829;44;45;0.386363636363636;27;17;0.113636363636364;0.386363636363636
Control.SRR15539829;42;45;0.523809523809524;20;22;0.0238095238095238;0.476190476190476
Control.SRR15539829;50;45;0.52;24;26;0.02;0.48
Control.SRR15539829;45;45;0.622222222222222;17;28;0.122222222222222;0.377777777777778
Control.SRR15539829;45;45;0.6;18;27;0.1;0.4
Control.SRR15539829;45;45;0.488888888888889;23;22;0.0111111111111111;0.488888888888889
Control.SRR15539829;49;45;0.551020408163265;22;27;0.0510204081632653;0.448979591836735
Control.SRR15539829;45;45;0.577777777777778;19;26;0.0777777777777777;0.422222222222222
Control.SRR15539829;41;45;0.51219512195122;20;21;0.0121951219512195;0.48780487804878
Control.SRR15539829;44;45;0.454545454545455;24;20;0.0454545454545455;0.454545454545455
Control.SRR15539829;48;45;0.395833333333333;29;19;0.104166666666667;0.395833333333333
Control.SRR15539829;44;45;0.522727272727273;21;23;0.0227272727272727;0.477272727272727
Control.SRR15539829;39;45;0.487179487179487;20;19;0.0128205128205128;0.487179487179487
Control.SRR15539829;43;45;0.488372093023256;22;21;0.0116279069767442;0.488372093023256
Control.SRR15539829;42;45;0.523809523809524;20;22;0.0238095238095238;0.476190476190476
Control.SRR15539829;46;45;0.58695652173913;19;27;0.0869565217391305;0.41304347826087
Control.SRR15539829;44;45;0.454545454545455;24;20;0.0454545454545455;0.454545454545455
Control.SRR15539829;47;45;0.48936170212766;24;23;0.0106382978723404;0.48936170212766
Control.SRR15539829;38;45;0.5;19;19;0;0.5
Control.SRR15539829;45;45;0.4;27;18;0.1;0.4
Control.SRR15539829;49;45;0.530612244897959;23;26;0.0306122448979592;0.469387755102041
Control.SRR15539829;41;45;0.414634146341463;24;17;0.0853658536585366;0.414634146341463
Control.SRR15539829;50;45;0.46;27;23;0.04;0.46
Control.SRR15539829;45;45;0.555555555555556;20;25;0.0555555555555556;0.444444444444444
Control.SRR15539829;45;45;0.511111111111111;22;23;0.0111111111111111;0.488888888888889
Control.SRR15539829;48;45;0.5625;21;27;0.0625;0.4375
Control.SRR15539829;49;45;0.489795918367347;25;24;0.0102040816326531;0.489795918367347
Control.SRR15539829;44;45;0.477272727272727;23;21;0.0227272727272727;0.477272727272727
Control.SRR15539829;44;45;0.431818181818182;25;19;0.0681818181818182;0.431818181818182
Control.SRR15539829;46;45;0.608695652173913;18;28;0.108695652173913;0.391304347826087
Control.SRR15539829;48;45;0.458333333333333;26;22;0.0416666666666667;0.458333333333333
Control.SRR15539829;39;45;0.512820512820513;19;20;0.0128205128205128;0.487179487179487
Control.SRR15539829;44;45;0.522727272727273;21;23;0.0227272727272727;0.477272727272727
Control.SRR15539829;42;45;0.5;21;21;0;0.5
Control.SRR15539829;42;45;0.452380952380952;23;19;0.0476190476190476;0.452380952380952
Control.SRR15539829;47;45;0.446808510638298;26;21;0.0531914893617021;0.446808510638298
Control.SRR15539829;50;45;0.54;23;27;0.04;0.46
Control.SRR15539829;49;45;0.489795918367347;25;24;0.0102040816326531;0.489795918367347
Control.SRR15539829;49;45;0.408163265306122;29;20;0.0918367346938775;0.408163265306122
Control.SRR15539829;48;45;0.604166666666667;19;29;0.104166666666667;0.395833333333333
Control.SRR15539829;39;45;0.538461538461538;18;21;0.0384615384615384;0.461538461538462
Control.SRR15539829;50;45;0.6;20;30;0.1;0.4
Control.SRR15539829;48;45;0.583333333333333;20;28;0.0833333333333334;0.416666666666667
Control.SRR15539829;44;45;0.659090909090909;15;29;0.159090909090909;0.340909090909091
Control.SRR15539829;40;45;0.45;22;18;0.05;0.45
Control.SRR15539829;49;45;0.448979591836735;27;22;0.0510204081632653;0.448979591836735
Control.SRR15539829;42;45;0.642857142857143;15;27;0.142857142857143;0.357142857142857
Control.SRR15539829;50;45;0.52;24;26;0.02;0.48
Control.SRR15539829;44;45;0.454545454545455;24;20;0.0454545454545455;0.454545454545455
Control.SRR15539829;49;45;0.551020408163265;22;27;0.0510204081632653;0.448979591836735
Control.SRR15539829;44;45;0.386363636363636;27;17;0.113636363636364;0.386363636363636
Control.SRR15539829;50;45;0.48;26;24;0.02;0.48
Control.SRR15539829;49;45;0.306122448979592;34;15;0.193877551020408;0.306122448979592
Control.SRR15539829;39;45;0.435897435897436;22;17;0.0641025641025641;0.435897435897436
Control.SRR15539829;47;45;0.425531914893617;27;20;0.074468085106383;0.425531914893617
Control.SRR15539829;50;45;0.42;29;21;0.08;0.42
Control.SRR15539829;47;45;0.659574468085106;16;31;0.159574468085106;0.340425531914894
Control.SRR15539829;50;45;0.46;27;23;0.04;0.46
Control.SRR15539829;47;45;0.48936170212766;24;23;0.0106382978723404;0.48936170212766
Control.SRR15539829;43;45;0.511627906976744;21;22;0.0116279069767442;0.488372093023256
Control.SRR15539829;48;45;0.5;24;24;0;0.5
Control.SRR15539829;40;45;0.55;18;22;0.05;0.45
Control.SRR15539829;49;45;0.448979591836735;27;22;0.0510204081632653;0.448979591836735
Control.SRR15539829;38;45;0.447368421052632;21;17;0.0526315789473684;0.447368421052632
Control.SRR15539829;45;45;0.533333333333333;21;24;0.0333333333333333;0.466666666666667
Control.SRR15539829;41;45;0.48780487804878;21;20;0.0121951219512195;0.48780487804878
Control.SRR15539829;43;45;0.465116279069767;23;20;0.0348837209302326;0.465116279069767
Control.SRR15539829;46;45;0.347826086956522;30;16;0.152173913043478;0.347826086956522
Control.SRR15539829;50;45;0.48;26;24;0.02;0.48
Control.SRR15539829;43;45;0.534883720930233;20;23;0.0348837209302325;0.465116279069767
Control.SRR15539829;47;45;0.48936170212766;24;23;0.0106382978723404;0.48936170212766
Control.SRR15539829;46;45;0.391304347826087;28;18;0.108695652173913;0.391304347826087
Control.SRR15539829;49;45;0.530612244897959;23;26;0.0306122448979592;0.469387755102041
Control.SRR15539829;47;45;0.425531914893617;27;20;0.074468085106383;0.425531914893617
Control.SRR15539829;48;45;0.520833333333333;23;25;0.0208333333333334;0.479166666666667
Control.SRR15539829;50;45;0.56;22;28;0.0600000000000001;0.44
Control.SRR15539829;46;45;0.630434782608696;17;29;0.130434782608696;0.369565217391304
Control.SRR15539829;46;45;0.456521739130435;25;21;0.0434782608695652;0.456521739130435
Control.SRR15539829;41;45;0.536585365853659;19;22;0.0365853658536586;0.463414634146341
Control.SRR15539829;41;45;0.585365853658537;17;24;0.0853658536585366;0.414634146341463
Control.SRR15539829;43;45;0.395348837209302;26;17;0.104651162790698;0.395348837209302
Control.SRR15539829;42;45;0.404761904761905;25;17;0.0952380952380952;0.404761904761905
Control.SRR15539829;43;45;0.441860465116279;24;19;0.0581395348837209;0.441860465116279
Control.SRR15539829;38;45;0.473684210526316;20;18;0.0263157894736842;0.473684210526316
Control.SRR15539829;46;45;0.5;23;23;0;0.5
Control.SRR15539829;43;45;0.558139534883721;19;24;0.0581395348837209;0.441860465116279
Control.SRR15539829;48;45;0.333333333333333;32;16;0.166666666666667;0.333333333333333
Control.SRR15539829;48;45;0.583333333333333;20;28;0.0833333333333334;0.416666666666667
Control.SRR15539829;41;45;0.365853658536585;26;15;0.134146341463415;0.365853658536585
Control.SRR15539829;50;45;0.56;22;28;0.0600000000000001;0.44
Control.SRR15539829;47;45;0.531914893617021;22;25;0.0319148936170213;0.468085106382979
Control.SRR15539829;41;45;0.414634146341463;24;17;0.0853658536585366;0.414634146341463
Control.SRR15539829;39;45;0.358974358974359;25;14;0.141025641025641;0.358974358974359
Control.SRR15539829;47;45;0.468085106382979;25;22;0.0319148936170213;0.468085106382979
Control.SRR15539829;43;45;0.534883720930233;20;23;0.0348837209302325;0.465116279069767
Control.SRR15539829;48;45;0.5625;21;27;0.0625;0.4375
Control.SRR15539829;50;45;0.58;21;29;0.08;0.42
Control.SRR15539829;44;45;0.477272727272727;23;21;0.0227272727272727;0.477272727272727
Control.SRR15539829;46;45;0.456521739130435;25;21;0.0434782608695652;0.456521739130435
Control.SRR15539829;40;45;0.45;22;18;0.05;0.45
Control.SRR15539829;48;45;0.416666666666667;28;20;0.0833333333333333;0.416666666666667
Control.SRR15539829;44;45;0.454545454545455;24;20;0.0454545454545455;0.454545454545455
Control.SRR15539829;49;45;0.448979591836735;27;22;0.0510204081632653;0.448979591836735
Control.SRR15539829;39;45;0.512820512820513;19;20;0.0128205128205128;0.487179487179487
Control.SRR15539829;41;45;0.682926829268293;13;28;0.182926829268293;0.317073170731707
Control.SRR15539829;40;45;0.525;19;21;0.025;0.475
Control.SRR15539829;44;45;0.340909090909091;29;15;0.159090909090909;0.340909090909091
Control.SRR15539829;49;45;0.387755102040816;30;19;0.112244897959184;0.387755102040816
Control.SRR15539829;43;45;0.534883720930233;20;23;0.0348837209302325;0.465116279069767
Control.SRR15539829;46;45;0.521739130434783;22;24;0.0217391304347826;0.478260869565217
Control.SRR15539829;46;45;0.478260869565217;24;22;0.0217391304347826;0.478260869565217
Control.SRR15539829;49;45;0.510204081632653;24;25;0.0102040816326531;0.489795918367347
Control.SRR15539829;49;45;0.428571428571429;28;21;0.0714285714285715;0.428571428571429
Control.SRR15539829;41;45;0.51219512195122;20;21;0.0121951219512195;0.48780487804878
Control.SRR15539829;47;45;0.595744680851064;19;28;0.0957446808510638;0.404255319148936
Control.SRR15539829;48;45;0.604166666666667;19;29;0.104166666666667;0.395833333333333
Control.SRR15539829;47;45;0.595744680851064;19;28;0.0957446808510638;0.404255319148936
Control.SRR15539829;41;45;0.560975609756098;18;23;0.0609756097560976;0.439024390243902
Control.SRR15539829;46;45;0.543478260869565;21;25;0.0434782608695652;0.456521739130435
Control.SRR15539829;46;45;0.41304347826087;27;19;0.0869565217391304;0.41304347826087
Control.SRR15539829;45;45;0.4;27;18;0.1;0.4
Control.SRR15539829;42;45;0.452380952380952;23;19;0.0476190476190476;0.452380952380952
Control.SRR15539829;50;45;0.5;25;25;0;0.5
Control.SRR15539829;45;45;0.511111111111111;22;23;0.0111111111111111;0.488888888888889
Control.SRR15539829;47;45;0.446808510638298;26;21;0.0531914893617021;0.446808510638298
Control.SRR15539829;44;45;0.568181818181818;19;25;0.0681818181818182;0.431818181818182
Control.SRR15539829;45;45;0.533333333333333;21;24;0.0333333333333333;0.466666666666667
Control.SRR15539829;41;45;0.609756097560976;16;25;0.109756097560976;0.390243902439024
Control.SRR15539829;45;45;0.466666666666667;24;21;0.0333333333333333;0.466666666666667
Control.SRR15539829;47;45;0.446808510638298;26;21;0.0531914893617021;0.446808510638298
Control.SRR15539829;48;45;0.479166666666667;25;23;0.0208333333333333;0.479166666666667
Control.SRR15539829;45;45;0.466666666666667;24;21;0.0333333333333333;0.466666666666667
Control.SRR15539829;45;45;0.422222222222222;26;19;0.0777777777777778;0.422222222222222
Control.SRR15539829;47;45;0.468085106382979;25;22;0.0319148936170213;0.468085106382979
Control.SRR15539829;40;45;0.55;18;22;0.05;0.45
Control.SRR15539829;41;45;0.585365853658537;17;24;0.0853658536585366;0.414634146341463
Control.SRR15539829;45;45;0.511111111111111;22;23;0.0111111111111111;0.488888888888889
Control.SRR15539829;43;45;0.534883720930233;20;23;0.0348837209302325;0.465116279069767
Control.SRR15539829;39;45;0.487179487179487;20;19;0.0128205128205128;0.487179487179487
Control.SRR15539829;46;45;0.5;23;23;0;0.5
Control.SRR15539829;46;45;0.565217391304348;20;26;0.0652173913043478;0.434782608695652
Control.SRR15539829;44;45;0.590909090909091;18;26;0.0909090909090909;0.409090909090909
Control.SRR15539829;47;45;0.51063829787234;23;24;0.0106382978723404;0.48936170212766
Control.SRR15539829;45;45;0.511111111111111;22;23;0.0111111111111111;0.488888888888889
Control.SRR15539829;45;45;0.577777777777778;19;26;0.0777777777777777;0.422222222222222
Control.SRR15539829;39;45;0.641025641025641;14;25;0.141025641025641;0.358974358974359
Control.SRR15539829;40;45;0.475;21;19;0.025;0.475
Control.SRR15539829;44;45;0.568181818181818;19;25;0.0681818181818182;0.431818181818182
Control.SRR15539829;49;45;0.510204081632653;24;25;0.0102040816326531;0.489795918367347
Control.SRR15539829;50;45;0.56;22;28;0.0600000000000001;0.44
Control.SRR15539829;49;45;0.551020408163265;22;27;0.0510204081632653;0.448979591836735
Control.SRR15539829;50;45;0.5;25;25;0;0.5
Control.SRR15539829;41;45;0.48780487804878;21;20;0.0121951219512195;0.48780487804878
Control.SRR15539829;41;45;0.609756097560976;16;25;0.109756097560976;0.390243902439024
Control.SRR15539829;45;45;0.577777777777778;19;26;0.0777777777777777;0.422222222222222
Control.SRR15539829;49;45;0.591836734693878;20;29;0.0918367346938775;0.408163265306122
Control.SRR15539829;41;45;0.682926829268293;13;28;0.182926829268293;0.317073170731707
Control.SRR15539829;41;45;0.439024390243902;23;18;0.0609756097560976;0.439024390243902
Control.SRR15539829;40;45;0.525;19;21;0.025;0.475
Control.SRR15539829;45;45;0.577777777777778;19;26;0.0777777777777777;0.422222222222222
Control.SRR15539829;39;45;0.58974358974359;16;23;0.0897435897435898;0.41025641025641
Control.SRR15539829;43;45;0.465116279069767;23;20;0.0348837209302326;0.465116279069767
Control.SRR15539829;50;45;0.48;26;24;0.02;0.48
Control.SRR15539829;46;45;0.478260869565217;24;22;0.0217391304347826;0.478260869565217
Control.SRR15539829;45;45;0.533333333333333;21;24;0.0333333333333333;0.466666666666667
Control.SRR15539829;47;45;0.404255319148936;28;19;0.0957446808510639;0.404255319148936
Control.SRR15539829;49;45;0.448979591836735;27;22;0.0510204081632653;0.448979591836735
Control.SRR15539829;42;45;0.452380952380952;23;19;0.0476190476190476;0.452380952380952
Control.SRR15539829;49;45;0.510204081632653;24;25;0.0102040816326531;0.489795918367347
Control.SRR15539829;44;45;0.409090909090909;26;18;0.0909090909090909;0.409090909090909
Control.SRR15539829;46;45;0.434782608695652;26;20;0.0652173913043478;0.434782608695652
Control.SRR15539829;40;45;0.5;20;20;0;0.5
Control.SRR15539829;41;45;0.609756097560976;16;25;0.109756097560976;0.390243902439024
Control.SRR15539829;42;45;0.452380952380952;23;19;0.0476190476190476;0.452380952380952
Control.SRR15539829;50;45;0.58;21;29;0.08;0.42
Control.SRR15539829;46;45;0.478260869565217;24;22;0.0217391304347826;0.478260869565217
Control.SRR15539829;47;45;0.48936170212766;24;23;0.0106382978723404;0.48936170212766
Control.SRR15539829;48;45;0.520833333333333;23;25;0.0208333333333334;0.479166666666667
Control.SRR15539829;40;45;0.5;20;20;0;0.5
Control.SRR15539829;39;45;0.487179487179487;20;19;0.0128205128205128;0.487179487179487
Control.SRR15539829;40;45;0.525;19;21;0.025;0.475
Control.SRR15539829;41;45;0.536585365853659;19;22;0.0365853658536586;0.463414634146341
Control.SRR15539829;42;45;0.476190476190476;22;20;0.0238095238095238;0.476190476190476
Control.SRR15539829;46;45;0.456521739130435;25;21;0.0434782608695652;0.456521739130435
Control.SRR15539829;50;45;0.5;25;25;0;0.5
Control.SRR15539829;41;45;0.560975609756098;18;23;0.0609756097560976;0.439024390243902
Control.SRR15539829;42;45;0.523809523809524;20;22;0.0238095238095238;0.476190476190476
Control.SRR15539829;45;45;0.622222222222222;17;28;0.122222222222222;0.377777777777778
Control.SRR15539829;47;45;0.48936170212766;24;23;0.0106382978723404;0.48936170212766
Control.SRR15539829;39;45;0.333333333333333;26;13;0.166666666666667;0.333333333333333
Control.SRR15539829;44;45;0.613636363636364;17;27;0.113636363636364;0.386363636363636
Control.SRR15539829;44;45;0.431818181818182;25;19;0.0681818181818182;0.431818181818182
Control.SRR15539829;41;45;0.414634146341463;24;17;0.0853658536585366;0.414634146341463
Control.SRR15539829;40;45;0.425;23;17;0.075;0.425
Control.SRR15539829;45;45;0.466666666666667;24;21;0.0333333333333333;0.466666666666667
Control.SRR15539829;48;45;0.541666666666667;22;26;0.0416666666666666;0.458333333333333
Control.SRR15539829;41;45;0.439024390243902;23;18;0.0609756097560976;0.439024390243902
Control.SRR15539829;43;45;0.627906976744186;16;27;0.127906976744186;0.372093023255814
Control.SRR15539829;45;45;0.577777777777778;19;26;0.0777777777777777;0.422222222222222
Control.SRR15539829;44;45;0.545454545454545;20;24;0.0454545454545454;0.454545454545455
Control.SRR15539829;40;45;0.575;17;23;0.075;0.425
Control.SRR15539829;49;45;0.571428571428571;21;28;0.0714285714285714;0.428571428571429
Control.SRR15539829;38;45;0.342105263157895;25;13;0.157894736842105;0.342105263157895
Control.SRR15539829;48;45;0.5;24;24;0;0.5
Control.SRR15539829;41;45;0.634146341463415;15;26;0.134146341463415;0.365853658536585
Control.SRR15539829;47;45;0.574468085106383;20;27;0.074468085106383;0.425531914893617
Control.SRR15539829;47;45;0.51063829787234;23;24;0.0106382978723404;0.48936170212766
Control.SRR15539829;48;45;0.354166666666667;31;17;0.145833333333333;0.354166666666667
Control.SRR15539829;40;45;0.575;17;23;0.075;0.425
Control.SRR15539829;41;45;0.414634146341463;24;17;0.0853658536585366;0.414634146341463
Control.SRR15539829;43;45;0.465116279069767;23;20;0.0348837209302326;0.465116279069767
Control.SRR15539829;47;45;0.48936170212766;24;23;0.0106382978723404;0.48936170212766
Control.SRR15539829;45;45;0.466666666666667;24;21;0.0333333333333333;0.466666666666667
Control.SRR15539829;43;45;0.534883720930233;20;23;0.0348837209302325;0.465116279069767
Control.SRR15539829;48;45;0.6875;15;33;0.1875;0.3125
Control.SRR15539829;49;45;0.387755102040816;30;19;0.112244897959184;0.387755102040816
Control.SRR15539829;49;45;0.530612244897959;23;26;0.0306122448979592;0.469387755102041
Control.SRR15539829;47;45;0.553191489361702;21;26;0.0531914893617021;0.446808510638298
Control.SRR15539829;49;45;0.653061224489796;17;32;0.153061224489796;0.346938775510204
Control.SRR15539829;47;45;0.382978723404255;29;18;0.117021276595745;0.382978723404255
Control.SRR15539829;46;45;0.543478260869565;21;25;0.0434782608695652;0.456521739130435
Control.SRR15539829;41;45;0.463414634146341;22;19;0.0365853658536585;0.463414634146341
Control.SRR15539829;47;45;0.51063829787234;23;24;0.0106382978723404;0.48936170212766
Control.SRR15539829;46;45;0.521739130434783;22;24;0.0217391304347826;0.478260869565217
Control.SRR15539829;49;45;0.612244897959184;19;30;0.112244897959184;0.387755102040816
Control.SRR15539829;46;45;0.478260869565217;24;22;0.0217391304347826;0.478260869565217
Control.SRR15539829;42;45;0.619047619047619;16;26;0.119047619047619;0.380952380952381
Control.SRR15539829;49;45;0.551020408163265;22;27;0.0510204081632653;0.448979591836735
Control.SRR15539829;50;45;0.4;30;20;0.1;0.4
Control.SRR15539829;48;45;0.541666666666667;22;26;0.0416666666666666;0.458333333333333
Control.SRR15539829;44;45;0.522727272727273;21;23;0.0227272727272727;0.477272727272727
Control.SRR15539829;47;45;0.48936170212766;24;23;0.0106382978723404;0.48936170212766
Control.SRR15539829;45;45;0.577777777777778;19;26;0.0777777777777777;0.422222222222222
Control.SRR15539829;48;45;0.520833333333333;23;25;0.0208333333333334;0.479166666666667
Control.SRR15539829;50;45;0.6;20;30;0.1;0.4
Control.SRR15539829;39;45;0.358974358974359;25;14;0.141025641025641;0.358974358974359
Control.SRR15539829;39;45;0.615384615384615;15;24;0.115384615384615;0.384615384615385
Control.SRR15539829;38;45;0.631578947368421;14;24;0.131578947368421;0.368421052631579
Control.SRR15539829;43;45;0.581395348837209;18;25;0.0813953488372093;0.418604651162791
Control.SRR15539829;47;45;0.702127659574468;14;33;0.202127659574468;0.297872340425532
Control.SRR15539829;42;45;0.523809523809524;20;22;0.0238095238095238;0.476190476190476
Control.SRR15539829;46;45;0.521739130434783;22;24;0.0217391304347826;0.478260869565217
Control.SRR15539829;45;45;0.333333333333333;30;15;0.166666666666667;0.333333333333333
Control.SRR15539829;48;45;0.458333333333333;26;22;0.0416666666666667;0.458333333333333
Control.SRR15539829;45;45;0.444444444444444;25;20;0.0555555555555556;0.444444444444444
Control.SRR15539829;47;45;0.531914893617021;22;25;0.0319148936170213;0.468085106382979
Control.SRR15539829;44;45;0.568181818181818;19;25;0.0681818181818182;0.431818181818182
Control.SRR15539829;42;45;0.642857142857143;15;27;0.142857142857143;0.357142857142857
Control.SRR15539829;48;45;0.479166666666667;25;23;0.0208333333333333;0.479166666666667
Control.SRR15539829;48;45;0.583333333333333;20;28;0.0833333333333334;0.416666666666667
Control.SRR15539829;39;45;0.538461538461538;18;21;0.0384615384615384;0.461538461538462
Control.SRR15539829;48;45;0.479166666666667;25;23;0.0208333333333333;0.479166666666667
Control.SRR15539829;49;45;0.551020408163265;22;27;0.0510204081632653;0.448979591836735
Control.SRR15539829;41;45;0.439024390243902;23;18;0.0609756097560976;0.439024390243902
Control.SRR15539829;41;45;0.365853658536585;26;15;0.134146341463415;0.365853658536585
Control.SRR15539829;44;45;0.454545454545455;24;20;0.0454545454545455;0.454545454545455
Control.SRR15539829;39;45;0.384615384615385;24;15;0.115384615384615;0.384615384615385
Control.SRR15539829;43;45;0.395348837209302;26;17;0.104651162790698;0.395348837209302
Control.SRR15539829;40;45;0.525;19;21;0.025;0.475
Control.SRR15539829;49;45;0.469387755102041;26;23;0.0306122448979592;0.469387755102041
Control.SRR15539829;38;45;0.526315789473684;18;20;0.0263157894736842;0.473684210526316
Control.SRR15539829;41;45;0.439024390243902;23;18;0.0609756097560976;0.439024390243902
Control.SRR15539829;50;45;0.58;21;29;0.08;0.42
Control.SRR15539829;39;45;0.41025641025641;23;16;0.0897435897435898;0.41025641025641
Control.SRR15539829;50;45;0.52;24;26;0.02;0.48
Control.SRR15539829;39;45;0.435897435897436;22;17;0.0641025641025641;0.435897435897436
Control.SRR15539829;50;45;0.38;31;19;0.12;0.38
Control.SRR15539829;48;45;0.583333333333333;20;28;0.0833333333333334;0.416666666666667
Control.SRR15539829;44;45;0.5;22;22;0;0.5
Control.SRR15539829;47;45;0.48936170212766;24;23;0.0106382978723404;0.48936170212766
Control.SRR15539829;47;45;0.595744680851064;19;28;0.0957446808510638;0.404255319148936
Control.SRR15539829;43;45;0.441860465116279;24;19;0.0581395348837209;0.441860465116279
Control.SRR15539829;40;45;0.375;25;15;0.125;0.375
Control.SRR15539829;46;45;0.543478260869565;21;25;0.0434782608695652;0.456521739130435
Control.SRR15539829;48;45;0.479166666666667;25;23;0.0208333333333333;0.479166666666667
Control.SRR15539829;46;45;0.478260869565217;24;22;0.0217391304347826;0.478260869565217
Control.SRR15539829;47;45;0.51063829787234;23;24;0.0106382978723404;0.48936170212766
Control.SRR15539829;43;45;0.465116279069767;23;20;0.0348837209302326;0.465116279069767
Control.SRR15539829;46;45;0.608695652173913;18;28;0.108695652173913;0.391304347826087
Control.SRR15539829;41;45;0.536585365853659;19;22;0.0365853658536586;0.463414634146341
Control.SRR15539829;49;45;0.571428571428571;21;28;0.0714285714285714;0.428571428571429
Control.SRR15539829;50;45;0.56;22;28;0.0600000000000001;0.44
Control.SRR15539829;40;45;0.4;24;16;0.1;0.4
Control.SRR15539829;39;45;0.538461538461538;18;21;0.0384615384615384;0.461538461538462
Control.SRR15539829;53;45;0.452830188679245;29;24;0.0471698113207547;0.452830188679245
Control.SRR15539829;52;45;0.5;26;26;0;0.5
Control.SRR15539829;51;45;0.529411764705882;24;27;0.0294117647058824;0.470588235294118
Control.SRR15539829;53;45;0.490566037735849;27;26;0.00943396226415094;0.490566037735849
Control.SRR15539829;46;45;0.478260869565217;24;22;0.0217391304347826;0.478260869565217
Control.SRR15539829;46;45;0.434782608695652;26;20;0.0652173913043478;0.434782608695652
Control.SRR15539829;51;45;0.568627450980392;22;29;0.0686274509803921;0.431372549019608
Control.SRR15539829;45;45;0.555555555555556;20;25;0.0555555555555556;0.444444444444444
Control.SRR15539829;47;45;0.382978723404255;29;18;0.117021276595745;0.382978723404255
Control.SRR15539829;47;45;0.382978723404255;29;18;0.117021276595745;0.382978723404255
Control.SRR15539829;51;45;0.529411764705882;24;27;0.0294117647058824;0.470588235294118
Control.SRR15539829;49;45;0.428571428571429;28;21;0.0714285714285715;0.428571428571429
Control.SRR15539829;50;45;0.58;21;29;0.08;0.42
Control.SRR15539829;46;45;0.369565217391304;29;17;0.130434782608696;0.369565217391304
Control.SRR15539829;51;45;0.568627450980392;22;29;0.0686274509803921;0.431372549019608
Control.SRR15539829;54;45;0.592592592592593;22;32;0.0925925925925926;0.407407407407407
Control.SRR15539829;44;45;0.431818181818182;25;19;0.0681818181818182;0.431818181818182
Control.SRR15539829;53;45;0.547169811320755;24;29;0.0471698113207547;0.452830188679245
Control.SRR15539829;45;45;0.466666666666667;24;21;0.0333333333333333;0.466666666666667
Control.SRR15539829;44;45;0.5;22;22;0;0.5
Control.SRR15539829;41;45;0.439024390243902;23;18;0.0609756097560976;0.439024390243902
Control.SRR15539829;46;45;0.565217391304348;20;26;0.0652173913043478;0.434782608695652
Control.SRR15539829;44;45;0.454545454545455;24;20;0.0454545454545455;0.454545454545455
Control.SRR15539829;40;45;0.425;23;17;0.075;0.425
Control.SRR15539829;47;45;0.574468085106383;20;27;0.074468085106383;0.425531914893617
Control.SRR15539829;52;45;0.5;26;26;0;0.5
Control.SRR15539829;47;45;0.553191489361702;21;26;0.0531914893617021;0.446808510638298
Control.SRR15539829;42;45;0.547619047619048;19;23;0.0476190476190477;0.452380952380952
Control.SRR15539829;48;45;0.4375;27;21;0.0625;0.4375
Control.SRR15539829;43;45;0.511627906976744;21;22;0.0116279069767442;0.488372093023256
Control.SRR15539829;49;45;0.387755102040816;30;19;0.112244897959184;0.387755102040816
Control.SRR15539829;41;45;0.51219512195122;20;21;0.0121951219512195;0.48780487804878
Control.SRR15539829;46;45;0.434782608695652;26;20;0.0652173913043478;0.434782608695652
Control.SRR15539829;46;45;0.608695652173913;18;28;0.108695652173913;0.391304347826087
Control.SRR15539829;44;45;0.409090909090909;26;18;0.0909090909090909;0.409090909090909
Control.SRR15539829;42;45;0.523809523809524;20;22;0.0238095238095238;0.476190476190476
Control.SRR15539829;50;45;0.5;25;25;0;0.5
Control.SRR15539829;44;45;0.409090909090909;26;18;0.0909090909090909;0.409090909090909
Control.SRR15539829;45;45;0.511111111111111;22;23;0.0111111111111111;0.488888888888889
Control.SRR15539829;42;45;0.476190476190476;22;20;0.0238095238095238;0.476190476190476
Control.SRR15539829;45;45;0.466666666666667;24;21;0.0333333333333333;0.466666666666667
Control.SRR15539829;45;45;0.466666666666667;24;21;0.0333333333333333;0.466666666666667
Control.SRR15539829;40;45;0.5;20;20;0;0.5
Control.SRR15539829;41;45;0.48780487804878;21;20;0.0121951219512195;0.48780487804878
Control.SRR15539829;45;45;0.511111111111111;22;23;0.0111111111111111;0.488888888888889
Control.SRR15539829;46;45;0.478260869565217;24;22;0.0217391304347826;0.478260869565217
Control.SRR15539829;40;45;0.55;18;22;0.05;0.45
Control.SRR15539829;47;45;0.48936170212766;24;23;0.0106382978723404;0.48936170212766
Control.SRR15539829;49;45;0.510204081632653;24;25;0.0102040816326531;0.489795918367347
Control.SRR15539829;46;45;0.521739130434783;22;24;0.0217391304347826;0.478260869565217
Control.SRR15539829;46;45;0.565217391304348;20;26;0.0652173913043478;0.434782608695652
Control.SRR15539829;40;45;0.45;22;18;0.05;0.45
Control.SRR15539829;41;45;0.390243902439024;25;16;0.109756097560976;0.390243902439024
Control.SRR15539829;43;45;0.418604651162791;25;18;0.0813953488372093;0.418604651162791
Control.SRR15539829;40;45;0.425;23;17;0.075;0.425
Control.SRR15539829;42;45;0.404761904761905;25;17;0.0952380952380952;0.404761904761905
Control.SRR15539829;46;45;0.478260869565217;24;22;0.0217391304347826;0.478260869565217
Control.SRR15539829;40;45;0.525;19;21;0.025;0.475
Control.SRR15539829;51;45;0.470588235294118;27;24;0.0294117647058824;0.470588235294118
Control.SRR15539829;51;45;0.509803921568627;25;26;0.00980392156862742;0.490196078431373
Control.SRR15539829;51;45;0.627450980392157;19;32;0.127450980392157;0.372549019607843
Control.SRR15539829;49;45;0.387755102040816;30;19;0.112244897959184;0.387755102040816
Control.SRR15539829;48;45;0.583333333333333;20;28;0.0833333333333334;0.416666666666667
Control.SRR15539829;48;45;0.4375;27;21;0.0625;0.4375
Control.SRR15539829;47;45;0.404255319148936;28;19;0.0957446808510639;0.404255319148936
Control.SRR15539829;43;45;0.488372093023256;22;21;0.0116279069767442;0.488372093023256
Control.SRR15539829;41;45;0.536585365853659;19;22;0.0365853658536586;0.463414634146341
Control.SRR15539829;40;45;0.5;20;20;0;0.5
Control.SRR15539829;44;45;0.545454545454545;20;24;0.0454545454545454;0.454545454545455
Control.SRR15539829;47;45;0.404255319148936;28;19;0.0957446808510639;0.404255319148936
Control.SRR15539829;52;45;0.557692307692308;23;29;0.0576923076923077;0.442307692307692
Control.SRR15539829;47;45;0.51063829787234;23;24;0.0106382978723404;0.48936170212766
Control.SRR15539829;50;45;0.54;23;27;0.04;0.46
Control.SRR15539829;46;45;0.543478260869565;21;25;0.0434782608695652;0.456521739130435
Control.SRR15539829;47;45;0.51063829787234;23;24;0.0106382978723404;0.48936170212766
Control.SRR15539829;53;45;0.528301886792453;25;28;0.0283018867924528;0.471698113207547
Control.SRR15539829;42;45;0.5;21;21;0;0.5
Control.SRR15539829;47;45;0.468085106382979;25;22;0.0319148936170213;0.468085106382979
Control.SRR15539829;49;45;0.591836734693878;20;29;0.0918367346938775;0.408163265306122
Control.SRR15539829;43;45;0.488372093023256;22;21;0.0116279069767442;0.488372093023256
Control.SRR15539829;45;45;0.533333333333333;21;24;0.0333333333333333;0.466666666666667
Control.SRR15539829;41;45;0.585365853658537;17;24;0.0853658536585366;0.414634146341463
Control.SRR15539829;46;45;0.478260869565217;24;22;0.0217391304347826;0.478260869565217
Control.SRR15539829;40;45;0.6;16;24;0.1;0.4
Control.SRR15539829;50;45;0.48;26;24;0.02;0.48
Control.SRR15539829;47;45;0.404255319148936;28;19;0.0957446808510639;0.404255319148936
Control.SRR15539829;41;45;0.560975609756098;18;23;0.0609756097560976;0.439024390243902
Control.SRR15539829;49;45;0.448979591836735;27;22;0.0510204081632653;0.448979591836735
Control.SRR15539829;42;45;0.452380952380952;23;19;0.0476190476190476;0.452380952380952
Control.SRR15539829;42;45;0.380952380952381;26;16;0.119047619047619;0.380952380952381
Control.SRR15539829;40;45;0.475;21;19;0.025;0.475
Control.SRR15539829;43;45;0.581395348837209;18;25;0.0813953488372093;0.418604651162791
Control.SRR15539829;45;45;0.533333333333333;21;24;0.0333333333333333;0.466666666666667
Control.SRR15539829;43;45;0.395348837209302;26;17;0.104651162790698;0.395348837209302
Control.SRR15539829;41;45;0.365853658536585;26;15;0.134146341463415;0.365853658536585
Control.SRR15539829;44;45;0.477272727272727;23;21;0.0227272727272727;0.477272727272727
Control.SRR15539829;45;45;0.688888888888889;14;31;0.188888888888889;0.311111111111111
Control.SRR15539829;49;45;0.551020408163265;22;27;0.0510204081632653;0.448979591836735
Control.SRR15539829;46;45;0.58695652173913;19;27;0.0869565217391305;0.41304347826087
Control.SRR15539829;44;45;0.545454545454545;20;24;0.0454545454545454;0.454545454545455
Control.SRR15539829;45;45;0.4;27;18;0.1;0.4
Control.SRR15539829;40;45;0.5;20;20;0;0.5
Control.SRR15539829;42;45;0.452380952380952;23;19;0.0476190476190476;0.452380952380952
Control.SRR15539829;45;45;0.511111111111111;22;23;0.0111111111111111;0.488888888888889
Control.SRR15539829;48;45;0.541666666666667;22;26;0.0416666666666666;0.458333333333333
Control.SRR15539829;41;45;0.536585365853659;19;22;0.0365853658536586;0.463414634146341
Control.SRR15539829;47;45;0.425531914893617;27;20;0.074468085106383;0.425531914893617
Control.SRR15539829;54;45;0.574074074074074;23;31;0.0740740740740741;0.425925925925926
Control.SRR15539829;42;45;0.571428571428571;18;24;0.0714285714285714;0.428571428571429
Control.SRR15539829;53;45;0.490566037735849;27;26;0.00943396226415094;0.490566037735849
Control.SRR15539829;51;45;0.568627450980392;22;29;0.0686274509803921;0.431372549019608
Control.SRR15539829;41;45;0.463414634146341;22;19;0.0365853658536585;0.463414634146341
Control.SRR15539829;45;45;0.555555555555556;20;25;0.0555555555555556;0.444444444444444
Control.SRR15539829;42;45;0.452380952380952;23;19;0.0476190476190476;0.452380952380952
Control.SRR15539829;47;45;0.48936170212766;24;23;0.0106382978723404;0.48936170212766
Control.SRR15539829;53;45;0.452830188679245;29;24;0.0471698113207547;0.452830188679245
Control.SRR15539829;41;45;0.585365853658537;17;24;0.0853658536585366;0.414634146341463
Control.SRR15539829;42;45;0.619047619047619;16;26;0.119047619047619;0.380952380952381
Control.SRR15539829;52;45;0.673076923076923;17;35;0.173076923076923;0.326923076923077
Control.SRR15539829;44;45;0.477272727272727;23;21;0.0227272727272727;0.477272727272727
Control.SRR15539829;50;45;0.44;28;22;0.06;0.44
Control.SRR15539829;50;45;0.54;23;27;0.04;0.46
Control.SRR15539829;49;45;0.489795918367347;25;24;0.0102040816326531;0.489795918367347
Control.SRR15539829;48;45;0.4375;27;21;0.0625;0.4375
Control.SRR15539829;47;45;0.531914893617021;22;25;0.0319148936170213;0.468085106382979
Control.SRR15539829;40;45;0.525;19;21;0.025;0.475
Control.SRR15539829;44;45;0.477272727272727;23;21;0.0227272727272727;0.477272727272727
Control.SRR15539829;49;45;0.510204081632653;24;25;0.0102040816326531;0.489795918367347
Control.SRR15539829;41;45;0.439024390243902;23;18;0.0609756097560976;0.439024390243902
Control.SRR15539829;49;45;0.653061224489796;17;32;0.153061224489796;0.346938775510204
Control.SRR15539829;42;45;0.5;21;21;0;0.5
Control.SRR15539829;45;45;0.488888888888889;23;22;0.0111111111111111;0.488888888888889
Control.SRR15539829;42;45;0.523809523809524;20;22;0.0238095238095238;0.476190476190476
Control.SRR15539829;44;45;0.477272727272727;23;21;0.0227272727272727;0.477272727272727
Control.SRR15539829;44;45;0.727272727272727;12;32;0.227272727272727;0.272727272727273
Control.SRR15539829;49;45;0.469387755102041;26;23;0.0306122448979592;0.469387755102041
Control.SRR15539829;49;45;0.530612244897959;23;26;0.0306122448979592;0.469387755102041
Control.SRR15539829;41;45;0.365853658536585;26;15;0.134146341463415;0.365853658536585
Control.SRR15539829;44;45;0.454545454545455;24;20;0.0454545454545455;0.454545454545455
Control.SRR15539829;47;45;0.553191489361702;21;26;0.0531914893617021;0.446808510638298
Control.SRR15539829;48;45;0.458333333333333;26;22;0.0416666666666667;0.458333333333333
Control.SRR15539829;51;45;0.470588235294118;27;24;0.0294117647058824;0.470588235294118
Control.SRR15539829;49;45;0.571428571428571;21;28;0.0714285714285714;0.428571428571429
Control.SRR15539829;53;45;0.471698113207547;28;25;0.0283018867924528;0.471698113207547
Control.SRR15539829;52;45;0.461538461538462;28;24;0.0384615384615384;0.461538461538462
Control.SRR15539829;42;45;0.666666666666667;14;28;0.166666666666667;0.333333333333333
Control.SRR15539829;46;45;0.521739130434783;22;24;0.0217391304347826;0.478260869565217
Control.SRR15539829;45;45;0.444444444444444;25;20;0.0555555555555556;0.444444444444444
Control.SRR15539829;44;45;0.522727272727273;21;23;0.0227272727272727;0.477272727272727
Control.SRR15539829;50;45;0.54;23;27;0.04;0.46
Control.SRR15539829;41;45;0.609756097560976;16;25;0.109756097560976;0.390243902439024
Control.SRR15539829;44;45;0.522727272727273;21;23;0.0227272727272727;0.477272727272727
Control.SRR15539829;45;45;0.466666666666667;24;21;0.0333333333333333;0.466666666666667
Control.SRR15539829;48;45;0.604166666666667;19;29;0.104166666666667;0.395833333333333
Control.SRR15539829;44;45;0.568181818181818;19;25;0.0681818181818182;0.431818181818182
Control.SRR15539829;54;45;0.574074074074074;23;31;0.0740740740740741;0.425925925925926
Control.SRR15539829;51;45;0.666666666666667;17;34;0.166666666666667;0.333333333333333
Control.SRR15539829;45;45;0.422222222222222;26;19;0.0777777777777778;0.422222222222222
Control.SRR15539829;48;45;0.458333333333333;26;22;0.0416666666666667;0.458333333333333
Control.SRR15539829;50;45;0.44;28;22;0.06;0.44
Control.SRR15539829;43;45;0.441860465116279;24;19;0.0581395348837209;0.441860465116279
Control.SRR15539829;45;45;0.4;27;18;0.1;0.4
Control.SRR15539829;46;45;0.543478260869565;21;25;0.0434782608695652;0.456521739130435
Control.SRR15539829;48;45;0.458333333333333;26;22;0.0416666666666667;0.458333333333333
Control.SRR15539829;43;45;0.534883720930233;20;23;0.0348837209302325;0.465116279069767
Control.SRR15539829;42;45;0.5;21;21;0;0.5
Control.SRR15539829;45;45;0.488888888888889;23;22;0.0111111111111111;0.488888888888889
Control.SRR15539829;50;45;0.44;28;22;0.06;0.44
Control.SRR15539829;44;45;0.454545454545455;24;20;0.0454545454545455;0.454545454545455
Control.SRR15539829;46;45;0.58695652173913;19;27;0.0869565217391305;0.41304347826087
Control.SRR15539829;52;45;0.519230769230769;25;27;0.0192307692307693;0.480769230769231
Control.SRR15539829;49;45;0.591836734693878;20;29;0.0918367346938775;0.408163265306122
Control.SRR15539829;44;45;0.568181818181818;19;25;0.0681818181818182;0.431818181818182
Control.SRR15539829;47;45;0.595744680851064;19;28;0.0957446808510638;0.404255319148936
Control.SRR15539829;48;45;0.479166666666667;25;23;0.0208333333333333;0.479166666666667
Control.SRR15539829;41;45;0.317073170731707;28;13;0.182926829268293;0.317073170731707
Control.SRR15539829;45;45;0.533333333333333;21;24;0.0333333333333333;0.466666666666667
Control.SRR15539829;48;45;0.583333333333333;20;28;0.0833333333333334;0.416666666666667
Control.SRR15539829;51;45;0.568627450980392;22;29;0.0686274509803921;0.431372549019608
Control.SRR15539829;47;45;0.446808510638298;26;21;0.0531914893617021;0.446808510638298
Control.SRR15539829;43;45;0.348837209302326;28;15;0.151162790697674;0.348837209302326
Control.SRR15539829;40;45;0.55;18;22;0.05;0.45
Control.SRR15539829;40;45;0.5;20;20;0;0.5
Control.SRR15539829;41;45;0.390243902439024;25;16;0.109756097560976;0.390243902439024
Control.SRR15539829;44;45;0.545454545454545;20;24;0.0454545454545454;0.454545454545455
Control.SRR15539829;43;45;0.558139534883721;19;24;0.0581395348837209;0.441860465116279
Control.SRR15539829;43;45;0.627906976744186;16;27;0.127906976744186;0.372093023255814
Control.SRR15539829;41;45;0.48780487804878;21;20;0.0121951219512195;0.48780487804878
Control.SRR15539829;47;45;0.659574468085106;16;31;0.159574468085106;0.340425531914894
Control.SRR15539829;48;45;0.479166666666667;25;23;0.0208333333333333;0.479166666666667
Control.SRR15539829;45;45;0.444444444444444;25;20;0.0555555555555556;0.444444444444444
Control.SRR15539829;44;45;0.454545454545455;24;20;0.0454545454545455;0.454545454545455
Control.SRR15539829;43;45;0.534883720930233;20;23;0.0348837209302325;0.465116279069767
Control.SRR15539829;46;45;0.543478260869565;21;25;0.0434782608695652;0.456521739130435
Control.SRR15539829;41;45;0.365853658536585;26;15;0.134146341463415;0.365853658536585
Control.SRR15539829;50;45;0.52;24;26;0.02;0.48
Control.SRR15539829;54;45;0.518518518518518;26;28;0.0185185185185185;0.481481481481481
Control.SRR15539829;48;45;0.520833333333333;23;25;0.0208333333333334;0.479166666666667
Control.SRR15539829;54;45;0.537037037037037;25;29;0.0370370370370371;0.462962962962963
Control.SRR15539829;43;45;0.418604651162791;25;18;0.0813953488372093;0.418604651162791
Control.SRR15539829;42;45;0.476190476190476;22;20;0.0238095238095238;0.476190476190476
Control.SRR15539829;51;45;0.568627450980392;22;29;0.0686274509803921;0.431372549019608
Control.SRR15539829;46;45;0.5;23;23;0;0.5
Control.SRR15539829;53;45;0.584905660377358;22;31;0.0849056603773585;0.415094339622642
Control.SRR15539829;48;45;0.541666666666667;22;26;0.0416666666666666;0.458333333333333
Control.SRR15539829;42;45;0.547619047619048;19;23;0.0476190476190477;0.452380952380952
Control.SRR15539829;41;45;0.536585365853659;19;22;0.0365853658536586;0.463414634146341
Control.SRR15539829;42;45;0.523809523809524;20;22;0.0238095238095238;0.476190476190476
Control.SRR15539829;49;45;0.489795918367347;25;24;0.0102040816326531;0.489795918367347
Control.SRR15539829;47;45;0.425531914893617;27;20;0.074468085106383;0.425531914893617
Control.SRR15539829;50;45;0.6;20;30;0.1;0.4
Control.SRR15539829;40;45;0.475;21;19;0.025;0.475
Control.SRR15539829;40;45;0.45;22;18;0.05;0.45
Control.SRR15539829;51;45;0.470588235294118;27;24;0.0294117647058824;0.470588235294118
Control.SRR15539829;49;45;0.530612244897959;23;26;0.0306122448979592;0.469387755102041
Control.SRR15539829;44;45;0.454545454545455;24;20;0.0454545454545455;0.454545454545455
Control.SRR15539829;50;45;0.42;29;21;0.08;0.42
Control.SRR15539829;50;45;0.56;22;28;0.0600000000000001;0.44
Control.SRR15539829;40;45;0.4;24;16;0.1;0.4
Control.SRR15539829;49;45;0.469387755102041;26;23;0.0306122448979592;0.469387755102041
Control.SRR15539829;48;45;0.4375;27;21;0.0625;0.4375
Control.SRR15539829;40;45;0.4;24;16;0.1;0.4
Control.SRR15539829;43;45;0.511627906976744;21;22;0.0116279069767442;0.488372093023256
Control.SRR15539829;45;45;0.577777777777778;19;26;0.0777777777777777;0.422222222222222
Control.SRR15539829;42;45;0.428571428571429;24;18;0.0714285714285715;0.428571428571429
Control.SRR15539829;53;45;0.452830188679245;29;24;0.0471698113207547;0.452830188679245
Control.SRR15539829;52;45;0.403846153846154;31;21;0.0961538461538461;0.403846153846154
Control.SRR15539829;46;45;0.434782608695652;26;20;0.0652173913043478;0.434782608695652
Control.SRR15539829;48;45;0.5625;21;27;0.0625;0.4375
Control.SRR15539829;46;45;0.565217391304348;20;26;0.0652173913043478;0.434782608695652
Control.SRR15539829;40;45;0.625;15;25;0.125;0.375
Control.SRR15539829;45;45;0.533333333333333;21;24;0.0333333333333333;0.466666666666667
Control.SRR15539829;44;45;0.545454545454545;20;24;0.0454545454545454;0.454545454545455
Control.SRR15539829;53;45;0.679245283018868;17;36;0.179245283018868;0.320754716981132
Control.SRR15539829;52;45;0.423076923076923;30;22;0.0769230769230769;0.423076923076923
Control.SRR15539829;48;45;0.4375;27;21;0.0625;0.4375
Control.SRR15539829;45;45;0.488888888888889;23;22;0.0111111111111111;0.488888888888889
Control.SRR15539829;50;45;0.4;30;20;0.1;0.4
Control.SRR15539829;48;45;0.5;24;24;0;0.5
Control.SRR15539829;41;45;0.439024390243902;23;18;0.0609756097560976;0.439024390243902
Control.SRR15539829;53;45;0.471698113207547;28;25;0.0283018867924528;0.471698113207547
Control.SRR15539829;48;45;0.604166666666667;19;29;0.104166666666667;0.395833333333333
Control.SRR15539829;46;45;0.41304347826087;27;19;0.0869565217391304;0.41304347826087
Control.SRR15539829;41;45;0.609756097560976;16;25;0.109756097560976;0.390243902439024
Control.SRR15539829;52;45;0.519230769230769;25;27;0.0192307692307693;0.480769230769231
Control.SRR15539829;52;45;0.5;26;26;0;0.5
Control.SRR15539829;54;45;0.481481481481481;28;26;0.0185185185185185;0.481481481481481
Control.SRR15539829;46;45;0.5;23;23;0;0.5
Control.SRR15539829;53;45;0.452830188679245;29;24;0.0471698113207547;0.452830188679245
Control.SRR15539829;43;45;0.465116279069767;23;20;0.0348837209302326;0.465116279069767
Control.SRR15539829;40;45;0.625;15;25;0.125;0.375
Control.SRR15539829;51;45;0.431372549019608;29;22;0.0686274509803921;0.431372549019608
Control.SRR15539829;45;45;0.555555555555556;20;25;0.0555555555555556;0.444444444444444
Control.SRR15539829;49;45;0.530612244897959;23;26;0.0306122448979592;0.469387755102041
Control.SRR15539829;54;45;0.444444444444444;30;24;0.0555555555555556;0.444444444444444
Control.SRR15539829;50;45;0.48;26;24;0.02;0.48
Control.SRR15539829;44;45;0.477272727272727;23;21;0.0227272727272727;0.477272727272727
Control.SRR15539829;46;45;0.565217391304348;20;26;0.0652173913043478;0.434782608695652
Control.SRR15539829;44;45;0.590909090909091;18;26;0.0909090909090909;0.409090909090909
Control.SRR15539829;46;45;0.543478260869565;21;25;0.0434782608695652;0.456521739130435
Control.SRR15539829;48;45;0.583333333333333;20;28;0.0833333333333334;0.416666666666667
Control.SRR15539829;49;45;0.571428571428571;21;28;0.0714285714285714;0.428571428571429
Control.SRR15539829;49;45;0.428571428571429;28;21;0.0714285714285715;0.428571428571429
Control.SRR15539829;53;45;0.471698113207547;28;25;0.0283018867924528;0.471698113207547
Control.SRR15539829;44;45;0.477272727272727;23;21;0.0227272727272727;0.477272727272727
Control.SRR15539829;49;45;0.530612244897959;23;26;0.0306122448979592;0.469387755102041
Control.SRR15539829;53;45;0.39622641509434;32;21;0.10377358490566;0.39622641509434
Control.SRR15539829;51;45;0.470588235294118;27;24;0.0294117647058824;0.470588235294118
Control.SRR15539829;41;45;0.51219512195122;20;21;0.0121951219512195;0.48780487804878
Control.SRR15539829;49;45;0.591836734693878;20;29;0.0918367346938775;0.408163265306122
Control.SRR15539829;46;45;0.369565217391304;29;17;0.130434782608696;0.369565217391304
Control.SRR15539829;54;45;0.425925925925926;31;23;0.0740740740740741;0.425925925925926
Control.SRR15539829;42;45;0.523809523809524;20;22;0.0238095238095238;0.476190476190476
Control.SRR15539829;52;45;0.5;26;26;0;0.5
Control.SRR15539829;54;45;0.5;27;27;0;0.5
Control.SRR15539829;45;45;0.444444444444444;25;20;0.0555555555555556;0.444444444444444
Control.SRR15539829;52;45;0.538461538461538;24;28;0.0384615384615384;0.461538461538462
Control.SRR15539829;45;45;0.622222222222222;17;28;0.122222222222222;0.377777777777778
Control.SRR15539829;48;45;0.520833333333333;23;25;0.0208333333333334;0.479166666666667
Control.SRR15539829;49;45;0.571428571428571;21;28;0.0714285714285714;0.428571428571429
Control.SRR15539829;48;45;0.5625;21;27;0.0625;0.4375
Control.SRR15539829;54;45;0.518518518518518;26;28;0.0185185185185185;0.481481481481481
Control.SRR15539829;54;45;0.592592592592593;22;32;0.0925925925925926;0.407407407407407
Control.SRR15539829;46;45;0.565217391304348;20;26;0.0652173913043478;0.434782608695652
Control.SRR15539829;49;45;0.469387755102041;26;23;0.0306122448979592;0.469387755102041
Control.SRR15539829;54;45;0.462962962962963;29;25;0.037037037037037;0.462962962962963
Control.SRR15539829;51;45;0.490196078431373;26;25;0.00980392156862747;0.490196078431373
Control.SRR15539829;42;45;0.523809523809524;20;22;0.0238095238095238;0.476190476190476
Control.SRR15539829;51;45;0.549019607843137;23;28;0.0490196078431373;0.450980392156863
Control.SRR15539829;43;45;0.558139534883721;19;24;0.0581395348837209;0.441860465116279
Control.SRR15539829;53;45;0.528301886792453;25;28;0.0283018867924528;0.471698113207547
Control.SRR15539829;51;45;0.450980392156863;28;23;0.0490196078431372;0.450980392156863
Control.SRR15539829;44;45;0.5;22;22;0;0.5
Control.SRR15539829;48;45;0.416666666666667;28;20;0.0833333333333333;0.416666666666667
Control.SRR15539829;47;45;0.468085106382979;25;22;0.0319148936170213;0.468085106382979
Control.SRR15539829;50;45;0.52;24;26;0.02;0.48
Control.SRR15539829;48;45;0.5;24;24;0;0.5
Control.SRR15539829;47;45;0.531914893617021;22;25;0.0319148936170213;0.468085106382979
Control.SRR15539829;46;45;0.521739130434783;22;24;0.0217391304347826;0.478260869565217
Control.SRR15539829;44;45;0.477272727272727;23;21;0.0227272727272727;0.477272727272727
Control.SRR15539829;45;45;0.533333333333333;21;24;0.0333333333333333;0.466666666666667
Control.SRR15539829;47;45;0.51063829787234;23;24;0.0106382978723404;0.48936170212766
Control.SRR15539829;41;45;0.560975609756098;18;23;0.0609756097560976;0.439024390243902
Control.SRR15539829;41;45;0.585365853658537;17;24;0.0853658536585366;0.414634146341463
Control.SRR15539829;42;45;0.595238095238095;17;25;0.0952380952380952;0.404761904761905
Control.SRR15539829;54;45;0.481481481481481;28;26;0.0185185185185185;0.481481481481481
Control.SRR15539829;48;45;0.583333333333333;20;28;0.0833333333333334;0.416666666666667
Control.SRR15539829;52;45;0.480769230769231;27;25;0.0192307692307692;0.480769230769231
Control.SRR15539829;53;45;0.415094339622642;31;22;0.0849056603773585;0.415094339622642
Control.SRR15539829;50;45;0.54;23;27;0.04;0.46
Control.SRR15539829;44;45;0.613636363636364;17;27;0.113636363636364;0.386363636363636
Control.SRR15539829;44;45;0.590909090909091;18;26;0.0909090909090909;0.409090909090909
Control.SRR15539829;48;45;0.541666666666667;22;26;0.0416666666666666;0.458333333333333
Control.SRR15539829;54;45;0.555555555555556;24;30;0.0555555555555556;0.444444444444444
Control.SRR15539829;42;45;0.380952380952381;26;16;0.119047619047619;0.380952380952381
Control.SRR15539829;40;45;0.55;18;22;0.05;0.45
Control.SRR15539829;41;45;0.51219512195122;20;21;0.0121951219512195;0.48780487804878
Control.SRR15539829;47;45;0.468085106382979;25;22;0.0319148936170213;0.468085106382979
Control.SRR15539829;48;45;0.645833333333333;17;31;0.145833333333333;0.354166666666667
Control.SRR15539829;47;45;0.340425531914894;31;16;0.159574468085106;0.340425531914894
Control.SRR15539829;47;45;0.48936170212766;24;23;0.0106382978723404;0.48936170212766
Control.SRR15539829;51;45;0.490196078431373;26;25;0.00980392156862747;0.490196078431373
Control.SRR15539829;48;45;0.541666666666667;22;26;0.0416666666666666;0.458333333333333
Control.SRR15539829;47;45;0.51063829787234;23;24;0.0106382978723404;0.48936170212766
Control.SRR15539829;40;45;0.425;23;17;0.075;0.425
Control.SRR15539829;43;45;0.558139534883721;19;24;0.0581395348837209;0.441860465116279
Control.SRR15539829;50;45;0.62;19;31;0.12;0.38
Control.SRR15539829;49;45;0.489795918367347;25;24;0.0102040816326531;0.489795918367347
Control.SRR15539829;46;45;0.260869565217391;34;12;0.239130434782609;0.260869565217391
Control.SRR15539829;51;45;0.490196078431373;26;25;0.00980392156862747;0.490196078431373
Control.SRR15539829;41;45;0.585365853658537;17;24;0.0853658536585366;0.414634146341463
Control.SRR15539829;42;45;0.571428571428571;18;24;0.0714285714285714;0.428571428571429
Control.SRR15539829;40;45;0.525;19;21;0.025;0.475
Control.SRR15539829;45;45;0.533333333333333;21;24;0.0333333333333333;0.466666666666667
Control.SRR15539829;41;45;0.536585365853659;19;22;0.0365853658536586;0.463414634146341
Control.SRR15539829;47;45;0.361702127659574;30;17;0.138297872340426;0.361702127659574
Control.SRR15539829;52;45;0.480769230769231;27;25;0.0192307692307692;0.480769230769231
Control.SRR15539829;52;45;0.519230769230769;25;27;0.0192307692307693;0.480769230769231
Control.SRR15539829;47;45;0.48936170212766;24;23;0.0106382978723404;0.48936170212766
Control.SRR15539829;48;45;0.541666666666667;22;26;0.0416666666666666;0.458333333333333
Control.SRR15539829;45;45;0.6;18;27;0.1;0.4
Control.SRR15539829;45;45;0.577777777777778;19;26;0.0777777777777777;0.422222222222222
Control.SRR15539829;53;45;0.641509433962264;19;34;0.141509433962264;0.358490566037736
Control.SRR15539829;42;45;0.547619047619048;19;23;0.0476190476190477;0.452380952380952
Control.SRR15539829;45;45;0.488888888888889;23;22;0.0111111111111111;0.488888888888889
Control.SRR15539829;49;45;0.387755102040816;30;19;0.112244897959184;0.387755102040816
Control.SRR15539829;50;45;0.5;25;25;0;0.5
Control.SRR15539829;46;45;0.434782608695652;26;20;0.0652173913043478;0.434782608695652
Control.SRR15539829;44;45;0.409090909090909;26;18;0.0909090909090909;0.409090909090909
Control.SRR15539829;42;45;0.428571428571429;24;18;0.0714285714285715;0.428571428571429
Control.SRR15539829;45;45;0.644444444444444;16;29;0.144444444444444;0.355555555555556
Control.SRR15539829;54;45;0.555555555555556;24;30;0.0555555555555556;0.444444444444444
Control.SRR15539829;54;45;0.5;27;27;0;0.5
Control.SRR15539829;54;45;0.611111111111111;21;33;0.111111111111111;0.388888888888889
Control.SRR15539829;49;45;0.469387755102041;26;23;0.0306122448979592;0.469387755102041
Control.SRR15539829;43;45;0.511627906976744;21;22;0.0116279069767442;0.488372093023256
Control.SRR15539829;48;45;0.583333333333333;20;28;0.0833333333333334;0.416666666666667
Control.SRR15539829;42;45;0.523809523809524;20;22;0.0238095238095238;0.476190476190476
Control.SRR15539829;46;45;0.58695652173913;19;27;0.0869565217391305;0.41304347826087
Control.SRR15539829;44;45;0.522727272727273;21;23;0.0227272727272727;0.477272727272727
Control.SRR15539829;54;45;0.481481481481481;28;26;0.0185185185185185;0.481481481481481
Control.SRR15539829;47;45;0.553191489361702;21;26;0.0531914893617021;0.446808510638298
Control.SRR15539829;50;45;0.54;23;27;0.04;0.46
Control.SRR15539829;52;45;0.403846153846154;31;21;0.0961538461538461;0.403846153846154
Control.SRR15539829;51;45;0.549019607843137;23;28;0.0490196078431373;0.450980392156863
Control.SRR15539829;50;45;0.52;24;26;0.02;0.48
Control.SRR15539829;54;45;0.481481481481481;28;26;0.0185185185185185;0.481481481481481
Control.SRR15539829;47;45;0.574468085106383;20;27;0.074468085106383;0.425531914893617
Control.SRR15539829;48;45;0.458333333333333;26;22;0.0416666666666667;0.458333333333333
Control.SRR15539829;41;45;0.51219512195122;20;21;0.0121951219512195;0.48780487804878
Control.SRR15539829;51;45;0.588235294117647;21;30;0.0882352941176471;0.411764705882353
Control.SRR15539829;47;45;0.531914893617021;22;25;0.0319148936170213;0.468085106382979
Control.SRR15539829;44;45;0.636363636363636;16;28;0.136363636363636;0.363636363636364
Control.SRR15539829;51;45;0.470588235294118;27;24;0.0294117647058824;0.470588235294118
Control.SRR15539829;41;45;0.536585365853659;19;22;0.0365853658536586;0.463414634146341
Control.SRR15539829;44;45;0.477272727272727;23;21;0.0227272727272727;0.477272727272727
Control.SRR15539829;51;45;0.509803921568627;25;26;0.00980392156862742;0.490196078431373
Control.SRR15539829;52;45;0.557692307692308;23;29;0.0576923076923077;0.442307692307692
Control.SRR15539829;53;45;0.566037735849057;23;30;0.0660377358490566;0.433962264150943
Control.SRR15539829;54;45;0.555555555555556;24;30;0.0555555555555556;0.444444444444444
Control.SRR15539829;51;45;0.568627450980392;22;29;0.0686274509803921;0.431372549019608
Control.SRR15539829;45;45;0.511111111111111;22;23;0.0111111111111111;0.488888888888889
Control.SRR15539829;48;45;0.479166666666667;25;23;0.0208333333333333;0.479166666666667
Control.SRR15539829;51;45;0.450980392156863;28;23;0.0490196078431372;0.450980392156863
Control.SRR15539829;44;45;0.477272727272727;23;21;0.0227272727272727;0.477272727272727
Control.SRR15539829;40;45;0.4;24;16;0.1;0.4
Control.SRR15539829;53;45;0.509433962264151;26;27;0.00943396226415094;0.490566037735849
Control.SRR15539829;50;45;0.5;25;25;0;0.5
Control.SRR15539829;46;45;0.521739130434783;22;24;0.0217391304347826;0.478260869565217
Control.SRR15539829;49;45;0.469387755102041;26;23;0.0306122448979592;0.469387755102041
Control.SRR15539829;47;45;0.531914893617021;22;25;0.0319148936170213;0.468085106382979
Control.SRR15539829;46;45;0.652173913043478;16;30;0.152173913043478;0.347826086956522
Control.SRR15539829;44;45;0.545454545454545;20;24;0.0454545454545454;0.454545454545455
Control.SRR15539829;44;45;0.363636363636364;28;16;0.136363636363636;0.363636363636364
Control.SRR15539829;42;45;0.619047619047619;16;26;0.119047619047619;0.380952380952381
Control.SRR15539829;41;45;0.536585365853659;19;22;0.0365853658536586;0.463414634146341
Control.SRR15539829;41;45;0.439024390243902;23;18;0.0609756097560976;0.439024390243902
Control.SRR15539829;50;45;0.4;30;20;0.1;0.4
Control.SRR15539829;52;45;0.538461538461538;24;28;0.0384615384615384;0.461538461538462
Control.SRR15539829;48;45;0.541666666666667;22;26;0.0416666666666666;0.458333333333333
Control.SRR15539829;48;45;0.479166666666667;25;23;0.0208333333333333;0.479166666666667
Control.SRR15539829;47;45;0.48936170212766;24;23;0.0106382978723404;0.48936170212766
Control.SRR15539829;50;45;0.36;32;18;0.14;0.36
Control.SRR15539829;43;45;0.488372093023256;22;21;0.0116279069767442;0.488372093023256
Control.SRR15539829;47;45;0.680851063829787;15;32;0.180851063829787;0.319148936170213
Control.SRR15539829;48;45;0.5;24;24;0;0.5
Control.SRR15539829;44;45;0.522727272727273;21;23;0.0227272727272727;0.477272727272727
Control.SRR15539829;46;45;0.434782608695652;26;20;0.0652173913043478;0.434782608695652
Control.SRR15539829;42;45;0.476190476190476;22;20;0.0238095238095238;0.476190476190476
Control.SRR15539829;46;45;0.608695652173913;18;28;0.108695652173913;0.391304347826087
Control.SRR15539829;49;45;0.428571428571429;28;21;0.0714285714285715;0.428571428571429
Control.SRR15539829;45;45;0.555555555555556;20;25;0.0555555555555556;0.444444444444444
Control.SRR15539829;50;45;0.5;25;25;0;0.5
Control.SRR15539829;43;45;0.488372093023256;22;21;0.0116279069767442;0.488372093023256
Control.SRR15539829;44;45;0.363636363636364;28;16;0.136363636363636;0.363636363636364
Control.SRR15539829;40;45;0.6;16;24;0.1;0.4
Control.SRR15539829;45;45;0.577777777777778;19;26;0.0777777777777777;0.422222222222222
Control.SRR15539829;52;45;0.576923076923077;22;30;0.0769230769230769;0.423076923076923
Control.SRR15539829;51;45;0.549019607843137;23;28;0.0490196078431373;0.450980392156863
Control.SRR15539829;42;45;0.571428571428571;18;24;0.0714285714285714;0.428571428571429
Control.SRR15539829;44;45;0.454545454545455;24;20;0.0454545454545455;0.454545454545455
Control.SRR15539829;52;45;0.538461538461538;24;28;0.0384615384615384;0.461538461538462
Control.SRR15539829;45;45;0.555555555555556;20;25;0.0555555555555556;0.444444444444444
Control.SRR15539829;51;45;0.431372549019608;29;22;0.0686274509803921;0.431372549019608
Control.SRR15539829;40;45;0.55;18;22;0.05;0.45
Control.SRR15539829;43;45;0.488372093023256;22;21;0.0116279069767442;0.488372093023256
Control.SRR15539829;49;45;0.489795918367347;25;24;0.0102040816326531;0.489795918367347
Control.SRR15539829;43;45;0.534883720930233;20;23;0.0348837209302325;0.465116279069767
Control.SRR15539829;48;45;0.583333333333333;20;28;0.0833333333333334;0.416666666666667
Control.SRR15539829;43;45;0.441860465116279;24;19;0.0581395348837209;0.441860465116279
Control.SRR15539829;41;45;0.48780487804878;21;20;0.0121951219512195;0.48780487804878
Control.SRR15539829;41;45;0.48780487804878;21;20;0.0121951219512195;0.48780487804878
Control.SRR15539829;41;45;0.585365853658537;17;24;0.0853658536585366;0.414634146341463
Control.SRR15539829;48;45;0.541666666666667;22;26;0.0416666666666666;0.458333333333333
Control.SRR15539829;44;45;0.5;22;22;0;0.5
Control.SRR15539829;47;45;0.468085106382979;25;22;0.0319148936170213;0.468085106382979
Control.SRR15539829;51;45;0.450980392156863;28;23;0.0490196078431372;0.450980392156863
Control.SRR15539829;50;45;0.44;28;22;0.06;0.44
Control.SRR15539829;47;45;0.51063829787234;23;24;0.0106382978723404;0.48936170212766
Control.SRR15539829;44;45;0.636363636363636;16;28;0.136363636363636;0.363636363636364
Control.SRR15539829;48;45;0.5;24;24;0;0.5
Control.SRR15539829;41;45;0.439024390243902;23;18;0.0609756097560976;0.439024390243902
Control.SRR15539829;40;45;0.35;26;14;0.15;0.35
Control.SRR15539829;52;45;0.576923076923077;22;30;0.0769230769230769;0.423076923076923
Control.SRR15539829;44;45;0.477272727272727;23;21;0.0227272727272727;0.477272727272727
Control.SRR15539829;47;45;0.595744680851064;19;28;0.0957446808510638;0.404255319148936
Control.SRR15539829;43;45;0.488372093023256;22;21;0.0116279069767442;0.488372093023256
Control.SRR15539829;48;45;0.625;18;30;0.125;0.375
Control.SRR15539829;45;45;0.533333333333333;21;24;0.0333333333333333;0.466666666666667
Control.SRR15539829;52;45;0.5;26;26;0;0.5
Control.SRR15539829;46;45;0.456521739130435;25;21;0.0434782608695652;0.456521739130435
Control.SRR15539829;45;45;0.422222222222222;26;19;0.0777777777777778;0.422222222222222
Control.SRR15539829;48;45;0.5;24;24;0;0.5
Control.SRR15539829;48;45;0.458333333333333;26;22;0.0416666666666667;0.458333333333333
Control.SRR15539829;51;45;0.627450980392157;19;32;0.127450980392157;0.372549019607843
Control.SRR15539829;43;45;0.372093023255814;27;16;0.127906976744186;0.372093023255814
Control.SRR15539829;44;45;0.477272727272727;23;21;0.0227272727272727;0.477272727272727
Control.SRR15539829;41;45;0.536585365853659;19;22;0.0365853658536586;0.463414634146341
Control.SRR15539829;41;45;0.536585365853659;19;22;0.0365853658536586;0.463414634146341
Control.SRR15539829;51;45;0.490196078431373;26;25;0.00980392156862747;0.490196078431373
Control.SRR15539829;42;45;0.666666666666667;14;28;0.166666666666667;0.333333333333333
Control.SRR15539829;46;45;0.456521739130435;25;21;0.0434782608695652;0.456521739130435
Control.SRR15539829;42;45;0.547619047619048;19;23;0.0476190476190477;0.452380952380952
Control.SRR15539829;47;45;0.553191489361702;21;26;0.0531914893617021;0.446808510638298
Control.SRR15539829;46;45;0.434782608695652;26;20;0.0652173913043478;0.434782608695652
Control.SRR15539829;51;45;0.470588235294118;27;24;0.0294117647058824;0.470588235294118
Control.SRR15539829;49;45;0.469387755102041;26;23;0.0306122448979592;0.469387755102041
Control.SRR15539829;41;45;0.536585365853659;19;22;0.0365853658536586;0.463414634146341
Control.SRR15539829;43;45;0.674418604651163;14;29;0.174418604651163;0.325581395348837
Control.SRR15539829;42;45;0.547619047619048;19;23;0.0476190476190477;0.452380952380952
Control.SRR15539829;52;45;0.403846153846154;31;21;0.0961538461538461;0.403846153846154
Control.SRR15539829;42;45;0.452380952380952;23;19;0.0476190476190476;0.452380952380952
Control.SRR15539829;50;45;0.5;25;25;0;0.5
Control.SRR15539829;44;45;0.431818181818182;25;19;0.0681818181818182;0.431818181818182
Control.SRR15539829;41;45;0.463414634146341;22;19;0.0365853658536585;0.463414634146341
Control.SRR15539829;51;45;0.549019607843137;23;28;0.0490196078431373;0.450980392156863
Control.SRR15539829;50;45;0.4;30;20;0.1;0.4
Control.SRR15539829;48;45;0.458333333333333;26;22;0.0416666666666667;0.458333333333333
Control.SRR15539829;51;45;0.470588235294118;27;24;0.0294117647058824;0.470588235294118
Control.SRR15539829;51;45;0.490196078431373;26;25;0.00980392156862747;0.490196078431373
Control.SRR15539829;50;45;0.44;28;22;0.06;0.44
Control.SRR15539829;51;45;0.470588235294118;27;24;0.0294117647058824;0.470588235294118
Control.SRR15539829;46;45;0.630434782608696;17;29;0.130434782608696;0.369565217391304
Control.SRR15539829;46;45;0.478260869565217;24;22;0.0217391304347826;0.478260869565217
Control.SRR15539829;43;45;0.511627906976744;21;22;0.0116279069767442;0.488372093023256
Control.SRR15539829;44;45;0.545454545454545;20;24;0.0454545454545454;0.454545454545455
Control.SRR15539829;52;45;0.480769230769231;27;25;0.0192307692307692;0.480769230769231
Control.SRR15539829;52;45;0.403846153846154;31;21;0.0961538461538461;0.403846153846154
Control.SRR15539829;47;45;0.51063829787234;23;24;0.0106382978723404;0.48936170212766
Control.SRR15539829;52;45;0.326923076923077;35;17;0.173076923076923;0.326923076923077
Control.SRR15539829;45;45;0.511111111111111;22;23;0.0111111111111111;0.488888888888889
Control.SRR15539829;52;45;0.461538461538462;28;24;0.0384615384615384;0.461538461538462
Control.SRR15539829;49;45;0.408163265306122;29;20;0.0918367346938775;0.408163265306122
Control.SRR15539829;43;45;0.534883720930233;20;23;0.0348837209302325;0.465116279069767
Control.SRR15539829;47;45;0.595744680851064;19;28;0.0957446808510638;0.404255319148936
Control.SRR15539829;48;45;0.520833333333333;23;25;0.0208333333333334;0.479166666666667
Control.SRR15539829;45;45;0.377777777777778;28;17;0.122222222222222;0.377777777777778
Control.SRR15539829;40;45;0.525;19;21;0.025;0.475
Control.SRR15539829;50;45;0.44;28;22;0.06;0.44
Control.SRR15539829;50;45;0.52;24;26;0.02;0.48
Control.SRR15539829;46;45;0.41304347826087;27;19;0.0869565217391304;0.41304347826087
Control.SRR15539829;47;45;0.595744680851064;19;28;0.0957446808510638;0.404255319148936
Control.SRR15539829;47;45;0.446808510638298;26;21;0.0531914893617021;0.446808510638298
Control.SRR15539829;49;45;0.612244897959184;19;30;0.112244897959184;0.387755102040816
Control.SRR15539829;43;45;0.534883720930233;20;23;0.0348837209302325;0.465116279069767
Control.SRR15539829;50;45;0.48;26;24;0.02;0.48
Control.SRR15539829;50;45;0.48;26;24;0.02;0.48
Control.SRR15539829;52;45;0.5;26;26;0;0.5
Control.SRR15539829;42;45;0.595238095238095;17;25;0.0952380952380952;0.404761904761905
Control.SRR15539829;52;45;0.461538461538462;28;24;0.0384615384615384;0.461538461538462
Control.SRR15539829;51;45;0.549019607843137;23;28;0.0490196078431373;0.450980392156863
Control.SRR15539829;43;45;0.441860465116279;24;19;0.0581395348837209;0.441860465116279
Control.SRR15539829;46;45;0.608695652173913;18;28;0.108695652173913;0.391304347826087
Control.SRR15539829;40;45;0.55;18;22;0.05;0.45
Control.SRR15539829;45;45;0.533333333333333;21;24;0.0333333333333333;0.466666666666667
Control.SRR15539829;44;45;0.409090909090909;26;18;0.0909090909090909;0.409090909090909
Control.SRR15539829;48;45;0.520833333333333;23;25;0.0208333333333334;0.479166666666667
Control.SRR15539829;43;45;0.441860465116279;24;19;0.0581395348837209;0.441860465116279
Control.SRR15539829;52;45;0.557692307692308;23;29;0.0576923076923077;0.442307692307692
Control.SRR15539829;49;45;0.551020408163265;22;27;0.0510204081632653;0.448979591836735
Control.SRR15539829;41;45;0.48780487804878;21;20;0.0121951219512195;0.48780487804878
Control.SRR15539829;49;45;0.510204081632653;24;25;0.0102040816326531;0.489795918367347
Control.SRR15539829;47;45;0.446808510638298;26;21;0.0531914893617021;0.446808510638298
Control.SRR15539829;41;45;0.463414634146341;22;19;0.0365853658536585;0.463414634146341
Control.SRR15539829;47;45;0.382978723404255;29;18;0.117021276595745;0.382978723404255
Control.SRR15539829;51;45;0.588235294117647;21;30;0.0882352941176471;0.411764705882353
Control.SRR15539829;47;45;0.48936170212766;24;23;0.0106382978723404;0.48936170212766
Control.SRR15539829;49;45;0.530612244897959;23;26;0.0306122448979592;0.469387755102041
Control.SRR15539829;49;45;0.530612244897959;23;26;0.0306122448979592;0.469387755102041
Control.SRR15539829;48;45;0.479166666666667;25;23;0.0208333333333333;0.479166666666667
Control.SRR15539829;43;45;0.465116279069767;23;20;0.0348837209302326;0.465116279069767
Control.SRR15539829;43;45;0.465116279069767;23;20;0.0348837209302326;0.465116279069767
Control.SRR15539829;44;45;0.545454545454545;20;24;0.0454545454545454;0.454545454545455
Control.SRR15539829;44;45;0.386363636363636;27;17;0.113636363636364;0.386363636363636
Control.SRR15539829;46;45;0.5;23;23;0;0.5
Control.SRR15539829;46;45;0.478260869565217;24;22;0.0217391304347826;0.478260869565217
Control.SRR15539829;46;45;0.478260869565217;24;22;0.0217391304347826;0.478260869565217
Control.SRR15539829;40;45;0.525;19;21;0.025;0.475
Control.SRR15539829;51;45;0.450980392156863;28;23;0.0490196078431372;0.450980392156863
Control.SRR15539829;49;45;0.510204081632653;24;25;0.0102040816326531;0.489795918367347
Control.SRR15539829;52;45;0.615384615384615;20;32;0.115384615384615;0.384615384615385
Control.SRR15539829;41;45;0.536585365853659;19;22;0.0365853658536586;0.463414634146341
Control.SRR15539829;44;45;0.431818181818182;25;19;0.0681818181818182;0.431818181818182
Control.SRR15539829;45;45;0.422222222222222;26;19;0.0777777777777778;0.422222222222222
Control.SRR15539829;43;45;0.558139534883721;19;24;0.0581395348837209;0.441860465116279
Control.SRR15539829;51;45;0.509803921568627;25;26;0.00980392156862742;0.490196078431373
Control.SRR15539829;43;45;0.395348837209302;26;17;0.104651162790698;0.395348837209302
Control.SRR15539829;48;45;0.479166666666667;25;23;0.0208333333333333;0.479166666666667
Control.SRR15539829;44;45;0.477272727272727;23;21;0.0227272727272727;0.477272727272727
Control.SRR15539829;40;45;0.475;21;19;0.025;0.475
Control.SRR15539829;51;45;0.607843137254902;20;31;0.107843137254902;0.392156862745098
Control.SRR15539829;40;45;0.525;19;21;0.025;0.475
Control.SRR15539829;44;45;0.568181818181818;19;25;0.0681818181818182;0.431818181818182
Control.SRR15539829;40;45;0.425;23;17;0.075;0.425
Control.SRR15539829;40;45;0.4;24;16;0.1;0.4
Control.SRR15539829;40;45;0.6;16;24;0.1;0.4
Control.SRR15539829;44;45;0.431818181818182;25;19;0.0681818181818182;0.431818181818182
Control.SRR15539829;40;45;0.4;24;16;0.1;0.4
Control.SRR15539829;46;45;0.456521739130435;25;21;0.0434782608695652;0.456521739130435
Control.SRR15539829;47;45;0.574468085106383;20;27;0.074468085106383;0.425531914893617
Control.SRR15539829;52;45;0.538461538461538;24;28;0.0384615384615384;0.461538461538462
Control.SRR15539829;42;45;0.428571428571429;24;18;0.0714285714285715;0.428571428571429
Control.SRR15539829;44;45;0.590909090909091;18;26;0.0909090909090909;0.409090909090909
Control.SRR15539829;43;45;0.558139534883721;19;24;0.0581395348837209;0.441860465116279
Control.SRR15539829;49;45;0.469387755102041;26;23;0.0306122448979592;0.469387755102041
Control.SRR15539829;48;45;0.416666666666667;28;20;0.0833333333333333;0.416666666666667
Control.SRR15539829;49;45;0.428571428571429;28;21;0.0714285714285715;0.428571428571429
Control.SRR15539829;44;45;0.477272727272727;23;21;0.0227272727272727;0.477272727272727
Control.SRR15539829;42;45;0.619047619047619;16;26;0.119047619047619;0.380952380952381
Control.SRR15539829;50;45;0.46;27;23;0.04;0.46
Control.SRR15539829;49;45;0.489795918367347;25;24;0.0102040816326531;0.489795918367347
Control.SRR15539829;46;45;0.434782608695652;26;20;0.0652173913043478;0.434782608695652
Control.SRR15539829;43;45;0.581395348837209;18;25;0.0813953488372093;0.418604651162791
Control.SRR15539829;47;45;0.446808510638298;26;21;0.0531914893617021;0.446808510638298
Control.SRR15539829;41;45;0.560975609756098;18;23;0.0609756097560976;0.439024390243902
Control.SRR15539829;44;45;0.454545454545455;24;20;0.0454545454545455;0.454545454545455
Control.SRR15539829;41;45;0.341463414634146;27;14;0.158536585365854;0.341463414634146
Control.SRR15539829;44;45;0.590909090909091;18;26;0.0909090909090909;0.409090909090909
Control.SRR15539829;41;45;0.463414634146341;22;19;0.0365853658536585;0.463414634146341
Control.SRR15539829;45;45;0.622222222222222;17;28;0.122222222222222;0.377777777777778
Control.SRR15539829;49;45;0.387755102040816;30;19;0.112244897959184;0.387755102040816
Control.SRR15539829;45;45;0.4;27;18;0.1;0.4
Control.SRR15539829;42;45;0.285714285714286;30;12;0.214285714285714;0.285714285714286
Control.SRR15539829;50;45;0.44;28;22;0.06;0.44
Control.SRR15539829;47;45;0.531914893617021;22;25;0.0319148936170213;0.468085106382979
Control.SRR15539829;52;45;0.538461538461538;24;28;0.0384615384615384;0.461538461538462
Control.SRR15539829;41;45;0.51219512195122;20;21;0.0121951219512195;0.48780487804878
Control.SRR15539829;50;45;0.64;18;32;0.14;0.36
Control.SRR15539829;51;45;0.588235294117647;21;30;0.0882352941176471;0.411764705882353
Control.SRR15539829;42;45;0.571428571428571;18;24;0.0714285714285714;0.428571428571429
Control.SRR15539829;44;45;0.590909090909091;18;26;0.0909090909090909;0.409090909090909
Control.SRR15539829;44;45;0.522727272727273;21;23;0.0227272727272727;0.477272727272727
Control.SRR15539829;40;45;0.5;20;20;0;0.5
Control.SRR15539829;47;45;0.446808510638298;26;21;0.0531914893617021;0.446808510638298
Control.SRR15539829;49;45;0.551020408163265;22;27;0.0510204081632653;0.448979591836735
Control.SRR15539829;43;45;0.395348837209302;26;17;0.104651162790698;0.395348837209302
Control.SRR15539829;43;45;0.465116279069767;23;20;0.0348837209302326;0.465116279069767
Control.SRR15539829;44;45;0.568181818181818;19;25;0.0681818181818182;0.431818181818182
Control.SRR15539829;43;45;0.465116279069767;23;20;0.0348837209302326;0.465116279069767
Control.SRR15539829;49;45;0.387755102040816;30;19;0.112244897959184;0.387755102040816
Control.SRR15539829;46;45;0.434782608695652;26;20;0.0652173913043478;0.434782608695652
Control.SRR15539829;50;45;0.5;25;25;0;0.5
Control.SRR15539829;42;45;0.523809523809524;20;22;0.0238095238095238;0.476190476190476
Control.SRR15539829;51;45;0.411764705882353;30;21;0.0882352941176471;0.411764705882353
Control.SRR15539829;46;45;0.565217391304348;20;26;0.0652173913043478;0.434782608695652
Control.SRR15539829;45;45;0.355555555555556;29;16;0.144444444444444;0.355555555555556
Control.SRR15539829;40;45;0.4;24;16;0.1;0.4
Control.SRR15539829;51;45;0.470588235294118;27;24;0.0294117647058824;0.470588235294118
Control.SRR15539829;49;45;0.448979591836735;27;22;0.0510204081632653;0.448979591836735
Control.SRR15539829;47;45;0.531914893617021;22;25;0.0319148936170213;0.468085106382979
Control.SRR15539829;50;45;0.46;27;23;0.04;0.46
Control.SRR15539829;43;45;0.465116279069767;23;20;0.0348837209302326;0.465116279069767
Control.SRR15539829;51;45;0.470588235294118;27;24;0.0294117647058824;0.470588235294118
Control.SRR15539829;42;45;0.523809523809524;20;22;0.0238095238095238;0.476190476190476
Control.SRR15539829;44;45;0.386363636363636;27;17;0.113636363636364;0.386363636363636
Control.SRR15539829;45;45;0.444444444444444;25;20;0.0555555555555556;0.444444444444444
Control.SRR15539829;40;45;0.575;17;23;0.075;0.425
Control.SRR15539829;41;45;0.463414634146341;22;19;0.0365853658536585;0.463414634146341
Control.SRR15539829;51;45;0.431372549019608;29;22;0.0686274509803921;0.431372549019608
Control.SRR15539829;50;45;0.5;25;25;0;0.5
Control.SRR15539829;44;45;0.477272727272727;23;21;0.0227272727272727;0.477272727272727
Control.SRR15539829;40;45;0.35;26;14;0.15;0.35
Control.SRR15539829;40;45;0.5;20;20;0;0.5
Control.SRR15539829;45;45;0.511111111111111;22;23;0.0111111111111111;0.488888888888889
Control.SRR15539829;45;45;0.6;18;27;0.1;0.4
Control.SRR15539829;40;45;0.525;19;21;0.025;0.475
Control.SRR15539829;50;45;0.4;30;20;0.1;0.4
Control.SRR15539829;43;45;0.465116279069767;23;20;0.0348837209302326;0.465116279069767
Control.SRR15539829;40;45;0.55;18;22;0.05;0.45
Control.SRR15539829;48;45;0.645833333333333;17;31;0.145833333333333;0.354166666666667
Control.SRR15539829;47;45;0.48936170212766;24;23;0.0106382978723404;0.48936170212766
Control.SRR15539829;47;45;0.51063829787234;23;24;0.0106382978723404;0.48936170212766
Control.SRR15539829;52;45;0.576923076923077;22;30;0.0769230769230769;0.423076923076923
Control.SRR15539829;46;45;0.608695652173913;18;28;0.108695652173913;0.391304347826087
Control.SRR15539829;49;45;0.551020408163265;22;27;0.0510204081632653;0.448979591836735
Control.SRR15539829;46;45;0.41304347826087;27;19;0.0869565217391304;0.41304347826087
Control.SRR15539829;44;45;0.454545454545455;24;20;0.0454545454545455;0.454545454545455
Control.SRR15539829;43;45;0.604651162790698;17;26;0.104651162790698;0.395348837209302
Control.SRR15539829;44;45;0.613636363636364;17;27;0.113636363636364;0.386363636363636
Control.SRR15539829;51;45;0.529411764705882;24;27;0.0294117647058824;0.470588235294118
Control.SRR15539829;40;45;0.525;19;21;0.025;0.475
Control.SRR15539829;40;45;0.525;19;21;0.025;0.475
Control.SRR15539829;45;45;0.488888888888889;23;22;0.0111111111111111;0.488888888888889
Control.SRR15539829;47;45;0.48936170212766;24;23;0.0106382978723404;0.48936170212766
Control.SRR15539829;45;45;0.488888888888889;23;22;0.0111111111111111;0.488888888888889
Control.SRR15539829;40;45;0.425;23;17;0.075;0.425
Control.SRR15539829;43;45;0.627906976744186;16;27;0.127906976744186;0.372093023255814
Control.SRR15539829;45;45;0.555555555555556;20;25;0.0555555555555556;0.444444444444444
Control.SRR15539829;40;45;0.65;14;26;0.15;0.35
Control.SRR15539829;46;45;0.543478260869565;21;25;0.0434782608695652;0.456521739130435
Control.SRR15539829;43;45;0.418604651162791;25;18;0.0813953488372093;0.418604651162791
Control.SRR15539829;51;45;0.411764705882353;30;21;0.0882352941176471;0.411764705882353
Control.SRR15539829;50;45;0.5;25;25;0;0.5
Control.SRR15539829;52;45;0.480769230769231;27;25;0.0192307692307692;0.480769230769231
Control.SRR15539829;48;45;0.458333333333333;26;22;0.0416666666666667;0.458333333333333
Control.SRR15539829;52;45;0.576923076923077;22;30;0.0769230769230769;0.423076923076923
Control.SRR15539829;42;45;0.595238095238095;17;25;0.0952380952380952;0.404761904761905
Control.SRR15539829;43;45;0.372093023255814;27;16;0.127906976744186;0.372093023255814
Control.SRR15539829;40;45;0.65;14;26;0.15;0.35
Control.SRR15539829;47;45;0.51063829787234;23;24;0.0106382978723404;0.48936170212766
Control.SRR15539829;42;45;0.476190476190476;22;20;0.0238095238095238;0.476190476190476
Control.SRR15539829;47;45;0.659574468085106;16;31;0.159574468085106;0.340425531914894
Control.SRR15539829;47;45;0.404255319148936;28;19;0.0957446808510639;0.404255319148936
Control.SRR15539829;44;45;0.522727272727273;21;23;0.0227272727272727;0.477272727272727
Control.SRR15539829;43;45;0.488372093023256;22;21;0.0116279069767442;0.488372093023256
Control.SRR15539829;46;45;0.58695652173913;19;27;0.0869565217391305;0.41304347826087
Control.SRR15539829;43;45;0.511627906976744;21;22;0.0116279069767442;0.488372093023256
Control.SRR15539829;45;45;0.444444444444444;25;20;0.0555555555555556;0.444444444444444
Control.SRR15539829;47;45;0.553191489361702;21;26;0.0531914893617021;0.446808510638298
Control.SRR15539829;41;45;0.48780487804878;21;20;0.0121951219512195;0.48780487804878
Control.SRR15539829;46;45;0.543478260869565;21;25;0.0434782608695652;0.456521739130435
Control.SRR15539829;46;45;0.456521739130435;25;21;0.0434782608695652;0.456521739130435
Control.SRR15539829;51;45;0.490196078431373;26;25;0.00980392156862747;0.490196078431373
Control.SRR15539829;48;45;0.583333333333333;20;28;0.0833333333333334;0.416666666666667
Control.SRR15539829;47;45;0.574468085106383;20;27;0.074468085106383;0.425531914893617
Control.SRR15539829;43;45;0.465116279069767;23;20;0.0348837209302326;0.465116279069767
Control.SRR15539829;45;45;0.355555555555556;29;16;0.144444444444444;0.355555555555556
Control.SRR15539829;40;45;0.375;25;15;0.125;0.375
Control.SRR15539829;41;45;0.341463414634146;27;14;0.158536585365854;0.341463414634146
Control.SRR15539829;50;45;0.4;30;20;0.1;0.4
Control.SRR15539829;47;45;0.553191489361702;21;26;0.0531914893617021;0.446808510638298
Control.SRR15539829;41;45;0.585365853658537;17;24;0.0853658536585366;0.414634146341463
Control.SRR15539829;51;45;0.568627450980392;22;29;0.0686274509803921;0.431372549019608
Control.SRR15539829;40;45;0.525;19;21;0.025;0.475
Control.SRR15539829;48;45;0.604166666666667;19;29;0.104166666666667;0.395833333333333
Control.SRR15539829;45;45;0.533333333333333;21;24;0.0333333333333333;0.466666666666667
Control.SRR15539829;48;45;0.520833333333333;23;25;0.0208333333333334;0.479166666666667
Control.SRR15539829;41;45;0.51219512195122;20;21;0.0121951219512195;0.48780487804878
Control.SRR15539829;42;45;0.547619047619048;19;23;0.0476190476190477;0.452380952380952
Control.SRR15539829;41;45;0.463414634146341;22;19;0.0365853658536585;0.463414634146341
Control.SRR15539829;41;45;0.439024390243902;23;18;0.0609756097560976;0.439024390243902
Control.SRR15539829;48;45;0.541666666666667;22;26;0.0416666666666666;0.458333333333333
Control.SRR15539829;47;45;0.574468085106383;20;27;0.074468085106383;0.425531914893617
Control.SRR15539829;50;45;0.5;25;25;0;0.5
Control.SRR15539829;41;45;0.560975609756098;18;23;0.0609756097560976;0.439024390243902
Control.SRR15539829;51;45;0.470588235294118;27;24;0.0294117647058824;0.470588235294118
Control.SRR15539829;47;45;0.446808510638298;26;21;0.0531914893617021;0.446808510638298
Control.SRR15539829;49;45;0.469387755102041;26;23;0.0306122448979592;0.469387755102041
Control.SRR15539829;48;45;0.541666666666667;22;26;0.0416666666666666;0.458333333333333
Control.SRR15539829;44;45;0.431818181818182;25;19;0.0681818181818182;0.431818181818182
Control.SRR15539829;43;45;0.488372093023256;22;21;0.0116279069767442;0.488372093023256
Control.SRR15539829;50;45;0.52;24;26;0.02;0.48
Control.SRR15539829;41;45;0.439024390243902;23;18;0.0609756097560976;0.439024390243902
Control.SRR15539829;44;45;0.386363636363636;27;17;0.113636363636364;0.386363636363636
Control.SRR15539829;43;45;0.441860465116279;24;19;0.0581395348837209;0.441860465116279
Control.SRR15539829;51;45;0.470588235294118;27;24;0.0294117647058824;0.470588235294118
Control.SRR15539829;51;45;0.549019607843137;23;28;0.0490196078431373;0.450980392156863
Control.SRR15539829;51;45;0.509803921568627;25;26;0.00980392156862742;0.490196078431373
Control.SRR15539829;52;45;0.461538461538462;28;24;0.0384615384615384;0.461538461538462
Control.SRR15539829;48;45;0.479166666666667;25;23;0.0208333333333333;0.479166666666667
Control.SRR15539829;51;45;0.411764705882353;30;21;0.0882352941176471;0.411764705882353
Control.SRR15539829;42;45;0.452380952380952;23;19;0.0476190476190476;0.452380952380952
Control.SRR15539829;40;45;0.5;20;20;0;0.5
Control.SRR15539829;41;45;0.560975609756098;18;23;0.0609756097560976;0.439024390243902
Control.SRR15539829;40;45;0.625;15;25;0.125;0.375
Control.SRR15539829;45;45;0.555555555555556;20;25;0.0555555555555556;0.444444444444444
Control.SRR15539829;50;45;0.44;28;22;0.06;0.44
Control.SRR15539829;44;45;0.613636363636364;17;27;0.113636363636364;0.386363636363636
Control.SRR15539829;43;45;0.697674418604651;13;30;0.197674418604651;0.302325581395349
Control.SRR15539829;44;45;0.5;22;22;0;0.5
Control.SRR15539829;51;45;0.450980392156863;28;23;0.0490196078431372;0.450980392156863
Control.SRR15539829;43;45;0.534883720930233;20;23;0.0348837209302325;0.465116279069767
Control.SRR15539829;51;45;0.549019607843137;23;28;0.0490196078431373;0.450980392156863
Control.SRR15539829;50;45;0.42;29;21;0.08;0.42
Control.SRR15539829;42;45;0.452380952380952;23;19;0.0476190476190476;0.452380952380952
Control.SRR15539829;47;45;0.425531914893617;27;20;0.074468085106383;0.425531914893617
Control.SRR15539829;50;45;0.58;21;29;0.08;0.42
Control.SRR15539829;48;45;0.520833333333333;23;25;0.0208333333333334;0.479166666666667
Control.SRR15539829;43;45;0.627906976744186;16;27;0.127906976744186;0.372093023255814
Control.SRR15539829;49;45;0.428571428571429;28;21;0.0714285714285715;0.428571428571429
Control.SRR15539829;50;45;0.5;25;25;0;0.5
Control.SRR15539829;43;45;0.372093023255814;27;16;0.127906976744186;0.372093023255814
Control.SRR15539829;50;45;0.52;24;26;0.02;0.48
Control.SRR15539829;48;45;0.416666666666667;28;20;0.0833333333333333;0.416666666666667
Control.SRR15539829;43;45;0.465116279069767;23;20;0.0348837209302326;0.465116279069767
Control.SRR15539829;44;45;0.477272727272727;23;21;0.0227272727272727;0.477272727272727
Control.SRR15539829;45;45;0.488888888888889;23;22;0.0111111111111111;0.488888888888889
Control.SRR15539829;42;45;0.452380952380952;23;19;0.0476190476190476;0.452380952380952
Control.SRR15539829;42;45;0.761904761904762;10;32;0.261904761904762;0.238095238095238
Control.SRR15539829;47;45;0.446808510638298;26;21;0.0531914893617021;0.446808510638298
Control.SRR15539829;41;45;0.341463414634146;27;14;0.158536585365854;0.341463414634146
Control.SRR15539829;50;45;0.44;28;22;0.06;0.44
Control.SRR15539829;47;45;0.574468085106383;20;27;0.074468085106383;0.425531914893617
Control.SRR15539829;43;45;0.581395348837209;18;25;0.0813953488372093;0.418604651162791
Control.SRR15539829;43;45;0.325581395348837;29;14;0.174418604651163;0.325581395348837
Control.SRR15539829;48;45;0.479166666666667;25;23;0.0208333333333333;0.479166666666667
Control.SRR15539829;52;45;0.596153846153846;21;31;0.0961538461538461;0.403846153846154
Control.SRR15539829;45;45;0.488888888888889;23;22;0.0111111111111111;0.488888888888889
Control.SRR15539829;41;45;0.439024390243902;23;18;0.0609756097560976;0.439024390243902
Control.SRR15539829;42;45;0.428571428571429;24;18;0.0714285714285715;0.428571428571429
Control.SRR15539829;44;45;0.5;22;22;0;0.5
Control.SRR15539829;43;45;0.418604651162791;25;18;0.0813953488372093;0.418604651162791
Control.SRR15539829;44;45;0.318181818181818;30;14;0.181818181818182;0.318181818181818
Control.SRR15539829;46;45;0.434782608695652;26;20;0.0652173913043478;0.434782608695652
Control.SRR15539829;43;45;0.441860465116279;24;19;0.0581395348837209;0.441860465116279
Control.SRR15539829;47;45;0.382978723404255;29;18;0.117021276595745;0.382978723404255
Control.SRR15539829;48;45;0.5625;21;27;0.0625;0.4375
Control.SRR15539829;43;45;0.558139534883721;19;24;0.0581395348837209;0.441860465116279
Control.SRR15539829;46;45;0.41304347826087;27;19;0.0869565217391304;0.41304347826087
Control.SRR15539829;45;45;0.466666666666667;24;21;0.0333333333333333;0.466666666666667
Control.SRR15539829;51;45;0.529411764705882;24;27;0.0294117647058824;0.470588235294118
Control.SRR15539829;50;45;0.6;20;30;0.1;0.4
Control.SRR15539829;51;45;0.509803921568627;25;26;0.00980392156862742;0.490196078431373
Control.SRR15539829;48;45;0.520833333333333;23;25;0.0208333333333334;0.479166666666667
Control.SRR15539829;48;45;0.395833333333333;29;19;0.104166666666667;0.395833333333333
Control.SRR15539829;49;45;0.408163265306122;29;20;0.0918367346938775;0.408163265306122
Control.SRR15539829;45;45;0.355555555555556;29;16;0.144444444444444;0.355555555555556
Control.SRR15539829;48;45;0.458333333333333;26;22;0.0416666666666667;0.458333333333333
Control.SRR15539829;43;45;0.558139534883721;19;24;0.0581395348837209;0.441860465116279
Control.SRR15539829;43;45;0.558139534883721;19;24;0.0581395348837209;0.441860465116279
Control.SRR15539829;45;45;0.422222222222222;26;19;0.0777777777777778;0.422222222222222
Control.SRR15539829;43;45;0.604651162790698;17;26;0.104651162790698;0.395348837209302
Control.SRR15539829;44;45;0.386363636363636;27;17;0.113636363636364;0.386363636363636
Control.SRR15539829;45;45;0.466666666666667;24;21;0.0333333333333333;0.466666666666667
Control.SRR15539829;48;45;0.5;24;24;0;0.5
Control.SRR15539829;40;45;0.5;20;20;0;0.5
Control.SRR15539829;44;45;0.522727272727273;21;23;0.0227272727272727;0.477272727272727
Control.SRR15539829;49;45;0.530612244897959;23;26;0.0306122448979592;0.469387755102041
Control.SRR15539829;47;45;0.595744680851064;19;28;0.0957446808510638;0.404255319148936
Control.SRR15539829;41;45;0.585365853658537;17;24;0.0853658536585366;0.414634146341463
Control.SRR15539829;45;45;0.444444444444444;25;20;0.0555555555555556;0.444444444444444
Control.SRR15539829;46;45;0.608695652173913;18;28;0.108695652173913;0.391304347826087
Control.SRR15539829;47;45;0.553191489361702;21;26;0.0531914893617021;0.446808510638298
Control.SRR15539829;45;45;0.422222222222222;26;19;0.0777777777777778;0.422222222222222
Control.SRR15539829;49;45;0.551020408163265;22;27;0.0510204081632653;0.448979591836735
Control.SRR15539829;51;45;0.627450980392157;19;32;0.127450980392157;0.372549019607843
Control.SRR15539829;42;45;0.476190476190476;22;20;0.0238095238095238;0.476190476190476
Control.SRR15539829;43;45;0.488372093023256;22;21;0.0116279069767442;0.488372093023256
Control.SRR15539829;50;45;0.46;27;23;0.04;0.46
Control.SRR15539829;43;45;0.395348837209302;26;17;0.104651162790698;0.395348837209302
Control.SRR15539829;43;45;0.465116279069767;23;20;0.0348837209302326;0.465116279069767
Control.SRR15539829;47;45;0.446808510638298;26;21;0.0531914893617021;0.446808510638298
Control.SRR15539829;42;45;0.571428571428571;18;24;0.0714285714285714;0.428571428571429
Control.SRR15539829;43;45;0.372093023255814;27;16;0.127906976744186;0.372093023255814
Control.SRR15539829;40;45;0.4;24;16;0.1;0.4
Control.SRR15539829;48;45;0.520833333333333;23;25;0.0208333333333334;0.479166666666667
Control.SRR15539829;52;45;0.538461538461538;24;28;0.0384615384615384;0.461538461538462
Control.SRR15539829;45;45;0.355555555555556;29;16;0.144444444444444;0.355555555555556
Control.SRR15539829;48;45;0.479166666666667;25;23;0.0208333333333333;0.479166666666667
Control.SRR15539829;46;45;0.478260869565217;24;22;0.0217391304347826;0.478260869565217
Control.SRR15539829;44;45;0.5;22;22;0;0.5
Control.SRR15539829;51;45;0.490196078431373;26;25;0.00980392156862747;0.490196078431373
Control.SRR15539829;46;45;0.456521739130435;25;21;0.0434782608695652;0.456521739130435
Control.SRR15539829;40;45;0.475;21;19;0.025;0.475
Control.SRR15539829;48;45;0.583333333333333;20;28;0.0833333333333334;0.416666666666667
Control.SRR15539829;45;45;0.466666666666667;24;21;0.0333333333333333;0.466666666666667
Control.SRR15539829;50;45;0.36;32;18;0.14;0.36
Control.SRR15539829;48;45;0.520833333333333;23;25;0.0208333333333334;0.479166666666667
Control.SRR15539829;42;45;0.476190476190476;22;20;0.0238095238095238;0.476190476190476
Control.SRR15539829;41;45;0.463414634146341;22;19;0.0365853658536585;0.463414634146341
Control.SRR15539829;47;45;0.468085106382979;25;22;0.0319148936170213;0.468085106382979
Control.SRR15539829;51;45;0.470588235294118;27;24;0.0294117647058824;0.470588235294118
Control.SRR15539829;43;45;0.465116279069767;23;20;0.0348837209302326;0.465116279069767
Control.SRR15539829;42;45;0.380952380952381;26;16;0.119047619047619;0.380952380952381
Control.SRR15539829;48;45;0.333333333333333;32;16;0.166666666666667;0.333333333333333
Control.SRR15539829;47;45;0.531914893617021;22;25;0.0319148936170213;0.468085106382979
Control.SRR15539829;49;45;0.448979591836735;27;22;0.0510204081632653;0.448979591836735
Control.SRR15539829;51;45;0.588235294117647;21;30;0.0882352941176471;0.411764705882353
Control.SRR15539829;41;45;0.634146341463415;15;26;0.134146341463415;0.365853658536585
Control.SRR15539829;50;45;0.5;25;25;0;0.5
Control.SRR15539829;50;45;0.54;23;27;0.04;0.46
Control.SRR15539829;49;45;0.489795918367347;25;24;0.0102040816326531;0.489795918367347
Control.SRR15539829;45;45;0.466666666666667;24;21;0.0333333333333333;0.466666666666667
Control.SRR15539829;41;45;0.536585365853659;19;22;0.0365853658536586;0.463414634146341
Control.SRR15539829;42;45;0.523809523809524;20;22;0.0238095238095238;0.476190476190476
Control.SRR15539829;45;45;0.422222222222222;26;19;0.0777777777777778;0.422222222222222
Control.SRR15539829;48;45;0.4375;27;21;0.0625;0.4375
Control.SRR15539829;46;45;0.630434782608696;17;29;0.130434782608696;0.369565217391304
Control.SRR15539829;50;45;0.44;28;22;0.06;0.44
Control.SRR15539829;46;45;0.369565217391304;29;17;0.130434782608696;0.369565217391304
Control.SRR15539829;47;45;0.531914893617021;22;25;0.0319148936170213;0.468085106382979
Control.SRR15539829;46;45;0.630434782608696;17;29;0.130434782608696;0.369565217391304
Control.SRR15539829;45;45;0.555555555555556;20;25;0.0555555555555556;0.444444444444444
Control.SRR15539829;42;45;0.5;21;21;0;0.5
Control.SRR15539829;49;45;0.387755102040816;30;19;0.112244897959184;0.387755102040816
Control.SRR15539829;47;45;0.553191489361702;21;26;0.0531914893617021;0.446808510638298
Control.SRR15539829;50;45;0.58;21;29;0.08;0.42
Control.SRR15539829;48;45;0.395833333333333;29;19;0.104166666666667;0.395833333333333
Control.SRR15539829;46;45;0.58695652173913;19;27;0.0869565217391305;0.41304347826087
Control.SRR15539829;49;45;0.530612244897959;23;26;0.0306122448979592;0.469387755102041
Control.SRR15539829;47;45;0.468085106382979;25;22;0.0319148936170213;0.468085106382979
Control.SRR15539829;48;45;0.5625;21;27;0.0625;0.4375
Control.SRR15539829;43;45;0.534883720930233;20;23;0.0348837209302325;0.465116279069767
Control.SRR15539829;51;45;0.509803921568627;25;26;0.00980392156862742;0.490196078431373
Control.SRR15539829;48;45;0.583333333333333;20;28;0.0833333333333334;0.416666666666667
Control.SRR15539829;45;45;0.555555555555556;20;25;0.0555555555555556;0.444444444444444
Control.SRR15539829;41;45;0.439024390243902;23;18;0.0609756097560976;0.439024390243902
Control.SRR15539829;43;45;0.534883720930233;20;23;0.0348837209302325;0.465116279069767
Control.SRR15539829;43;45;0.604651162790698;17;26;0.104651162790698;0.395348837209302
Control.SRR15539829;48;45;0.479166666666667;25;23;0.0208333333333333;0.479166666666667
Control.SRR15539829;48;45;0.520833333333333;23;25;0.0208333333333334;0.479166666666667
Control.SRR15539829;47;45;0.574468085106383;20;27;0.074468085106383;0.425531914893617
Control.SRR15539829;40;45;0.375;25;15;0.125;0.375
Control.SRR15539829;43;45;0.534883720930233;20;23;0.0348837209302325;0.465116279069767
Control.SRR15539829;50;45;0.5;25;25;0;0.5
Control.SRR15539829;46;45;0.521739130434783;22;24;0.0217391304347826;0.478260869565217
Control.SRR15539829;44;45;0.477272727272727;23;21;0.0227272727272727;0.477272727272727
Control.SRR15539829;49;45;0.489795918367347;25;24;0.0102040816326531;0.489795918367347
Control.SRR15539829;50;45;0.58;21;29;0.08;0.42
Control.SRR15539829;51;45;0.568627450980392;22;29;0.0686274509803921;0.431372549019608
Control.SRR15539829;52;45;0.365384615384615;33;19;0.134615384615385;0.365384615384615
Control.SRR15539829;43;45;0.534883720930233;20;23;0.0348837209302325;0.465116279069767
Control.SRR15539829;44;45;0.454545454545455;24;20;0.0454545454545455;0.454545454545455
Control.SRR15539829;43;45;0.534883720930233;20;23;0.0348837209302325;0.465116279069767
Control.SRR15539829;42;45;0.380952380952381;26;16;0.119047619047619;0.380952380952381
Control.SRR15539829;45;45;0.622222222222222;17;28;0.122222222222222;0.377777777777778
Control.SRR15539829;43;45;0.488372093023256;22;21;0.0116279069767442;0.488372093023256
Control.SRR15539829;51;45;0.450980392156863;28;23;0.0490196078431372;0.450980392156863
Control.SRR15539829;50;45;0.52;24;26;0.02;0.48
Control.SRR15539829;48;45;0.4375;27;21;0.0625;0.4375
Control.SRR15539829;42;45;0.595238095238095;17;25;0.0952380952380952;0.404761904761905
Control.SRR15539829;44;45;0.477272727272727;23;21;0.0227272727272727;0.477272727272727
Control.SRR15539829;49;45;0.489795918367347;25;24;0.0102040816326531;0.489795918367347
Control.SRR15539829;40;45;0.625;15;25;0.125;0.375
Control.SRR15539829;46;45;0.391304347826087;28;18;0.108695652173913;0.391304347826087
Control.SRR15539829;52;45;0.5;26;26;0;0.5
Control.SRR15539829;45;45;0.555555555555556;20;25;0.0555555555555556;0.444444444444444
Control.SRR15539829;40;45;0.45;22;18;0.05;0.45
Control.SRR15539829;40;45;0.575;17;23;0.075;0.425
Control.SRR15539829;50;45;0.54;23;27;0.04;0.46
Control.SRR15539829;46;45;0.391304347826087;28;18;0.108695652173913;0.391304347826087
Control.SRR15539829;45;45;0.555555555555556;20;25;0.0555555555555556;0.444444444444444
Control.SRR15539829;47;45;0.51063829787234;23;24;0.0106382978723404;0.48936170212766
Control.SRR15539829;48;45;0.5625;21;27;0.0625;0.4375
Control.SRR15539829;48;45;0.4375;27;21;0.0625;0.4375
Control.SRR15539829;48;45;0.583333333333333;20;28;0.0833333333333334;0.416666666666667
Control.SRR15539829;46;45;0.58695652173913;19;27;0.0869565217391305;0.41304347826087
Control.SRR15539829;42;45;0.547619047619048;19;23;0.0476190476190477;0.452380952380952
Control.SRR15539829;40;45;0.625;15;25;0.125;0.375
Control.SRR15539829;42;45;0.714285714285714;12;30;0.214285714285714;0.285714285714286
Control.SRR15539829;42;45;0.595238095238095;17;25;0.0952380952380952;0.404761904761905
Control.SRR15539829;46;45;0.391304347826087;28;18;0.108695652173913;0.391304347826087
Control.SRR15539829;41;45;0.365853658536585;26;15;0.134146341463415;0.365853658536585
Control.SRR15539829;45;45;0.444444444444444;25;20;0.0555555555555556;0.444444444444444
Control.SRR15539829;41;45;0.609756097560976;16;25;0.109756097560976;0.390243902439024
Control.SRR15539829;47;45;0.574468085106383;20;27;0.074468085106383;0.425531914893617
Control.SRR15539829;49;45;0.510204081632653;24;25;0.0102040816326531;0.489795918367347
Control.SRR15539829;50;45;0.52;24;26;0.02;0.48
Control.SRR15539829;43;45;0.441860465116279;24;19;0.0581395348837209;0.441860465116279
Control.SRR15539829;48;45;0.583333333333333;20;28;0.0833333333333334;0.416666666666667
Control.SRR15539829;42;45;0.476190476190476;22;20;0.0238095238095238;0.476190476190476
Control.SRR15539829;41;45;0.585365853658537;17;24;0.0853658536585366;0.414634146341463
Control.SRR15539829;52;45;0.673076923076923;17;35;0.173076923076923;0.326923076923077
Control.SRR15539829;46;45;0.369565217391304;29;17;0.130434782608696;0.369565217391304
Control.SRR15539829;47;45;0.531914893617021;22;25;0.0319148936170213;0.468085106382979
Control.SRR15539829;43;45;0.418604651162791;25;18;0.0813953488372093;0.418604651162791
Control.SRR15539829;41;45;0.439024390243902;23;18;0.0609756097560976;0.439024390243902
Control.SRR15539829;45;45;0.444444444444444;25;20;0.0555555555555556;0.444444444444444
Control.SRR15539829;44;45;0.522727272727273;21;23;0.0227272727272727;0.477272727272727
Control.SRR15539829;46;45;0.369565217391304;29;17;0.130434782608696;0.369565217391304
Control.SRR15539829;44;45;0.522727272727273;21;23;0.0227272727272727;0.477272727272727
Control.SRR15539829;41;45;0.439024390243902;23;18;0.0609756097560976;0.439024390243902
Control.SRR15539829;44;45;0.454545454545455;24;20;0.0454545454545455;0.454545454545455
Control.SRR15539829;43;45;0.511627906976744;21;22;0.0116279069767442;0.488372093023256
Control.SRR15539829;43;45;0.511627906976744;21;22;0.0116279069767442;0.488372093023256
Control.SRR15539829;43;45;0.651162790697674;15;28;0.151162790697674;0.348837209302326
Control.SRR15539829;44;45;0.477272727272727;23;21;0.0227272727272727;0.477272727272727
Control.SRR15539829;52;45;0.442307692307692;29;23;0.0576923076923077;0.442307692307692
Control.SRR15539829;46;45;0.565217391304348;20;26;0.0652173913043478;0.434782608695652
Control.SRR15539829;46;45;0.608695652173913;18;28;0.108695652173913;0.391304347826087
Control.SRR15539829;45;45;0.377777777777778;28;17;0.122222222222222;0.377777777777778
Control.SRR15539829;46;45;0.41304347826087;27;19;0.0869565217391304;0.41304347826087
Control.SRR15539829;43;45;0.511627906976744;21;22;0.0116279069767442;0.488372093023256
Control.SRR15539829;44;45;0.522727272727273;21;23;0.0227272727272727;0.477272727272727
Control.SRR15539829;47;45;0.382978723404255;29;18;0.117021276595745;0.382978723404255
Control.SRR15539829;41;45;0.536585365853659;19;22;0.0365853658536586;0.463414634146341
Control.SRR15539829;40;45;0.525;19;21;0.025;0.475
Control.SRR15539829;40;45;0.5;20;20;0;0.5
Control.SRR15539829;41;45;0.51219512195122;20;21;0.0121951219512195;0.48780487804878
Control.SRR15539829;51;45;0.509803921568627;25;26;0.00980392156862742;0.490196078431373
Control.SRR15539829;49;45;0.510204081632653;24;25;0.0102040816326531;0.489795918367347
Control.SRR15539829;44;45;0.454545454545455;24;20;0.0454545454545455;0.454545454545455
Control.SRR15539829;51;45;0.431372549019608;29;22;0.0686274509803921;0.431372549019608
Control.SRR15539829;47;45;0.48936170212766;24;23;0.0106382978723404;0.48936170212766
Control.SRR15539829;47;45;0.574468085106383;20;27;0.074468085106383;0.425531914893617
Control.SRR15539829;43;45;0.558139534883721;19;24;0.0581395348837209;0.441860465116279
Control.SRR15539829;44;45;0.454545454545455;24;20;0.0454545454545455;0.454545454545455
Control.SRR15539829;41;45;0.731707317073171;11;30;0.231707317073171;0.268292682926829
Control.SRR15539829;43;45;0.604651162790698;17;26;0.104651162790698;0.395348837209302
Control.SRR15539829;48;45;0.458333333333333;26;22;0.0416666666666667;0.458333333333333
Control.SRR15539829;41;45;0.634146341463415;15;26;0.134146341463415;0.365853658536585
Control.SRR15539829;44;45;0.545454545454545;20;24;0.0454545454545454;0.454545454545455
Control.SRR15539829;40;45;0.5;20;20;0;0.5
Control.SRR15539829;41;45;0.48780487804878;21;20;0.0121951219512195;0.48780487804878
Control.SRR15539829;51;45;0.392156862745098;31;20;0.107843137254902;0.392156862745098
Control.SRR15539829;41;45;0.51219512195122;20;21;0.0121951219512195;0.48780487804878
Control.SRR15539829;47;45;0.574468085106383;20;27;0.074468085106383;0.425531914893617
Control.SRR15539829;52;45;0.423076923076923;30;22;0.0769230769230769;0.423076923076923
Control.SRR15539829;52;45;0.384615384615385;32;20;0.115384615384615;0.384615384615385
Control.SRR15539829;40;45;0.6;16;24;0.1;0.4
Control.SRR15539829;41;45;0.365853658536585;26;15;0.134146341463415;0.365853658536585
Control.SRR15539829;50;45;0.42;29;21;0.08;0.42
Control.SRR15539829;50;45;0.64;18;32;0.14;0.36
Control.SRR15539829;45;45;0.355555555555556;29;16;0.144444444444444;0.355555555555556
Control.SRR15539829;42;45;0.476190476190476;22;20;0.0238095238095238;0.476190476190476
Control.SRR15539829;48;45;0.458333333333333;26;22;0.0416666666666667;0.458333333333333
Control.SRR15539829;47;45;0.531914893617021;22;25;0.0319148936170213;0.468085106382979
Control.SRR15539829;50;45;0.52;24;26;0.02;0.48
Control.SRR15539829;43;45;0.418604651162791;25;18;0.0813953488372093;0.418604651162791
Control.SRR15539829;41;45;0.51219512195122;20;21;0.0121951219512195;0.48780487804878
Control.SRR15539829;46;45;0.521739130434783;22;24;0.0217391304347826;0.478260869565217
Control.SRR15539829;43;45;0.534883720930233;20;23;0.0348837209302325;0.465116279069767
Control.SRR15539829;40;45;0.35;26;14;0.15;0.35
Control.SRR15539829;48;45;0.479166666666667;25;23;0.0208333333333333;0.479166666666667
Control.SRR15539829;42;45;0.428571428571429;24;18;0.0714285714285715;0.428571428571429
Control.SRR15539829;45;45;0.555555555555556;20;25;0.0555555555555556;0.444444444444444
Control.SRR15539829;43;45;0.465116279069767;23;20;0.0348837209302326;0.465116279069767
Control.SRR15539829;51;45;0.529411764705882;24;27;0.0294117647058824;0.470588235294118
Control.SRR15539829;50;45;0.44;28;22;0.06;0.44
Control.SRR15539829;46;45;0.5;23;23;0;0.5
Control.SRR15539829;45;45;0.488888888888889;23;22;0.0111111111111111;0.488888888888889
Control.SRR15539829;40;45;0.6;16;24;0.1;0.4
Control.SRR15539829;46;45;0.5;23;23;0;0.5
Control.SRR15539829;45;45;0.466666666666667;24;21;0.0333333333333333;0.466666666666667
Control.SRR15539829;46;45;0.456521739130435;25;21;0.0434782608695652;0.456521739130435
Control.SRR15539829;44;45;0.590909090909091;18;26;0.0909090909090909;0.409090909090909
Control.SRR15539829;47;45;0.553191489361702;21;26;0.0531914893617021;0.446808510638298
Control.SRR15539829;46;45;0.521739130434783;22;24;0.0217391304347826;0.478260869565217
Control.SRR15539829;46;45;0.58695652173913;19;27;0.0869565217391305;0.41304347826087
Control.SRR15539829;51;45;0.509803921568627;25;26;0.00980392156862742;0.490196078431373
Control.SRR15539829;42;45;0.595238095238095;17;25;0.0952380952380952;0.404761904761905
Control.SRR15539829;41;45;0.634146341463415;15;26;0.134146341463415;0.365853658536585
Control.SRR15539829;42;45;0.476190476190476;22;20;0.0238095238095238;0.476190476190476
Control.SRR15539829;40;45;0.55;18;22;0.05;0.45
Control.SRR15539829;49;45;0.428571428571429;28;21;0.0714285714285715;0.428571428571429
Control.SRR15539829;43;45;0.395348837209302;26;17;0.104651162790698;0.395348837209302
Control.SRR15539829;47;45;0.446808510638298;26;21;0.0531914893617021;0.446808510638298
Control.SRR15539829;48;45;0.479166666666667;25;23;0.0208333333333333;0.479166666666667
Control.SRR15539829;40;45;0.5;20;20;0;0.5
Control.SRR15539829;50;45;0.42;29;21;0.08;0.42
Control.SRR15539829;43;45;0.395348837209302;26;17;0.104651162790698;0.395348837209302
Control.SRR15539829;41;45;0.463414634146341;22;19;0.0365853658536585;0.463414634146341
Control.SRR15539829;48;45;0.479166666666667;25;23;0.0208333333333333;0.479166666666667
Control.SRR15539829;45;45;0.466666666666667;24;21;0.0333333333333333;0.466666666666667
Control.SRR15539829;50;45;0.46;27;23;0.04;0.46
Control.SRR15539829;43;45;0.465116279069767;23;20;0.0348837209302326;0.465116279069767
Control.SRR15539829;40;45;0.65;14;26;0.15;0.35
Control.SRR15539829;42;45;0.523809523809524;20;22;0.0238095238095238;0.476190476190476
Control.SRR15539829;47;45;0.404255319148936;28;19;0.0957446808510639;0.404255319148936
Control.SRR15539829;47;45;0.638297872340426;17;30;0.138297872340426;0.361702127659574
Control.SRR15539829;45;45;0.311111111111111;31;14;0.188888888888889;0.311111111111111
Control.SRR15539829;50;45;0.44;28;22;0.06;0.44
Control.SRR15539829;40;45;0.35;26;14;0.15;0.35
Control.SRR15539829;44;45;0.545454545454545;20;24;0.0454545454545454;0.454545454545455
Control.SRR15539829;46;45;0.434782608695652;26;20;0.0652173913043478;0.434782608695652
Control.SRR15539829;51;45;0.392156862745098;31;20;0.107843137254902;0.392156862745098
Control.SRR15539829;40;45;0.525;19;21;0.025;0.475
Control.SRR15539829;43;45;0.651162790697674;15;28;0.151162790697674;0.348837209302326
Control.SRR15539829;45;45;0.444444444444444;25;20;0.0555555555555556;0.444444444444444
Control.SRR15539829;42;45;0.5;21;21;0;0.5
Control.SRR15539829;48;45;0.5625;21;27;0.0625;0.4375
Control.SRR15539829;42;45;0.476190476190476;22;20;0.0238095238095238;0.476190476190476
Control.SRR15539829;51;45;0.549019607843137;23;28;0.0490196078431373;0.450980392156863
Control.SRR15539829;50;45;0.5;25;25;0;0.5
Control.SRR15539829;52;45;0.557692307692308;23;29;0.0576923076923077;0.442307692307692
Control.SRR15539829;50;45;0.5;25;25;0;0.5
Control.SRR15539829;51;45;0.568627450980392;22;29;0.0686274509803921;0.431372549019608
Control.SRR15539829;52;45;0.384615384615385;32;20;0.115384615384615;0.384615384615385
Control.SRR15539829;46;45;0.5;23;23;0;0.5
Control.SRR15539829;44;45;0.454545454545455;24;20;0.0454545454545455;0.454545454545455
Control.SRR15539829;52;45;0.538461538461538;24;28;0.0384615384615384;0.461538461538462
Control.SRR15539829;40;45;0.5;20;20;0;0.5
Control.SRR15539829;46;45;0.478260869565217;24;22;0.0217391304347826;0.478260869565217
Control.SRR15539829;42;45;0.476190476190476;22;20;0.0238095238095238;0.476190476190476
Control.SRR15539829;52;45;0.384615384615385;32;20;0.115384615384615;0.384615384615385
Control.SRR15539829;47;45;0.553191489361702;21;26;0.0531914893617021;0.446808510638298
Control.SRR15539829;43;45;0.511627906976744;21;22;0.0116279069767442;0.488372093023256
Control.SRR15539829;51;45;0.509803921568627;25;26;0.00980392156862742;0.490196078431373
Control.SRR15539829;45;45;0.533333333333333;21;24;0.0333333333333333;0.466666666666667
Control.SRR15539829;40;45;0.625;15;25;0.125;0.375
Control.SRR15539829;42;45;0.595238095238095;17;25;0.0952380952380952;0.404761904761905
Control.SRR15539829;43;45;0.441860465116279;24;19;0.0581395348837209;0.441860465116279
Control.SRR15539829;42;45;0.642857142857143;15;27;0.142857142857143;0.357142857142857
Control.SRR15539829;41;45;0.365853658536585;26;15;0.134146341463415;0.365853658536585
Control.SRR15539829;41;45;0.439024390243902;23;18;0.0609756097560976;0.439024390243902
Control.SRR15539829;47;45;0.574468085106383;20;27;0.074468085106383;0.425531914893617
Control.SRR15539829;46;45;0.565217391304348;20;26;0.0652173913043478;0.434782608695652
Control.SRR15539829;43;45;0.558139534883721;19;24;0.0581395348837209;0.441860465116279
Control.SRR15539829;40;45;0.575;17;23;0.075;0.425
Control.SRR15539829;52;45;0.5;26;26;0;0.5
Control.SRR15539829;43;45;0.534883720930233;20;23;0.0348837209302325;0.465116279069767
Control.SRR15539829;44;45;0.386363636363636;27;17;0.113636363636364;0.386363636363636
Control.SRR15539829;42;45;0.452380952380952;23;19;0.0476190476190476;0.452380952380952
Control.SRR15539829;48;45;0.5;24;24;0;0.5
Control.SRR15539829;43;45;0.395348837209302;26;17;0.104651162790698;0.395348837209302
Control.SRR15539829;47;45;0.468085106382979;25;22;0.0319148936170213;0.468085106382979
Control.SRR15539829;44;45;0.477272727272727;23;21;0.0227272727272727;0.477272727272727
Control.SRR15539829;48;45;0.4375;27;21;0.0625;0.4375
Control.SRR15539829;44;45;0.545454545454545;20;24;0.0454545454545454;0.454545454545455
Control.SRR15539829;41;45;0.51219512195122;20;21;0.0121951219512195;0.48780487804878
Control.SRR15539829;42;45;0.476190476190476;22;20;0.0238095238095238;0.476190476190476
Control.SRR15539829;41;45;0.560975609756098;18;23;0.0609756097560976;0.439024390243902
Control.SRR15539829;50;45;0.4;30;20;0.1;0.4
Control.SRR15539829;50;45;0.58;21;29;0.08;0.42
Control.SRR15539829;48;45;0.520833333333333;23;25;0.0208333333333334;0.479166666666667
Control.SRR15539829;51;45;0.431372549019608;29;22;0.0686274509803921;0.431372549019608
Control.SRR15539829;41;45;0.560975609756098;18;23;0.0609756097560976;0.439024390243902
Control.SRR15539829;52;45;0.403846153846154;31;21;0.0961538461538461;0.403846153846154
Control.SRR15539829;42;45;0.452380952380952;23;19;0.0476190476190476;0.452380952380952
Control.SRR15539829;40;45;0.55;18;22;0.05;0.45
Control.SRR15539829;49;45;0.489795918367347;25;24;0.0102040816326531;0.489795918367347
Control.SRR15539829;51;45;0.490196078431373;26;25;0.00980392156862747;0.490196078431373
Control.SRR15539829;45;45;0.533333333333333;21;24;0.0333333333333333;0.466666666666667
Control.SRR15539829;45;45;0.4;27;18;0.1;0.4
Control.SRR15539829;44;45;0.590909090909091;18;26;0.0909090909090909;0.409090909090909
Control.SRR15539829;40;45;0.525;19;21;0.025;0.475
Control.SRR15539829;41;45;0.439024390243902;23;18;0.0609756097560976;0.439024390243902
Control.SRR15539829;50;45;0.4;30;20;0.1;0.4
Control.SRR15539829;52;45;0.5;26;26;0;0.5
Control.SRR15539829;51;45;0.431372549019608;29;22;0.0686274509803921;0.431372549019608
Control.SRR15539829;50;45;0.46;27;23;0.04;0.46
Control.SRR15539829;45;45;0.444444444444444;25;20;0.0555555555555556;0.444444444444444
Control.SRR15539829;48;45;0.541666666666667;22;26;0.0416666666666666;0.458333333333333
Control.SRR15539829;48;45;0.520833333333333;23;25;0.0208333333333334;0.479166666666667
Control.SRR15539829;46;45;0.434782608695652;26;20;0.0652173913043478;0.434782608695652
Control.SRR15539829;51;45;0.450980392156863;28;23;0.0490196078431372;0.450980392156863
Control.SRR15539829;45;45;0.422222222222222;26;19;0.0777777777777778;0.422222222222222
Control.SRR15539829;50;45;0.46;27;23;0.04;0.46
Control.SRR15539829;47;45;0.638297872340426;17;30;0.138297872340426;0.361702127659574
Control.SRR15539829;44;45;0.477272727272727;23;21;0.0227272727272727;0.477272727272727
Control.SRR15539829;45;45;0.488888888888889;23;22;0.0111111111111111;0.488888888888889
Control.SRR15539829;48;45;0.541666666666667;22;26;0.0416666666666666;0.458333333333333
Control.SRR15539829;45;45;0.511111111111111;22;23;0.0111111111111111;0.488888888888889
Control.SRR15539829;49;45;0.612244897959184;19;30;0.112244897959184;0.387755102040816
Control.SRR15539829;44;45;0.545454545454545;20;24;0.0454545454545454;0.454545454545455
Control.SRR15539829;45;45;0.555555555555556;20;25;0.0555555555555556;0.444444444444444
Control.SRR15539829;47;45;0.553191489361702;21;26;0.0531914893617021;0.446808510638298
Control.SRR15539829;50;45;0.42;29;21;0.08;0.42
Control.SRR15539829;50;45;0.54;23;27;0.04;0.46
Control.SRR15539829;52;45;0.480769230769231;27;25;0.0192307692307692;0.480769230769231
Control.SRR15539829;46;45;0.521739130434783;22;24;0.0217391304347826;0.478260869565217
Control.SRR15539829;46;45;0.565217391304348;20;26;0.0652173913043478;0.434782608695652
Control.SRR15539829;45;45;0.377777777777778;28;17;0.122222222222222;0.377777777777778
Control.SRR15539829;49;45;0.551020408163265;22;27;0.0510204081632653;0.448979591836735
Control.SRR15539829;40;45;0.45;22;18;0.05;0.45
Control.SRR15539829;51;45;0.450980392156863;28;23;0.0490196078431372;0.450980392156863
Control.SRR15539829;51;45;0.568627450980392;22;29;0.0686274509803921;0.431372549019608
Control.SRR15539829;41;45;0.48780487804878;21;20;0.0121951219512195;0.48780487804878
Control.SRR15539829;44;45;0.454545454545455;24;20;0.0454545454545455;0.454545454545455
Control.SRR15539829;48;45;0.5625;21;27;0.0625;0.4375
Control.SRR15539829;45;45;0.4;27;18;0.1;0.4
Control.SRR15539829;40;45;0.5;20;20;0;0.5
Control.SRR15539829;40;45;0.65;14;26;0.15;0.35
Control.SRR15539829;45;45;0.6;18;27;0.1;0.4
Control.SRR15539829;45;45;0.444444444444444;25;20;0.0555555555555556;0.444444444444444
Control.SRR15539829;48;45;0.479166666666667;25;23;0.0208333333333333;0.479166666666667
Control.SRR15539829;41;45;0.536585365853659;19;22;0.0365853658536586;0.463414634146341
Control.SRR15539829;51;45;0.490196078431373;26;25;0.00980392156862747;0.490196078431373
Control.SRR15539829;40;45;0.5;20;20;0;0.5
Control.SRR15539829;48;45;0.541666666666667;22;26;0.0416666666666666;0.458333333333333
Control.SRR15539829;50;45;0.48;26;24;0.02;0.48
Control.SRR15539829;46;45;0.521739130434783;22;24;0.0217391304347826;0.478260869565217
Control.SRR15539829;45;45;0.422222222222222;26;19;0.0777777777777778;0.422222222222222
Control.SRR15539829;44;45;0.409090909090909;26;18;0.0909090909090909;0.409090909090909
Control.SRR15539829;45;45;0.422222222222222;26;19;0.0777777777777778;0.422222222222222
Control.SRR15539829;41;45;0.585365853658537;17;24;0.0853658536585366;0.414634146341463
Control.SRR15539829;46;45;0.630434782608696;17;29;0.130434782608696;0.369565217391304
Control.SRR15539829;52;45;0.423076923076923;30;22;0.0769230769230769;0.423076923076923
Control.SRR15539829;43;45;0.465116279069767;23;20;0.0348837209302326;0.465116279069767
Control.SRR15539829;46;45;0.565217391304348;20;26;0.0652173913043478;0.434782608695652
Control.SRR15539829;51;45;0.529411764705882;24;27;0.0294117647058824;0.470588235294118
Control.SRR15539829;44;45;0.477272727272727;23;21;0.0227272727272727;0.477272727272727
Control.SRR15539829;40;45;0.475;21;19;0.025;0.475
Control.SRR15539829;48;45;0.541666666666667;22;26;0.0416666666666666;0.458333333333333
Control.SRR15539829;50;45;0.52;24;26;0.02;0.48
Control.SRR15539829;48;45;0.541666666666667;22;26;0.0416666666666666;0.458333333333333
Control.SRR15539829;52;45;0.461538461538462;28;24;0.0384615384615384;0.461538461538462
Control.SRR15539829;43;45;0.488372093023256;22;21;0.0116279069767442;0.488372093023256
Control.SRR15539829;46;45;0.543478260869565;21;25;0.0434782608695652;0.456521739130435
Control.SRR15539829;45;45;0.422222222222222;26;19;0.0777777777777778;0.422222222222222
Control.SRR15539829;50;45;0.42;29;21;0.08;0.42
Control.SRR15539829;42;45;0.404761904761905;25;17;0.0952380952380952;0.404761904761905
Control.SRR15539829;40;45;0.475;21;19;0.025;0.475
Control.SRR15539829;46;45;0.41304347826087;27;19;0.0869565217391304;0.41304347826087
Control.SRR15539829;46;45;0.652173913043478;16;30;0.152173913043478;0.347826086956522
Control.SRR15539829;52;45;0.5;26;26;0;0.5
Control.SRR15539829;48;45;0.541666666666667;22;26;0.0416666666666666;0.458333333333333
Control.SRR15539829;48;45;0.5625;21;27;0.0625;0.4375
Control.SRR15539829;41;45;0.439024390243902;23;18;0.0609756097560976;0.439024390243902
Control.SRR15539829;45;45;0.488888888888889;23;22;0.0111111111111111;0.488888888888889
Control.SRR15539829;47;45;0.574468085106383;20;27;0.074468085106383;0.425531914893617
Control.SRR15539829;48;45;0.458333333333333;26;22;0.0416666666666667;0.458333333333333
Control.SRR15539829;45;45;0.622222222222222;17;28;0.122222222222222;0.377777777777778
Control.SRR15539829;49;45;0.469387755102041;26;23;0.0306122448979592;0.469387755102041
Control.SRR15539829;51;45;0.549019607843137;23;28;0.0490196078431373;0.450980392156863
Control.SRR15539829;42;45;0.380952380952381;26;16;0.119047619047619;0.380952380952381
Control.SRR15539829;48;45;0.479166666666667;25;23;0.0208333333333333;0.479166666666667
Control.SRR15539829;52;45;0.692307692307692;16;36;0.192307692307692;0.307692307692308
Control.SRR15539829;41;45;0.439024390243902;23;18;0.0609756097560976;0.439024390243902
Control.SRR15539829;49;45;0.428571428571429;28;21;0.0714285714285715;0.428571428571429
Control.SRR15539829;43;45;0.534883720930233;20;23;0.0348837209302325;0.465116279069767
Control.SRR15539829;47;45;0.51063829787234;23;24;0.0106382978723404;0.48936170212766
Control.SRR15539829;47;45;0.446808510638298;26;21;0.0531914893617021;0.446808510638298
Control.SRR15539829;43;45;0.395348837209302;26;17;0.104651162790698;0.395348837209302
Control.SRR15539829;48;45;0.5;24;24;0;0.5
Control.SRR15539829;50;45;0.42;29;21;0.08;0.42
Control.SRR15539829;50;45;0.5;25;25;0;0.5
Control.SRR15539829;50;45;0.66;17;33;0.16;0.34
Control.SRR15539829;49;45;0.551020408163265;22;27;0.0510204081632653;0.448979591836735
Control.SRR15539829;41;45;0.560975609756098;18;23;0.0609756097560976;0.439024390243902
Control.SRR15539829;46;45;0.630434782608696;17;29;0.130434782608696;0.369565217391304
Control.SRR15539829;49;45;0.428571428571429;28;21;0.0714285714285715;0.428571428571429
Control.SRR15539829;47;45;0.51063829787234;23;24;0.0106382978723404;0.48936170212766
Control.SRR15539829;49;45;0.469387755102041;26;23;0.0306122448979592;0.469387755102041
Control.SRR15539829;41;45;0.439024390243902;23;18;0.0609756097560976;0.439024390243902
Control.SRR15539829;44;45;0.409090909090909;26;18;0.0909090909090909;0.409090909090909
Control.SRR15539829;46;45;0.391304347826087;28;18;0.108695652173913;0.391304347826087
Control.SRR15539829;49;45;0.530612244897959;23;26;0.0306122448979592;0.469387755102041
Control.SRR15539829;41;45;0.536585365853659;19;22;0.0365853658536586;0.463414634146341
Control.SRR15539829;40;45;0.5;20;20;0;0.5
Control.SRR15539829;43;45;0.441860465116279;24;19;0.0581395348837209;0.441860465116279
Control.SRR15539829;44;45;0.568181818181818;19;25;0.0681818181818182;0.431818181818182
Control.SRR15539829;42;45;0.452380952380952;23;19;0.0476190476190476;0.452380952380952
Control.SRR15539829;48;45;0.604166666666667;19;29;0.104166666666667;0.395833333333333
Control.SRR15539829;46;45;0.5;23;23;0;0.5
Control.SRR15539829;50;45;0.48;26;24;0.02;0.48
Control.SRR15539829;46;45;0.5;23;23;0;0.5
Control.SRR15539829;45;45;0.488888888888889;23;22;0.0111111111111111;0.488888888888889
Control.SRR15539829;42;45;0.595238095238095;17;25;0.0952380952380952;0.404761904761905
Control.SRR15539829;48;45;0.5;24;24;0;0.5
Control.SRR15539829;42;45;0.547619047619048;19;23;0.0476190476190477;0.452380952380952
Control.SRR15539829;40;45;0.525;19;21;0.025;0.475
Control.SRR15539829;48;45;0.541666666666667;22;26;0.0416666666666666;0.458333333333333
Control.SRR15539829;49;45;0.530612244897959;23;26;0.0306122448979592;0.469387755102041
Control.SRR15539829;48;45;0.541666666666667;22;26;0.0416666666666666;0.458333333333333
Control.SRR15539829;46;45;0.565217391304348;20;26;0.0652173913043478;0.434782608695652
Control.SRR15539829;49;45;0.469387755102041;26;23;0.0306122448979592;0.469387755102041
Control.SRR15539829;48;45;0.520833333333333;23;25;0.0208333333333334;0.479166666666667
Control.SRR15539829;47;45;0.553191489361702;21;26;0.0531914893617021;0.446808510638298
Control.SRR15539829;40;45;0.35;26;14;0.15;0.35
Control.SRR15539829;46;45;0.543478260869565;21;25;0.0434782608695652;0.456521739130435
Control.SRR15539829;48;45;0.479166666666667;25;23;0.0208333333333333;0.479166666666667
Control.SRR15539829;40;45;0.45;22;18;0.05;0.45
Control.SRR15539829;50;45;0.5;25;25;0;0.5
Control.SRR15539829;48;45;0.4375;27;21;0.0625;0.4375
Control.SRR15539829;47;45;0.425531914893617;27;20;0.074468085106383;0.425531914893617
Control.SRR15539829;41;45;0.585365853658537;17;24;0.0853658536585366;0.414634146341463
Control.SRR15539829;46;45;0.565217391304348;20;26;0.0652173913043478;0.434782608695652
Control.SRR15539829;49;45;0.469387755102041;26;23;0.0306122448979592;0.469387755102041
Control.SRR15539829;43;45;0.604651162790698;17;26;0.104651162790698;0.395348837209302
Control.SRR15539829;44;45;0.431818181818182;25;19;0.0681818181818182;0.431818181818182
Control.SRR15539829;42;45;0.547619047619048;19;23;0.0476190476190477;0.452380952380952
Control.SRR15539829;48;45;0.479166666666667;25;23;0.0208333333333333;0.479166666666667
Control.SRR15539829;42;45;0.5;21;21;0;0.5
Control.SRR15539829;49;45;0.571428571428571;21;28;0.0714285714285714;0.428571428571429
Control.SRR15539829;42;45;0.595238095238095;17;25;0.0952380952380952;0.404761904761905
Control.SRR15539829;40;45;0.525;19;21;0.025;0.475
Control.SRR15539829;44;45;0.454545454545455;24;20;0.0454545454545455;0.454545454545455
Control.SRR15539829;40;45;0.425;23;17;0.075;0.425
Control.SRR15539829;45;45;0.422222222222222;26;19;0.0777777777777778;0.422222222222222
Control.SRR15539829;45;45;0.622222222222222;17;28;0.122222222222222;0.377777777777778
Control.SRR15539829;47;45;0.361702127659574;30;17;0.138297872340426;0.361702127659574
Control.SRR15539829;46;45;0.434782608695652;26;20;0.0652173913043478;0.434782608695652
Control.SRR15539829;51;45;0.450980392156863;28;23;0.0490196078431372;0.450980392156863
Control.SRR15539829;50;45;0.46;27;23;0.04;0.46
Control.SRR15539829;44;45;0.590909090909091;18;26;0.0909090909090909;0.409090909090909
Control.SRR15539829;48;45;0.458333333333333;26;22;0.0416666666666667;0.458333333333333
Control.SRR15539829;51;45;0.450980392156863;28;23;0.0490196078431372;0.450980392156863
Control.SRR15539829;49;45;0.510204081632653;24;25;0.0102040816326531;0.489795918367347
Control.SRR15539829;46;45;0.5;23;23;0;0.5
Control.SRR15539829;47;45;0.595744680851064;19;28;0.0957446808510638;0.404255319148936
Control.SRR15539829;43;45;0.511627906976744;21;22;0.0116279069767442;0.488372093023256
Control.SRR15539829;51;45;0.588235294117647;21;30;0.0882352941176471;0.411764705882353
Control.SRR15539829;48;45;0.4375;27;21;0.0625;0.4375
Control.SRR15539829;48;45;0.458333333333333;26;22;0.0416666666666667;0.458333333333333
Control.SRR15539829;49;45;0.551020408163265;22;27;0.0510204081632653;0.448979591836735
Control.SRR15539829;46;45;0.478260869565217;24;22;0.0217391304347826;0.478260869565217
Control.SRR15539829;49;45;0.510204081632653;24;25;0.0102040816326531;0.489795918367347
Control.SRR15539829;42;45;0.5;21;21;0;0.5
Control.SRR15539829;43;45;0.558139534883721;19;24;0.0581395348837209;0.441860465116279
Control.SRR15539829;43;45;0.581395348837209;18;25;0.0813953488372093;0.418604651162791
Control.SRR15539829;50;45;0.62;19;31;0.12;0.38
Control.SRR15539829;42;45;0.476190476190476;22;20;0.0238095238095238;0.476190476190476
Control.SRR15539829;49;45;0.469387755102041;26;23;0.0306122448979592;0.469387755102041
Control.SRR15539829;49;45;0.408163265306122;29;20;0.0918367346938775;0.408163265306122
Control.SRR15539829;47;45;0.361702127659574;30;17;0.138297872340426;0.361702127659574
Control.SRR15539829;41;45;0.560975609756098;18;23;0.0609756097560976;0.439024390243902
Control.SRR15539829;51;45;0.411764705882353;30;21;0.0882352941176471;0.411764705882353
Control.SRR15539829;41;45;0.634146341463415;15;26;0.134146341463415;0.365853658536585
Control.SRR15539829;41;45;0.365853658536585;26;15;0.134146341463415;0.365853658536585
Control.SRR15539829;45;45;0.555555555555556;20;25;0.0555555555555556;0.444444444444444
Control.SRR15539829;49;45;0.448979591836735;27;22;0.0510204081632653;0.448979591836735
Control.SRR15539829;52;45;0.461538461538462;28;24;0.0384615384615384;0.461538461538462
Control.SRR15539829;42;45;0.5;21;21;0;0.5
Control.SRR15539829;41;45;0.463414634146341;22;19;0.0365853658536585;0.463414634146341
Control.SRR15539829;45;45;0.511111111111111;22;23;0.0111111111111111;0.488888888888889
Control.SRR15539829;41;45;0.51219512195122;20;21;0.0121951219512195;0.48780487804878
Control.SRR15539829;48;45;0.541666666666667;22;26;0.0416666666666666;0.458333333333333
Control.SRR15539829;46;45;0.673913043478261;15;31;0.173913043478261;0.326086956521739
Control.SRR15539829;41;45;0.439024390243902;23;18;0.0609756097560976;0.439024390243902
Control.SRR15539829;51;45;0.549019607843137;23;28;0.0490196078431373;0.450980392156863
Control.SRR15539829;50;45;0.4;30;20;0.1;0.4
Control.SRR15539829;44;45;0.454545454545455;24;20;0.0454545454545455;0.454545454545455
Control.SRR15539829;48;45;0.604166666666667;19;29;0.104166666666667;0.395833333333333
Control.SRR15539829;50;45;0.58;21;29;0.08;0.42
Control.SRR15539829;44;45;0.454545454545455;24;20;0.0454545454545455;0.454545454545455
Control.SRR15539829;42;45;0.571428571428571;18;24;0.0714285714285714;0.428571428571429
Control.SRR15539829;40;45;0.575;17;23;0.075;0.425
Control.SRR15539829;47;45;0.425531914893617;27;20;0.074468085106383;0.425531914893617
Control.SRR15539829;48;45;0.583333333333333;20;28;0.0833333333333334;0.416666666666667
Control.SRR15539829;49;45;0.530612244897959;23;26;0.0306122448979592;0.469387755102041
Control.SRR15539829;45;45;0.355555555555556;29;16;0.144444444444444;0.355555555555556
Control.SRR15539829;43;45;0.465116279069767;23;20;0.0348837209302326;0.465116279069767
Control.SRR15539829;48;45;0.583333333333333;20;28;0.0833333333333334;0.416666666666667
Control.SRR15539829;48;45;0.5;24;24;0;0.5
Control.SRR15539829;49;45;0.510204081632653;24;25;0.0102040816326531;0.489795918367347
Control.SRR15539829;44;45;0.545454545454545;20;24;0.0454545454545454;0.454545454545455
Control.SRR15539829;50;45;0.4;30;20;0.1;0.4
Control.SRR15539829;42;45;0.571428571428571;18;24;0.0714285714285714;0.428571428571429
Control.SRR15539829;50;45;0.42;29;21;0.08;0.42
Control.SRR15539829;44;45;0.568181818181818;19;25;0.0681818181818182;0.431818181818182
Control.SRR15539829;52;45;0.423076923076923;30;22;0.0769230769230769;0.423076923076923
Control.SRR15539829;47;45;0.48936170212766;24;23;0.0106382978723404;0.48936170212766
Control.SRR15539829;47;45;0.48936170212766;24;23;0.0106382978723404;0.48936170212766
Control.SRR15539829;46;45;0.565217391304348;20;26;0.0652173913043478;0.434782608695652
Control.SRR15539829;52;45;0.365384615384615;33;19;0.134615384615385;0.365384615384615
Control.SRR15539829;44;45;0.545454545454545;20;24;0.0454545454545454;0.454545454545455
Control.SRR15539829;50;45;0.46;27;23;0.04;0.46
Control.SRR15539829;49;45;0.510204081632653;24;25;0.0102040816326531;0.489795918367347
Control.SRR15539829;46;45;0.521739130434783;22;24;0.0217391304347826;0.478260869565217
Control.SRR15539829;45;45;0.511111111111111;22;23;0.0111111111111111;0.488888888888889
Control.SRR15539829;49;45;0.510204081632653;24;25;0.0102040816326531;0.489795918367347
Control.SRR15539829;46;45;0.5;23;23;0;0.5
Control.SRR15539829;46;45;0.58695652173913;19;27;0.0869565217391305;0.41304347826087
Control.SRR15539829;44;45;0.659090909090909;15;29;0.159090909090909;0.340909090909091
Control.SRR15539829;44;45;0.386363636363636;27;17;0.113636363636364;0.386363636363636
Control.SRR15539829;45;45;0.622222222222222;17;28;0.122222222222222;0.377777777777778
Control.SRR15539829;40;45;0.55;18;22;0.05;0.45
Control.SRR15539829;41;45;0.609756097560976;16;25;0.109756097560976;0.390243902439024
Control.SRR15539829;40;45;0.65;14;26;0.15;0.35
Control.SRR15539829;43;45;0.418604651162791;25;18;0.0813953488372093;0.418604651162791
Control.SRR15539829;46;45;0.565217391304348;20;26;0.0652173913043478;0.434782608695652
Control.SRR15539829;51;45;0.450980392156863;28;23;0.0490196078431372;0.450980392156863
Control.SRR15539829;45;45;0.555555555555556;20;25;0.0555555555555556;0.444444444444444
Control.SRR15539829;41;45;0.536585365853659;19;22;0.0365853658536586;0.463414634146341
Control.SRR15539829;44;45;0.340909090909091;29;15;0.159090909090909;0.340909090909091
Control.SRR15539829;42;45;0.595238095238095;17;25;0.0952380952380952;0.404761904761905
Control.SRR15539829;52;45;0.5;26;26;0;0.5
Control.SRR15539829;46;45;0.456521739130435;25;21;0.0434782608695652;0.456521739130435
Control.SRR15539829;45;45;0.4;27;18;0.1;0.4
Control.SRR15539829;47;45;0.553191489361702;21;26;0.0531914893617021;0.446808510638298
Control.SRR15539829;45;45;0.533333333333333;21;24;0.0333333333333333;0.466666666666667
Control.SRR15539829;40;45;0.45;22;18;0.05;0.45
Control.SRR15539829;44;45;0.545454545454545;20;24;0.0454545454545454;0.454545454545455
Control.SRR15539829;42;45;0.571428571428571;18;24;0.0714285714285714;0.428571428571429
Control.SRR15539829;50;45;0.48;26;24;0.02;0.48
Control.SRR15539829;47;45;0.574468085106383;20;27;0.074468085106383;0.425531914893617
Control.SRR15539829;43;45;0.581395348837209;18;25;0.0813953488372093;0.418604651162791
Control.SRR15539829;49;45;0.489795918367347;25;24;0.0102040816326531;0.489795918367347
Control.SRR15539829;42;45;0.571428571428571;18;24;0.0714285714285714;0.428571428571429
Control.SRR15539829;49;45;0.428571428571429;28;21;0.0714285714285715;0.428571428571429
Control.SRR15539829;49;45;0.326530612244898;33;16;0.173469387755102;0.326530612244898
Control.SRR15539829;48;45;0.4375;27;21;0.0625;0.4375
Control.SRR15539829;45;45;0.377777777777778;28;17;0.122222222222222;0.377777777777778
Control.SRR15539829;42;45;0.357142857142857;27;15;0.142857142857143;0.357142857142857
Control.SRR15539829;50;45;0.52;24;26;0.02;0.48
Control.SRR15539829;46;45;0.456521739130435;25;21;0.0434782608695652;0.456521739130435
Control.SRR15539829;52;45;0.519230769230769;25;27;0.0192307692307693;0.480769230769231
Control.SRR15539829;41;45;0.634146341463415;15;26;0.134146341463415;0.365853658536585
Control.SRR15539829;50;45;0.34;33;17;0.16;0.34
Control.SRR15539829;51;45;0.588235294117647;21;30;0.0882352941176471;0.411764705882353
Control.SRR15539829;40;45;0.5;20;20;0;0.5
Control.SRR15539829;40;45;0.375;25;15;0.125;0.375
Control.SRR15539829;48;45;0.541666666666667;22;26;0.0416666666666666;0.458333333333333
Control.SRR15539829;40;45;0.525;19;21;0.025;0.475
Control.SRR15539829;51;45;0.411764705882353;30;21;0.0882352941176471;0.411764705882353
Control.SRR15539829;42;45;0.404761904761905;25;17;0.0952380952380952;0.404761904761905
Control.SRR15539829;44;45;0.5;22;22;0;0.5
Control.SRR15539829;50;45;0.48;26;24;0.02;0.48
Control.SRR15539829;48;45;0.5;24;24;0;0.5
Control.SRR15539829;44;45;0.568181818181818;19;25;0.0681818181818182;0.431818181818182
Control.SRR15539829;45;45;0.444444444444444;25;20;0.0555555555555556;0.444444444444444
Control.SRR15539829;44;45;0.409090909090909;26;18;0.0909090909090909;0.409090909090909
Control.SRR15539829;47;45;0.276595744680851;34;13;0.223404255319149;0.276595744680851
Control.SRR15539829;44;45;0.409090909090909;26;18;0.0909090909090909;0.409090909090909
Control.SRR15539829;51;45;0.470588235294118;27;24;0.0294117647058824;0.470588235294118
Control.SRR15539829;52;45;0.442307692307692;29;23;0.0576923076923077;0.442307692307692
Control.SRR15539829;41;45;0.48780487804878;21;20;0.0121951219512195;0.48780487804878
Control.SRR15539829;42;45;0.476190476190476;22;20;0.0238095238095238;0.476190476190476
Control.SRR15539829;42;45;0.523809523809524;20;22;0.0238095238095238;0.476190476190476
Control.SRR15539829;42;45;0.428571428571429;24;18;0.0714285714285715;0.428571428571429
Control.SRR15539829;47;45;0.553191489361702;21;26;0.0531914893617021;0.446808510638298
Control.SRR15539829;40;45;0.575;17;23;0.075;0.425
Control.SRR15539829;43;45;0.581395348837209;18;25;0.0813953488372093;0.418604651162791
Control.SRR15539829;42;45;0.523809523809524;20;22;0.0238095238095238;0.476190476190476
Control.SRR15539829;42;45;0.5;21;21;0;0.5
Control.SRR15539829;42;45;0.5;21;21;0;0.5
Control.SRR15539829;42;45;0.523809523809524;20;22;0.0238095238095238;0.476190476190476
Control.SRR15539829;50;45;0.46;27;23;0.04;0.46
Control.SRR15539829;49;45;0.612244897959184;19;30;0.112244897959184;0.387755102040816
Control.SRR15539829;46;45;0.478260869565217;24;22;0.0217391304347826;0.478260869565217
Control.SRR15539829;44;45;0.454545454545455;24;20;0.0454545454545455;0.454545454545455
Control.SRR15539829;48;45;0.479166666666667;25;23;0.0208333333333333;0.479166666666667
Control.SRR15539829;45;45;0.466666666666667;24;21;0.0333333333333333;0.466666666666667
Control.SRR15539829;49;45;0.469387755102041;26;23;0.0306122448979592;0.469387755102041
Control.SRR15539829;44;45;0.477272727272727;23;21;0.0227272727272727;0.477272727272727
Control.SRR15539829;51;45;0.470588235294118;27;24;0.0294117647058824;0.470588235294118
Control.SRR15539829;46;45;0.478260869565217;24;22;0.0217391304347826;0.478260869565217
Control.SRR15539829;52;45;0.538461538461538;24;28;0.0384615384615384;0.461538461538462
Control.SRR15539829;41;45;0.51219512195122;20;21;0.0121951219512195;0.48780487804878
Control.SRR15539829;45;45;0.533333333333333;21;24;0.0333333333333333;0.466666666666667
Control.SRR15539829;43;45;0.441860465116279;24;19;0.0581395348837209;0.441860465116279
Control.SRR15539829;51;45;0.588235294117647;21;30;0.0882352941176471;0.411764705882353
Control.SRR15539829;41;45;0.560975609756098;18;23;0.0609756097560976;0.439024390243902
Control.SRR15539829;42;45;0.547619047619048;19;23;0.0476190476190477;0.452380952380952
Control.SRR15539829;42;45;0.571428571428571;18;24;0.0714285714285714;0.428571428571429
Control.SRR15539829;41;45;0.585365853658537;17;24;0.0853658536585366;0.414634146341463
Control.SRR15539829;45;45;0.355555555555556;29;16;0.144444444444444;0.355555555555556
Control.SRR15539829;50;45;0.52;24;26;0.02;0.48
Control.SRR15539829;46;45;0.41304347826087;27;19;0.0869565217391304;0.41304347826087
Control.SRR15539829;43;45;0.558139534883721;19;24;0.0581395348837209;0.441860465116279
Control.SRR15539829;41;45;0.390243902439024;25;16;0.109756097560976;0.390243902439024
Control.SRR15539829;45;45;0.422222222222222;26;19;0.0777777777777778;0.422222222222222
Control.SRR15539829;48;45;0.604166666666667;19;29;0.104166666666667;0.395833333333333
Control.SRR15539829;50;45;0.4;30;20;0.1;0.4
Control.SRR15539829;51;45;0.607843137254902;20;31;0.107843137254902;0.392156862745098
Control.SRR15539829;51;45;0.568627450980392;22;29;0.0686274509803921;0.431372549019608
Control.SRR15539829;41;45;0.707317073170732;12;29;0.207317073170732;0.292682926829268
Control.SRR15539829;52;45;0.538461538461538;24;28;0.0384615384615384;0.461538461538462
Control.SRR15539829;50;45;0.58;21;29;0.08;0.42
Control.SRR15539829;42;45;0.523809523809524;20;22;0.0238095238095238;0.476190476190476
Control.SRR15539829;41;45;0.48780487804878;21;20;0.0121951219512195;0.48780487804878
Control.SRR15539829;48;45;0.375;30;18;0.125;0.375
Control.SRR15539829;50;45;0.54;23;27;0.04;0.46
Control.SRR15539829;49;45;0.612244897959184;19;30;0.112244897959184;0.387755102040816
Control.SRR15539829;52;45;0.346153846153846;34;18;0.153846153846154;0.346153846153846
Control.SRR15539829;47;45;0.553191489361702;21;26;0.0531914893617021;0.446808510638298
Control.SRR15539829;48;45;0.479166666666667;25;23;0.0208333333333333;0.479166666666667
Control.SRR15539829;43;45;0.488372093023256;22;21;0.0116279069767442;0.488372093023256
Control.SRR15539829;44;45;0.386363636363636;27;17;0.113636363636364;0.386363636363636
Control.SRR15539829;40;45;0.45;22;18;0.05;0.45
Control.SRR15539829;41;45;0.414634146341463;24;17;0.0853658536585366;0.414634146341463
Control.SRR15539829;43;45;0.651162790697674;15;28;0.151162790697674;0.348837209302326
Control.SRR15539829;41;45;0.51219512195122;20;21;0.0121951219512195;0.48780487804878
Control.SRR15539829;47;45;0.51063829787234;23;24;0.0106382978723404;0.48936170212766
Control.SRR15539829;45;45;0.488888888888889;23;22;0.0111111111111111;0.488888888888889
Control.SRR15539829;42;45;0.571428571428571;18;24;0.0714285714285714;0.428571428571429
Control.SRR15539829;47;45;0.638297872340426;17;30;0.138297872340426;0.361702127659574
Control.SRR15539829;50;45;0.46;27;23;0.04;0.46
Control.SRR15539829;49;45;0.489795918367347;25;24;0.0102040816326531;0.489795918367347
Control.SRR15539829;40;45;0.475;21;19;0.025;0.475
Control.SRR15539829;46;45;0.521739130434783;22;24;0.0217391304347826;0.478260869565217
Control.SRR15539829;47;45;0.574468085106383;20;27;0.074468085106383;0.425531914893617
Control.SRR15539829;42;45;0.523809523809524;20;22;0.0238095238095238;0.476190476190476
Control.SRR15539829;43;45;0.465116279069767;23;20;0.0348837209302326;0.465116279069767
Control.SRR15539829;43;45;0.581395348837209;18;25;0.0813953488372093;0.418604651162791
Control.SRR15539829;42;45;0.595238095238095;17;25;0.0952380952380952;0.404761904761905
Control.SRR15539829;44;45;0.477272727272727;23;21;0.0227272727272727;0.477272727272727
Control.SRR15539829;40;45;0.7;12;28;0.2;0.3
Control.SRR15539829;49;45;0.448979591836735;27;22;0.0510204081632653;0.448979591836735
Control.SRR15539829;47;45;0.51063829787234;23;24;0.0106382978723404;0.48936170212766
Control.SRR15539829;44;45;0.340909090909091;29;15;0.159090909090909;0.340909090909091
Control.SRR15539829;48;45;0.416666666666667;28;20;0.0833333333333333;0.416666666666667
Control.SRR15539829;51;45;0.588235294117647;21;30;0.0882352941176471;0.411764705882353
Control.SRR15539829;48;45;0.541666666666667;22;26;0.0416666666666666;0.458333333333333
Control.SRR15539829;44;45;0.409090909090909;26;18;0.0909090909090909;0.409090909090909
Control.SRR15539829;43;45;0.441860465116279;24;19;0.0581395348837209;0.441860465116279
Control.SRR15539829;47;45;0.638297872340426;17;30;0.138297872340426;0.361702127659574
Control.SRR15539829;45;45;0.533333333333333;21;24;0.0333333333333333;0.466666666666667
Control.SRR15539829;46;45;0.478260869565217;24;22;0.0217391304347826;0.478260869565217
Control.SRR15539829;49;45;0.469387755102041;26;23;0.0306122448979592;0.469387755102041
Control.SRR15539829;49;45;0.63265306122449;18;31;0.13265306122449;0.36734693877551
Control.SRR15539829;49;45;0.571428571428571;21;28;0.0714285714285714;0.428571428571429
Control.SRR15539829;46;45;0.5;23;23;0;0.5
Control.SRR15539829;49;45;0.551020408163265;22;27;0.0510204081632653;0.448979591836735
Control.SRR15539829;46;45;0.456521739130435;25;21;0.0434782608695652;0.456521739130435
Control.SRR15539829;47;45;0.553191489361702;21;26;0.0531914893617021;0.446808510638298
Control.SRR15539829;48;45;0.479166666666667;25;23;0.0208333333333333;0.479166666666667
Control.SRR15539829;52;45;0.5;26;26;0;0.5
Control.SRR15539829;50;45;0.44;28;22;0.06;0.44
Control.SRR15539829;52;45;0.615384615384615;20;32;0.115384615384615;0.384615384615385
Control.SRR15539829;50;45;0.46;27;23;0.04;0.46
Control.SRR15539829;45;45;0.422222222222222;26;19;0.0777777777777778;0.422222222222222
Control.SRR15539829;41;45;0.414634146341463;24;17;0.0853658536585366;0.414634146341463
Control.SRR15539829;47;45;0.48936170212766;24;23;0.0106382978723404;0.48936170212766
Control.SRR15539829;51;45;0.509803921568627;25;26;0.00980392156862742;0.490196078431373
Control.SRR15539829;47;45;0.51063829787234;23;24;0.0106382978723404;0.48936170212766
Control.SRR15539829;48;45;0.520833333333333;23;25;0.0208333333333334;0.479166666666667
Control.SRR15539829;47;45;0.446808510638298;26;21;0.0531914893617021;0.446808510638298
Control.SRR15539829;45;45;0.511111111111111;22;23;0.0111111111111111;0.488888888888889
Control.SRR15539829;48;45;0.541666666666667;22;26;0.0416666666666666;0.458333333333333
Control.SRR15539829;43;45;0.418604651162791;25;18;0.0813953488372093;0.418604651162791
Control.SRR15539829;43;45;0.465116279069767;23;20;0.0348837209302326;0.465116279069767
Control.SRR15539829;40;45;0.575;17;23;0.075;0.425
Control.SRR15539829;42;45;0.476190476190476;22;20;0.0238095238095238;0.476190476190476
Control.SRR15539829;44;45;0.477272727272727;23;21;0.0227272727272727;0.477272727272727
Control.SRR15539829;52;45;0.442307692307692;29;23;0.0576923076923077;0.442307692307692
Control.SRR15539829;52;45;0.538461538461538;24;28;0.0384615384615384;0.461538461538462
Control.SRR15539829;49;45;0.571428571428571;21;28;0.0714285714285714;0.428571428571429
Control.SRR15539829;41;45;0.658536585365854;14;27;0.158536585365854;0.341463414634146
Control.SRR15539829;44;45;0.477272727272727;23;21;0.0227272727272727;0.477272727272727
Control.SRR15539829;40;45;0.35;26;14;0.15;0.35
Control.SRR15539829;49;45;0.530612244897959;23;26;0.0306122448979592;0.469387755102041
Control.SRR15539829;51;45;0.529411764705882;24;27;0.0294117647058824;0.470588235294118
Control.SRR15539829;49;45;0.571428571428571;21;28;0.0714285714285714;0.428571428571429
Control.SRR15539829;41;45;0.51219512195122;20;21;0.0121951219512195;0.48780487804878
Control.SRR15539829;44;45;0.568181818181818;19;25;0.0681818181818182;0.431818181818182
Control.SRR15539829;46;45;0.565217391304348;20;26;0.0652173913043478;0.434782608695652
Control.SRR15539829;52;45;0.5;26;26;0;0.5
Control.SRR15539829;51;45;0.509803921568627;25;26;0.00980392156862742;0.490196078431373
Control.SRR15539829;50;45;0.5;25;25;0;0.5
Control.SRR15539829;49;45;0.489795918367347;25;24;0.0102040816326531;0.489795918367347
Control.SRR15539829;47;45;0.531914893617021;22;25;0.0319148936170213;0.468085106382979
Control.SRR15539829;44;45;0.477272727272727;23;21;0.0227272727272727;0.477272727272727
Control.SRR15539829;50;45;0.54;23;27;0.04;0.46
Control.SRR15539829;46;45;0.478260869565217;24;22;0.0217391304347826;0.478260869565217
Control.SRR15539829;48;45;0.416666666666667;28;20;0.0833333333333333;0.416666666666667
Control.SRR15539829;49;45;0.530612244897959;23;26;0.0306122448979592;0.469387755102041
Control.SRR15539829;52;45;0.576923076923077;22;30;0.0769230769230769;0.423076923076923
Control.SRR15539829;41;45;0.439024390243902;23;18;0.0609756097560976;0.439024390243902
Control.SRR15539829;51;45;0.529411764705882;24;27;0.0294117647058824;0.470588235294118
Control.SRR15539829;49;45;0.489795918367347;25;24;0.0102040816326531;0.489795918367347
Control.SRR15539829;51;45;0.490196078431373;26;25;0.00980392156862747;0.490196078431373
Control.SRR15539829;45;45;0.377777777777778;28;17;0.122222222222222;0.377777777777778
Control.SRR15539829;47;45;0.446808510638298;26;21;0.0531914893617021;0.446808510638298
Control.SRR15539829;41;45;0.48780487804878;21;20;0.0121951219512195;0.48780487804878
Control.SRR15539829;51;45;0.568627450980392;22;29;0.0686274509803921;0.431372549019608
Control.SRR15539829;44;45;0.272727272727273;32;12;0.227272727272727;0.272727272727273
Control.SRR15539829;51;45;0.549019607843137;23;28;0.0490196078431373;0.450980392156863
Control.SRR15539829;50;45;0.48;26;24;0.02;0.48
Control.SRR15539829;45;45;0.466666666666667;24;21;0.0333333333333333;0.466666666666667
Control.SRR15539829;47;45;0.553191489361702;21;26;0.0531914893617021;0.446808510638298
Control.SRR15539829;44;45;0.5;22;22;0;0.5
Control.SRR15539829;40;45;0.475;21;19;0.025;0.475
Control.SRR15539829;51;45;0.470588235294118;27;24;0.0294117647058824;0.470588235294118
Control.SRR15539829;51;45;0.529411764705882;24;27;0.0294117647058824;0.470588235294118
Control.SRR15539829;50;45;0.58;21;29;0.08;0.42
Control.SRR15539829;52;45;0.5;26;26;0;0.5
Control.SRR15539829;45;45;0.6;18;27;0.1;0.4
Control.SRR15539829;44;45;0.454545454545455;24;20;0.0454545454545455;0.454545454545455
Control.SRR15539829;49;45;0.489795918367347;25;24;0.0102040816326531;0.489795918367347
Control.SRR15539829;43;45;0.465116279069767;23;20;0.0348837209302326;0.465116279069767
Control.SRR15539829;49;45;0.469387755102041;26;23;0.0306122448979592;0.469387755102041
Control.SRR15539829;44;45;0.659090909090909;15;29;0.159090909090909;0.340909090909091
Control.SRR15539829;42;45;0.5;21;21;0;0.5
Control.SRR15539829;52;45;0.692307692307692;16;36;0.192307692307692;0.307692307692308
Control.SRR15539829;52;45;0.384615384615385;32;20;0.115384615384615;0.384615384615385
Control.SRR15539829;47;45;0.468085106382979;25;22;0.0319148936170213;0.468085106382979
Control.SRR15539829;42;45;0.571428571428571;18;24;0.0714285714285714;0.428571428571429
Control.SRR15539829;42;45;0.428571428571429;24;18;0.0714285714285715;0.428571428571429
Control.SRR15539829;50;45;0.42;29;21;0.08;0.42
Control.SRR15539829;42;45;0.523809523809524;20;22;0.0238095238095238;0.476190476190476
Control.SRR15539829;43;45;0.348837209302326;28;15;0.151162790697674;0.348837209302326
Control.SRR15539829;51;45;0.470588235294118;27;24;0.0294117647058824;0.470588235294118
Control.SRR15539829;42;45;0.523809523809524;20;22;0.0238095238095238;0.476190476190476
Control.SRR15539829;49;45;0.469387755102041;26;23;0.0306122448979592;0.469387755102041
Control.SRR15539829;46;45;0.478260869565217;24;22;0.0217391304347826;0.478260869565217
Control.SRR15539829;40;45;0.3;28;12;0.2;0.3
Control.SRR15539829;51;45;0.509803921568627;25;26;0.00980392156862742;0.490196078431373
Control.SRR15539829;52;45;0.519230769230769;25;27;0.0192307692307693;0.480769230769231
Control.SRR15539829;50;45;0.54;23;27;0.04;0.46
Control.SRR15539829;48;45;0.458333333333333;26;22;0.0416666666666667;0.458333333333333
Control.SRR15539829;48;45;0.520833333333333;23;25;0.0208333333333334;0.479166666666667
Control.SRR15539829;51;45;0.450980392156863;28;23;0.0490196078431372;0.450980392156863
Control.SRR15539829;50;45;0.56;22;28;0.0600000000000001;0.44
Control.SRR15539829;46;45;0.565217391304348;20;26;0.0652173913043478;0.434782608695652
Control.SRR15539829;47;45;0.638297872340426;17;30;0.138297872340426;0.361702127659574
Control.SRR15539829;46;45;0.391304347826087;28;18;0.108695652173913;0.391304347826087
Control.SRR15539829;45;45;0.355555555555556;29;16;0.144444444444444;0.355555555555556
Control.SRR15539829;49;45;0.489795918367347;25;24;0.0102040816326531;0.489795918367347
Control.SRR15539829;50;45;0.5;25;25;0;0.5
Control.SRR15539829;52;45;0.5;26;26;0;0.5
Control.SRR15539829;44;45;0.5;22;22;0;0.5
Control.SRR15539829;48;45;0.625;18;30;0.125;0.375
Control.SRR15539829;44;45;0.454545454545455;24;20;0.0454545454545455;0.454545454545455
Control.SRR15539829;50;45;0.5;25;25;0;0.5
Control.SRR15539829;42;45;0.619047619047619;16;26;0.119047619047619;0.380952380952381
Control.SRR15539829;48;45;0.625;18;30;0.125;0.375
Control.SRR15539829;51;45;0.509803921568627;25;26;0.00980392156862742;0.490196078431373
Control.SRR15539829;45;45;0.422222222222222;26;19;0.0777777777777778;0.422222222222222
Control.SRR15539829;48;45;0.291666666666667;34;14;0.208333333333333;0.291666666666667
Control.SRR15539829;47;45;0.531914893617021;22;25;0.0319148936170213;0.468085106382979
Control.SRR15539829;42;45;0.404761904761905;25;17;0.0952380952380952;0.404761904761905
Control.SRR15539829;41;45;0.365853658536585;26;15;0.134146341463415;0.365853658536585
Control.SRR15539829;41;45;0.463414634146341;22;19;0.0365853658536585;0.463414634146341
Control.SRR15539829;46;45;0.543478260869565;21;25;0.0434782608695652;0.456521739130435
Control.SRR15539829;47;45;0.531914893617021;22;25;0.0319148936170213;0.468085106382979
Control.SRR15539829;46;45;0.434782608695652;26;20;0.0652173913043478;0.434782608695652
Control.SRR15539829;40;45;0.525;19;21;0.025;0.475
Control.SRR15539829;46;45;0.5;23;23;0;0.5
Control.SRR15539829;47;45;0.425531914893617;27;20;0.074468085106383;0.425531914893617
Control.SRR15539829;51;45;0.294117647058824;36;15;0.205882352941176;0.294117647058824
Control.SRR15539829;50;45;0.44;28;22;0.06;0.44
Control.SRR15539829;46;45;0.543478260869565;21;25;0.0434782608695652;0.456521739130435
Control.SRR15539829;40;45;0.45;22;18;0.05;0.45
Control.SRR15539829;45;45;0.555555555555556;20;25;0.0555555555555556;0.444444444444444
Control.SRR15539829;47;45;0.553191489361702;21;26;0.0531914893617021;0.446808510638298
Control.SRR15539829;51;45;0.431372549019608;29;22;0.0686274509803921;0.431372549019608
Control.SRR15539829;47;45;0.48936170212766;24;23;0.0106382978723404;0.48936170212766
Control.SRR15539829;48;45;0.479166666666667;25;23;0.0208333333333333;0.479166666666667
Control.SRR15539829;45;45;0.533333333333333;21;24;0.0333333333333333;0.466666666666667
Control.SRR15539829;49;45;0.489795918367347;25;24;0.0102040816326531;0.489795918367347
Control.SRR15539829;50;45;0.58;21;29;0.08;0.42
Control.SRR15539829;44;45;0.431818181818182;25;19;0.0681818181818182;0.431818181818182
Control.SRR15539829;43;45;0.302325581395349;30;13;0.197674418604651;0.302325581395349
Control.SRR15539829;50;45;0.6;20;30;0.1;0.4
Control.SRR15539829;52;45;0.519230769230769;25;27;0.0192307692307693;0.480769230769231
Control.SRR15539829;50;45;0.46;27;23;0.04;0.46
Control.SRR15539829;41;45;0.439024390243902;23;18;0.0609756097560976;0.439024390243902
Control.SRR15539829;52;45;0.596153846153846;21;31;0.0961538461538461;0.403846153846154
Control.SRR15539829;46;45;0.41304347826087;27;19;0.0869565217391304;0.41304347826087
Control.SRR15539829;42;45;0.595238095238095;17;25;0.0952380952380952;0.404761904761905
Control.SRR15539829;47;45;0.531914893617021;22;25;0.0319148936170213;0.468085106382979
Control.SRR15539829;51;45;0.549019607843137;23;28;0.0490196078431373;0.450980392156863
Control.SRR15539829;49;45;0.428571428571429;28;21;0.0714285714285715;0.428571428571429
Control.SRR15539829;45;45;0.488888888888889;23;22;0.0111111111111111;0.488888888888889
Control.SRR15539829;47;45;0.574468085106383;20;27;0.074468085106383;0.425531914893617
Control.SRR15539829;50;45;0.62;19;31;0.12;0.38
Control.SRR15539829;47;45;0.51063829787234;23;24;0.0106382978723404;0.48936170212766
Control.SRR15539829;45;45;0.511111111111111;22;23;0.0111111111111111;0.488888888888889
Control.SRR15539829;42;45;0.5;21;21;0;0.5
Control.SRR15539829;48;45;0.5;24;24;0;0.5
Control.SRR15539829;44;45;0.522727272727273;21;23;0.0227272727272727;0.477272727272727
Control.SRR15539829;50;45;0.5;25;25;0;0.5
Control.SRR15539829;48;45;0.541666666666667;22;26;0.0416666666666666;0.458333333333333
Control.SRR15539829;48;45;0.416666666666667;28;20;0.0833333333333333;0.416666666666667
Control.SRR15539829;49;45;0.510204081632653;24;25;0.0102040816326531;0.489795918367347
Control.SRR15539829;49;45;0.63265306122449;18;31;0.13265306122449;0.36734693877551
Control.SRR15539829;43;45;0.488372093023256;22;21;0.0116279069767442;0.488372093023256
Control.SRR15539829;50;45;0.5;25;25;0;0.5
Control.SRR15539829;44;45;0.590909090909091;18;26;0.0909090909090909;0.409090909090909
Control.SRR15539829;42;45;0.523809523809524;20;22;0.0238095238095238;0.476190476190476
Control.SRR15539829;52;45;0.384615384615385;32;20;0.115384615384615;0.384615384615385
Control.SRR15539829;44;45;0.454545454545455;24;20;0.0454545454545455;0.454545454545455
Control.SRR15539829;40;45;0.55;18;22;0.05;0.45
Control.SRR15539829;45;45;0.622222222222222;17;28;0.122222222222222;0.377777777777778
Control.SRR15539829;45;45;0.577777777777778;19;26;0.0777777777777777;0.422222222222222
Control.SRR15539829;41;45;0.341463414634146;27;14;0.158536585365854;0.341463414634146
Control.SRR15539829;40;45;0.475;21;19;0.025;0.475
Control.SRR15539829;51;45;0.568627450980392;22;29;0.0686274509803921;0.431372549019608
Control.SRR15539829;52;45;0.384615384615385;32;20;0.115384615384615;0.384615384615385
Control.SRR15539829;46;45;0.5;23;23;0;0.5
Control.SRR15539829;46;45;0.369565217391304;29;17;0.130434782608696;0.369565217391304
Control.SRR15539829;41;45;0.585365853658537;17;24;0.0853658536585366;0.414634146341463
Control.SRR15539829;51;45;0.607843137254902;20;31;0.107843137254902;0.392156862745098
Control.SRR15539829;51;45;0.509803921568627;25;26;0.00980392156862742;0.490196078431373
Control.SRR15539829;51;45;0.392156862745098;31;20;0.107843137254902;0.392156862745098
Control.SRR15539829;44;45;0.477272727272727;23;21;0.0227272727272727;0.477272727272727
Control.SRR15539829;41;45;0.390243902439024;25;16;0.109756097560976;0.390243902439024
Control.SRR15539829;41;45;0.48780487804878;21;20;0.0121951219512195;0.48780487804878
Control.SRR15539829;45;45;0.533333333333333;21;24;0.0333333333333333;0.466666666666667
Control.SRR15539829;45;45;0.444444444444444;25;20;0.0555555555555556;0.444444444444444
Control.SRR15539829;42;45;0.428571428571429;24;18;0.0714285714285715;0.428571428571429
Control.SRR15539829;47;45;0.361702127659574;30;17;0.138297872340426;0.361702127659574
Control.SRR15539829;54;45;0.537037037037037;25;29;0.0370370370370371;0.462962962962963
Control.SRR15539829;43;45;0.581395348837209;18;25;0.0813953488372093;0.418604651162791
Control.SRR15539829;41;45;0.560975609756098;18;23;0.0609756097560976;0.439024390243902
Control.SRR15539829;47;45;0.48936170212766;24;23;0.0106382978723404;0.48936170212766
Control.SRR15539829;51;45;0.568627450980392;22;29;0.0686274509803921;0.431372549019608
Control.SRR15539829;54;45;0.555555555555556;24;30;0.0555555555555556;0.444444444444444
Control.SRR15539829;42;45;0.380952380952381;26;16;0.119047619047619;0.380952380952381
Control.SRR15539829;43;45;0.604651162790698;17;26;0.104651162790698;0.395348837209302
Control.SRR15539829;48;45;0.625;18;30;0.125;0.375
Control.SRR15539829;50;45;0.42;29;21;0.08;0.42
Control.SRR15539829;46;45;0.456521739130435;25;21;0.0434782608695652;0.456521739130435
Control.SRR15539829;43;45;0.627906976744186;16;27;0.127906976744186;0.372093023255814
Control.SRR15539829;50;45;0.46;27;23;0.04;0.46
Control.SRR15539829;45;45;0.622222222222222;17;28;0.122222222222222;0.377777777777778
Control.SRR15539829;54;45;0.592592592592593;22;32;0.0925925925925926;0.407407407407407
Control.SRR15539829;48;45;0.4375;27;21;0.0625;0.4375
Control.SRR15539829;41;45;0.585365853658537;17;24;0.0853658536585366;0.414634146341463
Control.SRR15539829;40;45;0.425;23;17;0.075;0.425
Control.SRR15539829;42;45;0.571428571428571;18;24;0.0714285714285714;0.428571428571429
Control.SRR15539829;46;45;0.5;23;23;0;0.5
Control.SRR15539829;49;45;0.530612244897959;23;26;0.0306122448979592;0.469387755102041
Control.SRR15539829;52;45;0.576923076923077;22;30;0.0769230769230769;0.423076923076923
Control.SRR15539829;51;45;0.431372549019608;29;22;0.0686274509803921;0.431372549019608
Control.SRR15539829;53;45;0.471698113207547;28;25;0.0283018867924528;0.471698113207547
Control.SRR15539829;54;45;0.518518518518518;26;28;0.0185185185185185;0.481481481481481
Control.SRR15539829;40;45;0.4;24;16;0.1;0.4
Control.SRR15539829;44;45;0.409090909090909;26;18;0.0909090909090909;0.409090909090909
Control.SRR15539829;54;45;0.444444444444444;30;24;0.0555555555555556;0.444444444444444
Control.SRR15539829;41;45;0.536585365853659;19;22;0.0365853658536586;0.463414634146341
Control.SRR15539829;46;45;0.456521739130435;25;21;0.0434782608695652;0.456521739130435
Control.SRR15539829;46;45;0.391304347826087;28;18;0.108695652173913;0.391304347826087
Control.SRR15539829;42;45;0.5;21;21;0;0.5
Control.SRR15539829;50;45;0.42;29;21;0.08;0.42
Control.SRR15539829;41;45;0.414634146341463;24;17;0.0853658536585366;0.414634146341463
Control.SRR15539829;45;45;0.533333333333333;21;24;0.0333333333333333;0.466666666666667
Control.SRR15539829;40;45;0.425;23;17;0.075;0.425
Control.SRR15539829;43;45;0.627906976744186;16;27;0.127906976744186;0.372093023255814
Control.SRR15539829;42;45;0.595238095238095;17;25;0.0952380952380952;0.404761904761905
Control.SRR15539829;43;45;0.488372093023256;22;21;0.0116279069767442;0.488372093023256
Control.SRR15539829;44;45;0.522727272727273;21;23;0.0227272727272727;0.477272727272727
Control.SRR15539829;41;45;0.414634146341463;24;17;0.0853658536585366;0.414634146341463
Control.SRR15539829;43;45;0.581395348837209;18;25;0.0813953488372093;0.418604651162791
Control.SRR15539829;43;45;0.488372093023256;22;21;0.0116279069767442;0.488372093023256
Control.SRR15539829;41;45;0.51219512195122;20;21;0.0121951219512195;0.48780487804878
Control.SRR15539829;47;45;0.51063829787234;23;24;0.0106382978723404;0.48936170212766
Control.SRR15539829;54;45;0.592592592592593;22;32;0.0925925925925926;0.407407407407407
Control.SRR15539829;54;45;0.685185185185185;17;37;0.185185185185185;0.314814814814815
Control.SRR15539829;53;45;0.39622641509434;32;21;0.10377358490566;0.39622641509434
Control.SRR15539829;48;45;0.541666666666667;22;26;0.0416666666666666;0.458333333333333
Control.SRR15539829;49;45;0.469387755102041;26;23;0.0306122448979592;0.469387755102041
Control.SRR15539829;52;45;0.442307692307692;29;23;0.0576923076923077;0.442307692307692
Control.SRR15539829;47;45;0.425531914893617;27;20;0.074468085106383;0.425531914893617
Control.SRR15539829;41;45;0.414634146341463;24;17;0.0853658536585366;0.414634146341463
Control.SRR15539829;53;45;0.377358490566038;33;20;0.122641509433962;0.377358490566038
Control.SRR15539829;51;45;0.686274509803922;16;35;0.186274509803922;0.313725490196078
Control.SRR15539829;50;45;0.38;31;19;0.12;0.38
Control.SRR15539829;46;45;0.456521739130435;25;21;0.0434782608695652;0.456521739130435
Control.SRR15539829;50;45;0.48;26;24;0.02;0.48
Control.SRR15539829;44;45;0.386363636363636;27;17;0.113636363636364;0.386363636363636
Control.SRR15539829;40;45;0.525;19;21;0.025;0.475
Control.SRR15539829;43;45;0.418604651162791;25;18;0.0813953488372093;0.418604651162791
Control.SRR15539829;40;45;0.6;16;24;0.1;0.4
Control.SRR15539829;48;45;0.604166666666667;19;29;0.104166666666667;0.395833333333333
Control.SRR15539829;49;45;0.510204081632653;24;25;0.0102040816326531;0.489795918367347
Control.SRR15539829;47;45;0.382978723404255;29;18;0.117021276595745;0.382978723404255
Control.SRR15539829;47;45;0.617021276595745;18;29;0.117021276595745;0.382978723404255
Control.SRR15539829;42;45;0.380952380952381;26;16;0.119047619047619;0.380952380952381
Control.SRR15539829;49;45;0.489795918367347;25;24;0.0102040816326531;0.489795918367347
Control.SRR15539829;48;45;0.520833333333333;23;25;0.0208333333333334;0.479166666666667
Control.SRR15539829;51;45;0.588235294117647;21;30;0.0882352941176471;0.411764705882353
Control.SRR15539829;47;45;0.468085106382979;25;22;0.0319148936170213;0.468085106382979
Control.SRR15539829;48;45;0.5;24;24;0;0.5
Control.SRR15539829;44;45;0.5;22;22;0;0.5
Control.SRR15539829;46;45;0.456521739130435;25;21;0.0434782608695652;0.456521739130435
Control.SRR15539829;51;45;0.549019607843137;23;28;0.0490196078431373;0.450980392156863
Control.SRR15539829;48;45;0.395833333333333;29;19;0.104166666666667;0.395833333333333
Control.SRR15539829;52;45;0.615384615384615;20;32;0.115384615384615;0.384615384615385
Control.SRR15539829;45;45;0.4;27;18;0.1;0.4
Control.SRR15539829;40;45;0.45;22;18;0.05;0.45
Control.SRR15539829;42;45;0.547619047619048;19;23;0.0476190476190477;0.452380952380952
Control.SRR15539829;44;45;0.659090909090909;15;29;0.159090909090909;0.340909090909091
Control.SRR15539829;46;45;0.391304347826087;28;18;0.108695652173913;0.391304347826087
Control.SRR15539829;42;45;0.619047619047619;16;26;0.119047619047619;0.380952380952381
Control.SRR15539829;50;45;0.58;21;29;0.08;0.42
Control.SRR15539829;46;45;0.391304347826087;28;18;0.108695652173913;0.391304347826087
Control.SRR15539829;41;45;0.560975609756098;18;23;0.0609756097560976;0.439024390243902
Control.SRR15539829;49;45;0.448979591836735;27;22;0.0510204081632653;0.448979591836735
Control.SRR15539829;47;45;0.553191489361702;21;26;0.0531914893617021;0.446808510638298
Control.SRR15539829;45;45;0.4;27;18;0.1;0.4
Control.SRR15539829;45;45;0.511111111111111;22;23;0.0111111111111111;0.488888888888889
Control.SRR15539829;48;45;0.625;18;30;0.125;0.375
Control.SRR15539829;52;45;0.519230769230769;25;27;0.0192307692307693;0.480769230769231
Control.SRR15539829;54;45;0.5;27;27;0;0.5
Control.SRR15539829;47;45;0.531914893617021;22;25;0.0319148936170213;0.468085106382979
Control.SRR15539829;47;45;0.340425531914894;31;16;0.159574468085106;0.340425531914894
Control.SRR15539829;48;45;0.520833333333333;23;25;0.0208333333333334;0.479166666666667
Control.SRR15539829;53;45;0.490566037735849;27;26;0.00943396226415094;0.490566037735849
Control.SRR15539829;49;45;0.489795918367347;25;24;0.0102040816326531;0.489795918367347
Control.SRR15539829;40;45;0.6;16;24;0.1;0.4
Control.SRR15539829;42;45;0.476190476190476;22;20;0.0238095238095238;0.476190476190476
Control.SRR15539829;51;45;0.431372549019608;29;22;0.0686274509803921;0.431372549019608
Control.SRR15539829;48;45;0.520833333333333;23;25;0.0208333333333334;0.479166666666667
Control.SRR15539829;41;45;0.365853658536585;26;15;0.134146341463415;0.365853658536585
Control.SRR15539829;47;45;0.574468085106383;20;27;0.074468085106383;0.425531914893617
Control.SRR15539829;41;45;0.463414634146341;22;19;0.0365853658536585;0.463414634146341
Control.SRR15539829;45;45;0.555555555555556;20;25;0.0555555555555556;0.444444444444444
Control.SRR15539829;51;45;0.549019607843137;23;28;0.0490196078431373;0.450980392156863
Control.SRR15539829;52;45;0.557692307692308;23;29;0.0576923076923077;0.442307692307692
Control.SRR15539829;47;45;0.425531914893617;27;20;0.074468085106383;0.425531914893617
Control.SRR15539829;45;45;0.622222222222222;17;28;0.122222222222222;0.377777777777778
Control.SRR15539829;47;45;0.595744680851064;19;28;0.0957446808510638;0.404255319148936
Control.SRR15539829;44;45;0.568181818181818;19;25;0.0681818181818182;0.431818181818182
Control.SRR15539829;44;45;0.568181818181818;19;25;0.0681818181818182;0.431818181818182
Control.SRR15539829;43;45;0.465116279069767;23;20;0.0348837209302326;0.465116279069767
Control.SRR15539829;45;45;0.444444444444444;25;20;0.0555555555555556;0.444444444444444
Control.SRR15539829;41;45;0.48780487804878;21;20;0.0121951219512195;0.48780487804878
Control.SRR15539829;48;45;0.416666666666667;28;20;0.0833333333333333;0.416666666666667
Control.SRR15539829;41;45;0.585365853658537;17;24;0.0853658536585366;0.414634146341463
Control.SRR15539829;47;45;0.404255319148936;28;19;0.0957446808510639;0.404255319148936
Control.SRR15539829;42;45;0.523809523809524;20;22;0.0238095238095238;0.476190476190476
Control.SRR15539829;52;45;0.673076923076923;17;35;0.173076923076923;0.326923076923077
Control.SRR15539829;52;45;0.519230769230769;25;27;0.0192307692307693;0.480769230769231
Control.SRR15539829;54;45;0.462962962962963;29;25;0.037037037037037;0.462962962962963
Control.SRR15539829;49;45;0.428571428571429;28;21;0.0714285714285715;0.428571428571429
Control.SRR15539829;43;45;0.465116279069767;23;20;0.0348837209302326;0.465116279069767
Control.SRR15539829;45;45;0.622222222222222;17;28;0.122222222222222;0.377777777777778
Control.SRR15539829;47;45;0.617021276595745;18;29;0.117021276595745;0.382978723404255
Control.SRR15539829;47;45;0.574468085106383;20;27;0.074468085106383;0.425531914893617
Control.SRR15539829;53;45;0.528301886792453;25;28;0.0283018867924528;0.471698113207547
Control.SRR15539829;50;45;0.44;28;22;0.06;0.44
Control.SRR15539829;45;45;0.377777777777778;28;17;0.122222222222222;0.377777777777778
Control.SRR15539829;50;45;0.56;22;28;0.0600000000000001;0.44
Control.SRR15539829;52;45;0.480769230769231;27;25;0.0192307692307692;0.480769230769231
Control.SRR15539829;50;45;0.62;19;31;0.12;0.38
Control.SRR15539829;50;45;0.46;27;23;0.04;0.46
Control.SRR15539829;46;45;0.521739130434783;22;24;0.0217391304347826;0.478260869565217
Control.SRR15539829;45;45;0.444444444444444;25;20;0.0555555555555556;0.444444444444444
Control.SRR15539829;54;45;0.537037037037037;25;29;0.0370370370370371;0.462962962962963
Control.SRR15539829;50;45;0.42;29;21;0.08;0.42
Control.SRR15539829;44;45;0.431818181818182;25;19;0.0681818181818182;0.431818181818182
Control.SRR15539829;41;45;0.51219512195122;20;21;0.0121951219512195;0.48780487804878
Control.SRR15539829;42;45;0.547619047619048;19;23;0.0476190476190477;0.452380952380952
Control.SRR15539829;44;45;0.477272727272727;23;21;0.0227272727272727;0.477272727272727
Control.SRR15539829;45;45;0.355555555555556;29;16;0.144444444444444;0.355555555555556
Control.SRR15539829;45;45;0.533333333333333;21;24;0.0333333333333333;0.466666666666667
Control.SRR15539829;50;45;0.48;26;24;0.02;0.48
Control.SRR15539829;45;45;0.577777777777778;19;26;0.0777777777777777;0.422222222222222
Control.SRR15539829;46;45;0.543478260869565;21;25;0.0434782608695652;0.456521739130435
Control.SRR15539829;48;45;0.645833333333333;17;31;0.145833333333333;0.354166666666667
Control.SRR15539829;47;45;0.51063829787234;23;24;0.0106382978723404;0.48936170212766
Control.SRR15539829;44;45;0.613636363636364;17;27;0.113636363636364;0.386363636363636
Control.SRR15539829;48;45;0.583333333333333;20;28;0.0833333333333334;0.416666666666667
Control.SRR15539829;49;45;0.571428571428571;21;28;0.0714285714285714;0.428571428571429
Control.SRR15539829;50;45;0.52;24;26;0.02;0.48
Control.SRR15539829;50;45;0.5;25;25;0;0.5
Control.SRR15539829;54;45;0.425925925925926;31;23;0.0740740740740741;0.425925925925926
Control.SRR15539829;51;45;0.490196078431373;26;25;0.00980392156862747;0.490196078431373
Control.SRR15539829;40;45;0.625;15;25;0.125;0.375
Control.SRR15539829;44;45;0.568181818181818;19;25;0.0681818181818182;0.431818181818182
Control.SRR15539829;46;45;0.608695652173913;18;28;0.108695652173913;0.391304347826087
Control.SRR15539829;48;45;0.5625;21;27;0.0625;0.4375
Control.SRR15539829;40;45;0.475;21;19;0.025;0.475
Control.SRR15539829;48;45;0.520833333333333;23;25;0.0208333333333334;0.479166666666667
Control.SRR15539829;47;45;0.553191489361702;21;26;0.0531914893617021;0.446808510638298
Control.SRR15539829;49;45;0.551020408163265;22;27;0.0510204081632653;0.448979591836735
Control.SRR15539829;41;45;0.439024390243902;23;18;0.0609756097560976;0.439024390243902
Control.SRR15539829;46;45;0.5;23;23;0;0.5
Control.SRR15539829;49;45;0.530612244897959;23;26;0.0306122448979592;0.469387755102041
Control.SRR15539829;46;45;0.478260869565217;24;22;0.0217391304347826;0.478260869565217
Control.SRR15539829;43;45;0.604651162790698;17;26;0.104651162790698;0.395348837209302
Control.SRR15539829;52;45;0.596153846153846;21;31;0.0961538461538461;0.403846153846154
Control.SRR15539829;43;45;0.558139534883721;19;24;0.0581395348837209;0.441860465116279
Control.SRR15539829;52;45;0.5;26;26;0;0.5
Control.SRR15539829;54;45;0.444444444444444;30;24;0.0555555555555556;0.444444444444444
Control.SRR15539829;46;45;0.58695652173913;19;27;0.0869565217391305;0.41304347826087
Control.SRR15539829;42;45;0.523809523809524;20;22;0.0238095238095238;0.476190476190476
Control.SRR15539829;42;45;0.571428571428571;18;24;0.0714285714285714;0.428571428571429
Control.SRR15539829;41;45;0.51219512195122;20;21;0.0121951219512195;0.48780487804878
Control.SRR15539829;41;45;0.585365853658537;17;24;0.0853658536585366;0.414634146341463
Control.SRR15539829;50;45;0.48;26;24;0.02;0.48
Control.SRR15539829;53;45;0.622641509433962;20;33;0.122641509433962;0.377358490566038
Control.SRR15539829;51;45;0.431372549019608;29;22;0.0686274509803921;0.431372549019608
Control.SRR15539829;44;45;0.522727272727273;21;23;0.0227272727272727;0.477272727272727
Control.SRR15539829;42;45;0.476190476190476;22;20;0.0238095238095238;0.476190476190476
Control.SRR15539829;45;45;0.666666666666667;15;30;0.166666666666667;0.333333333333333
Control.SRR15539829;47;45;0.531914893617021;22;25;0.0319148936170213;0.468085106382979
Control.SRR15539829;46;45;0.565217391304348;20;26;0.0652173913043478;0.434782608695652
Control.SRR15539829;48;45;0.520833333333333;23;25;0.0208333333333334;0.479166666666667
Control.SRR15539829;45;45;0.622222222222222;17;28;0.122222222222222;0.377777777777778
Control.SRR15539829;44;45;0.568181818181818;19;25;0.0681818181818182;0.431818181818182
Control.SRR15539829;43;45;0.488372093023256;22;21;0.0116279069767442;0.488372093023256
Control.SRR15539829;43;45;0.558139534883721;19;24;0.0581395348837209;0.441860465116279
Control.SRR15539829;52;45;0.423076923076923;30;22;0.0769230769230769;0.423076923076923
Control.SRR15539829;46;45;0.434782608695652;26;20;0.0652173913043478;0.434782608695652
Control.SRR15539829;46;45;0.521739130434783;22;24;0.0217391304347826;0.478260869565217
Control.SRR15539829;54;45;0.5;27;27;0;0.5
Control.SRR15539829;40;45;0.575;17;23;0.075;0.425
Control.SRR15539829;48;45;0.416666666666667;28;20;0.0833333333333333;0.416666666666667
Control.SRR15539829;42;45;0.5;21;21;0;0.5
Control.SRR15539829;43;45;0.534883720930233;20;23;0.0348837209302325;0.465116279069767
Control.SRR15539829;44;45;0.613636363636364;17;27;0.113636363636364;0.386363636363636
Control.SRR15539829;44;45;0.590909090909091;18;26;0.0909090909090909;0.409090909090909
Control.SRR15539829;54;45;0.425925925925926;31;23;0.0740740740740741;0.425925925925926
Control.SRR15539829;46;45;0.521739130434783;22;24;0.0217391304347826;0.478260869565217
Control.SRR15539829;45;45;0.533333333333333;21;24;0.0333333333333333;0.466666666666667
Control.SRR15539829;47;45;0.48936170212766;24;23;0.0106382978723404;0.48936170212766
Control.SRR15539829;44;45;0.477272727272727;23;21;0.0227272727272727;0.477272727272727
Control.SRR15539829;43;45;0.558139534883721;19;24;0.0581395348837209;0.441860465116279
Control.SRR15539829;41;45;0.463414634146341;22;19;0.0365853658536585;0.463414634146341
Control.SRR15539829;40;45;0.45;22;18;0.05;0.45
Control.SRR15539829;46;45;0.58695652173913;19;27;0.0869565217391305;0.41304347826087
Control.SRR15539829;41;45;0.634146341463415;15;26;0.134146341463415;0.365853658536585
Control.SRR15539829;46;45;0.543478260869565;21;25;0.0434782608695652;0.456521739130435
Control.SRR15539829;45;45;0.622222222222222;17;28;0.122222222222222;0.377777777777778
Control.SRR15539829;53;45;0.415094339622642;31;22;0.0849056603773585;0.415094339622642
Control.SRR15539829;49;45;0.510204081632653;24;25;0.0102040816326531;0.489795918367347
Control.SRR15539829;49;45;0.571428571428571;21;28;0.0714285714285714;0.428571428571429
Control.SRR15539829;52;45;0.480769230769231;27;25;0.0192307692307692;0.480769230769231
Control.SRR15539829;50;45;0.48;26;24;0.02;0.48
Control.SRR15539829;42;45;0.452380952380952;23;19;0.0476190476190476;0.452380952380952
Control.SRR15539829;43;45;0.395348837209302;26;17;0.104651162790698;0.395348837209302
Control.SRR15539829;44;45;0.522727272727273;21;23;0.0227272727272727;0.477272727272727
Control.SRR15539829;45;45;0.288888888888889;32;13;0.211111111111111;0.288888888888889
Control.SRR15539829;44;45;0.5;22;22;0;0.5
Control.SRR15539829;53;45;0.60377358490566;21;32;0.10377358490566;0.39622641509434
Control.SRR15539829;50;45;0.56;22;28;0.0600000000000001;0.44
Control.SRR15539829;50;45;0.42;29;21;0.08;0.42
Control.SRR15539829;40;45;0.4;24;16;0.1;0.4
Control.SRR15539829;48;45;0.4375;27;21;0.0625;0.4375
Control.SRR15539829;53;45;0.641509433962264;19;34;0.141509433962264;0.358490566037736
Control.SRR15539829;47;45;0.404255319148936;28;19;0.0957446808510639;0.404255319148936
Control.SRR15539829;45;45;0.444444444444444;25;20;0.0555555555555556;0.444444444444444
Control.SRR15539829;42;45;0.452380952380952;23;19;0.0476190476190476;0.452380952380952
Control.SRR15539829;42;45;0.571428571428571;18;24;0.0714285714285714;0.428571428571429
Control.SRR15539829;50;45;0.52;24;26;0.02;0.48
Control.SRR15539829;42;45;0.547619047619048;19;23;0.0476190476190477;0.452380952380952
Control.SRR15539829;54;45;0.462962962962963;29;25;0.037037037037037;0.462962962962963
Control.SRR15539829;51;45;0.509803921568627;25;26;0.00980392156862742;0.490196078431373
Control.SRR15539829;43;45;0.465116279069767;23;20;0.0348837209302326;0.465116279069767
Control.SRR15539829;46;45;0.5;23;23;0;0.5
Control.SRR15539829;51;45;0.588235294117647;21;30;0.0882352941176471;0.411764705882353
Control.SRR15539829;44;45;0.522727272727273;21;23;0.0227272727272727;0.477272727272727
Control.SRR15539829;47;45;0.361702127659574;30;17;0.138297872340426;0.361702127659574
Control.SRR15539829;40;45;0.225;31;9;0.275;0.225
Control.SRR15539829;44;45;0.522727272727273;21;23;0.0227272727272727;0.477272727272727
Control.SRR15539829;49;45;0.551020408163265;22;27;0.0510204081632653;0.448979591836735
Control.SRR15539829;50;45;0.48;26;24;0.02;0.48
Control.SRR15539829;52;45;0.461538461538462;28;24;0.0384615384615384;0.461538461538462
Control.SRR15539829;41;45;0.341463414634146;27;14;0.158536585365854;0.341463414634146
Control.SRR15539829;49;45;0.530612244897959;23;26;0.0306122448979592;0.469387755102041
Control.SRR15539829;45;45;0.577777777777778;19;26;0.0777777777777777;0.422222222222222
Control.SRR15539829;40;45;0.4;24;16;0.1;0.4
Control.SRR15539829;52;45;0.519230769230769;25;27;0.0192307692307693;0.480769230769231
Control.SRR15539829;50;45;0.48;26;24;0.02;0.48
Control.SRR15539829;52;45;0.5;26;26;0;0.5
Control.SRR15539829;49;45;0.448979591836735;27;22;0.0510204081632653;0.448979591836735
Control.SRR15539829;44;45;0.613636363636364;17;27;0.113636363636364;0.386363636363636
Control.SRR15539829;40;45;0.55;18;22;0.05;0.45
Control.SRR15539829;49;45;0.571428571428571;21;28;0.0714285714285714;0.428571428571429
Control.SRR15539829;40;45;0.675;13;27;0.175;0.325
Control.SRR15539829;40;45;0.425;23;17;0.075;0.425
Control.SRR15539829;45;45;0.488888888888889;23;22;0.0111111111111111;0.488888888888889
Control.SRR15539829;43;45;0.534883720930233;20;23;0.0348837209302325;0.465116279069767
Control.SRR15539829;43;45;0.465116279069767;23;20;0.0348837209302326;0.465116279069767
Control.SRR15539829;42;45;0.5;21;21;0;0.5
Control.SRR15539829;47;45;0.468085106382979;25;22;0.0319148936170213;0.468085106382979
Control.SRR15539829;43;45;0.511627906976744;21;22;0.0116279069767442;0.488372093023256
Control.SRR15539829;42;45;0.428571428571429;24;18;0.0714285714285715;0.428571428571429
Control.SRR15539829;43;45;0.488372093023256;22;21;0.0116279069767442;0.488372093023256
Control.SRR15539829;46;45;0.608695652173913;18;28;0.108695652173913;0.391304347826087
Control.SRR15539829;47;45;0.531914893617021;22;25;0.0319148936170213;0.468085106382979
Control.SRR15539829;48;45;0.5625;21;27;0.0625;0.4375
Control.SRR15539829;46;45;0.521739130434783;22;24;0.0217391304347826;0.478260869565217
Control.SRR15539829;49;45;0.571428571428571;21;28;0.0714285714285714;0.428571428571429
Control.SRR15539829;46;45;0.456521739130435;25;21;0.0434782608695652;0.456521739130435
Control.SRR15539829;46;45;0.608695652173913;18;28;0.108695652173913;0.391304347826087
Control.SRR15539829;42;45;0.476190476190476;22;20;0.0238095238095238;0.476190476190476
Control.SRR15539829;42;45;0.595238095238095;17;25;0.0952380952380952;0.404761904761905
Control.SRR15539829;45;45;0.488888888888889;23;22;0.0111111111111111;0.488888888888889
Control.SRR15539829;45;45;0.466666666666667;24;21;0.0333333333333333;0.466666666666667
Control.SRR15539829;50;45;0.52;24;26;0.02;0.48
Control.SRR15539829;54;45;0.537037037037037;25;29;0.0370370370370371;0.462962962962963
Control.SRR15539829;43;45;0.441860465116279;24;19;0.0581395348837209;0.441860465116279
Control.SRR15539829;46;45;0.521739130434783;22;24;0.0217391304347826;0.478260869565217
Control.SRR15539829;40;45;0.525;19;21;0.025;0.475
Control.SRR15539829;52;45;0.442307692307692;29;23;0.0576923076923077;0.442307692307692
Control.SRR15539829;46;45;0.434782608695652;26;20;0.0652173913043478;0.434782608695652
Control.SRR15539829;49;45;0.530612244897959;23;26;0.0306122448979592;0.469387755102041
Control.SRR15539829;49;45;0.408163265306122;29;20;0.0918367346938775;0.408163265306122
Control.SRR15539829;43;45;0.465116279069767;23;20;0.0348837209302326;0.465116279069767
Control.SRR15539829;47;45;0.51063829787234;23;24;0.0106382978723404;0.48936170212766
Control.SRR15539829;47;45;0.382978723404255;29;18;0.117021276595745;0.382978723404255
Control.SRR15539829;50;45;0.62;19;31;0.12;0.38
Control.SRR15539829;47;45;0.553191489361702;21;26;0.0531914893617021;0.446808510638298
Control.SRR15539829;51;45;0.568627450980392;22;29;0.0686274509803921;0.431372549019608
Control.SRR15539829;50;45;0.4;30;20;0.1;0.4
Control.SRR15539829;43;45;0.395348837209302;26;17;0.104651162790698;0.395348837209302
Control.SRR15539829;50;45;0.46;27;23;0.04;0.46
Control.SRR15539829;50;45;0.44;28;22;0.06;0.44
Control.SRR15539829;45;45;0.4;27;18;0.1;0.4
Control.SRR15539829;50;45;0.42;29;21;0.08;0.42
Control.SRR15539829;45;45;0.577777777777778;19;26;0.0777777777777777;0.422222222222222
Control.SRR15539829;51;45;0.431372549019608;29;22;0.0686274509803921;0.431372549019608
Control.SRR15539829;48;45;0.479166666666667;25;23;0.0208333333333333;0.479166666666667
Control.SRR15539829;42;45;0.547619047619048;19;23;0.0476190476190477;0.452380952380952
Control.SRR15539829;44;45;0.454545454545455;24;20;0.0454545454545455;0.454545454545455
Control.SRR15539829;51;45;0.470588235294118;27;24;0.0294117647058824;0.470588235294118
Control.SRR15539829;50;45;0.54;23;27;0.04;0.46
Control.SRR15539829;40;45;0.475;21;19;0.025;0.475
Control.SRR15539829;51;45;0.392156862745098;31;20;0.107843137254902;0.392156862745098
Control.SRR15539829;44;45;0.409090909090909;26;18;0.0909090909090909;0.409090909090909
Control.SRR15539829;45;45;0.444444444444444;25;20;0.0555555555555556;0.444444444444444
Control.SRR15539829;40;45;0.525;19;21;0.025;0.475
Control.SRR15539829;54;45;0.555555555555556;24;30;0.0555555555555556;0.444444444444444
Control.SRR15539829;49;45;0.63265306122449;18;31;0.13265306122449;0.36734693877551
Control.SRR15539829;54;45;0.592592592592593;22;32;0.0925925925925926;0.407407407407407
Control.SRR15539829;44;45;0.477272727272727;23;21;0.0227272727272727;0.477272727272727
Control.SRR15539829;43;45;0.581395348837209;18;25;0.0813953488372093;0.418604651162791
Control.SRR15539829;46;45;0.347826086956522;30;16;0.152173913043478;0.347826086956522
Control.SRR15539829;49;45;0.551020408163265;22;27;0.0510204081632653;0.448979591836735
Control.SRR15539829;46;45;0.326086956521739;31;15;0.173913043478261;0.326086956521739
Control.SRR15539829;48;45;0.5;24;24;0;0.5
Control.SRR15539829;53;45;0.490566037735849;27;26;0.00943396226415094;0.490566037735849
Control.SRR15539829;46;45;0.41304347826087;27;19;0.0869565217391304;0.41304347826087
Control.SRR15539829;44;45;0.568181818181818;19;25;0.0681818181818182;0.431818181818182
Control.SRR15539829;41;45;0.634146341463415;15;26;0.134146341463415;0.365853658536585
Control.SRR15539829;48;45;0.479166666666667;25;23;0.0208333333333333;0.479166666666667
Control.SRR15539829;41;45;0.634146341463415;15;26;0.134146341463415;0.365853658536585
Control.SRR15539829;51;45;0.509803921568627;25;26;0.00980392156862742;0.490196078431373
Control.SRR15539829;47;45;0.48936170212766;24;23;0.0106382978723404;0.48936170212766
Control.SRR15539829;51;45;0.509803921568627;25;26;0.00980392156862742;0.490196078431373
Control.SRR15539829;46;45;0.41304347826087;27;19;0.0869565217391304;0.41304347826087
Control.SRR15539829;46;45;0.391304347826087;28;18;0.108695652173913;0.391304347826087
Control.SRR15539829;45;45;0.377777777777778;28;17;0.122222222222222;0.377777777777778
Control.SRR15539829;48;45;0.604166666666667;19;29;0.104166666666667;0.395833333333333
Control.SRR15539829;52;45;0.461538461538462;28;24;0.0384615384615384;0.461538461538462
Control.SRR15539829;51;45;0.490196078431373;26;25;0.00980392156862747;0.490196078431373
Control.SRR15539829;46;45;0.478260869565217;24;22;0.0217391304347826;0.478260869565217
Control.SRR15539829;50;45;0.5;25;25;0;0.5
Control.SRR15539829;43;45;0.558139534883721;19;24;0.0581395348837209;0.441860465116279
Control.SRR15539829;43;45;0.558139534883721;19;24;0.0581395348837209;0.441860465116279
Control.SRR15539829;43;45;0.325581395348837;29;14;0.174418604651163;0.325581395348837
Control.SRR15539829;41;45;0.463414634146341;22;19;0.0365853658536585;0.463414634146341
Control.SRR15539829;52;45;0.519230769230769;25;27;0.0192307692307693;0.480769230769231
Control.SRR15539829;47;45;0.51063829787234;23;24;0.0106382978723404;0.48936170212766
Control.SRR15539829;47;45;0.574468085106383;20;27;0.074468085106383;0.425531914893617
Control.SRR15539829;50;45;0.28;36;14;0.22;0.28
Control.SRR15539829;43;45;0.372093023255814;27;16;0.127906976744186;0.372093023255814
Control.SRR15539829;45;45;0.533333333333333;21;24;0.0333333333333333;0.466666666666667
Control.SRR15539829;49;45;0.489795918367347;25;24;0.0102040816326531;0.489795918367347
Control.SRR15539829;41;45;0.463414634146341;22;19;0.0365853658536585;0.463414634146341
Control.SRR15539829;44;45;0.568181818181818;19;25;0.0681818181818182;0.431818181818182
Control.SRR15539829;47;45;0.468085106382979;25;22;0.0319148936170213;0.468085106382979
Control.SRR15539829;46;45;0.673913043478261;15;31;0.173913043478261;0.326086956521739
Control.SRR15539829;54;45;0.407407407407407;32;22;0.0925925925925926;0.407407407407407
Control.SRR15539829;42;45;0.428571428571429;24;18;0.0714285714285715;0.428571428571429
Control.SRR15539829;49;45;0.326530612244898;33;16;0.173469387755102;0.326530612244898
Control.SRR15539829;51;45;0.431372549019608;29;22;0.0686274509803921;0.431372549019608
Control.SRR15539829;47;45;0.48936170212766;24;23;0.0106382978723404;0.48936170212766
Control.SRR15539829;51;45;0.549019607843137;23;28;0.0490196078431373;0.450980392156863
Control.SRR15539829;47;45;0.574468085106383;20;27;0.074468085106383;0.425531914893617
Control.SRR15539829;42;45;0.476190476190476;22;20;0.0238095238095238;0.476190476190476
Control.SRR15539829;44;45;0.522727272727273;21;23;0.0227272727272727;0.477272727272727
Control.SRR15539829;47;45;0.574468085106383;20;27;0.074468085106383;0.425531914893617
Control.SRR15539829;42;45;0.619047619047619;16;26;0.119047619047619;0.380952380952381
Control.SRR15539829;45;45;0.6;18;27;0.1;0.4
Control.SRR15539829;45;45;0.533333333333333;21;24;0.0333333333333333;0.466666666666667
Control.SRR15539829;48;45;0.604166666666667;19;29;0.104166666666667;0.395833333333333
Control.SRR15539829;50;45;0.44;28;22;0.06;0.44
Control.SRR15539829;45;45;0.444444444444444;25;20;0.0555555555555556;0.444444444444444
Control.SRR15539829;49;45;0.551020408163265;22;27;0.0510204081632653;0.448979591836735
Control.SRR15539829;44;45;0.454545454545455;24;20;0.0454545454545455;0.454545454545455
Control.SRR15539829;47;45;0.446808510638298;26;21;0.0531914893617021;0.446808510638298
Control.SRR15539829;51;45;0.490196078431373;26;25;0.00980392156862747;0.490196078431373
Control.SRR15539829;54;45;0.518518518518518;26;28;0.0185185185185185;0.481481481481481
Control.SRR15539829;48;45;0.583333333333333;20;28;0.0833333333333334;0.416666666666667
Control.SRR15539829;46;45;0.565217391304348;20;26;0.0652173913043478;0.434782608695652
Control.SRR15539829;46;45;0.326086956521739;31;15;0.173913043478261;0.326086956521739
Control.SRR15539829;53;45;0.547169811320755;24;29;0.0471698113207547;0.452830188679245
Control.SRR15539829;52;45;0.480769230769231;27;25;0.0192307692307692;0.480769230769231
Control.SRR15539829;49;45;0.469387755102041;26;23;0.0306122448979592;0.469387755102041
Control.SRR15539829;53;45;0.471698113207547;28;25;0.0283018867924528;0.471698113207547
Control.SRR15539829;53;45;0.509433962264151;26;27;0.00943396226415094;0.490566037735849
Control.SRR15539829;46;45;0.478260869565217;24;22;0.0217391304347826;0.478260869565217
Control.SRR15539829;46;45;0.543478260869565;21;25;0.0434782608695652;0.456521739130435
Control.SRR15539829;49;45;0.346938775510204;32;17;0.153061224489796;0.346938775510204
Control.SRR15539829;45;45;0.533333333333333;21;24;0.0333333333333333;0.466666666666667
Control.SRR15539829;51;45;0.372549019607843;32;19;0.127450980392157;0.372549019607843
Control.SRR15539829;54;45;0.444444444444444;30;24;0.0555555555555556;0.444444444444444
Control.SRR15539829;47;45;0.574468085106383;20;27;0.074468085106383;0.425531914893617
Control.SRR15539829;49;45;0.428571428571429;28;21;0.0714285714285715;0.428571428571429
Control.SRR15539829;49;45;0.448979591836735;27;22;0.0510204081632653;0.448979591836735
Control.SRR15539829;47;45;0.531914893617021;22;25;0.0319148936170213;0.468085106382979
Control.SRR15539829;43;45;0.488372093023256;22;21;0.0116279069767442;0.488372093023256
Control.SRR15539829;47;45;0.574468085106383;20;27;0.074468085106383;0.425531914893617
Control.SRR15539829;45;45;0.422222222222222;26;19;0.0777777777777778;0.422222222222222
Control.SRR15539829;45;45;0.6;18;27;0.1;0.4
Control.SRR15539829;49;45;0.510204081632653;24;25;0.0102040816326531;0.489795918367347
Control.SRR15539829;40;45;0.425;23;17;0.075;0.425
Control.SRR15539829;42;45;0.547619047619048;19;23;0.0476190476190477;0.452380952380952
Control.SRR15539829;45;45;0.466666666666667;24;21;0.0333333333333333;0.466666666666667
Control.SRR15539829;53;45;0.490566037735849;27;26;0.00943396226415094;0.490566037735849
Control.SRR15539829;40;45;0.475;21;19;0.025;0.475
Control.SRR15539829;40;45;0.425;23;17;0.075;0.425
Control.SRR15539829;48;45;0.479166666666667;25;23;0.0208333333333333;0.479166666666667
Control.SRR15539829;45;45;0.444444444444444;25;20;0.0555555555555556;0.444444444444444
Control.SRR15539829;49;45;0.530612244897959;23;26;0.0306122448979592;0.469387755102041
Control.SRR15539829;48;45;0.458333333333333;26;22;0.0416666666666667;0.458333333333333
Control.SRR15539829;47;45;0.446808510638298;26;21;0.0531914893617021;0.446808510638298
Control.SRR15539829;52;45;0.5;26;26;0;0.5
Control.SRR15539829;45;45;0.511111111111111;22;23;0.0111111111111111;0.488888888888889
Control.SRR15539829;40;45;0.5;20;20;0;0.5
Control.SRR15539829;40;45;0.625;15;25;0.125;0.375
Control.SRR15539829;47;45;0.446808510638298;26;21;0.0531914893617021;0.446808510638298
Control.SRR15539829;42;45;0.428571428571429;24;18;0.0714285714285715;0.428571428571429
Control.SRR15539829;42;45;0.452380952380952;23;19;0.0476190476190476;0.452380952380952
Control.SRR15539829;40;45;0.475;21;19;0.025;0.475
Control.SRR15539829;49;45;0.530612244897959;23;26;0.0306122448979592;0.469387755102041
Control.SRR15539829;44;45;0.545454545454545;20;24;0.0454545454545454;0.454545454545455
Control.SRR15539829;49;45;0.469387755102041;26;23;0.0306122448979592;0.469387755102041
Control.SRR15539829;53;45;0.735849056603774;14;39;0.235849056603774;0.264150943396226
Control.SRR15539829;54;45;0.5;27;27;0;0.5
Control.SRR15539829;52;45;0.5;26;26;0;0.5
Control.SRR15539829;44;45;0.386363636363636;27;17;0.113636363636364;0.386363636363636
Control.SRR15539829;45;45;0.511111111111111;22;23;0.0111111111111111;0.488888888888889
Control.SRR15539829;45;45;0.555555555555556;20;25;0.0555555555555556;0.444444444444444
Control.SRR15539829;48;45;0.458333333333333;26;22;0.0416666666666667;0.458333333333333
Control.SRR15539829;49;45;0.673469387755102;16;33;0.173469387755102;0.326530612244898
Control.SRR15539829;45;45;0.355555555555556;29;16;0.144444444444444;0.355555555555556
Control.SRR15539829;49;45;0.469387755102041;26;23;0.0306122448979592;0.469387755102041
Control.SRR15539829;46;45;0.5;23;23;0;0.5
Control.SRR15539829;44;45;0.545454545454545;20;24;0.0454545454545454;0.454545454545455
Control.SRR15539829;50;45;0.58;21;29;0.08;0.42
Control.SRR15539829;51;45;0.372549019607843;32;19;0.127450980392157;0.372549019607843
Control.SRR15539829;47;45;0.51063829787234;23;24;0.0106382978723404;0.48936170212766
Control.SRR15539829;52;45;0.538461538461538;24;28;0.0384615384615384;0.461538461538462
Control.SRR15539829;51;45;0.529411764705882;24;27;0.0294117647058824;0.470588235294118
Control.SRR15539829;46;45;0.543478260869565;21;25;0.0434782608695652;0.456521739130435
Control.SRR15539829;42;45;0.452380952380952;23;19;0.0476190476190476;0.452380952380952
Control.SRR15539829;51;45;0.470588235294118;27;24;0.0294117647058824;0.470588235294118
Control.SRR15539829;53;45;0.60377358490566;21;32;0.10377358490566;0.39622641509434
Control.SRR15539829;51;45;0.411764705882353;30;21;0.0882352941176471;0.411764705882353
Control.SRR15539829;43;45;0.348837209302326;28;15;0.151162790697674;0.348837209302326
Control.SRR15539829;54;45;0.425925925925926;31;23;0.0740740740740741;0.425925925925926
Control.SRR15539829;48;45;0.479166666666667;25;23;0.0208333333333333;0.479166666666667
Control.SRR15539829;48;45;0.583333333333333;20;28;0.0833333333333334;0.416666666666667
Control.SRR15539829;42;45;0.69047619047619;13;29;0.19047619047619;0.30952380952381
Control.SRR15539829;40;45;0.4;24;16;0.1;0.4
Control.SRR15539829;41;45;0.439024390243902;23;18;0.0609756097560976;0.439024390243902
Control.SRR15539829;46;45;0.652173913043478;16;30;0.152173913043478;0.347826086956522
Control.SRR15539829;50;45;0.46;27;23;0.04;0.46
Control.SRR15539829;45;45;0.488888888888889;23;22;0.0111111111111111;0.488888888888889
Control.SRR15539829;43;45;0.348837209302326;28;15;0.151162790697674;0.348837209302326
Control.SRR15539829;44;45;0.431818181818182;25;19;0.0681818181818182;0.431818181818182
Control.SRR15539829;42;45;0.523809523809524;20;22;0.0238095238095238;0.476190476190476
Control.SRR15539829;42;45;0.547619047619048;19;23;0.0476190476190477;0.452380952380952
Control.SRR15539829;44;45;0.454545454545455;24;20;0.0454545454545455;0.454545454545455
Control.SRR15539829;49;45;0.448979591836735;27;22;0.0510204081632653;0.448979591836735
Control.SRR15539829;40;45;0.45;22;18;0.05;0.45
Control.SRR15539829;44;45;0.522727272727273;21;23;0.0227272727272727;0.477272727272727
Control.SRR15539829;45;45;0.444444444444444;25;20;0.0555555555555556;0.444444444444444
Control.SRR15539829;42;45;0.69047619047619;13;29;0.19047619047619;0.30952380952381
Control.SRR15539829;40;45;0.5;20;20;0;0.5
Control.SRR15539829;53;45;0.528301886792453;25;28;0.0283018867924528;0.471698113207547
Control.SRR15539829;41;45;0.439024390243902;23;18;0.0609756097560976;0.439024390243902
Control.SRR15539829;52;45;0.596153846153846;21;31;0.0961538461538461;0.403846153846154
Control.SRR15539829;51;45;0.509803921568627;25;26;0.00980392156862742;0.490196078431373
Control.SRR15539829;45;45;0.488888888888889;23;22;0.0111111111111111;0.488888888888889
Control.SRR15539829;51;45;0.568627450980392;22;29;0.0686274509803921;0.431372549019608
Control.SRR15539829;46;45;0.58695652173913;19;27;0.0869565217391305;0.41304347826087
Control.SRR15539829;43;45;0.558139534883721;19;24;0.0581395348837209;0.441860465116279
Control.SRR15539829;40;45;0.425;23;17;0.075;0.425
Control.SRR15539829;42;45;0.547619047619048;19;23;0.0476190476190477;0.452380952380952
Control.SRR15539829;50;45;0.36;32;18;0.14;0.36
Control.SRR15539829;41;45;0.463414634146341;22;19;0.0365853658536585;0.463414634146341
Control.SRR15539829;47;45;0.553191489361702;21;26;0.0531914893617021;0.446808510638298
Control.SRR15539829;49;45;0.530612244897959;23;26;0.0306122448979592;0.469387755102041
Control.SRR15539829;48;45;0.5;24;24;0;0.5
Control.SRR15539829;49;45;0.489795918367347;25;24;0.0102040816326531;0.489795918367347
Control.SRR15539829;52;45;0.519230769230769;25;27;0.0192307692307693;0.480769230769231
Control.SRR15539829;51;45;0.549019607843137;23;28;0.0490196078431373;0.450980392156863
Control.SRR15539829;44;45;0.477272727272727;23;21;0.0227272727272727;0.477272727272727
Control.SRR15539829;51;45;0.411764705882353;30;21;0.0882352941176471;0.411764705882353
Control.SRR15539829;49;45;0.469387755102041;26;23;0.0306122448979592;0.469387755102041
Control.SRR15539829;48;45;0.520833333333333;23;25;0.0208333333333334;0.479166666666667
Control.SRR15539829;47;45;0.48936170212766;24;23;0.0106382978723404;0.48936170212766
Control.SRR15539829;46;45;0.608695652173913;18;28;0.108695652173913;0.391304347826087
Control.SRR15539829;49;45;0.530612244897959;23;26;0.0306122448979592;0.469387755102041
Control.SRR15539829;52;45;0.519230769230769;25;27;0.0192307692307693;0.480769230769231
Control.SRR15539829;52;45;0.480769230769231;27;25;0.0192307692307692;0.480769230769231
Control.SRR15539829;54;45;0.592592592592593;22;32;0.0925925925925926;0.407407407407407
Control.SRR15539829;51;45;0.549019607843137;23;28;0.0490196078431373;0.450980392156863
Control.SRR15539829;50;45;0.58;21;29;0.08;0.42
Control.SRR15539829;48;45;0.5;24;24;0;0.5
Control.SRR15539829;47;45;0.48936170212766;24;23;0.0106382978723404;0.48936170212766
Control.SRR15539829;45;45;0.466666666666667;24;21;0.0333333333333333;0.466666666666667
Control.SRR15539829;49;45;0.63265306122449;18;31;0.13265306122449;0.36734693877551
Control.SRR15539829;42;45;0.547619047619048;19;23;0.0476190476190477;0.452380952380952
Control.SRR15539829;46;45;0.543478260869565;21;25;0.0434782608695652;0.456521739130435
Control.SRR15539829;48;45;0.5625;21;27;0.0625;0.4375
Control.SRR15539829;54;45;0.462962962962963;29;25;0.037037037037037;0.462962962962963
Control.SRR15539829;45;45;0.466666666666667;24;21;0.0333333333333333;0.466666666666667
Control.SRR15539829;51;45;0.549019607843137;23;28;0.0490196078431373;0.450980392156863
Control.SRR15539829;47;45;0.531914893617021;22;25;0.0319148936170213;0.468085106382979
Control.SRR15539829;51;45;0.450980392156863;28;23;0.0490196078431372;0.450980392156863
Control.SRR15539829;50;45;0.54;23;27;0.04;0.46
Control.SRR15539829;53;45;0.490566037735849;27;26;0.00943396226415094;0.490566037735849
Control.SRR15539829;50;45;0.46;27;23;0.04;0.46
Control.SRR15539829;48;45;0.604166666666667;19;29;0.104166666666667;0.395833333333333
Control.SRR15539829;49;45;0.551020408163265;22;27;0.0510204081632653;0.448979591836735
Control.SRR15539829;46;45;0.456521739130435;25;21;0.0434782608695652;0.456521739130435
Control.SRR15539829;54;45;0.481481481481481;28;26;0.0185185185185185;0.481481481481481
Control.SRR15539829;50;45;0.42;29;21;0.08;0.42
Control.SRR15539829;51;45;0.392156862745098;31;20;0.107843137254902;0.392156862745098
Control.SRR15539829;43;45;0.418604651162791;25;18;0.0813953488372093;0.418604651162791
Control.SRR15539829;50;45;0.54;23;27;0.04;0.46
Control.SRR15539829;44;45;0.477272727272727;23;21;0.0227272727272727;0.477272727272727
Control.SRR15539829;52;45;0.538461538461538;24;28;0.0384615384615384;0.461538461538462
Control.SRR15539829;50;45;0.54;23;27;0.04;0.46
Control.SRR15539829;51;45;0.509803921568627;25;26;0.00980392156862742;0.490196078431373
Control.SRR15539829;53;45;0.452830188679245;29;24;0.0471698113207547;0.452830188679245
Control.SRR15539829;53;45;0.566037735849057;23;30;0.0660377358490566;0.433962264150943
Control.SRR15539829;49;45;0.530612244897959;23;26;0.0306122448979592;0.469387755102041
Control.SRR15539829;47;45;0.595744680851064;19;28;0.0957446808510638;0.404255319148936
Control.SRR15539829;52;45;0.403846153846154;31;21;0.0961538461538461;0.403846153846154
Control.SRR15539829;48;45;0.479166666666667;25;23;0.0208333333333333;0.479166666666667
Control.SRR15539829;45;45;0.4;27;18;0.1;0.4
Control.SRR15539829;46;45;0.478260869565217;24;22;0.0217391304347826;0.478260869565217
Control.SRR15539829;47;45;0.382978723404255;29;18;0.117021276595745;0.382978723404255
Control.SRR15539829;53;45;0.528301886792453;25;28;0.0283018867924528;0.471698113207547
Control.SRR15539829;48;45;0.520833333333333;23;25;0.0208333333333334;0.479166666666667
Control.SRR15539829;50;45;0.54;23;27;0.04;0.46
Control.SRR15539829;40;45;0.425;23;17;0.075;0.425
Control.SRR15539829;47;45;0.531914893617021;22;25;0.0319148936170213;0.468085106382979
Control.SRR15539829;44;45;0.590909090909091;18;26;0.0909090909090909;0.409090909090909
Control.SRR15539829;44;45;0.568181818181818;19;25;0.0681818181818182;0.431818181818182
Control.SRR15539829;45;45;0.577777777777778;19;26;0.0777777777777777;0.422222222222222
Control.SRR15539829;41;45;0.439024390243902;23;18;0.0609756097560976;0.439024390243902
Control.SRR15539829;53;45;0.547169811320755;24;29;0.0471698113207547;0.452830188679245
Control.SRR15539829;45;45;0.488888888888889;23;22;0.0111111111111111;0.488888888888889
Control.SRR15539829;46;45;0.58695652173913;19;27;0.0869565217391305;0.41304347826087
Control.SRR15539829;51;45;0.392156862745098;31;20;0.107843137254902;0.392156862745098
Control.SRR15539829;48;45;0.583333333333333;20;28;0.0833333333333334;0.416666666666667
Control.SRR15539829;53;45;0.490566037735849;27;26;0.00943396226415094;0.490566037735849
Control.SRR15539829;50;45;0.62;19;31;0.12;0.38
Control.SRR15539829;51;45;0.450980392156863;28;23;0.0490196078431372;0.450980392156863
Control.SRR15539829;51;45;0.450980392156863;28;23;0.0490196078431372;0.450980392156863
Control.SRR15539829;48;45;0.416666666666667;28;20;0.0833333333333333;0.416666666666667
Control.SRR15539829;53;45;0.377358490566038;33;20;0.122641509433962;0.377358490566038
Control.SRR15539829;41;45;0.609756097560976;16;25;0.109756097560976;0.390243902439024
Control.SRR15539829;46;45;0.41304347826087;27;19;0.0869565217391304;0.41304347826087
Control.SRR15539829;48;45;0.479166666666667;25;23;0.0208333333333333;0.479166666666667
Control.SRR15539829;41;45;0.634146341463415;15;26;0.134146341463415;0.365853658536585
Control.SRR15539829;44;45;0.522727272727273;21;23;0.0227272727272727;0.477272727272727
Control.SRR15539829;45;45;0.4;27;18;0.1;0.4
Control.SRR15539829;41;45;0.51219512195122;20;21;0.0121951219512195;0.48780487804878
Control.SRR15539829;44;45;0.522727272727273;21;23;0.0227272727272727;0.477272727272727
Control.SRR15539829;41;45;0.48780487804878;21;20;0.0121951219512195;0.48780487804878
Control.SRR15539829;43;45;0.441860465116279;24;19;0.0581395348837209;0.441860465116279
Control.SRR15539829;46;45;0.456521739130435;25;21;0.0434782608695652;0.456521739130435
Control.SRR15539829;47;45;0.531914893617021;22;25;0.0319148936170213;0.468085106382979
Control.SRR15539829;54;45;0.666666666666667;18;36;0.166666666666667;0.333333333333333
Control.SRR15539829;52;45;0.480769230769231;27;25;0.0192307692307692;0.480769230769231
Control.SRR15539829;48;45;0.4375;27;21;0.0625;0.4375
Control.SRR15539829;43;45;0.372093023255814;27;16;0.127906976744186;0.372093023255814
Control.SRR15539829;47;45;0.553191489361702;21;26;0.0531914893617021;0.446808510638298
Control.SRR15539829;53;45;0.528301886792453;25;28;0.0283018867924528;0.471698113207547
Control.SRR15539829;54;45;0.462962962962963;29;25;0.037037037037037;0.462962962962963
Control.SRR15539829;51;45;0.392156862745098;31;20;0.107843137254902;0.392156862745098
Control.SRR15539829;53;45;0.471698113207547;28;25;0.0283018867924528;0.471698113207547
Control.SRR15539829;50;45;0.44;28;22;0.06;0.44
Control.SRR15539829;51;45;0.450980392156863;28;23;0.0490196078431372;0.450980392156863
Control.SRR15539829;50;45;0.6;20;30;0.1;0.4
Control.SRR15539829;53;45;0.509433962264151;26;27;0.00943396226415094;0.490566037735849
Control.SRR15539829;50;45;0.44;28;22;0.06;0.44
Control.SRR15539829;49;45;0.551020408163265;22;27;0.0510204081632653;0.448979591836735
Control.SRR15539829;41;45;0.634146341463415;15;26;0.134146341463415;0.365853658536585
Control.SRR15539829;50;45;0.48;26;24;0.02;0.48
Control.SRR15539829;49;45;0.36734693877551;31;18;0.13265306122449;0.36734693877551
Control.SRR15539829;48;45;0.604166666666667;19;29;0.104166666666667;0.395833333333333
Control.SRR15539829;46;45;0.652173913043478;16;30;0.152173913043478;0.347826086956522
Control.SRR15539829;50;45;0.6;20;30;0.1;0.4
Control.SRR15539829;48;45;0.458333333333333;26;22;0.0416666666666667;0.458333333333333
Control.SRR15539829;46;45;0.565217391304348;20;26;0.0652173913043478;0.434782608695652
Control.SRR15539829;44;45;0.454545454545455;24;20;0.0454545454545455;0.454545454545455
Control.SRR15539829;46;45;0.456521739130435;25;21;0.0434782608695652;0.456521739130435
Control.SRR15539829;45;45;0.533333333333333;21;24;0.0333333333333333;0.466666666666667
Control.SRR15539829;52;45;0.557692307692308;23;29;0.0576923076923077;0.442307692307692
Control.SRR15539829;50;45;0.54;23;27;0.04;0.46
Control.SRR15539829;45;45;0.444444444444444;25;20;0.0555555555555556;0.444444444444444
Control.SRR15539829;52;45;0.326923076923077;35;17;0.173076923076923;0.326923076923077
Control.SRR15539829;49;45;0.489795918367347;25;24;0.0102040816326531;0.489795918367347
Control.SRR15539829;54;45;0.462962962962963;29;25;0.037037037037037;0.462962962962963
Control.SRR15539829;54;45;0.574074074074074;23;31;0.0740740740740741;0.425925925925926
Control.SRR15539829;49;45;0.591836734693878;20;29;0.0918367346938775;0.408163265306122
Control.SRR15539829;54;45;0.5;27;27;0;0.5
Control.SRR15539829;46;45;0.41304347826087;27;19;0.0869565217391304;0.41304347826087
Control.SRR15539829;47;45;0.51063829787234;23;24;0.0106382978723404;0.48936170212766
Control.SRR15539829;43;45;0.511627906976744;21;22;0.0116279069767442;0.488372093023256
Control.SRR15539829;49;45;0.530612244897959;23;26;0.0306122448979592;0.469387755102041
Control.SRR15539829;49;45;0.489795918367347;25;24;0.0102040816326531;0.489795918367347
Control.SRR15539829;49;45;0.408163265306122;29;20;0.0918367346938775;0.408163265306122
Control.SRR15539829;51;45;0.372549019607843;32;19;0.127450980392157;0.372549019607843
Control.SRR15539829;52;45;0.346153846153846;34;18;0.153846153846154;0.346153846153846
Control.SRR15539829;46;45;0.41304347826087;27;19;0.0869565217391304;0.41304347826087
Control.SRR15539829;49;45;0.428571428571429;28;21;0.0714285714285715;0.428571428571429
Control.SRR15539829;47;45;0.574468085106383;20;27;0.074468085106383;0.425531914893617
Control.SRR15539829;49;45;0.428571428571429;28;21;0.0714285714285715;0.428571428571429
Control.SRR15539829;42;45;0.523809523809524;20;22;0.0238095238095238;0.476190476190476
Control.SRR15539829;51;45;0.549019607843137;23;28;0.0490196078431373;0.450980392156863
Control.SRR15539829;47;45;0.531914893617021;22;25;0.0319148936170213;0.468085106382979
Control.SRR15539829;49;45;0.428571428571429;28;21;0.0714285714285715;0.428571428571429
Control.SRR15539829;41;45;0.658536585365854;14;27;0.158536585365854;0.341463414634146
Control.SRR15539829;46;45;0.521739130434783;22;24;0.0217391304347826;0.478260869565217
Control.SRR15539829;43;45;0.558139534883721;19;24;0.0581395348837209;0.441860465116279
Control.SRR15539829;53;45;0.528301886792453;25;28;0.0283018867924528;0.471698113207547
Control.SRR15539829;54;45;0.537037037037037;25;29;0.0370370370370371;0.462962962962963
Control.SRR15539829;48;45;0.5625;21;27;0.0625;0.4375
Control.SRR15539829;43;45;0.511627906976744;21;22;0.0116279069767442;0.488372093023256
Control.SRR15539829;52;45;0.5;26;26;0;0.5
Control.SRR15539829;53;45;0.622641509433962;20;33;0.122641509433962;0.377358490566038
Control.SRR15539829;53;45;0.471698113207547;28;25;0.0283018867924528;0.471698113207547
Control.SRR15539829;41;45;0.439024390243902;23;18;0.0609756097560976;0.439024390243902
Control.SRR15539829;47;45;0.531914893617021;22;25;0.0319148936170213;0.468085106382979
Control.SRR15539829;41;45;0.51219512195122;20;21;0.0121951219512195;0.48780487804878
Control.SRR15539829;53;45;0.566037735849057;23;30;0.0660377358490566;0.433962264150943
Control.SRR15539829;46;45;0.565217391304348;20;26;0.0652173913043478;0.434782608695652
Control.SRR15539829;43;45;0.418604651162791;25;18;0.0813953488372093;0.418604651162791
Control.SRR15539829;51;45;0.529411764705882;24;27;0.0294117647058824;0.470588235294118
Control.SRR15539829;54;45;0.481481481481481;28;26;0.0185185185185185;0.481481481481481
Control.SRR15539829;41;45;0.51219512195122;20;21;0.0121951219512195;0.48780487804878
Control.SRR15539829;51;45;0.509803921568627;25;26;0.00980392156862742;0.490196078431373
Control.SRR15539829;51;45;0.529411764705882;24;27;0.0294117647058824;0.470588235294118
Control.SRR15539829;48;45;0.520833333333333;23;25;0.0208333333333334;0.479166666666667
Control.SRR15539829;42;45;0.476190476190476;22;20;0.0238095238095238;0.476190476190476
Control.SRR15539829;53;45;0.509433962264151;26;27;0.00943396226415094;0.490566037735849
Control.SRR15539829;40;45;0.575;17;23;0.075;0.425
Control.SRR15539829;43;45;0.488372093023256;22;21;0.0116279069767442;0.488372093023256
Control.SRR15539829;40;45;0.475;21;19;0.025;0.475
Control.SRR15539829;41;45;0.585365853658537;17;24;0.0853658536585366;0.414634146341463
Control.SRR15539829;43;45;0.674418604651163;14;29;0.174418604651163;0.325581395348837
Control.SRR15539829;41;45;0.463414634146341;22;19;0.0365853658536585;0.463414634146341
Control.SRR15539829;44;45;0.545454545454545;20;24;0.0454545454545454;0.454545454545455
Control.SRR15539829;44;45;0.431818181818182;25;19;0.0681818181818182;0.431818181818182
Control.SRR15539829;42;45;0.523809523809524;20;22;0.0238095238095238;0.476190476190476
Control.SRR15539829;43;45;0.465116279069767;23;20;0.0348837209302326;0.465116279069767
Control.SRR15539829;48;45;0.479166666666667;25;23;0.0208333333333333;0.479166666666667
Control.SRR15539829;48;45;0.604166666666667;19;29;0.104166666666667;0.395833333333333
Control.SRR15539829;40;45;0.525;19;21;0.025;0.475
Control.SRR15539829;47;45;0.468085106382979;25;22;0.0319148936170213;0.468085106382979
Control.SRR15539829;52;45;0.557692307692308;23;29;0.0576923076923077;0.442307692307692
Control.SRR15539829;45;45;0.422222222222222;26;19;0.0777777777777778;0.422222222222222
Control.SRR15539829;47;45;0.425531914893617;27;20;0.074468085106383;0.425531914893617
Control.SRR15539829;45;45;0.533333333333333;21;24;0.0333333333333333;0.466666666666667
Control.SRR15539829;46;45;0.565217391304348;20;26;0.0652173913043478;0.434782608695652
Control.SRR15539829;49;45;0.530612244897959;23;26;0.0306122448979592;0.469387755102041
Control.SRR15539829;47;45;0.531914893617021;22;25;0.0319148936170213;0.468085106382979
Control.SRR15539829;42;45;0.30952380952381;29;13;0.19047619047619;0.30952380952381
Control.SRR15539829;46;45;0.41304347826087;27;19;0.0869565217391304;0.41304347826087
Control.SRR15539829;45;45;0.666666666666667;15;30;0.166666666666667;0.333333333333333
Control.SRR15539829;47;45;0.617021276595745;18;29;0.117021276595745;0.382978723404255
Control.SRR15539829;47;45;0.595744680851064;19;28;0.0957446808510638;0.404255319148936
Control.SRR15539829;45;45;0.622222222222222;17;28;0.122222222222222;0.377777777777778
Control.SRR15539829;51;45;0.549019607843137;23;28;0.0490196078431373;0.450980392156863
Control.SRR15539829;50;45;0.5;25;25;0;0.5
Control.SRR15539829;54;45;0.574074074074074;23;31;0.0740740740740741;0.425925925925926
Control.SRR15539829;50;45;0.46;27;23;0.04;0.46
Control.SRR15539829;44;45;0.409090909090909;26;18;0.0909090909090909;0.409090909090909
Control.SRR15539829;48;45;0.520833333333333;23;25;0.0208333333333334;0.479166666666667
Control.SRR15539829;47;45;0.468085106382979;25;22;0.0319148936170213;0.468085106382979
Control.SRR15539829;48;45;0.645833333333333;17;31;0.145833333333333;0.354166666666667
Control.SRR15539829;41;45;0.48780487804878;21;20;0.0121951219512195;0.48780487804878
Control.SRR15539829;47;45;0.446808510638298;26;21;0.0531914893617021;0.446808510638298
Control.SRR15539829;50;45;0.58;21;29;0.08;0.42
Control.SRR15539829;43;45;0.395348837209302;26;17;0.104651162790698;0.395348837209302
Control.SRR15539829;47;45;0.340425531914894;31;16;0.159574468085106;0.340425531914894
Control.SRR15539829;44;45;0.590909090909091;18;26;0.0909090909090909;0.409090909090909
Control.SRR15539829;45;45;0.466666666666667;24;21;0.0333333333333333;0.466666666666667
Control.SRR15539829;48;45;0.479166666666667;25;23;0.0208333333333333;0.479166666666667
Control.SRR15539829;51;45;0.490196078431373;26;25;0.00980392156862747;0.490196078431373
Control.SRR15539829;41;45;0.560975609756098;18;23;0.0609756097560976;0.439024390243902
Control.SRR15539829;47;45;0.574468085106383;20;27;0.074468085106383;0.425531914893617
Control.SRR15539829;51;45;0.568627450980392;22;29;0.0686274509803921;0.431372549019608
Control.SRR15539829;49;45;0.469387755102041;26;23;0.0306122448979592;0.469387755102041
Control.SRR15539829;47;45;0.446808510638298;26;21;0.0531914893617021;0.446808510638298
Control.SRR15539829;46;45;0.565217391304348;20;26;0.0652173913043478;0.434782608695652
Control.SRR15539829;47;45;0.48936170212766;24;23;0.0106382978723404;0.48936170212766
Control.SRR15539829;40;45;0.6;16;24;0.1;0.4
Control.SRR15539829;52;45;0.461538461538462;28;24;0.0384615384615384;0.461538461538462
Control.SRR15539829;44;45;0.545454545454545;20;24;0.0454545454545454;0.454545454545455
Control.SRR15539829;46;45;0.58695652173913;19;27;0.0869565217391305;0.41304347826087
Control.SRR15539829;48;45;0.5625;21;27;0.0625;0.4375
Control.SRR15539829;49;45;0.510204081632653;24;25;0.0102040816326531;0.489795918367347
Control.SRR15539829;40;45;0.6;16;24;0.1;0.4
Control.SRR15539829;44;45;0.522727272727273;21;23;0.0227272727272727;0.477272727272727
Control.SRR15539829;50;45;0.38;31;19;0.12;0.38
Control.SRR15539829;51;45;0.431372549019608;29;22;0.0686274509803921;0.431372549019608
Control.SRR15539829;45;45;0.488888888888889;23;22;0.0111111111111111;0.488888888888889
Control.SRR15539829;49;45;0.551020408163265;22;27;0.0510204081632653;0.448979591836735
Control.SRR15539829;44;45;0.454545454545455;24;20;0.0454545454545455;0.454545454545455
Control.SRR15539829;46;45;0.5;23;23;0;0.5
Control.SRR15539829;47;45;0.574468085106383;20;27;0.074468085106383;0.425531914893617
Control.SRR15539829;49;45;0.387755102040816;30;19;0.112244897959184;0.387755102040816
Control.SRR15539829;47;45;0.531914893617021;22;25;0.0319148936170213;0.468085106382979
Control.SRR15539829;45;45;0.466666666666667;24;21;0.0333333333333333;0.466666666666667
Control.SRR15539829;40;45;0.625;15;25;0.125;0.375
Control.SRR15539829;45;45;0.444444444444444;25;20;0.0555555555555556;0.444444444444444
Control.SRR15539829;54;45;0.574074074074074;23;31;0.0740740740740741;0.425925925925926
Control.SRR15539829;45;45;0.533333333333333;21;24;0.0333333333333333;0.466666666666667
Control.SRR15539829;52;45;0.423076923076923;30;22;0.0769230769230769;0.423076923076923
Control.SRR15539829;52;45;0.480769230769231;27;25;0.0192307692307692;0.480769230769231
Control.SRR15539829;52;45;0.519230769230769;25;27;0.0192307692307693;0.480769230769231
Control.SRR15539829;46;45;0.434782608695652;26;20;0.0652173913043478;0.434782608695652
Control.SRR15539829;53;45;0.528301886792453;25;28;0.0283018867924528;0.471698113207547
Control.SRR15539829;53;45;0.547169811320755;24;29;0.0471698113207547;0.452830188679245
Control.SRR15539829;52;45;0.596153846153846;21;31;0.0961538461538461;0.403846153846154
Control.SRR15539829;46;45;0.543478260869565;21;25;0.0434782608695652;0.456521739130435
Control.SRR15539829;50;45;0.54;23;27;0.04;0.46
Control.SRR15539829;51;45;0.588235294117647;21;30;0.0882352941176471;0.411764705882353
Control.SRR15539829;44;45;0.431818181818182;25;19;0.0681818181818182;0.431818181818182
Control.SRR15539829;50;45;0.56;22;28;0.0600000000000001;0.44
Control.SRR15539829;54;45;0.444444444444444;30;24;0.0555555555555556;0.444444444444444
Control.SRR15539829;50;45;0.48;26;24;0.02;0.48
Control.SRR15539829;51;45;0.529411764705882;24;27;0.0294117647058824;0.470588235294118
Control.SRR15539829;52;45;0.5;26;26;0;0.5
Control.SRR15539829;48;45;0.583333333333333;20;28;0.0833333333333334;0.416666666666667
Control.SRR15539829;41;45;0.536585365853659;19;22;0.0365853658536586;0.463414634146341
Control.SRR15539829;49;45;0.551020408163265;22;27;0.0510204081632653;0.448979591836735
Control.SRR15539829;53;45;0.471698113207547;28;25;0.0283018867924528;0.471698113207547
Control.SRR15539829;44;45;0.386363636363636;27;17;0.113636363636364;0.386363636363636
Control.SRR15539829;49;45;0.551020408163265;22;27;0.0510204081632653;0.448979591836735
Control.SRR15539829;51;45;0.411764705882353;30;21;0.0882352941176471;0.411764705882353
Control.SRR15539829;52;45;0.538461538461538;24;28;0.0384615384615384;0.461538461538462
Control.SRR15539829;48;45;0.458333333333333;26;22;0.0416666666666667;0.458333333333333
Control.SRR15539829;48;45;0.458333333333333;26;22;0.0416666666666667;0.458333333333333
Control.SRR15539829;43;45;0.581395348837209;18;25;0.0813953488372093;0.418604651162791
Control.SRR15539829;47;45;0.531914893617021;22;25;0.0319148936170213;0.468085106382979
Control.SRR15539829;45;45;0.466666666666667;24;21;0.0333333333333333;0.466666666666667
Control.SRR15539829;53;45;0.547169811320755;24;29;0.0471698113207547;0.452830188679245
Control.SRR15539829;48;45;0.4375;27;21;0.0625;0.4375
Control.SRR15539829;47;45;0.595744680851064;19;28;0.0957446808510638;0.404255319148936
Control.SRR15539829;48;45;0.5;24;24;0;0.5
Control.SRR15539829;52;45;0.615384615384615;20;32;0.115384615384615;0.384615384615385
Control.SRR15539829;49;45;0.428571428571429;28;21;0.0714285714285715;0.428571428571429
Control.SRR15539829;45;45;0.466666666666667;24;21;0.0333333333333333;0.466666666666667
Control.SRR15539829;48;45;0.4375;27;21;0.0625;0.4375
Control.SRR15539829;47;45;0.553191489361702;21;26;0.0531914893617021;0.446808510638298
Control.SRR15539829;44;45;0.386363636363636;27;17;0.113636363636364;0.386363636363636
Control.SRR15539829;51;45;0.470588235294118;27;24;0.0294117647058824;0.470588235294118
Control.SRR15539829;42;45;0.547619047619048;19;23;0.0476190476190477;0.452380952380952
Control.SRR15539829;42;45;0.69047619047619;13;29;0.19047619047619;0.30952380952381
Control.SRR15539829;51;45;0.490196078431373;26;25;0.00980392156862747;0.490196078431373
Control.SRR15539829;48;45;0.541666666666667;22;26;0.0416666666666666;0.458333333333333
Control.SRR15539829;50;45;0.6;20;30;0.1;0.4
Control.SRR15539829;52;45;0.461538461538462;28;24;0.0384615384615384;0.461538461538462
Control.SRR15539829;51;45;0.549019607843137;23;28;0.0490196078431373;0.450980392156863
Control.SRR15539829;41;45;0.560975609756098;18;23;0.0609756097560976;0.439024390243902
Control.SRR15539829;48;45;0.479166666666667;25;23;0.0208333333333333;0.479166666666667
Control.SRR15539829;48;45;0.395833333333333;29;19;0.104166666666667;0.395833333333333
Control.SRR15539829;47;45;0.51063829787234;23;24;0.0106382978723404;0.48936170212766
Control.SRR15539829;49;45;0.510204081632653;24;25;0.0102040816326531;0.489795918367347
Control.SRR15539829;51;45;0.490196078431373;26;25;0.00980392156862747;0.490196078431373
Control.SRR15539829;54;45;0.5;27;27;0;0.5
Control.SRR15539829;45;45;0.622222222222222;17;28;0.122222222222222;0.377777777777778
Control.SRR15539829;52;45;0.480769230769231;27;25;0.0192307692307692;0.480769230769231
Control.SRR15539829;49;45;0.469387755102041;26;23;0.0306122448979592;0.469387755102041
Control.SRR15539829;44;45;0.454545454545455;24;20;0.0454545454545455;0.454545454545455
Control.SRR15539829;45;45;0.333333333333333;30;15;0.166666666666667;0.333333333333333
Control.SRR15539829;53;45;0.509433962264151;26;27;0.00943396226415094;0.490566037735849
Control.SRR15539829;54;45;0.5;27;27;0;0.5
Control.SRR15539829;46;45;0.521739130434783;22;24;0.0217391304347826;0.478260869565217
Control.SRR15539829;46;45;0.521739130434783;22;24;0.0217391304347826;0.478260869565217
Control.SRR15539829;50;45;0.64;18;32;0.14;0.36
Control.SRR15539829;52;45;0.519230769230769;25;27;0.0192307692307693;0.480769230769231
Control.SRR15539829;49;45;0.469387755102041;26;23;0.0306122448979592;0.469387755102041
Control.SRR15539829;46;45;0.5;23;23;0;0.5
Control.SRR15539829;53;45;0.39622641509434;32;21;0.10377358490566;0.39622641509434
Control.SRR15539829;53;45;0.60377358490566;21;32;0.10377358490566;0.39622641509434
Control.SRR15539829;53;45;0.283018867924528;38;15;0.216981132075472;0.283018867924528
Control.SRR15539829;41;45;0.536585365853659;19;22;0.0365853658536586;0.463414634146341
Control.SRR15539829;41;45;0.560975609756098;18;23;0.0609756097560976;0.439024390243902
Control.SRR15539829;47;45;0.553191489361702;21;26;0.0531914893617021;0.446808510638298
Control.SRR15539829;40;45;0.6;16;24;0.1;0.4
Control.SRR15539829;42;45;0.476190476190476;22;20;0.0238095238095238;0.476190476190476
Control.SRR15539829;44;45;0.681818181818182;14;30;0.181818181818182;0.318181818181818
Control.SRR15539829;54;45;0.592592592592593;22;32;0.0925925925925926;0.407407407407407
Control.SRR15539829;41;45;0.51219512195122;20;21;0.0121951219512195;0.48780487804878
Control.SRR15539829;50;45;0.34;33;17;0.16;0.34
Control.SRR15539829;47;45;0.51063829787234;23;24;0.0106382978723404;0.48936170212766
Control.SRR15539829;48;45;0.604166666666667;19;29;0.104166666666667;0.395833333333333
Control.SRR15539829;53;45;0.490566037735849;27;26;0.00943396226415094;0.490566037735849
Control.SRR15539829;48;45;0.625;18;30;0.125;0.375
Control.SRR15539829;41;45;0.439024390243902;23;18;0.0609756097560976;0.439024390243902
Control.SRR15539829;44;45;0.386363636363636;27;17;0.113636363636364;0.386363636363636
Control.SRR15539829;45;45;0.488888888888889;23;22;0.0111111111111111;0.488888888888889
Control.SRR15539829;51;45;0.549019607843137;23;28;0.0490196078431373;0.450980392156863
Control.SRR15539829;53;45;0.622641509433962;20;33;0.122641509433962;0.377358490566038
Control.SRR15539829;49;45;0.448979591836735;27;22;0.0510204081632653;0.448979591836735
Control.SRR15539829;54;45;0.407407407407407;32;22;0.0925925925925926;0.407407407407407
Control.SRR15539829;54;45;0.481481481481481;28;26;0.0185185185185185;0.481481481481481
Control.SRR15539829;52;45;0.403846153846154;31;21;0.0961538461538461;0.403846153846154
Control.SRR15539829;48;45;0.5;24;24;0;0.5
Control.SRR15539829;47;45;0.48936170212766;24;23;0.0106382978723404;0.48936170212766
Control.SRR15539829;47;45;0.553191489361702;21;26;0.0531914893617021;0.446808510638298
Control.SRR15539829;41;45;0.414634146341463;24;17;0.0853658536585366;0.414634146341463
Control.SRR15539829;44;45;0.431818181818182;25;19;0.0681818181818182;0.431818181818182
Control.SRR15539829;48;45;0.479166666666667;25;23;0.0208333333333333;0.479166666666667
Control.SRR15539829;45;45;0.466666666666667;24;21;0.0333333333333333;0.466666666666667
Control.SRR15539829;40;45;0.5;20;20;0;0.5
Control.SRR15539829;48;45;0.375;30;18;0.125;0.375
Control.SRR15539829;53;45;0.39622641509434;32;21;0.10377358490566;0.39622641509434
Control.SRR15539829;42;45;0.476190476190476;22;20;0.0238095238095238;0.476190476190476
Control.SRR15539829;41;45;0.536585365853659;19;22;0.0365853658536586;0.463414634146341
Control.SRR15539829;41;45;0.658536585365854;14;27;0.158536585365854;0.341463414634146
Control.SRR15539829;46;45;0.5;23;23;0;0.5
Control.SRR15539829;46;45;0.434782608695652;26;20;0.0652173913043478;0.434782608695652
Control.SRR15539829;44;45;0.613636363636364;17;27;0.113636363636364;0.386363636363636
Control.SRR15539829;53;45;0.452830188679245;29;24;0.0471698113207547;0.452830188679245
Control.SRR15539829;46;45;0.456521739130435;25;21;0.0434782608695652;0.456521739130435
Control.SRR15539829;48;45;0.375;30;18;0.125;0.375
Control.SRR15539829;40;45;0.525;19;21;0.025;0.475
Control.SRR15539829;42;45;0.5;21;21;0;0.5
Control.SRR15539829;47;45;0.51063829787234;23;24;0.0106382978723404;0.48936170212766
Control.SRR15539829;49;45;0.530612244897959;23;26;0.0306122448979592;0.469387755102041
Control.SRR15539829;53;45;0.566037735849057;23;30;0.0660377358490566;0.433962264150943
Control.SRR15539829;45;45;0.555555555555556;20;25;0.0555555555555556;0.444444444444444
Control.SRR15539829;42;45;0.404761904761905;25;17;0.0952380952380952;0.404761904761905
Control.SRR15539829;52;45;0.557692307692308;23;29;0.0576923076923077;0.442307692307692
Control.SRR15539829;52;45;0.519230769230769;25;27;0.0192307692307693;0.480769230769231
Control.SRR15539829;43;45;0.441860465116279;24;19;0.0581395348837209;0.441860465116279
Control.SRR15539829;50;45;0.52;24;26;0.02;0.48
Control.SRR15539829;42;45;0.30952380952381;29;13;0.19047619047619;0.30952380952381
Control.SRR15539829;49;45;0.571428571428571;21;28;0.0714285714285714;0.428571428571429
Control.SRR15539829;44;45;0.431818181818182;25;19;0.0681818181818182;0.431818181818182
Control.SRR15539829;48;45;0.458333333333333;26;22;0.0416666666666667;0.458333333333333
Control.SRR15539829;40;45;0.525;19;21;0.025;0.475
Control.SRR15539829;53;45;0.471698113207547;28;25;0.0283018867924528;0.471698113207547
Control.SRR15539829;46;45;0.5;23;23;0;0.5
Control.SRR15539829;51;45;0.509803921568627;25;26;0.00980392156862742;0.490196078431373
Control.SRR15539829;45;45;0.355555555555556;29;16;0.144444444444444;0.355555555555556
Control.SRR15539829;43;45;0.348837209302326;28;15;0.151162790697674;0.348837209302326
Control.SRR15539829;44;45;0.522727272727273;21;23;0.0227272727272727;0.477272727272727
Control.SRR15539829;42;45;0.547619047619048;19;23;0.0476190476190477;0.452380952380952
Control.SRR15539829;43;45;0.441860465116279;24;19;0.0581395348837209;0.441860465116279
Control.SRR15539829;51;45;0.509803921568627;25;26;0.00980392156862742;0.490196078431373
Control.SRR15539829;43;45;0.558139534883721;19;24;0.0581395348837209;0.441860465116279
Control.SRR15539829;53;45;0.433962264150943;30;23;0.0660377358490566;0.433962264150943
Control.SRR15539829;47;45;0.404255319148936;28;19;0.0957446808510639;0.404255319148936
Control.SRR15539829;45;45;0.511111111111111;22;23;0.0111111111111111;0.488888888888889
Control.SRR15539829;48;45;0.5;24;24;0;0.5
Control.SRR15539829;44;45;0.522727272727273;21;23;0.0227272727272727;0.477272727272727
Control.SRR15539829;43;45;0.395348837209302;26;17;0.104651162790698;0.395348837209302
Control.SRR15539829;51;45;0.549019607843137;23;28;0.0490196078431373;0.450980392156863
Control.SRR15539829;53;45;0.528301886792453;25;28;0.0283018867924528;0.471698113207547
Control.SRR15539829;46;45;0.608695652173913;18;28;0.108695652173913;0.391304347826087
Control.SRR15539829;47;45;0.425531914893617;27;20;0.074468085106383;0.425531914893617
Control.SRR15539829;40;45;0.55;18;22;0.05;0.45
Control.SRR15539829;44;45;0.431818181818182;25;19;0.0681818181818182;0.431818181818182
Control.SRR15539829;42;45;0.5;21;21;0;0.5
Control.SRR15539829;48;45;0.479166666666667;25;23;0.0208333333333333;0.479166666666667
Control.SRR15539829;48;45;0.416666666666667;28;20;0.0833333333333333;0.416666666666667
Control.SRR15539829;50;45;0.32;34;16;0.18;0.32
Control.SRR15539829;47;45;0.425531914893617;27;20;0.074468085106383;0.425531914893617
Control.SRR15539829;44;45;0.522727272727273;21;23;0.0227272727272727;0.477272727272727
Control.SRR15539829;53;45;0.622641509433962;20;33;0.122641509433962;0.377358490566038
Control.SRR15539829;43;45;0.418604651162791;25;18;0.0813953488372093;0.418604651162791
Control.SRR15539829;46;45;0.565217391304348;20;26;0.0652173913043478;0.434782608695652
Control.SRR15539829;41;45;0.439024390243902;23;18;0.0609756097560976;0.439024390243902
Control.SRR15539829;40;45;0.5;20;20;0;0.5
Control.SRR15539829;47;45;0.51063829787234;23;24;0.0106382978723404;0.48936170212766
Control.SRR15539829;42;45;0.476190476190476;22;20;0.0238095238095238;0.476190476190476
Control.SRR15539829;46;45;0.521739130434783;22;24;0.0217391304347826;0.478260869565217
Control.SRR15539829;41;45;0.365853658536585;26;15;0.134146341463415;0.365853658536585
Control.SRR15539829;42;45;0.547619047619048;19;23;0.0476190476190477;0.452380952380952
Control.SRR15539829;45;45;0.533333333333333;21;24;0.0333333333333333;0.466666666666667
Control.SRR15539829;45;45;0.644444444444444;16;29;0.144444444444444;0.355555555555556
Control.SRR15539829;46;45;0.5;23;23;0;0.5
Control.SRR15539829;45;45;0.511111111111111;22;23;0.0111111111111111;0.488888888888889
Control.SRR15539829;50;45;0.48;26;24;0.02;0.48
Control.SRR15539829;40;45;0.45;22;18;0.05;0.45
Control.SRR15539829;52;45;0.5;26;26;0;0.5
Control.SRR15539829;53;45;0.433962264150943;30;23;0.0660377358490566;0.433962264150943
Control.SRR15539829;51;45;0.490196078431373;26;25;0.00980392156862747;0.490196078431373
Control.SRR15539829;50;45;0.44;28;22;0.06;0.44
Control.SRR15539829;40;45;0.675;13;27;0.175;0.325
Control.SRR15539829;42;45;0.452380952380952;23;19;0.0476190476190476;0.452380952380952
Control.SRR15539829;42;45;0.428571428571429;24;18;0.0714285714285715;0.428571428571429
Control.SRR15539829;47;45;0.446808510638298;26;21;0.0531914893617021;0.446808510638298
Control.SRR15539829;52;45;0.480769230769231;27;25;0.0192307692307692;0.480769230769231
Control.SRR15539829;49;45;0.591836734693878;20;29;0.0918367346938775;0.408163265306122
Control.SRR15539829;52;45;0.576923076923077;22;30;0.0769230769230769;0.423076923076923
Control.SRR15539829;50;45;0.62;19;31;0.12;0.38
Control.SRR15539829;54;45;0.518518518518518;26;28;0.0185185185185185;0.481481481481481
Control.SRR15539829;54;45;0.5;27;27;0;0.5
Control.SRR15539829;52;45;0.538461538461538;24;28;0.0384615384615384;0.461538461538462
Control.SRR15539829;48;45;0.5625;21;27;0.0625;0.4375
Control.SRR15539829;46;45;0.347826086956522;30;16;0.152173913043478;0.347826086956522
Control.SRR15539829;46;45;0.5;23;23;0;0.5
Control.SRR15539829;42;45;0.428571428571429;24;18;0.0714285714285715;0.428571428571429
Control.SRR15539829;48;45;0.4375;27;21;0.0625;0.4375
Control.SRR15539829;54;45;0.388888888888889;33;21;0.111111111111111;0.388888888888889
Control.SRR15539829;50;45;0.5;25;25;0;0.5
Control.SRR15539829;52;45;0.576923076923077;22;30;0.0769230769230769;0.423076923076923
Control.SRR15539829;40;45;0.525;19;21;0.025;0.475
Control.SRR15539829;41;45;0.341463414634146;27;14;0.158536585365854;0.341463414634146
Control.SRR15539829;43;45;0.372093023255814;27;16;0.127906976744186;0.372093023255814
Control.SRR15539829;40;45;0.6;16;24;0.1;0.4
Control.SRR15539829;49;45;0.448979591836735;27;22;0.0510204081632653;0.448979591836735
Control.SRR15539829;40;45;0.525;19;21;0.025;0.475
Control.SRR15539829;43;45;0.558139534883721;19;24;0.0581395348837209;0.441860465116279
Control.SRR15539829;46;45;0.565217391304348;20;26;0.0652173913043478;0.434782608695652
Control.SRR15539829;46;45;0.434782608695652;26;20;0.0652173913043478;0.434782608695652
Control.SRR15539829;53;45;0.471698113207547;28;25;0.0283018867924528;0.471698113207547
Control.SRR15539829;46;45;0.5;23;23;0;0.5
Control.SRR15539829;41;45;0.48780487804878;21;20;0.0121951219512195;0.48780487804878
Control.SRR15539829;46;45;0.630434782608696;17;29;0.130434782608696;0.369565217391304
Control.SRR15539829;40;45;0.325;27;13;0.175;0.325
Control.SRR15539829;47;45;0.404255319148936;28;19;0.0957446808510639;0.404255319148936
Control.SRR15539829;52;45;0.519230769230769;25;27;0.0192307692307693;0.480769230769231
Control.SRR15539829;47;45;0.574468085106383;20;27;0.074468085106383;0.425531914893617
Control.SRR15539829;49;45;0.387755102040816;30;19;0.112244897959184;0.387755102040816
Control.SRR15539829;43;45;0.534883720930233;20;23;0.0348837209302325;0.465116279069767
Control.SRR15539829;44;45;0.545454545454545;20;24;0.0454545454545454;0.454545454545455
Control.SRR15539829;43;45;0.534883720930233;20;23;0.0348837209302325;0.465116279069767
Control.SRR15539829;41;45;0.536585365853659;19;22;0.0365853658536586;0.463414634146341
Control.SRR15539829;45;45;0.622222222222222;17;28;0.122222222222222;0.377777777777778
Control.SRR15539829;51;45;0.607843137254902;20;31;0.107843137254902;0.392156862745098
Control.SRR15539829;52;45;0.519230769230769;25;27;0.0192307692307693;0.480769230769231
Control.SRR15539829;46;45;0.369565217391304;29;17;0.130434782608696;0.369565217391304
Control.SRR15539829;47;45;0.425531914893617;27;20;0.074468085106383;0.425531914893617
Control.SRR15539829;46;45;0.282608695652174;33;13;0.217391304347826;0.282608695652174
Control.SRR15539829;53;45;0.452830188679245;29;24;0.0471698113207547;0.452830188679245
Control.SRR15539829;40;45;0.55;18;22;0.05;0.45
Control.SRR15539829;40;45;0.575;17;23;0.075;0.425
Control.SRR15539829;50;45;0.56;22;28;0.0600000000000001;0.44
Control.SRR15539829;51;45;0.666666666666667;17;34;0.166666666666667;0.333333333333333
Control.SRR15539829;50;45;0.48;26;24;0.02;0.48
Control.SRR15539829;46;45;0.478260869565217;24;22;0.0217391304347826;0.478260869565217
Control.SRR15539829;51;45;0.392156862745098;31;20;0.107843137254902;0.392156862745098
Control.SRR15539829;50;45;0.54;23;27;0.04;0.46
Control.SRR15539829;48;45;0.5;24;24;0;0.5
Control.SRR15539829;47;45;0.617021276595745;18;29;0.117021276595745;0.382978723404255
Control.SRR15539829;46;45;0.434782608695652;26;20;0.0652173913043478;0.434782608695652
Control.SRR15539829;53;45;0.415094339622642;31;22;0.0849056603773585;0.415094339622642
Control.SRR15539829;50;45;0.34;33;17;0.16;0.34
Control.SRR15539829;47;45;0.48936170212766;24;23;0.0106382978723404;0.48936170212766
Control.SRR15539829;48;45;0.625;18;30;0.125;0.375
Control.SRR15539829;51;45;0.450980392156863;28;23;0.0490196078431372;0.450980392156863
Control.SRR15539829;48;45;0.5625;21;27;0.0625;0.4375
Control.SRR15539829;45;45;0.422222222222222;26;19;0.0777777777777778;0.422222222222222
Control.SRR15539829;48;45;0.604166666666667;19;29;0.104166666666667;0.395833333333333
Control.SRR15539829;50;45;0.48;26;24;0.02;0.48
Control.SRR15539829;51;45;0.450980392156863;28;23;0.0490196078431372;0.450980392156863
Control.SRR15539829;49;45;0.448979591836735;27;22;0.0510204081632653;0.448979591836735
Control.SRR15539829;47;45;0.553191489361702;21;26;0.0531914893617021;0.446808510638298
Control.SRR15539829;48;45;0.583333333333333;20;28;0.0833333333333334;0.416666666666667
Control.SRR15539829;44;45;0.590909090909091;18;26;0.0909090909090909;0.409090909090909
Control.SRR15539829;46;45;0.478260869565217;24;22;0.0217391304347826;0.478260869565217
Control.SRR15539829;50;45;0.4;30;20;0.1;0.4
Control.SRR15539829;52;45;0.403846153846154;31;21;0.0961538461538461;0.403846153846154
Control.SRR15539829;47;45;0.468085106382979;25;22;0.0319148936170213;0.468085106382979
Control.SRR15539829;50;45;0.5;25;25;0;0.5
Control.SRR15539829;51;45;0.549019607843137;23;28;0.0490196078431373;0.450980392156863
Control.SRR15539829;43;45;0.558139534883721;19;24;0.0581395348837209;0.441860465116279
Control.SRR15539829;48;45;0.5;24;24;0;0.5
Control.SRR15539829;47;45;0.382978723404255;29;18;0.117021276595745;0.382978723404255
Control.SRR15539829;40;45;0.4;24;16;0.1;0.4
Control.SRR15539829;44;45;0.522727272727273;21;23;0.0227272727272727;0.477272727272727
Control.SRR15539829;42;45;0.476190476190476;22;20;0.0238095238095238;0.476190476190476
Control.SRR15539829;44;45;0.5;22;22;0;0.5
Control.SRR15539829;51;45;0.529411764705882;24;27;0.0294117647058824;0.470588235294118
Control.SRR15539829;43;45;0.511627906976744;21;22;0.0116279069767442;0.488372093023256
Control.SRR15539829;47;45;0.425531914893617;27;20;0.074468085106383;0.425531914893617
Control.SRR15539829;50;45;0.36;32;18;0.14;0.36
Control.SRR15539829;51;45;0.450980392156863;28;23;0.0490196078431372;0.450980392156863
Control.SRR15539829;42;45;0.476190476190476;22;20;0.0238095238095238;0.476190476190476
Control.SRR15539829;41;45;0.560975609756098;18;23;0.0609756097560976;0.439024390243902
Control.SRR15539829;51;45;0.509803921568627;25;26;0.00980392156862742;0.490196078431373
Control.SRR15539829;50;45;0.48;26;24;0.02;0.48
Control.SRR15539829;48;45;0.666666666666667;16;32;0.166666666666667;0.333333333333333
Control.SRR15539829;46;45;0.456521739130435;25;21;0.0434782608695652;0.456521739130435
Control.SRR15539829;45;45;0.444444444444444;25;20;0.0555555555555556;0.444444444444444
Control.SRR15539829;40;45;0.525;19;21;0.025;0.475
Control.SRR15539829;45;45;0.6;18;27;0.1;0.4
Control.SRR15539829;45;45;0.511111111111111;22;23;0.0111111111111111;0.488888888888889
Control.SRR15539829;44;45;0.363636363636364;28;16;0.136363636363636;0.363636363636364
Control.SRR15539829;42;45;0.404761904761905;25;17;0.0952380952380952;0.404761904761905
Control.SRR15539829;42;45;0.571428571428571;18;24;0.0714285714285714;0.428571428571429
Control.SRR15539829;52;45;0.5;26;26;0;0.5
Control.SRR15539829;45;45;0.511111111111111;22;23;0.0111111111111111;0.488888888888889
Control.SRR15539829;48;45;0.5625;21;27;0.0625;0.4375
Control.SRR15539829;43;45;0.465116279069767;23;20;0.0348837209302326;0.465116279069767
Control.SRR15539829;40;45;0.7;12;28;0.2;0.3
Control.SRR15539829;44;45;0.659090909090909;15;29;0.159090909090909;0.340909090909091
Control.SRR15539829;43;45;0.581395348837209;18;25;0.0813953488372093;0.418604651162791
Control.SRR15539829;44;45;0.522727272727273;21;23;0.0227272727272727;0.477272727272727
Control.SRR15539829;42;45;0.547619047619048;19;23;0.0476190476190477;0.452380952380952
Control.SRR15539829;41;45;0.48780487804878;21;20;0.0121951219512195;0.48780487804878
Control.SRR15539829;43;45;0.511627906976744;21;22;0.0116279069767442;0.488372093023256
Control.SRR15539829;41;45;0.48780487804878;21;20;0.0121951219512195;0.48780487804878
Control.SRR15539829;43;45;0.488372093023256;22;21;0.0116279069767442;0.488372093023256
Control.SRR15539829;42;45;0.5;21;21;0;0.5
Control.SRR15539829;46;45;0.58695652173913;19;27;0.0869565217391305;0.41304347826087
Control.SRR15539829;44;45;0.431818181818182;25;19;0.0681818181818182;0.431818181818182
Control.SRR15539829;42;45;0.404761904761905;25;17;0.0952380952380952;0.404761904761905
Control.SRR15539829;46;45;0.673913043478261;15;31;0.173913043478261;0.326086956521739
Control.SRR15539829;44;45;0.409090909090909;26;18;0.0909090909090909;0.409090909090909
Control.SRR15539829;43;45;0.581395348837209;18;25;0.0813953488372093;0.418604651162791
Control.SRR15539829;44;45;0.454545454545455;24;20;0.0454545454545455;0.454545454545455
Control.SRR15539829;51;45;0.529411764705882;24;27;0.0294117647058824;0.470588235294118
Control.SRR15539829;52;45;0.423076923076923;30;22;0.0769230769230769;0.423076923076923
Control.SRR15539829;51;45;0.549019607843137;23;28;0.0490196078431373;0.450980392156863
Control.SRR15539829;41;45;0.560975609756098;18;23;0.0609756097560976;0.439024390243902
Control.SRR15539829;46;45;0.521739130434783;22;24;0.0217391304347826;0.478260869565217
Control.SRR15539829;46;45;0.58695652173913;19;27;0.0869565217391305;0.41304347826087
Control.SRR15539829;52;45;0.538461538461538;24;28;0.0384615384615384;0.461538461538462
Control.SRR15539829;40;45;0.45;22;18;0.05;0.45
Control.SRR15539829;49;45;0.469387755102041;26;23;0.0306122448979592;0.469387755102041
Control.SRR15539829;51;45;0.549019607843137;23;28;0.0490196078431373;0.450980392156863
Control.SRR15539829;46;45;0.456521739130435;25;21;0.0434782608695652;0.456521739130435
Control.SRR15539829;43;45;0.511627906976744;21;22;0.0116279069767442;0.488372093023256
Control.SRR15539829;48;45;0.479166666666667;25;23;0.0208333333333333;0.479166666666667
Control.SRR15539829;41;45;0.51219512195122;20;21;0.0121951219512195;0.48780487804878
Control.SRR15539829;42;45;0.476190476190476;22;20;0.0238095238095238;0.476190476190476
Control.SRR15539829;42;45;0.547619047619048;19;23;0.0476190476190477;0.452380952380952
Control.SRR15539829;44;45;0.477272727272727;23;21;0.0227272727272727;0.477272727272727
Control.SRR15539829;44;45;0.454545454545455;24;20;0.0454545454545455;0.454545454545455
Control.SRR15539829;45;45;0.4;27;18;0.1;0.4
Control.SRR15539829;51;45;0.431372549019608;29;22;0.0686274509803921;0.431372549019608
Control.SRR15539829;51;45;0.549019607843137;23;28;0.0490196078431373;0.450980392156863
Control.SRR15539829;47;45;0.48936170212766;24;23;0.0106382978723404;0.48936170212766
Control.SRR15539829;43;45;0.558139534883721;19;24;0.0581395348837209;0.441860465116279
Control.SRR15539829;50;45;0.56;22;28;0.0600000000000001;0.44
Control.SRR15539829;43;45;0.465116279069767;23;20;0.0348837209302326;0.465116279069767
Control.SRR15539829;47;45;0.553191489361702;21;26;0.0531914893617021;0.446808510638298
Control.SRR15539829;40;45;0.45;22;18;0.05;0.45
Control.SRR15539829;47;45;0.319148936170213;32;15;0.180851063829787;0.319148936170213
Control.SRR15539829;47;45;0.51063829787234;23;24;0.0106382978723404;0.48936170212766
Control.SRR15539829;47;45;0.425531914893617;27;20;0.074468085106383;0.425531914893617
Control.SRR15539829;51;45;0.411764705882353;30;21;0.0882352941176471;0.411764705882353
Control.SRR15539829;44;45;0.522727272727273;21;23;0.0227272727272727;0.477272727272727
Control.SRR15539829;47;45;0.531914893617021;22;25;0.0319148936170213;0.468085106382979
Control.SRR15539829;45;45;0.555555555555556;20;25;0.0555555555555556;0.444444444444444
Control.SRR15539829;47;45;0.617021276595745;18;29;0.117021276595745;0.382978723404255
Control.SRR15539829;52;45;0.596153846153846;21;31;0.0961538461538461;0.403846153846154
Control.SRR15539829;41;45;0.48780487804878;21;20;0.0121951219512195;0.48780487804878
Control.SRR15539829;43;45;0.418604651162791;25;18;0.0813953488372093;0.418604651162791
Control.SRR15539829;41;45;0.463414634146341;22;19;0.0365853658536585;0.463414634146341
Control.SRR15539829;46;45;0.478260869565217;24;22;0.0217391304347826;0.478260869565217
Control.SRR15539829;43;45;0.395348837209302;26;17;0.104651162790698;0.395348837209302
Control.SRR15539829;43;45;0.558139534883721;19;24;0.0581395348837209;0.441860465116279
Control.SRR15539829;43;45;0.488372093023256;22;21;0.0116279069767442;0.488372093023256
Control.SRR15539829;46;45;0.478260869565217;24;22;0.0217391304347826;0.478260869565217
Control.SRR15539829;44;45;0.363636363636364;28;16;0.136363636363636;0.363636363636364
Control.SRR15539829;41;45;0.658536585365854;14;27;0.158536585365854;0.341463414634146
Control.SRR15539829;46;45;0.543478260869565;21;25;0.0434782608695652;0.456521739130435
Control.SRR15539829;50;45;0.62;19;31;0.12;0.38
Control.SRR15539829;48;45;0.416666666666667;28;20;0.0833333333333333;0.416666666666667
Control.SRR15539829;50;45;0.38;31;19;0.12;0.38
Control.SRR15539829;43;45;0.488372093023256;22;21;0.0116279069767442;0.488372093023256
Control.SRR15539829;49;45;0.510204081632653;24;25;0.0102040816326531;0.489795918367347
Control.SRR15539829;49;45;0.448979591836735;27;22;0.0510204081632653;0.448979591836735
Control.SRR15539829;41;45;0.536585365853659;19;22;0.0365853658536586;0.463414634146341
Control.SRR15539829;46;45;0.5;23;23;0;0.5
Control.SRR15539829;46;45;0.456521739130435;25;21;0.0434782608695652;0.456521739130435
Control.SRR15539829;49;45;0.469387755102041;26;23;0.0306122448979592;0.469387755102041
Control.SRR15539829;44;45;0.590909090909091;18;26;0.0909090909090909;0.409090909090909
Control.SRR15539829;42;45;0.428571428571429;24;18;0.0714285714285715;0.428571428571429
Control.SRR15539829;44;45;0.477272727272727;23;21;0.0227272727272727;0.477272727272727
Control.SRR15539829;40;45;0.575;17;23;0.075;0.425
Control.SRR15539829;42;45;0.595238095238095;17;25;0.0952380952380952;0.404761904761905
Control.SRR15539829;41;45;0.463414634146341;22;19;0.0365853658536585;0.463414634146341
Control.SRR15539829;48;45;0.395833333333333;29;19;0.104166666666667;0.395833333333333
Control.SRR15539829;45;45;0.533333333333333;21;24;0.0333333333333333;0.466666666666667
Control.SRR15539829;48;45;0.645833333333333;17;31;0.145833333333333;0.354166666666667
Control.SRR15539829;49;45;0.612244897959184;19;30;0.112244897959184;0.387755102040816
Control.SRR15539829;41;45;0.51219512195122;20;21;0.0121951219512195;0.48780487804878
Control.SRR15539829;46;45;0.521739130434783;22;24;0.0217391304347826;0.478260869565217
Control.SRR15539829;46;45;0.41304347826087;27;19;0.0869565217391304;0.41304347826087
Control.SRR15539829;43;45;0.418604651162791;25;18;0.0813953488372093;0.418604651162791
Control.SRR15539829;43;45;0.581395348837209;18;25;0.0813953488372093;0.418604651162791
Control.SRR15539829;42;45;0.547619047619048;19;23;0.0476190476190477;0.452380952380952
Control.SRR15539829;40;45;0.475;21;19;0.025;0.475
Control.SRR15539829;41;45;0.365853658536585;26;15;0.134146341463415;0.365853658536585
Control.SRR15539829;51;45;0.509803921568627;25;26;0.00980392156862742;0.490196078431373
Control.SRR15539829;42;45;0.452380952380952;23;19;0.0476190476190476;0.452380952380952
Control.SRR15539829;41;45;0.439024390243902;23;18;0.0609756097560976;0.439024390243902
Control.SRR15539829;52;45;0.461538461538462;28;24;0.0384615384615384;0.461538461538462
Control.SRR15539829;51;45;0.470588235294118;27;24;0.0294117647058824;0.470588235294118
Control.SRR15539829;43;45;0.511627906976744;21;22;0.0116279069767442;0.488372093023256
Control.SRR15539829;51;45;0.549019607843137;23;28;0.0490196078431373;0.450980392156863
Control.SRR15539829;44;45;0.409090909090909;26;18;0.0909090909090909;0.409090909090909
Control.SRR15539829;43;45;0.511627906976744;21;22;0.0116279069767442;0.488372093023256
Control.SRR15539829;46;45;0.456521739130435;25;21;0.0434782608695652;0.456521739130435
Control.SRR15539829;43;45;0.488372093023256;22;21;0.0116279069767442;0.488372093023256
Control.SRR15539829;50;45;0.44;28;22;0.06;0.44
Control.SRR15539829;46;45;0.434782608695652;26;20;0.0652173913043478;0.434782608695652
Control.SRR15539829;42;45;0.30952380952381;29;13;0.19047619047619;0.30952380952381
Control.SRR15539829;45;45;0.422222222222222;26;19;0.0777777777777778;0.422222222222222
Control.SRR15539829;40;45;0.45;22;18;0.05;0.45
Control.SRR15539829;47;45;0.25531914893617;35;12;0.24468085106383;0.25531914893617
Control.SRR15539829;43;45;0.465116279069767;23;20;0.0348837209302326;0.465116279069767
Control.SRR15539829;46;45;0.391304347826087;28;18;0.108695652173913;0.391304347826087
Control.SRR15539829;42;45;0.428571428571429;24;18;0.0714285714285715;0.428571428571429
Control.SRR15539829;47;45;0.446808510638298;26;21;0.0531914893617021;0.446808510638298
Control.SRR15539829;51;45;0.470588235294118;27;24;0.0294117647058824;0.470588235294118
Control.SRR15539829;46;45;0.5;23;23;0;0.5
Control.SRR15539829;45;45;0.533333333333333;21;24;0.0333333333333333;0.466666666666667
Control.SRR15539829;51;45;0.431372549019608;29;22;0.0686274509803921;0.431372549019608
Control.SRR15539829;49;45;0.448979591836735;27;22;0.0510204081632653;0.448979591836735
Control.SRR15539829;50;45;0.46;27;23;0.04;0.46
Control.SRR15539829;48;45;0.5625;21;27;0.0625;0.4375
Control.SRR15539829;51;45;0.627450980392157;19;32;0.127450980392157;0.372549019607843
Control.SRR15539829;52;45;0.365384615384615;33;19;0.134615384615385;0.365384615384615
Control.SRR15539829;47;45;0.574468085106383;20;27;0.074468085106383;0.425531914893617
Control.SRR15539829;51;45;0.470588235294118;27;24;0.0294117647058824;0.470588235294118
Control.SRR15539829;47;45;0.468085106382979;25;22;0.0319148936170213;0.468085106382979
Control.SRR15539829;44;45;0.5;22;22;0;0.5
Control.SRR15539829;50;45;0.54;23;27;0.04;0.46
Control.SRR15539829;52;45;0.480769230769231;27;25;0.0192307692307692;0.480769230769231
Control.SRR15539829;50;45;0.58;21;29;0.08;0.42
Control.SRR15539829;52;45;0.519230769230769;25;27;0.0192307692307693;0.480769230769231
Control.SRR15539829;51;45;0.588235294117647;21;30;0.0882352941176471;0.411764705882353
Control.SRR15539829;42;45;0.428571428571429;24;18;0.0714285714285715;0.428571428571429
Control.SRR15539829;42;45;0.523809523809524;20;22;0.0238095238095238;0.476190476190476
Control.SRR15539829;40;45;0.55;18;22;0.05;0.45
Control.SRR15539829;52;45;0.403846153846154;31;21;0.0961538461538461;0.403846153846154
Control.SRR15539829;52;45;0.576923076923077;22;30;0.0769230769230769;0.423076923076923
Control.SRR15539829;48;45;0.583333333333333;20;28;0.0833333333333334;0.416666666666667
Control.SRR15539829;47;45;0.468085106382979;25;22;0.0319148936170213;0.468085106382979
Control.SRR15539829;44;45;0.590909090909091;18;26;0.0909090909090909;0.409090909090909
Control.SRR15539829;43;45;0.395348837209302;26;17;0.104651162790698;0.395348837209302
Control.SRR15539829;46;45;0.521739130434783;22;24;0.0217391304347826;0.478260869565217
Control.SRR15539829;52;45;0.346153846153846;34;18;0.153846153846154;0.346153846153846
Control.SRR15539829;49;45;0.469387755102041;26;23;0.0306122448979592;0.469387755102041
Control.SRR15539829;41;45;0.51219512195122;20;21;0.0121951219512195;0.48780487804878
Control.SRR15539829;46;45;0.456521739130435;25;21;0.0434782608695652;0.456521739130435
Control.SRR15539829;50;45;0.48;26;24;0.02;0.48
Control.SRR15539829;47;45;0.51063829787234;23;24;0.0106382978723404;0.48936170212766
Control.SRR15539829;40;45;0.425;23;17;0.075;0.425
Control.SRR15539829;44;45;0.613636363636364;17;27;0.113636363636364;0.386363636363636
Control.SRR15539829;51;45;0.568627450980392;22;29;0.0686274509803921;0.431372549019608
Control.SRR15539829;49;45;0.591836734693878;20;29;0.0918367346938775;0.408163265306122
Control.SRR15539829;50;45;0.34;33;17;0.16;0.34
Control.SRR15539829;52;45;0.346153846153846;34;18;0.153846153846154;0.346153846153846
Control.SRR15539829;47;45;0.574468085106383;20;27;0.074468085106383;0.425531914893617
Control.SRR15539829;40;45;0.65;14;26;0.15;0.35
Control.SRR15539829;48;45;0.395833333333333;29;19;0.104166666666667;0.395833333333333
Control.SRR15539829;46;45;0.565217391304348;20;26;0.0652173913043478;0.434782608695652
Control.SRR15539829;49;45;0.612244897959184;19;30;0.112244897959184;0.387755102040816
Control.SRR15539829;44;45;0.477272727272727;23;21;0.0227272727272727;0.477272727272727
Control.SRR15539829;44;45;0.409090909090909;26;18;0.0909090909090909;0.409090909090909
Control.SRR15539829;46;45;0.434782608695652;26;20;0.0652173913043478;0.434782608695652
Control.SRR15539829;47;45;0.659574468085106;16;31;0.159574468085106;0.340425531914894
Control.SRR15539829;49;45;0.551020408163265;22;27;0.0510204081632653;0.448979591836735
Control.SRR15539829;48;45;0.479166666666667;25;23;0.0208333333333333;0.479166666666667
Control.SRR15539829;44;45;0.477272727272727;23;21;0.0227272727272727;0.477272727272727
Control.SRR15539829;42;45;0.619047619047619;16;26;0.119047619047619;0.380952380952381
Control.SRR15539829;50;45;0.44;28;22;0.06;0.44
Control.SRR15539829;47;45;0.51063829787234;23;24;0.0106382978723404;0.48936170212766
Control.SRR15539829;41;45;0.463414634146341;22;19;0.0365853658536585;0.463414634146341
Control.SRR15539829;46;45;0.521739130434783;22;24;0.0217391304347826;0.478260869565217
Control.SRR15539829;50;45;0.42;29;21;0.08;0.42
Control.SRR15539829;41;45;0.51219512195122;20;21;0.0121951219512195;0.48780487804878
Control.SRR15539829;47;45;0.425531914893617;27;20;0.074468085106383;0.425531914893617
Control.SRR15539829;40;45;0.6;16;24;0.1;0.4
Control.SRR15539829;50;45;0.4;30;20;0.1;0.4
Control.SRR15539829;49;45;0.489795918367347;25;24;0.0102040816326531;0.489795918367347
Control.SRR15539829;45;45;0.466666666666667;24;21;0.0333333333333333;0.466666666666667
Control.SRR15539829;41;45;0.682926829268293;13;28;0.182926829268293;0.317073170731707
Control.SRR15539829;48;45;0.541666666666667;22;26;0.0416666666666666;0.458333333333333
Control.SRR15539829;49;45;0.510204081632653;24;25;0.0102040816326531;0.489795918367347
Control.SRR15539829;41;45;0.51219512195122;20;21;0.0121951219512195;0.48780487804878
Control.SRR15539829;44;45;0.568181818181818;19;25;0.0681818181818182;0.431818181818182
Control.SRR15539829;47;45;0.361702127659574;30;17;0.138297872340426;0.361702127659574
Control.SRR15539829;44;45;0.568181818181818;19;25;0.0681818181818182;0.431818181818182
Control.SRR15539829;48;45;0.520833333333333;23;25;0.0208333333333334;0.479166666666667
Control.SRR15539829;43;45;0.511627906976744;21;22;0.0116279069767442;0.488372093023256
Control.SRR15539829;49;45;0.591836734693878;20;29;0.0918367346938775;0.408163265306122
Control.SRR15539829;51;45;0.627450980392157;19;32;0.127450980392157;0.372549019607843
Control.SRR15539829;40;45;0.55;18;22;0.05;0.45
Control.SRR15539829;45;45;0.555555555555556;20;25;0.0555555555555556;0.444444444444444
Control.SRR15539829;40;45;0.425;23;17;0.075;0.425
Control.SRR15539829;43;45;0.534883720930233;20;23;0.0348837209302325;0.465116279069767
Control.SRR15539829;51;45;0.431372549019608;29;22;0.0686274509803921;0.431372549019608
Control.SRR15539829;46;45;0.478260869565217;24;22;0.0217391304347826;0.478260869565217
Control.SRR15539829;49;45;0.36734693877551;31;18;0.13265306122449;0.36734693877551
Control.SRR15539829;47;45;0.425531914893617;27;20;0.074468085106383;0.425531914893617
Control.SRR15539829;40;45;0.45;22;18;0.05;0.45
Control.SRR15539829;47;45;0.617021276595745;18;29;0.117021276595745;0.382978723404255
Control.SRR15539829;44;45;0.340909090909091;29;15;0.159090909090909;0.340909090909091
Control.SRR15539829;49;45;0.530612244897959;23;26;0.0306122448979592;0.469387755102041
Control.SRR15539829;48;45;0.520833333333333;23;25;0.0208333333333334;0.479166666666667
Control.SRR15539829;46;45;0.478260869565217;24;22;0.0217391304347826;0.478260869565217
Control.SRR15539829;44;45;0.431818181818182;25;19;0.0681818181818182;0.431818181818182
Control.SRR15539829;47;45;0.48936170212766;24;23;0.0106382978723404;0.48936170212766
Control.SRR15539829;50;45;0.5;25;25;0;0.5
Control.SRR15539829;50;45;0.3;35;15;0.2;0.3
Control.SRR15539829;45;45;0.4;27;18;0.1;0.4
Control.SRR15539829;48;45;0.541666666666667;22;26;0.0416666666666666;0.458333333333333
Control.SRR15539829;44;45;0.318181818181818;30;14;0.181818181818182;0.318181818181818
Control.SRR15539829;44;45;0.454545454545455;24;20;0.0454545454545455;0.454545454545455
Control.SRR15539829;52;45;0.5;26;26;0;0.5
Control.SRR15539829;48;45;0.604166666666667;19;29;0.104166666666667;0.395833333333333
Control.SRR15539829;46;45;0.608695652173913;18;28;0.108695652173913;0.391304347826087
Control.SRR15539829;49;45;0.510204081632653;24;25;0.0102040816326531;0.489795918367347
Control.SRR15539829;49;45;0.489795918367347;25;24;0.0102040816326531;0.489795918367347
Control.SRR15539829;51;45;0.529411764705882;24;27;0.0294117647058824;0.470588235294118
Control.SRR15539829;50;45;0.4;30;20;0.1;0.4
Control.SRR15539829;51;45;0.490196078431373;26;25;0.00980392156862747;0.490196078431373
Control.SRR15539829;43;45;0.441860465116279;24;19;0.0581395348837209;0.441860465116279
Control.SRR15539829;44;45;0.613636363636364;17;27;0.113636363636364;0.386363636363636
Control.SRR15539829;42;45;0.547619047619048;19;23;0.0476190476190477;0.452380952380952
Control.SRR15539829;41;45;0.463414634146341;22;19;0.0365853658536585;0.463414634146341
Control.SRR15539829;46;45;0.391304347826087;28;18;0.108695652173913;0.391304347826087
Control.SRR15539829;41;45;0.634146341463415;15;26;0.134146341463415;0.365853658536585
Control.SRR15539829;44;45;0.522727272727273;21;23;0.0227272727272727;0.477272727272727
Control.SRR15539829;43;45;0.581395348837209;18;25;0.0813953488372093;0.418604651162791
Control.SRR15539829;44;45;0.545454545454545;20;24;0.0454545454545454;0.454545454545455
Control.SRR15539829;48;45;0.520833333333333;23;25;0.0208333333333334;0.479166666666667
Control.SRR15539829;41;45;0.51219512195122;20;21;0.0121951219512195;0.48780487804878
Control.SRR15539829;42;45;0.547619047619048;19;23;0.0476190476190477;0.452380952380952
Control.SRR15539829;44;45;0.409090909090909;26;18;0.0909090909090909;0.409090909090909
Control.SRR15539829;45;45;0.4;27;18;0.1;0.4
Control.SRR15539829;46;45;0.521739130434783;22;24;0.0217391304347826;0.478260869565217
Control.SRR15539829;52;45;0.480769230769231;27;25;0.0192307692307692;0.480769230769231
Control.SRR15539829;42;45;0.523809523809524;20;22;0.0238095238095238;0.476190476190476
Control.SRR15539829;48;45;0.645833333333333;17;31;0.145833333333333;0.354166666666667
Control.SRR15539829;44;45;0.522727272727273;21;23;0.0227272727272727;0.477272727272727
Control.SRR15539829;52;45;0.519230769230769;25;27;0.0192307692307693;0.480769230769231
Control.SRR15539829;43;45;0.534883720930233;20;23;0.0348837209302325;0.465116279069767
Control.SRR15539829;50;45;0.5;25;25;0;0.5
Control.SRR15539829;49;45;0.448979591836735;27;22;0.0510204081632653;0.448979591836735
Control.SRR15539829;50;45;0.44;28;22;0.06;0.44
Control.SRR15539829;51;45;0.509803921568627;25;26;0.00980392156862742;0.490196078431373
Control.SRR15539829;44;45;0.5;22;22;0;0.5
Control.SRR15539829;43;45;0.441860465116279;24;19;0.0581395348837209;0.441860465116279
Control.SRR15539829;44;45;0.454545454545455;24;20;0.0454545454545455;0.454545454545455
Control.SRR15539829;45;45;0.444444444444444;25;20;0.0555555555555556;0.444444444444444
Control.SRR15539829;41;45;0.439024390243902;23;18;0.0609756097560976;0.439024390243902
Control.SRR15539829;40;45;0.425;23;17;0.075;0.425
Control.SRR15539829;48;45;0.520833333333333;23;25;0.0208333333333334;0.479166666666667
Control.SRR15539829;44;45;0.545454545454545;20;24;0.0454545454545454;0.454545454545455
Control.SRR15539829;51;45;0.450980392156863;28;23;0.0490196078431372;0.450980392156863
Control.SRR15539829;46;45;0.543478260869565;21;25;0.0434782608695652;0.456521739130435
Control.SRR15539829;40;45;0.6;16;24;0.1;0.4
Control.SRR15539829;40;45;0.525;19;21;0.025;0.475
Control.SRR15539829;51;45;0.509803921568627;25;26;0.00980392156862742;0.490196078431373
Control.SRR15539829;46;45;0.41304347826087;27;19;0.0869565217391304;0.41304347826087
Control.SRR15539829;42;45;0.547619047619048;19;23;0.0476190476190477;0.452380952380952
Control.SRR15539829;47;45;0.531914893617021;22;25;0.0319148936170213;0.468085106382979
Control.SRR15539829;40;45;0.525;19;21;0.025;0.475
Control.SRR15539829;40;45;0.65;14;26;0.15;0.35
Control.SRR15539829;41;45;0.51219512195122;20;21;0.0121951219512195;0.48780487804878
Control.SRR15539829;44;45;0.568181818181818;19;25;0.0681818181818182;0.431818181818182
Control.SRR15539829;47;45;0.48936170212766;24;23;0.0106382978723404;0.48936170212766
Control.SRR15539829;43;45;0.511627906976744;21;22;0.0116279069767442;0.488372093023256
Control.SRR15539829;48;45;0.583333333333333;20;28;0.0833333333333334;0.416666666666667
Control.SRR15539829;48;45;0.5625;21;27;0.0625;0.4375
Control.SRR15539829;42;45;0.523809523809524;20;22;0.0238095238095238;0.476190476190476
Control.SRR15539829;46;45;0.434782608695652;26;20;0.0652173913043478;0.434782608695652
Control.SRR15539829;46;45;0.58695652173913;19;27;0.0869565217391305;0.41304347826087
Control.SRR15539829;48;45;0.604166666666667;19;29;0.104166666666667;0.395833333333333
Control.SRR15539829;42;45;0.404761904761905;25;17;0.0952380952380952;0.404761904761905
Control.SRR15539829;50;45;0.44;28;22;0.06;0.44
Control.SRR15539829;46;45;0.434782608695652;26;20;0.0652173913043478;0.434782608695652
Control.SRR15539829;50;45;0.58;21;29;0.08;0.42
Control.SRR15539829;47;45;0.574468085106383;20;27;0.074468085106383;0.425531914893617
Control.SRR15539829;50;45;0.44;28;22;0.06;0.44
Control.SRR15539829;46;45;0.391304347826087;28;18;0.108695652173913;0.391304347826087
Control.SRR15539829;52;45;0.442307692307692;29;23;0.0576923076923077;0.442307692307692
Control.SRR15539829;48;45;0.520833333333333;23;25;0.0208333333333334;0.479166666666667
Control.SRR15539829;52;45;0.557692307692308;23;29;0.0576923076923077;0.442307692307692
Control.SRR15539829;48;45;0.3125;33;15;0.1875;0.3125
Control.SRR15539829;48;45;0.5625;21;27;0.0625;0.4375
Control.SRR15539829;47;45;0.574468085106383;20;27;0.074468085106383;0.425531914893617
Control.SRR15539829;40;45;0.45;22;18;0.05;0.45
Control.SRR15539829;50;45;0.66;17;33;0.16;0.34
Control.SRR15539829;52;45;0.384615384615385;32;20;0.115384615384615;0.384615384615385
Control.SRR15539829;43;45;0.558139534883721;19;24;0.0581395348837209;0.441860465116279
Control.SRR15539829;43;45;0.604651162790698;17;26;0.104651162790698;0.395348837209302
Control.SRR15539829;51;45;0.392156862745098;31;20;0.107843137254902;0.392156862745098
Control.SRR15539829;40;45;0.55;18;22;0.05;0.45
Control.SRR15539829;44;45;0.522727272727273;21;23;0.0227272727272727;0.477272727272727
Control.SRR15539829;50;45;0.48;26;24;0.02;0.48
Control.SRR15539829;46;45;0.260869565217391;34;12;0.239130434782609;0.260869565217391
Control.SRR15539829;42;45;0.380952380952381;26;16;0.119047619047619;0.380952380952381
Control.SRR15539829;50;45;0.42;29;21;0.08;0.42
Control.SRR15539829;44;45;0.5;22;22;0;0.5
Control.SRR15539829;45;45;0.444444444444444;25;20;0.0555555555555556;0.444444444444444
Control.SRR15539829;50;45;0.64;18;32;0.14;0.36
Control.SRR15539829;51;45;0.529411764705882;24;27;0.0294117647058824;0.470588235294118
Control.SRR15539829;43;45;0.558139534883721;19;24;0.0581395348837209;0.441860465116279
Control.SRR15539829;45;45;0.488888888888889;23;22;0.0111111111111111;0.488888888888889
Control.SRR15539829;50;45;0.52;24;26;0.02;0.48
Control.SRR15539829;40;45;0.525;19;21;0.025;0.475
Control.SRR15539829;43;45;0.581395348837209;18;25;0.0813953488372093;0.418604651162791
Control.SRR15539829;48;45;0.5;24;24;0;0.5
Control.SRR15539829;46;45;0.5;23;23;0;0.5
Control.SRR15539829;46;45;0.41304347826087;27;19;0.0869565217391304;0.41304347826087
Control.SRR15539829;49;45;0.408163265306122;29;20;0.0918367346938775;0.408163265306122
Control.SRR15539829;40;45;0.55;18;22;0.05;0.45
Control.SRR15539829;43;45;0.488372093023256;22;21;0.0116279069767442;0.488372093023256
Control.SRR15539829;51;45;0.529411764705882;24;27;0.0294117647058824;0.470588235294118
Control.SRR15539829;47;45;0.595744680851064;19;28;0.0957446808510638;0.404255319148936
Control.SRR15539829;42;45;0.69047619047619;13;29;0.19047619047619;0.30952380952381
Control.SRR15539829;42;45;0.5;21;21;0;0.5
Control.SRR15539829;50;45;0.44;28;22;0.06;0.44
Control.SRR15539829;45;45;0.444444444444444;25;20;0.0555555555555556;0.444444444444444
Control.SRR15539829;48;45;0.458333333333333;26;22;0.0416666666666667;0.458333333333333
Control.SRR15539829;52;45;0.423076923076923;30;22;0.0769230769230769;0.423076923076923
Control.SRR15539829;48;45;0.4375;27;21;0.0625;0.4375
Control.SRR15539829;46;45;0.5;23;23;0;0.5
Control.SRR15539829;46;45;0.41304347826087;27;19;0.0869565217391304;0.41304347826087
Control.SRR15539829;40;45;0.525;19;21;0.025;0.475
Control.SRR15539829;49;45;0.510204081632653;24;25;0.0102040816326531;0.489795918367347
Control.SRR15539829;47;45;0.574468085106383;20;27;0.074468085106383;0.425531914893617
Control.SRR15539829;41;45;0.536585365853659;19;22;0.0365853658536586;0.463414634146341
Control.SRR15539829;42;45;0.5;21;21;0;0.5
Control.SRR15539829;46;45;0.434782608695652;26;20;0.0652173913043478;0.434782608695652
Control.SRR15539829;46;45;0.5;23;23;0;0.5
Control.SRR15539829;44;45;0.613636363636364;17;27;0.113636363636364;0.386363636363636
Control.SRR15539829;46;45;0.434782608695652;26;20;0.0652173913043478;0.434782608695652
Control.SRR15539829;43;45;0.488372093023256;22;21;0.0116279069767442;0.488372093023256
Control.SRR15539829;44;45;0.454545454545455;24;20;0.0454545454545455;0.454545454545455
Control.SRR15539829;45;45;0.533333333333333;21;24;0.0333333333333333;0.466666666666667
Control.SRR15539829;46;45;0.565217391304348;20;26;0.0652173913043478;0.434782608695652
Control.SRR15539829;45;45;0.644444444444444;16;29;0.144444444444444;0.355555555555556
Control.SRR15539829;40;45;0.525;19;21;0.025;0.475
Control.SRR15539829;48;45;0.4375;27;21;0.0625;0.4375
Control.SRR15539829;52;45;0.423076923076923;30;22;0.0769230769230769;0.423076923076923
Control.SRR15539829;51;45;0.431372549019608;29;22;0.0686274509803921;0.431372549019608
Control.SRR15539829;45;45;0.466666666666667;24;21;0.0333333333333333;0.466666666666667
Control.SRR15539829;43;45;0.488372093023256;22;21;0.0116279069767442;0.488372093023256
Control.SRR15539829;52;45;0.442307692307692;29;23;0.0576923076923077;0.442307692307692
Control.SRR15539829;47;45;0.574468085106383;20;27;0.074468085106383;0.425531914893617
Control.SRR15539829;51;45;0.450980392156863;28;23;0.0490196078431372;0.450980392156863
Control.SRR15539829;41;45;0.48780487804878;21;20;0.0121951219512195;0.48780487804878
Control.SRR15539829;51;45;0.607843137254902;20;31;0.107843137254902;0.392156862745098
Control.SRR15539829;48;45;0.458333333333333;26;22;0.0416666666666667;0.458333333333333
Control.SRR15539829;44;45;0.386363636363636;27;17;0.113636363636364;0.386363636363636
Control.SRR15539829;50;45;0.48;26;24;0.02;0.48
Control.SRR15539829;47;45;0.595744680851064;19;28;0.0957446808510638;0.404255319148936
Control.SRR15539829;49;45;0.469387755102041;26;23;0.0306122448979592;0.469387755102041
Control.SRR15539829;40;45;0.35;26;14;0.15;0.35
Control.SRR15539829;48;45;0.583333333333333;20;28;0.0833333333333334;0.416666666666667
Control.SRR15539829;46;45;0.434782608695652;26;20;0.0652173913043478;0.434782608695652
Control.SRR15539829;48;45;0.604166666666667;19;29;0.104166666666667;0.395833333333333
Control.SRR15539829;41;45;0.48780487804878;21;20;0.0121951219512195;0.48780487804878
Control.SRR15539829;46;45;0.456521739130435;25;21;0.0434782608695652;0.456521739130435
Control.SRR15539829;46;45;0.630434782608696;17;29;0.130434782608696;0.369565217391304
Control.SRR15539829;43;45;0.418604651162791;25;18;0.0813953488372093;0.418604651162791
Control.SRR15539829;46;45;0.565217391304348;20;26;0.0652173913043478;0.434782608695652
Control.SRR15539829;47;45;0.51063829787234;23;24;0.0106382978723404;0.48936170212766
Control.SRR15539829;44;45;0.5;22;22;0;0.5
Control.SRR15539829;52;45;0.461538461538462;28;24;0.0384615384615384;0.461538461538462
Control.SRR15539829;40;45;0.475;21;19;0.025;0.475
Control.SRR15539829;41;45;0.48780487804878;21;20;0.0121951219512195;0.48780487804878
Control.SRR15539829;49;45;0.63265306122449;18;31;0.13265306122449;0.36734693877551
Control.SRR15539829;49;45;0.530612244897959;23;26;0.0306122448979592;0.469387755102041
Control.SRR15539829;45;45;0.444444444444444;25;20;0.0555555555555556;0.444444444444444
Control.SRR15539829;49;45;0.510204081632653;24;25;0.0102040816326531;0.489795918367347
Control.SRR15539829;40;45;0.4;24;16;0.1;0.4
Control.SRR15539829;44;45;0.431818181818182;25;19;0.0681818181818182;0.431818181818182
Control.SRR15539829;49;45;0.448979591836735;27;22;0.0510204081632653;0.448979591836735
Control.SRR15539829;50;45;0.6;20;30;0.1;0.4
Control.SRR15539829;48;45;0.5;24;24;0;0.5
Control.SRR15539829;49;45;0.591836734693878;20;29;0.0918367346938775;0.408163265306122
Control.SRR15539829;46;45;0.630434782608696;17;29;0.130434782608696;0.369565217391304
Control.SRR15539829;50;45;0.54;23;27;0.04;0.46
Control.SRR15539829;52;45;0.461538461538462;28;24;0.0384615384615384;0.461538461538462
Control.SRR15539829;45;45;0.511111111111111;22;23;0.0111111111111111;0.488888888888889
Control.SRR15539829;50;45;0.66;17;33;0.16;0.34
Control.SRR15539829;49;45;0.448979591836735;27;22;0.0510204081632653;0.448979591836735
Control.SRR15539829;52;45;0.557692307692308;23;29;0.0576923076923077;0.442307692307692
Control.SRR15539829;50;45;0.4;30;20;0.1;0.4
Control.SRR15539829;40;45;0.45;22;18;0.05;0.45
Control.SRR15539829;52;45;0.480769230769231;27;25;0.0192307692307692;0.480769230769231
Control.SRR15539829;43;45;0.441860465116279;24;19;0.0581395348837209;0.441860465116279
Control.SRR15539829;47;45;0.468085106382979;25;22;0.0319148936170213;0.468085106382979
Control.SRR15539829;49;45;0.469387755102041;26;23;0.0306122448979592;0.469387755102041
Control.SRR15539829;43;45;0.651162790697674;15;28;0.151162790697674;0.348837209302326
Control.SRR15539829;41;45;0.609756097560976;16;25;0.109756097560976;0.390243902439024
Control.SRR15539829;46;45;0.456521739130435;25;21;0.0434782608695652;0.456521739130435
Control.SRR15539829;40;45;0.575;17;23;0.075;0.425
Control.SRR15539829;47;45;0.382978723404255;29;18;0.117021276595745;0.382978723404255
Control.SRR15539829;41;45;0.536585365853659;19;22;0.0365853658536586;0.463414634146341
Control.SRR15539829;47;45;0.617021276595745;18;29;0.117021276595745;0.382978723404255
Control.SRR15539829;52;45;0.519230769230769;25;27;0.0192307692307693;0.480769230769231
Control.SRR15539829;41;45;0.536585365853659;19;22;0.0365853658536586;0.463414634146341
Control.SRR15539829;52;45;0.596153846153846;21;31;0.0961538461538461;0.403846153846154
Control.SRR15539829;41;45;0.51219512195122;20;21;0.0121951219512195;0.48780487804878
Control.SRR15539829;43;45;0.697674418604651;13;30;0.197674418604651;0.302325581395349
Control.SRR15539829;43;45;0.441860465116279;24;19;0.0581395348837209;0.441860465116279
Control.SRR15539829;42;45;0.547619047619048;19;23;0.0476190476190477;0.452380952380952
Control.SRR15539829;43;45;0.674418604651163;14;29;0.174418604651163;0.325581395348837
Control.SRR15539829;40;45;0.4;24;16;0.1;0.4
Control.SRR15539829;46;45;0.478260869565217;24;22;0.0217391304347826;0.478260869565217
Control.SRR15539829;42;45;0.5;21;21;0;0.5
Control.SRR15539829;49;45;0.489795918367347;25;24;0.0102040816326531;0.489795918367347
Control.SRR15539829;47;45;0.404255319148936;28;19;0.0957446808510639;0.404255319148936
Control.SRR15539829;44;45;0.636363636363636;16;28;0.136363636363636;0.363636363636364
Control.SRR15539829;43;45;0.418604651162791;25;18;0.0813953488372093;0.418604651162791
Control.SRR15539829;42;45;0.428571428571429;24;18;0.0714285714285715;0.428571428571429
Control.SRR15539829;50;45;0.58;21;29;0.08;0.42
Control.SRR15539829;51;45;0.588235294117647;21;30;0.0882352941176471;0.411764705882353
Control.SRR15539829;46;45;0.5;23;23;0;0.5
Control.SRR15539829;44;45;0.590909090909091;18;26;0.0909090909090909;0.409090909090909
Control.SRR15539829;49;45;0.612244897959184;19;30;0.112244897959184;0.387755102040816
Control.SRR15539829;48;45;0.625;18;30;0.125;0.375
Control.SRR15539829;48;45;0.520833333333333;23;25;0.0208333333333334;0.479166666666667
Control.SRR15539829;43;45;0.441860465116279;24;19;0.0581395348837209;0.441860465116279
Control.SRR15539829;48;45;0.520833333333333;23;25;0.0208333333333334;0.479166666666667
Control.SRR15539829;49;45;0.469387755102041;26;23;0.0306122448979592;0.469387755102041
Control.SRR15539829;52;45;0.538461538461538;24;28;0.0384615384615384;0.461538461538462
Control.SRR15539829;50;45;0.52;24;26;0.02;0.48
Control.SRR15539829;46;45;0.543478260869565;21;25;0.0434782608695652;0.456521739130435
Control.SRR15539829;41;45;0.439024390243902;23;18;0.0609756097560976;0.439024390243902
Control.SRR15539829;40;45;0.4;24;16;0.1;0.4
Control.SRR15539829;43;45;0.558139534883721;19;24;0.0581395348837209;0.441860465116279
Control.SRR15539829;46;45;0.434782608695652;26;20;0.0652173913043478;0.434782608695652
Control.SRR15539829;49;45;0.530612244897959;23;26;0.0306122448979592;0.469387755102041
Control.SRR15539829;52;45;0.384615384615385;32;20;0.115384615384615;0.384615384615385
Control.SRR15539829;51;45;0.529411764705882;24;27;0.0294117647058824;0.470588235294118
Control.SRR15539829;51;45;0.529411764705882;24;27;0.0294117647058824;0.470588235294118
Control.SRR15539829;43;45;0.348837209302326;28;15;0.151162790697674;0.348837209302326
Control.SRR15539829;45;45;0.444444444444444;25;20;0.0555555555555556;0.444444444444444
Control.SRR15539829;42;45;0.5;21;21;0;0.5
Control.SRR15539829;45;45;0.555555555555556;20;25;0.0555555555555556;0.444444444444444
Control.SRR15539829;51;45;0.450980392156863;28;23;0.0490196078431372;0.450980392156863
Control.SRR15539829;45;45;0.555555555555556;20;25;0.0555555555555556;0.444444444444444
Control.SRR15539829;46;45;0.521739130434783;22;24;0.0217391304347826;0.478260869565217
Control.SRR15539829;47;45;0.425531914893617;27;20;0.074468085106383;0.425531914893617
Control.SRR15539829;47;45;0.574468085106383;20;27;0.074468085106383;0.425531914893617
Control.SRR15539829;47;45;0.48936170212766;24;23;0.0106382978723404;0.48936170212766
Control.SRR15539829;43;45;0.441860465116279;24;19;0.0581395348837209;0.441860465116279
Control.SRR15539829;46;45;0.347826086956522;30;16;0.152173913043478;0.347826086956522
Control.SRR15539829;50;45;0.42;29;21;0.08;0.42
Control.SRR15539829;43;45;0.372093023255814;27;16;0.127906976744186;0.372093023255814
Control.SRR15539829;43;45;0.534883720930233;20;23;0.0348837209302325;0.465116279069767
Control.SRR15539829;49;45;0.551020408163265;22;27;0.0510204081632653;0.448979591836735
Control.SRR15539829;40;45;0.6;16;24;0.1;0.4
Control.SRR15539829;44;45;0.659090909090909;15;29;0.159090909090909;0.340909090909091
Control.SRR15539829;44;45;0.409090909090909;26;18;0.0909090909090909;0.409090909090909
Control.SRR15539829;49;45;0.448979591836735;27;22;0.0510204081632653;0.448979591836735
Control.SRR15539829;43;45;0.534883720930233;20;23;0.0348837209302325;0.465116279069767
Control.SRR15539829;51;45;0.529411764705882;24;27;0.0294117647058824;0.470588235294118
Control.SRR15539829;51;45;0.607843137254902;20;31;0.107843137254902;0.392156862745098
Control.SRR15539829;45;45;0.511111111111111;22;23;0.0111111111111111;0.488888888888889
Control.SRR15539829;51;45;0.490196078431373;26;25;0.00980392156862747;0.490196078431373
Control.SRR15539829;46;45;0.543478260869565;21;25;0.0434782608695652;0.456521739130435
Control.SRR15539829;48;45;0.416666666666667;28;20;0.0833333333333333;0.416666666666667
Control.SRR15539829;40;45;0.525;19;21;0.025;0.475
Control.SRR15539829;48;45;0.4375;27;21;0.0625;0.4375
Control.SRR15539829;48;45;0.416666666666667;28;20;0.0833333333333333;0.416666666666667
Control.SRR15539829;42;45;0.5;21;21;0;0.5
Control.SRR15539829;50;45;0.58;21;29;0.08;0.42
Control.SRR15539829;41;45;0.51219512195122;20;21;0.0121951219512195;0.48780487804878
Control.SRR15539829;51;45;0.549019607843137;23;28;0.0490196078431373;0.450980392156863
Control.SRR15539829;49;45;0.510204081632653;24;25;0.0102040816326531;0.489795918367347
Control.SRR15539829;48;45;0.5;24;24;0;0.5
Control.SRR15539829;43;45;0.488372093023256;22;21;0.0116279069767442;0.488372093023256
Control.SRR15539829;40;45;0.6;16;24;0.1;0.4
Control.SRR15539829;51;45;0.411764705882353;30;21;0.0882352941176471;0.411764705882353
Control.SRR15539829;50;45;0.42;29;21;0.08;0.42
Control.SRR15539829;50;45;0.62;19;31;0.12;0.38
Control.SRR15539829;45;45;0.355555555555556;29;16;0.144444444444444;0.355555555555556
Control.SRR15539829;44;45;0.340909090909091;29;15;0.159090909090909;0.340909090909091
Control.SRR15539829;44;45;0.545454545454545;20;24;0.0454545454545454;0.454545454545455
Control.SRR15539829;46;45;0.630434782608696;17;29;0.130434782608696;0.369565217391304
Control.SRR15539829;43;45;0.651162790697674;15;28;0.151162790697674;0.348837209302326
Control.SRR15539829;42;45;0.452380952380952;23;19;0.0476190476190476;0.452380952380952
Control.SRR15539829;48;45;0.583333333333333;20;28;0.0833333333333334;0.416666666666667
Control.SRR15539829;40;45;0.525;19;21;0.025;0.475
Control.SRR15539829;44;45;0.5;22;22;0;0.5
Control.SRR15539829;43;45;0.534883720930233;20;23;0.0348837209302325;0.465116279069767
Control.SRR15539829;43;45;0.418604651162791;25;18;0.0813953488372093;0.418604651162791
Control.SRR15539829;52;45;0.461538461538462;28;24;0.0384615384615384;0.461538461538462
Control.SRR15539829;41;45;0.341463414634146;27;14;0.158536585365854;0.341463414634146
Control.SRR15539829;41;45;0.341463414634146;27;14;0.158536585365854;0.341463414634146
Control.SRR15539829;52;45;0.442307692307692;29;23;0.0576923076923077;0.442307692307692
Control.SRR15539829;51;45;0.549019607843137;23;28;0.0490196078431373;0.450980392156863
Control.SRR15539829;42;45;0.571428571428571;18;24;0.0714285714285714;0.428571428571429
Control.SRR15539829;40;45;0.525;19;21;0.025;0.475
Control.SRR15539829;52;45;0.5;26;26;0;0.5
Control.SRR15539829;51;45;0.490196078431373;26;25;0.00980392156862747;0.490196078431373
Control.SRR15539829;40;45;0.5;20;20;0;0.5
Control.SRR15539829;49;45;0.469387755102041;26;23;0.0306122448979592;0.469387755102041
Control.SRR15539829;42;45;0.357142857142857;27;15;0.142857142857143;0.357142857142857
Control.SRR15539829;46;45;0.521739130434783;22;24;0.0217391304347826;0.478260869565217
Control.SRR15539829;50;45;0.5;25;25;0;0.5
Control.SRR15539829;41;45;0.341463414634146;27;14;0.158536585365854;0.341463414634146
Control.SRR15539829;49;45;0.448979591836735;27;22;0.0510204081632653;0.448979591836735
Control.SRR15539829;47;45;0.468085106382979;25;22;0.0319148936170213;0.468085106382979
Control.SRR15539829;40;45;0.55;18;22;0.05;0.45
Control.SRR15539829;43;45;0.488372093023256;22;21;0.0116279069767442;0.488372093023256
Control.SRR15539829;41;45;0.414634146341463;24;17;0.0853658536585366;0.414634146341463
Control.SRR15539829;41;45;0.341463414634146;27;14;0.158536585365854;0.341463414634146
Control.SRR15539829;44;45;0.431818181818182;25;19;0.0681818181818182;0.431818181818182
Control.SRR15539829;45;45;0.4;27;18;0.1;0.4
Control.SRR15539829;47;45;0.595744680851064;19;28;0.0957446808510638;0.404255319148936
Control.SRR15539829;48;45;0.541666666666667;22;26;0.0416666666666666;0.458333333333333
Control.SRR15539829;43;45;0.372093023255814;27;16;0.127906976744186;0.372093023255814
Control.SRR15539829;40;45;0.475;21;19;0.025;0.475
Control.SRR15539829;42;45;0.571428571428571;18;24;0.0714285714285714;0.428571428571429
Control.SRR15539829;44;45;0.386363636363636;27;17;0.113636363636364;0.386363636363636
Control.SRR15539829;48;45;0.479166666666667;25;23;0.0208333333333333;0.479166666666667
Control.SRR15539829;43;45;0.581395348837209;18;25;0.0813953488372093;0.418604651162791
Control.SRR15539829;40;45;0.525;19;21;0.025;0.475
Control.SRR15539829;43;45;0.604651162790698;17;26;0.104651162790698;0.395348837209302
Control.SRR15539829;41;45;0.439024390243902;23;18;0.0609756097560976;0.439024390243902
Control.SRR15539829;41;45;0.48780487804878;21;20;0.0121951219512195;0.48780487804878
Control.SRR15539829;48;45;0.416666666666667;28;20;0.0833333333333333;0.416666666666667
Control.SRR15539829;52;45;0.596153846153846;21;31;0.0961538461538461;0.403846153846154
Control.SRR15539829;44;45;0.568181818181818;19;25;0.0681818181818182;0.431818181818182
Control.SRR15539829;43;45;0.558139534883721;19;24;0.0581395348837209;0.441860465116279
Control.SRR15539829;45;45;0.4;27;18;0.1;0.4
Control.SRR15539829;46;45;0.347826086956522;30;16;0.152173913043478;0.347826086956522
Control.SRR15539829;49;45;0.387755102040816;30;19;0.112244897959184;0.387755102040816
Control.SRR15539829;52;45;0.442307692307692;29;23;0.0576923076923077;0.442307692307692
Control.SRR15539829;42;45;0.595238095238095;17;25;0.0952380952380952;0.404761904761905
Control.SRR15539829;47;45;0.468085106382979;25;22;0.0319148936170213;0.468085106382979
Control.SRR15539829;40;45;0.475;21;19;0.025;0.475
Control.SRR15539829;40;45;0.525;19;21;0.025;0.475
Control.SRR15539829;41;45;0.585365853658537;17;24;0.0853658536585366;0.414634146341463
Control.SRR15539829;46;45;0.478260869565217;24;22;0.0217391304347826;0.478260869565217
Control.SRR15539829;47;45;0.425531914893617;27;20;0.074468085106383;0.425531914893617
Control.SRR15539829;43;45;0.511627906976744;21;22;0.0116279069767442;0.488372093023256
Control.SRR15539829;42;45;0.571428571428571;18;24;0.0714285714285714;0.428571428571429
Control.SRR15539829;48;45;0.4375;27;21;0.0625;0.4375
Control.SRR15539829;44;45;0.590909090909091;18;26;0.0909090909090909;0.409090909090909
Control.SRR15539829;45;45;0.444444444444444;25;20;0.0555555555555556;0.444444444444444
Control.SRR15539829;41;45;0.48780487804878;21;20;0.0121951219512195;0.48780487804878
Control.SRR15539829;51;45;0.490196078431373;26;25;0.00980392156862747;0.490196078431373
Control.SRR15539829;43;45;0.581395348837209;18;25;0.0813953488372093;0.418604651162791
Control.SRR15539829;43;45;0.581395348837209;18;25;0.0813953488372093;0.418604651162791
Control.SRR15539829;42;45;0.571428571428571;18;24;0.0714285714285714;0.428571428571429
Control.SRR15539829;45;45;0.355555555555556;29;16;0.144444444444444;0.355555555555556
Control.SRR15539829;50;45;0.54;23;27;0.04;0.46
Control.SRR15539829;44;45;0.522727272727273;21;23;0.0227272727272727;0.477272727272727
Control.SRR15539829;45;45;0.511111111111111;22;23;0.0111111111111111;0.488888888888889
Control.SRR15539829;44;45;0.590909090909091;18;26;0.0909090909090909;0.409090909090909
Control.SRR15539829;48;45;0.5;24;24;0;0.5
Control.SRR15539829;44;45;0.522727272727273;21;23;0.0227272727272727;0.477272727272727
Control.SRR15539829;42;45;0.547619047619048;19;23;0.0476190476190477;0.452380952380952
Control.SRR15539829;40;45;0.45;22;18;0.05;0.45
Control.SRR15539829;40;45;0.575;17;23;0.075;0.425
Control.SRR15539829;48;45;0.541666666666667;22;26;0.0416666666666666;0.458333333333333
Control.SRR15539829;51;45;0.450980392156863;28;23;0.0490196078431372;0.450980392156863
Control.SRR15539829;51;45;0.490196078431373;26;25;0.00980392156862747;0.490196078431373
Control.SRR15539829;47;45;0.51063829787234;23;24;0.0106382978723404;0.48936170212766
Control.SRR15539829;50;45;0.6;20;30;0.1;0.4
Control.SRR15539829;40;45;0.6;16;24;0.1;0.4
Control.SRR15539829;51;45;0.490196078431373;26;25;0.00980392156862747;0.490196078431373
Control.SRR15539829;44;45;0.409090909090909;26;18;0.0909090909090909;0.409090909090909
Control.SRR15539829;51;45;0.568627450980392;22;29;0.0686274509803921;0.431372549019608
Control.SRR15539829;44;45;0.522727272727273;21;23;0.0227272727272727;0.477272727272727
Control.SRR15539829;40;45;0.6;16;24;0.1;0.4
Control.SRR15539829;52;45;0.461538461538462;28;24;0.0384615384615384;0.461538461538462
Control.SRR15539829;44;45;0.522727272727273;21;23;0.0227272727272727;0.477272727272727
Control.SRR15539829;45;45;0.511111111111111;22;23;0.0111111111111111;0.488888888888889
Control.SRR15539829;45;45;0.377777777777778;28;17;0.122222222222222;0.377777777777778
Control.SRR15539829;46;45;0.565217391304348;20;26;0.0652173913043478;0.434782608695652
Control.SRR15539829;45;45;0.6;18;27;0.1;0.4
Control.SRR15539829;49;45;0.530612244897959;23;26;0.0306122448979592;0.469387755102041
Control.SRR15539829;42;45;0.547619047619048;19;23;0.0476190476190477;0.452380952380952
Control.SRR15539829;44;45;0.522727272727273;21;23;0.0227272727272727;0.477272727272727
Control.SRR15539829;42;45;0.428571428571429;24;18;0.0714285714285715;0.428571428571429
Control.SRR15539829;50;45;0.54;23;27;0.04;0.46
Control.SRR15539829;47;45;0.468085106382979;25;22;0.0319148936170213;0.468085106382979
Control.SRR15539829;45;45;0.622222222222222;17;28;0.122222222222222;0.377777777777778
Control.SRR15539829;52;45;0.615384615384615;20;32;0.115384615384615;0.384615384615385
Control.SRR15539829;48;45;0.5;24;24;0;0.5
Control.SRR15539829;47;45;0.553191489361702;21;26;0.0531914893617021;0.446808510638298
Control.SRR15539829;46;45;0.5;23;23;0;0.5
Control.SRR15539829;49;45;0.36734693877551;31;18;0.13265306122449;0.36734693877551
Control.SRR15539829;45;45;0.466666666666667;24;21;0.0333333333333333;0.466666666666667
Control.SRR15539829;43;45;0.511627906976744;21;22;0.0116279069767442;0.488372093023256
Control.SRR15539829;47;45;0.531914893617021;22;25;0.0319148936170213;0.468085106382979
Control.SRR15539829;47;45;0.48936170212766;24;23;0.0106382978723404;0.48936170212766
Control.SRR15539829;50;45;0.54;23;27;0.04;0.46
Control.SRR15539829;42;45;0.523809523809524;20;22;0.0238095238095238;0.476190476190476
Control.SRR15539829;48;45;0.5625;21;27;0.0625;0.4375
Control.SRR15539829;40;45;0.65;14;26;0.15;0.35
Control.SRR15539829;41;45;0.658536585365854;14;27;0.158536585365854;0.341463414634146
Control.SRR15539829;42;45;0.428571428571429;24;18;0.0714285714285715;0.428571428571429
Control.SRR15539829;48;45;0.458333333333333;26;22;0.0416666666666667;0.458333333333333
Control.SRR15539829;48;45;0.520833333333333;23;25;0.0208333333333334;0.479166666666667
Control.SRR15539829;51;45;0.509803921568627;25;26;0.00980392156862742;0.490196078431373
Control.SRR15539829;47;45;0.425531914893617;27;20;0.074468085106383;0.425531914893617
Control.SRR15539829;45;45;0.555555555555556;20;25;0.0555555555555556;0.444444444444444
Control.SRR15539829;45;45;0.533333333333333;21;24;0.0333333333333333;0.466666666666667
Control.SRR15539829;45;45;0.577777777777778;19;26;0.0777777777777777;0.422222222222222
Control.SRR15539829;43;45;0.627906976744186;16;27;0.127906976744186;0.372093023255814
Control.SRR15539829;42;45;0.595238095238095;17;25;0.0952380952380952;0.404761904761905
Control.SRR15539829;51;45;0.352941176470588;33;18;0.147058823529412;0.352941176470588
Control.SRR15539829;47;45;0.468085106382979;25;22;0.0319148936170213;0.468085106382979
Control.SRR15539829;42;45;0.476190476190476;22;20;0.0238095238095238;0.476190476190476
Control.SRR15539829;41;45;0.439024390243902;23;18;0.0609756097560976;0.439024390243902
Control.SRR15539829;45;45;0.488888888888889;23;22;0.0111111111111111;0.488888888888889
Control.SRR15539829;45;45;0.511111111111111;22;23;0.0111111111111111;0.488888888888889
Control.SRR15539829;46;45;0.456521739130435;25;21;0.0434782608695652;0.456521739130435
Control.SRR15539829;52;45;0.615384615384615;20;32;0.115384615384615;0.384615384615385
Control.SRR15539829;48;45;0.4375;27;21;0.0625;0.4375
Control.SRR15539829;43;45;0.395348837209302;26;17;0.104651162790698;0.395348837209302
Control.SRR15539829;45;45;0.533333333333333;21;24;0.0333333333333333;0.466666666666667
Control.SRR15539829;45;45;0.577777777777778;19;26;0.0777777777777777;0.422222222222222
Control.SRR15539829;43;45;0.511627906976744;21;22;0.0116279069767442;0.488372093023256
Control.SRR15539829;46;45;0.5;23;23;0;0.5
Control.SRR15539829;52;45;0.442307692307692;29;23;0.0576923076923077;0.442307692307692
Control.SRR15539829;51;45;0.607843137254902;20;31;0.107843137254902;0.392156862745098
Control.SRR15539829;51;45;0.568627450980392;22;29;0.0686274509803921;0.431372549019608
Control.SRR15539829;43;45;0.534883720930233;20;23;0.0348837209302325;0.465116279069767
Control.SRR15539829;46;45;0.608695652173913;18;28;0.108695652173913;0.391304347826087
Control.SRR15539829;42;45;0.523809523809524;20;22;0.0238095238095238;0.476190476190476
Control.SRR15539829;48;45;0.4375;27;21;0.0625;0.4375
Control.SRR15539829;43;45;0.488372093023256;22;21;0.0116279069767442;0.488372093023256
Control.SRR15539829;47;45;0.468085106382979;25;22;0.0319148936170213;0.468085106382979
Control.SRR15539829;42;45;0.404761904761905;25;17;0.0952380952380952;0.404761904761905
Control.SRR15539829;48;45;0.479166666666667;25;23;0.0208333333333333;0.479166666666667
Control.SRR15539829;47;45;0.638297872340426;17;30;0.138297872340426;0.361702127659574
Control.SRR15539829;51;45;0.470588235294118;27;24;0.0294117647058824;0.470588235294118
Control.SRR15539829;45;45;0.488888888888889;23;22;0.0111111111111111;0.488888888888889
Control.SRR15539829;51;45;0.588235294117647;21;30;0.0882352941176471;0.411764705882353
Control.SRR15539829;47;45;0.48936170212766;24;23;0.0106382978723404;0.48936170212766
Control.SRR15539829;52;45;0.576923076923077;22;30;0.0769230769230769;0.423076923076923
Control.SRR15539829;46;45;0.608695652173913;18;28;0.108695652173913;0.391304347826087
Control.SRR15539829;49;45;0.489795918367347;25;24;0.0102040816326531;0.489795918367347
Control.SRR15539829;47;45;0.446808510638298;26;21;0.0531914893617021;0.446808510638298
Control.SRR15539829;49;45;0.428571428571429;28;21;0.0714285714285715;0.428571428571429
Control.SRR15539829;45;45;0.555555555555556;20;25;0.0555555555555556;0.444444444444444
Control.SRR15539829;45;45;0.622222222222222;17;28;0.122222222222222;0.377777777777778
Control.SRR15539829;46;45;0.521739130434783;22;24;0.0217391304347826;0.478260869565217
Control.SRR15539829;45;45;0.6;18;27;0.1;0.4
Control.SRR15539829;42;45;0.571428571428571;18;24;0.0714285714285714;0.428571428571429
Control.SRR15539829;46;45;0.5;23;23;0;0.5
Control.SRR15539829;40;45;0.325;27;13;0.175;0.325
Control.SRR15539829;49;45;0.448979591836735;27;22;0.0510204081632653;0.448979591836735
Control.SRR15539829;48;45;0.458333333333333;26;22;0.0416666666666667;0.458333333333333
Control.SRR15539829;46;45;0.456521739130435;25;21;0.0434782608695652;0.456521739130435
Control.SRR15539829;49;45;0.530612244897959;23;26;0.0306122448979592;0.469387755102041
Control.SRR15539829;49;45;0.489795918367347;25;24;0.0102040816326531;0.489795918367347
Control.SRR15539829;43;45;0.534883720930233;20;23;0.0348837209302325;0.465116279069767
Control.SRR15539829;48;45;0.5;24;24;0;0.5
Control.SRR15539829;48;45;0.5;24;24;0;0.5
Control.SRR15539829;47;45;0.468085106382979;25;22;0.0319148936170213;0.468085106382979
Control.SRR15539829;48;45;0.645833333333333;17;31;0.145833333333333;0.354166666666667
Control.SRR15539829;40;45;0.475;21;19;0.025;0.475
Control.SRR15539829;52;45;0.519230769230769;25;27;0.0192307692307693;0.480769230769231
Control.SRR15539829;46;45;0.5;23;23;0;0.5
Control.SRR15539829;42;45;0.476190476190476;22;20;0.0238095238095238;0.476190476190476
Control.SRR15539829;44;45;0.5;22;22;0;0.5
Control.SRR15539829;44;45;0.318181818181818;30;14;0.181818181818182;0.318181818181818
Control.SRR15539829;49;45;0.408163265306122;29;20;0.0918367346938775;0.408163265306122
Control.SRR15539829;48;45;0.541666666666667;22;26;0.0416666666666666;0.458333333333333
Control.SRR15539829;51;45;0.529411764705882;24;27;0.0294117647058824;0.470588235294118
Control.SRR15539829;43;45;0.465116279069767;23;20;0.0348837209302326;0.465116279069767
Control.SRR15539829;47;45;0.638297872340426;17;30;0.138297872340426;0.361702127659574
Control.SRR15539829;52;45;0.519230769230769;25;27;0.0192307692307693;0.480769230769231
Control.SRR15539829;54;45;0.592592592592593;22;32;0.0925925925925926;0.407407407407407
Control.SRR15539829;40;45;0.425;23;17;0.075;0.425
Control.SRR15539829;45;45;0.466666666666667;24;21;0.0333333333333333;0.466666666666667
Control.SRR15539829;52;45;0.480769230769231;27;25;0.0192307692307692;0.480769230769231
Control.SRR15539829;49;45;0.510204081632653;24;25;0.0102040816326531;0.489795918367347
Control.SRR15539829;50;45;0.6;20;30;0.1;0.4
Control.SRR15539829;46;45;0.456521739130435;25;21;0.0434782608695652;0.456521739130435
Control.SRR15539829;47;45;0.468085106382979;25;22;0.0319148936170213;0.468085106382979
Control.SRR15539829;54;45;0.537037037037037;25;29;0.0370370370370371;0.462962962962963
Control.SRR15539829;44;45;0.545454545454545;20;24;0.0454545454545454;0.454545454545455
Control.SRR15539829;44;45;0.386363636363636;27;17;0.113636363636364;0.386363636363636
Control.SRR15539829;42;45;0.452380952380952;23;19;0.0476190476190476;0.452380952380952
Control.SRR15539829;49;45;0.469387755102041;26;23;0.0306122448979592;0.469387755102041
Control.SRR15539829;41;45;0.585365853658537;17;24;0.0853658536585366;0.414634146341463
Control.SRR15539829;52;45;0.519230769230769;25;27;0.0192307692307693;0.480769230769231
Control.SRR15539829;47;45;0.446808510638298;26;21;0.0531914893617021;0.446808510638298
Control.SRR15539829;46;45;0.608695652173913;18;28;0.108695652173913;0.391304347826087
Control.SRR15539829;46;45;0.521739130434783;22;24;0.0217391304347826;0.478260869565217
Control.SRR15539829;50;45;0.46;27;23;0.04;0.46
Control.SRR15539829;53;45;0.490566037735849;27;26;0.00943396226415094;0.490566037735849
Control.SRR15539829;46;45;0.478260869565217;24;22;0.0217391304347826;0.478260869565217
Control.SRR15539829;40;45;0.525;19;21;0.025;0.475
Control.SRR15539829;41;45;0.560975609756098;18;23;0.0609756097560976;0.439024390243902
Control.SRR15539829;41;45;0.560975609756098;18;23;0.0609756097560976;0.439024390243902
Control.SRR15539829;48;45;0.520833333333333;23;25;0.0208333333333334;0.479166666666667
Control.SRR15539829;45;45;0.466666666666667;24;21;0.0333333333333333;0.466666666666667
Control.SRR15539829;44;45;0.431818181818182;25;19;0.0681818181818182;0.431818181818182
Control.SRR15539829;43;45;0.534883720930233;20;23;0.0348837209302325;0.465116279069767
Control.SRR15539829;43;45;0.651162790697674;15;28;0.151162790697674;0.348837209302326
Control.SRR15539829;48;45;0.541666666666667;22;26;0.0416666666666666;0.458333333333333
Control.SRR15539829;44;45;0.454545454545455;24;20;0.0454545454545455;0.454545454545455
Control.SRR15539829;47;45;0.617021276595745;18;29;0.117021276595745;0.382978723404255
Control.SRR15539829;51;45;0.607843137254902;20;31;0.107843137254902;0.392156862745098
Control.SRR15539829;49;45;0.469387755102041;26;23;0.0306122448979592;0.469387755102041
Control.SRR15539829;41;45;0.585365853658537;17;24;0.0853658536585366;0.414634146341463
Control.SRR15539829;47;45;0.51063829787234;23;24;0.0106382978723404;0.48936170212766
Control.SRR15539829;42;45;0.476190476190476;22;20;0.0238095238095238;0.476190476190476
Control.SRR15539829;43;45;0.441860465116279;24;19;0.0581395348837209;0.441860465116279
Control.SRR15539829;41;45;0.48780487804878;21;20;0.0121951219512195;0.48780487804878
Control.SRR15539829;46;45;0.521739130434783;22;24;0.0217391304347826;0.478260869565217
Control.SRR15539829;54;45;0.425925925925926;31;23;0.0740740740740741;0.425925925925926
Control.SRR15539829;42;45;0.547619047619048;19;23;0.0476190476190477;0.452380952380952
Control.SRR15539829;50;45;0.46;27;23;0.04;0.46
Control.SRR15539829;43;45;0.651162790697674;15;28;0.151162790697674;0.348837209302326
Control.SRR15539829;45;45;0.644444444444444;16;29;0.144444444444444;0.355555555555556
Control.SRR15539829;42;45;0.642857142857143;15;27;0.142857142857143;0.357142857142857
Control.SRR15539829;51;45;0.568627450980392;22;29;0.0686274509803921;0.431372549019608
Control.SRR15539829;49;45;0.551020408163265;22;27;0.0510204081632653;0.448979591836735
Control.SRR15539829;45;45;0.466666666666667;24;21;0.0333333333333333;0.466666666666667
Control.SRR15539829;48;45;0.416666666666667;28;20;0.0833333333333333;0.416666666666667
Control.SRR15539829;41;45;0.658536585365854;14;27;0.158536585365854;0.341463414634146
Control.SRR15539829;43;45;0.372093023255814;27;16;0.127906976744186;0.372093023255814
Control.SRR15539829;41;45;0.51219512195122;20;21;0.0121951219512195;0.48780487804878
Control.SRR15539829;50;45;0.44;28;22;0.06;0.44
Control.SRR15539829;49;45;0.551020408163265;22;27;0.0510204081632653;0.448979591836735
Control.SRR15539829;47;45;0.382978723404255;29;18;0.117021276595745;0.382978723404255
Control.SRR15539829;48;45;0.5;24;24;0;0.5
Control.SRR15539829;44;45;0.522727272727273;21;23;0.0227272727272727;0.477272727272727
Control.SRR15539829;49;45;0.571428571428571;21;28;0.0714285714285714;0.428571428571429
Control.SRR15539829;47;45;0.425531914893617;27;20;0.074468085106383;0.425531914893617
Control.SRR15539829;44;45;0.522727272727273;21;23;0.0227272727272727;0.477272727272727
Control.SRR15539829;47;45;0.553191489361702;21;26;0.0531914893617021;0.446808510638298
Control.SRR15539829;45;45;0.555555555555556;20;25;0.0555555555555556;0.444444444444444
Control.SRR15539829;53;45;0.490566037735849;27;26;0.00943396226415094;0.490566037735849
Control.SRR15539829;53;45;0.452830188679245;29;24;0.0471698113207547;0.452830188679245
Control.SRR15539829;40;45;0.625;15;25;0.125;0.375
Control.SRR15539829;51;45;0.431372549019608;29;22;0.0686274509803921;0.431372549019608
Control.SRR15539829;46;45;0.565217391304348;20;26;0.0652173913043478;0.434782608695652
Control.SRR15539829;52;45;0.5;26;26;0;0.5
Control.SRR15539829;50;45;0.56;22;28;0.0600000000000001;0.44
Control.SRR15539829;52;45;0.5;26;26;0;0.5
Control.SRR15539829;51;45;0.509803921568627;25;26;0.00980392156862742;0.490196078431373
Control.SRR15539829;46;45;0.456521739130435;25;21;0.0434782608695652;0.456521739130435
Control.SRR15539829;50;45;0.46;27;23;0.04;0.46
Control.SRR15539829;53;45;0.490566037735849;27;26;0.00943396226415094;0.490566037735849
Control.SRR15539829;54;45;0.5;27;27;0;0.5
Control.SRR15539829;54;45;0.555555555555556;24;30;0.0555555555555556;0.444444444444444
Control.SRR15539829;44;45;0.522727272727273;21;23;0.0227272727272727;0.477272727272727
Control.SRR15539829;42;45;0.5;21;21;0;0.5
Control.SRR15539829;51;45;0.607843137254902;20;31;0.107843137254902;0.392156862745098
Control.SRR15539829;47;45;0.553191489361702;21;26;0.0531914893617021;0.446808510638298
Control.SRR15539829;41;45;0.51219512195122;20;21;0.0121951219512195;0.48780487804878
Control.SRR15539829;52;45;0.480769230769231;27;25;0.0192307692307692;0.480769230769231
Control.SRR15539829;43;45;0.488372093023256;22;21;0.0116279069767442;0.488372093023256
Control.SRR15539829;41;45;0.536585365853659;19;22;0.0365853658536586;0.463414634146341
Control.SRR15539829;42;45;0.476190476190476;22;20;0.0238095238095238;0.476190476190476
Control.SRR15539829;42;45;0.452380952380952;23;19;0.0476190476190476;0.452380952380952
Control.SRR15539829;40;45;0.5;20;20;0;0.5
Control.SRR15539829;52;45;0.461538461538462;28;24;0.0384615384615384;0.461538461538462
Control.SRR15539829;51;45;0.568627450980392;22;29;0.0686274509803921;0.431372549019608
Control.SRR15539829;44;45;0.5;22;22;0;0.5
Control.SRR15539829;43;45;0.627906976744186;16;27;0.127906976744186;0.372093023255814
Control.SRR15539829;47;45;0.48936170212766;24;23;0.0106382978723404;0.48936170212766
Control.SRR15539829;45;45;0.555555555555556;20;25;0.0555555555555556;0.444444444444444
Control.SRR15539829;45;45;0.533333333333333;21;24;0.0333333333333333;0.466666666666667
Control.SRR15539829;49;45;0.571428571428571;21;28;0.0714285714285714;0.428571428571429
Control.SRR15539829;49;45;0.63265306122449;18;31;0.13265306122449;0.36734693877551
Control.SRR15539829;52;45;0.557692307692308;23;29;0.0576923076923077;0.442307692307692
Control.SRR15539829;43;45;0.418604651162791;25;18;0.0813953488372093;0.418604651162791
Control.SRR15539829;47;45;0.51063829787234;23;24;0.0106382978723404;0.48936170212766
Control.SRR15539829;52;45;0.519230769230769;25;27;0.0192307692307693;0.480769230769231
Control.SRR15539829;46;45;0.5;23;23;0;0.5
Control.SRR15539829;51;45;0.450980392156863;28;23;0.0490196078431372;0.450980392156863
Control.SRR15539829;51;45;0.450980392156863;28;23;0.0490196078431372;0.450980392156863
Control.SRR15539829;50;45;0.56;22;28;0.0600000000000001;0.44
Control.SRR15539829;47;45;0.531914893617021;22;25;0.0319148936170213;0.468085106382979
Control.SRR15539829;40;45;0.675;13;27;0.175;0.325
Control.SRR15539829;53;45;0.415094339622642;31;22;0.0849056603773585;0.415094339622642
Control.SRR15539829;48;45;0.479166666666667;25;23;0.0208333333333333;0.479166666666667
Control.SRR15539829;40;45;0.65;14;26;0.15;0.35
Control.SRR15539829;42;45;0.571428571428571;18;24;0.0714285714285714;0.428571428571429
Control.SRR15539829;44;45;0.5;22;22;0;0.5
Control.SRR15539829;45;45;0.488888888888889;23;22;0.0111111111111111;0.488888888888889
Control.SRR15539829;51;45;0.490196078431373;26;25;0.00980392156862747;0.490196078431373
Control.SRR15539829;48;45;0.520833333333333;23;25;0.0208333333333334;0.479166666666667
Control.SRR15539829;45;45;0.4;27;18;0.1;0.4
Control.SRR15539829;49;45;0.530612244897959;23;26;0.0306122448979592;0.469387755102041
Control.SRR15539829;40;45;0.475;21;19;0.025;0.475
Control.SRR15539829;40;45;0.475;21;19;0.025;0.475
Control.SRR15539829;41;45;0.414634146341463;24;17;0.0853658536585366;0.414634146341463
Control.SRR15539829;40;45;0.55;18;22;0.05;0.45
Control.SRR15539829;41;45;0.390243902439024;25;16;0.109756097560976;0.390243902439024
Control.SRR15539829;42;45;0.476190476190476;22;20;0.0238095238095238;0.476190476190476
Control.SRR15539829;49;45;0.428571428571429;28;21;0.0714285714285715;0.428571428571429
Control.SRR15539829;43;45;0.372093023255814;27;16;0.127906976744186;0.372093023255814
Control.SRR15539829;51;45;0.588235294117647;21;30;0.0882352941176471;0.411764705882353
Control.SRR15539829;45;45;0.4;27;18;0.1;0.4
Control.SRR15539829;50;45;0.64;18;32;0.14;0.36
Control.SRR15539829;48;45;0.583333333333333;20;28;0.0833333333333334;0.416666666666667
Control.SRR15539829;51;45;0.450980392156863;28;23;0.0490196078431372;0.450980392156863
Control.SRR15539829;44;45;0.545454545454545;20;24;0.0454545454545454;0.454545454545455
Control.SRR15539829;53;45;0.452830188679245;29;24;0.0471698113207547;0.452830188679245
Control.SRR15539829;46;45;0.456521739130435;25;21;0.0434782608695652;0.456521739130435
Control.SRR15539829;47;45;0.595744680851064;19;28;0.0957446808510638;0.404255319148936
Control.SRR15539829;47;45;0.425531914893617;27;20;0.074468085106383;0.425531914893617
Control.SRR15539829;45;45;0.466666666666667;24;21;0.0333333333333333;0.466666666666667
Control.SRR15539829;43;45;0.511627906976744;21;22;0.0116279069767442;0.488372093023256
Control.SRR15539829;47;45;0.48936170212766;24;23;0.0106382978723404;0.48936170212766
Control.SRR15539829;49;45;0.469387755102041;26;23;0.0306122448979592;0.469387755102041
Control.SRR15539829;46;45;0.608695652173913;18;28;0.108695652173913;0.391304347826087
Control.SRR15539829;44;45;0.5;22;22;0;0.5
Control.SRR15539829;44;45;0.477272727272727;23;21;0.0227272727272727;0.477272727272727
Control.SRR15539829;45;45;0.533333333333333;21;24;0.0333333333333333;0.466666666666667
Control.SRR15539829;44;45;0.431818181818182;25;19;0.0681818181818182;0.431818181818182
Control.SRR15539829;42;45;0.452380952380952;23;19;0.0476190476190476;0.452380952380952
Control.SRR15539829;54;45;0.555555555555556;24;30;0.0555555555555556;0.444444444444444
Control.SRR15539829;52;45;0.557692307692308;23;29;0.0576923076923077;0.442307692307692
Control.SRR15539829;54;45;0.592592592592593;22;32;0.0925925925925926;0.407407407407407
Control.SRR15539829;43;45;0.488372093023256;22;21;0.0116279069767442;0.488372093023256
Control.SRR15539829;44;45;0.477272727272727;23;21;0.0227272727272727;0.477272727272727
Control.SRR15539829;53;45;0.566037735849057;23;30;0.0660377358490566;0.433962264150943
Control.SRR15539829;51;45;0.568627450980392;22;29;0.0686274509803921;0.431372549019608
Control.SRR15539829;44;45;0.5;22;22;0;0.5
Control.SRR15539829;49;45;0.469387755102041;26;23;0.0306122448979592;0.469387755102041
Control.SRR15539829;49;45;0.571428571428571;21;28;0.0714285714285714;0.428571428571429
Control.SRR15539829;53;45;0.415094339622642;31;22;0.0849056603773585;0.415094339622642
Control.SRR15539829;46;45;0.41304347826087;27;19;0.0869565217391304;0.41304347826087
Control.SRR15539829;48;45;0.541666666666667;22;26;0.0416666666666666;0.458333333333333
Control.SRR15539829;54;45;0.555555555555556;24;30;0.0555555555555556;0.444444444444444
Control.SRR15539829;48;45;0.520833333333333;23;25;0.0208333333333334;0.479166666666667
Control.SRR15539829;49;45;0.448979591836735;27;22;0.0510204081632653;0.448979591836735
Control.SRR15539829;44;45;0.5;22;22;0;0.5
Control.SRR15539829;50;45;0.6;20;30;0.1;0.4
Control.SRR15539829;45;45;0.488888888888889;23;22;0.0111111111111111;0.488888888888889
Control.SRR15539829;44;45;0.522727272727273;21;23;0.0227272727272727;0.477272727272727
Control.SRR15539829;40;45;0.55;18;22;0.05;0.45
Control.SRR15539829;52;45;0.365384615384615;33;19;0.134615384615385;0.365384615384615
Control.SRR15539829;42;45;0.547619047619048;19;23;0.0476190476190477;0.452380952380952
Control.SRR15539829;46;45;0.565217391304348;20;26;0.0652173913043478;0.434782608695652
Control.SRR15539829;51;45;0.549019607843137;23;28;0.0490196078431373;0.450980392156863
Control.SRR15539829;52;45;0.5;26;26;0;0.5
Control.SRR15539829;44;45;0.522727272727273;21;23;0.0227272727272727;0.477272727272727
Control.SRR15539829;50;45;0.44;28;22;0.06;0.44
Control.SRR15539829;46;45;0.58695652173913;19;27;0.0869565217391305;0.41304347826087
Control.SRR15539829;43;45;0.395348837209302;26;17;0.104651162790698;0.395348837209302
Control.SRR15539829;53;45;0.547169811320755;24;29;0.0471698113207547;0.452830188679245
Control.SRR15539829;41;45;0.560975609756098;18;23;0.0609756097560976;0.439024390243902
Control.SRR15539829;51;45;0.529411764705882;24;27;0.0294117647058824;0.470588235294118
Control.SRR15539829;49;45;0.530612244897959;23;26;0.0306122448979592;0.469387755102041
Control.SRR15539829;47;45;0.468085106382979;25;22;0.0319148936170213;0.468085106382979
Control.SRR15539829;47;45;0.468085106382979;25;22;0.0319148936170213;0.468085106382979
Control.SRR15539829;51;45;0.431372549019608;29;22;0.0686274509803921;0.431372549019608
Control.SRR15539829;43;45;0.465116279069767;23;20;0.0348837209302326;0.465116279069767
Control.SRR15539829;45;45;0.577777777777778;19;26;0.0777777777777777;0.422222222222222
Control.SRR15539829;44;45;0.522727272727273;21;23;0.0227272727272727;0.477272727272727
Control.SRR15539829;47;45;0.595744680851064;19;28;0.0957446808510638;0.404255319148936
Control.SRR15539829;49;45;0.448979591836735;27;22;0.0510204081632653;0.448979591836735
Control.SRR15539829;47;45;0.595744680851064;19;28;0.0957446808510638;0.404255319148936
Control.SRR15539829;48;45;0.583333333333333;20;28;0.0833333333333334;0.416666666666667
Control.SRR15539829;46;45;0.608695652173913;18;28;0.108695652173913;0.391304347826087
Control.SRR15539829;53;45;0.584905660377358;22;31;0.0849056603773585;0.415094339622642
Control.SRR15539829;48;45;0.520833333333333;23;25;0.0208333333333334;0.479166666666667
Control.SRR15539829;46;45;0.543478260869565;21;25;0.0434782608695652;0.456521739130435
Control.SRR15539829;53;45;0.509433962264151;26;27;0.00943396226415094;0.490566037735849
Control.SRR15539829;47;45;0.553191489361702;21;26;0.0531914893617021;0.446808510638298
Control.SRR15539829;46;45;0.347826086956522;30;16;0.152173913043478;0.347826086956522
Control.SRR15539829;49;45;0.571428571428571;21;28;0.0714285714285714;0.428571428571429
Control.SRR15539829;51;45;0.607843137254902;20;31;0.107843137254902;0.392156862745098
Control.SRR15539829;49;45;0.530612244897959;23;26;0.0306122448979592;0.469387755102041
Control.SRR15539829;50;45;0.56;22;28;0.0600000000000001;0.44
Control.SRR15539829;46;45;0.521739130434783;22;24;0.0217391304347826;0.478260869565217
Control.SRR15539829;45;45;0.466666666666667;24;21;0.0333333333333333;0.466666666666667
Control.SRR15539829;53;45;0.377358490566038;33;20;0.122641509433962;0.377358490566038
Control.SRR15539829;44;45;0.636363636363636;16;28;0.136363636363636;0.363636363636364
Control.SRR15539829;49;45;0.551020408163265;22;27;0.0510204081632653;0.448979591836735
Control.SRR15539829;47;45;0.468085106382979;25;22;0.0319148936170213;0.468085106382979
Control.SRR15539829;50;45;0.46;27;23;0.04;0.46
Control.SRR15539829;51;45;0.490196078431373;26;25;0.00980392156862747;0.490196078431373
Control.SRR15539829;49;45;0.551020408163265;22;27;0.0510204081632653;0.448979591836735
Control.SRR15539829;47;45;0.553191489361702;21;26;0.0531914893617021;0.446808510638298
Control.SRR15539829;43;45;0.372093023255814;27;16;0.127906976744186;0.372093023255814
Control.SRR15539829;41;45;0.365853658536585;26;15;0.134146341463415;0.365853658536585
Control.SRR15539829;48;45;0.645833333333333;17;31;0.145833333333333;0.354166666666667
Control.SRR15539829;41;45;0.390243902439024;25;16;0.109756097560976;0.390243902439024
Control.SRR15539829;52;45;0.615384615384615;20;32;0.115384615384615;0.384615384615385
Control.SRR15539829;47;45;0.361702127659574;30;17;0.138297872340426;0.361702127659574
Control.SRR15539829;43;45;0.465116279069767;23;20;0.0348837209302326;0.465116279069767
Control.SRR15539829;43;45;0.395348837209302;26;17;0.104651162790698;0.395348837209302
Control.SRR15539829;40;45;0.575;17;23;0.075;0.425
Control.SRR15539829;47;45;0.574468085106383;20;27;0.074468085106383;0.425531914893617
Control.SRR15539829;48;45;0.520833333333333;23;25;0.0208333333333334;0.479166666666667
Control.SRR15539829;41;45;0.536585365853659;19;22;0.0365853658536586;0.463414634146341
Control.SRR15539829;42;45;0.428571428571429;24;18;0.0714285714285715;0.428571428571429
Control.SRR15539829;46;45;0.369565217391304;29;17;0.130434782608696;0.369565217391304
Control.SRR15539829;41;45;0.536585365853659;19;22;0.0365853658536586;0.463414634146341
Control.SRR15539829;48;45;0.5625;21;27;0.0625;0.4375
Control.SRR15539829;43;45;0.511627906976744;21;22;0.0116279069767442;0.488372093023256
Control.SRR15539829;52;45;0.5;26;26;0;0.5
Control.SRR15539829;49;45;0.530612244897959;23;26;0.0306122448979592;0.469387755102041
Control.SRR15539829;40;45;0.575;17;23;0.075;0.425
Control.SRR15539829;45;45;0.555555555555556;20;25;0.0555555555555556;0.444444444444444
Control.SRR15539829;48;45;0.479166666666667;25;23;0.0208333333333333;0.479166666666667
Control.SRR15539829;41;45;0.390243902439024;25;16;0.109756097560976;0.390243902439024
Control.SRR15539829;51;45;0.392156862745098;31;20;0.107843137254902;0.392156862745098
Control.SRR15539829;47;45;0.382978723404255;29;18;0.117021276595745;0.382978723404255
Control.SRR15539829;53;45;0.490566037735849;27;26;0.00943396226415094;0.490566037735849
Control.SRR15539829;44;45;0.568181818181818;19;25;0.0681818181818182;0.431818181818182
Control.SRR15539829;47;45;0.51063829787234;23;24;0.0106382978723404;0.48936170212766
Control.SRR15539829;47;45;0.425531914893617;27;20;0.074468085106383;0.425531914893617
Control.SRR15539829;44;45;0.545454545454545;20;24;0.0454545454545454;0.454545454545455
Control.SRR15539829;40;45;0.6;16;24;0.1;0.4
Control.SRR15539829;47;45;0.446808510638298;26;21;0.0531914893617021;0.446808510638298
Control.SRR15539829;47;45;0.531914893617021;22;25;0.0319148936170213;0.468085106382979
Control.SRR15539829;47;45;0.51063829787234;23;24;0.0106382978723404;0.48936170212766
Control.SRR15539829;54;45;0.462962962962963;29;25;0.037037037037037;0.462962962962963
Control.SRR15539829;41;45;0.463414634146341;22;19;0.0365853658536585;0.463414634146341
Control.SRR15539829;47;45;0.51063829787234;23;24;0.0106382978723404;0.48936170212766
Control.SRR15539829;52;45;0.423076923076923;30;22;0.0769230769230769;0.423076923076923
Control.SRR15539829;49;45;0.551020408163265;22;27;0.0510204081632653;0.448979591836735
Control.SRR15539829;48;45;0.5625;21;27;0.0625;0.4375
Control.SRR15539829;42;45;0.523809523809524;20;22;0.0238095238095238;0.476190476190476
Control.SRR15539829;42;45;0.428571428571429;24;18;0.0714285714285715;0.428571428571429
Control.SRR15539829;50;45;0.52;24;26;0.02;0.48
Control.SRR15539829;46;45;0.543478260869565;21;25;0.0434782608695652;0.456521739130435
Control.SRR15539829;47;45;0.48936170212766;24;23;0.0106382978723404;0.48936170212766
Control.SRR15539829;43;45;0.465116279069767;23;20;0.0348837209302326;0.465116279069767
Control.SRR15539829;47;45;0.446808510638298;26;21;0.0531914893617021;0.446808510638298
Control.SRR15539829;48;45;0.541666666666667;22;26;0.0416666666666666;0.458333333333333
Control.SRR15539829;46;45;0.41304347826087;27;19;0.0869565217391304;0.41304347826087
Control.SRR15539829;45;45;0.6;18;27;0.1;0.4
Control.SRR15539829;42;45;0.571428571428571;18;24;0.0714285714285714;0.428571428571429
Control.SRR15539829;52;45;0.480769230769231;27;25;0.0192307692307692;0.480769230769231
Control.SRR15539829;48;45;0.5625;21;27;0.0625;0.4375
Control.SRR15539829;43;45;0.674418604651163;14;29;0.174418604651163;0.325581395348837
Control.SRR15539829;40;45;0.475;21;19;0.025;0.475
Control.SRR15539829;42;45;0.666666666666667;14;28;0.166666666666667;0.333333333333333
Control.SRR15539829;52;45;0.519230769230769;25;27;0.0192307692307693;0.480769230769231
Control.SRR15539829;52;45;0.519230769230769;25;27;0.0192307692307693;0.480769230769231
Control.SRR15539829;47;45;0.531914893617021;22;25;0.0319148936170213;0.468085106382979
Control.SRR15539829;44;45;0.568181818181818;19;25;0.0681818181818182;0.431818181818182
Control.SRR15539829;48;45;0.520833333333333;23;25;0.0208333333333334;0.479166666666667
Control.SRR15539829;48;45;0.5625;21;27;0.0625;0.4375
Control.SRR15539829;43;45;0.488372093023256;22;21;0.0116279069767442;0.488372093023256
Control.SRR15539829;47;45;0.48936170212766;24;23;0.0106382978723404;0.48936170212766
Control.SRR15539829;44;45;0.636363636363636;16;28;0.136363636363636;0.363636363636364
Control.SRR15539829;50;45;0.58;21;29;0.08;0.42
Control.SRR15539829;40;45;0.575;17;23;0.075;0.425
Control.SRR15539829;43;45;0.465116279069767;23;20;0.0348837209302326;0.465116279069767
Control.SRR15539829;44;45;0.386363636363636;27;17;0.113636363636364;0.386363636363636
Control.SRR15539829;50;45;0.4;30;20;0.1;0.4
Control.SRR15539829;54;45;0.5;27;27;0;0.5
Control.SRR15539829;41;45;0.609756097560976;16;25;0.109756097560976;0.390243902439024
Control.SRR15539829;48;45;0.5;24;24;0;0.5
Control.SRR15539829;46;45;0.391304347826087;28;18;0.108695652173913;0.391304347826087
Control.SRR15539829;48;45;0.395833333333333;29;19;0.104166666666667;0.395833333333333
Control.SRR15539829;46;45;0.608695652173913;18;28;0.108695652173913;0.391304347826087
Control.SRR15539829;47;45;0.361702127659574;30;17;0.138297872340426;0.361702127659574
Control.SRR15539829;41;45;0.585365853658537;17;24;0.0853658536585366;0.414634146341463
Control.SRR15539829;50;45;0.58;21;29;0.08;0.42
Control.SRR15539829;51;45;0.470588235294118;27;24;0.0294117647058824;0.470588235294118
Control.SRR15539829;47;45;0.617021276595745;18;29;0.117021276595745;0.382978723404255
Control.SRR15539829;52;45;0.480769230769231;27;25;0.0192307692307692;0.480769230769231
Control.SRR15539829;51;45;0.431372549019608;29;22;0.0686274509803921;0.431372549019608
Control.SRR15539829;42;45;0.357142857142857;27;15;0.142857142857143;0.357142857142857
Control.SRR15539829;40;45;0.325;27;13;0.175;0.325
Control.SRR15539829;48;45;0.479166666666667;25;23;0.0208333333333333;0.479166666666667
Control.SRR15539829;40;45;0.5;20;20;0;0.5
Control.SRR15539829;45;45;0.355555555555556;29;16;0.144444444444444;0.355555555555556
Control.SRR15539829;42;45;0.452380952380952;23;19;0.0476190476190476;0.452380952380952
Control.SRR15539829;45;45;0.511111111111111;22;23;0.0111111111111111;0.488888888888889
Control.SRR15539829;41;45;0.560975609756098;18;23;0.0609756097560976;0.439024390243902
Control.SRR15539829;44;45;0.386363636363636;27;17;0.113636363636364;0.386363636363636
Control.SRR15539829;42;45;0.5;21;21;0;0.5
Control.SRR15539829;43;45;0.534883720930233;20;23;0.0348837209302325;0.465116279069767
Control.SRR15539829;47;45;0.468085106382979;25;22;0.0319148936170213;0.468085106382979
Control.SRR15539829;49;45;0.551020408163265;22;27;0.0510204081632653;0.448979591836735
Control.SRR15539829;43;45;0.558139534883721;19;24;0.0581395348837209;0.441860465116279
Control.SRR15539829;51;45;0.509803921568627;25;26;0.00980392156862742;0.490196078431373
Control.SRR15539829;49;45;0.448979591836735;27;22;0.0510204081632653;0.448979591836735
Control.SRR15539829;49;45;0.612244897959184;19;30;0.112244897959184;0.387755102040816
Control.SRR15539829;47;45;0.595744680851064;19;28;0.0957446808510638;0.404255319148936
Control.SRR15539829;43;45;0.488372093023256;22;21;0.0116279069767442;0.488372093023256
Control.SRR15539829;48;45;0.291666666666667;34;14;0.208333333333333;0.291666666666667
Control.SRR15539829;40;45;0.575;17;23;0.075;0.425
Control.SRR15539829;40;45;0.425;23;17;0.075;0.425
Control.SRR15539829;40;45;0.55;18;22;0.05;0.45
Control.SRR15539829;44;45;0.454545454545455;24;20;0.0454545454545455;0.454545454545455
Control.SRR15539829;43;45;0.488372093023256;22;21;0.0116279069767442;0.488372093023256
Control.SRR15539829;45;45;0.577777777777778;19;26;0.0777777777777777;0.422222222222222
Control.SRR15539829;47;45;0.446808510638298;26;21;0.0531914893617021;0.446808510638298
Control.SRR15539829;42;45;0.428571428571429;24;18;0.0714285714285715;0.428571428571429
Control.SRR15539829;44;45;0.659090909090909;15;29;0.159090909090909;0.340909090909091
Control.SRR15539829;40;45;0.425;23;17;0.075;0.425
Control.SRR15539829;50;45;0.58;21;29;0.08;0.42
Control.SRR15539829;41;45;0.439024390243902;23;18;0.0609756097560976;0.439024390243902
Control.SRR15539829;51;45;0.549019607843137;23;28;0.0490196078431373;0.450980392156863
Control.SRR15539829;52;45;0.596153846153846;21;31;0.0961538461538461;0.403846153846154
Control.SRR15539829;48;45;0.541666666666667;22;26;0.0416666666666666;0.458333333333333
Control.SRR15539829;54;45;0.37037037037037;34;20;0.12962962962963;0.37037037037037
Control.SRR15539829;46;45;0.478260869565217;24;22;0.0217391304347826;0.478260869565217
Control.SRR15539829;47;45;0.48936170212766;24;23;0.0106382978723404;0.48936170212766
Control.SRR15539829;49;45;0.591836734693878;20;29;0.0918367346938775;0.408163265306122
Control.SRR15539829;47;45;0.446808510638298;26;21;0.0531914893617021;0.446808510638298
Control.SRR15539829;41;45;0.536585365853659;19;22;0.0365853658536586;0.463414634146341
Control.SRR15539829;43;45;0.465116279069767;23;20;0.0348837209302326;0.465116279069767
Control.SRR15539829;46;45;0.565217391304348;20;26;0.0652173913043478;0.434782608695652
Control.SRR15539829;51;45;0.470588235294118;27;24;0.0294117647058824;0.470588235294118
Control.SRR15539829;43;45;0.558139534883721;19;24;0.0581395348837209;0.441860465116279
Control.SRR15539829;44;45;0.545454545454545;20;24;0.0454545454545454;0.454545454545455
Control.SRR15539829;50;45;0.46;27;23;0.04;0.46
Control.SRR15539829;48;45;0.5;24;24;0;0.5
Control.SRR15539829;46;45;0.521739130434783;22;24;0.0217391304347826;0.478260869565217
Control.SRR15539829;41;45;0.439024390243902;23;18;0.0609756097560976;0.439024390243902
Control.SRR15539829;48;45;0.5;24;24;0;0.5
Control.SRR15539829;44;45;0.590909090909091;18;26;0.0909090909090909;0.409090909090909
Control.SRR15539829;51;45;0.352941176470588;33;18;0.147058823529412;0.352941176470588
Control.SRR15539829;47;45;0.531914893617021;22;25;0.0319148936170213;0.468085106382979
Control.SRR15539829;54;45;0.444444444444444;30;24;0.0555555555555556;0.444444444444444
Control.SRR15539829;53;45;0.358490566037736;34;19;0.141509433962264;0.358490566037736
Control.SRR15539829;41;45;0.609756097560976;16;25;0.109756097560976;0.390243902439024
Control.SRR15539829;41;45;0.51219512195122;20;21;0.0121951219512195;0.48780487804878
Control.SRR15539829;47;45;0.297872340425532;33;14;0.202127659574468;0.297872340425532
Control.SRR15539829;43;45;0.441860465116279;24;19;0.0581395348837209;0.441860465116279
Control.SRR15539829;47;45;0.48936170212766;24;23;0.0106382978723404;0.48936170212766
Control.SRR15539829;45;45;0.422222222222222;26;19;0.0777777777777778;0.422222222222222
Control.SRR15539829;46;45;0.434782608695652;26;20;0.0652173913043478;0.434782608695652
Control.SRR15539829;48;45;0.479166666666667;25;23;0.0208333333333333;0.479166666666667
Control.SRR15539829;46;45;0.456521739130435;25;21;0.0434782608695652;0.456521739130435
Control.SRR15539829;41;45;0.341463414634146;27;14;0.158536585365854;0.341463414634146
Control.SRR15539829;41;45;0.48780487804878;21;20;0.0121951219512195;0.48780487804878
Control.SRR15539829;40;45;0.65;14;26;0.15;0.35
Control.SRR15539829;42;45;0.5;21;21;0;0.5
Control.SRR15539829;49;45;0.551020408163265;22;27;0.0510204081632653;0.448979591836735
Control.SRR15539829;54;45;0.37037037037037;34;20;0.12962962962963;0.37037037037037
Control.SRR15539829;47;45;0.319148936170213;32;15;0.180851063829787;0.319148936170213
Control.SRR15539829;53;45;0.490566037735849;27;26;0.00943396226415094;0.490566037735849
Control.SRR15539829;53;45;0.433962264150943;30;23;0.0660377358490566;0.433962264150943
Control.SRR15539829;44;45;0.454545454545455;24;20;0.0454545454545455;0.454545454545455
Control.SRR15539829;51;45;0.509803921568627;25;26;0.00980392156862742;0.490196078431373
Control.SRR15539829;45;45;0.466666666666667;24;21;0.0333333333333333;0.466666666666667
Control.SRR15539829;40;45;0.625;15;25;0.125;0.375
Control.SRR15539829;45;45;0.466666666666667;24;21;0.0333333333333333;0.466666666666667
Control.SRR15539829;45;45;0.488888888888889;23;22;0.0111111111111111;0.488888888888889
Control.SRR15539829;42;45;0.380952380952381;26;16;0.119047619047619;0.380952380952381
Control.SRR15539829;47;45;0.48936170212766;24;23;0.0106382978723404;0.48936170212766
Control.SRR15539829;46;45;0.630434782608696;17;29;0.130434782608696;0.369565217391304
Control.SRR15539829;53;45;0.433962264150943;30;23;0.0660377358490566;0.433962264150943
Control.SRR15539829;42;45;0.5;21;21;0;0.5
Control.SRR15539829;45;45;0.666666666666667;15;30;0.166666666666667;0.333333333333333
Control.SRR15539829;47;45;0.51063829787234;23;24;0.0106382978723404;0.48936170212766
Control.SRR15539829;42;45;0.452380952380952;23;19;0.0476190476190476;0.452380952380952
Control.SRR15539829;50;45;0.42;29;21;0.08;0.42
Control.SRR15539829;54;45;0.518518518518518;26;28;0.0185185185185185;0.481481481481481
Control.SRR15539829;52;45;0.576923076923077;22;30;0.0769230769230769;0.423076923076923
Control.SRR15539829;53;45;0.490566037735849;27;26;0.00943396226415094;0.490566037735849
Control.SRR15539829;43;45;0.604651162790698;17;26;0.104651162790698;0.395348837209302
Control.SRR15539829;47;45;0.531914893617021;22;25;0.0319148936170213;0.468085106382979
Control.SRR15539829;45;45;0.622222222222222;17;28;0.122222222222222;0.377777777777778
Control.SRR15539829;44;45;0.5;22;22;0;0.5
Control.SRR15539829;52;45;0.576923076923077;22;30;0.0769230769230769;0.423076923076923
Control.SRR15539829;44;45;0.5;22;22;0;0.5
Control.SRR15539829;52;45;0.538461538461538;24;28;0.0384615384615384;0.461538461538462
Control.SRR15539829;51;45;0.686274509803922;16;35;0.186274509803922;0.313725490196078
Control.SRR15539829;51;45;0.490196078431373;26;25;0.00980392156862747;0.490196078431373
Control.SRR15539829;41;45;0.48780487804878;21;20;0.0121951219512195;0.48780487804878
Control.SRR15539829;52;45;0.576923076923077;22;30;0.0769230769230769;0.423076923076923
Control.SRR15539829;48;45;0.416666666666667;28;20;0.0833333333333333;0.416666666666667
Control.SRR15539829;51;45;0.549019607843137;23;28;0.0490196078431373;0.450980392156863
Control.SRR15539829;49;45;0.530612244897959;23;26;0.0306122448979592;0.469387755102041
Control.SRR15539829;53;45;0.547169811320755;24;29;0.0471698113207547;0.452830188679245
Control.SRR15539829;44;45;0.568181818181818;19;25;0.0681818181818182;0.431818181818182
Control.SRR15539829;43;45;0.604651162790698;17;26;0.104651162790698;0.395348837209302
Control.SRR15539829;49;45;0.571428571428571;21;28;0.0714285714285714;0.428571428571429
Control.SRR15539829;45;45;0.488888888888889;23;22;0.0111111111111111;0.488888888888889
Control.SRR15539829;46;45;0.478260869565217;24;22;0.0217391304347826;0.478260869565217
Control.SRR15539829;45;45;0.466666666666667;24;21;0.0333333333333333;0.466666666666667
Control.SRR15539829;43;45;0.372093023255814;27;16;0.127906976744186;0.372093023255814
Control.SRR15539829;46;45;0.347826086956522;30;16;0.152173913043478;0.347826086956522
Control.SRR15539829;42;45;0.476190476190476;22;20;0.0238095238095238;0.476190476190476
Control.SRR15539829;51;45;0.470588235294118;27;24;0.0294117647058824;0.470588235294118
Control.SRR15539829;47;45;0.553191489361702;21;26;0.0531914893617021;0.446808510638298
Control.SRR15539829;54;45;0.518518518518518;26;28;0.0185185185185185;0.481481481481481
Control.SRR15539829;40;45;0.425;23;17;0.075;0.425
Control.SRR15539829;47;45;0.446808510638298;26;21;0.0531914893617021;0.446808510638298
Control.SRR15539829;40;45;0.575;17;23;0.075;0.425
Control.SRR15539829;52;45;0.461538461538462;28;24;0.0384615384615384;0.461538461538462
Control.SRR15539829;50;45;0.54;23;27;0.04;0.46
Control.SRR15539829;44;45;0.613636363636364;17;27;0.113636363636364;0.386363636363636
Control.SRR15539829;49;45;0.469387755102041;26;23;0.0306122448979592;0.469387755102041
Control.SRR15539829;45;45;0.422222222222222;26;19;0.0777777777777778;0.422222222222222
Control.SRR15539829;53;45;0.452830188679245;29;24;0.0471698113207547;0.452830188679245
Control.SRR15539829;54;45;0.407407407407407;32;22;0.0925925925925926;0.407407407407407
Control.SRR15539829;54;45;0.518518518518518;26;28;0.0185185185185185;0.481481481481481
Control.SRR15539829;51;45;0.470588235294118;27;24;0.0294117647058824;0.470588235294118
Control.SRR15539829;49;45;0.551020408163265;22;27;0.0510204081632653;0.448979591836735
Control.SRR15539829;40;45;0.525;19;21;0.025;0.475
Control.SRR15539829;46;45;0.478260869565217;24;22;0.0217391304347826;0.478260869565217
Control.SRR15539829;50;45;0.44;28;22;0.06;0.44
Control.SRR15539829;43;45;0.534883720930233;20;23;0.0348837209302325;0.465116279069767
Control.SRR15539829;51;45;0.588235294117647;21;30;0.0882352941176471;0.411764705882353
Control.SRR15539829;43;45;0.465116279069767;23;20;0.0348837209302326;0.465116279069767
Control.SRR15539829;47;45;0.531914893617021;22;25;0.0319148936170213;0.468085106382979
Control.SRR15539829;41;45;0.609756097560976;16;25;0.109756097560976;0.390243902439024
Control.SRR15539829;40;45;0.575;17;23;0.075;0.425
Control.SRR15539829;44;45;0.545454545454545;20;24;0.0454545454545454;0.454545454545455
Control.SRR15539829;52;45;0.5;26;26;0;0.5
Control.SRR15539829;51;45;0.588235294117647;21;30;0.0882352941176471;0.411764705882353
Control.SRR15539829;44;45;0.545454545454545;20;24;0.0454545454545454;0.454545454545455
Control.SRR15539829;52;45;0.403846153846154;31;21;0.0961538461538461;0.403846153846154
Control.SRR15539829;51;45;0.568627450980392;22;29;0.0686274509803921;0.431372549019608
Control.SRR15539829;52;45;0.5;26;26;0;0.5
Control.SRR15539829;41;45;0.414634146341463;24;17;0.0853658536585366;0.414634146341463
Control.SRR15539829;49;45;0.510204081632653;24;25;0.0102040816326531;0.489795918367347
Control.SRR15539829;43;45;0.418604651162791;25;18;0.0813953488372093;0.418604651162791
Control.SRR15539829;41;45;0.634146341463415;15;26;0.134146341463415;0.365853658536585
Control.SRR15539829;46;45;0.478260869565217;24;22;0.0217391304347826;0.478260869565217
Control.SRR15539829;46;45;0.5;23;23;0;0.5
Control.SRR15539829;54;45;0.462962962962963;29;25;0.037037037037037;0.462962962962963
Control.SRR15539829;53;45;0.377358490566038;33;20;0.122641509433962;0.377358490566038
Control.SRR15539829;54;45;0.555555555555556;24;30;0.0555555555555556;0.444444444444444
Control.SRR15539829;54;45;0.462962962962963;29;25;0.037037037037037;0.462962962962963
Control.SRR15539829;41;45;0.341463414634146;27;14;0.158536585365854;0.341463414634146
Control.SRR15539829;53;45;0.547169811320755;24;29;0.0471698113207547;0.452830188679245
Control.SRR15539829;42;45;0.523809523809524;20;22;0.0238095238095238;0.476190476190476
Control.SRR15539829;46;45;0.369565217391304;29;17;0.130434782608696;0.369565217391304
Control.SRR15539829;48;45;0.479166666666667;25;23;0.0208333333333333;0.479166666666667
Control.SRR15539829;44;45;0.431818181818182;25;19;0.0681818181818182;0.431818181818182
Control.SRR15539829;43;45;0.372093023255814;27;16;0.127906976744186;0.372093023255814
Control.SRR15539829;53;45;0.452830188679245;29;24;0.0471698113207547;0.452830188679245
Control.SRR15539829;47;45;0.446808510638298;26;21;0.0531914893617021;0.446808510638298
Control.SRR15539829;52;45;0.384615384615385;32;20;0.115384615384615;0.384615384615385
Control.SRR15539829;52;45;0.480769230769231;27;25;0.0192307692307692;0.480769230769231
Control.SRR15539829;43;45;0.511627906976744;21;22;0.0116279069767442;0.488372093023256
Control.SRR15539829;52;45;0.403846153846154;31;21;0.0961538461538461;0.403846153846154
Control.SRR15539829;46;45;0.5;23;23;0;0.5
Control.SRR15539829;46;45;0.456521739130435;25;21;0.0434782608695652;0.456521739130435
Control.SRR15539829;51;45;0.607843137254902;20;31;0.107843137254902;0.392156862745098
Control.SRR15539829;48;45;0.4375;27;21;0.0625;0.4375
Control.SRR15539829;42;45;0.404761904761905;25;17;0.0952380952380952;0.404761904761905
Control.SRR15539829;46;45;0.58695652173913;19;27;0.0869565217391305;0.41304347826087
Control.SRR15539829;49;45;0.530612244897959;23;26;0.0306122448979592;0.469387755102041
Control.SRR15539829;40;45;0.5;20;20;0;0.5
Control.SRR15539829;47;45;0.297872340425532;33;14;0.202127659574468;0.297872340425532
Control.SRR15539829;41;45;0.463414634146341;22;19;0.0365853658536585;0.463414634146341
Control.SRR15539829;52;45;0.442307692307692;29;23;0.0576923076923077;0.442307692307692
Control.SRR15539829;52;45;0.519230769230769;25;27;0.0192307692307693;0.480769230769231
Control.SRR15539829;49;45;0.408163265306122;29;20;0.0918367346938775;0.408163265306122
Control.SRR15539829;50;45;0.42;29;21;0.08;0.42
Control.SRR15539829;43;45;0.511627906976744;21;22;0.0116279069767442;0.488372093023256
Control.SRR15539829;45;45;0.444444444444444;25;20;0.0555555555555556;0.444444444444444
Control.SRR15539829;44;45;0.5;22;22;0;0.5
Control.SRR15539829;45;45;0.355555555555556;29;16;0.144444444444444;0.355555555555556
Control.SRR15539829;45;45;0.577777777777778;19;26;0.0777777777777777;0.422222222222222
Control.SRR15539829;52;45;0.480769230769231;27;25;0.0192307692307692;0.480769230769231
Control.SRR15539829;46;45;0.5;23;23;0;0.5
Control.SRR15539829;50;45;0.46;27;23;0.04;0.46
Control.SRR15539829;41;45;0.439024390243902;23;18;0.0609756097560976;0.439024390243902
Control.SRR15539829;44;45;0.431818181818182;25;19;0.0681818181818182;0.431818181818182
Control.SRR15539829;49;45;0.510204081632653;24;25;0.0102040816326531;0.489795918367347
Control.SRR15539829;46;45;0.58695652173913;19;27;0.0869565217391305;0.41304347826087
Control.SRR15539829;47;45;0.48936170212766;24;23;0.0106382978723404;0.48936170212766
Control.SRR15539829;44;45;0.454545454545455;24;20;0.0454545454545455;0.454545454545455
Control.SRR15539829;44;45;0.568181818181818;19;25;0.0681818181818182;0.431818181818182
Control.SRR15539829;44;45;0.522727272727273;21;23;0.0227272727272727;0.477272727272727
Control.SRR15539829;44;45;0.431818181818182;25;19;0.0681818181818182;0.431818181818182
Control.SRR15539829;49;45;0.489795918367347;25;24;0.0102040816326531;0.489795918367347
Control.SRR15539829;43;45;0.441860465116279;24;19;0.0581395348837209;0.441860465116279
Control.SRR15539829;45;45;0.555555555555556;20;25;0.0555555555555556;0.444444444444444
Control.SRR15539829;48;45;0.5;24;24;0;0.5
Control.SRR15539829;45;45;0.511111111111111;22;23;0.0111111111111111;0.488888888888889
Control.SRR15539829;46;45;0.391304347826087;28;18;0.108695652173913;0.391304347826087
Control.SRR15539829;54;45;0.592592592592593;22;32;0.0925925925925926;0.407407407407407
Control.SRR15539829;46;45;0.478260869565217;24;22;0.0217391304347826;0.478260869565217
Control.SRR15539829;54;45;0.648148148148148;19;35;0.148148148148148;0.351851851851852
Control.SRR15539829;50;45;0.64;18;32;0.14;0.36
Control.SRR15539829;52;45;0.5;26;26;0;0.5
Control.SRR15539829;48;45;0.458333333333333;26;22;0.0416666666666667;0.458333333333333
Control.SRR15539829;52;45;0.461538461538462;28;24;0.0384615384615384;0.461538461538462
Control.SRR15539829;42;45;0.547619047619048;19;23;0.0476190476190477;0.452380952380952
Control.SRR15539829;49;45;0.571428571428571;21;28;0.0714285714285714;0.428571428571429
Control.SRR15539829;54;45;0.481481481481481;28;26;0.0185185185185185;0.481481481481481
Control.SRR15539829;52;45;0.596153846153846;21;31;0.0961538461538461;0.403846153846154
Control.SRR15539829;46;45;0.41304347826087;27;19;0.0869565217391304;0.41304347826087
Control.SRR15539829;41;45;0.560975609756098;18;23;0.0609756097560976;0.439024390243902
Control.SRR15539829;50;45;0.54;23;27;0.04;0.46
Control.SRR15539829;51;45;0.549019607843137;23;28;0.0490196078431373;0.450980392156863
Control.SRR15539829;48;45;0.5625;21;27;0.0625;0.4375
Control.SRR15539829;45;45;0.577777777777778;19;26;0.0777777777777777;0.422222222222222
Control.SRR15539829;44;45;0.409090909090909;26;18;0.0909090909090909;0.409090909090909
Control.SRR15539829;43;45;0.441860465116279;24;19;0.0581395348837209;0.441860465116279
Control.SRR15539829;51;45;0.568627450980392;22;29;0.0686274509803921;0.431372549019608
Control.SRR15539829;51;45;0.470588235294118;27;24;0.0294117647058824;0.470588235294118
Control.SRR15539829;44;45;0.386363636363636;27;17;0.113636363636364;0.386363636363636
Control.SRR15539829;52;45;0.557692307692308;23;29;0.0576923076923077;0.442307692307692
Control.SRR15539829;46;45;0.521739130434783;22;24;0.0217391304347826;0.478260869565217
Control.SRR15539829;45;45;0.511111111111111;22;23;0.0111111111111111;0.488888888888889
Control.SRR15539829;54;45;0.574074074074074;23;31;0.0740740740740741;0.425925925925926
Control.SRR15539829;45;45;0.511111111111111;22;23;0.0111111111111111;0.488888888888889
Control.SRR15539829;43;45;0.441860465116279;24;19;0.0581395348837209;0.441860465116279
Control.SRR15539829;47;45;0.617021276595745;18;29;0.117021276595745;0.382978723404255
Control.SRR15539829;42;45;0.523809523809524;20;22;0.0238095238095238;0.476190476190476
Control.SRR15539829;48;45;0.479166666666667;25;23;0.0208333333333333;0.479166666666667
Control.SRR15539829;43;45;0.465116279069767;23;20;0.0348837209302326;0.465116279069767
Control.SRR15539829;53;45;0.433962264150943;30;23;0.0660377358490566;0.433962264150943
Control.SRR15539829;52;45;0.557692307692308;23;29;0.0576923076923077;0.442307692307692
Control.SRR15539829;49;45;0.63265306122449;18;31;0.13265306122449;0.36734693877551
Control.SRR15539829;50;45;0.42;29;21;0.08;0.42
Control.SRR15539829;44;45;0.681818181818182;14;30;0.181818181818182;0.318181818181818
Control.SRR15539829;41;45;0.414634146341463;24;17;0.0853658536585366;0.414634146341463
Control.SRR15539829;45;45;0.488888888888889;23;22;0.0111111111111111;0.488888888888889
Control.SRR15539829;46;45;0.5;23;23;0;0.5
Control.SRR15539829;47;45;0.51063829787234;23;24;0.0106382978723404;0.48936170212766
Control.SRR15539829;45;45;0.6;18;27;0.1;0.4
Control.SRR15539829;53;45;0.471698113207547;28;25;0.0283018867924528;0.471698113207547
Control.SRR15539829;43;45;0.488372093023256;22;21;0.0116279069767442;0.488372093023256
Control.SRR15539829;49;45;0.36734693877551;31;18;0.13265306122449;0.36734693877551
Control.SRR15539829;52;45;0.538461538461538;24;28;0.0384615384615384;0.461538461538462
Control.SRR15539829;53;45;0.566037735849057;23;30;0.0660377358490566;0.433962264150943
Control.SRR15539829;41;45;0.585365853658537;17;24;0.0853658536585366;0.414634146341463
Control.SRR15539829;48;45;0.5;24;24;0;0.5
Control.SRR15539829;42;45;0.452380952380952;23;19;0.0476190476190476;0.452380952380952
Control.SRR15539829;51;45;0.529411764705882;24;27;0.0294117647058824;0.470588235294118
Control.SRR15539829;40;45;0.575;17;23;0.075;0.425
Control.SRR15539829;45;45;0.488888888888889;23;22;0.0111111111111111;0.488888888888889
Control.SRR15539829;41;45;0.536585365853659;19;22;0.0365853658536586;0.463414634146341
Control.SRR15539829;49;45;0.428571428571429;28;21;0.0714285714285715;0.428571428571429
Control.SRR15539829;49;45;0.408163265306122;29;20;0.0918367346938775;0.408163265306122
Control.SRR15539829;50;45;0.54;23;27;0.04;0.46
Control.SRR15539829;48;45;0.479166666666667;25;23;0.0208333333333333;0.479166666666667
Control.SRR15539829;50;45;0.62;19;31;0.12;0.38
Control.SRR15539829;50;45;0.56;22;28;0.0600000000000001;0.44
Control.SRR15539829;48;45;0.5;24;24;0;0.5
Control.SRR15539829;49;45;0.489795918367347;25;24;0.0102040816326531;0.489795918367347
Control.SRR15539829;54;45;0.444444444444444;30;24;0.0555555555555556;0.444444444444444
Control.SRR15539829;40;45;0.425;23;17;0.075;0.425
Control.SRR15539829;52;45;0.442307692307692;29;23;0.0576923076923077;0.442307692307692
Control.SRR15539829;50;45;0.5;25;25;0;0.5
Control.SRR15539829;41;45;0.48780487804878;21;20;0.0121951219512195;0.48780487804878
Control.SRR15539829;42;45;0.404761904761905;25;17;0.0952380952380952;0.404761904761905
Control.SRR15539829;45;45;0.577777777777778;19;26;0.0777777777777777;0.422222222222222
Control.SRR15539829;47;45;0.531914893617021;22;25;0.0319148936170213;0.468085106382979
Control.SRR15539829;49;45;0.448979591836735;27;22;0.0510204081632653;0.448979591836735
Control.SRR15539829;54;45;0.537037037037037;25;29;0.0370370370370371;0.462962962962963
Control.SRR15539829;48;45;0.604166666666667;19;29;0.104166666666667;0.395833333333333
Control.SRR15539829;42;45;0.476190476190476;22;20;0.0238095238095238;0.476190476190476
Control.SRR15539829;54;45;0.518518518518518;26;28;0.0185185185185185;0.481481481481481
Control.SRR15539829;40;45;0.5;20;20;0;0.5
Control.SRR15539829;42;45;0.5;21;21;0;0.5
Control.SRR15539829;40;45;0.5;20;20;0;0.5
Control.SRR15539829;41;45;0.51219512195122;20;21;0.0121951219512195;0.48780487804878
Control.SRR15539829;51;45;0.431372549019608;29;22;0.0686274509803921;0.431372549019608
Control.SRR15539829;42;45;0.571428571428571;18;24;0.0714285714285714;0.428571428571429
Control.SRR15539829;48;45;0.625;18;30;0.125;0.375
Control.SRR15539829;40;45;0.675;13;27;0.175;0.325
Control.SRR15539829;41;45;0.439024390243902;23;18;0.0609756097560976;0.439024390243902
Control.SRR15539829;44;45;0.363636363636364;28;16;0.136363636363636;0.363636363636364
Control.SRR15539829;40;45;0.6;16;24;0.1;0.4
Control.SRR15539829;46;45;0.5;23;23;0;0.5
Control.SRR15539829;43;45;0.465116279069767;23;20;0.0348837209302326;0.465116279069767
Control.SRR15539829;41;45;0.439024390243902;23;18;0.0609756097560976;0.439024390243902
Control.SRR15539829;43;45;0.558139534883721;19;24;0.0581395348837209;0.441860465116279
Control.SRR15539829;50;45;0.5;25;25;0;0.5
Control.SRR15539829;53;45;0.660377358490566;18;35;0.160377358490566;0.339622641509434
Control.SRR15539829;42;45;0.5;21;21;0;0.5
Control.SRR15539829;45;45;0.555555555555556;20;25;0.0555555555555556;0.444444444444444
Control.SRR15539829;48;45;0.479166666666667;25;23;0.0208333333333333;0.479166666666667
Control.SRR15539829;45;45;0.288888888888889;32;13;0.211111111111111;0.288888888888889
Control.SRR15539829;45;45;0.444444444444444;25;20;0.0555555555555556;0.444444444444444
Control.SRR15539829;46;45;0.565217391304348;20;26;0.0652173913043478;0.434782608695652
Control.SRR15539829;53;45;0.547169811320755;24;29;0.0471698113207547;0.452830188679245
Control.SRR15539829;49;45;0.571428571428571;21;28;0.0714285714285714;0.428571428571429
Control.SRR15539829;47;45;0.617021276595745;18;29;0.117021276595745;0.382978723404255
Control.SRR15539829;49;45;0.346938775510204;32;17;0.153061224489796;0.346938775510204
Control.SRR15539829;43;45;0.604651162790698;17;26;0.104651162790698;0.395348837209302
Control.SRR15539829;43;45;0.465116279069767;23;20;0.0348837209302326;0.465116279069767
Control.SRR15539829;48;45;0.541666666666667;22;26;0.0416666666666666;0.458333333333333
Control.SRR15539829;50;45;0.48;26;24;0.02;0.48
Control.SRR15539829;51;45;0.470588235294118;27;24;0.0294117647058824;0.470588235294118
Control.SRR15539829;50;45;0.6;20;30;0.1;0.4
Control.SRR15539829;48;45;0.5;24;24;0;0.5
Control.SRR15539829;43;45;0.581395348837209;18;25;0.0813953488372093;0.418604651162791
Control.SRR15539829;40;45;0.625;15;25;0.125;0.375
Control.SRR15539829;40;45;0.475;21;19;0.025;0.475
Control.SRR15539829;50;45;0.52;24;26;0.02;0.48
Control.SRR15539829;53;45;0.547169811320755;24;29;0.0471698113207547;0.452830188679245
Control.SRR15539829;46;45;0.543478260869565;21;25;0.0434782608695652;0.456521739130435
Control.SRR15539829;43;45;0.674418604651163;14;29;0.174418604651163;0.325581395348837
Control.SRR15539829;42;45;0.5;21;21;0;0.5
Control.SRR15539829;42;45;0.428571428571429;24;18;0.0714285714285715;0.428571428571429
Control.SRR15539829;50;45;0.56;22;28;0.0600000000000001;0.44
Control.SRR15539829;54;45;0.518518518518518;26;28;0.0185185185185185;0.481481481481481
Control.SRR15539829;43;45;0.511627906976744;21;22;0.0116279069767442;0.488372093023256
Control.SRR15539829;49;45;0.448979591836735;27;22;0.0510204081632653;0.448979591836735
Control.SRR15539829;54;45;0.481481481481481;28;26;0.0185185185185185;0.481481481481481
Control.SRR15539829;41;45;0.48780487804878;21;20;0.0121951219512195;0.48780487804878
Control.SRR15539829;53;45;0.622641509433962;20;33;0.122641509433962;0.377358490566038
Control.SRR15539829;44;45;0.409090909090909;26;18;0.0909090909090909;0.409090909090909
Control.SRR15539829;45;45;0.466666666666667;24;21;0.0333333333333333;0.466666666666667
Control.SRR15539829;42;45;0.5;21;21;0;0.5
Control.SRR15539829;50;45;0.56;22;28;0.0600000000000001;0.44
Control.SRR15539829;52;45;0.423076923076923;30;22;0.0769230769230769;0.423076923076923
Control.SRR15539829;51;45;0.666666666666667;17;34;0.166666666666667;0.333333333333333
Control.SRR15539829;54;45;0.481481481481481;28;26;0.0185185185185185;0.481481481481481
Control.SRR15539829;47;45;0.553191489361702;21;26;0.0531914893617021;0.446808510638298
Control.SRR15539829;40;45;0.625;15;25;0.125;0.375
Control.SRR15539829;46;45;0.565217391304348;20;26;0.0652173913043478;0.434782608695652
Control.SRR15539829;45;45;0.555555555555556;20;25;0.0555555555555556;0.444444444444444
Control.SRR15539829;54;45;0.5;27;27;0;0.5
Control.SRR15539829;46;45;0.673913043478261;15;31;0.173913043478261;0.326086956521739
Control.SRR15539829;49;45;0.346938775510204;32;17;0.153061224489796;0.346938775510204
Control.SRR15539829;48;45;0.5;24;24;0;0.5
Control.SRR15539829;54;45;0.574074074074074;23;31;0.0740740740740741;0.425925925925926
Control.SRR15539829;46;45;0.543478260869565;21;25;0.0434782608695652;0.456521739130435
Control.SRR15539829;49;45;0.551020408163265;22;27;0.0510204081632653;0.448979591836735
Control.SRR15539829;47;45;0.48936170212766;24;23;0.0106382978723404;0.48936170212766
Control.SRR15539829;45;45;0.622222222222222;17;28;0.122222222222222;0.377777777777778
Control.SRR15539829;54;45;0.5;27;27;0;0.5
Control.SRR15539829;50;45;0.5;25;25;0;0.5
Control.SRR15539829;40;45;0.45;22;18;0.05;0.45
Control.SRR15539829;43;45;0.441860465116279;24;19;0.0581395348837209;0.441860465116279
Control.SRR15539829;53;45;0.433962264150943;30;23;0.0660377358490566;0.433962264150943
Control.SRR15539829;46;45;0.521739130434783;22;24;0.0217391304347826;0.478260869565217
Control.SRR15539829;40;45;0.425;23;17;0.075;0.425
Control.SRR15539829;49;45;0.530612244897959;23;26;0.0306122448979592;0.469387755102041
Control.SRR15539829;49;45;0.448979591836735;27;22;0.0510204081632653;0.448979591836735
Control.SRR15539829;49;45;0.551020408163265;22;27;0.0510204081632653;0.448979591836735
Control.SRR15539829;51;45;0.568627450980392;22;29;0.0686274509803921;0.431372549019608
Control.SRR15539829;46;45;0.434782608695652;26;20;0.0652173913043478;0.434782608695652
Control.SRR15539829;40;45;0.475;21;19;0.025;0.475
Control.SRR15539829;39;45;0.538461538461538;18;21;0.0384615384615384;0.461538461538462
Control.SRR15539829;49;45;0.530612244897959;23;26;0.0306122448979592;0.469387755102041
Control.SRR15539829;45;45;0.488888888888889;23;22;0.0111111111111111;0.488888888888889
Control.SRR15539829;50;45;0.58;21;29;0.08;0.42
Control.SRR15539829;45;45;0.533333333333333;21;24;0.0333333333333333;0.466666666666667
Control.SRR15539829;49;45;0.510204081632653;24;25;0.0102040816326531;0.489795918367347
Control.SRR15539829;47;45;0.446808510638298;26;21;0.0531914893617021;0.446808510638298
Control.SRR15539829;49;45;0.387755102040816;30;19;0.112244897959184;0.387755102040816
Control.SRR15539829;47;45;0.425531914893617;27;20;0.074468085106383;0.425531914893617
Control.SRR15539829;39;45;0.538461538461538;18;21;0.0384615384615384;0.461538461538462
Control.SRR15539829;47;45;0.446808510638298;26;21;0.0531914893617021;0.446808510638298
Control.SRR15539829;44;45;0.568181818181818;19;25;0.0681818181818182;0.431818181818182
Control.SRR15539829;39;45;0.615384615384615;15;24;0.115384615384615;0.384615384615385
Control.SRR15539829;42;45;0.428571428571429;24;18;0.0714285714285715;0.428571428571429
Control.SRR15539829;44;45;0.386363636363636;27;17;0.113636363636364;0.386363636363636
Control.SRR15539829;40;45;0.55;18;22;0.05;0.45
Control.SRR15539829;39;45;0.512820512820513;19;20;0.0128205128205128;0.487179487179487
Control.SRR15539829;50;45;0.6;20;30;0.1;0.4
Control.SRR15539829;46;45;0.565217391304348;20;26;0.0652173913043478;0.434782608695652
Control.SRR15539829;48;45;0.416666666666667;28;20;0.0833333333333333;0.416666666666667
Control.SRR15539829;48;45;0.4375;27;21;0.0625;0.4375
Control.SRR15539829;48;45;0.520833333333333;23;25;0.0208333333333334;0.479166666666667
Control.SRR15539829;43;45;0.441860465116279;24;19;0.0581395348837209;0.441860465116279
Control.SRR15539829;47;45;0.48936170212766;24;23;0.0106382978723404;0.48936170212766
Control.SRR15539829;52;45;0.403846153846154;31;21;0.0961538461538461;0.403846153846154
Control.SRR15539829;43;45;0.418604651162791;25;18;0.0813953488372093;0.418604651162791
Control.SRR15539829;48;45;0.520833333333333;23;25;0.0208333333333334;0.479166666666667
Control.SRR15539829;44;45;0.545454545454545;20;24;0.0454545454545454;0.454545454545455
Control.SRR15539829;40;45;0.4;24;16;0.1;0.4
Control.SRR15539829;50;45;0.44;28;22;0.06;0.44
Control.SRR15539829;46;45;0.521739130434783;22;24;0.0217391304347826;0.478260869565217
Control.SRR15539829;44;45;0.545454545454545;20;24;0.0454545454545454;0.454545454545455
Control.SRR15539829;45;45;0.422222222222222;26;19;0.0777777777777778;0.422222222222222
Control.SRR15539829;39;45;0.538461538461538;18;21;0.0384615384615384;0.461538461538462
Control.SRR15539829;39;45;0.435897435897436;22;17;0.0641025641025641;0.435897435897436
Control.SRR15539829;49;45;0.571428571428571;21;28;0.0714285714285714;0.428571428571429
Control.SRR15539829;44;45;0.386363636363636;27;17;0.113636363636364;0.386363636363636
Control.SRR15539829;51;45;0.509803921568627;25;26;0.00980392156862742;0.490196078431373
Control.SRR15539829;42;45;0.523809523809524;20;22;0.0238095238095238;0.476190476190476
Control.SRR15539829;47;45;0.382978723404255;29;18;0.117021276595745;0.382978723404255
Control.SRR15539829;49;45;0.530612244897959;23;26;0.0306122448979592;0.469387755102041
Control.SRR15539829;40;45;0.4;24;16;0.1;0.4
Control.SRR15539829;44;45;0.522727272727273;21;23;0.0227272727272727;0.477272727272727
Control.SRR15539829;45;45;0.555555555555556;20;25;0.0555555555555556;0.444444444444444
Control.SRR15539829;45;45;0.444444444444444;25;20;0.0555555555555556;0.444444444444444
Control.SRR15539829;39;45;0.58974358974359;16;23;0.0897435897435898;0.41025641025641
Control.SRR15539829;46;45;0.478260869565217;24;22;0.0217391304347826;0.478260869565217
Control.SRR15539829;46;45;0.630434782608696;17;29;0.130434782608696;0.369565217391304
Control.SRR15539829;41;45;0.48780487804878;21;20;0.0121951219512195;0.48780487804878
Control.SRR15539829;43;45;0.488372093023256;22;21;0.0116279069767442;0.488372093023256
Control.SRR15539829;41;45;0.609756097560976;16;25;0.109756097560976;0.390243902439024
Control.SRR15539829;45;45;0.488888888888889;23;22;0.0111111111111111;0.488888888888889
Control.SRR15539829;46;45;0.478260869565217;24;22;0.0217391304347826;0.478260869565217
Control.SRR15539829;47;45;0.382978723404255;29;18;0.117021276595745;0.382978723404255
Control.SRR15539829;43;45;0.534883720930233;20;23;0.0348837209302325;0.465116279069767
Control.SRR15539829;46;45;0.41304347826087;27;19;0.0869565217391304;0.41304347826087
Control.SRR15539829;40;45;0.65;14;26;0.15;0.35
Control.SRR15539829;44;45;0.590909090909091;18;26;0.0909090909090909;0.409090909090909
Control.SRR15539829;49;45;0.489795918367347;25;24;0.0102040816326531;0.489795918367347
Control.SRR15539829;46;45;0.630434782608696;17;29;0.130434782608696;0.369565217391304
Control.SRR15539829;44;45;0.409090909090909;26;18;0.0909090909090909;0.409090909090909
Control.SRR15539829;42;45;0.333333333333333;28;14;0.166666666666667;0.333333333333333
Control.SRR15539829;45;45;0.6;18;27;0.1;0.4
Control.SRR15539829;46;45;0.434782608695652;26;20;0.0652173913043478;0.434782608695652
Control.SRR15539829;48;45;0.541666666666667;22;26;0.0416666666666666;0.458333333333333
Control.SRR15539829;45;45;0.666666666666667;15;30;0.166666666666667;0.333333333333333
Control.SRR15539829;39;45;0.538461538461538;18;21;0.0384615384615384;0.461538461538462
Control.SRR15539829;48;45;0.541666666666667;22;26;0.0416666666666666;0.458333333333333
Control.SRR15539829;49;45;0.36734693877551;31;18;0.13265306122449;0.36734693877551
Control.SRR15539829;48;45;0.5;24;24;0;0.5
Control.SRR15539829;44;45;0.386363636363636;27;17;0.113636363636364;0.386363636363636
Control.SRR15539829;43;45;0.511627906976744;21;22;0.0116279069767442;0.488372093023256
Control.SRR15539829;41;45;0.48780487804878;21;20;0.0121951219512195;0.48780487804878
Control.SRR15539829;46;45;0.608695652173913;18;28;0.108695652173913;0.391304347826087
Control.SRR15539829;42;45;0.428571428571429;24;18;0.0714285714285715;0.428571428571429
Control.SRR15539829;39;45;0.512820512820513;19;20;0.0128205128205128;0.487179487179487
Control.SRR15539829;48;45;0.5625;21;27;0.0625;0.4375
Control.SRR15539829;42;45;0.452380952380952;23;19;0.0476190476190476;0.452380952380952
Control.SRR15539829;40;45;0.5;20;20;0;0.5
Control.SRR15539829;43;45;0.558139534883721;19;24;0.0581395348837209;0.441860465116279
Control.SRR15539829;47;45;0.51063829787234;23;24;0.0106382978723404;0.48936170212766
Control.SRR15539829;42;45;0.547619047619048;19;23;0.0476190476190477;0.452380952380952
Control.SRR15539829;40;45;0.575;17;23;0.075;0.425
Control.SRR15539829;51;45;0.470588235294118;27;24;0.0294117647058824;0.470588235294118
Control.SRR15539829;47;45;0.574468085106383;20;27;0.074468085106383;0.425531914893617
Control.SRR15539829;44;45;0.477272727272727;23;21;0.0227272727272727;0.477272727272727
Control.SRR15539829;41;45;0.560975609756098;18;23;0.0609756097560976;0.439024390243902
Control.SRR15539829;39;45;0.538461538461538;18;21;0.0384615384615384;0.461538461538462
Control.SRR15539829;44;45;0.636363636363636;16;28;0.136363636363636;0.363636363636364
Control.SRR15539829;52;45;0.403846153846154;31;21;0.0961538461538461;0.403846153846154
Control.SRR15539829;47;45;0.574468085106383;20;27;0.074468085106383;0.425531914893617
Control.SRR15539829;52;45;0.615384615384615;20;32;0.115384615384615;0.384615384615385
Control.SRR15539829;43;45;0.558139534883721;19;24;0.0581395348837209;0.441860465116279
Control.SRR15539829;50;45;0.48;26;24;0.02;0.48
Control.SRR15539829;42;45;0.380952380952381;26;16;0.119047619047619;0.380952380952381
Control.SRR15539829;44;45;0.545454545454545;20;24;0.0454545454545454;0.454545454545455
Control.SRR15539829;41;45;0.48780487804878;21;20;0.0121951219512195;0.48780487804878
Control.SRR15539829;49;45;0.36734693877551;31;18;0.13265306122449;0.36734693877551
Control.SRR15539829;46;45;0.630434782608696;17;29;0.130434782608696;0.369565217391304
Control.SRR15539829;41;45;0.390243902439024;25;16;0.109756097560976;0.390243902439024
Control.SRR15539829;50;45;0.62;19;31;0.12;0.38
Control.SRR15539829;42;45;0.523809523809524;20;22;0.0238095238095238;0.476190476190476
Control.SRR15539829;43;45;0.511627906976744;21;22;0.0116279069767442;0.488372093023256
Control.SRR15539829;43;45;0.441860465116279;24;19;0.0581395348837209;0.441860465116279
Control.SRR15539829;39;45;0.58974358974359;16;23;0.0897435897435898;0.41025641025641
Control.SRR15539829;43;45;0.534883720930233;20;23;0.0348837209302325;0.465116279069767
Control.SRR15539829;47;45;0.595744680851064;19;28;0.0957446808510638;0.404255319148936
Control.SRR15539829;50;45;0.64;18;32;0.14;0.36
Control.SRR15539829;39;45;0.58974358974359;16;23;0.0897435897435898;0.41025641025641
Control.SRR15539829;45;45;0.6;18;27;0.1;0.4
Control.SRR15539829;52;45;0.480769230769231;27;25;0.0192307692307692;0.480769230769231
Control.SRR15539829;40;45;0.45;22;18;0.05;0.45
Control.SRR15539829;48;45;0.4375;27;21;0.0625;0.4375
Control.SRR15539829;40;45;0.525;19;21;0.025;0.475
Control.SRR15539829;48;45;0.5;24;24;0;0.5
Control.SRR15539829;45;45;0.444444444444444;25;20;0.0555555555555556;0.444444444444444
Control.SRR15539829;43;45;0.534883720930233;20;23;0.0348837209302325;0.465116279069767
Control.SRR15539829;46;45;0.630434782608696;17;29;0.130434782608696;0.369565217391304
Control.SRR15539829;47;45;0.48936170212766;24;23;0.0106382978723404;0.48936170212766
Control.SRR15539829;43;45;0.674418604651163;14;29;0.174418604651163;0.325581395348837
Control.SRR15539829;39;45;0.435897435897436;22;17;0.0641025641025641;0.435897435897436
Control.SRR15539829;39;45;0.384615384615385;24;15;0.115384615384615;0.384615384615385
Control.SRR15539829;42;45;0.404761904761905;25;17;0.0952380952380952;0.404761904761905
Control.SRR15539829;41;45;0.536585365853659;19;22;0.0365853658536586;0.463414634146341
Control.SRR15539829;47;45;0.553191489361702;21;26;0.0531914893617021;0.446808510638298
Control.SRR15539829;40;45;0.675;13;27;0.175;0.325
Control.SRR15539829;44;45;0.568181818181818;19;25;0.0681818181818182;0.431818181818182
Control.SRR15539829;41;45;0.536585365853659;19;22;0.0365853658536586;0.463414634146341
Control.SRR15539829;47;45;0.446808510638298;26;21;0.0531914893617021;0.446808510638298
Control.SRR15539829;50;45;0.48;26;24;0.02;0.48
Control.SRR15539829;42;45;0.666666666666667;14;28;0.166666666666667;0.333333333333333
Control.SRR15539829;48;45;0.520833333333333;23;25;0.0208333333333334;0.479166666666667
Control.SRR15539829;43;45;0.441860465116279;24;19;0.0581395348837209;0.441860465116279
Control.SRR15539829;48;45;0.4375;27;21;0.0625;0.4375
Control.SRR15539829;44;45;0.590909090909091;18;26;0.0909090909090909;0.409090909090909
Control.SRR15539829;45;45;0.555555555555556;20;25;0.0555555555555556;0.444444444444444
Control.SRR15539829;42;45;0.5;21;21;0;0.5
Control.SRR15539829;50;45;0.4;30;20;0.1;0.4
Control.SRR15539829;48;45;0.5;24;24;0;0.5
Control.SRR15539829;41;45;0.609756097560976;16;25;0.109756097560976;0.390243902439024
Control.SRR15539829;42;45;0.547619047619048;19;23;0.0476190476190477;0.452380952380952
Control.SRR15539829;44;45;0.5;22;22;0;0.5
Control.SRR15539829;45;45;0.533333333333333;21;24;0.0333333333333333;0.466666666666667
Control.SRR15539829;49;45;0.469387755102041;26;23;0.0306122448979592;0.469387755102041
Control.SRR15539829;45;45;0.555555555555556;20;25;0.0555555555555556;0.444444444444444
Control.SRR15539829;44;45;0.613636363636364;17;27;0.113636363636364;0.386363636363636
Control.SRR15539829;47;45;0.48936170212766;24;23;0.0106382978723404;0.48936170212766
Control.SRR15539829;45;45;0.488888888888889;23;22;0.0111111111111111;0.488888888888889
Control.SRR15539829;48;45;0.458333333333333;26;22;0.0416666666666667;0.458333333333333
Control.SRR15539829;48;45;0.5;24;24;0;0.5
Control.SRR15539829;49;45;0.571428571428571;21;28;0.0714285714285714;0.428571428571429
Control.SRR15539829;39;45;0.461538461538462;21;18;0.0384615384615384;0.461538461538462
Control.SRR15539829;42;45;0.642857142857143;15;27;0.142857142857143;0.357142857142857
Control.SRR15539829;52;45;0.557692307692308;23;29;0.0576923076923077;0.442307692307692
Control.SRR15539829;47;45;0.404255319148936;28;19;0.0957446808510639;0.404255319148936
Control.SRR15539829;42;45;0.404761904761905;25;17;0.0952380952380952;0.404761904761905
Control.SRR15539829;46;45;0.5;23;23;0;0.5
Control.SRR15539829;44;45;0.431818181818182;25;19;0.0681818181818182;0.431818181818182
Control.SRR15539829;51;45;0.392156862745098;31;20;0.107843137254902;0.392156862745098
Control.SRR15539829;39;45;0.487179487179487;20;19;0.0128205128205128;0.487179487179487
Control.SRR15539829;41;45;0.414634146341463;24;17;0.0853658536585366;0.414634146341463
Control.SRR15539829;51;45;0.490196078431373;26;25;0.00980392156862747;0.490196078431373
Control.SRR15539829;40;45;0.425;23;17;0.075;0.425
Control.SRR15539829;46;45;0.478260869565217;24;22;0.0217391304347826;0.478260869565217
Control.SRR15539829;48;45;0.5625;21;27;0.0625;0.4375
Control.SRR15539829;49;45;0.387755102040816;30;19;0.112244897959184;0.387755102040816
Control.SRR15539829;46;45;0.608695652173913;18;28;0.108695652173913;0.391304347826087
Control.SRR15539829;43;45;0.465116279069767;23;20;0.0348837209302326;0.465116279069767
Control.SRR15539829;50;45;0.58;21;29;0.08;0.42
Control.SRR15539829;47;45;0.48936170212766;24;23;0.0106382978723404;0.48936170212766
Control.SRR15539829;48;45;0.5625;21;27;0.0625;0.4375
Control.SRR15539829;46;45;0.543478260869565;21;25;0.0434782608695652;0.456521739130435
Control.SRR15539829;45;45;0.466666666666667;24;21;0.0333333333333333;0.466666666666667
Control.SRR15539829;51;45;0.568627450980392;22;29;0.0686274509803921;0.431372549019608
Control.SRR15539829;40;45;0.55;18;22;0.05;0.45
Control.SRR15539829;39;45;0.461538461538462;21;18;0.0384615384615384;0.461538461538462
Control.SRR15539829;39;45;0.41025641025641;23;16;0.0897435897435898;0.41025641025641
Control.SRR15539829;52;45;0.596153846153846;21;31;0.0961538461538461;0.403846153846154
Control.SRR15539829;40;45;0.475;21;19;0.025;0.475
Control.SRR15539829;46;45;0.456521739130435;25;21;0.0434782608695652;0.456521739130435
Control.SRR15539829;44;45;0.409090909090909;26;18;0.0909090909090909;0.409090909090909
Control.SRR15539829;43;45;0.534883720930233;20;23;0.0348837209302325;0.465116279069767
Control.SRR15539829;47;45;0.531914893617021;22;25;0.0319148936170213;0.468085106382979
Control.SRR15539829;52;45;0.442307692307692;29;23;0.0576923076923077;0.442307692307692
Control.SRR15539829;49;45;0.551020408163265;22;27;0.0510204081632653;0.448979591836735
Control.SRR15539829;52;45;0.576923076923077;22;30;0.0769230769230769;0.423076923076923
Control.SRR15539829;42;45;0.357142857142857;27;15;0.142857142857143;0.357142857142857
Control.SRR15539829;42;45;0.571428571428571;18;24;0.0714285714285714;0.428571428571429
Control.SRR15539829;44;45;0.568181818181818;19;25;0.0681818181818182;0.431818181818182
Control.SRR15539829;50;45;0.48;26;24;0.02;0.48
Control.SRR15539829;48;45;0.583333333333333;20;28;0.0833333333333334;0.416666666666667
Control.SRR15539829;52;45;0.403846153846154;31;21;0.0961538461538461;0.403846153846154
Control.SRR15539829;49;45;0.551020408163265;22;27;0.0510204081632653;0.448979591836735
Control.SRR15539829;43;45;0.418604651162791;25;18;0.0813953488372093;0.418604651162791
Control.SRR15539829;50;45;0.46;27;23;0.04;0.46
Control.SRR15539829;51;45;0.549019607843137;23;28;0.0490196078431373;0.450980392156863
Control.SRR15539829;47;45;0.702127659574468;14;33;0.202127659574468;0.297872340425532
Control.SRR15539829;47;45;0.425531914893617;27;20;0.074468085106383;0.425531914893617
Control.SRR15539829;41;45;0.560975609756098;18;23;0.0609756097560976;0.439024390243902
Control.SRR15539829;50;45;0.6;20;30;0.1;0.4
Control.SRR15539829;43;45;0.511627906976744;21;22;0.0116279069767442;0.488372093023256
Control.SRR15539829;50;45;0.48;26;24;0.02;0.48
Control.SRR15539829;51;45;0.588235294117647;21;30;0.0882352941176471;0.411764705882353
Control.SRR15539829;51;45;0.431372549019608;29;22;0.0686274509803921;0.431372549019608
Control.SRR15539829;41;45;0.609756097560976;16;25;0.109756097560976;0.390243902439024
Control.SRR15539829;43;45;0.534883720930233;20;23;0.0348837209302325;0.465116279069767
Control.SRR15539829;49;45;0.408163265306122;29;20;0.0918367346938775;0.408163265306122
Control.SRR15539829;47;45;0.446808510638298;26;21;0.0531914893617021;0.446808510638298
Control.SRR15539829;50;45;0.56;22;28;0.0600000000000001;0.44
Control.SRR15539829;45;45;0.666666666666667;15;30;0.166666666666667;0.333333333333333
Control.SRR15539829;42;45;0.547619047619048;19;23;0.0476190476190477;0.452380952380952
Control.SRR15539829;47;45;0.553191489361702;21;26;0.0531914893617021;0.446808510638298
Control.SRR15539829;42;45;0.595238095238095;17;25;0.0952380952380952;0.404761904761905
Control.SRR15539829;48;45;0.458333333333333;26;22;0.0416666666666667;0.458333333333333
Control.SRR15539829;41;45;0.414634146341463;24;17;0.0853658536585366;0.414634146341463
Control.SRR15539829;43;45;0.604651162790698;17;26;0.104651162790698;0.395348837209302
Control.SRR15539829;44;45;0.5;22;22;0;0.5
Control.SRR15539829;40;45;0.45;22;18;0.05;0.45
Control.SRR15539829;47;45;0.531914893617021;22;25;0.0319148936170213;0.468085106382979
Control.SRR15539829;49;45;0.469387755102041;26;23;0.0306122448979592;0.469387755102041
Control.SRR15539829;44;45;0.363636363636364;28;16;0.136363636363636;0.363636363636364
Control.SRR15539829;43;45;0.511627906976744;21;22;0.0116279069767442;0.488372093023256
Control.SRR15539829;42;45;0.523809523809524;20;22;0.0238095238095238;0.476190476190476
Control.SRR15539829;43;45;0.604651162790698;17;26;0.104651162790698;0.395348837209302
Control.SRR15539829;45;45;0.511111111111111;22;23;0.0111111111111111;0.488888888888889
Control.SRR15539829;42;45;0.285714285714286;30;12;0.214285714285714;0.285714285714286
Control.SRR15539829;50;45;0.46;27;23;0.04;0.46
Control.SRR15539829;47;45;0.595744680851064;19;28;0.0957446808510638;0.404255319148936
Control.SRR15539829;47;45;0.382978723404255;29;18;0.117021276595745;0.382978723404255
Control.SRR15539829;42;45;0.476190476190476;22;20;0.0238095238095238;0.476190476190476
Control.SRR15539829;39;45;0.461538461538462;21;18;0.0384615384615384;0.461538461538462
Control.SRR15539829;39;45;0.512820512820513;19;20;0.0128205128205128;0.487179487179487
Control.SRR15539829;50;45;0.62;19;31;0.12;0.38
Control.SRR15539829;39;45;0.461538461538462;21;18;0.0384615384615384;0.461538461538462
Control.SRR15539829;52;45;0.480769230769231;27;25;0.0192307692307692;0.480769230769231
Control.SRR15539829;43;45;0.418604651162791;25;18;0.0813953488372093;0.418604651162791
Control.SRR15539829;45;45;0.666666666666667;15;30;0.166666666666667;0.333333333333333
Control.SRR15539829;52;45;0.519230769230769;25;27;0.0192307692307693;0.480769230769231
Control.SRR15539829;49;45;0.551020408163265;22;27;0.0510204081632653;0.448979591836735
Control.SRR15539829;45;45;0.488888888888889;23;22;0.0111111111111111;0.488888888888889
Control.SRR15539829;40;45;0.425;23;17;0.075;0.425
Control.SRR15539829;46;45;0.478260869565217;24;22;0.0217391304347826;0.478260869565217
Control.SRR15539829;48;45;0.541666666666667;22;26;0.0416666666666666;0.458333333333333
Control.SRR15539829;39;45;0.564102564102564;17;22;0.0641025641025641;0.435897435897436
Control.SRR15539829;39;45;0.58974358974359;16;23;0.0897435897435898;0.41025641025641
Control.SRR15539829;46;45;0.58695652173913;19;27;0.0869565217391305;0.41304347826087
Control.SRR15539829;45;45;0.377777777777778;28;17;0.122222222222222;0.377777777777778
Control.SRR15539829;46;45;0.41304347826087;27;19;0.0869565217391304;0.41304347826087
Control.SRR15539829;43;45;0.488372093023256;22;21;0.0116279069767442;0.488372093023256
Control.SRR15539829;47;45;0.425531914893617;27;20;0.074468085106383;0.425531914893617
Control.SRR15539829;47;45;0.404255319148936;28;19;0.0957446808510639;0.404255319148936
Control.SRR15539829;51;45;0.392156862745098;31;20;0.107843137254902;0.392156862745098
Control.SRR15539829;46;45;0.456521739130435;25;21;0.0434782608695652;0.456521739130435
Control.SRR15539829;45;45;0.666666666666667;15;30;0.166666666666667;0.333333333333333
Control.SRR15539829;42;45;0.452380952380952;23;19;0.0476190476190476;0.452380952380952
Control.SRR15539829;42;45;0.404761904761905;25;17;0.0952380952380952;0.404761904761905
Control.SRR15539829;45;45;0.488888888888889;23;22;0.0111111111111111;0.488888888888889
Control.SRR15539829;50;45;0.42;29;21;0.08;0.42
Control.SRR15539829;48;45;0.479166666666667;25;23;0.0208333333333333;0.479166666666667
Control.SRR15539829;50;45;0.58;21;29;0.08;0.42
Control.SRR15539829;41;45;0.51219512195122;20;21;0.0121951219512195;0.48780487804878
Control.SRR15539829;49;45;0.469387755102041;26;23;0.0306122448979592;0.469387755102041
Control.SRR15539829;52;45;0.461538461538462;28;24;0.0384615384615384;0.461538461538462
Control.SRR15539829;47;45;0.446808510638298;26;21;0.0531914893617021;0.446808510638298
Control.SRR15539829;43;45;0.488372093023256;22;21;0.0116279069767442;0.488372093023256
Control.SRR15539829;41;45;0.536585365853659;19;22;0.0365853658536586;0.463414634146341
Control.SRR15539829;45;45;0.533333333333333;21;24;0.0333333333333333;0.466666666666667
Control.SRR15539829;51;45;0.490196078431373;26;25;0.00980392156862747;0.490196078431373
Control.SRR15539829;44;45;0.431818181818182;25;19;0.0681818181818182;0.431818181818182
Control.SRR15539829;48;45;0.5;24;24;0;0.5
Control.SRR15539829;43;45;0.488372093023256;22;21;0.0116279069767442;0.488372093023256
Control.SRR15539829;48;45;0.5;24;24;0;0.5
Control.SRR15539829;50;45;0.38;31;19;0.12;0.38
Control.SRR15539829;51;45;0.450980392156863;28;23;0.0490196078431372;0.450980392156863
Control.SRR15539829;40;45;0.55;18;22;0.05;0.45
Control.SRR15539829;40;45;0.525;19;21;0.025;0.475
Control.SRR15539829;52;45;0.288461538461538;37;15;0.211538461538462;0.288461538461538
Control.SRR15539829;52;45;0.557692307692308;23;29;0.0576923076923077;0.442307692307692
Control.SRR15539829;47;45;0.382978723404255;29;18;0.117021276595745;0.382978723404255
Control.SRR15539829;47;45;0.638297872340426;17;30;0.138297872340426;0.361702127659574
Control.SRR15539829;45;45;0.444444444444444;25;20;0.0555555555555556;0.444444444444444
Control.SRR15539829;46;45;0.543478260869565;21;25;0.0434782608695652;0.456521739130435
Control.SRR15539829;44;45;0.613636363636364;17;27;0.113636363636364;0.386363636363636
Control.SRR15539829;51;45;0.588235294117647;21;30;0.0882352941176471;0.411764705882353
Control.SRR15539829;46;45;0.58695652173913;19;27;0.0869565217391305;0.41304347826087
Control.SRR15539829;45;45;0.533333333333333;21;24;0.0333333333333333;0.466666666666667
Control.SRR15539829;43;45;0.465116279069767;23;20;0.0348837209302326;0.465116279069767
Control.SRR15539829;45;45;0.466666666666667;24;21;0.0333333333333333;0.466666666666667
Control.SRR15539829;43;45;0.534883720930233;20;23;0.0348837209302325;0.465116279069767
Control.SRR15539829;42;45;0.5;21;21;0;0.5
Control.SRR15539829;47;45;0.51063829787234;23;24;0.0106382978723404;0.48936170212766
Control.SRR15539829;47;45;0.48936170212766;24;23;0.0106382978723404;0.48936170212766
Control.SRR15539829;40;45;0.55;18;22;0.05;0.45
Control.SRR15539829;39;45;0.512820512820513;19;20;0.0128205128205128;0.487179487179487
Control.SRR15539829;42;45;0.428571428571429;24;18;0.0714285714285715;0.428571428571429
Control.SRR15539829;42;45;0.571428571428571;18;24;0.0714285714285714;0.428571428571429
Control.SRR15539829;39;45;0.461538461538462;21;18;0.0384615384615384;0.461538461538462
Control.SRR15539829;46;45;0.456521739130435;25;21;0.0434782608695652;0.456521739130435
Control.SRR15539829;51;45;0.450980392156863;28;23;0.0490196078431372;0.450980392156863
Control.SRR15539829;50;45;0.48;26;24;0.02;0.48
Control.SRR15539829;49;45;0.653061224489796;17;32;0.153061224489796;0.346938775510204
Control.SRR15539829;42;45;0.547619047619048;19;23;0.0476190476190477;0.452380952380952
Control.SRR15539829;46;45;0.521739130434783;22;24;0.0217391304347826;0.478260869565217
Control.SRR15539829;41;45;0.51219512195122;20;21;0.0121951219512195;0.48780487804878
Control.SRR15539829;46;45;0.565217391304348;20;26;0.0652173913043478;0.434782608695652
Control.SRR15539829;39;45;0.487179487179487;20;19;0.0128205128205128;0.487179487179487
Control.SRR15539829;46;45;0.58695652173913;19;27;0.0869565217391305;0.41304347826087
Control.SRR15539829;50;45;0.54;23;27;0.04;0.46
Control.SRR15539829;47;45;0.531914893617021;22;25;0.0319148936170213;0.468085106382979
Control.SRR15539829;43;45;0.674418604651163;14;29;0.174418604651163;0.325581395348837
Control.SRR15539829;52;45;0.5;26;26;0;0.5
Control.SRR15539829;50;45;0.48;26;24;0.02;0.48
Control.SRR15539829;41;45;0.609756097560976;16;25;0.109756097560976;0.390243902439024
Control.SRR15539829;52;45;0.423076923076923;30;22;0.0769230769230769;0.423076923076923
Control.SRR15539829;43;45;0.627906976744186;16;27;0.127906976744186;0.372093023255814
Control.SRR15539829;44;45;0.5;22;22;0;0.5
Control.SRR15539829;49;45;0.612244897959184;19;30;0.112244897959184;0.387755102040816
Control.SRR15539829;39;45;0.512820512820513;19;20;0.0128205128205128;0.487179487179487
Control.SRR15539829;47;45;0.404255319148936;28;19;0.0957446808510639;0.404255319148936
Control.SRR15539829;49;45;0.469387755102041;26;23;0.0306122448979592;0.469387755102041
Control.SRR15539829;50;45;0.58;21;29;0.08;0.42
Control.SRR15539829;45;45;0.577777777777778;19;26;0.0777777777777777;0.422222222222222
Control.SRR15539829;46;45;0.543478260869565;21;25;0.0434782608695652;0.456521739130435
Control.SRR15539829;49;45;0.530612244897959;23;26;0.0306122448979592;0.469387755102041
Control.SRR15539829;48;45;0.458333333333333;26;22;0.0416666666666667;0.458333333333333
Control.SRR15539829;44;45;0.5;22;22;0;0.5
Control.SRR15539829;40;45;0.5;20;20;0;0.5
Control.SRR15539829;43;45;0.581395348837209;18;25;0.0813953488372093;0.418604651162791
Control.SRR15539829;46;45;0.347826086956522;30;16;0.152173913043478;0.347826086956522
Control.SRR15539829;43;45;0.488372093023256;22;21;0.0116279069767442;0.488372093023256
Control.SRR15539829;52;45;0.423076923076923;30;22;0.0769230769230769;0.423076923076923
Control.SRR15539829;49;45;0.530612244897959;23;26;0.0306122448979592;0.469387755102041
Control.SRR15539829;48;45;0.583333333333333;20;28;0.0833333333333334;0.416666666666667
Control.SRR15539829;47;45;0.404255319148936;28;19;0.0957446808510639;0.404255319148936
Control.SRR15539829;49;45;0.448979591836735;27;22;0.0510204081632653;0.448979591836735
Control.SRR15539829;49;45;0.448979591836735;27;22;0.0510204081632653;0.448979591836735
Control.SRR15539829;41;45;0.609756097560976;16;25;0.109756097560976;0.390243902439024
Control.SRR15539829;50;45;0.38;31;19;0.12;0.38
Control.SRR15539829;52;45;0.442307692307692;29;23;0.0576923076923077;0.442307692307692
Control.SRR15539829;48;45;0.5625;21;27;0.0625;0.4375
Control.SRR15539829;49;45;0.530612244897959;23;26;0.0306122448979592;0.469387755102041
Control.SRR15539829;51;45;0.529411764705882;24;27;0.0294117647058824;0.470588235294118
Control.SRR15539829;51;45;0.333333333333333;34;17;0.166666666666667;0.333333333333333
Control.SRR15539829;42;45;0.571428571428571;18;24;0.0714285714285714;0.428571428571429
Control.SRR15539829;49;45;0.530612244897959;23;26;0.0306122448979592;0.469387755102041
Control.SRR15539829;48;45;0.541666666666667;22;26;0.0416666666666666;0.458333333333333
Control.SRR15539829;52;45;0.538461538461538;24;28;0.0384615384615384;0.461538461538462
Control.SRR15539829;47;45;0.553191489361702;21;26;0.0531914893617021;0.446808510638298
Control.SRR15539829;47;45;0.51063829787234;23;24;0.0106382978723404;0.48936170212766
Control.SRR15539829;50;45;0.54;23;27;0.04;0.46
Control.SRR15539829;45;45;0.444444444444444;25;20;0.0555555555555556;0.444444444444444
Control.SRR15539829;43;45;0.511627906976744;21;22;0.0116279069767442;0.488372093023256
Control.SRR15539829;49;45;0.469387755102041;26;23;0.0306122448979592;0.469387755102041
Control.SRR15539829;46;45;0.41304347826087;27;19;0.0869565217391304;0.41304347826087
Control.SRR15539829;49;45;0.448979591836735;27;22;0.0510204081632653;0.448979591836735
Control.SRR15539829;39;45;0.461538461538462;21;18;0.0384615384615384;0.461538461538462
Control.SRR15539829;51;45;0.529411764705882;24;27;0.0294117647058824;0.470588235294118
Control.SRR15539829;50;45;0.6;20;30;0.1;0.4
Control.SRR15539829;45;45;0.488888888888889;23;22;0.0111111111111111;0.488888888888889
Control.SRR15539829;48;45;0.375;30;18;0.125;0.375
Control.SRR15539829;50;45;0.62;19;31;0.12;0.38
Control.SRR15539829;47;45;0.638297872340426;17;30;0.138297872340426;0.361702127659574
Control.SRR15539829;39;45;0.512820512820513;19;20;0.0128205128205128;0.487179487179487
Control.SRR15539829;45;45;0.377777777777778;28;17;0.122222222222222;0.377777777777778
Control.SRR15539829;39;45;0.538461538461538;18;21;0.0384615384615384;0.461538461538462
Control.SRR15539829;45;45;0.555555555555556;20;25;0.0555555555555556;0.444444444444444
Control.SRR15539829;48;45;0.3125;33;15;0.1875;0.3125
Control.SRR15539829;48;45;0.5;24;24;0;0.5
Control.SRR15539829;52;45;0.634615384615385;19;33;0.134615384615385;0.365384615384615
Control.SRR15539829;45;45;0.511111111111111;22;23;0.0111111111111111;0.488888888888889
Control.SRR15539829;47;45;0.531914893617021;22;25;0.0319148936170213;0.468085106382979
Control.SRR15539829;42;45;0.523809523809524;20;22;0.0238095238095238;0.476190476190476
Control.SRR15539829;46;45;0.260869565217391;34;12;0.239130434782609;0.260869565217391
Control.SRR15539829;46;45;0.565217391304348;20;26;0.0652173913043478;0.434782608695652
Control.SRR15539829;44;45;0.409090909090909;26;18;0.0909090909090909;0.409090909090909
Control.SRR15539829;44;45;0.5;22;22;0;0.5
Control.SRR15539829;50;45;0.6;20;30;0.1;0.4
Control.SRR15539829;43;45;0.488372093023256;22;21;0.0116279069767442;0.488372093023256
Control.SRR15539829;48;45;0.479166666666667;25;23;0.0208333333333333;0.479166666666667
Control.SRR15539829;42;45;0.523809523809524;20;22;0.0238095238095238;0.476190476190476
Control.SRR15539829;50;45;0.52;24;26;0.02;0.48
Control.SRR15539829;40;45;0.525;19;21;0.025;0.475
Control.SRR15539829;45;45;0.444444444444444;25;20;0.0555555555555556;0.444444444444444
Control.SRR15539829;47;45;0.446808510638298;26;21;0.0531914893617021;0.446808510638298
Control.SRR15539829;39;45;0.435897435897436;22;17;0.0641025641025641;0.435897435897436
Control.SRR15539829;40;45;0.35;26;14;0.15;0.35
Control.SRR15539829;49;45;0.428571428571429;28;21;0.0714285714285715;0.428571428571429
Control.SRR15539829;50;45;0.46;27;23;0.04;0.46
Control.SRR15539829;49;45;0.551020408163265;22;27;0.0510204081632653;0.448979591836735
Control.SRR15539829;51;45;0.450980392156863;28;23;0.0490196078431372;0.450980392156863
Control.SRR15539829;44;45;0.522727272727273;21;23;0.0227272727272727;0.477272727272727
Control.SRR15539829;42;45;0.476190476190476;22;20;0.0238095238095238;0.476190476190476
Control.SRR15539829;47;45;0.446808510638298;26;21;0.0531914893617021;0.446808510638298
Control.SRR15539829;50;45;0.5;25;25;0;0.5
Control.SRR15539829;46;45;0.5;23;23;0;0.5
Control.SRR15539829;45;45;0.511111111111111;22;23;0.0111111111111111;0.488888888888889
Control.SRR15539829;46;45;0.5;23;23;0;0.5
Control.SRR15539829;44;45;0.5;22;22;0;0.5
Control.SRR15539829;44;45;0.545454545454545;20;24;0.0454545454545454;0.454545454545455
Control.SRR15539829;48;45;0.520833333333333;23;25;0.0208333333333334;0.479166666666667
Control.SRR15539829;52;45;0.461538461538462;28;24;0.0384615384615384;0.461538461538462
Control.SRR15539829;46;45;0.456521739130435;25;21;0.0434782608695652;0.456521739130435
Control.SRR15539829;46;45;0.434782608695652;26;20;0.0652173913043478;0.434782608695652
Control.SRR15539829;46;45;0.543478260869565;21;25;0.0434782608695652;0.456521739130435
Control.SRR15539829;52;45;0.442307692307692;29;23;0.0576923076923077;0.442307692307692
Control.SRR15539829;47;45;0.446808510638298;26;21;0.0531914893617021;0.446808510638298
Control.SRR15539829;51;45;0.490196078431373;26;25;0.00980392156862747;0.490196078431373
Control.SRR15539829;49;45;0.530612244897959;23;26;0.0306122448979592;0.469387755102041
Control.SRR15539829;51;45;0.549019607843137;23;28;0.0490196078431373;0.450980392156863
Control.SRR15539829;48;45;0.5;24;24;0;0.5
Control.SRR15539829;43;45;0.511627906976744;21;22;0.0116279069767442;0.488372093023256
Control.SRR15539829;47;45;0.382978723404255;29;18;0.117021276595745;0.382978723404255
Control.SRR15539829;44;45;0.477272727272727;23;21;0.0227272727272727;0.477272727272727
Control.SRR15539829;41;45;0.463414634146341;22;19;0.0365853658536585;0.463414634146341
Control.SRR15539829;42;45;0.619047619047619;16;26;0.119047619047619;0.380952380952381
Control.SRR15539829;44;45;0.454545454545455;24;20;0.0454545454545455;0.454545454545455
Control.SRR15539829;44;45;0.431818181818182;25;19;0.0681818181818182;0.431818181818182
Control.SRR15539829;52;45;0.596153846153846;21;31;0.0961538461538461;0.403846153846154
Control.SRR15539829;50;45;0.46;27;23;0.04;0.46
Control.SRR15539829;41;45;0.48780487804878;21;20;0.0121951219512195;0.48780487804878
Control.SRR15539829;50;45;0.58;21;29;0.08;0.42
Control.SRR15539829;52;45;0.519230769230769;25;27;0.0192307692307693;0.480769230769231
Control.SRR15539829;44;45;0.318181818181818;30;14;0.181818181818182;0.318181818181818
Control.SRR15539829;39;45;0.58974358974359;16;23;0.0897435897435898;0.41025641025641
Control.SRR15539829;41;45;0.51219512195122;20;21;0.0121951219512195;0.48780487804878
Control.SRR15539829;48;45;0.5625;21;27;0.0625;0.4375
Control.SRR15539829;42;45;0.571428571428571;18;24;0.0714285714285714;0.428571428571429
Control.SRR15539829;49;45;0.530612244897959;23;26;0.0306122448979592;0.469387755102041
Control.SRR15539829;49;45;0.489795918367347;25;24;0.0102040816326531;0.489795918367347
Control.SRR15539829;51;45;0.313725490196078;35;16;0.186274509803922;0.313725490196078
Control.SRR15539829;48;45;0.395833333333333;29;19;0.104166666666667;0.395833333333333
Control.SRR15539829;51;45;0.588235294117647;21;30;0.0882352941176471;0.411764705882353
Control.SRR15539829;51;45;0.431372549019608;29;22;0.0686274509803921;0.431372549019608
Control.SRR15539829;46;45;0.543478260869565;21;25;0.0434782608695652;0.456521739130435
Control.SRR15539829;45;45;0.422222222222222;26;19;0.0777777777777778;0.422222222222222
Control.SRR15539829;48;45;0.520833333333333;23;25;0.0208333333333334;0.479166666666667
Control.SRR15539829;45;45;0.511111111111111;22;23;0.0111111111111111;0.488888888888889
Control.SRR15539829;41;45;0.609756097560976;16;25;0.109756097560976;0.390243902439024
Control.SRR15539829;47;45;0.574468085106383;20;27;0.074468085106383;0.425531914893617
Control.SRR15539829;51;45;0.549019607843137;23;28;0.0490196078431373;0.450980392156863
Control.SRR15539829;50;45;0.6;20;30;0.1;0.4
Control.SRR15539829;43;45;0.558139534883721;19;24;0.0581395348837209;0.441860465116279
Control.SRR15539829;48;45;0.5;24;24;0;0.5
Control.SRR15539829;41;45;0.390243902439024;25;16;0.109756097560976;0.390243902439024
Control.SRR15539829;48;45;0.645833333333333;17;31;0.145833333333333;0.354166666666667
Control.SRR15539829;47;45;0.51063829787234;23;24;0.0106382978723404;0.48936170212766
Control.SRR15539829;46;45;0.478260869565217;24;22;0.0217391304347826;0.478260869565217
Control.SRR15539829;45;45;0.511111111111111;22;23;0.0111111111111111;0.488888888888889
Control.SRR15539829;51;45;0.568627450980392;22;29;0.0686274509803921;0.431372549019608
Control.SRR15539829;40;45;0.55;18;22;0.05;0.45
Control.SRR15539829;51;45;0.470588235294118;27;24;0.0294117647058824;0.470588235294118
Control.SRR15539829;48;45;0.5625;21;27;0.0625;0.4375
Control.SRR15539829;51;45;0.431372549019608;29;22;0.0686274509803921;0.431372549019608
Control.SRR15539829;52;45;0.5;26;26;0;0.5
Control.SRR15539829;51;45;0.431372549019608;29;22;0.0686274509803921;0.431372549019608
Control.SRR15539829;43;45;0.488372093023256;22;21;0.0116279069767442;0.488372093023256
Control.SRR15539829;45;45;0.577777777777778;19;26;0.0777777777777777;0.422222222222222
Control.SRR15539829;51;45;0.333333333333333;34;17;0.166666666666667;0.333333333333333
Control.SRR15539829;44;45;0.613636363636364;17;27;0.113636363636364;0.386363636363636
Control.SRR15539829;45;45;0.555555555555556;20;25;0.0555555555555556;0.444444444444444
Control.SRR15539829;50;45;0.52;24;26;0.02;0.48
Control.SRR15539829;44;45;0.363636363636364;28;16;0.136363636363636;0.363636363636364
Control.SRR15539829;44;45;0.409090909090909;26;18;0.0909090909090909;0.409090909090909
Control.SRR15539829;40;45;0.45;22;18;0.05;0.45
Control.SRR15539829;51;45;0.470588235294118;27;24;0.0294117647058824;0.470588235294118
Control.SRR15539829;49;45;0.551020408163265;22;27;0.0510204081632653;0.448979591836735
Control.SRR15539829;47;45;0.468085106382979;25;22;0.0319148936170213;0.468085106382979
Control.SRR15539829;46;45;0.41304347826087;27;19;0.0869565217391304;0.41304347826087
Control.SRR15539829;51;45;0.549019607843137;23;28;0.0490196078431373;0.450980392156863
Control.SRR15539829;47;45;0.446808510638298;26;21;0.0531914893617021;0.446808510638298
Control.SRR15539829;46;45;0.478260869565217;24;22;0.0217391304347826;0.478260869565217
Control.SRR15539829;41;45;0.48780487804878;21;20;0.0121951219512195;0.48780487804878
Control.SRR15539829;43;45;0.511627906976744;21;22;0.0116279069767442;0.488372093023256
Control.SRR15539829;42;45;0.619047619047619;16;26;0.119047619047619;0.380952380952381
Control.SRR15539829;41;45;0.536585365853659;19;22;0.0365853658536586;0.463414634146341
Control.SRR15539829;40;45;0.5;20;20;0;0.5
Control.SRR15539829;51;45;0.450980392156863;28;23;0.0490196078431372;0.450980392156863
Control.SRR15539829;50;45;0.56;22;28;0.0600000000000001;0.44
Control.SRR15539829;49;45;0.510204081632653;24;25;0.0102040816326531;0.489795918367347
Control.SRR15539829;50;45;0.54;23;27;0.04;0.46
Control.SRR15539829;50;45;0.46;27;23;0.04;0.46
Control.SRR15539829;46;45;0.41304347826087;27;19;0.0869565217391304;0.41304347826087
Control.SRR15539829;41;45;0.365853658536585;26;15;0.134146341463415;0.365853658536585
Control.SRR15539829;45;45;0.533333333333333;21;24;0.0333333333333333;0.466666666666667
Control.SRR15539829;44;45;0.568181818181818;19;25;0.0681818181818182;0.431818181818182
Control.SRR15539829;50;45;0.48;26;24;0.02;0.48
Control.SRR15539829;41;45;0.51219512195122;20;21;0.0121951219512195;0.48780487804878
Control.SRR15539829;45;45;0.511111111111111;22;23;0.0111111111111111;0.488888888888889
Control.SRR15539829;43;45;0.558139534883721;19;24;0.0581395348837209;0.441860465116279
Control.SRR15539829;44;45;0.295454545454545;31;13;0.204545454545455;0.295454545454545
Control.SRR15539829;47;45;0.531914893617021;22;25;0.0319148936170213;0.468085106382979
Control.SRR15539829;41;45;0.536585365853659;19;22;0.0365853658536586;0.463414634146341
Control.SRR15539829;46;45;0.673913043478261;15;31;0.173913043478261;0.326086956521739
Control.SRR15539829;43;45;0.511627906976744;21;22;0.0116279069767442;0.488372093023256
Control.SRR15539829;41;45;0.707317073170732;12;29;0.207317073170732;0.292682926829268
Control.SRR15539829;43;45;0.581395348837209;18;25;0.0813953488372093;0.418604651162791
Control.SRR15539829;40;45;0.575;17;23;0.075;0.425
Control.SRR15539829;51;45;0.470588235294118;27;24;0.0294117647058824;0.470588235294118
Control.SRR15539829;39;45;0.461538461538462;21;18;0.0384615384615384;0.461538461538462
Control.SRR15539829;48;45;0.520833333333333;23;25;0.0208333333333334;0.479166666666667
Control.SRR15539829;48;45;0.604166666666667;19;29;0.104166666666667;0.395833333333333
Control.SRR15539829;44;45;0.5;22;22;0;0.5
Control.SRR15539829;45;45;0.377777777777778;28;17;0.122222222222222;0.377777777777778
Control.SRR15539829;46;45;0.58695652173913;19;27;0.0869565217391305;0.41304347826087
Control.SRR15539829;52;45;0.596153846153846;21;31;0.0961538461538461;0.403846153846154
Control.SRR15539829;39;45;0.435897435897436;22;17;0.0641025641025641;0.435897435897436
Control.SRR15539829;40;45;0.475;21;19;0.025;0.475
Control.SRR15539829;42;45;0.452380952380952;23;19;0.0476190476190476;0.452380952380952
Control.SRR15539829;48;45;0.5;24;24;0;0.5
Control.SRR15539829;49;45;0.428571428571429;28;21;0.0714285714285715;0.428571428571429
Control.SRR15539829;47;45;0.595744680851064;19;28;0.0957446808510638;0.404255319148936
Control.SRR15539829;47;45;0.468085106382979;25;22;0.0319148936170213;0.468085106382979
Control.SRR15539829;43;45;0.441860465116279;24;19;0.0581395348837209;0.441860465116279
Control.SRR15539829;46;45;0.521739130434783;22;24;0.0217391304347826;0.478260869565217
Control.SRR15539829;51;45;0.450980392156863;28;23;0.0490196078431372;0.450980392156863
Control.SRR15539829;45;45;0.422222222222222;26;19;0.0777777777777778;0.422222222222222
Control.SRR15539829;44;45;0.386363636363636;27;17;0.113636363636364;0.386363636363636
Control.SRR15539829;44;45;0.545454545454545;20;24;0.0454545454545454;0.454545454545455
Control.SRR15539829;47;45;0.595744680851064;19;28;0.0957446808510638;0.404255319148936
Control.SRR15539829;46;45;0.434782608695652;26;20;0.0652173913043478;0.434782608695652
Control.SRR15539829;44;45;0.545454545454545;20;24;0.0454545454545454;0.454545454545455
Control.SRR15539829;40;45;0.5;20;20;0;0.5
Control.SRR15539829;41;45;0.463414634146341;22;19;0.0365853658536585;0.463414634146341
Control.SRR15539829;40;45;0.6;16;24;0.1;0.4
Control.SRR15539829;40;45;0.45;22;18;0.05;0.45
Control.SRR15539829;46;45;0.478260869565217;24;22;0.0217391304347826;0.478260869565217
Control.SRR15539829;47;45;0.595744680851064;19;28;0.0957446808510638;0.404255319148936
Control.SRR15539829;42;45;0.571428571428571;18;24;0.0714285714285714;0.428571428571429
Control.SRR15539829;43;45;0.441860465116279;24;19;0.0581395348837209;0.441860465116279
Control.SRR15539829;39;45;0.512820512820513;19;20;0.0128205128205128;0.487179487179487
Control.SRR15539829;45;45;0.422222222222222;26;19;0.0777777777777778;0.422222222222222
Control.SRR15539829;45;45;0.466666666666667;24;21;0.0333333333333333;0.466666666666667
Control.SRR15539829;44;45;0.590909090909091;18;26;0.0909090909090909;0.409090909090909
Control.SRR15539829;48;45;0.395833333333333;29;19;0.104166666666667;0.395833333333333
Control.SRR15539829;42;45;0.5;21;21;0;0.5
Control.SRR15539829;48;45;0.458333333333333;26;22;0.0416666666666667;0.458333333333333
Control.SRR15539829;46;45;0.456521739130435;25;21;0.0434782608695652;0.456521739130435
Control.SRR15539829;45;45;0.6;18;27;0.1;0.4
Control.SRR15539829;42;45;0.428571428571429;24;18;0.0714285714285715;0.428571428571429
Control.SRR15539829;45;45;0.377777777777778;28;17;0.122222222222222;0.377777777777778
Control.SRR15539829;46;45;0.41304347826087;27;19;0.0869565217391304;0.41304347826087
Control.SRR15539829;50;45;0.52;24;26;0.02;0.48
Control.SRR15539829;44;45;0.477272727272727;23;21;0.0227272727272727;0.477272727272727
Control.SRR15539829;42;45;0.523809523809524;20;22;0.0238095238095238;0.476190476190476
Control.SRR15539829;46;45;0.434782608695652;26;20;0.0652173913043478;0.434782608695652
Control.SRR15539829;49;45;0.408163265306122;29;20;0.0918367346938775;0.408163265306122
Control.SRR15539829;39;45;0.564102564102564;17;22;0.0641025641025641;0.435897435897436
Control.SRR15539829;42;45;0.523809523809524;20;22;0.0238095238095238;0.476190476190476
Control.SRR15539829;52;45;0.557692307692308;23;29;0.0576923076923077;0.442307692307692
Control.SRR15539829;41;45;0.48780487804878;21;20;0.0121951219512195;0.48780487804878
Control.SRR15539829;48;45;0.604166666666667;19;29;0.104166666666667;0.395833333333333
Control.SRR15539829;48;45;0.479166666666667;25;23;0.0208333333333333;0.479166666666667
Control.SRR15539829;49;45;0.510204081632653;24;25;0.0102040816326531;0.489795918367347
Control.SRR15539829;43;45;0.511627906976744;21;22;0.0116279069767442;0.488372093023256
Control.SRR15539829;49;45;0.489795918367347;25;24;0.0102040816326531;0.489795918367347
Control.SRR15539829;50;45;0.68;16;34;0.18;0.32
Control.SRR15539829;44;45;0.477272727272727;23;21;0.0227272727272727;0.477272727272727
Control.SRR15539829;43;45;0.441860465116279;24;19;0.0581395348837209;0.441860465116279
Control.SRR15539829;44;45;0.272727272727273;32;12;0.227272727272727;0.272727272727273
Control.SRR15539829;46;45;0.478260869565217;24;22;0.0217391304347826;0.478260869565217
Control.SRR15539829;48;45;0.5;24;24;0;0.5
Control.SRR15539829;43;45;0.558139534883721;19;24;0.0581395348837209;0.441860465116279
Control.SRR15539829;49;45;0.469387755102041;26;23;0.0306122448979592;0.469387755102041
Control.SRR15539829;48;45;0.5;24;24;0;0.5
Control.SRR15539829;43;45;0.395348837209302;26;17;0.104651162790698;0.395348837209302
Control.SRR15539829;39;45;0.487179487179487;20;19;0.0128205128205128;0.487179487179487
Control.SRR15539829;44;45;0.409090909090909;26;18;0.0909090909090909;0.409090909090909
Control.SRR15539829;39;45;0.461538461538462;21;18;0.0384615384615384;0.461538461538462
Control.SRR15539829;39;45;0.538461538461538;18;21;0.0384615384615384;0.461538461538462
Control.SRR15539829;40;45;0.575;17;23;0.075;0.425
Control.SRR15539829;44;45;0.568181818181818;19;25;0.0681818181818182;0.431818181818182
Control.SRR15539829;40;45;0.575;17;23;0.075;0.425
Control.SRR15539829;46;45;0.543478260869565;21;25;0.0434782608695652;0.456521739130435
Control.SRR15539829;42;45;0.547619047619048;19;23;0.0476190476190477;0.452380952380952
Control.SRR15539829;41;45;0.585365853658537;17;24;0.0853658536585366;0.414634146341463
Control.SRR15539829;43;45;0.511627906976744;21;22;0.0116279069767442;0.488372093023256
Control.SRR15539829;41;45;0.536585365853659;19;22;0.0365853658536586;0.463414634146341
Control.SRR15539829;51;45;0.509803921568627;25;26;0.00980392156862742;0.490196078431373
Control.SRR15539829;48;45;0.520833333333333;23;25;0.0208333333333334;0.479166666666667
Control.SRR15539829;41;45;0.536585365853659;19;22;0.0365853658536586;0.463414634146341
Control.SRR15539829;48;45;0.625;18;30;0.125;0.375
Control.SRR15539829;49;45;0.448979591836735;27;22;0.0510204081632653;0.448979591836735
Control.SRR15539829;45;45;0.488888888888889;23;22;0.0111111111111111;0.488888888888889
Control.SRR15539829;40;45;0.625;15;25;0.125;0.375
Control.SRR15539829;44;45;0.454545454545455;24;20;0.0454545454545455;0.454545454545455
Control.SRR15539829;40;45;0.45;22;18;0.05;0.45
Control.SRR15539829;41;45;0.536585365853659;19;22;0.0365853658536586;0.463414634146341
Control.SRR15539829;44;45;0.590909090909091;18;26;0.0909090909090909;0.409090909090909
Control.SRR15539829;42;45;0.595238095238095;17;25;0.0952380952380952;0.404761904761905
Control.SRR15539829;42;45;0.666666666666667;14;28;0.166666666666667;0.333333333333333
Control.SRR15539829;41;45;0.536585365853659;19;22;0.0365853658536586;0.463414634146341
Control.SRR15539829;42;45;0.547619047619048;19;23;0.0476190476190477;0.452380952380952
Control.SRR15539829;42;45;0.571428571428571;18;24;0.0714285714285714;0.428571428571429
Control.SRR15539829;39;45;0.41025641025641;23;16;0.0897435897435898;0.41025641025641
Control.SRR15539829;47;45;0.468085106382979;25;22;0.0319148936170213;0.468085106382979
Control.SRR15539829;46;45;0.565217391304348;20;26;0.0652173913043478;0.434782608695652
Control.SRR15539829;47;45;0.48936170212766;24;23;0.0106382978723404;0.48936170212766
Control.SRR15539829;49;45;0.387755102040816;30;19;0.112244897959184;0.387755102040816
Control.SRR15539829;49;45;0.571428571428571;21;28;0.0714285714285714;0.428571428571429
Control.SRR15539829;47;45;0.531914893617021;22;25;0.0319148936170213;0.468085106382979
Control.SRR15539829;47;45;0.446808510638298;26;21;0.0531914893617021;0.446808510638298
Control.SRR15539829;42;45;0.476190476190476;22;20;0.0238095238095238;0.476190476190476
Control.SRR15539829;43;45;0.534883720930233;20;23;0.0348837209302325;0.465116279069767
Control.SRR15539829;47;45;0.446808510638298;26;21;0.0531914893617021;0.446808510638298
Control.SRR15539829;43;45;0.465116279069767;23;20;0.0348837209302326;0.465116279069767
Control.SRR15539829;44;45;0.704545454545455;13;31;0.204545454545455;0.295454545454545
Control.SRR15539829;45;45;0.377777777777778;28;17;0.122222222222222;0.377777777777778
Control.SRR15539829;41;45;0.463414634146341;22;19;0.0365853658536585;0.463414634146341
Control.SRR15539829;49;45;0.448979591836735;27;22;0.0510204081632653;0.448979591836735
Control.SRR15539829;45;45;0.311111111111111;31;14;0.188888888888889;0.311111111111111
Control.SRR15539829;46;45;0.326086956521739;31;15;0.173913043478261;0.326086956521739
Control.SRR15539829;43;45;0.627906976744186;16;27;0.127906976744186;0.372093023255814
Control.SRR15539829;48;45;0.5625;21;27;0.0625;0.4375
Control.SRR15539829;42;45;0.523809523809524;20;22;0.0238095238095238;0.476190476190476
Control.SRR15539829;43;45;0.465116279069767;23;20;0.0348837209302326;0.465116279069767
Control.SRR15539829;46;45;0.521739130434783;22;24;0.0217391304347826;0.478260869565217
Control.SRR15539829;42;45;0.547619047619048;19;23;0.0476190476190477;0.452380952380952
Control.SRR15539829;49;45;0.428571428571429;28;21;0.0714285714285715;0.428571428571429
Control.SRR15539829;50;45;0.4;30;20;0.1;0.4
Control.SRR15539829;46;45;0.369565217391304;29;17;0.130434782608696;0.369565217391304
Control.SRR15539829;43;45;0.558139534883721;19;24;0.0581395348837209;0.441860465116279
Control.SRR15539829;42;45;0.476190476190476;22;20;0.0238095238095238;0.476190476190476
Control.SRR15539829;40;45;0.525;19;21;0.025;0.475
Control.SRR15539829;46;45;0.58695652173913;19;27;0.0869565217391305;0.41304347826087
Control.SRR15539829;39;45;0.384615384615385;24;15;0.115384615384615;0.384615384615385
Control.SRR15539829;44;45;0.454545454545455;24;20;0.0454545454545455;0.454545454545455
Control.SRR15539829;49;45;0.510204081632653;24;25;0.0102040816326531;0.489795918367347
Control.SRR15539829;45;45;0.533333333333333;21;24;0.0333333333333333;0.466666666666667
Control.SRR15539829;51;45;0.431372549019608;29;22;0.0686274509803921;0.431372549019608
Control.SRR15539829;46;45;0.478260869565217;24;22;0.0217391304347826;0.478260869565217
Control.SRR15539829;43;45;0.441860465116279;24;19;0.0581395348837209;0.441860465116279
Control.SRR15539829;51;45;0.490196078431373;26;25;0.00980392156862747;0.490196078431373
Control.SRR15539829;51;45;0.549019607843137;23;28;0.0490196078431373;0.450980392156863
Control.SRR15539829;44;45;0.590909090909091;18;26;0.0909090909090909;0.409090909090909
Control.SRR15539829;42;45;0.571428571428571;18;24;0.0714285714285714;0.428571428571429
Control.SRR15539829;48;45;0.395833333333333;29;19;0.104166666666667;0.395833333333333
Control.SRR15539829;39;45;0.435897435897436;22;17;0.0641025641025641;0.435897435897436
Control.SRR15539829;44;45;0.590909090909091;18;26;0.0909090909090909;0.409090909090909
Control.SRR15539829;46;45;0.5;23;23;0;0.5
Control.SRR15539829;48;45;0.4375;27;21;0.0625;0.4375
Control.SRR15539829;50;45;0.42;29;21;0.08;0.42
Control.SRR15539829;49;45;0.387755102040816;30;19;0.112244897959184;0.387755102040816
Control.SRR15539829;46;45;0.41304347826087;27;19;0.0869565217391304;0.41304347826087
Control.SRR15539829;45;45;0.422222222222222;26;19;0.0777777777777778;0.422222222222222
Control.SRR15539829;43;45;0.395348837209302;26;17;0.104651162790698;0.395348837209302
Control.SRR15539829;44;45;0.522727272727273;21;23;0.0227272727272727;0.477272727272727
Control.SRR15539829;46;45;0.543478260869565;21;25;0.0434782608695652;0.456521739130435
Control.SRR15539829;44;45;0.431818181818182;25;19;0.0681818181818182;0.431818181818182
Control.SRR15539829;39;45;0.461538461538462;21;18;0.0384615384615384;0.461538461538462
Control.SRR15539829;40;45;0.475;21;19;0.025;0.475
Control.SRR15539829;44;45;0.5;22;22;0;0.5
Control.SRR15539829;42;45;0.523809523809524;20;22;0.0238095238095238;0.476190476190476
Control.SRR15539829;49;45;0.469387755102041;26;23;0.0306122448979592;0.469387755102041
Control.SRR15539829;48;45;0.5625;21;27;0.0625;0.4375
Control.SRR15539829;43;45;0.627906976744186;16;27;0.127906976744186;0.372093023255814
Control.SRR15539829;46;45;0.543478260869565;21;25;0.0434782608695652;0.456521739130435
Control.SRR15539829;41;45;0.634146341463415;15;26;0.134146341463415;0.365853658536585
Control.SRR15539829;43;45;0.465116279069767;23;20;0.0348837209302326;0.465116279069767
Control.SRR15539829;50;45;0.62;19;31;0.12;0.38
Control.SRR15539829;48;45;0.541666666666667;22;26;0.0416666666666666;0.458333333333333
Control.SRR15539829;43;45;0.418604651162791;25;18;0.0813953488372093;0.418604651162791
Control.SRR15539829;49;45;0.510204081632653;24;25;0.0102040816326531;0.489795918367347
Control.SRR15539829;45;45;0.533333333333333;21;24;0.0333333333333333;0.466666666666667
Control.SRR15539829;49;45;0.571428571428571;21;28;0.0714285714285714;0.428571428571429
Control.SRR15539829;49;45;0.387755102040816;30;19;0.112244897959184;0.387755102040816
Control.SRR15539829;40;45;0.6;16;24;0.1;0.4
Control.SRR15539829;48;45;0.5;24;24;0;0.5
Control.SRR15539829;49;45;0.510204081632653;24;25;0.0102040816326531;0.489795918367347
Control.SRR15539829;48;45;0.416666666666667;28;20;0.0833333333333333;0.416666666666667
Control.SRR15539829;50;45;0.48;26;24;0.02;0.48
Control.SRR15539829;50;45;0.66;17;33;0.16;0.34
Control.SRR15539829;43;45;0.488372093023256;22;21;0.0116279069767442;0.488372093023256
Control.SRR15539829;39;45;0.461538461538462;21;18;0.0384615384615384;0.461538461538462
Control.SRR15539829;42;45;0.619047619047619;16;26;0.119047619047619;0.380952380952381
Control.SRR15539829;49;45;0.530612244897959;23;26;0.0306122448979592;0.469387755102041
Control.SRR15539829;47;45;0.702127659574468;14;33;0.202127659574468;0.297872340425532
Control.SRR15539829;45;45;0.688888888888889;14;31;0.188888888888889;0.311111111111111
Control.SRR15539829;42;45;0.476190476190476;22;20;0.0238095238095238;0.476190476190476
Control.SRR15539829;49;45;0.489795918367347;25;24;0.0102040816326531;0.489795918367347
Control.SRR15539829;44;45;0.545454545454545;20;24;0.0454545454545454;0.454545454545455
Control.SRR15539829;41;45;0.414634146341463;24;17;0.0853658536585366;0.414634146341463
Control.SRR15539829;47;45;0.425531914893617;27;20;0.074468085106383;0.425531914893617
Control.SRR15539829;48;45;0.541666666666667;22;26;0.0416666666666666;0.458333333333333
Control.SRR15539829;42;45;0.5;21;21;0;0.5
Control.SRR15539829;50;45;0.5;25;25;0;0.5
Control.SRR15539829;50;45;0.54;23;27;0.04;0.46
Control.SRR15539829;47;45;0.595744680851064;19;28;0.0957446808510638;0.404255319148936
Control.SRR15539829;41;45;0.585365853658537;17;24;0.0853658536585366;0.414634146341463
Control.SRR15539829;39;45;0.41025641025641;23;16;0.0897435897435898;0.41025641025641
Control.SRR15539829;45;45;0.555555555555556;20;25;0.0555555555555556;0.444444444444444
Control.SRR15539829;44;45;0.522727272727273;21;23;0.0227272727272727;0.477272727272727
Control.SRR15539829;44;45;0.522727272727273;21;23;0.0227272727272727;0.477272727272727
Control.SRR15539829;48;45;0.458333333333333;26;22;0.0416666666666667;0.458333333333333
Control.SRR15539829;41;45;0.414634146341463;24;17;0.0853658536585366;0.414634146341463
Control.SRR15539829;43;45;0.418604651162791;25;18;0.0813953488372093;0.418604651162791
Control.SRR15539829;42;45;0.357142857142857;27;15;0.142857142857143;0.357142857142857
Control.SRR15539829;43;45;0.441860465116279;24;19;0.0581395348837209;0.441860465116279
Control.SRR15539829;46;45;0.543478260869565;21;25;0.0434782608695652;0.456521739130435
Control.SRR15539829;46;45;0.5;23;23;0;0.5
Control.SRR15539829;42;45;0.380952380952381;26;16;0.119047619047619;0.380952380952381
Control.SRR15539829;39;45;0.538461538461538;18;21;0.0384615384615384;0.461538461538462
Control.SRR15539829;49;45;0.36734693877551;31;18;0.13265306122449;0.36734693877551
Control.SRR15539829;42;45;0.642857142857143;15;27;0.142857142857143;0.357142857142857
Control.SRR15539829;39;45;0.358974358974359;25;14;0.141025641025641;0.358974358974359
Control.SRR15539829;39;45;0.666666666666667;13;26;0.166666666666667;0.333333333333333
Control.SRR15539829;42;45;0.5;21;21;0;0.5
Control.SRR15539829;41;45;0.585365853658537;17;24;0.0853658536585366;0.414634146341463
Control.SRR15539829;51;45;0.607843137254902;20;31;0.107843137254902;0.392156862745098
Control.SRR15539829;42;45;0.523809523809524;20;22;0.0238095238095238;0.476190476190476
Control.SRR15539829;49;45;0.510204081632653;24;25;0.0102040816326531;0.489795918367347
Control.SRR15539829;48;45;0.479166666666667;25;23;0.0208333333333333;0.479166666666667
Control.SRR15539829;43;45;0.488372093023256;22;21;0.0116279069767442;0.488372093023256
Control.SRR15539829;44;45;0.5;22;22;0;0.5
Control.SRR15539829;46;45;0.5;23;23;0;0.5
Control.SRR15539829;50;45;0.6;20;30;0.1;0.4
Control.SRR15539829;51;45;0.549019607843137;23;28;0.0490196078431373;0.450980392156863
Control.SRR15539829;41;45;0.463414634146341;22;19;0.0365853658536585;0.463414634146341
Control.SRR15539829;43;45;0.395348837209302;26;17;0.104651162790698;0.395348837209302
Control.SRR15539829;49;45;0.510204081632653;24;25;0.0102040816326531;0.489795918367347
Control.SRR15539829;42;45;0.571428571428571;18;24;0.0714285714285714;0.428571428571429
Control.SRR15539829;43;45;0.441860465116279;24;19;0.0581395348837209;0.441860465116279
Control.SRR15539829;39;45;0.461538461538462;21;18;0.0384615384615384;0.461538461538462
Control.SRR15539829;51;45;0.431372549019608;29;22;0.0686274509803921;0.431372549019608
Control.SRR15539829;50;45;0.5;25;25;0;0.5
Control.SRR15539829;45;45;0.444444444444444;25;20;0.0555555555555556;0.444444444444444
Control.SRR15539829;43;45;0.325581395348837;29;14;0.174418604651163;0.325581395348837
Control.SRR15539829;41;45;0.51219512195122;20;21;0.0121951219512195;0.48780487804878
Control.SRR15539829;46;45;0.5;23;23;0;0.5
Control.SRR15539829;49;45;0.571428571428571;21;28;0.0714285714285714;0.428571428571429
Control.SRR15539829;40;45;0.4;24;16;0.1;0.4
Control.SRR15539829;44;45;0.454545454545455;24;20;0.0454545454545455;0.454545454545455
Control.SRR15539829;47;45;0.659574468085106;16;31;0.159574468085106;0.340425531914894
Control.SRR15539829;44;45;0.613636363636364;17;27;0.113636363636364;0.386363636363636
Control.SRR15539829;41;45;0.585365853658537;17;24;0.0853658536585366;0.414634146341463
Control.SRR15539829;39;45;0.58974358974359;16;23;0.0897435897435898;0.41025641025641
Control.SRR15539829;42;45;0.5;21;21;0;0.5
Control.SRR15539829;49;45;0.63265306122449;18;31;0.13265306122449;0.36734693877551
Control.SRR15539829;51;45;0.568627450980392;22;29;0.0686274509803921;0.431372549019608
Control.SRR15539829;48;45;0.333333333333333;32;16;0.166666666666667;0.333333333333333
Control.SRR15539829;48;45;0.5;24;24;0;0.5
Control.SRR15539829;50;45;0.34;33;17;0.16;0.34
Control.SRR15539829;45;45;0.6;18;27;0.1;0.4
Control.SRR15539829;50;45;0.48;26;24;0.02;0.48
Control.SRR15539829;48;45;0.458333333333333;26;22;0.0416666666666667;0.458333333333333
Control.SRR15539829;48;45;0.5;24;24;0;0.5
Control.SRR15539829;44;45;0.522727272727273;21;23;0.0227272727272727;0.477272727272727
Control.SRR15539829;39;45;0.58974358974359;16;23;0.0897435897435898;0.41025641025641
Control.SRR15539829;47;45;0.617021276595745;18;29;0.117021276595745;0.382978723404255
Control.SRR15539829;51;45;0.470588235294118;27;24;0.0294117647058824;0.470588235294118
Control.SRR15539829;48;45;0.479166666666667;25;23;0.0208333333333333;0.479166666666667
Control.SRR15539829;49;45;0.387755102040816;30;19;0.112244897959184;0.387755102040816
Control.SRR15539829;47;45;0.531914893617021;22;25;0.0319148936170213;0.468085106382979
Control.SRR15539829;46;45;0.58695652173913;19;27;0.0869565217391305;0.41304347826087
Control.SRR15539829;51;45;0.529411764705882;24;27;0.0294117647058824;0.470588235294118
Control.SRR15539829;45;45;0.355555555555556;29;16;0.144444444444444;0.355555555555556
Control.SRR15539829;42;45;0.547619047619048;19;23;0.0476190476190477;0.452380952380952
Control.SRR15539829;51;45;0.392156862745098;31;20;0.107843137254902;0.392156862745098
Control.SRR15539829;49;45;0.448979591836735;27;22;0.0510204081632653;0.448979591836735
Control.SRR15539829;46;45;0.5;23;23;0;0.5
Control.SRR15539829;48;45;0.416666666666667;28;20;0.0833333333333333;0.416666666666667
Control.SRR15539829;43;45;0.488372093023256;22;21;0.0116279069767442;0.488372093023256
Control.SRR15539829;47;45;0.574468085106383;20;27;0.074468085106383;0.425531914893617
Control.SRR15539829;44;45;0.454545454545455;24;20;0.0454545454545455;0.454545454545455
Control.SRR15539829;43;45;0.604651162790698;17;26;0.104651162790698;0.395348837209302
Control.SRR15539829;44;45;0.477272727272727;23;21;0.0227272727272727;0.477272727272727
Control.SRR15539829;46;45;0.521739130434783;22;24;0.0217391304347826;0.478260869565217
Control.SRR15539829;42;45;0.547619047619048;19;23;0.0476190476190477;0.452380952380952
Control.SRR15539829;45;45;0.555555555555556;20;25;0.0555555555555556;0.444444444444444
Control.SRR15539829;47;45;0.446808510638298;26;21;0.0531914893617021;0.446808510638298
Control.SRR15539829;42;45;0.523809523809524;20;22;0.0238095238095238;0.476190476190476
Control.SRR15539829;47;45;0.531914893617021;22;25;0.0319148936170213;0.468085106382979
Control.SRR15539829;49;45;0.448979591836735;27;22;0.0510204081632653;0.448979591836735
Control.SRR15539829;47;45;0.48936170212766;24;23;0.0106382978723404;0.48936170212766
Control.SRR15539829;46;45;0.434782608695652;26;20;0.0652173913043478;0.434782608695652
Control.SRR15539829;47;45;0.51063829787234;23;24;0.0106382978723404;0.48936170212766
Control.SRR15539829;48;45;0.583333333333333;20;28;0.0833333333333334;0.416666666666667
Control.SRR15539829;40;45;0.375;25;15;0.125;0.375
Control.SRR15539829;50;45;0.52;24;26;0.02;0.48
Control.SRR15539829;47;45;0.425531914893617;27;20;0.074468085106383;0.425531914893617
Control.SRR15539829;45;45;0.466666666666667;24;21;0.0333333333333333;0.466666666666667
Control.SRR15539829;41;45;0.48780487804878;21;20;0.0121951219512195;0.48780487804878
Control.SRR15539829;44;45;0.568181818181818;19;25;0.0681818181818182;0.431818181818182
Control.SRR15539829;42;45;0.404761904761905;25;17;0.0952380952380952;0.404761904761905
Control.SRR15539829;51;45;0.568627450980392;22;29;0.0686274509803921;0.431372549019608
Control.SRR15539829;46;45;0.456521739130435;25;21;0.0434782608695652;0.456521739130435
Control.SRR15539829;47;45;0.553191489361702;21;26;0.0531914893617021;0.446808510638298
Control.SRR15539829;49;45;0.571428571428571;21;28;0.0714285714285714;0.428571428571429
Control.SRR15539829;44;45;0.477272727272727;23;21;0.0227272727272727;0.477272727272727
Control.SRR15539829;43;45;0.465116279069767;23;20;0.0348837209302326;0.465116279069767
Control.SRR15539829;46;45;0.434782608695652;26;20;0.0652173913043478;0.434782608695652
Control.SRR15539829;39;45;0.307692307692308;27;12;0.192307692307692;0.307692307692308
Control.SRR15539829;45;45;0.444444444444444;25;20;0.0555555555555556;0.444444444444444
Control.SRR15539829;49;45;0.571428571428571;21;28;0.0714285714285714;0.428571428571429
Control.SRR15539829;49;45;0.591836734693878;20;29;0.0918367346938775;0.408163265306122
Control.SRR15539829;51;45;0.411764705882353;30;21;0.0882352941176471;0.411764705882353
Control.SRR15539829;46;45;0.478260869565217;24;22;0.0217391304347826;0.478260869565217
Control.SRR15539829;50;45;0.58;21;29;0.08;0.42
Control.SRR15539829;40;45;0.45;22;18;0.05;0.45
Control.SRR15539829;45;45;0.555555555555556;20;25;0.0555555555555556;0.444444444444444
Control.SRR15539829;51;45;0.607843137254902;20;31;0.107843137254902;0.392156862745098
Control.SRR15539829;46;45;0.565217391304348;20;26;0.0652173913043478;0.434782608695652
Control.SRR15539829;43;45;0.488372093023256;22;21;0.0116279069767442;0.488372093023256
Control.SRR15539829;47;45;0.531914893617021;22;25;0.0319148936170213;0.468085106382979
Control.SRR15539829;48;45;0.5625;21;27;0.0625;0.4375
Control.SRR15539829;41;45;0.560975609756098;18;23;0.0609756097560976;0.439024390243902
Control.SRR15539829;40;45;0.425;23;17;0.075;0.425
Control.SRR15539829;51;45;0.509803921568627;25;26;0.00980392156862742;0.490196078431373
Control.SRR15539829;41;45;0.560975609756098;18;23;0.0609756097560976;0.439024390243902
Control.SRR15539829;48;45;0.479166666666667;25;23;0.0208333333333333;0.479166666666667
Control.SRR15539829;43;45;0.558139534883721;19;24;0.0581395348837209;0.441860465116279
Control.SRR15539829;41;45;0.414634146341463;24;17;0.0853658536585366;0.414634146341463
Control.SRR15539829;40;45;0.425;23;17;0.075;0.425
Control.SRR15539829;39;45;0.487179487179487;20;19;0.0128205128205128;0.487179487179487
Control.SRR15539829;40;45;0.325;27;13;0.175;0.325
Control.SRR15539829;48;45;0.5625;21;27;0.0625;0.4375
Control.SRR15539829;49;45;0.551020408163265;22;27;0.0510204081632653;0.448979591836735
Control.SRR15539829;42;45;0.547619047619048;19;23;0.0476190476190477;0.452380952380952
Control.SRR15539829;47;45;0.340425531914894;31;16;0.159574468085106;0.340425531914894
Control.SRR15539829;40;45;0.45;22;18;0.05;0.45
Control.SRR15539829;51;45;0.607843137254902;20;31;0.107843137254902;0.392156862745098
Control.SRR15539829;40;45;0.45;22;18;0.05;0.45
Control.SRR15539829;50;45;0.42;29;21;0.08;0.42
Control.SRR15539829;42;45;0.571428571428571;18;24;0.0714285714285714;0.428571428571429
Control.SRR15539829;46;45;0.58695652173913;19;27;0.0869565217391305;0.41304347826087
Control.SRR15539829;45;45;0.577777777777778;19;26;0.0777777777777777;0.422222222222222
Control.SRR15539829;47;45;0.48936170212766;24;23;0.0106382978723404;0.48936170212766
Control.SRR15539829;51;45;0.450980392156863;28;23;0.0490196078431372;0.450980392156863
Control.SRR15539829;42;45;0.547619047619048;19;23;0.0476190476190477;0.452380952380952
Control.SRR15539829;44;45;0.454545454545455;24;20;0.0454545454545455;0.454545454545455
Control.SRR15539829;42;45;0.571428571428571;18;24;0.0714285714285714;0.428571428571429
Control.SRR15539829;43;45;0.558139534883721;19;24;0.0581395348837209;0.441860465116279
Control.SRR15539829;48;45;0.4375;27;21;0.0625;0.4375
Control.SRR15539829;40;45;0.325;27;13;0.175;0.325
Control.SRR15539829;47;45;0.574468085106383;20;27;0.074468085106383;0.425531914893617
Control.SRR15539829;40;45;0.5;20;20;0;0.5
Control.SRR15539829;49;45;0.448979591836735;27;22;0.0510204081632653;0.448979591836735
Control.SRR15539829;48;45;0.5;24;24;0;0.5
Control.SRR15539829;42;45;0.476190476190476;22;20;0.0238095238095238;0.476190476190476
Control.SRR15539829;39;45;0.461538461538462;21;18;0.0384615384615384;0.461538461538462
Control.SRR15539829;51;45;0.607843137254902;20;31;0.107843137254902;0.392156862745098
Control.SRR15539829;51;45;0.490196078431373;26;25;0.00980392156862747;0.490196078431373
Control.SRR15539829;42;45;0.547619047619048;19;23;0.0476190476190477;0.452380952380952
Control.SRR15539829;50;45;0.58;21;29;0.08;0.42
Control.SRR15539829;41;45;0.390243902439024;25;16;0.109756097560976;0.390243902439024
Control.SRR15539829;49;45;0.530612244897959;23;26;0.0306122448979592;0.469387755102041
Control.SRR15539829;45;45;0.577777777777778;19;26;0.0777777777777777;0.422222222222222
Control.SRR15539829;49;45;0.408163265306122;29;20;0.0918367346938775;0.408163265306122
Control.SRR15539829;39;45;0.564102564102564;17;22;0.0641025641025641;0.435897435897436
Control.SRR15539829;42;45;0.523809523809524;20;22;0.0238095238095238;0.476190476190476
Control.SRR15539829;50;45;0.48;26;24;0.02;0.48
Control.SRR15539829;44;45;0.5;22;22;0;0.5
Control.SRR15539829;51;45;0.529411764705882;24;27;0.0294117647058824;0.470588235294118
Control.SRR15539829;50;45;0.3;35;15;0.2;0.3
Control.SRR15539829;44;45;0.613636363636364;17;27;0.113636363636364;0.386363636363636
Control.SRR15539829;45;45;0.533333333333333;21;24;0.0333333333333333;0.466666666666667
Control.SRR15539829;46;45;0.521739130434783;22;24;0.0217391304347826;0.478260869565217
Control.SRR15539829;44;45;0.477272727272727;23;21;0.0227272727272727;0.477272727272727
Control.SRR15539829;43;45;0.697674418604651;13;30;0.197674418604651;0.302325581395349
Control.SRR15539829;41;45;0.536585365853659;19;22;0.0365853658536586;0.463414634146341
Control.SRR15539829;41;45;0.390243902439024;25;16;0.109756097560976;0.390243902439024
Control.SRR15539829;42;45;0.357142857142857;27;15;0.142857142857143;0.357142857142857
Control.SRR15539829;50;45;0.58;21;29;0.08;0.42
Control.SRR15539829;39;45;0.58974358974359;16;23;0.0897435897435898;0.41025641025641
Control.SRR15539829;49;45;0.448979591836735;27;22;0.0510204081632653;0.448979591836735
Control.SRR15539829;40;45;0.65;14;26;0.15;0.35
Control.SRR15539829;49;45;0.510204081632653;24;25;0.0102040816326531;0.489795918367347
Control.SRR15539829;46;45;0.456521739130435;25;21;0.0434782608695652;0.456521739130435
Control.SRR15539829;51;45;0.411764705882353;30;21;0.0882352941176471;0.411764705882353
Control.SRR15539829;46;45;0.456521739130435;25;21;0.0434782608695652;0.456521739130435
Control.SRR15539829;42;45;0.428571428571429;24;18;0.0714285714285715;0.428571428571429
Control.SRR15539829;42;45;0.428571428571429;24;18;0.0714285714285715;0.428571428571429
Control.SRR15539829;43;45;0.418604651162791;25;18;0.0813953488372093;0.418604651162791
Control.SRR15539829;46;45;0.5;23;23;0;0.5
Control.SRR15539829;39;45;0.666666666666667;13;26;0.166666666666667;0.333333333333333
Control.SRR15539829;39;45;0.461538461538462;21;18;0.0384615384615384;0.461538461538462
Control.SRR15539829;41;45;0.560975609756098;18;23;0.0609756097560976;0.439024390243902
Control.SRR15539829;39;45;0.538461538461538;18;21;0.0384615384615384;0.461538461538462
Control.SRR15539829;47;45;0.48936170212766;24;23;0.0106382978723404;0.48936170212766
Control.SRR15539829;45;45;0.622222222222222;17;28;0.122222222222222;0.377777777777778
Control.SRR15539829;46;45;0.5;23;23;0;0.5
Control.SRR15539829;39;45;0.307692307692308;27;12;0.192307692307692;0.307692307692308
Control.SRR15539829;47;45;0.680851063829787;15;32;0.180851063829787;0.319148936170213
Control.SRR15539829;50;45;0.42;29;21;0.08;0.42
Control.SRR15539829;41;45;0.48780487804878;21;20;0.0121951219512195;0.48780487804878
Control.SRR15539829;42;45;0.547619047619048;19;23;0.0476190476190477;0.452380952380952
Control.SRR15539829;43;45;0.441860465116279;24;19;0.0581395348837209;0.441860465116279
Control.SRR15539829;50;45;0.44;28;22;0.06;0.44
Control.SRR15539829;43;45;0.534883720930233;20;23;0.0348837209302325;0.465116279069767
Control.SRR15539829;50;45;0.48;26;24;0.02;0.48
Control.SRR15539829;49;45;0.469387755102041;26;23;0.0306122448979592;0.469387755102041
Control.SRR15539829;45;45;0.6;18;27;0.1;0.4
Control.SRR15539829;46;45;0.391304347826087;28;18;0.108695652173913;0.391304347826087
Control.SRR15539829;42;45;0.428571428571429;24;18;0.0714285714285715;0.428571428571429
Control.SRR15539829;50;45;0.6;20;30;0.1;0.4
Control.SRR15539829;46;45;0.608695652173913;18;28;0.108695652173913;0.391304347826087
Control.SRR15539829;39;45;0.538461538461538;18;21;0.0384615384615384;0.461538461538462
Control.SRR15539829;42;45;0.5;21;21;0;0.5
Control.SRR15539829;43;45;0.465116279069767;23;20;0.0348837209302326;0.465116279069767
Control.SRR15539829;48;45;0.520833333333333;23;25;0.0208333333333334;0.479166666666667
Control.SRR15539829;46;45;0.5;23;23;0;0.5
Control.SRR15539829;41;45;0.51219512195122;20;21;0.0121951219512195;0.48780487804878
Control.SRR15539829;49;45;0.530612244897959;23;26;0.0306122448979592;0.469387755102041
Control.SRR15539829;48;45;0.583333333333333;20;28;0.0833333333333334;0.416666666666667
Control.SRR15539829;50;45;0.44;28;22;0.06;0.44
Control.SRR15539829;40;45;0.525;19;21;0.025;0.475
Control.SRR15539829;39;45;0.564102564102564;17;22;0.0641025641025641;0.435897435897436
Control.SRR15539829;45;45;0.466666666666667;24;21;0.0333333333333333;0.466666666666667
Control.SRR15539829;51;45;0.470588235294118;27;24;0.0294117647058824;0.470588235294118
Control.SRR15539829;47;45;0.48936170212766;24;23;0.0106382978723404;0.48936170212766
Control.SRR15539829;50;45;0.42;29;21;0.08;0.42
Control.SRR15539829;40;45;0.6;16;24;0.1;0.4
Control.SRR15539829;39;45;0.461538461538462;21;18;0.0384615384615384;0.461538461538462
Control.SRR15539829;47;45;0.361702127659574;30;17;0.138297872340426;0.361702127659574
Control.SRR15539829;39;45;0.512820512820513;19;20;0.0128205128205128;0.487179487179487
Control.SRR15539829;49;45;0.612244897959184;19;30;0.112244897959184;0.387755102040816
Control.SRR15539829;39;45;0.564102564102564;17;22;0.0641025641025641;0.435897435897436
Control.SRR15539829;45;45;0.533333333333333;21;24;0.0333333333333333;0.466666666666667
Control.SRR15539829;50;45;0.36;32;18;0.14;0.36
Control.SRR15539829;41;45;0.585365853658537;17;24;0.0853658536585366;0.414634146341463
Control.SRR15539829;46;45;0.478260869565217;24;22;0.0217391304347826;0.478260869565217
Control.SRR15539829;49;45;0.571428571428571;21;28;0.0714285714285714;0.428571428571429
Control.SRR15539829;43;45;0.465116279069767;23;20;0.0348837209302326;0.465116279069767
Control.SRR15539829;49;45;0.591836734693878;20;29;0.0918367346938775;0.408163265306122
Control.SRR15539829;43;45;0.441860465116279;24;19;0.0581395348837209;0.441860465116279
Control.SRR15539829;51;45;0.411764705882353;30;21;0.0882352941176471;0.411764705882353
Control.SRR15539829;45;45;0.488888888888889;23;22;0.0111111111111111;0.488888888888889
Control.SRR15539829;49;45;0.448979591836735;27;22;0.0510204081632653;0.448979591836735
Control.SRR15539829;47;45;0.48936170212766;24;23;0.0106382978723404;0.48936170212766
Control.SRR15539829;48;45;0.416666666666667;28;20;0.0833333333333333;0.416666666666667
Control.SRR15539829;48;45;0.375;30;18;0.125;0.375
Control.SRR15539829;48;45;0.458333333333333;26;22;0.0416666666666667;0.458333333333333
Control.SRR15539829;44;45;0.5;22;22;0;0.5
Control.SRR15539829;42;45;0.476190476190476;22;20;0.0238095238095238;0.476190476190476
Control.SRR15539829;48;45;0.416666666666667;28;20;0.0833333333333333;0.416666666666667
Control.SRR15539829;49;45;0.489795918367347;25;24;0.0102040816326531;0.489795918367347
Control.SRR15539829;45;45;0.533333333333333;21;24;0.0333333333333333;0.466666666666667
Control.SRR15539829;40;45;0.625;15;25;0.125;0.375
Control.SRR15539829;50;45;0.6;20;30;0.1;0.4
Control.SRR15539829;41;45;0.439024390243902;23;18;0.0609756097560976;0.439024390243902
Control.SRR15539829;51;45;0.529411764705882;24;27;0.0294117647058824;0.470588235294118
Control.SRR15539829;49;45;0.469387755102041;26;23;0.0306122448979592;0.469387755102041
Control.SRR15539829;51;45;0.529411764705882;24;27;0.0294117647058824;0.470588235294118
Control.SRR15539829;49;45;0.428571428571429;28;21;0.0714285714285715;0.428571428571429
Control.SRR15539829;41;45;0.585365853658537;17;24;0.0853658536585366;0.414634146341463
Control.SRR15539829;40;45;0.525;19;21;0.025;0.475
Control.SRR15539829;44;45;0.568181818181818;19;25;0.0681818181818182;0.431818181818182
Control.SRR15539829;40;45;0.575;17;23;0.075;0.425
Control.SRR15539829;39;45;0.435897435897436;22;17;0.0641025641025641;0.435897435897436
Control.SRR15539829;40;45;0.525;19;21;0.025;0.475
Control.SRR15539829;48;45;0.4375;27;21;0.0625;0.4375
Control.SRR15539829;44;45;0.568181818181818;19;25;0.0681818181818182;0.431818181818182
Control.SRR15539829;42;45;0.404761904761905;25;17;0.0952380952380952;0.404761904761905
Control.SRR15539829;45;45;0.577777777777778;19;26;0.0777777777777777;0.422222222222222
Control.SRR15539829;43;45;0.488372093023256;22;21;0.0116279069767442;0.488372093023256
Control.SRR15539829;49;45;0.428571428571429;28;21;0.0714285714285715;0.428571428571429
Control.SRR15539829;45;45;0.6;18;27;0.1;0.4
Control.SRR15539829;48;45;0.520833333333333;23;25;0.0208333333333334;0.479166666666667
Control.SRR15539829;45;45;0.444444444444444;25;20;0.0555555555555556;0.444444444444444
Control.SRR15539829;40;45;0.525;19;21;0.025;0.475
Control.SRR15539829;40;45;0.475;21;19;0.025;0.475
Control.SRR15539829;47;45;0.531914893617021;22;25;0.0319148936170213;0.468085106382979
Control.SRR15539829;43;45;0.581395348837209;18;25;0.0813953488372093;0.418604651162791
Control.SRR15539829;40;45;0.4;24;16;0.1;0.4
Control.SRR15539829;51;45;0.470588235294118;27;24;0.0294117647058824;0.470588235294118
Control.SRR15539829;47;45;0.702127659574468;14;33;0.202127659574468;0.297872340425532
Control.SRR15539829;44;45;0.386363636363636;27;17;0.113636363636364;0.386363636363636
Control.SRR15539829;42;45;0.476190476190476;22;20;0.0238095238095238;0.476190476190476
Control.SRR15539829;46;45;0.434782608695652;26;20;0.0652173913043478;0.434782608695652
Control.SRR15539829;50;45;0.48;26;24;0.02;0.48
Control.SRR15539829;41;45;0.414634146341463;24;17;0.0853658536585366;0.414634146341463
Control.SRR15539829;41;45;0.560975609756098;18;23;0.0609756097560976;0.439024390243902
Control.SRR15539829;46;45;0.369565217391304;29;17;0.130434782608696;0.369565217391304
Control.SRR15539829;45;45;0.422222222222222;26;19;0.0777777777777778;0.422222222222222
Control.SRR15539829;42;45;0.547619047619048;19;23;0.0476190476190477;0.452380952380952
Control.SRR15539829;47;45;0.446808510638298;26;21;0.0531914893617021;0.446808510638298
Control.SRR15539829;39;45;0.461538461538462;21;18;0.0384615384615384;0.461538461538462
Control.SRR15539829;40;45;0.65;14;26;0.15;0.35
Control.SRR15539829;42;45;0.619047619047619;16;26;0.119047619047619;0.380952380952381
Control.SRR15539829;44;45;0.545454545454545;20;24;0.0454545454545454;0.454545454545455
Control.SRR15539829;43;45;0.488372093023256;22;21;0.0116279069767442;0.488372093023256
Control.SRR15539829;41;45;0.414634146341463;24;17;0.0853658536585366;0.414634146341463
Control.SRR15539829;46;45;0.565217391304348;20;26;0.0652173913043478;0.434782608695652
Control.SRR15539829;41;45;0.414634146341463;24;17;0.0853658536585366;0.414634146341463
Control.SRR15539829;45;45;0.533333333333333;21;24;0.0333333333333333;0.466666666666667
Control.SRR15539829;48;45;0.583333333333333;20;28;0.0833333333333334;0.416666666666667
Control.SRR15539829;48;45;0.541666666666667;22;26;0.0416666666666666;0.458333333333333
Control.SRR15539829;48;45;0.395833333333333;29;19;0.104166666666667;0.395833333333333
Control.SRR15539829;47;45;0.553191489361702;21;26;0.0531914893617021;0.446808510638298
Control.SRR15539829;50;45;0.64;18;32;0.14;0.36
Control.SRR15539829;46;45;0.391304347826087;28;18;0.108695652173913;0.391304347826087
Control.SRR15539829;50;45;0.48;26;24;0.02;0.48
Control.SRR15539829;44;45;0.522727272727273;21;23;0.0227272727272727;0.477272727272727
Control.SRR15539829;45;45;0.422222222222222;26;19;0.0777777777777778;0.422222222222222
Control.SRR15539829;48;45;0.479166666666667;25;23;0.0208333333333333;0.479166666666667
Control.SRR15539829;43;45;0.488372093023256;22;21;0.0116279069767442;0.488372093023256
Control.SRR15539829;50;45;0.54;23;27;0.04;0.46
Control.SRR15539829;44;45;0.454545454545455;24;20;0.0454545454545455;0.454545454545455
Control.SRR15539829;51;45;0.490196078431373;26;25;0.00980392156862747;0.490196078431373
Control.SRR15539829;49;45;0.469387755102041;26;23;0.0306122448979592;0.469387755102041
Control.SRR15539829;40;45;0.6;16;24;0.1;0.4
Control.SRR15539829;49;45;0.530612244897959;23;26;0.0306122448979592;0.469387755102041
Control.SRR15539829;50;45;0.56;22;28;0.0600000000000001;0.44
Control.SRR15539829;51;45;0.411764705882353;30;21;0.0882352941176471;0.411764705882353
Control.SRR15539829;47;45;0.446808510638298;26;21;0.0531914893617021;0.446808510638298
Control.SRR15539829;46;45;0.58695652173913;19;27;0.0869565217391305;0.41304347826087
Control.SRR15539829;50;45;0.44;28;22;0.06;0.44
Control.SRR15539829;48;45;0.5;24;24;0;0.5
Control.SRR15539829;39;45;0.41025641025641;23;16;0.0897435897435898;0.41025641025641
Control.SRR15539829;39;45;0.564102564102564;17;22;0.0641025641025641;0.435897435897436
Control.SRR15539829;43;45;0.534883720930233;20;23;0.0348837209302325;0.465116279069767
Control.SRR15539829;40;45;0.425;23;17;0.075;0.425
Control.SRR15539829;42;45;0.452380952380952;23;19;0.0476190476190476;0.452380952380952
Control.SRR15539829;42;45;0.452380952380952;23;19;0.0476190476190476;0.452380952380952
Control.SRR15539829;42;45;0.595238095238095;17;25;0.0952380952380952;0.404761904761905
Control.SRR15539829;47;45;0.404255319148936;28;19;0.0957446808510639;0.404255319148936
Control.SRR15539829;44;45;0.5;22;22;0;0.5
Control.SRR15539829;49;45;0.612244897959184;19;30;0.112244897959184;0.387755102040816
Control.SRR15539829;39;45;0.58974358974359;16;23;0.0897435897435898;0.41025641025641
Control.SRR15539829;49;45;0.489795918367347;25;24;0.0102040816326531;0.489795918367347
Control.SRR15539829;48;45;0.666666666666667;16;32;0.166666666666667;0.333333333333333
Control.SRR15539829;49;45;0.591836734693878;20;29;0.0918367346938775;0.408163265306122
Control.SRR15539829;48;45;0.5625;21;27;0.0625;0.4375
Control.SRR15539829;49;45;0.530612244897959;23;26;0.0306122448979592;0.469387755102041
Control.SRR15539829;49;45;0.510204081632653;24;25;0.0102040816326531;0.489795918367347
Control.SRR15539829;47;45;0.446808510638298;26;21;0.0531914893617021;0.446808510638298
Control.SRR15539829;47;45;0.574468085106383;20;27;0.074468085106383;0.425531914893617
Control.SRR15539829;44;45;0.568181818181818;19;25;0.0681818181818182;0.431818181818182
Control.SRR15539829;44;45;0.5;22;22;0;0.5
Control.SRR15539829;44;45;0.568181818181818;19;25;0.0681818181818182;0.431818181818182
Control.SRR15539829;48;45;0.5;24;24;0;0.5
Control.SRR15539829;49;45;0.428571428571429;28;21;0.0714285714285715;0.428571428571429
Control.SRR15539829;47;45;0.595744680851064;19;28;0.0957446808510638;0.404255319148936
Control.SRR15539829;47;45;0.468085106382979;25;22;0.0319148936170213;0.468085106382979
Control.SRR15539829;42;45;0.5;21;21;0;0.5
Control.SRR15539829;44;45;0.522727272727273;21;23;0.0227272727272727;0.477272727272727
Control.SRR15539829;42;45;0.404761904761905;25;17;0.0952380952380952;0.404761904761905
Control.SRR15539829;45;45;0.488888888888889;23;22;0.0111111111111111;0.488888888888889
Control.SRR15539829;41;45;0.536585365853659;19;22;0.0365853658536586;0.463414634146341
Control.SRR15539829;51;45;0.529411764705882;24;27;0.0294117647058824;0.470588235294118
Control.SRR15539829;40;45;0.575;17;23;0.075;0.425
Control.SRR15539829;40;45;0.35;26;14;0.15;0.35
Control.SRR15539829;50;45;0.54;23;27;0.04;0.46
Control.SRR15539829;41;45;0.609756097560976;16;25;0.109756097560976;0.390243902439024
Control.SRR15539829;46;45;0.478260869565217;24;22;0.0217391304347826;0.478260869565217
Control.SRR15539829;40;45;0.55;18;22;0.05;0.45
Control.SRR15539829;39;45;0.58974358974359;16;23;0.0897435897435898;0.41025641025641
Control.SRR15539829;51;45;0.313725490196078;35;16;0.186274509803922;0.313725490196078
Control.SRR15539829;49;45;0.408163265306122;29;20;0.0918367346938775;0.408163265306122
Control.SRR15539829;47;45;0.48936170212766;24;23;0.0106382978723404;0.48936170212766
Control.SRR15539829;48;45;0.5625;21;27;0.0625;0.4375
Control.SRR15539829;51;45;0.509803921568627;25;26;0.00980392156862742;0.490196078431373
Control.SRR15539829;47;45;0.595744680851064;19;28;0.0957446808510638;0.404255319148936
Control.SRR15539829;45;45;0.355555555555556;29;16;0.144444444444444;0.355555555555556
Control.SRR15539829;43;45;0.604651162790698;17;26;0.104651162790698;0.395348837209302
Control.SRR15539829;39;45;0.435897435897436;22;17;0.0641025641025641;0.435897435897436
Control.SRR15539829;45;45;0.488888888888889;23;22;0.0111111111111111;0.488888888888889
Control.SRR15539829;46;45;0.456521739130435;25;21;0.0434782608695652;0.456521739130435
Control.SRR15539829;45;45;0.488888888888889;23;22;0.0111111111111111;0.488888888888889
Control.SRR15539829;45;45;0.533333333333333;21;24;0.0333333333333333;0.466666666666667
Control.SRR15539829;47;45;0.425531914893617;27;20;0.074468085106383;0.425531914893617
Control.SRR15539829;39;45;0.358974358974359;25;14;0.141025641025641;0.358974358974359
Control.SRR15539829;39;45;0.615384615384615;15;24;0.115384615384615;0.384615384615385
Control.SRR15539829;44;45;0.477272727272727;23;21;0.0227272727272727;0.477272727272727
Control.SRR15539829;40;45;0.575;17;23;0.075;0.425
Control.SRR15539829;41;45;0.560975609756098;18;23;0.0609756097560976;0.439024390243902
Control.SRR15539829;47;45;0.425531914893617;27;20;0.074468085106383;0.425531914893617
Control.SRR15539829;51;45;0.450980392156863;28;23;0.0490196078431372;0.450980392156863
Control.SRR15539829;49;45;0.530612244897959;23;26;0.0306122448979592;0.469387755102041
Control.SRR15539829;50;45;0.54;23;27;0.04;0.46
Control.SRR15539829;49;45;0.530612244897959;23;26;0.0306122448979592;0.469387755102041
Control.SRR15539829;49;45;0.469387755102041;26;23;0.0306122448979592;0.469387755102041
Control.SRR15539829;51;45;0.588235294117647;21;30;0.0882352941176471;0.411764705882353
Control.SRR15539829;49;45;0.612244897959184;19;30;0.112244897959184;0.387755102040816
Control.SRR15539829;49;45;0.387755102040816;30;19;0.112244897959184;0.387755102040816
Control.SRR15539829;40;45;0.4;24;16;0.1;0.4
Control.SRR15539829;41;45;0.48780487804878;21;20;0.0121951219512195;0.48780487804878
Control.SRR15539829;45;45;0.511111111111111;22;23;0.0111111111111111;0.488888888888889
Control.SRR15539829;43;45;0.395348837209302;26;17;0.104651162790698;0.395348837209302
Control.SRR15539829;50;45;0.58;21;29;0.08;0.42
Control.SRR15539829;51;45;0.647058823529412;18;33;0.147058823529412;0.352941176470588
Control.SRR15539829;51;45;0.392156862745098;31;20;0.107843137254902;0.392156862745098
Control.SRR15539829;42;45;0.571428571428571;18;24;0.0714285714285714;0.428571428571429
Control.SRR15539829;39;45;0.615384615384615;15;24;0.115384615384615;0.384615384615385
Control.SRR15539829;49;45;0.448979591836735;27;22;0.0510204081632653;0.448979591836735
Control.SRR15539829;40;45;0.425;23;17;0.075;0.425
Control.SRR15539829;47;45;0.51063829787234;23;24;0.0106382978723404;0.48936170212766
Control.SRR15539829;49;45;0.489795918367347;25;24;0.0102040816326531;0.489795918367347
Control.SRR15539829;40;45;0.625;15;25;0.125;0.375
Control.SRR15539829;51;45;0.470588235294118;27;24;0.0294117647058824;0.470588235294118
Control.SRR15539829;39;45;0.41025641025641;23;16;0.0897435897435898;0.41025641025641
Control.SRR15539829;43;45;0.558139534883721;19;24;0.0581395348837209;0.441860465116279
Control.SRR15539829;51;45;0.450980392156863;28;23;0.0490196078431372;0.450980392156863
Control.SRR15539829;48;45;0.541666666666667;22;26;0.0416666666666666;0.458333333333333
Control.SRR15539829;45;45;0.533333333333333;21;24;0.0333333333333333;0.466666666666667
Control.SRR15539829;39;45;0.41025641025641;23;16;0.0897435897435898;0.41025641025641
Control.SRR15539829;42;45;0.571428571428571;18;24;0.0714285714285714;0.428571428571429
Control.SRR15539829;50;45;0.54;23;27;0.04;0.46
Control.SRR15539829;48;45;0.5;24;24;0;0.5
Control.SRR15539829;44;45;0.272727272727273;32;12;0.227272727272727;0.272727272727273
Control.SRR15539829;43;45;0.581395348837209;18;25;0.0813953488372093;0.418604651162791
Control.SRR15539829;48;45;0.625;18;30;0.125;0.375
Control.SRR15539829;48;45;0.729166666666667;13;35;0.229166666666667;0.270833333333333
Control.SRR15539829;50;45;0.48;26;24;0.02;0.48
Control.SRR15539829;46;45;0.543478260869565;21;25;0.0434782608695652;0.456521739130435
Control.SRR15539829;43;45;0.627906976744186;16;27;0.127906976744186;0.372093023255814
Control.SRR15539829;40;45;0.525;19;21;0.025;0.475
Control.SRR15539829;50;45;0.5;25;25;0;0.5
Control.SRR15539829;47;45;0.468085106382979;25;22;0.0319148936170213;0.468085106382979
Control.SRR15539829;50;45;0.46;27;23;0.04;0.46
Control.SRR15539829;41;45;0.536585365853659;19;22;0.0365853658536586;0.463414634146341
Control.SRR15539829;39;45;0.384615384615385;24;15;0.115384615384615;0.384615384615385
Control.SRR15539829;40;45;0.475;21;19;0.025;0.475
Control.SRR15539829;49;45;0.530612244897959;23;26;0.0306122448979592;0.469387755102041
Control.SRR15539829;42;45;0.5;21;21;0;0.5
Control.SRR15539829;51;45;0.568627450980392;22;29;0.0686274509803921;0.431372549019608
Control.SRR15539829;50;45;0.44;28;22;0.06;0.44
Control.SRR15539829;49;45;0.469387755102041;26;23;0.0306122448979592;0.469387755102041
Control.SRR15539829;51;45;0.627450980392157;19;32;0.127450980392157;0.372549019607843
Control.SRR15539829;48;45;0.5625;21;27;0.0625;0.4375
Control.SRR15539829;47;45;0.531914893617021;22;25;0.0319148936170213;0.468085106382979
Control.SRR15539829;41;45;0.48780487804878;21;20;0.0121951219512195;0.48780487804878
Control.SRR15539829;46;45;0.41304347826087;27;19;0.0869565217391304;0.41304347826087
Control.SRR15539829;40;45;0.55;18;22;0.05;0.45
Control.SRR15539829;43;45;0.558139534883721;19;24;0.0581395348837209;0.441860465116279
Control.SRR15539829;40;45;0.5;20;20;0;0.5
Control.SRR15539829;51;45;0.509803921568627;25;26;0.00980392156862742;0.490196078431373
Control.SRR15539829;50;45;0.42;29;21;0.08;0.42
Control.SRR15539829;44;45;0.545454545454545;20;24;0.0454545454545454;0.454545454545455
Control.SRR15539829;50;45;0.6;20;30;0.1;0.4
Control.SRR15539829;45;45;0.533333333333333;21;24;0.0333333333333333;0.466666666666667
Control.SRR15539829;43;45;0.511627906976744;21;22;0.0116279069767442;0.488372093023256
Control.SRR15539829;51;45;0.647058823529412;18;33;0.147058823529412;0.352941176470588
Control.SRR15539829;44;45;0.409090909090909;26;18;0.0909090909090909;0.409090909090909
Control.SRR15539829;48;45;0.604166666666667;19;29;0.104166666666667;0.395833333333333
Control.SRR15539829;43;45;0.465116279069767;23;20;0.0348837209302326;0.465116279069767
Control.SRR15539829;41;45;0.414634146341463;24;17;0.0853658536585366;0.414634146341463
Control.SRR15539829;46;45;0.326086956521739;31;15;0.173913043478261;0.326086956521739
Control.SRR15539829;44;45;0.363636363636364;28;16;0.136363636363636;0.363636363636364
Control.SRR15539829;50;45;0.5;25;25;0;0.5
Control.SRR15539829;49;45;0.510204081632653;24;25;0.0102040816326531;0.489795918367347
Control.SRR15539829;46;45;0.434782608695652;26;20;0.0652173913043478;0.434782608695652
Control.SRR15539829;45;45;0.6;18;27;0.1;0.4
Control.SRR15539829;45;45;0.644444444444444;16;29;0.144444444444444;0.355555555555556
Control.SRR15539829;42;45;0.5;21;21;0;0.5
Control.SRR15539829;45;45;0.511111111111111;22;23;0.0111111111111111;0.488888888888889
Control.SRR15539829;40;45;0.425;23;17;0.075;0.425
Control.SRR15539829;43;45;0.581395348837209;18;25;0.0813953488372093;0.418604651162791
Control.SRR15539829;45;45;0.444444444444444;25;20;0.0555555555555556;0.444444444444444
Control.SRR15539829;40;45;0.625;15;25;0.125;0.375
Control.SRR15539829;45;45;0.377777777777778;28;17;0.122222222222222;0.377777777777778
Control.SRR15539829;50;45;0.44;28;22;0.06;0.44
Control.SRR15539829;44;45;0.568181818181818;19;25;0.0681818181818182;0.431818181818182
Control.SRR15539829;38;45;0.5;19;19;0;0.5
Control.SRR15539829;45;45;0.555555555555556;20;25;0.0555555555555556;0.444444444444444
Control.SRR15539829;42;45;0.452380952380952;23;19;0.0476190476190476;0.452380952380952
Control.SRR15539829;46;45;0.391304347826087;28;18;0.108695652173913;0.391304347826087
Control.SRR15539829;45;45;0.488888888888889;23;22;0.0111111111111111;0.488888888888889
Control.SRR15539829;46;45;0.41304347826087;27;19;0.0869565217391304;0.41304347826087
Control.SRR15539829;40;45;0.525;19;21;0.025;0.475
Control.SRR15539829;44;45;0.5;22;22;0;0.5
Control.SRR15539829;47;45;0.51063829787234;23;24;0.0106382978723404;0.48936170212766
Control.SRR15539829;46;45;0.434782608695652;26;20;0.0652173913043478;0.434782608695652
Control.SRR15539829;50;45;0.52;24;26;0.02;0.48
Control.SRR15539829;48;45;0.520833333333333;23;25;0.0208333333333334;0.479166666666667
Control.SRR15539829;45;45;0.377777777777778;28;17;0.122222222222222;0.377777777777778
Control.SRR15539829;48;45;0.5;24;24;0;0.5
Control.SRR15539829;44;45;0.545454545454545;20;24;0.0454545454545454;0.454545454545455
Control.SRR15539829;48;45;0.666666666666667;16;32;0.166666666666667;0.333333333333333
Control.SRR15539829;48;45;0.541666666666667;22;26;0.0416666666666666;0.458333333333333
Control.SRR15539829;44;45;0.386363636363636;27;17;0.113636363636364;0.386363636363636
Control.SRR15539829;45;45;0.355555555555556;29;16;0.144444444444444;0.355555555555556
Control.SRR15539829;41;45;0.463414634146341;22;19;0.0365853658536585;0.463414634146341
Control.SRR15539829;45;45;0.444444444444444;25;20;0.0555555555555556;0.444444444444444
Control.SRR15539829;43;45;0.441860465116279;24;19;0.0581395348837209;0.441860465116279
Control.SRR15539829;45;45;0.488888888888889;23;22;0.0111111111111111;0.488888888888889
Control.SRR15539829;43;45;0.558139534883721;19;24;0.0581395348837209;0.441860465116279
Control.SRR15539829;49;45;0.428571428571429;28;21;0.0714285714285715;0.428571428571429
Control.SRR15539829;49;45;0.489795918367347;25;24;0.0102040816326531;0.489795918367347
Control.SRR15539829;50;45;0.5;25;25;0;0.5
Control.SRR15539829;44;45;0.545454545454545;20;24;0.0454545454545454;0.454545454545455
Control.SRR15539829;39;45;0.487179487179487;20;19;0.0128205128205128;0.487179487179487
Control.SRR15539829;50;45;0.48;26;24;0.02;0.48
Control.SRR15539829;41;45;0.463414634146341;22;19;0.0365853658536585;0.463414634146341
Control.SRR15539829;40;45;0.55;18;22;0.05;0.45
Control.SRR15539829;41;45;0.414634146341463;24;17;0.0853658536585366;0.414634146341463
Control.SRR15539829;44;45;0.477272727272727;23;21;0.0227272727272727;0.477272727272727
Control.SRR15539829;45;45;0.577777777777778;19;26;0.0777777777777777;0.422222222222222
Control.SRR15539829;48;45;0.541666666666667;22;26;0.0416666666666666;0.458333333333333
Control.SRR15539829;45;45;0.533333333333333;21;24;0.0333333333333333;0.466666666666667
Control.SRR15539829;45;45;0.688888888888889;14;31;0.188888888888889;0.311111111111111
Control.SRR15539829;43;45;0.651162790697674;15;28;0.151162790697674;0.348837209302326
Control.SRR15539829;41;45;0.560975609756098;18;23;0.0609756097560976;0.439024390243902
Control.SRR15539829;50;45;0.62;19;31;0.12;0.38
Control.SRR15539829;50;45;0.5;25;25;0;0.5
Control.SRR15539829;38;45;0.394736842105263;23;15;0.105263157894737;0.394736842105263
Control.SRR15539829;46;45;0.565217391304348;20;26;0.0652173913043478;0.434782608695652
Control.SRR15539829;40;45;0.525;19;21;0.025;0.475
Control.SRR15539829;40;45;0.425;23;17;0.075;0.425
Control.SRR15539829;48;45;0.604166666666667;19;29;0.104166666666667;0.395833333333333
Control.SRR15539829;49;45;0.530612244897959;23;26;0.0306122448979592;0.469387755102041
Control.SRR15539829;38;45;0.552631578947368;17;21;0.0526315789473685;0.447368421052632
Control.SRR15539829;39;45;0.487179487179487;20;19;0.0128205128205128;0.487179487179487
Control.SRR15539829;42;45;0.547619047619048;19;23;0.0476190476190477;0.452380952380952
Control.SRR15539829;46;45;0.369565217391304;29;17;0.130434782608696;0.369565217391304
Control.SRR15539829;43;45;0.488372093023256;22;21;0.0116279069767442;0.488372093023256
Control.SRR15539829;47;45;0.51063829787234;23;24;0.0106382978723404;0.48936170212766
Control.SRR15539829;41;45;0.536585365853659;19;22;0.0365853658536586;0.463414634146341
Control.SRR15539829;38;45;0.578947368421053;16;22;0.0789473684210527;0.421052631578947
Control.SRR15539829;39;45;0.641025641025641;14;25;0.141025641025641;0.358974358974359
Control.SRR15539829;40;45;0.4;24;16;0.1;0.4
Control.SRR15539829;47;45;0.51063829787234;23;24;0.0106382978723404;0.48936170212766
Control.SRR15539829;46;45;0.565217391304348;20;26;0.0652173913043478;0.434782608695652
Control.SRR15539829;38;45;0.5;19;19;0;0.5
Control.SRR15539829;43;45;0.558139534883721;19;24;0.0581395348837209;0.441860465116279
Control.SRR15539829;45;45;0.533333333333333;21;24;0.0333333333333333;0.466666666666667
Control.SRR15539829;39;45;0.538461538461538;18;21;0.0384615384615384;0.461538461538462
Control.SRR15539829;39;45;0.41025641025641;23;16;0.0897435897435898;0.41025641025641
Control.SRR15539829;42;45;0.380952380952381;26;16;0.119047619047619;0.380952380952381
Control.SRR15539829;42;45;0.428571428571429;24;18;0.0714285714285715;0.428571428571429
Control.SRR15539829;38;45;0.421052631578947;22;16;0.0789473684210527;0.421052631578947
Control.SRR15539829;48;45;0.479166666666667;25;23;0.0208333333333333;0.479166666666667
Control.SRR15539829;46;45;0.5;23;23;0;0.5
Control.SRR15539829;38;45;0.631578947368421;14;24;0.131578947368421;0.368421052631579
Control.SRR15539829;39;45;0.512820512820513;19;20;0.0128205128205128;0.487179487179487
Control.SRR15539829;43;45;0.534883720930233;20;23;0.0348837209302325;0.465116279069767
Control.SRR15539829;44;45;0.636363636363636;16;28;0.136363636363636;0.363636363636364
Control.SRR15539829;46;45;0.5;23;23;0;0.5
Control.SRR15539829;48;45;0.5;24;24;0;0.5
Control.SRR15539829;40;45;0.575;17;23;0.075;0.425
Control.SRR15539829;38;45;0.473684210526316;20;18;0.0263157894736842;0.473684210526316
Control.SRR15539829;42;45;0.523809523809524;20;22;0.0238095238095238;0.476190476190476
Control.SRR15539829;40;45;0.35;26;14;0.15;0.35
Control.SRR15539829;48;45;0.395833333333333;29;19;0.104166666666667;0.395833333333333
Control.SRR15539829;48;45;0.520833333333333;23;25;0.0208333333333334;0.479166666666667
Control.SRR15539829;38;45;0.394736842105263;23;15;0.105263157894737;0.394736842105263
Control.SRR15539829;44;45;0.659090909090909;15;29;0.159090909090909;0.340909090909091
Control.SRR15539829;38;45;0.315789473684211;26;12;0.184210526315789;0.315789473684211
Control.SRR15539829;49;45;0.551020408163265;22;27;0.0510204081632653;0.448979591836735
Control.SRR15539829;41;45;0.48780487804878;21;20;0.0121951219512195;0.48780487804878
Control.SRR15539829;43;45;0.488372093023256;22;21;0.0116279069767442;0.488372093023256
Control.SRR15539829;46;45;0.5;23;23;0;0.5
Control.SRR15539829;47;45;0.638297872340426;17;30;0.138297872340426;0.361702127659574
Control.SRR15539829;48;45;0.5625;21;27;0.0625;0.4375
Control.SRR15539829;44;45;0.568181818181818;19;25;0.0681818181818182;0.431818181818182
Control.SRR15539829;44;45;0.477272727272727;23;21;0.0227272727272727;0.477272727272727
Control.SRR15539829;38;45;0.421052631578947;22;16;0.0789473684210527;0.421052631578947
Control.SRR15539829;44;45;0.613636363636364;17;27;0.113636363636364;0.386363636363636
Control.SRR15539829;43;45;0.441860465116279;24;19;0.0581395348837209;0.441860465116279
Control.SRR15539829;44;45;0.454545454545455;24;20;0.0454545454545455;0.454545454545455
Control.SRR15539829;43;45;0.372093023255814;27;16;0.127906976744186;0.372093023255814
Control.SRR15539829;45;45;0.533333333333333;21;24;0.0333333333333333;0.466666666666667
Control.SRR15539829;49;45;0.469387755102041;26;23;0.0306122448979592;0.469387755102041
Control.SRR15539829;39;45;0.384615384615385;24;15;0.115384615384615;0.384615384615385
Control.SRR15539829;48;45;0.479166666666667;25;23;0.0208333333333333;0.479166666666667
Control.SRR15539829;41;45;0.634146341463415;15;26;0.134146341463415;0.365853658536585
Control.SRR15539829;40;45;0.5;20;20;0;0.5
Control.SRR15539829;47;45;0.553191489361702;21;26;0.0531914893617021;0.446808510638298
Control.SRR15539829;47;45;0.48936170212766;24;23;0.0106382978723404;0.48936170212766
Control.SRR15539829;42;45;0.523809523809524;20;22;0.0238095238095238;0.476190476190476
Control.SRR15539829;45;45;0.422222222222222;26;19;0.0777777777777778;0.422222222222222
Control.SRR15539829;45;45;0.488888888888889;23;22;0.0111111111111111;0.488888888888889
Control.SRR15539829;38;45;0.526315789473684;18;20;0.0263157894736842;0.473684210526316
Control.SRR15539829;41;45;0.414634146341463;24;17;0.0853658536585366;0.414634146341463
Control.SRR15539829;42;45;0.5;21;21;0;0.5
Control.SRR15539829;49;45;0.489795918367347;25;24;0.0102040816326531;0.489795918367347
Control.SRR15539829;44;45;0.590909090909091;18;26;0.0909090909090909;0.409090909090909
Control.SRR15539829;38;45;0.552631578947368;17;21;0.0526315789473685;0.447368421052632
Control.SRR15539829;41;45;0.365853658536585;26;15;0.134146341463415;0.365853658536585
Control.SRR15539829;42;45;0.571428571428571;18;24;0.0714285714285714;0.428571428571429
Control.SRR15539829;50;45;0.46;27;23;0.04;0.46
Control.SRR15539829;39;45;0.538461538461538;18;21;0.0384615384615384;0.461538461538462
Control.SRR15539829;41;45;0.536585365853659;19;22;0.0365853658536586;0.463414634146341
Control.SRR15539829;47;45;0.531914893617021;22;25;0.0319148936170213;0.468085106382979
Control.SRR15539829;45;45;0.533333333333333;21;24;0.0333333333333333;0.466666666666667
Control.SRR15539829;43;45;0.488372093023256;22;21;0.0116279069767442;0.488372093023256
Control.SRR15539829;43;45;0.604651162790698;17;26;0.104651162790698;0.395348837209302
Control.SRR15539829;49;45;0.448979591836735;27;22;0.0510204081632653;0.448979591836735
Control.SRR15539829;46;45;0.434782608695652;26;20;0.0652173913043478;0.434782608695652
Control.SRR15539829;50;45;0.44;28;22;0.06;0.44
Control.SRR15539829;50;45;0.36;32;18;0.14;0.36
Control.SRR15539829;42;45;0.642857142857143;15;27;0.142857142857143;0.357142857142857
Control.SRR15539829;49;45;0.510204081632653;24;25;0.0102040816326531;0.489795918367347
Control.SRR15539829;50;45;0.54;23;27;0.04;0.46
Control.SRR15539829;38;45;0.578947368421053;16;22;0.0789473684210527;0.421052631578947
Control.SRR15539829;38;45;0.447368421052632;21;17;0.0526315789473684;0.447368421052632
Control.SRR15539829;43;45;0.441860465116279;24;19;0.0581395348837209;0.441860465116279
Control.SRR15539829;49;45;0.489795918367347;25;24;0.0102040816326531;0.489795918367347
Control.SRR15539829;44;45;0.568181818181818;19;25;0.0681818181818182;0.431818181818182
Control.SRR15539829;44;45;0.454545454545455;24;20;0.0454545454545455;0.454545454545455
Control.SRR15539829;47;45;0.680851063829787;15;32;0.180851063829787;0.319148936170213
Control.SRR15539829;48;45;0.5625;21;27;0.0625;0.4375
Control.SRR15539829;41;45;0.439024390243902;23;18;0.0609756097560976;0.439024390243902
Control.SRR15539829;49;45;0.489795918367347;25;24;0.0102040816326531;0.489795918367347
Control.SRR15539829;47;45;0.425531914893617;27;20;0.074468085106383;0.425531914893617
Control.SRR15539829;44;45;0.545454545454545;20;24;0.0454545454545454;0.454545454545455
Control.SRR15539829;39;45;0.512820512820513;19;20;0.0128205128205128;0.487179487179487
Control.SRR15539829;40;45;0.45;22;18;0.05;0.45
Control.SRR15539829;48;45;0.479166666666667;25;23;0.0208333333333333;0.479166666666667
Control.SRR15539829;50;45;0.5;25;25;0;0.5
Control.SRR15539829;44;45;0.454545454545455;24;20;0.0454545454545455;0.454545454545455
Control.SRR15539829;48;45;0.479166666666667;25;23;0.0208333333333333;0.479166666666667
Control.SRR15539829;45;45;0.466666666666667;24;21;0.0333333333333333;0.466666666666667
Control.SRR15539829;42;45;0.452380952380952;23;19;0.0476190476190476;0.452380952380952
Control.SRR15539829;43;45;0.348837209302326;28;15;0.151162790697674;0.348837209302326
Control.SRR15539829;42;45;0.547619047619048;19;23;0.0476190476190477;0.452380952380952
Control.SRR15539829;40;45;0.45;22;18;0.05;0.45
Control.SRR15539829;41;45;0.48780487804878;21;20;0.0121951219512195;0.48780487804878
Control.SRR15539829;47;45;0.468085106382979;25;22;0.0319148936170213;0.468085106382979
Control.SRR15539829;38;45;0.447368421052632;21;17;0.0526315789473684;0.447368421052632
Control.SRR15539829;40;45;0.575;17;23;0.075;0.425
Control.SRR15539829;43;45;0.511627906976744;21;22;0.0116279069767442;0.488372093023256
Control.SRR15539829;47;45;0.553191489361702;21;26;0.0531914893617021;0.446808510638298
Control.SRR15539829;47;45;0.48936170212766;24;23;0.0106382978723404;0.48936170212766
Control.SRR15539829;38;45;0.5;19;19;0;0.5
Control.SRR15539829;39;45;0.358974358974359;25;14;0.141025641025641;0.358974358974359
Control.SRR15539829;40;45;0.5;20;20;0;0.5
Control.SRR15539829;41;45;0.414634146341463;24;17;0.0853658536585366;0.414634146341463
Control.SRR15539829;40;45;0.6;16;24;0.1;0.4
Control.SRR15539829;50;45;0.44;28;22;0.06;0.44
Control.SRR15539829;50;45;0.52;24;26;0.02;0.48
Control.SRR15539829;47;45;0.531914893617021;22;25;0.0319148936170213;0.468085106382979
Control.SRR15539829;45;45;0.333333333333333;30;15;0.166666666666667;0.333333333333333
Control.SRR15539829;41;45;0.658536585365854;14;27;0.158536585365854;0.341463414634146
Control.SRR15539829;42;45;0.547619047619048;19;23;0.0476190476190477;0.452380952380952
Control.SRR15539829;44;45;0.431818181818182;25;19;0.0681818181818182;0.431818181818182
Control.SRR15539829;44;45;0.681818181818182;14;30;0.181818181818182;0.318181818181818
Control.SRR15539829;45;45;0.533333333333333;21;24;0.0333333333333333;0.466666666666667
Control.SRR15539829;43;45;0.604651162790698;17;26;0.104651162790698;0.395348837209302
Control.SRR15539829;45;45;0.466666666666667;24;21;0.0333333333333333;0.466666666666667
Control.SRR15539829;41;45;0.536585365853659;19;22;0.0365853658536586;0.463414634146341
Control.SRR15539829;40;45;0.675;13;27;0.175;0.325
Control.SRR15539829;44;45;0.522727272727273;21;23;0.0227272727272727;0.477272727272727
Control.SRR15539829;42;45;0.476190476190476;22;20;0.0238095238095238;0.476190476190476
Control.SRR15539829;42;45;0.547619047619048;19;23;0.0476190476190477;0.452380952380952
Control.SRR15539829;50;45;0.42;29;21;0.08;0.42
Control.SRR15539829;50;45;0.58;21;29;0.08;0.42
Control.SRR15539829;46;45;0.521739130434783;22;24;0.0217391304347826;0.478260869565217
Control.SRR15539829;38;45;0.368421052631579;24;14;0.131578947368421;0.368421052631579
Control.SRR15539829;40;45;0.35;26;14;0.15;0.35
Control.SRR15539829;40;45;0.525;19;21;0.025;0.475
Control.SRR15539829;40;45;0.55;18;22;0.05;0.45
Control.SRR15539829;40;45;0.45;22;18;0.05;0.45
Control.SRR15539829;40;45;0.575;17;23;0.075;0.425
Control.SRR15539829;45;45;0.377777777777778;28;17;0.122222222222222;0.377777777777778
Control.SRR15539829;42;45;0.452380952380952;23;19;0.0476190476190476;0.452380952380952
Control.SRR15539829;49;45;0.448979591836735;27;22;0.0510204081632653;0.448979591836735
Control.SRR15539829;40;45;0.55;18;22;0.05;0.45
Control.SRR15539829;47;45;0.425531914893617;27;20;0.074468085106383;0.425531914893617
Control.SRR15539829;45;45;0.422222222222222;26;19;0.0777777777777778;0.422222222222222
Control.SRR15539829;40;45;0.525;19;21;0.025;0.475
Control.SRR15539829;38;45;0.5;19;19;0;0.5
Control.SRR15539829;42;45;0.476190476190476;22;20;0.0238095238095238;0.476190476190476
Control.SRR15539829;42;45;0.428571428571429;24;18;0.0714285714285715;0.428571428571429
Control.SRR15539829;38;45;0.473684210526316;20;18;0.0263157894736842;0.473684210526316
Control.SRR15539829;39;45;0.564102564102564;17;22;0.0641025641025641;0.435897435897436
Control.SRR15539829;40;45;0.425;23;17;0.075;0.425
Control.SRR15539829;45;45;0.422222222222222;26;19;0.0777777777777778;0.422222222222222
Control.SRR15539829;40;45;0.55;18;22;0.05;0.45
Control.SRR15539829;45;45;0.4;27;18;0.1;0.4
Control.SRR15539829;45;45;0.466666666666667;24;21;0.0333333333333333;0.466666666666667
Control.SRR15539829;49;45;0.448979591836735;27;22;0.0510204081632653;0.448979591836735
Control.SRR15539829;39;45;0.384615384615385;24;15;0.115384615384615;0.384615384615385
Control.SRR15539829;49;45;0.489795918367347;25;24;0.0102040816326531;0.489795918367347
Control.SRR15539829;38;45;0.552631578947368;17;21;0.0526315789473685;0.447368421052632
Control.SRR15539829;38;45;0.421052631578947;22;16;0.0789473684210527;0.421052631578947
Control.SRR15539829;38;45;0.5;19;19;0;0.5
Control.SRR15539829;44;45;0.409090909090909;26;18;0.0909090909090909;0.409090909090909
Control.SRR15539829;50;45;0.54;23;27;0.04;0.46
Control.SRR15539829;44;45;0.590909090909091;18;26;0.0909090909090909;0.409090909090909
Control.SRR15539829;41;45;0.414634146341463;24;17;0.0853658536585366;0.414634146341463
Control.SRR15539829;38;45;0.526315789473684;18;20;0.0263157894736842;0.473684210526316
Control.SRR15539829;40;45;0.675;13;27;0.175;0.325
Control.SRR15539829;46;45;0.630434782608696;17;29;0.130434782608696;0.369565217391304
Control.SRR15539829;40;45;0.625;15;25;0.125;0.375
Control.SRR15539829;40;45;0.4;24;16;0.1;0.4
Control.SRR15539829;38;45;0.473684210526316;20;18;0.0263157894736842;0.473684210526316
Control.SRR15539829;47;45;0.51063829787234;23;24;0.0106382978723404;0.48936170212766
Control.SRR15539829;50;45;0.6;20;30;0.1;0.4
Control.SRR15539829;45;45;0.444444444444444;25;20;0.0555555555555556;0.444444444444444
Control.SRR15539829;48;45;0.520833333333333;23;25;0.0208333333333334;0.479166666666667
Control.SRR15539829;44;45;0.340909090909091;29;15;0.159090909090909;0.340909090909091
Control.SRR15539829;41;45;0.560975609756098;18;23;0.0609756097560976;0.439024390243902
Control.SRR15539829;42;45;0.595238095238095;17;25;0.0952380952380952;0.404761904761905
Control.SRR15539829;43;45;0.534883720930233;20;23;0.0348837209302325;0.465116279069767
Control.SRR15539829;42;45;0.571428571428571;18;24;0.0714285714285714;0.428571428571429
Control.SRR15539829;50;45;0.54;23;27;0.04;0.46
Control.SRR15539829;46;45;0.326086956521739;31;15;0.173913043478261;0.326086956521739
Control.SRR15539829;50;45;0.4;30;20;0.1;0.4
Control.SRR15539829;45;45;0.444444444444444;25;20;0.0555555555555556;0.444444444444444
Control.SRR15539829;38;45;0.473684210526316;20;18;0.0263157894736842;0.473684210526316
Control.SRR15539829;42;45;0.5;21;21;0;0.5
Control.SRR15539829;43;45;0.604651162790698;17;26;0.104651162790698;0.395348837209302
Control.SRR15539829;44;45;0.568181818181818;19;25;0.0681818181818182;0.431818181818182
Control.SRR15539829;42;45;0.547619047619048;19;23;0.0476190476190477;0.452380952380952
Control.SRR15539829;44;45;0.590909090909091;18;26;0.0909090909090909;0.409090909090909
Control.SRR15539829;48;45;0.5;24;24;0;0.5
Control.SRR15539829;42;45;0.428571428571429;24;18;0.0714285714285715;0.428571428571429
Control.SRR15539829;43;45;0.418604651162791;25;18;0.0813953488372093;0.418604651162791
Control.SRR15539829;43;45;0.418604651162791;25;18;0.0813953488372093;0.418604651162791
Control.SRR15539829;38;45;0.394736842105263;23;15;0.105263157894737;0.394736842105263
Control.SRR15539829;50;45;0.5;25;25;0;0.5
Control.SRR15539829;44;45;0.545454545454545;20;24;0.0454545454545454;0.454545454545455
Control.SRR15539829;48;45;0.5;24;24;0;0.5
Control.SRR15539829;41;45;0.560975609756098;18;23;0.0609756097560976;0.439024390243902
Control.SRR15539829;38;45;0.5;19;19;0;0.5
Control.SRR15539829;43;45;0.651162790697674;15;28;0.151162790697674;0.348837209302326
Control.SRR15539829;38;45;0.552631578947368;17;21;0.0526315789473685;0.447368421052632
Control.SRR15539829;41;45;0.463414634146341;22;19;0.0365853658536585;0.463414634146341
Control.SRR15539829;43;45;0.465116279069767;23;20;0.0348837209302326;0.465116279069767
Control.SRR15539829;45;45;0.466666666666667;24;21;0.0333333333333333;0.466666666666667
Control.SRR15539829;38;45;0.5;19;19;0;0.5
Control.SRR15539829;38;45;0.447368421052632;21;17;0.0526315789473684;0.447368421052632
Control.SRR15539829;48;45;0.479166666666667;25;23;0.0208333333333333;0.479166666666667
Control.SRR15539829;39;45;0.461538461538462;21;18;0.0384615384615384;0.461538461538462
Control.SRR15539829;47;45;0.468085106382979;25;22;0.0319148936170213;0.468085106382979
Control.SRR15539829;42;45;0.428571428571429;24;18;0.0714285714285715;0.428571428571429
Control.SRR15539829;44;45;0.568181818181818;19;25;0.0681818181818182;0.431818181818182
Control.SRR15539829;41;45;0.536585365853659;19;22;0.0365853658536586;0.463414634146341
Control.SRR15539829;44;45;0.522727272727273;21;23;0.0227272727272727;0.477272727272727
Control.SRR15539829;49;45;0.571428571428571;21;28;0.0714285714285714;0.428571428571429
Control.SRR15539829;48;45;0.4375;27;21;0.0625;0.4375
Control.SRR15539829;39;45;0.538461538461538;18;21;0.0384615384615384;0.461538461538462
Control.SRR15539829;41;45;0.51219512195122;20;21;0.0121951219512195;0.48780487804878
Control.SRR15539829;40;45;0.55;18;22;0.05;0.45
Control.SRR15539829;39;45;0.461538461538462;21;18;0.0384615384615384;0.461538461538462
Control.SRR15539829;45;45;0.4;27;18;0.1;0.4
Control.SRR15539829;48;45;0.520833333333333;23;25;0.0208333333333334;0.479166666666667
Control.SRR15539829;44;45;0.522727272727273;21;23;0.0227272727272727;0.477272727272727
Control.SRR15539829;43;45;0.511627906976744;21;22;0.0116279069767442;0.488372093023256
Control.SRR15539829;40;45;0.525;19;21;0.025;0.475
Control.SRR15539829;41;45;0.439024390243902;23;18;0.0609756097560976;0.439024390243902
Control.SRR15539829;43;45;0.534883720930233;20;23;0.0348837209302325;0.465116279069767
Control.SRR15539829;38;45;0.578947368421053;16;22;0.0789473684210527;0.421052631578947
Control.SRR15539829;40;45;0.425;23;17;0.075;0.425
Control.SRR15539829;44;45;0.545454545454545;20;24;0.0454545454545454;0.454545454545455
Control.SRR15539829;45;45;0.355555555555556;29;16;0.144444444444444;0.355555555555556
Control.SRR15539829;40;45;0.575;17;23;0.075;0.425
Control.SRR15539829;42;45;0.5;21;21;0;0.5
Control.SRR15539829;40;45;0.575;17;23;0.075;0.425
Control.SRR15539829;40;45;0.55;18;22;0.05;0.45
Control.SRR15539829;40;45;0.575;17;23;0.075;0.425
Control.SRR15539829;43;45;0.418604651162791;25;18;0.0813953488372093;0.418604651162791
Control.SRR15539829;40;45;0.6;16;24;0.1;0.4
Control.SRR15539829;45;45;0.444444444444444;25;20;0.0555555555555556;0.444444444444444
Control.SRR15539829;41;45;0.536585365853659;19;22;0.0365853658536586;0.463414634146341
Control.SRR15539829;42;45;0.428571428571429;24;18;0.0714285714285715;0.428571428571429
Control.SRR15539829;44;45;0.545454545454545;20;24;0.0454545454545454;0.454545454545455
Control.SRR15539829;42;45;0.619047619047619;16;26;0.119047619047619;0.380952380952381
Control.SRR15539829;50;45;0.48;26;24;0.02;0.48
Control.SRR15539829;48;45;0.479166666666667;25;23;0.0208333333333333;0.479166666666667
Control.SRR15539829;44;45;0.545454545454545;20;24;0.0454545454545454;0.454545454545455
Control.SRR15539829;47;45;0.48936170212766;24;23;0.0106382978723404;0.48936170212766
Control.SRR15539829;42;45;0.523809523809524;20;22;0.0238095238095238;0.476190476190476
Control.SRR15539829;46;45;0.41304347826087;27;19;0.0869565217391304;0.41304347826087
Control.SRR15539829;44;45;0.5;22;22;0;0.5
Control.SRR15539829;50;45;0.54;23;27;0.04;0.46
Control.SRR15539829;47;45;0.48936170212766;24;23;0.0106382978723404;0.48936170212766
Control.SRR15539829;49;45;0.551020408163265;22;27;0.0510204081632653;0.448979591836735
Control.SRR15539829;38;45;0.473684210526316;20;18;0.0263157894736842;0.473684210526316
Control.SRR15539829;38;45;0.552631578947368;17;21;0.0526315789473685;0.447368421052632
Control.SRR15539829;38;45;0.5;19;19;0;0.5
Control.SRR15539829;50;45;0.44;28;22;0.06;0.44
Control.SRR15539829;41;45;0.463414634146341;22;19;0.0365853658536585;0.463414634146341
Control.SRR15539829;39;45;0.41025641025641;23;16;0.0897435897435898;0.41025641025641
Control.SRR15539829;38;45;0.473684210526316;20;18;0.0263157894736842;0.473684210526316
Control.SRR15539829;44;45;0.522727272727273;21;23;0.0227272727272727;0.477272727272727
Control.SRR15539829;48;45;0.520833333333333;23;25;0.0208333333333334;0.479166666666667
Control.SRR15539829;47;45;0.638297872340426;17;30;0.138297872340426;0.361702127659574
Control.SRR15539829;43;45;0.488372093023256;22;21;0.0116279069767442;0.488372093023256
Control.SRR15539829;42;45;0.523809523809524;20;22;0.0238095238095238;0.476190476190476
Control.SRR15539829;48;45;0.520833333333333;23;25;0.0208333333333334;0.479166666666667
Control.SRR15539829;39;45;0.384615384615385;24;15;0.115384615384615;0.384615384615385
Control.SRR15539829;47;45;0.595744680851064;19;28;0.0957446808510638;0.404255319148936
Control.SRR15539829;50;45;0.64;18;32;0.14;0.36
Control.SRR15539829;50;45;0.48;26;24;0.02;0.48
Control.SRR15539829;44;45;0.431818181818182;25;19;0.0681818181818182;0.431818181818182
Control.SRR15539829;41;45;0.658536585365854;14;27;0.158536585365854;0.341463414634146
Control.SRR15539829;39;45;0.358974358974359;25;14;0.141025641025641;0.358974358974359
Control.SRR15539829;43;45;0.441860465116279;24;19;0.0581395348837209;0.441860465116279
Control.SRR15539829;43;45;0.395348837209302;26;17;0.104651162790698;0.395348837209302
Control.SRR15539829;48;45;0.520833333333333;23;25;0.0208333333333334;0.479166666666667
Control.SRR15539829;42;45;0.523809523809524;20;22;0.0238095238095238;0.476190476190476
Control.SRR15539829;45;45;0.488888888888889;23;22;0.0111111111111111;0.488888888888889
Control.SRR15539829;41;45;0.609756097560976;16;25;0.109756097560976;0.390243902439024
Control.SRR15539829;39;45;0.512820512820513;19;20;0.0128205128205128;0.487179487179487
Control.SRR15539829;40;45;0.55;18;22;0.05;0.45
Control.SRR15539829;39;45;0.615384615384615;15;24;0.115384615384615;0.384615384615385
Control.SRR15539829;48;45;0.375;30;18;0.125;0.375
Control.SRR15539829;44;45;0.568181818181818;19;25;0.0681818181818182;0.431818181818182
Control.SRR15539829;47;45;0.48936170212766;24;23;0.0106382978723404;0.48936170212766
Control.SRR15539829;41;45;0.365853658536585;26;15;0.134146341463415;0.365853658536585
Control.SRR15539829;49;45;0.489795918367347;25;24;0.0102040816326531;0.489795918367347
Control.SRR15539829;47;45;0.574468085106383;20;27;0.074468085106383;0.425531914893617
Control.SRR15539829;47;45;0.48936170212766;24;23;0.0106382978723404;0.48936170212766
Control.SRR15539829;46;45;0.521739130434783;22;24;0.0217391304347826;0.478260869565217
Control.SRR15539829;44;45;0.545454545454545;20;24;0.0454545454545454;0.454545454545455
Control.SRR15539829;38;45;0.421052631578947;22;16;0.0789473684210527;0.421052631578947
Control.SRR15539829;47;45;0.617021276595745;18;29;0.117021276595745;0.382978723404255
Control.SRR15539829;41;45;0.536585365853659;19;22;0.0365853658536586;0.463414634146341
Control.SRR15539829;40;45;0.575;17;23;0.075;0.425
Control.SRR15539829;43;45;0.558139534883721;19;24;0.0581395348837209;0.441860465116279
Control.SRR15539829;44;45;0.5;22;22;0;0.5
Control.SRR15539829;49;45;0.489795918367347;25;24;0.0102040816326531;0.489795918367347
Control.SRR15539829;50;45;0.52;24;26;0.02;0.48
Control.SRR15539829;49;45;0.612244897959184;19;30;0.112244897959184;0.387755102040816
Control.SRR15539829;44;45;0.590909090909091;18;26;0.0909090909090909;0.409090909090909
Control.SRR15539829;44;45;0.613636363636364;17;27;0.113636363636364;0.386363636363636
Control.SRR15539829;44;45;0.477272727272727;23;21;0.0227272727272727;0.477272727272727
Control.SRR15539829;46;45;0.521739130434783;22;24;0.0217391304347826;0.478260869565217
Control.SRR15539829;47;45;0.425531914893617;27;20;0.074468085106383;0.425531914893617
Control.SRR15539829;45;45;0.555555555555556;20;25;0.0555555555555556;0.444444444444444
Control.SRR15539829;44;45;0.545454545454545;20;24;0.0454545454545454;0.454545454545455
Control.SRR15539829;41;45;0.585365853658537;17;24;0.0853658536585366;0.414634146341463
Control.SRR15539829;42;45;0.5;21;21;0;0.5
Control.SRR15539829;47;45;0.468085106382979;25;22;0.0319148936170213;0.468085106382979
Control.SRR15539829;39;45;0.512820512820513;19;20;0.0128205128205128;0.487179487179487
Control.SRR15539829;38;45;0.473684210526316;20;18;0.0263157894736842;0.473684210526316
Control.SRR15539829;46;45;0.434782608695652;26;20;0.0652173913043478;0.434782608695652
Control.SRR15539829;49;45;0.428571428571429;28;21;0.0714285714285715;0.428571428571429
Control.SRR15539829;49;45;0.428571428571429;28;21;0.0714285714285715;0.428571428571429
Control.SRR15539829;41;45;0.51219512195122;20;21;0.0121951219512195;0.48780487804878
Control.SRR15539829;45;45;0.511111111111111;22;23;0.0111111111111111;0.488888888888889
Control.SRR15539829;39;45;0.564102564102564;17;22;0.0641025641025641;0.435897435897436
Control.SRR15539829;40;45;0.6;16;24;0.1;0.4
Control.SRR15539829;48;45;0.458333333333333;26;22;0.0416666666666667;0.458333333333333
Control.SRR15539829;45;45;0.555555555555556;20;25;0.0555555555555556;0.444444444444444
Control.SRR15539829;48;45;0.479166666666667;25;23;0.0208333333333333;0.479166666666667
Control.SRR15539829;48;45;0.458333333333333;26;22;0.0416666666666667;0.458333333333333
Control.SRR15539829;50;45;0.52;24;26;0.02;0.48
Control.SRR15539829;47;45;0.51063829787234;23;24;0.0106382978723404;0.48936170212766
Control.SRR15539829;43;45;0.604651162790698;17;26;0.104651162790698;0.395348837209302
Control.SRR15539829;38;45;0.552631578947368;17;21;0.0526315789473685;0.447368421052632
Control.SRR15539829;38;45;0.368421052631579;24;14;0.131578947368421;0.368421052631579
Control.SRR15539829;44;45;0.477272727272727;23;21;0.0227272727272727;0.477272727272727
Control.SRR15539829;48;45;0.5625;21;27;0.0625;0.4375
Control.SRR15539829;46;45;0.521739130434783;22;24;0.0217391304347826;0.478260869565217
Control.SRR15539829;44;45;0.454545454545455;24;20;0.0454545454545455;0.454545454545455
Control.SRR15539829;46;45;0.521739130434783;22;24;0.0217391304347826;0.478260869565217
Control.SRR15539829;49;45;0.510204081632653;24;25;0.0102040816326531;0.489795918367347
Control.SRR15539829;44;45;0.522727272727273;21;23;0.0227272727272727;0.477272727272727
Control.SRR15539829;38;45;0.447368421052632;21;17;0.0526315789473684;0.447368421052632
Control.SRR15539829;41;45;0.609756097560976;16;25;0.109756097560976;0.390243902439024
Control.SRR15539829;49;45;0.448979591836735;27;22;0.0510204081632653;0.448979591836735
Control.SRR15539829;46;45;0.478260869565217;24;22;0.0217391304347826;0.478260869565217
Control.SRR15539829;45;45;0.466666666666667;24;21;0.0333333333333333;0.466666666666667
Control.SRR15539829;41;45;0.48780487804878;21;20;0.0121951219512195;0.48780487804878
Control.SRR15539829;42;45;0.571428571428571;18;24;0.0714285714285714;0.428571428571429
Control.SRR15539829;44;45;0.636363636363636;16;28;0.136363636363636;0.363636363636364
Control.SRR15539829;43;45;0.511627906976744;21;22;0.0116279069767442;0.488372093023256
Control.SRR15539829;41;45;0.365853658536585;26;15;0.134146341463415;0.365853658536585
Control.SRR15539829;48;45;0.3125;33;15;0.1875;0.3125
Control.SRR15539829;40;45;0.575;17;23;0.075;0.425
Control.SRR15539829;50;45;0.5;25;25;0;0.5
Control.SRR15539829;49;45;0.612244897959184;19;30;0.112244897959184;0.387755102040816
Control.SRR15539829;41;45;0.463414634146341;22;19;0.0365853658536585;0.463414634146341
Control.SRR15539829;42;45;0.5;21;21;0;0.5
Control.SRR15539829;45;45;0.533333333333333;21;24;0.0333333333333333;0.466666666666667
Control.SRR15539829;43;45;0.418604651162791;25;18;0.0813953488372093;0.418604651162791
Control.SRR15539829;46;45;0.434782608695652;26;20;0.0652173913043478;0.434782608695652
Control.SRR15539829;42;45;0.476190476190476;22;20;0.0238095238095238;0.476190476190476
Control.SRR15539829;47;45;0.361702127659574;30;17;0.138297872340426;0.361702127659574
Control.SRR15539829;46;45;0.521739130434783;22;24;0.0217391304347826;0.478260869565217
Control.SRR15539829;41;45;0.560975609756098;18;23;0.0609756097560976;0.439024390243902
Control.SRR15539829;42;45;0.452380952380952;23;19;0.0476190476190476;0.452380952380952
Control.SRR15539829;49;45;0.428571428571429;28;21;0.0714285714285715;0.428571428571429
Control.SRR15539829;39;45;0.512820512820513;19;20;0.0128205128205128;0.487179487179487
Control.SRR15539829;46;45;0.652173913043478;16;30;0.152173913043478;0.347826086956522
Control.SRR15539829;46;45;0.5;23;23;0;0.5
Control.SRR15539829;43;45;0.627906976744186;16;27;0.127906976744186;0.372093023255814
Control.SRR15539829;41;45;0.414634146341463;24;17;0.0853658536585366;0.414634146341463
Control.SRR15539829;46;45;0.478260869565217;24;22;0.0217391304347826;0.478260869565217
Control.SRR15539829;42;45;0.619047619047619;16;26;0.119047619047619;0.380952380952381
Control.SRR15539829;45;45;0.533333333333333;21;24;0.0333333333333333;0.466666666666667
Control.SRR15539829;42;45;0.619047619047619;16;26;0.119047619047619;0.380952380952381
Control.SRR15539829;42;45;0.595238095238095;17;25;0.0952380952380952;0.404761904761905
Control.SRR15539829;40;45;0.55;18;22;0.05;0.45
Control.SRR15539829;38;45;0.473684210526316;20;18;0.0263157894736842;0.473684210526316
Control.SRR15539829;46;45;0.456521739130435;25;21;0.0434782608695652;0.456521739130435
Control.SRR15539829;45;45;0.422222222222222;26;19;0.0777777777777778;0.422222222222222
Control.SRR15539829;41;45;0.365853658536585;26;15;0.134146341463415;0.365853658536585
Control.SRR15539829;45;45;0.555555555555556;20;25;0.0555555555555556;0.444444444444444
Control.SRR15539829;46;45;0.58695652173913;19;27;0.0869565217391305;0.41304347826087
Control.SRR15539829;40;45;0.425;23;17;0.075;0.425
Control.SRR15539829;50;45;0.52;24;26;0.02;0.48
Control.SRR15539829;46;45;0.456521739130435;25;21;0.0434782608695652;0.456521739130435
Control.SRR15539829;49;45;0.530612244897959;23;26;0.0306122448979592;0.469387755102041
Control.SRR15539829;41;45;0.48780487804878;21;20;0.0121951219512195;0.48780487804878
Control.SRR15539829;47;45;0.574468085106383;20;27;0.074468085106383;0.425531914893617
Control.SRR15539829;42;45;0.5;21;21;0;0.5
Control.SRR15539829;44;45;0.568181818181818;19;25;0.0681818181818182;0.431818181818182
Control.SRR15539829;38;45;0.5;19;19;0;0.5
Control.SRR15539829;42;45;0.452380952380952;23;19;0.0476190476190476;0.452380952380952
Control.SRR15539829;44;45;0.636363636363636;16;28;0.136363636363636;0.363636363636364
Control.SRR15539829;49;45;0.448979591836735;27;22;0.0510204081632653;0.448979591836735
Control.SRR15539829;46;45;0.521739130434783;22;24;0.0217391304347826;0.478260869565217
Control.SRR15539829;46;45;0.456521739130435;25;21;0.0434782608695652;0.456521739130435
Control.SRR15539829;38;45;0.552631578947368;17;21;0.0526315789473685;0.447368421052632
Control.SRR15539829;44;45;0.681818181818182;14;30;0.181818181818182;0.318181818181818
Control.SRR15539829;40;45;0.375;25;15;0.125;0.375
Control.SRR15539829;43;45;0.488372093023256;22;21;0.0116279069767442;0.488372093023256
Control.SRR15539829;44;45;0.409090909090909;26;18;0.0909090909090909;0.409090909090909
Control.SRR15539829;46;45;0.521739130434783;22;24;0.0217391304347826;0.478260869565217
Control.SRR15539829;43;45;0.488372093023256;22;21;0.0116279069767442;0.488372093023256
Control.SRR15539829;44;45;0.431818181818182;25;19;0.0681818181818182;0.431818181818182
Control.SRR15539829;41;45;0.390243902439024;25;16;0.109756097560976;0.390243902439024
Control.SRR15539829;48;45;0.645833333333333;17;31;0.145833333333333;0.354166666666667
Control.SRR15539829;44;45;0.477272727272727;23;21;0.0227272727272727;0.477272727272727
Control.SRR15539829;40;45;0.5;20;20;0;0.5
Control.SRR15539829;40;45;0.475;21;19;0.025;0.475
Control.SRR15539829;42;45;0.452380952380952;23;19;0.0476190476190476;0.452380952380952
Control.SRR15539829;40;45;0.575;17;23;0.075;0.425
Control.SRR15539829;42;45;0.547619047619048;19;23;0.0476190476190477;0.452380952380952
Control.SRR15539829;43;45;0.534883720930233;20;23;0.0348837209302325;0.465116279069767
Control.SRR15539829;39;45;0.512820512820513;19;20;0.0128205128205128;0.487179487179487
Control.SRR15539829;43;45;0.418604651162791;25;18;0.0813953488372093;0.418604651162791
Control.SRR15539829;50;45;0.48;26;24;0.02;0.48
Control.SRR15539829;39;45;0.487179487179487;20;19;0.0128205128205128;0.487179487179487
Control.SRR15539829;38;45;0.5;19;19;0;0.5
Control.SRR15539829;40;45;0.6;16;24;0.1;0.4
Control.SRR15539829;39;45;0.564102564102564;17;22;0.0641025641025641;0.435897435897436
Control.SRR15539829;42;45;0.571428571428571;18;24;0.0714285714285714;0.428571428571429
Control.SRR15539829;43;45;0.418604651162791;25;18;0.0813953488372093;0.418604651162791
Control.SRR15539829;41;45;0.463414634146341;22;19;0.0365853658536585;0.463414634146341
Control.SRR15539829;46;45;0.521739130434783;22;24;0.0217391304347826;0.478260869565217
Control.SRR15539829;43;45;0.465116279069767;23;20;0.0348837209302326;0.465116279069767
Control.SRR15539829;40;45;0.6;16;24;0.1;0.4
Control.SRR15539829;50;45;0.42;29;21;0.08;0.42
Control.SRR15539829;42;45;0.5;21;21;0;0.5
Control.SRR15539829;49;45;0.530612244897959;23;26;0.0306122448979592;0.469387755102041
Control.SRR15539829;45;45;0.4;27;18;0.1;0.4
Control.SRR15539829;43;45;0.418604651162791;25;18;0.0813953488372093;0.418604651162791
Control.SRR15539829;45;45;0.4;27;18;0.1;0.4
Control.SRR15539829;47;45;0.531914893617021;22;25;0.0319148936170213;0.468085106382979
Control.SRR15539829;43;45;0.488372093023256;22;21;0.0116279069767442;0.488372093023256
Control.SRR15539829;47;45;0.404255319148936;28;19;0.0957446808510639;0.404255319148936
Control.SRR15539829;46;45;0.521739130434783;22;24;0.0217391304347826;0.478260869565217
Control.SRR15539829;39;45;0.538461538461538;18;21;0.0384615384615384;0.461538461538462
Control.SRR15539829;39;45;0.435897435897436;22;17;0.0641025641025641;0.435897435897436
Control.SRR15539829;41;45;0.48780487804878;21;20;0.0121951219512195;0.48780487804878
Control.SRR15539829;47;45;0.574468085106383;20;27;0.074468085106383;0.425531914893617
Control.SRR15539829;40;45;0.575;17;23;0.075;0.425
Control.SRR15539829;44;45;0.386363636363636;27;17;0.113636363636364;0.386363636363636
Control.SRR15539829;50;45;0.4;30;20;0.1;0.4
Control.SRR15539829;42;45;0.476190476190476;22;20;0.0238095238095238;0.476190476190476
Control.SRR15539829;40;45;0.45;22;18;0.05;0.45
Control.SRR15539829;43;45;0.488372093023256;22;21;0.0116279069767442;0.488372093023256
Control.SRR15539829;44;45;0.454545454545455;24;20;0.0454545454545455;0.454545454545455
Control.SRR15539829;45;45;0.577777777777778;19;26;0.0777777777777777;0.422222222222222
Control.SRR15539829;44;45;0.477272727272727;23;21;0.0227272727272727;0.477272727272727
Control.SRR15539829;44;45;0.454545454545455;24;20;0.0454545454545455;0.454545454545455
Control.SRR15539829;41;45;0.463414634146341;22;19;0.0365853658536585;0.463414634146341
Control.SRR15539829;46;45;0.41304347826087;27;19;0.0869565217391304;0.41304347826087
Control.SRR15539829;44;45;0.477272727272727;23;21;0.0227272727272727;0.477272727272727
Control.SRR15539829;44;45;0.477272727272727;23;21;0.0227272727272727;0.477272727272727
Control.SRR15539829;47;45;0.446808510638298;26;21;0.0531914893617021;0.446808510638298
Control.SRR15539829;43;45;0.511627906976744;21;22;0.0116279069767442;0.488372093023256
Control.SRR15539829;49;45;0.571428571428571;21;28;0.0714285714285714;0.428571428571429
Control.SRR15539829;47;45;0.425531914893617;27;20;0.074468085106383;0.425531914893617
Control.SRR15539829;46;45;0.565217391304348;20;26;0.0652173913043478;0.434782608695652
Control.SRR15539829;48;45;0.541666666666667;22;26;0.0416666666666666;0.458333333333333
Control.SRR15539829;39;45;0.564102564102564;17;22;0.0641025641025641;0.435897435897436
Control.SRR15539829;50;45;0.4;30;20;0.1;0.4
Control.SRR15539829;46;45;0.521739130434783;22;24;0.0217391304347826;0.478260869565217
Control.SRR15539829;46;45;0.521739130434783;22;24;0.0217391304347826;0.478260869565217
Control.SRR15539829;49;45;0.530612244897959;23;26;0.0306122448979592;0.469387755102041
Control.SRR15539829;47;45;0.531914893617021;22;25;0.0319148936170213;0.468085106382979
Control.SRR15539829;50;45;0.54;23;27;0.04;0.46
Control.SRR15539829;42;45;0.428571428571429;24;18;0.0714285714285715;0.428571428571429
Control.SRR15539829;47;45;0.531914893617021;22;25;0.0319148936170213;0.468085106382979
Control.SRR15539829;41;45;0.609756097560976;16;25;0.109756097560976;0.390243902439024
Control.SRR15539829;48;45;0.583333333333333;20;28;0.0833333333333334;0.416666666666667
Control.SRR15539829;39;45;0.461538461538462;21;18;0.0384615384615384;0.461538461538462
Control.SRR15539829;48;45;0.458333333333333;26;22;0.0416666666666667;0.458333333333333
Control.SRR15539829;49;45;0.428571428571429;28;21;0.0714285714285715;0.428571428571429
Control.SRR15539829;50;45;0.48;26;24;0.02;0.48
Control.SRR15539829;46;45;0.565217391304348;20;26;0.0652173913043478;0.434782608695652
Control.SRR15539829;38;45;0.526315789473684;18;20;0.0263157894736842;0.473684210526316
Control.SRR15539829;48;45;0.458333333333333;26;22;0.0416666666666667;0.458333333333333
Control.SRR15539829;50;45;0.54;23;27;0.04;0.46
Control.SRR15539829;49;45;0.612244897959184;19;30;0.112244897959184;0.387755102040816
Control.SRR15539829;42;45;0.452380952380952;23;19;0.0476190476190476;0.452380952380952
Control.SRR15539829;49;45;0.489795918367347;25;24;0.0102040816326531;0.489795918367347
Control.SRR15539829;42;45;0.404761904761905;25;17;0.0952380952380952;0.404761904761905
Control.SRR15539829;46;45;0.456521739130435;25;21;0.0434782608695652;0.456521739130435
Control.SRR15539829;49;45;0.469387755102041;26;23;0.0306122448979592;0.469387755102041
Control.SRR15539829;48;45;0.479166666666667;25;23;0.0208333333333333;0.479166666666667
Control.SRR15539829;49;45;0.428571428571429;28;21;0.0714285714285715;0.428571428571429
Control.SRR15539829;44;45;0.568181818181818;19;25;0.0681818181818182;0.431818181818182
Control.SRR15539829;42;45;0.452380952380952;23;19;0.0476190476190476;0.452380952380952
Control.SRR15539829;39;45;0.461538461538462;21;18;0.0384615384615384;0.461538461538462
Control.SRR15539829;39;45;0.41025641025641;23;16;0.0897435897435898;0.41025641025641
Control.SRR15539829;42;45;0.619047619047619;16;26;0.119047619047619;0.380952380952381
Control.SRR15539829;39;45;0.41025641025641;23;16;0.0897435897435898;0.41025641025641
Control.SRR15539829;43;45;0.465116279069767;23;20;0.0348837209302326;0.465116279069767
Control.SRR15539829;41;45;0.365853658536585;26;15;0.134146341463415;0.365853658536585
Control.SRR15539829;42;45;0.523809523809524;20;22;0.0238095238095238;0.476190476190476
Control.SRR15539829;50;45;0.58;21;29;0.08;0.42
Control.SRR15539829;44;45;0.545454545454545;20;24;0.0454545454545454;0.454545454545455
Control.SRR15539829;50;45;0.56;22;28;0.0600000000000001;0.44
Control.SRR15539829;44;45;0.454545454545455;24;20;0.0454545454545455;0.454545454545455
Control.SRR15539829;43;45;0.558139534883721;19;24;0.0581395348837209;0.441860465116279
Control.SRR15539829;43;45;0.558139534883721;19;24;0.0581395348837209;0.441860465116279
Control.SRR15539829;45;45;0.488888888888889;23;22;0.0111111111111111;0.488888888888889
Control.SRR15539829;45;45;0.622222222222222;17;28;0.122222222222222;0.377777777777778
Control.SRR15539829;38;45;0.473684210526316;20;18;0.0263157894736842;0.473684210526316
Control.SRR15539829;49;45;0.612244897959184;19;30;0.112244897959184;0.387755102040816
Control.SRR15539829;49;45;0.448979591836735;27;22;0.0510204081632653;0.448979591836735
Control.SRR15539829;44;45;0.522727272727273;21;23;0.0227272727272727;0.477272727272727
Control.SRR15539829;39;45;0.538461538461538;18;21;0.0384615384615384;0.461538461538462
Control.SRR15539829;38;45;0.526315789473684;18;20;0.0263157894736842;0.473684210526316
Control.SRR15539829;44;45;0.545454545454545;20;24;0.0454545454545454;0.454545454545455
Control.SRR15539829;42;45;0.476190476190476;22;20;0.0238095238095238;0.476190476190476
Control.SRR15539829;42;45;0.404761904761905;25;17;0.0952380952380952;0.404761904761905
Control.SRR15539829;49;45;0.571428571428571;21;28;0.0714285714285714;0.428571428571429
Control.SRR15539829;47;45;0.659574468085106;16;31;0.159574468085106;0.340425531914894
Control.SRR15539829;41;45;0.585365853658537;17;24;0.0853658536585366;0.414634146341463
Control.SRR15539829;42;45;0.428571428571429;24;18;0.0714285714285715;0.428571428571429
Control.SRR15539829;50;45;0.44;28;22;0.06;0.44
Control.SRR15539829;49;45;0.530612244897959;23;26;0.0306122448979592;0.469387755102041
Control.SRR15539829;41;45;0.560975609756098;18;23;0.0609756097560976;0.439024390243902
Control.SRR15539829;49;45;0.408163265306122;29;20;0.0918367346938775;0.408163265306122
Control.SRR15539829;48;45;0.541666666666667;22;26;0.0416666666666666;0.458333333333333
Control.SRR15539829;41;45;0.51219512195122;20;21;0.0121951219512195;0.48780487804878
Control.SRR15539829;48;45;0.458333333333333;26;22;0.0416666666666667;0.458333333333333
Control.SRR15539829;41;45;0.414634146341463;24;17;0.0853658536585366;0.414634146341463
Control.SRR15539829;39;45;0.512820512820513;19;20;0.0128205128205128;0.487179487179487
Control.SRR15539829;44;45;0.659090909090909;15;29;0.159090909090909;0.340909090909091
Control.SRR15539829;44;45;0.5;22;22;0;0.5
Control.SRR15539829;40;45;0.575;17;23;0.075;0.425
Control.SRR15539829;43;45;0.581395348837209;18;25;0.0813953488372093;0.418604651162791
Control.SRR15539829;50;45;0.54;23;27;0.04;0.46
Control.SRR15539829;43;45;0.418604651162791;25;18;0.0813953488372093;0.418604651162791
Control.SRR15539829;45;45;0.355555555555556;29;16;0.144444444444444;0.355555555555556
Control.SRR15539829;45;45;0.355555555555556;29;16;0.144444444444444;0.355555555555556
Control.SRR15539829;49;45;0.510204081632653;24;25;0.0102040816326531;0.489795918367347
Control.SRR15539829;40;45;0.475;21;19;0.025;0.475
Control.SRR15539829;43;45;0.395348837209302;26;17;0.104651162790698;0.395348837209302
Control.SRR15539829;38;45;0.473684210526316;20;18;0.0263157894736842;0.473684210526316
Control.SRR15539829;49;45;0.510204081632653;24;25;0.0102040816326531;0.489795918367347
Control.SRR15539829;49;45;0.36734693877551;31;18;0.13265306122449;0.36734693877551
Control.SRR15539829;39;45;0.564102564102564;17;22;0.0641025641025641;0.435897435897436
Control.SRR15539829;45;45;0.466666666666667;24;21;0.0333333333333333;0.466666666666667
Control.SRR15539829;44;45;0.477272727272727;23;21;0.0227272727272727;0.477272727272727
Control.SRR15539829;44;45;0.431818181818182;25;19;0.0681818181818182;0.431818181818182
Control.SRR15539829;46;45;0.521739130434783;22;24;0.0217391304347826;0.478260869565217
Control.SRR15539829;42;45;0.5;21;21;0;0.5
Control.SRR15539829;46;45;0.521739130434783;22;24;0.0217391304347826;0.478260869565217
Control.SRR15539829;47;45;0.617021276595745;18;29;0.117021276595745;0.382978723404255
Control.SRR15539829;41;45;0.560975609756098;18;23;0.0609756097560976;0.439024390243902
Control.SRR15539829;38;45;0.578947368421053;16;22;0.0789473684210527;0.421052631578947
Control.SRR15539829;42;45;0.547619047619048;19;23;0.0476190476190477;0.452380952380952
Control.SRR15539829;40;45;0.5;20;20;0;0.5
Control.SRR15539829;45;45;0.444444444444444;25;20;0.0555555555555556;0.444444444444444
Control.SRR15539829;50;45;0.38;31;19;0.12;0.38
Control.SRR15539829;49;45;0.408163265306122;29;20;0.0918367346938775;0.408163265306122
Control.SRR15539829;40;45;0.5;20;20;0;0.5
Control.SRR15539829;39;45;0.487179487179487;20;19;0.0128205128205128;0.487179487179487
Control.SRR15539829;42;45;0.595238095238095;17;25;0.0952380952380952;0.404761904761905
Control.SRR15539829;46;45;0.456521739130435;25;21;0.0434782608695652;0.456521739130435
Control.SRR15539829;44;45;0.5;22;22;0;0.5
Control.SRR15539829;44;45;0.409090909090909;26;18;0.0909090909090909;0.409090909090909
Control.SRR15539829;38;45;0.473684210526316;20;18;0.0263157894736842;0.473684210526316
Control.SRR15539829;40;45;0.525;19;21;0.025;0.475
Control.SRR15539829;49;45;0.469387755102041;26;23;0.0306122448979592;0.469387755102041
Control.SRR15539829;45;45;0.488888888888889;23;22;0.0111111111111111;0.488888888888889
Control.SRR15539829;46;45;0.434782608695652;26;20;0.0652173913043478;0.434782608695652
Control.SRR15539829;40;45;0.475;21;19;0.025;0.475
Control.SRR15539829;40;45;0.35;26;14;0.15;0.35
Control.SRR15539829;43;45;0.395348837209302;26;17;0.104651162790698;0.395348837209302
Control.SRR15539829;47;45;0.553191489361702;21;26;0.0531914893617021;0.446808510638298
Control.SRR15539829;47;45;0.51063829787234;23;24;0.0106382978723404;0.48936170212766
Control.SRR15539829;43;45;0.488372093023256;22;21;0.0116279069767442;0.488372093023256
Control.SRR15539829;43;45;0.395348837209302;26;17;0.104651162790698;0.395348837209302
Control.SRR15539829;41;45;0.463414634146341;22;19;0.0365853658536585;0.463414634146341
Control.SRR15539829;43;45;0.534883720930233;20;23;0.0348837209302325;0.465116279069767
Control.SRR15539829;48;45;0.520833333333333;23;25;0.0208333333333334;0.479166666666667
Control.SRR15539829;39;45;0.58974358974359;16;23;0.0897435897435898;0.41025641025641
Control.SRR15539829;38;45;0.552631578947368;17;21;0.0526315789473685;0.447368421052632
Control.SRR15539829;45;45;0.488888888888889;23;22;0.0111111111111111;0.488888888888889
Control.SRR15539829;42;45;0.642857142857143;15;27;0.142857142857143;0.357142857142857
Control.SRR15539829;45;45;0.488888888888889;23;22;0.0111111111111111;0.488888888888889
Control.SRR15539829;41;45;0.48780487804878;21;20;0.0121951219512195;0.48780487804878
Control.SRR15539829;45;45;0.444444444444444;25;20;0.0555555555555556;0.444444444444444
Control.SRR15539829;41;45;0.51219512195122;20;21;0.0121951219512195;0.48780487804878
Control.SRR15539829;50;45;0.58;21;29;0.08;0.42
Control.SRR15539829;43;45;0.581395348837209;18;25;0.0813953488372093;0.418604651162791
Control.SRR15539829;42;45;0.476190476190476;22;20;0.0238095238095238;0.476190476190476
Control.SRR15539829;47;45;0.51063829787234;23;24;0.0106382978723404;0.48936170212766
Control.SRR15539829;41;45;0.560975609756098;18;23;0.0609756097560976;0.439024390243902
Control.SRR15539829;46;45;0.369565217391304;29;17;0.130434782608696;0.369565217391304
Control.SRR15539829;45;45;0.533333333333333;21;24;0.0333333333333333;0.466666666666667
Control.SRR15539829;42;45;0.547619047619048;19;23;0.0476190476190477;0.452380952380952
Control.SRR15539829;41;45;0.51219512195122;20;21;0.0121951219512195;0.48780487804878
Control.SRR15539829;46;45;0.5;23;23;0;0.5
Control.SRR15539829;48;45;0.375;30;18;0.125;0.375
Control.SRR15539829;46;45;0.434782608695652;26;20;0.0652173913043478;0.434782608695652
Control.SRR15539829;38;45;0.5;19;19;0;0.5
Control.SRR15539829;49;45;0.448979591836735;27;22;0.0510204081632653;0.448979591836735
Control.SRR15539829;40;45;0.625;15;25;0.125;0.375
Control.SRR15539829;48;45;0.4375;27;21;0.0625;0.4375
Control.SRR15539829;46;45;0.543478260869565;21;25;0.0434782608695652;0.456521739130435
Control.SRR15539829;45;45;0.555555555555556;20;25;0.0555555555555556;0.444444444444444
Control.SRR15539829;39;45;0.461538461538462;21;18;0.0384615384615384;0.461538461538462
Control.SRR15539829;45;45;0.533333333333333;21;24;0.0333333333333333;0.466666666666667
Control.SRR15539829;49;45;0.346938775510204;32;17;0.153061224489796;0.346938775510204
Control.SRR15539829;40;45;0.6;16;24;0.1;0.4
Control.SRR15539829;41;45;0.609756097560976;16;25;0.109756097560976;0.390243902439024
Control.SRR15539829;39;45;0.461538461538462;21;18;0.0384615384615384;0.461538461538462
Control.SRR15539829;46;45;0.5;23;23;0;0.5
Control.SRR15539829;43;45;0.418604651162791;25;18;0.0813953488372093;0.418604651162791
Control.SRR15539829;46;45;0.521739130434783;22;24;0.0217391304347826;0.478260869565217
Control.SRR15539829;38;45;0.526315789473684;18;20;0.0263157894736842;0.473684210526316
Control.SRR15539829;43;45;0.488372093023256;22;21;0.0116279069767442;0.488372093023256
Control.SRR15539829;44;45;0.5;22;22;0;0.5
Control.SRR15539829;41;45;0.585365853658537;17;24;0.0853658536585366;0.414634146341463
Control.SRR15539829;40;45;0.575;17;23;0.075;0.425
Control.SRR15539829;38;45;0.473684210526316;20;18;0.0263157894736842;0.473684210526316
Control.SRR15539829;43;45;0.581395348837209;18;25;0.0813953488372093;0.418604651162791
Control.SRR15539829;39;45;0.487179487179487;20;19;0.0128205128205128;0.487179487179487
Control.SRR15539829;46;45;0.565217391304348;20;26;0.0652173913043478;0.434782608695652
Control.SRR15539829;48;45;0.479166666666667;25;23;0.0208333333333333;0.479166666666667
Control.SRR15539829;45;45;0.555555555555556;20;25;0.0555555555555556;0.444444444444444
Control.SRR15539829;43;45;0.418604651162791;25;18;0.0813953488372093;0.418604651162791
Control.SRR15539829;47;45;0.574468085106383;20;27;0.074468085106383;0.425531914893617
Control.SRR15539829;40;45;0.5;20;20;0;0.5
Control.SRR15539829;42;45;0.5;21;21;0;0.5
Control.SRR15539829;48;45;0.458333333333333;26;22;0.0416666666666667;0.458333333333333
Control.SRR15539829;42;45;0.547619047619048;19;23;0.0476190476190477;0.452380952380952
Control.SRR15539829;50;45;0.62;19;31;0.12;0.38
Control.SRR15539829;50;45;0.44;28;22;0.06;0.44
Control.SRR15539829;43;45;0.720930232558139;12;31;0.220930232558139;0.27906976744186
Control.SRR15539829;48;45;0.3125;33;15;0.1875;0.3125
Control.SRR15539829;39;45;0.487179487179487;20;19;0.0128205128205128;0.487179487179487
Control.SRR15539829;49;45;0.469387755102041;26;23;0.0306122448979592;0.469387755102041
Control.SRR15539829;48;45;0.583333333333333;20;28;0.0833333333333334;0.416666666666667
Control.SRR15539829;41;45;0.48780487804878;21;20;0.0121951219512195;0.48780487804878
Control.SRR15539829;47;45;0.531914893617021;22;25;0.0319148936170213;0.468085106382979
Control.SRR15539829;50;45;0.5;25;25;0;0.5
Control.SRR15539829;45;45;0.555555555555556;20;25;0.0555555555555556;0.444444444444444
Control.SRR15539829;45;45;0.555555555555556;20;25;0.0555555555555556;0.444444444444444
Control.SRR15539829;44;45;0.454545454545455;24;20;0.0454545454545455;0.454545454545455
Control.SRR15539829;42;45;0.547619047619048;19;23;0.0476190476190477;0.452380952380952
Control.SRR15539829;47;45;0.468085106382979;25;22;0.0319148936170213;0.468085106382979
Control.SRR15539829;47;45;0.574468085106383;20;27;0.074468085106383;0.425531914893617
Control.SRR15539829;45;45;0.466666666666667;24;21;0.0333333333333333;0.466666666666667
Control.SRR15539829;41;45;0.24390243902439;31;10;0.25609756097561;0.24390243902439
Control.SRR15539829;48;45;0.4375;27;21;0.0625;0.4375
Control.SRR15539829;40;45;0.375;25;15;0.125;0.375
Control.SRR15539829;46;45;0.434782608695652;26;20;0.0652173913043478;0.434782608695652
Control.SRR15539829;41;45;0.609756097560976;16;25;0.109756097560976;0.390243902439024
Control.SRR15539829;42;45;0.547619047619048;19;23;0.0476190476190477;0.452380952380952
Control.SRR15539829;41;45;0.48780487804878;21;20;0.0121951219512195;0.48780487804878
Control.SRR15539829;43;45;0.418604651162791;25;18;0.0813953488372093;0.418604651162791
Control.SRR15539829;38;45;0.342105263157895;25;13;0.157894736842105;0.342105263157895
Control.SRR15539829;41;45;0.341463414634146;27;14;0.158536585365854;0.341463414634146
Control.SRR15539829;38;45;0.473684210526316;20;18;0.0263157894736842;0.473684210526316
Control.SRR15539829;38;45;0.447368421052632;21;17;0.0526315789473684;0.447368421052632
Control.SRR15539829;45;45;0.466666666666667;24;21;0.0333333333333333;0.466666666666667
Control.SRR15539829;40;45;0.325;27;13;0.175;0.325
Control.SRR15539829;44;45;0.590909090909091;18;26;0.0909090909090909;0.409090909090909
Control.SRR15539829;40;45;0.55;18;22;0.05;0.45
Control.SRR15539829;38;45;0.605263157894737;15;23;0.105263157894737;0.394736842105263
Control.SRR15539829;39;45;0.58974358974359;16;23;0.0897435897435898;0.41025641025641
Control.SRR15539829;40;45;0.45;22;18;0.05;0.45
Control.SRR15539829;40;45;0.45;22;18;0.05;0.45
Control.SRR15539829;39;45;0.384615384615385;24;15;0.115384615384615;0.384615384615385
Control.SRR15539829;41;45;0.634146341463415;15;26;0.134146341463415;0.365853658536585
Control.SRR15539829;39;45;0.512820512820513;19;20;0.0128205128205128;0.487179487179487
Control.SRR15539829;43;45;0.465116279069767;23;20;0.0348837209302326;0.465116279069767
Control.SRR15539829;42;45;0.476190476190476;22;20;0.0238095238095238;0.476190476190476
Control.SRR15539829;45;45;0.422222222222222;26;19;0.0777777777777778;0.422222222222222
Control.SRR15539829;45;45;0.555555555555556;20;25;0.0555555555555556;0.444444444444444
Control.SRR15539829;40;45;0.5;20;20;0;0.5
Control.SRR15539829;38;45;0.552631578947368;17;21;0.0526315789473685;0.447368421052632
Control.SRR15539829;47;45;0.595744680851064;19;28;0.0957446808510638;0.404255319148936
Control.SRR15539829;38;45;0.526315789473684;18;20;0.0263157894736842;0.473684210526316
Control.SRR15539829;48;45;0.458333333333333;26;22;0.0416666666666667;0.458333333333333
Control.SRR15539829;48;45;0.541666666666667;22;26;0.0416666666666666;0.458333333333333
Control.SRR15539829;44;45;0.545454545454545;20;24;0.0454545454545454;0.454545454545455
Control.SRR15539829;50;45;0.64;18;32;0.14;0.36
Control.SRR15539829;44;45;0.590909090909091;18;26;0.0909090909090909;0.409090909090909
Control.SRR15539829;38;45;0.473684210526316;20;18;0.0263157894736842;0.473684210526316
Control.SRR15539829;43;45;0.441860465116279;24;19;0.0581395348837209;0.441860465116279
Control.SRR15539829;48;45;0.458333333333333;26;22;0.0416666666666667;0.458333333333333
Control.SRR15539829;50;45;0.36;32;18;0.14;0.36
Control.SRR15539829;46;45;0.434782608695652;26;20;0.0652173913043478;0.434782608695652
Control.SRR15539829;40;45;0.45;22;18;0.05;0.45
Control.SRR15539829;42;45;0.333333333333333;28;14;0.166666666666667;0.333333333333333
Control.SRR15539829;48;45;0.5625;21;27;0.0625;0.4375
Control.SRR15539829;47;45;0.553191489361702;21;26;0.0531914893617021;0.446808510638298
Control.SRR15539829;47;45;0.382978723404255;29;18;0.117021276595745;0.382978723404255
Control.SRR15539829;48;45;0.458333333333333;26;22;0.0416666666666667;0.458333333333333
Control.SRR15539829;47;45;0.361702127659574;30;17;0.138297872340426;0.361702127659574
Control.SRR15539829;39;45;0.538461538461538;18;21;0.0384615384615384;0.461538461538462
Control.SRR15539829;40;45;0.475;21;19;0.025;0.475
Control.SRR15539829;49;45;0.428571428571429;28;21;0.0714285714285715;0.428571428571429
Control.SRR15539829;41;45;0.560975609756098;18;23;0.0609756097560976;0.439024390243902
Control.SRR15539829;44;45;0.363636363636364;28;16;0.136363636363636;0.363636363636364
Control.SRR15539829;48;45;0.5;24;24;0;0.5
Control.SRR15539829;44;45;0.545454545454545;20;24;0.0454545454545454;0.454545454545455
Control.SRR15539829;41;45;0.560975609756098;18;23;0.0609756097560976;0.439024390243902
Control.SRR15539829;45;45;0.444444444444444;25;20;0.0555555555555556;0.444444444444444
Control.SRR15539829;41;45;0.536585365853659;19;22;0.0365853658536586;0.463414634146341
Control.SRR15539829;47;45;0.51063829787234;23;24;0.0106382978723404;0.48936170212766
Control.SRR15539829;45;45;0.488888888888889;23;22;0.0111111111111111;0.488888888888889
Control.SRR15539829;47;45;0.446808510638298;26;21;0.0531914893617021;0.446808510638298
Control.SRR15539829;46;45;0.456521739130435;25;21;0.0434782608695652;0.456521739130435
Control.SRR15539829;44;45;0.477272727272727;23;21;0.0227272727272727;0.477272727272727
Control.SRR15539829;44;45;0.5;22;22;0;0.5
Control.SRR15539829;49;45;0.387755102040816;30;19;0.112244897959184;0.387755102040816
Control.SRR15539829;49;45;0.387755102040816;30;19;0.112244897959184;0.387755102040816
Control.SRR15539829;45;45;0.6;18;27;0.1;0.4
Control.SRR15539829;44;45;0.522727272727273;21;23;0.0227272727272727;0.477272727272727
Control.SRR15539829;48;45;0.541666666666667;22;26;0.0416666666666666;0.458333333333333
Control.SRR15539829;48;45;0.479166666666667;25;23;0.0208333333333333;0.479166666666667
Control.SRR15539829;45;45;0.355555555555556;29;16;0.144444444444444;0.355555555555556
Control.SRR15539829;46;45;0.434782608695652;26;20;0.0652173913043478;0.434782608695652
Control.SRR15539829;41;45;0.51219512195122;20;21;0.0121951219512195;0.48780487804878
Control.SRR15539829;48;45;0.5625;21;27;0.0625;0.4375
Control.SRR15539829;39;45;0.461538461538462;21;18;0.0384615384615384;0.461538461538462
Control.SRR15539829;43;45;0.558139534883721;19;24;0.0581395348837209;0.441860465116279
Control.SRR15539829;48;45;0.541666666666667;22;26;0.0416666666666666;0.458333333333333
Control.SRR15539829;49;45;0.408163265306122;29;20;0.0918367346938775;0.408163265306122
Control.SRR15539829;38;45;0.5;19;19;0;0.5
Control.SRR15539829;41;45;0.390243902439024;25;16;0.109756097560976;0.390243902439024
Control.SRR15539829;42;45;0.523809523809524;20;22;0.0238095238095238;0.476190476190476
Control.SRR15539829;45;45;0.466666666666667;24;21;0.0333333333333333;0.466666666666667
Control.SRR15539829;40;45;0.425;23;17;0.075;0.425
Control.SRR15539829;48;45;0.458333333333333;26;22;0.0416666666666667;0.458333333333333
Control.SRR15539829;47;45;0.574468085106383;20;27;0.074468085106383;0.425531914893617
Control.SRR15539829;40;45;0.525;19;21;0.025;0.475
Control.SRR15539829;39;45;0.512820512820513;19;20;0.0128205128205128;0.487179487179487
Control.SRR15539829;50;45;0.44;28;22;0.06;0.44
Control.SRR15539829;38;45;0.5;19;19;0;0.5
Control.SRR15539829;42;45;0.476190476190476;22;20;0.0238095238095238;0.476190476190476
Control.SRR15539829;44;45;0.5;22;22;0;0.5
Control.SRR15539829;45;45;0.466666666666667;24;21;0.0333333333333333;0.466666666666667
Control.SRR15539829;46;45;0.543478260869565;21;25;0.0434782608695652;0.456521739130435
Control.SRR15539829;41;45;0.609756097560976;16;25;0.109756097560976;0.390243902439024
Control.SRR15539829;44;45;0.477272727272727;23;21;0.0227272727272727;0.477272727272727
Control.SRR15539829;43;45;0.558139534883721;19;24;0.0581395348837209;0.441860465116279
Control.SRR15539829;41;45;0.292682926829268;29;12;0.207317073170732;0.292682926829268
Control.SRR15539829;45;45;0.533333333333333;21;24;0.0333333333333333;0.466666666666667
Control.SRR15539829;42;45;0.380952380952381;26;16;0.119047619047619;0.380952380952381
Control.SRR15539829;44;45;0.613636363636364;17;27;0.113636363636364;0.386363636363636
Control.SRR15539829;45;45;0.6;18;27;0.1;0.4
Control.SRR15539829;44;45;0.545454545454545;20;24;0.0454545454545454;0.454545454545455
Control.SRR15539829;41;45;0.439024390243902;23;18;0.0609756097560976;0.439024390243902
Control.SRR15539829;40;45;0.525;19;21;0.025;0.475
Control.SRR15539829;44;45;0.477272727272727;23;21;0.0227272727272727;0.477272727272727
Control.SRR15539829;38;45;0.421052631578947;22;16;0.0789473684210527;0.421052631578947
Control.SRR15539829;45;45;0.511111111111111;22;23;0.0111111111111111;0.488888888888889
Control.SRR15539829;50;45;0.42;29;21;0.08;0.42
Control.SRR15539829;40;45;0.6;16;24;0.1;0.4
Control.SRR15539829;40;45;0.4;24;16;0.1;0.4
Control.SRR15539829;41;45;0.48780487804878;21;20;0.0121951219512195;0.48780487804878
Control.SRR15539829;44;45;0.636363636363636;16;28;0.136363636363636;0.363636363636364
Control.SRR15539829;38;45;0.552631578947368;17;21;0.0526315789473685;0.447368421052632
Control.SRR15539829;44;45;0.659090909090909;15;29;0.159090909090909;0.340909090909091
Control.SRR15539829;46;45;0.58695652173913;19;27;0.0869565217391305;0.41304347826087
Control.SRR15539829;39;45;0.487179487179487;20;19;0.0128205128205128;0.487179487179487
Control.SRR15539829;40;45;0.5;20;20;0;0.5
Control.SRR15539829;39;45;0.512820512820513;19;20;0.0128205128205128;0.487179487179487
Control.SRR15539829;44;45;0.431818181818182;25;19;0.0681818181818182;0.431818181818182
Control.SRR15539829;39;45;0.333333333333333;26;13;0.166666666666667;0.333333333333333
Control.SRR15539829;43;45;0.581395348837209;18;25;0.0813953488372093;0.418604651162791
Control.SRR15539829;45;45;0.333333333333333;30;15;0.166666666666667;0.333333333333333
Control.SRR15539829;48;45;0.479166666666667;25;23;0.0208333333333333;0.479166666666667
Control.SRR15539829;47;45;0.48936170212766;24;23;0.0106382978723404;0.48936170212766
Control.SRR15539829;50;45;0.38;31;19;0.12;0.38
Control.SRR15539829;47;45;0.425531914893617;27;20;0.074468085106383;0.425531914893617
Control.SRR15539829;41;45;0.48780487804878;21;20;0.0121951219512195;0.48780487804878
Control.SRR15539829;41;45;0.560975609756098;18;23;0.0609756097560976;0.439024390243902
Control.SRR15539829;49;45;0.63265306122449;18;31;0.13265306122449;0.36734693877551
Control.SRR15539829;49;45;0.448979591836735;27;22;0.0510204081632653;0.448979591836735
Control.SRR15539829;42;45;0.523809523809524;20;22;0.0238095238095238;0.476190476190476
Control.SRR15539829;45;45;0.444444444444444;25;20;0.0555555555555556;0.444444444444444
Control.SRR15539829;48;45;0.520833333333333;23;25;0.0208333333333334;0.479166666666667
Control.SRR15539829;41;45;0.414634146341463;24;17;0.0853658536585366;0.414634146341463
Control.SRR15539829;45;45;0.555555555555556;20;25;0.0555555555555556;0.444444444444444
Control.SRR15539829;50;45;0.54;23;27;0.04;0.46
Control.SRR15539829;46;45;0.521739130434783;22;24;0.0217391304347826;0.478260869565217
Control.SRR15539829;41;45;0.51219512195122;20;21;0.0121951219512195;0.48780487804878
Control.SRR15539829;47;45;0.51063829787234;23;24;0.0106382978723404;0.48936170212766
Control.SRR15539829;46;45;0.41304347826087;27;19;0.0869565217391304;0.41304347826087
Control.SRR15539829;41;45;0.51219512195122;20;21;0.0121951219512195;0.48780487804878
Control.SRR15539829;38;45;0.526315789473684;18;20;0.0263157894736842;0.473684210526316
Control.SRR15539829;40;45;0.45;22;18;0.05;0.45
Control.SRR15539829;39;45;0.435897435897436;22;17;0.0641025641025641;0.435897435897436
Control.SRR15539829;46;45;0.434782608695652;26;20;0.0652173913043478;0.434782608695652
Control.SRR15539829;42;45;0.452380952380952;23;19;0.0476190476190476;0.452380952380952
Control.SRR15539829;39;45;0.41025641025641;23;16;0.0897435897435898;0.41025641025641
Control.SRR15539829;43;45;0.534883720930233;20;23;0.0348837209302325;0.465116279069767
Control.SRR15539829;41;45;0.48780487804878;21;20;0.0121951219512195;0.48780487804878
Control.SRR15539829;45;45;0.666666666666667;15;30;0.166666666666667;0.333333333333333
Control.SRR15539829;45;45;0.577777777777778;19;26;0.0777777777777777;0.422222222222222
Control.SRR15539829;46;45;0.565217391304348;20;26;0.0652173913043478;0.434782608695652
Control.SRR15539829;48;45;0.604166666666667;19;29;0.104166666666667;0.395833333333333
Control.SRR15539829;49;45;0.469387755102041;26;23;0.0306122448979592;0.469387755102041
Control.SRR15539829;46;45;0.543478260869565;21;25;0.0434782608695652;0.456521739130435
Control.SRR15539829;42;45;0.523809523809524;20;22;0.0238095238095238;0.476190476190476
Control.SRR15539829;45;45;0.466666666666667;24;21;0.0333333333333333;0.466666666666667
Control.SRR15539829;43;45;0.465116279069767;23;20;0.0348837209302326;0.465116279069767
Control.SRR15539829;47;45;0.531914893617021;22;25;0.0319148936170213;0.468085106382979
Control.SRR15539829;48;45;0.5625;21;27;0.0625;0.4375
Control.SRR15539829;40;45;0.475;21;19;0.025;0.475
Control.SRR15539829;40;45;0.5;20;20;0;0.5
Control.SRR15539829;40;45;0.5;20;20;0;0.5
Control.SRR15539829;49;45;0.510204081632653;24;25;0.0102040816326531;0.489795918367347
Control.SRR15539829;42;45;0.5;21;21;0;0.5
Control.SRR15539829;41;45;0.390243902439024;25;16;0.109756097560976;0.390243902439024
Control.SRR15539829;44;45;0.5;22;22;0;0.5
Control.SRR15539829;46;45;0.434782608695652;26;20;0.0652173913043478;0.434782608695652
Control.SRR15539829;41;45;0.439024390243902;23;18;0.0609756097560976;0.439024390243902
Control.SRR15539829;47;45;0.553191489361702;21;26;0.0531914893617021;0.446808510638298
Control.SRR15539829;39;45;0.564102564102564;17;22;0.0641025641025641;0.435897435897436
Control.SRR15539829;41;45;0.585365853658537;17;24;0.0853658536585366;0.414634146341463
Control.SRR15539829;46;45;0.41304347826087;27;19;0.0869565217391304;0.41304347826087
Control.SRR15539829;43;45;0.534883720930233;20;23;0.0348837209302325;0.465116279069767
Control.SRR15539829;38;45;0.473684210526316;20;18;0.0263157894736842;0.473684210526316
Control.SRR15539829;38;45;0.394736842105263;23;15;0.105263157894737;0.394736842105263
Control.SRR15539829;39;45;0.512820512820513;19;20;0.0128205128205128;0.487179487179487
Control.SRR15539829;44;45;0.431818181818182;25;19;0.0681818181818182;0.431818181818182
Control.SRR15539829;49;45;0.510204081632653;24;25;0.0102040816326531;0.489795918367347
Control.SRR15539829;49;45;0.489795918367347;25;24;0.0102040816326531;0.489795918367347
Control.SRR15539829;48;45;0.333333333333333;32;16;0.166666666666667;0.333333333333333
Control.SRR15539829;45;45;0.355555555555556;29;16;0.144444444444444;0.355555555555556
Control.SRR15539829;41;45;0.609756097560976;16;25;0.109756097560976;0.390243902439024
Control.SRR15539829;42;45;0.5;21;21;0;0.5
Control.SRR15539829;43;45;0.558139534883721;19;24;0.0581395348837209;0.441860465116279
Control.SRR15539829;47;45;0.595744680851064;19;28;0.0957446808510638;0.404255319148936
Control.SRR15539829;44;45;0.636363636363636;16;28;0.136363636363636;0.363636363636364
Control.SRR15539829;48;45;0.479166666666667;25;23;0.0208333333333333;0.479166666666667
Control.SRR15539829;50;45;0.38;31;19;0.12;0.38
Control.SRR15539829;38;45;0.5;19;19;0;0.5
Control.SRR15539829;42;45;0.428571428571429;24;18;0.0714285714285715;0.428571428571429
Control.SRR15539829;50;45;0.54;23;27;0.04;0.46
Control.SRR15539829;39;45;0.512820512820513;19;20;0.0128205128205128;0.487179487179487
Control.SRR15539829;45;45;0.355555555555556;29;16;0.144444444444444;0.355555555555556
Control.SRR15539829;39;45;0.512820512820513;19;20;0.0128205128205128;0.487179487179487
Control.SRR15539829;43;45;0.558139534883721;19;24;0.0581395348837209;0.441860465116279
Control.SRR15539829;50;45;0.5;25;25;0;0.5
Control.SRR15539829;45;45;0.466666666666667;24;21;0.0333333333333333;0.466666666666667
Control.SRR15539829;47;45;0.446808510638298;26;21;0.0531914893617021;0.446808510638298
Control.SRR15539829;48;45;0.479166666666667;25;23;0.0208333333333333;0.479166666666667
Control.SRR15539829;41;45;0.48780487804878;21;20;0.0121951219512195;0.48780487804878
Control.SRR15539829;50;45;0.5;25;25;0;0.5
Control.SRR15539829;44;45;0.545454545454545;20;24;0.0454545454545454;0.454545454545455
Control.SRR15539829;45;45;0.555555555555556;20;25;0.0555555555555556;0.444444444444444
Control.SRR15539829;41;45;0.390243902439024;25;16;0.109756097560976;0.390243902439024
Control.SRR15539829;44;45;0.431818181818182;25;19;0.0681818181818182;0.431818181818182
Control.SRR15539829;38;45;0.473684210526316;20;18;0.0263157894736842;0.473684210526316
Control.SRR15539829;42;45;0.547619047619048;19;23;0.0476190476190477;0.452380952380952
Control.SRR15539829;42;45;0.5;21;21;0;0.5
Control.SRR15539829;50;45;0.56;22;28;0.0600000000000001;0.44
Control.SRR15539829;49;45;0.469387755102041;26;23;0.0306122448979592;0.469387755102041
Control.SRR15539829;41;45;0.341463414634146;27;14;0.158536585365854;0.341463414634146
Control.SRR15539829;42;45;0.452380952380952;23;19;0.0476190476190476;0.452380952380952
Control.SRR15539829;43;45;0.511627906976744;21;22;0.0116279069767442;0.488372093023256
Control.SRR15539829;49;45;0.571428571428571;21;28;0.0714285714285714;0.428571428571429
Control.SRR15539829;43;45;0.441860465116279;24;19;0.0581395348837209;0.441860465116279
Control.SRR15539829;42;45;0.452380952380952;23;19;0.0476190476190476;0.452380952380952
Control.SRR15539829;38;45;0.447368421052632;21;17;0.0526315789473684;0.447368421052632
Control.SRR15539829;42;45;0.595238095238095;17;25;0.0952380952380952;0.404761904761905
Control.SRR15539829;46;45;0.478260869565217;24;22;0.0217391304347826;0.478260869565217
Control.SRR15539829;45;45;0.555555555555556;20;25;0.0555555555555556;0.444444444444444
Control.SRR15539829;40;45;0.575;17;23;0.075;0.425
Control.SRR15539829;48;45;0.458333333333333;26;22;0.0416666666666667;0.458333333333333
Control.SRR15539829;43;45;0.418604651162791;25;18;0.0813953488372093;0.418604651162791
Control.SRR15539829;42;45;0.476190476190476;22;20;0.0238095238095238;0.476190476190476
Control.SRR15539829;41;45;0.536585365853659;19;22;0.0365853658536586;0.463414634146341
Control.SRR15539829;43;45;0.581395348837209;18;25;0.0813953488372093;0.418604651162791
Control.SRR15539829;44;45;0.568181818181818;19;25;0.0681818181818182;0.431818181818182
Control.SRR15539829;43;45;0.348837209302326;28;15;0.151162790697674;0.348837209302326
Control.SRR15539829;47;45;0.51063829787234;23;24;0.0106382978723404;0.48936170212766
Control.SRR15539829;48;45;0.5;24;24;0;0.5
Control.SRR15539829;46;45;0.5;23;23;0;0.5
Control.SRR15539829;42;45;0.547619047619048;19;23;0.0476190476190477;0.452380952380952
Control.SRR15539829;50;45;0.56;22;28;0.0600000000000001;0.44
Control.SRR15539829;41;45;0.560975609756098;18;23;0.0609756097560976;0.439024390243902
Control.SRR15539829;42;45;0.523809523809524;20;22;0.0238095238095238;0.476190476190476
Control.SRR15539829;41;45;0.536585365853659;19;22;0.0365853658536586;0.463414634146341
Control.SRR15539829;40;45;0.625;15;25;0.125;0.375
Control.SRR15539829;45;45;0.533333333333333;21;24;0.0333333333333333;0.466666666666667
Control.SRR15539829;41;45;0.51219512195122;20;21;0.0121951219512195;0.48780487804878
Control.SRR15539829;47;45;0.404255319148936;28;19;0.0957446808510639;0.404255319148936
Control.SRR15539829;39;45;0.512820512820513;19;20;0.0128205128205128;0.487179487179487
Control.SRR15539829;41;45;0.439024390243902;23;18;0.0609756097560976;0.439024390243902
Control.SRR15539829;38;45;0.526315789473684;18;20;0.0263157894736842;0.473684210526316
Control.SRR15539829;40;45;0.4;24;16;0.1;0.4
Control.SRR15539829;50;45;0.52;24;26;0.02;0.48
Control.SRR15539829;47;45;0.553191489361702;21;26;0.0531914893617021;0.446808510638298
Control.SRR15539829;46;45;0.521739130434783;22;24;0.0217391304347826;0.478260869565217
Control.SRR15539829;43;45;0.441860465116279;24;19;0.0581395348837209;0.441860465116279
Control.SRR15539829;48;45;0.729166666666667;13;35;0.229166666666667;0.270833333333333
Control.SRR15539829;38;45;0.526315789473684;18;20;0.0263157894736842;0.473684210526316
Control.SRR15539829;43;45;0.488372093023256;22;21;0.0116279069767442;0.488372093023256
Control.SRR15539829;44;45;0.545454545454545;20;24;0.0454545454545454;0.454545454545455
Control.SRR15539829;48;45;0.541666666666667;22;26;0.0416666666666666;0.458333333333333
Control.SRR15539829;49;45;0.551020408163265;22;27;0.0510204081632653;0.448979591836735
Control.SRR15539829;46;45;0.543478260869565;21;25;0.0434782608695652;0.456521739130435
Control.SRR15539829;47;45;0.51063829787234;23;24;0.0106382978723404;0.48936170212766
Control.SRR15539829;44;45;0.522727272727273;21;23;0.0227272727272727;0.477272727272727
Control.SRR15539829;49;45;0.551020408163265;22;27;0.0510204081632653;0.448979591836735
Control.SRR15539829;45;45;0.577777777777778;19;26;0.0777777777777777;0.422222222222222
Control.SRR15539829;48;45;0.458333333333333;26;22;0.0416666666666667;0.458333333333333
Control.SRR15539829;38;45;0.315789473684211;26;12;0.184210526315789;0.315789473684211
Control.SRR15539829;42;45;0.428571428571429;24;18;0.0714285714285715;0.428571428571429
Control.SRR15539829;39;45;0.615384615384615;15;24;0.115384615384615;0.384615384615385
Control.SRR15539829;40;45;0.35;26;14;0.15;0.35
Control.SRR15539829;46;45;0.608695652173913;18;28;0.108695652173913;0.391304347826087
Control.SRR15539829;38;45;0.552631578947368;17;21;0.0526315789473685;0.447368421052632
Control.SRR15539829;39;45;0.358974358974359;25;14;0.141025641025641;0.358974358974359
Control.SRR15539829;46;45;0.478260869565217;24;22;0.0217391304347826;0.478260869565217
Control.SRR15539829;45;45;0.6;18;27;0.1;0.4
Control.SRR15539829;46;45;0.717391304347826;13;33;0.217391304347826;0.282608695652174
Control.SRR15539829;39;45;0.41025641025641;23;16;0.0897435897435898;0.41025641025641
Control.SRR15539829;43;45;0.511627906976744;21;22;0.0116279069767442;0.488372093023256
Control.SRR15539829;49;45;0.551020408163265;22;27;0.0510204081632653;0.448979591836735
Control.SRR15539829;40;45;0.65;14;26;0.15;0.35
Control.SRR15539829;42;45;0.619047619047619;16;26;0.119047619047619;0.380952380952381
Control.SRR15539829;46;45;0.391304347826087;28;18;0.108695652173913;0.391304347826087
Control.SRR15539829;50;45;0.56;22;28;0.0600000000000001;0.44
Control.SRR15539829;42;45;0.380952380952381;26;16;0.119047619047619;0.380952380952381
Control.SRR15539829;45;45;0.466666666666667;24;21;0.0333333333333333;0.466666666666667
Control.SRR15539829;44;45;0.409090909090909;26;18;0.0909090909090909;0.409090909090909
Control.SRR15539829;43;45;0.558139534883721;19;24;0.0581395348837209;0.441860465116279
Control.SRR15539829;44;45;0.477272727272727;23;21;0.0227272727272727;0.477272727272727
Control.SRR15539829;45;45;0.555555555555556;20;25;0.0555555555555556;0.444444444444444
Control.SRR15539829;40;45;0.55;18;22;0.05;0.45
Control.SRR15539829;50;45;0.4;30;20;0.1;0.4
Control.SRR15539829;44;45;0.5;22;22;0;0.5
Control.SRR15539829;46;45;0.434782608695652;26;20;0.0652173913043478;0.434782608695652
Control.SRR15539829;44;45;0.454545454545455;24;20;0.0454545454545455;0.454545454545455
Control.SRR15539829;43;45;0.488372093023256;22;21;0.0116279069767442;0.488372093023256
Control.SRR15539829;40;45;0.4;24;16;0.1;0.4
Control.SRR15539829;49;45;0.510204081632653;24;25;0.0102040816326531;0.489795918367347
Control.SRR15539829;42;45;0.476190476190476;22;20;0.0238095238095238;0.476190476190476
Control.SRR15539829;47;45;0.531914893617021;22;25;0.0319148936170213;0.468085106382979
Control.SRR15539829;47;45;0.404255319148936;28;19;0.0957446808510639;0.404255319148936
Control.SRR15539829;48;45;0.520833333333333;23;25;0.0208333333333334;0.479166666666667
Control.SRR15539829;46;45;0.543478260869565;21;25;0.0434782608695652;0.456521739130435
Control.SRR15539829;44;45;0.5;22;22;0;0.5
Control.SRR15539829;46;45;0.456521739130435;25;21;0.0434782608695652;0.456521739130435
Control.SRR15539829;48;45;0.479166666666667;25;23;0.0208333333333333;0.479166666666667
Control.SRR15539829;41;45;0.609756097560976;16;25;0.109756097560976;0.390243902439024
Control.SRR15539829;44;45;0.568181818181818;19;25;0.0681818181818182;0.431818181818182
Control.SRR15539829;49;45;0.510204081632653;24;25;0.0102040816326531;0.489795918367347
Control.SRR15539829;42;45;0.404761904761905;25;17;0.0952380952380952;0.404761904761905
Control.SRR15539829;43;45;0.465116279069767;23;20;0.0348837209302326;0.465116279069767
Control.SRR15539829;44;45;0.340909090909091;29;15;0.159090909090909;0.340909090909091
Control.SRR15539829;39;45;0.538461538461538;18;21;0.0384615384615384;0.461538461538462
Control.SRR15539829;40;45;0.375;25;15;0.125;0.375
Control.SRR15539829;48;45;0.541666666666667;22;26;0.0416666666666666;0.458333333333333
Control.SRR15539829;50;45;0.52;24;26;0.02;0.48
Control.SRR15539829;43;45;0.511627906976744;21;22;0.0116279069767442;0.488372093023256
Control.SRR15539829;38;45;0.473684210526316;20;18;0.0263157894736842;0.473684210526316
Control.SRR15539829;40;45;0.475;21;19;0.025;0.475
Control.SRR15539829;46;45;0.521739130434783;22;24;0.0217391304347826;0.478260869565217
Control.SRR15539829;40;45;0.375;25;15;0.125;0.375
Control.SRR15539829;48;45;0.583333333333333;20;28;0.0833333333333334;0.416666666666667
Control.SRR15539829;46;45;0.434782608695652;26;20;0.0652173913043478;0.434782608695652
Control.SRR15539829;42;45;0.5;21;21;0;0.5
Control.SRR15539829;47;45;0.531914893617021;22;25;0.0319148936170213;0.468085106382979
Control.SRR15539829;43;45;0.488372093023256;22;21;0.0116279069767442;0.488372093023256
Control.SRR15539829;45;45;0.444444444444444;25;20;0.0555555555555556;0.444444444444444
Control.SRR15539829;42;45;0.476190476190476;22;20;0.0238095238095238;0.476190476190476
Control.SRR15539829;39;45;0.538461538461538;18;21;0.0384615384615384;0.461538461538462
Control.SRR15539829;44;45;0.568181818181818;19;25;0.0681818181818182;0.431818181818182
Control.SRR15539829;39;45;0.512820512820513;19;20;0.0128205128205128;0.487179487179487
Control.SRR15539829;38;45;0.447368421052632;21;17;0.0526315789473684;0.447368421052632
Control.SRR15539829;39;45;0.435897435897436;22;17;0.0641025641025641;0.435897435897436
Control.SRR15539829;38;45;0.473684210526316;20;18;0.0263157894736842;0.473684210526316
Control.SRR15539829;38;45;0.710526315789474;11;27;0.210526315789474;0.289473684210526
Control.SRR15539829;45;45;0.533333333333333;21;24;0.0333333333333333;0.466666666666667
Control.SRR15539829;48;45;0.479166666666667;25;23;0.0208333333333333;0.479166666666667
Control.SRR15539829;44;45;0.522727272727273;21;23;0.0227272727272727;0.477272727272727
Control.SRR15539829;49;45;0.428571428571429;28;21;0.0714285714285715;0.428571428571429
Control.SRR15539829;47;45;0.51063829787234;23;24;0.0106382978723404;0.48936170212766
Control.SRR15539829;49;45;0.387755102040816;30;19;0.112244897959184;0.387755102040816
Control.SRR15539829;41;45;0.463414634146341;22;19;0.0365853658536585;0.463414634146341
Control.SRR15539829;50;45;0.54;23;27;0.04;0.46
Control.SRR15539829;45;45;0.511111111111111;22;23;0.0111111111111111;0.488888888888889
Control.SRR15539829;43;45;0.511627906976744;21;22;0.0116279069767442;0.488372093023256
Control.SRR15539829;41;45;0.536585365853659;19;22;0.0365853658536586;0.463414634146341
Control.SRR15539829;43;45;0.488372093023256;22;21;0.0116279069767442;0.488372093023256
Control.SRR15539829;44;45;0.477272727272727;23;21;0.0227272727272727;0.477272727272727
Control.SRR15539829;42;45;0.571428571428571;18;24;0.0714285714285714;0.428571428571429
Control.SRR15539829;42;45;0.619047619047619;16;26;0.119047619047619;0.380952380952381
Control.SRR15539829;40;45;0.525;19;21;0.025;0.475
Control.SRR15539829;46;45;0.565217391304348;20;26;0.0652173913043478;0.434782608695652
Control.SRR15539829;45;45;0.533333333333333;21;24;0.0333333333333333;0.466666666666667
Control.SRR15539829;45;45;0.511111111111111;22;23;0.0111111111111111;0.488888888888889
Control.SRR15539829;48;45;0.5;24;24;0;0.5
Control.SRR15539829;44;45;0.522727272727273;21;23;0.0227272727272727;0.477272727272727
Control.SRR15539829;41;45;0.439024390243902;23;18;0.0609756097560976;0.439024390243902
Control.SRR15539829;39;45;0.487179487179487;20;19;0.0128205128205128;0.487179487179487
Control.SRR15539829;48;45;0.416666666666667;28;20;0.0833333333333333;0.416666666666667
Control.SRR15539829;49;45;0.510204081632653;24;25;0.0102040816326531;0.489795918367347
Control.SRR15539829;49;45;0.551020408163265;22;27;0.0510204081632653;0.448979591836735
Control.SRR15539829;47;45;0.48936170212766;24;23;0.0106382978723404;0.48936170212766
Control.SRR15539829;46;45;0.41304347826087;27;19;0.0869565217391304;0.41304347826087
Control.SRR15539829;45;45;0.6;18;27;0.1;0.4
Control.SRR15539829;42;45;0.547619047619048;19;23;0.0476190476190477;0.452380952380952
Control.SRR15539829;39;45;0.487179487179487;20;19;0.0128205128205128;0.487179487179487
Control.SRR15539829;40;45;0.45;22;18;0.05;0.45
Control.SRR15539829;43;45;0.465116279069767;23;20;0.0348837209302326;0.465116279069767
Control.SRR15539829;50;45;0.52;24;26;0.02;0.48
Control.SRR15539829;50;45;0.54;23;27;0.04;0.46
Control.SRR15539829;44;45;0.454545454545455;24;20;0.0454545454545455;0.454545454545455
Control.SRR15539829;47;45;0.468085106382979;25;22;0.0319148936170213;0.468085106382979
Control.SRR15539829;38;45;0.447368421052632;21;17;0.0526315789473684;0.447368421052632
Control.SRR15539829;46;45;0.521739130434783;22;24;0.0217391304347826;0.478260869565217
Control.SRR15539829;48;45;0.395833333333333;29;19;0.104166666666667;0.395833333333333
Control.SRR15539829;38;45;0.631578947368421;14;24;0.131578947368421;0.368421052631579
Control.SRR15539829;39;45;0.538461538461538;18;21;0.0384615384615384;0.461538461538462
Control.SRR15539829;39;45;0.615384615384615;15;24;0.115384615384615;0.384615384615385
Control.SRR15539829;40;45;0.575;17;23;0.075;0.425
Control.SRR15539829;47;45;0.51063829787234;23;24;0.0106382978723404;0.48936170212766
Control.SRR15539829;40;45;0.575;17;23;0.075;0.425
Control.SRR15539829;40;45;0.625;15;25;0.125;0.375
Control.SRR15539829;48;45;0.458333333333333;26;22;0.0416666666666667;0.458333333333333
Control.SRR15539829;47;45;0.531914893617021;22;25;0.0319148936170213;0.468085106382979
Control.SRR15539829;42;45;0.452380952380952;23;19;0.0476190476190476;0.452380952380952
Control.SRR15539829;43;45;0.558139534883721;19;24;0.0581395348837209;0.441860465116279
Control.SRR15539829;43;45;0.558139534883721;19;24;0.0581395348837209;0.441860465116279
Control.SRR15539829;47;45;0.48936170212766;24;23;0.0106382978723404;0.48936170212766
Control.SRR15539829;49;45;0.530612244897959;23;26;0.0306122448979592;0.469387755102041
Control.SRR15539829;50;45;0.5;25;25;0;0.5
Control.SRR15539829;44;45;0.409090909090909;26;18;0.0909090909090909;0.409090909090909
Control.SRR15539829;40;45;0.5;20;20;0;0.5
Control.SRR15539829;41;45;0.439024390243902;23;18;0.0609756097560976;0.439024390243902
Control.SRR15539829;49;45;0.469387755102041;26;23;0.0306122448979592;0.469387755102041
Control.SRR15539829;38;45;0.315789473684211;26;12;0.184210526315789;0.315789473684211
Control.SRR15539829;41;45;0.414634146341463;24;17;0.0853658536585366;0.414634146341463
Control.SRR15539829;39;45;0.615384615384615;15;24;0.115384615384615;0.384615384615385
Control.SRR15539829;47;45;0.404255319148936;28;19;0.0957446808510639;0.404255319148936
Control.SRR15539829;47;45;0.553191489361702;21;26;0.0531914893617021;0.446808510638298
Control.SRR15539829;47;45;0.425531914893617;27;20;0.074468085106383;0.425531914893617
Control.SRR15539829;43;45;0.534883720930233;20;23;0.0348837209302325;0.465116279069767
Control.SRR15539829;43;45;0.581395348837209;18;25;0.0813953488372093;0.418604651162791
Control.SRR15539829;41;45;0.390243902439024;25;16;0.109756097560976;0.390243902439024
Control.SRR15539829;39;45;0.461538461538462;21;18;0.0384615384615384;0.461538461538462
Control.SRR15539829;50;45;0.48;26;24;0.02;0.48
Control.SRR15539829;42;45;0.428571428571429;24;18;0.0714285714285715;0.428571428571429
Control.SRR15539829;39;45;0.435897435897436;22;17;0.0641025641025641;0.435897435897436
Control.SRR15539829;42;45;0.404761904761905;25;17;0.0952380952380952;0.404761904761905
Control.SRR15539829;41;45;0.463414634146341;22;19;0.0365853658536585;0.463414634146341
Control.SRR15539829;48;45;0.4375;27;21;0.0625;0.4375
Control.SRR15539829;49;45;0.530612244897959;23;26;0.0306122448979592;0.469387755102041
Control.SRR15539829;47;45;0.468085106382979;25;22;0.0319148936170213;0.468085106382979
Control.SRR15539829;41;45;0.585365853658537;17;24;0.0853658536585366;0.414634146341463
Control.SRR15539829;39;45;0.487179487179487;20;19;0.0128205128205128;0.487179487179487
Control.SRR15539829;39;45;0.512820512820513;19;20;0.0128205128205128;0.487179487179487
Control.SRR15539829;45;45;0.533333333333333;21;24;0.0333333333333333;0.466666666666667
Control.SRR15539829;39;45;0.58974358974359;16;23;0.0897435897435898;0.41025641025641
Control.SRR15539829;38;45;0.552631578947368;17;21;0.0526315789473685;0.447368421052632
Control.SRR15539829;43;45;0.558139534883721;19;24;0.0581395348837209;0.441860465116279
Control.SRR15539829;41;45;0.48780487804878;21;20;0.0121951219512195;0.48780487804878
Control.SRR15539829;49;45;0.530612244897959;23;26;0.0306122448979592;0.469387755102041
Control.SRR15539829;50;45;0.44;28;22;0.06;0.44
Control.SRR15539829;48;45;0.541666666666667;22;26;0.0416666666666666;0.458333333333333
Control.SRR15539829;43;45;0.651162790697674;15;28;0.151162790697674;0.348837209302326
Control.SRR15539829;44;45;0.681818181818182;14;30;0.181818181818182;0.318181818181818
Control.SRR15539829;45;45;0.466666666666667;24;21;0.0333333333333333;0.466666666666667
Control.SRR15539829;41;45;0.536585365853659;19;22;0.0365853658536586;0.463414634146341
Control.SRR15539829;43;45;0.558139534883721;19;24;0.0581395348837209;0.441860465116279
Control.SRR15539829;43;45;0.534883720930233;20;23;0.0348837209302325;0.465116279069767
Control.SRR15539829;46;45;0.347826086956522;30;16;0.152173913043478;0.347826086956522
Control.SRR15539829;44;45;0.431818181818182;25;19;0.0681818181818182;0.431818181818182
Control.SRR15539829;48;45;0.583333333333333;20;28;0.0833333333333334;0.416666666666667
Control.SRR15539829;45;45;0.422222222222222;26;19;0.0777777777777778;0.422222222222222
Control.SRR15539829;50;45;0.46;27;23;0.04;0.46
Control.SRR15539829;47;45;0.468085106382979;25;22;0.0319148936170213;0.468085106382979
Control.SRR15539829;39;45;0.512820512820513;19;20;0.0128205128205128;0.487179487179487
Control.SRR15539829;38;45;0.578947368421053;16;22;0.0789473684210527;0.421052631578947
Control.SRR15539829;44;45;0.613636363636364;17;27;0.113636363636364;0.386363636363636
Control.SRR15539829;44;45;0.545454545454545;20;24;0.0454545454545454;0.454545454545455
Control.SRR15539829;43;45;0.674418604651163;14;29;0.174418604651163;0.325581395348837
Control.SRR15539829;46;45;0.565217391304348;20;26;0.0652173913043478;0.434782608695652
Control.SRR15539829;41;45;0.48780487804878;21;20;0.0121951219512195;0.48780487804878
Control.SRR15539829;42;45;0.404761904761905;25;17;0.0952380952380952;0.404761904761905
Control.SRR15539829;45;45;0.511111111111111;22;23;0.0111111111111111;0.488888888888889
Control.SRR15539829;41;45;0.317073170731707;28;13;0.182926829268293;0.317073170731707
Control.SRR15539829;47;45;0.425531914893617;27;20;0.074468085106383;0.425531914893617
Control.SRR15539829;48;45;0.5625;21;27;0.0625;0.4375
Control.SRR15539829;40;45;0.625;15;25;0.125;0.375
Control.SRR15539829;44;45;0.545454545454545;20;24;0.0454545454545454;0.454545454545455
Control.SRR15539829;41;45;0.48780487804878;21;20;0.0121951219512195;0.48780487804878
Control.SRR15539829;42;45;0.523809523809524;20;22;0.0238095238095238;0.476190476190476
Control.SRR15539829;45;45;0.444444444444444;25;20;0.0555555555555556;0.444444444444444
Control.SRR15539829;41;45;0.48780487804878;21;20;0.0121951219512195;0.48780487804878
Control.SRR15539829;44;45;0.590909090909091;18;26;0.0909090909090909;0.409090909090909
Control.SRR15539829;45;45;0.577777777777778;19;26;0.0777777777777777;0.422222222222222
Control.SRR15539829;50;45;0.54;23;27;0.04;0.46
Control.SRR15539829;38;45;0.421052631578947;22;16;0.0789473684210527;0.421052631578947
Control.SRR15539829;46;45;0.608695652173913;18;28;0.108695652173913;0.391304347826087
Control.SRR15539829;43;45;0.465116279069767;23;20;0.0348837209302326;0.465116279069767
Control.SRR15539829;44;45;0.386363636363636;27;17;0.113636363636364;0.386363636363636
Control.SRR15539829;47;45;0.446808510638298;26;21;0.0531914893617021;0.446808510638298
Control.SRR15539829;46;45;0.565217391304348;20;26;0.0652173913043478;0.434782608695652
Control.SRR15539829;38;45;0.473684210526316;20;18;0.0263157894736842;0.473684210526316
Control.SRR15539829;39;45;0.435897435897436;22;17;0.0641025641025641;0.435897435897436
Control.SRR15539829;44;45;0.454545454545455;24;20;0.0454545454545455;0.454545454545455
Control.SRR15539829;38;45;0.631578947368421;14;24;0.131578947368421;0.368421052631579
Control.SRR15539829;46;45;0.478260869565217;24;22;0.0217391304347826;0.478260869565217
Control.SRR15539829;43;45;0.441860465116279;24;19;0.0581395348837209;0.441860465116279
Control.SRR15539829;48;45;0.416666666666667;28;20;0.0833333333333333;0.416666666666667
Control.SRR15539829;49;45;0.489795918367347;25;24;0.0102040816326531;0.489795918367347
Control.SRR15539829;42;45;0.452380952380952;23;19;0.0476190476190476;0.452380952380952
Control.SRR15539829;49;45;0.510204081632653;24;25;0.0102040816326531;0.489795918367347
Control.SRR15539829;41;45;0.609756097560976;16;25;0.109756097560976;0.390243902439024
Control.SRR15539829;49;45;0.448979591836735;27;22;0.0510204081632653;0.448979591836735
Control.SRR15539829;50;45;0.6;20;30;0.1;0.4
Control.SRR15539829;47;45;0.531914893617021;22;25;0.0319148936170213;0.468085106382979
Control.SRR15539829;41;45;0.51219512195122;20;21;0.0121951219512195;0.48780487804878
Control.SRR15539829;40;45;0.425;23;17;0.075;0.425
Control.SRR15539829;41;45;0.48780487804878;21;20;0.0121951219512195;0.48780487804878
Control.SRR15539829;44;45;0.477272727272727;23;21;0.0227272727272727;0.477272727272727
Control.SRR15539829;48;45;0.520833333333333;23;25;0.0208333333333334;0.479166666666667
Control.SRR15539829;43;45;0.488372093023256;22;21;0.0116279069767442;0.488372093023256
Control.SRR15539829;43;45;0.534883720930233;20;23;0.0348837209302325;0.465116279069767
Control.SRR15539829;42;45;0.523809523809524;20;22;0.0238095238095238;0.476190476190476
Control.SRR15539829;40;45;0.375;25;15;0.125;0.375
Control.SRR15539829;50;45;0.46;27;23;0.04;0.46
Control.SRR15539829;42;45;0.666666666666667;14;28;0.166666666666667;0.333333333333333
Control.SRR15539829;40;45;0.525;19;21;0.025;0.475
Control.SRR15539829;46;45;0.478260869565217;24;22;0.0217391304347826;0.478260869565217
Control.SRR15539829;39;45;0.384615384615385;24;15;0.115384615384615;0.384615384615385
Control.SRR15539829;50;45;0.48;26;24;0.02;0.48
Control.SRR15539829;40;45;0.55;18;22;0.05;0.45
Control.SRR15539829;43;45;0.604651162790698;17;26;0.104651162790698;0.395348837209302
Control.SRR15539829;50;45;0.42;29;21;0.08;0.42
Control.SRR15539829;46;45;0.434782608695652;26;20;0.0652173913043478;0.434782608695652
Control.SRR15539829;41;45;0.585365853658537;17;24;0.0853658536585366;0.414634146341463
Control.SRR15539829;40;45;0.425;23;17;0.075;0.425
Control.SRR15539829;50;45;0.46;27;23;0.04;0.46
Control.SRR15539829;42;45;0.380952380952381;26;16;0.119047619047619;0.380952380952381
Control.SRR15539829;50;45;0.58;21;29;0.08;0.42
Control.SRR15539829;39;45;0.538461538461538;18;21;0.0384615384615384;0.461538461538462
Control.SRR15539829;40;45;0.55;18;22;0.05;0.45
Control.SRR15539829;40;45;0.425;23;17;0.075;0.425
Control.SRR15539829;45;45;0.6;18;27;0.1;0.4
Control.SRR15539829;44;45;0.454545454545455;24;20;0.0454545454545455;0.454545454545455
Control.SRR15539829;46;45;0.521739130434783;22;24;0.0217391304347826;0.478260869565217
Control.SRR15539829;41;45;0.560975609756098;18;23;0.0609756097560976;0.439024390243902
Control.SRR15539829;48;45;0.4375;27;21;0.0625;0.4375
Control.SRR15539829;41;45;0.414634146341463;24;17;0.0853658536585366;0.414634146341463
Control.SRR15539829;40;45;0.525;19;21;0.025;0.475
Control.SRR15539829;44;45;0.545454545454545;20;24;0.0454545454545454;0.454545454545455
Control.SRR15539829;41;45;0.51219512195122;20;21;0.0121951219512195;0.48780487804878
Control.SRR15539829;43;45;0.511627906976744;21;22;0.0116279069767442;0.488372093023256
Control.SRR15539829;44;45;0.681818181818182;14;30;0.181818181818182;0.318181818181818
Control.SRR15539829;40;45;0.475;21;19;0.025;0.475
Control.SRR15539829;40;45;0.575;17;23;0.075;0.425
Control.SRR15539829;48;45;0.354166666666667;31;17;0.145833333333333;0.354166666666667
Control.SRR15539829;47;45;0.553191489361702;21;26;0.0531914893617021;0.446808510638298
Control.SRR15539829;50;45;0.46;27;23;0.04;0.46
Control.SRR15539829;39;45;0.41025641025641;23;16;0.0897435897435898;0.41025641025641
Control.SRR15539829;38;45;0.473684210526316;20;18;0.0263157894736842;0.473684210526316
Control.SRR15539829;45;45;0.533333333333333;21;24;0.0333333333333333;0.466666666666667
Control.SRR15539829;48;45;0.479166666666667;25;23;0.0208333333333333;0.479166666666667
Control.SRR15539829;45;45;0.422222222222222;26;19;0.0777777777777778;0.422222222222222
Control.SRR15539829;45;45;0.6;18;27;0.1;0.4
Control.SRR15539829;47;45;0.531914893617021;22;25;0.0319148936170213;0.468085106382979
Control.SRR15539829;42;45;0.452380952380952;23;19;0.0476190476190476;0.452380952380952
Control.SRR15539829;42;45;0.547619047619048;19;23;0.0476190476190477;0.452380952380952
Control.SRR15539829;49;45;0.63265306122449;18;31;0.13265306122449;0.36734693877551
Control.SRR15539829;48;45;0.645833333333333;17;31;0.145833333333333;0.354166666666667
Control.SRR15539829;49;45;0.448979591836735;27;22;0.0510204081632653;0.448979591836735
Control.SRR15539829;49;45;0.489795918367347;25;24;0.0102040816326531;0.489795918367347
Control.SRR15539829;47;45;0.48936170212766;24;23;0.0106382978723404;0.48936170212766
Control.SRR15539829;43;45;0.325581395348837;29;14;0.174418604651163;0.325581395348837
Control.SRR15539829;40;45;0.55;18;22;0.05;0.45
Control.SRR15539829;39;45;0.435897435897436;22;17;0.0641025641025641;0.435897435897436
Control.SRR15539829;50;45;0.54;23;27;0.04;0.46
Control.SRR15539829;43;45;0.511627906976744;21;22;0.0116279069767442;0.488372093023256
Control.SRR15539829;44;45;0.568181818181818;19;25;0.0681818181818182;0.431818181818182
Control.SRR15539829;47;45;0.404255319148936;28;19;0.0957446808510639;0.404255319148936
Control.SRR15539829;48;45;0.479166666666667;25;23;0.0208333333333333;0.479166666666667
Control.SRR15539829;43;45;0.441860465116279;24;19;0.0581395348837209;0.441860465116279
Control.SRR15539829;48;45;0.458333333333333;26;22;0.0416666666666667;0.458333333333333
Control.SRR15539829;50;45;0.46;27;23;0.04;0.46
Control.SRR15539829;45;45;0.422222222222222;26;19;0.0777777777777778;0.422222222222222
Control.SRR15539829;50;45;0.44;28;22;0.06;0.44
Control.SRR15539829;45;45;0.511111111111111;22;23;0.0111111111111111;0.488888888888889
Control.SRR15539829;50;45;0.5;25;25;0;0.5
Control.SRR15539829;44;45;0.454545454545455;24;20;0.0454545454545455;0.454545454545455
Control.SRR15539829;50;45;0.5;25;25;0;0.5
Control.SRR15539829;48;45;0.5;24;24;0;0.5
Control.SRR15539829;48;45;0.416666666666667;28;20;0.0833333333333333;0.416666666666667
Control.SRR15539829;44;45;0.477272727272727;23;21;0.0227272727272727;0.477272727272727
Control.SRR15539829;38;45;0.342105263157895;25;13;0.157894736842105;0.342105263157895
Control.SRR15539829;41;45;0.609756097560976;16;25;0.109756097560976;0.390243902439024
Control.SRR15539829;40;45;0.475;21;19;0.025;0.475
Control.SRR15539829;41;45;0.414634146341463;24;17;0.0853658536585366;0.414634146341463
Control.SRR15539829;42;45;0.595238095238095;17;25;0.0952380952380952;0.404761904761905
Control.SRR15539829;38;45;0.473684210526316;20;18;0.0263157894736842;0.473684210526316
Control.SRR15539829;43;45;0.511627906976744;21;22;0.0116279069767442;0.488372093023256
Control.SRR15539829;39;45;0.58974358974359;16;23;0.0897435897435898;0.41025641025641
Control.SRR15539829;38;45;0.552631578947368;17;21;0.0526315789473685;0.447368421052632
Control.SRR15539829;40;45;0.55;18;22;0.05;0.45
Control.SRR15539829;48;45;0.604166666666667;19;29;0.104166666666667;0.395833333333333
Control.SRR15539829;38;45;0.447368421052632;21;17;0.0526315789473684;0.447368421052632
Control.SRR15539829;47;45;0.595744680851064;19;28;0.0957446808510638;0.404255319148936
Control.SRR15539829;47;45;0.553191489361702;21;26;0.0531914893617021;0.446808510638298
Control.SRR15539829;45;45;0.511111111111111;22;23;0.0111111111111111;0.488888888888889
Control.SRR15539829;44;45;0.545454545454545;20;24;0.0454545454545454;0.454545454545455
Control.SRR15539829;50;45;0.48;26;24;0.02;0.48
Control.SRR15539829;41;45;0.48780487804878;21;20;0.0121951219512195;0.48780487804878
Control.SRR15539829;45;45;0.333333333333333;30;15;0.166666666666667;0.333333333333333
Control.SRR15539829;48;45;0.541666666666667;22;26;0.0416666666666666;0.458333333333333
Control.SRR15539829;41;45;0.585365853658537;17;24;0.0853658536585366;0.414634146341463
Control.SRR15539829;43;45;0.558139534883721;19;24;0.0581395348837209;0.441860465116279
Control.SRR15539829;39;45;0.307692307692308;27;12;0.192307692307692;0.307692307692308
Control.SRR15539829;39;45;0.512820512820513;19;20;0.0128205128205128;0.487179487179487
Control.SRR15539829;43;45;0.511627906976744;21;22;0.0116279069767442;0.488372093023256
Control.SRR15539829;48;45;0.541666666666667;22;26;0.0416666666666666;0.458333333333333
Control.SRR15539829;40;45;0.5;20;20;0;0.5
Control.SRR15539829;42;45;0.523809523809524;20;22;0.0238095238095238;0.476190476190476
Control.SRR15539829;50;45;0.48;26;24;0.02;0.48
Control.SRR15539829;40;45;0.5;20;20;0;0.5
Control.SRR15539829;44;45;0.454545454545455;24;20;0.0454545454545455;0.454545454545455
Control.SRR15539829;46;45;0.347826086956522;30;16;0.152173913043478;0.347826086956522
Control.SRR15539829;48;45;0.354166666666667;31;17;0.145833333333333;0.354166666666667
Control.SRR15539829;46;45;0.434782608695652;26;20;0.0652173913043478;0.434782608695652
Control.SRR15539829;44;45;0.477272727272727;23;21;0.0227272727272727;0.477272727272727
Control.SRR15539829;50;45;0.4;30;20;0.1;0.4
Control.SRR15539829;50;45;0.44;28;22;0.06;0.44
Control.SRR15539829;40;45;0.55;18;22;0.05;0.45
Control.SRR15539829;38;45;0.447368421052632;21;17;0.0526315789473684;0.447368421052632
Control.SRR15539829;44;45;0.636363636363636;16;28;0.136363636363636;0.363636363636364
Control.SRR15539829;48;45;0.479166666666667;25;23;0.0208333333333333;0.479166666666667
Control.SRR15539829;40;45;0.5;20;20;0;0.5
Control.SRR15539829;50;45;0.54;23;27;0.04;0.46
Control.SRR15539829;50;45;0.56;22;28;0.0600000000000001;0.44
Control.SRR15539829;50;45;0.52;24;26;0.02;0.48
Control.SRR15539829;45;45;0.666666666666667;15;30;0.166666666666667;0.333333333333333
Control.SRR15539829;39;45;0.41025641025641;23;16;0.0897435897435898;0.41025641025641
Control.SRR15539829;42;45;0.404761904761905;25;17;0.0952380952380952;0.404761904761905
Control.SRR15539829;48;45;0.625;18;30;0.125;0.375
Control.SRR15539829;38;45;0.447368421052632;21;17;0.0526315789473684;0.447368421052632
Control.SRR15539829;43;45;0.465116279069767;23;20;0.0348837209302326;0.465116279069767
Control.SRR15539829;43;45;0.441860465116279;24;19;0.0581395348837209;0.441860465116279
Control.SRR15539829;50;45;0.52;24;26;0.02;0.48
Control.SRR15539829;47;45;0.574468085106383;20;27;0.074468085106383;0.425531914893617
Control.SRR15539829;46;45;0.434782608695652;26;20;0.0652173913043478;0.434782608695652
Control.SRR15539829;44;45;0.568181818181818;19;25;0.0681818181818182;0.431818181818182
Control.SRR15539829;48;45;0.5625;21;27;0.0625;0.4375
Control.SRR15539829;43;45;0.488372093023256;22;21;0.0116279069767442;0.488372093023256
Control.SRR15539829;42;45;0.476190476190476;22;20;0.0238095238095238;0.476190476190476
Control.SRR15539829;42;45;0.476190476190476;22;20;0.0238095238095238;0.476190476190476
Control.SRR15539829;48;45;0.604166666666667;19;29;0.104166666666667;0.395833333333333
Control.SRR15539829;43;45;0.465116279069767;23;20;0.0348837209302326;0.465116279069767
Control.SRR15539829;40;45;0.425;23;17;0.075;0.425
Control.SRR15539829;44;45;0.568181818181818;19;25;0.0681818181818182;0.431818181818182
Control.SRR15539829;38;45;0.552631578947368;17;21;0.0526315789473685;0.447368421052632
Control.SRR15539829;40;45;0.5;20;20;0;0.5
Control.SRR15539829;44;45;0.477272727272727;23;21;0.0227272727272727;0.477272727272727
Control.SRR15539829;46;45;0.521739130434783;22;24;0.0217391304347826;0.478260869565217
Control.SRR15539829;47;45;0.574468085106383;20;27;0.074468085106383;0.425531914893617
Control.SRR15539829;45;45;0.377777777777778;28;17;0.122222222222222;0.377777777777778
Control.SRR15539829;39;45;0.58974358974359;16;23;0.0897435897435898;0.41025641025641
Control.SRR15539829;46;45;0.434782608695652;26;20;0.0652173913043478;0.434782608695652
Control.SRR15539829;47;45;0.617021276595745;18;29;0.117021276595745;0.382978723404255
Control.SRR15539829;45;45;0.444444444444444;25;20;0.0555555555555556;0.444444444444444
Control.SRR15539829;43;45;0.534883720930233;20;23;0.0348837209302325;0.465116279069767
Control.SRR15539829;45;45;0.4;27;18;0.1;0.4
Control.SRR15539829;47;45;0.382978723404255;29;18;0.117021276595745;0.382978723404255
Control.SRR15539829;45;45;0.466666666666667;24;21;0.0333333333333333;0.466666666666667
Control.SRR15539829;40;45;0.6;16;24;0.1;0.4
Control.SRR15539829;43;45;0.511627906976744;21;22;0.0116279069767442;0.488372093023256
Control.SRR15539829;50;45;0.5;25;25;0;0.5
Control.SRR15539829;39;45;0.58974358974359;16;23;0.0897435897435898;0.41025641025641
Control.SRR15539829;49;45;0.489795918367347;25;24;0.0102040816326531;0.489795918367347
Control.SRR15539829;46;45;0.478260869565217;24;22;0.0217391304347826;0.478260869565217
Control.SRR15539829;48;45;0.458333333333333;26;22;0.0416666666666667;0.458333333333333
Control.SRR15539829;43;45;0.558139534883721;19;24;0.0581395348837209;0.441860465116279
Control.SRR15539829;41;45;0.317073170731707;28;13;0.182926829268293;0.317073170731707
Control.SRR15539829;47;45;0.531914893617021;22;25;0.0319148936170213;0.468085106382979
Control.SRR15539829;50;45;0.36;32;18;0.14;0.36
Control.SRR15539829;48;45;0.479166666666667;25;23;0.0208333333333333;0.479166666666667
Control.SRR15539829;48;45;0.604166666666667;19;29;0.104166666666667;0.395833333333333
Control.SRR15539829;45;45;0.6;18;27;0.1;0.4
Control.SRR15539829;45;45;0.666666666666667;15;30;0.166666666666667;0.333333333333333
Control.SRR15539829;39;45;0.41025641025641;23;16;0.0897435897435898;0.41025641025641
Control.SRR15539829;47;45;0.595744680851064;19;28;0.0957446808510638;0.404255319148936
Control.SRR15539829;50;45;0.52;24;26;0.02;0.48
Control.SRR15539829;46;45;0.58695652173913;19;27;0.0869565217391305;0.41304347826087
Control.SRR15539829;45;45;0.444444444444444;25;20;0.0555555555555556;0.444444444444444
Control.SRR15539829;40;45;0.45;22;18;0.05;0.45
Control.SRR15539829;44;45;0.5;22;22;0;0.5
Control.SRR15539829;38;45;0.342105263157895;25;13;0.157894736842105;0.342105263157895
Control.SRR15539829;38;45;0.447368421052632;21;17;0.0526315789473684;0.447368421052632
Control.SRR15539829;44;45;0.568181818181818;19;25;0.0681818181818182;0.431818181818182
Control.SRR15539829;47;45;0.51063829787234;23;24;0.0106382978723404;0.48936170212766
Control.SRR15539829;47;45;0.468085106382979;25;22;0.0319148936170213;0.468085106382979
Control.SRR15539829;48;45;0.541666666666667;22;26;0.0416666666666666;0.458333333333333
Control.SRR15539829;38;45;0.578947368421053;16;22;0.0789473684210527;0.421052631578947
Control.SRR15539829;47;45;0.553191489361702;21;26;0.0531914893617021;0.446808510638298
Control.SRR15539829;41;45;0.390243902439024;25;16;0.109756097560976;0.390243902439024
Control.SRR15539829;38;45;0.5;19;19;0;0.5
Control.SRR15539829;47;45;0.48936170212766;24;23;0.0106382978723404;0.48936170212766
Control.SRR15539829;43;45;0.534883720930233;20;23;0.0348837209302325;0.465116279069767
Control.SRR15539829;46;45;0.565217391304348;20;26;0.0652173913043478;0.434782608695652
Control.SRR15539829;38;45;0.5;19;19;0;0.5
Control.SRR15539829;47;45;0.468085106382979;25;22;0.0319148936170213;0.468085106382979
Control.SRR15539829;46;45;0.5;23;23;0;0.5
Control.SRR15539829;49;45;0.551020408163265;22;27;0.0510204081632653;0.448979591836735
Control.SRR15539829;43;45;0.372093023255814;27;16;0.127906976744186;0.372093023255814
Control.SRR15539829;42;45;0.642857142857143;15;27;0.142857142857143;0.357142857142857
Control.SRR15539829;40;45;0.525;19;21;0.025;0.475
Control.SRR15539829;45;45;0.577777777777778;19;26;0.0777777777777777;0.422222222222222
Control.SRR15539829;38;45;0.526315789473684;18;20;0.0263157894736842;0.473684210526316
Control.SRR15539829;45;45;0.511111111111111;22;23;0.0111111111111111;0.488888888888889
Control.SRR15539829;42;45;0.476190476190476;22;20;0.0238095238095238;0.476190476190476
Control.SRR15539829;44;45;0.522727272727273;21;23;0.0227272727272727;0.477272727272727
Control.SRR15539829;48;45;0.479166666666667;25;23;0.0208333333333333;0.479166666666667
Control.SRR15539829;43;45;0.465116279069767;23;20;0.0348837209302326;0.465116279069767
Control.SRR15539829;39;45;0.435897435897436;22;17;0.0641025641025641;0.435897435897436
Control.SRR15539829;39;45;0.435897435897436;22;17;0.0641025641025641;0.435897435897436
Control.SRR15539829;42;45;0.452380952380952;23;19;0.0476190476190476;0.452380952380952
Control.SRR15539829;41;45;0.365853658536585;26;15;0.134146341463415;0.365853658536585
Control.SRR15539829;42;45;0.547619047619048;19;23;0.0476190476190477;0.452380952380952
Control.SRR15539829;50;45;0.56;22;28;0.0600000000000001;0.44
Control.SRR15539829;50;45;0.44;28;22;0.06;0.44
Control.SRR15539829;43;45;0.534883720930233;20;23;0.0348837209302325;0.465116279069767
Control.SRR15539829;40;45;0.5;20;20;0;0.5
Control.SRR15539829;42;45;0.547619047619048;19;23;0.0476190476190477;0.452380952380952
Control.SRR15539829;41;45;0.439024390243902;23;18;0.0609756097560976;0.439024390243902
Control.SRR15539829;44;45;0.522727272727273;21;23;0.0227272727272727;0.477272727272727
Control.SRR15539829;45;45;0.511111111111111;22;23;0.0111111111111111;0.488888888888889
Control.SRR15539829;40;45;0.425;23;17;0.075;0.425
Control.SRR15539829;40;45;0.475;21;19;0.025;0.475
Control.SRR15539829;45;45;0.577777777777778;19;26;0.0777777777777777;0.422222222222222
Control.SRR15539829;50;45;0.48;26;24;0.02;0.48
Control.SRR15539829;48;45;0.604166666666667;19;29;0.104166666666667;0.395833333333333
Control.SRR15539829;40;45;0.55;18;22;0.05;0.45
Control.SRR15539829;49;45;0.591836734693878;20;29;0.0918367346938775;0.408163265306122
Control.SRR15539829;41;45;0.51219512195122;20;21;0.0121951219512195;0.48780487804878
Control.SRR15539829;43;45;0.488372093023256;22;21;0.0116279069767442;0.488372093023256
Control.SRR15539829;46;45;0.521739130434783;22;24;0.0217391304347826;0.478260869565217
Control.SRR15539829;47;45;0.531914893617021;22;25;0.0319148936170213;0.468085106382979
Control.SRR15539829;47;45;0.48936170212766;24;23;0.0106382978723404;0.48936170212766
Control.SRR15539829;43;45;0.488372093023256;22;21;0.0116279069767442;0.488372093023256
Control.SRR15539829;49;45;0.530612244897959;23;26;0.0306122448979592;0.469387755102041
Control.SRR15539829;49;45;0.571428571428571;21;28;0.0714285714285714;0.428571428571429
Control.SRR15539829;46;45;0.58695652173913;19;27;0.0869565217391305;0.41304347826087
Control.SRR15539829;49;45;0.36734693877551;31;18;0.13265306122449;0.36734693877551
Control.SRR15539829;38;45;0.447368421052632;21;17;0.0526315789473684;0.447368421052632
Control.SRR15539829;46;45;0.521739130434783;22;24;0.0217391304347826;0.478260869565217
Control.SRR15539829;46;45;0.543478260869565;21;25;0.0434782608695652;0.456521739130435
Control.SRR15539829;46;45;0.5;23;23;0;0.5
Control.SRR15539829;41;45;0.463414634146341;22;19;0.0365853658536585;0.463414634146341
Control.SRR15539829;38;45;0.421052631578947;22;16;0.0789473684210527;0.421052631578947
Control.SRR15539829;44;45;0.613636363636364;17;27;0.113636363636364;0.386363636363636
Control.SRR15539829;38;45;0.631578947368421;14;24;0.131578947368421;0.368421052631579
Control.SRR15539829;45;45;0.488888888888889;23;22;0.0111111111111111;0.488888888888889
Control.SRR15539829;50;45;0.7;15;35;0.2;0.3
Control.SRR15539829;42;45;0.523809523809524;20;22;0.0238095238095238;0.476190476190476
Control.SRR15539829;41;45;0.609756097560976;16;25;0.109756097560976;0.390243902439024
Control.SRR15539829;40;45;0.5;20;20;0;0.5
Control.SRR15539829;48;45;0.395833333333333;29;19;0.104166666666667;0.395833333333333
Control.SRR15539829;47;45;0.595744680851064;19;28;0.0957446808510638;0.404255319148936
Control.SRR15539829;48;45;0.5;24;24;0;0.5
Control.SRR15539829;46;45;0.5;23;23;0;0.5
Control.SRR15539829;49;45;0.673469387755102;16;33;0.173469387755102;0.326530612244898
Control.SRR15539829;39;45;0.435897435897436;22;17;0.0641025641025641;0.435897435897436
Control.SRR15539829;48;45;0.416666666666667;28;20;0.0833333333333333;0.416666666666667
Control.SRR15539829;39;45;0.487179487179487;20;19;0.0128205128205128;0.487179487179487
Control.SRR15539829;43;45;0.465116279069767;23;20;0.0348837209302326;0.465116279069767
Control.SRR15539829;48;45;0.458333333333333;26;22;0.0416666666666667;0.458333333333333
Control.SRR15539829;46;45;0.391304347826087;28;18;0.108695652173913;0.391304347826087
Control.SRR15539829;47;45;0.425531914893617;27;20;0.074468085106383;0.425531914893617
Control.SRR15539829;50;45;0.54;23;27;0.04;0.46
Control.SRR15539829;46;45;0.543478260869565;21;25;0.0434782608695652;0.456521739130435
Control.SRR15539829;40;45;0.55;18;22;0.05;0.45
Control.SRR15539829;43;45;0.627906976744186;16;27;0.127906976744186;0.372093023255814
Control.SRR15539829;47;45;0.446808510638298;26;21;0.0531914893617021;0.446808510638298
Control.SRR15539829;47;45;0.638297872340426;17;30;0.138297872340426;0.361702127659574
Control.SRR15539829;48;45;0.5625;21;27;0.0625;0.4375
Control.SRR15539829;41;45;0.536585365853659;19;22;0.0365853658536586;0.463414634146341
Control.SRR15539829;47;45;0.404255319148936;28;19;0.0957446808510639;0.404255319148936
Control.SRR15539829;49;45;0.448979591836735;27;22;0.0510204081632653;0.448979591836735
Control.SRR15539829;47;45;0.595744680851064;19;28;0.0957446808510638;0.404255319148936
Control.SRR15539829;42;45;0.476190476190476;22;20;0.0238095238095238;0.476190476190476
Control.SRR15539829;46;45;0.456521739130435;25;21;0.0434782608695652;0.456521739130435
Control.SRR15539829;42;45;0.5;21;21;0;0.5
Control.SRR15539829;44;45;0.590909090909091;18;26;0.0909090909090909;0.409090909090909
Control.SRR15539829;39;45;0.564102564102564;17;22;0.0641025641025641;0.435897435897436
Control.SRR15539829;43;45;0.558139534883721;19;24;0.0581395348837209;0.441860465116279
Control.SRR15539829;38;45;0.447368421052632;21;17;0.0526315789473684;0.447368421052632
Control.SRR15539829;49;45;0.489795918367347;25;24;0.0102040816326531;0.489795918367347
Control.SRR15539829;41;45;0.317073170731707;28;13;0.182926829268293;0.317073170731707
Control.SRR15539829;41;45;0.51219512195122;20;21;0.0121951219512195;0.48780487804878
Control.SRR15539829;41;45;0.390243902439024;25;16;0.109756097560976;0.390243902439024
Control.SRR15539829;42;45;0.5;21;21;0;0.5
Control.SRR15539829;43;45;0.488372093023256;22;21;0.0116279069767442;0.488372093023256
Control.SRR15539829;41;45;0.51219512195122;20;21;0.0121951219512195;0.48780487804878
Control.SRR15539829;45;45;0.511111111111111;22;23;0.0111111111111111;0.488888888888889
Control.SRR15539829;48;45;0.625;18;30;0.125;0.375
Control.SRR15539829;49;45;0.408163265306122;29;20;0.0918367346938775;0.408163265306122
Control.SRR15539829;39;45;0.461538461538462;21;18;0.0384615384615384;0.461538461538462
Control.SRR15539829;46;45;0.521739130434783;22;24;0.0217391304347826;0.478260869565217
Control.SRR15539829;44;45;0.409090909090909;26;18;0.0909090909090909;0.409090909090909
Control.SRR15539829;44;45;0.477272727272727;23;21;0.0227272727272727;0.477272727272727
Control.SRR15539829;38;45;0.447368421052632;21;17;0.0526315789473684;0.447368421052632
Control.SRR15539829;38;45;0.5;19;19;0;0.5
Control.SRR15539829;43;45;0.372093023255814;27;16;0.127906976744186;0.372093023255814
Control.SRR15539829;43;45;0.372093023255814;27;16;0.127906976744186;0.372093023255814
Control.SRR15539829;47;45;0.425531914893617;27;20;0.074468085106383;0.425531914893617
Control.SRR15539829;42;45;0.547619047619048;19;23;0.0476190476190477;0.452380952380952
Control.SRR15539829;38;45;0.578947368421053;16;22;0.0789473684210527;0.421052631578947
Control.SRR15539829;45;45;0.6;18;27;0.1;0.4
Control.SRR15539829;43;45;0.372093023255814;27;16;0.127906976744186;0.372093023255814
Control.SRR15539829;43;45;0.581395348837209;18;25;0.0813953488372093;0.418604651162791
Control.SRR15539829;42;45;0.595238095238095;17;25;0.0952380952380952;0.404761904761905
Control.SRR15539829;41;45;0.414634146341463;24;17;0.0853658536585366;0.414634146341463
Control.SRR15539829;45;45;0.488888888888889;23;22;0.0111111111111111;0.488888888888889
Control.SRR15539829;42;45;0.476190476190476;22;20;0.0238095238095238;0.476190476190476
Control.SRR15539829;43;45;0.581395348837209;18;25;0.0813953488372093;0.418604651162791
Control.SRR15539829;39;45;0.538461538461538;18;21;0.0384615384615384;0.461538461538462
Control.SRR15539829;42;45;0.380952380952381;26;16;0.119047619047619;0.380952380952381
Control.SRR15539829;50;45;0.36;32;18;0.14;0.36
Control.SRR15539829;46;45;0.521739130434783;22;24;0.0217391304347826;0.478260869565217
Control.SRR15539829;42;45;0.571428571428571;18;24;0.0714285714285714;0.428571428571429
Control.SRR15539829;44;45;0.5;22;22;0;0.5
Control.SRR15539829;42;45;0.619047619047619;16;26;0.119047619047619;0.380952380952381
Control.SRR15539829;42;45;0.452380952380952;23;19;0.0476190476190476;0.452380952380952
Control.SRR15539829;45;45;0.444444444444444;25;20;0.0555555555555556;0.444444444444444
Control.SRR15539829;46;45;0.456521739130435;25;21;0.0434782608695652;0.456521739130435
Control.SRR15539829;45;45;0.577777777777778;19;26;0.0777777777777777;0.422222222222222
Control.SRR15539829;40;45;0.6;16;24;0.1;0.4
Control.SRR15539829;49;45;0.510204081632653;24;25;0.0102040816326531;0.489795918367347
Control.SRR15539829;48;45;0.5;24;24;0;0.5
Control.SRR15539829;44;45;0.613636363636364;17;27;0.113636363636364;0.386363636363636
Control.SRR15539829;43;45;0.511627906976744;21;22;0.0116279069767442;0.488372093023256
Control.SRR15539829;46;45;0.478260869565217;24;22;0.0217391304347826;0.478260869565217
Control.SRR15539829;45;45;0.422222222222222;26;19;0.0777777777777778;0.422222222222222
Control.SRR15539829;42;45;0.5;21;21;0;0.5
Control.SRR15539829;45;45;0.533333333333333;21;24;0.0333333333333333;0.466666666666667
Control.SRR15539829;39;45;0.41025641025641;23;16;0.0897435897435898;0.41025641025641
Control.SRR15539829;39;45;0.435897435897436;22;17;0.0641025641025641;0.435897435897436
Control.SRR15539829;39;45;0.512820512820513;19;20;0.0128205128205128;0.487179487179487
Control.SRR15539829;38;45;0.657894736842105;13;25;0.157894736842105;0.342105263157895
Control.SRR15539829;41;45;0.536585365853659;19;22;0.0365853658536586;0.463414634146341
Control.SRR15539829;46;45;0.456521739130435;25;21;0.0434782608695652;0.456521739130435
Control.SRR15539829;50;45;0.58;21;29;0.08;0.42
Control.SRR15539829;39;45;0.564102564102564;17;22;0.0641025641025641;0.435897435897436
Control.SRR15539829;43;45;0.488372093023256;22;21;0.0116279069767442;0.488372093023256
Control.SRR15539829;38;45;0.631578947368421;14;24;0.131578947368421;0.368421052631579
Control.SRR15539829;48;45;0.458333333333333;26;22;0.0416666666666667;0.458333333333333
Control.SRR15539829;48;45;0.541666666666667;22;26;0.0416666666666666;0.458333333333333
Control.SRR15539829;43;45;0.441860465116279;24;19;0.0581395348837209;0.441860465116279
Control.SRR15539829;41;45;0.536585365853659;19;22;0.0365853658536586;0.463414634146341
Control.SRR15539829;49;45;0.591836734693878;20;29;0.0918367346938775;0.408163265306122
Control.SRR15539829;48;45;0.479166666666667;25;23;0.0208333333333333;0.479166666666667
Control.SRR15539829;48;45;0.5;24;24;0;0.5
Control.SRR15539829;44;45;0.568181818181818;19;25;0.0681818181818182;0.431818181818182
Control.SRR15539829;43;45;0.348837209302326;28;15;0.151162790697674;0.348837209302326
Control.SRR15539829;47;45;0.48936170212766;24;23;0.0106382978723404;0.48936170212766
Control.SRR15539829;41;45;0.560975609756098;18;23;0.0609756097560976;0.439024390243902
Control.SRR15539829;43;45;0.372093023255814;27;16;0.127906976744186;0.372093023255814
Control.SRR15539829;45;45;0.511111111111111;22;23;0.0111111111111111;0.488888888888889
Control.SRR15539829;41;45;0.463414634146341;22;19;0.0365853658536585;0.463414634146341
Control.SRR15539829;39;45;0.512820512820513;19;20;0.0128205128205128;0.487179487179487
Control.SRR15539829;46;45;0.41304347826087;27;19;0.0869565217391304;0.41304347826087
Control.SRR15539829;38;45;0.5;19;19;0;0.5
Control.SRR15539829;39;45;0.538461538461538;18;21;0.0384615384615384;0.461538461538462
Control.SRR15539829;45;45;0.466666666666667;24;21;0.0333333333333333;0.466666666666667
Control.SRR15539829;43;45;0.534883720930233;20;23;0.0348837209302325;0.465116279069767
Control.SRR15539829;43;45;0.511627906976744;21;22;0.0116279069767442;0.488372093023256
Control.SRR15539829;44;45;0.431818181818182;25;19;0.0681818181818182;0.431818181818182
Control.SRR15539829;44;45;0.545454545454545;20;24;0.0454545454545454;0.454545454545455
Control.SRR15539829;45;45;0.377777777777778;28;17;0.122222222222222;0.377777777777778
Control.SRR15539829;39;45;0.333333333333333;26;13;0.166666666666667;0.333333333333333
Control.SRR15539829;39;45;0.487179487179487;20;19;0.0128205128205128;0.487179487179487
Control.SRR15539829;44;45;0.477272727272727;23;21;0.0227272727272727;0.477272727272727
Control.SRR15539829;39;45;0.282051282051282;28;11;0.217948717948718;0.282051282051282
Control.SRR15539829;48;45;0.520833333333333;23;25;0.0208333333333334;0.479166666666667
Control.SRR15539829;39;45;0.487179487179487;20;19;0.0128205128205128;0.487179487179487
Control.SRR15539829;46;45;0.41304347826087;27;19;0.0869565217391304;0.41304347826087
Control.SRR15539829;43;45;0.441860465116279;24;19;0.0581395348837209;0.441860465116279
Control.SRR15539829;40;45;0.475;21;19;0.025;0.475
Control.SRR15539829;39;45;0.58974358974359;16;23;0.0897435897435898;0.41025641025641
Control.SRR15539829;43;45;0.581395348837209;18;25;0.0813953488372093;0.418604651162791
Control.SRR15539829;40;45;0.425;23;17;0.075;0.425
Control.SRR15539829;40;45;0.55;18;22;0.05;0.45
Control.SRR15539829;41;45;0.609756097560976;16;25;0.109756097560976;0.390243902439024
Control.SRR15539829;45;45;0.511111111111111;22;23;0.0111111111111111;0.488888888888889
Control.SRR15539829;46;45;0.434782608695652;26;20;0.0652173913043478;0.434782608695652
Control.SRR15539829;41;45;0.585365853658537;17;24;0.0853658536585366;0.414634146341463
Control.SRR15539829;49;45;0.387755102040816;30;19;0.112244897959184;0.387755102040816
Control.SRR15539829;44;45;0.5;22;22;0;0.5
Control.SRR15539829;43;45;0.372093023255814;27;16;0.127906976744186;0.372093023255814
Control.SRR15539829;39;45;0.538461538461538;18;21;0.0384615384615384;0.461538461538462
Control.SRR15539829;38;45;0.631578947368421;14;24;0.131578947368421;0.368421052631579
Control.SRR15539829;43;45;0.558139534883721;19;24;0.0581395348837209;0.441860465116279
Control.SRR15539829;40;45;0.475;21;19;0.025;0.475
Control.SRR15539829;40;45;0.525;19;21;0.025;0.475
Control.SRR15539829;48;45;0.666666666666667;16;32;0.166666666666667;0.333333333333333
Control.SRR15539829;39;45;0.512820512820513;19;20;0.0128205128205128;0.487179487179487
Control.SRR15539829;44;45;0.522727272727273;21;23;0.0227272727272727;0.477272727272727
Control.SRR15539829;38;45;0.5;19;19;0;0.5
Control.SRR15539829;40;45;0.525;19;21;0.025;0.475
Control.SRR15539829;44;45;0.568181818181818;19;25;0.0681818181818182;0.431818181818182
Control.SRR15539829;42;45;0.547619047619048;19;23;0.0476190476190477;0.452380952380952
Control.SRR15539829;47;45;0.361702127659574;30;17;0.138297872340426;0.361702127659574
Control.SRR15539829;48;45;0.4375;27;21;0.0625;0.4375
Control.SRR15539829;42;45;0.452380952380952;23;19;0.0476190476190476;0.452380952380952
Control.SRR15539829;48;45;0.5625;21;27;0.0625;0.4375
Control.SRR15539829;48;45;0.5625;21;27;0.0625;0.4375
Control.SRR15539829;41;45;0.51219512195122;20;21;0.0121951219512195;0.48780487804878
Control.SRR15539829;50;45;0.4;30;20;0.1;0.4
Control.SRR15539829;41;45;0.365853658536585;26;15;0.134146341463415;0.365853658536585
Control.SRR15539829;45;45;0.577777777777778;19;26;0.0777777777777777;0.422222222222222
Control.SRR15539829;39;45;0.358974358974359;25;14;0.141025641025641;0.358974358974359
Control.SRR15539829;45;45;0.488888888888889;23;22;0.0111111111111111;0.488888888888889
Control.SRR15539829;49;45;0.469387755102041;26;23;0.0306122448979592;0.469387755102041
Control.SRR15539829;44;45;0.522727272727273;21;23;0.0227272727272727;0.477272727272727
Control.SRR15539829;47;45;0.595744680851064;19;28;0.0957446808510638;0.404255319148936
Control.SRR15539829;48;45;0.4375;27;21;0.0625;0.4375
Control.SRR15539829;47;45;0.553191489361702;21;26;0.0531914893617021;0.446808510638298
Control.SRR15539829;40;45;0.575;17;23;0.075;0.425
Control.SRR15539829;44;45;0.477272727272727;23;21;0.0227272727272727;0.477272727272727
Control.SRR15539829;41;45;0.463414634146341;22;19;0.0365853658536585;0.463414634146341
Control.SRR15539829;46;45;0.521739130434783;22;24;0.0217391304347826;0.478260869565217
Control.SRR15539829;47;45;0.404255319148936;28;19;0.0957446808510639;0.404255319148936
Control.SRR15539829;44;45;0.545454545454545;20;24;0.0454545454545454;0.454545454545455
Control.SRR15539829;49;45;0.612244897959184;19;30;0.112244897959184;0.387755102040816
Control.SRR15539829;46;45;0.608695652173913;18;28;0.108695652173913;0.391304347826087
Control.SRR15539829;49;45;0.469387755102041;26;23;0.0306122448979592;0.469387755102041
Control.SRR15539829;49;45;0.428571428571429;28;21;0.0714285714285715;0.428571428571429
Control.SRR15539829;47;45;0.574468085106383;20;27;0.074468085106383;0.425531914893617
Control.SRR15539829;49;45;0.571428571428571;21;28;0.0714285714285714;0.428571428571429
Control.SRR15539829;43;45;0.534883720930233;20;23;0.0348837209302325;0.465116279069767
Control.SRR15539829;49;45;0.673469387755102;16;33;0.173469387755102;0.326530612244898
Control.SRR15539829;46;45;0.478260869565217;24;22;0.0217391304347826;0.478260869565217
Control.SRR15539829;45;45;0.533333333333333;21;24;0.0333333333333333;0.466666666666667
Control.SRR15539829;42;45;0.5;21;21;0;0.5
Control.SRR15539829;45;45;0.488888888888889;23;22;0.0111111111111111;0.488888888888889
Control.SRR15539829;44;45;0.568181818181818;19;25;0.0681818181818182;0.431818181818182
Control.SRR15539829;49;45;0.408163265306122;29;20;0.0918367346938775;0.408163265306122
Control.SRR15539829;38;45;0.5;19;19;0;0.5
Control.SRR15539829;41;45;0.51219512195122;20;21;0.0121951219512195;0.48780487804878
Control.SRR15539829;40;45;0.5;20;20;0;0.5
Control.SRR15539829;45;45;0.533333333333333;21;24;0.0333333333333333;0.466666666666667
Control.SRR15539829;41;45;0.536585365853659;19;22;0.0365853658536586;0.463414634146341
Control.SRR15539829;44;45;0.545454545454545;20;24;0.0454545454545454;0.454545454545455
Control.SRR15539829;42;45;0.547619047619048;19;23;0.0476190476190477;0.452380952380952
Control.SRR15539829;44;45;0.363636363636364;28;16;0.136363636363636;0.363636363636364
Control.SRR15539829;42;45;0.452380952380952;23;19;0.0476190476190476;0.452380952380952
Control.SRR15539829;45;45;0.555555555555556;20;25;0.0555555555555556;0.444444444444444
Control.SRR15539829;42;45;0.619047619047619;16;26;0.119047619047619;0.380952380952381
Control.SRR15539829;47;45;0.48936170212766;24;23;0.0106382978723404;0.48936170212766
Control.SRR15539829;42;45;0.571428571428571;18;24;0.0714285714285714;0.428571428571429
Control.SRR15539829;41;45;0.463414634146341;22;19;0.0365853658536585;0.463414634146341
Control.SRR15539829;45;45;0.466666666666667;24;21;0.0333333333333333;0.466666666666667
Control.SRR15539829;50;45;0.44;28;22;0.06;0.44
Control.SRR15539829;49;45;0.36734693877551;31;18;0.13265306122449;0.36734693877551
Control.SRR15539829;47;45;0.48936170212766;24;23;0.0106382978723404;0.48936170212766
Control.SRR15539829;49;45;0.571428571428571;21;28;0.0714285714285714;0.428571428571429
Control.SRR15539829;50;45;0.5;25;25;0;0.5
Control.SRR15539829;39;45;0.512820512820513;19;20;0.0128205128205128;0.487179487179487
Control.SRR15539829;47;45;0.425531914893617;27;20;0.074468085106383;0.425531914893617
Control.SRR15539829;41;45;0.51219512195122;20;21;0.0121951219512195;0.48780487804878
Control.SRR15539829;49;45;0.428571428571429;28;21;0.0714285714285715;0.428571428571429
Control.SRR15539829;41;45;0.463414634146341;22;19;0.0365853658536585;0.463414634146341
Control.SRR15539829;46;45;0.543478260869565;21;25;0.0434782608695652;0.456521739130435
Control.SRR15539829;48;45;0.479166666666667;25;23;0.0208333333333333;0.479166666666667
Control.SRR15539829;48;45;0.541666666666667;22;26;0.0416666666666666;0.458333333333333
Control.SRR15539829;43;45;0.488372093023256;22;21;0.0116279069767442;0.488372093023256
Control.SRR15539829;45;45;0.511111111111111;22;23;0.0111111111111111;0.488888888888889
Control.SRR15539829;42;45;0.547619047619048;19;23;0.0476190476190477;0.452380952380952
Control.SRR15539829;43;45;0.465116279069767;23;20;0.0348837209302326;0.465116279069767
Control.SRR15539829;41;45;0.463414634146341;22;19;0.0365853658536585;0.463414634146341
Control.SRR15539829;44;45;0.522727272727273;21;23;0.0227272727272727;0.477272727272727
Control.SRR15539829;41;45;0.536585365853659;19;22;0.0365853658536586;0.463414634146341
Control.SRR15539829;49;45;0.489795918367347;25;24;0.0102040816326531;0.489795918367347
Control.SRR15539829;48;45;0.416666666666667;28;20;0.0833333333333333;0.416666666666667
Control.SRR15539829;50;45;0.5;25;25;0;0.5
Control.SRR15539829;47;45;0.659574468085106;16;31;0.159574468085106;0.340425531914894
Control.SRR15539829;38;45;0.526315789473684;18;20;0.0263157894736842;0.473684210526316
Control.SRR15539829;43;45;0.465116279069767;23;20;0.0348837209302326;0.465116279069767
Control.SRR15539829;48;45;0.625;18;30;0.125;0.375
Control.SRR15539829;50;45;0.64;18;32;0.14;0.36
Control.SRR15539829;49;45;0.469387755102041;26;23;0.0306122448979592;0.469387755102041
Control.SRR15539829;49;45;0.36734693877551;31;18;0.13265306122449;0.36734693877551
Control.SRR15539829;49;45;0.489795918367347;25;24;0.0102040816326531;0.489795918367347
Control.SRR15539829;47;45;0.553191489361702;21;26;0.0531914893617021;0.446808510638298
Control.SRR15539829;43;45;0.441860465116279;24;19;0.0581395348837209;0.441860465116279
Control.SRR15539829;42;45;0.428571428571429;24;18;0.0714285714285715;0.428571428571429
Control.SRR15539829;50;45;0.5;25;25;0;0.5
Control.SRR15539829;40;45;0.575;17;23;0.075;0.425
Control.SRR15539829;48;45;0.583333333333333;20;28;0.0833333333333334;0.416666666666667
Control.SRR15539829;42;45;0.523809523809524;20;22;0.0238095238095238;0.476190476190476
Control.SRR15539829;45;45;0.488888888888889;23;22;0.0111111111111111;0.488888888888889
Control.SRR15539829;45;45;0.533333333333333;21;24;0.0333333333333333;0.466666666666667
Control.SRR15539829;45;45;0.511111111111111;22;23;0.0111111111111111;0.488888888888889
Control.SRR15539829;39;45;0.512820512820513;19;20;0.0128205128205128;0.487179487179487
Control.SRR15539829;40;45;0.625;15;25;0.125;0.375
Control.SRR15539829;39;45;0.538461538461538;18;21;0.0384615384615384;0.461538461538462
Control.SRR15539829;46;45;0.369565217391304;29;17;0.130434782608696;0.369565217391304
Control.SRR15539829;50;45;0.62;19;31;0.12;0.38
Control.SRR15539829;42;45;0.523809523809524;20;22;0.0238095238095238;0.476190476190476
Control.SRR15539829;48;45;0.395833333333333;29;19;0.104166666666667;0.395833333333333
Control.SRR15539829;48;45;0.541666666666667;22;26;0.0416666666666666;0.458333333333333
Control.SRR15539829;45;45;0.6;18;27;0.1;0.4
Control.SRR15539829;49;45;0.510204081632653;24;25;0.0102040816326531;0.489795918367347
Control.SRR15539829;50;45;0.58;21;29;0.08;0.42
Control.SRR15539829;48;45;0.520833333333333;23;25;0.0208333333333334;0.479166666666667
Control.SRR15539829;46;45;0.391304347826087;28;18;0.108695652173913;0.391304347826087
Control.SRR15539829;45;45;0.466666666666667;24;21;0.0333333333333333;0.466666666666667
Control.SRR15539829;43;45;0.604651162790698;17;26;0.104651162790698;0.395348837209302
Control.SRR15539829;44;45;0.522727272727273;21;23;0.0227272727272727;0.477272727272727
Control.SRR15539829;46;45;0.58695652173913;19;27;0.0869565217391305;0.41304347826087
Control.SRR15539829;46;45;0.41304347826087;27;19;0.0869565217391304;0.41304347826087
Control.SRR15539829;43;45;0.465116279069767;23;20;0.0348837209302326;0.465116279069767
Control.SRR15539829;46;45;0.478260869565217;24;22;0.0217391304347826;0.478260869565217
Control.SRR15539829;46;45;0.326086956521739;31;15;0.173913043478261;0.326086956521739
Control.SRR15539829;43;45;0.511627906976744;21;22;0.0116279069767442;0.488372093023256
Control.SRR15539829;43;45;0.534883720930233;20;23;0.0348837209302325;0.465116279069767
Control.SRR15539829;38;45;0.473684210526316;20;18;0.0263157894736842;0.473684210526316
Control.SRR15539829;45;45;0.422222222222222;26;19;0.0777777777777778;0.422222222222222
Control.SRR15539829;41;45;0.609756097560976;16;25;0.109756097560976;0.390243902439024
Control.SRR15539829;44;45;0.545454545454545;20;24;0.0454545454545454;0.454545454545455
Control.SRR15539829;46;45;0.391304347826087;28;18;0.108695652173913;0.391304347826087
Control.SRR15539829;50;45;0.58;21;29;0.08;0.42
Control.SRR15539829;48;45;0.520833333333333;23;25;0.0208333333333334;0.479166666666667
Control.SRR15539829;50;45;0.44;28;22;0.06;0.44
Control.SRR15539829;38;45;0.394736842105263;23;15;0.105263157894737;0.394736842105263
Control.SRR15539829;43;45;0.418604651162791;25;18;0.0813953488372093;0.418604651162791
Control.SRR15539829;41;45;0.463414634146341;22;19;0.0365853658536585;0.463414634146341
Control.SRR15539829;47;45;0.319148936170213;32;15;0.180851063829787;0.319148936170213
Control.SRR15539829;49;45;0.551020408163265;22;27;0.0510204081632653;0.448979591836735
Control.SRR15539829;39;45;0.666666666666667;13;26;0.166666666666667;0.333333333333333
Control.SRR15539829;49;45;0.489795918367347;25;24;0.0102040816326531;0.489795918367347
Control.SRR15539829;46;45;0.434782608695652;26;20;0.0652173913043478;0.434782608695652
Control.SRR15539829;44;45;0.386363636363636;27;17;0.113636363636364;0.386363636363636
Control.SRR15539829;40;45;0.525;19;21;0.025;0.475
Control.SRR15539829;44;45;0.545454545454545;20;24;0.0454545454545454;0.454545454545455
Control.SRR15539829;46;45;0.369565217391304;29;17;0.130434782608696;0.369565217391304
Control.SRR15539829;44;45;0.590909090909091;18;26;0.0909090909090909;0.409090909090909
Control.SRR15539829;44;45;0.431818181818182;25;19;0.0681818181818182;0.431818181818182
Control.SRR15539829;46;45;0.58695652173913;19;27;0.0869565217391305;0.41304347826087
Control.SRR15539829;45;45;0.444444444444444;25;20;0.0555555555555556;0.444444444444444
Control.SRR15539829;47;45;0.51063829787234;23;24;0.0106382978723404;0.48936170212766
Control.SRR15539829;45;45;0.488888888888889;23;22;0.0111111111111111;0.488888888888889
Control.SRR15539829;38;45;0.631578947368421;14;24;0.131578947368421;0.368421052631579
Control.SRR15539829;41;45;0.536585365853659;19;22;0.0365853658536586;0.463414634146341
Control.SRR15539829;47;45;0.425531914893617;27;20;0.074468085106383;0.425531914893617
Control.SRR15539829;42;45;0.428571428571429;24;18;0.0714285714285715;0.428571428571429
Control.SRR15539829;40;45;0.5;20;20;0;0.5
Control.SRR15539829;50;45;0.52;24;26;0.02;0.48
Control.SRR15539829;40;45;0.6;16;24;0.1;0.4
Control.SRR15539829;50;45;0.44;28;22;0.06;0.44
Control.SRR15539829;39;45;0.615384615384615;15;24;0.115384615384615;0.384615384615385
Control.SRR15539829;40;45;0.575;17;23;0.075;0.425
Control.SRR15539829;40;45;0.525;19;21;0.025;0.475
Control.SRR15539829;42;45;0.5;21;21;0;0.5
Control.SRR15539829;39;45;0.564102564102564;17;22;0.0641025641025641;0.435897435897436
Control.SRR15539829;44;45;0.386363636363636;27;17;0.113636363636364;0.386363636363636
Control.SRR15539829;48;45;0.333333333333333;32;16;0.166666666666667;0.333333333333333
Control.SRR15539829;41;45;0.536585365853659;19;22;0.0365853658536586;0.463414634146341
Control.SRR15539829;45;45;0.466666666666667;24;21;0.0333333333333333;0.466666666666667
Control.SRR15539829;45;45;0.533333333333333;21;24;0.0333333333333333;0.466666666666667
Control.SRR15539829;47;45;0.531914893617021;22;25;0.0319148936170213;0.468085106382979
Control.SRR15539829;44;45;0.659090909090909;15;29;0.159090909090909;0.340909090909091
Control.SRR15539829;41;45;0.536585365853659;19;22;0.0365853658536586;0.463414634146341
Control.SRR15539829;44;45;0.5;22;22;0;0.5
Control.SRR15539829;47;45;0.425531914893617;27;20;0.074468085106383;0.425531914893617
Control.SRR15539829;42;45;0.69047619047619;13;29;0.19047619047619;0.30952380952381
Control.SRR15539829;43;45;0.395348837209302;26;17;0.104651162790698;0.395348837209302
Control.SRR15539829;45;45;0.377777777777778;28;17;0.122222222222222;0.377777777777778
Control.SRR15539829;47;45;0.51063829787234;23;24;0.0106382978723404;0.48936170212766
Control.SRR15539829;41;45;0.51219512195122;20;21;0.0121951219512195;0.48780487804878
Control.SRR15539829;38;45;0.552631578947368;17;21;0.0526315789473685;0.447368421052632
Control.SRR15539829;39;45;0.358974358974359;25;14;0.141025641025641;0.358974358974359
Control.SRR15539829;50;45;0.54;23;27;0.04;0.46
Control.SRR15539829;38;45;0.710526315789474;11;27;0.210526315789474;0.289473684210526
Control.SRR15539829;47;45;0.531914893617021;22;25;0.0319148936170213;0.468085106382979
Control.SRR15539829;38;45;0.447368421052632;21;17;0.0526315789473684;0.447368421052632
Control.SRR15539829;43;45;0.558139534883721;19;24;0.0581395348837209;0.441860465116279
Control.SRR15539829;42;45;0.595238095238095;17;25;0.0952380952380952;0.404761904761905
Control.SRR15539829;41;45;0.609756097560976;16;25;0.109756097560976;0.390243902439024
Control.SRR15539829;44;45;0.5;22;22;0;0.5
Control.SRR15539829;39;45;0.487179487179487;20;19;0.0128205128205128;0.487179487179487
Control.SRR15539829;48;45;0.541666666666667;22;26;0.0416666666666666;0.458333333333333
Control.SRR15539829;46;45;0.369565217391304;29;17;0.130434782608696;0.369565217391304
Control.SRR15539829;46;45;0.58695652173913;19;27;0.0869565217391305;0.41304347826087
Control.SRR15539829;46;45;0.41304347826087;27;19;0.0869565217391304;0.41304347826087
Control.SRR15539829;47;45;0.468085106382979;25;22;0.0319148936170213;0.468085106382979
Control.SRR15539829;50;45;0.56;22;28;0.0600000000000001;0.44
Control.SRR15539829;48;45;0.583333333333333;20;28;0.0833333333333334;0.416666666666667
Control.SRR15539829;47;45;0.595744680851064;19;28;0.0957446808510638;0.404255319148936
Control.SRR15539829;42;45;0.547619047619048;19;23;0.0476190476190477;0.452380952380952
Control.SRR15539829;41;45;0.317073170731707;28;13;0.182926829268293;0.317073170731707
Control.SRR15539829;42;45;0.547619047619048;19;23;0.0476190476190477;0.452380952380952
Control.SRR15539829;46;45;0.456521739130435;25;21;0.0434782608695652;0.456521739130435
Control.SRR15539829;46;45;0.456521739130435;25;21;0.0434782608695652;0.456521739130435
Control.SRR15539829;42;45;0.547619047619048;19;23;0.0476190476190477;0.452380952380952
Control.SRR15539829;43;45;0.395348837209302;26;17;0.104651162790698;0.395348837209302
Control.SRR15539829;50;45;0.58;21;29;0.08;0.42
Control.SRR15539829;50;45;0.4;30;20;0.1;0.4
Control.SRR15539829;42;45;0.452380952380952;23;19;0.0476190476190476;0.452380952380952
Control.SRR15539829;42;45;0.523809523809524;20;22;0.0238095238095238;0.476190476190476
Control.SRR15539829;49;45;0.448979591836735;27;22;0.0510204081632653;0.448979591836735
Control.SRR15539829;50;45;0.5;25;25;0;0.5
Control.SRR15539829;38;45;0.5;19;19;0;0.5
Control.SRR15539829;44;45;0.545454545454545;20;24;0.0454545454545454;0.454545454545455
Control.SRR15539829;44;45;0.613636363636364;17;27;0.113636363636364;0.386363636363636
Control.SRR15539829;41;45;0.390243902439024;25;16;0.109756097560976;0.390243902439024
Control.SRR15539829;50;45;0.5;25;25;0;0.5
Control.SRR15539829;44;45;0.5;22;22;0;0.5
Control.SRR15539829;49;45;0.428571428571429;28;21;0.0714285714285715;0.428571428571429
Control.SRR15539829;40;45;0.675;13;27;0.175;0.325
Control.SRR15539829;39;45;0.384615384615385;24;15;0.115384615384615;0.384615384615385
Control.SRR15539829;48;45;0.604166666666667;19;29;0.104166666666667;0.395833333333333
Control.SRR15539829;40;45;0.625;15;25;0.125;0.375
Control.SRR15539829;48;45;0.458333333333333;26;22;0.0416666666666667;0.458333333333333
Control.SRR15539829;44;45;0.454545454545455;24;20;0.0454545454545455;0.454545454545455
Control.SRR15539829;46;45;0.5;23;23;0;0.5
Control.SRR15539829;42;45;0.714285714285714;12;30;0.214285714285714;0.285714285714286
Control.SRR15539829;43;45;0.372093023255814;27;16;0.127906976744186;0.372093023255814
Control.SRR15539829;46;45;0.456521739130435;25;21;0.0434782608695652;0.456521739130435
Control.SRR15539829;49;45;0.591836734693878;20;29;0.0918367346938775;0.408163265306122
Control.SRR15539829;39;45;0.564102564102564;17;22;0.0641025641025641;0.435897435897436
Control.SRR15539829;41;45;0.536585365853659;19;22;0.0365853658536586;0.463414634146341
Control.SRR15539829;50;45;0.4;30;20;0.1;0.4
Control.SRR15539829;40;45;0.525;19;21;0.025;0.475
Control.SRR15539829;42;45;0.476190476190476;22;20;0.0238095238095238;0.476190476190476
Control.SRR15539829;39;45;0.538461538461538;18;21;0.0384615384615384;0.461538461538462
Control.SRR15539829;39;45;0.538461538461538;18;21;0.0384615384615384;0.461538461538462
Control.SRR15539829;42;45;0.5;21;21;0;0.5
Control.SRR15539829;39;45;0.512820512820513;19;20;0.0128205128205128;0.487179487179487
Control.SRR15539829;46;45;0.521739130434783;22;24;0.0217391304347826;0.478260869565217
Control.SRR15539829;45;45;0.422222222222222;26;19;0.0777777777777778;0.422222222222222
Control.SRR15539829;48;45;0.729166666666667;13;35;0.229166666666667;0.270833333333333
Control.SRR15539829;50;45;0.4;30;20;0.1;0.4
Control.SRR15539829;50;45;0.5;25;25;0;0.5
Control.SRR15539829;46;45;0.456521739130435;25;21;0.0434782608695652;0.456521739130435
Control.SRR15539829;45;45;0.4;27;18;0.1;0.4
Control.SRR15539829;45;45;0.577777777777778;19;26;0.0777777777777777;0.422222222222222
Control.SRR15539829;39;45;0.58974358974359;16;23;0.0897435897435898;0.41025641025641
Control.SRR15539829;42;45;0.5;21;21;0;0.5
Control.SRR15539829;46;45;0.369565217391304;29;17;0.130434782608696;0.369565217391304
Control.SRR15539829;47;45;0.553191489361702;21;26;0.0531914893617021;0.446808510638298
Control.SRR15539829;39;45;0.461538461538462;21;18;0.0384615384615384;0.461538461538462
Control.SRR15539829;43;45;0.604651162790698;17;26;0.104651162790698;0.395348837209302
Control.SRR15539829;42;45;0.404761904761905;25;17;0.0952380952380952;0.404761904761905
Control.SRR15539829;44;45;0.5;22;22;0;0.5
Control.SRR15539829;42;45;0.404761904761905;25;17;0.0952380952380952;0.404761904761905
Control.SRR15539829;43;45;0.372093023255814;27;16;0.127906976744186;0.372093023255814
Control.SRR15539829;50;45;0.58;21;29;0.08;0.42
Control.SRR15539829;47;45;0.617021276595745;18;29;0.117021276595745;0.382978723404255
Control.SRR15539829;47;45;0.574468085106383;20;27;0.074468085106383;0.425531914893617
Control.SRR15539829;40;45;0.375;25;15;0.125;0.375
Control.SRR15539829;43;45;0.488372093023256;22;21;0.0116279069767442;0.488372093023256
Control.SRR15539829;42;45;0.452380952380952;23;19;0.0476190476190476;0.452380952380952
Control.SRR15539829;43;45;0.534883720930233;20;23;0.0348837209302325;0.465116279069767
Control.SRR15539829;41;45;0.51219512195122;20;21;0.0121951219512195;0.48780487804878
Control.SRR15539829;38;45;0.526315789473684;18;20;0.0263157894736842;0.473684210526316
Control.SRR15539829;48;45;0.395833333333333;29;19;0.104166666666667;0.395833333333333
Control.SRR15539829;42;45;0.547619047619048;19;23;0.0476190476190477;0.452380952380952
Control.SRR15539829;46;45;0.630434782608696;17;29;0.130434782608696;0.369565217391304
Control.SRR15539829;39;45;0.487179487179487;20;19;0.0128205128205128;0.487179487179487
Control.SRR15539829;39;45;0.564102564102564;17;22;0.0641025641025641;0.435897435897436
Control.SRR15539829;41;45;0.463414634146341;22;19;0.0365853658536585;0.463414634146341
Control.SRR15539829;49;45;0.489795918367347;25;24;0.0102040816326531;0.489795918367347
Control.SRR15539829;45;45;0.622222222222222;17;28;0.122222222222222;0.377777777777778
Control.SRR15539829;42;45;0.404761904761905;25;17;0.0952380952380952;0.404761904761905
Control.SRR15539829;39;45;0.435897435897436;22;17;0.0641025641025641;0.435897435897436
Control.SRR15539829;44;45;0.454545454545455;24;20;0.0454545454545455;0.454545454545455
Control.SRR15539829;41;45;0.634146341463415;15;26;0.134146341463415;0.365853658536585
Control.SRR15539829;40;45;0.625;15;25;0.125;0.375
Control.SRR15539829;39;45;0.512820512820513;19;20;0.0128205128205128;0.487179487179487
Control.SRR15539829;40;45;0.45;22;18;0.05;0.45
Control.SRR15539829;45;45;0.511111111111111;22;23;0.0111111111111111;0.488888888888889
Control.SRR15539829;46;45;0.565217391304348;20;26;0.0652173913043478;0.434782608695652
Control.SRR15539829;50;45;0.56;22;28;0.0600000000000001;0.44
Control.SRR15539829;48;45;0.479166666666667;25;23;0.0208333333333333;0.479166666666667
Control.SRR15539829;42;45;0.571428571428571;18;24;0.0714285714285714;0.428571428571429
Control.SRR15539829;40;45;0.45;22;18;0.05;0.45
Control.SRR15539829;39;45;0.538461538461538;18;21;0.0384615384615384;0.461538461538462
Control.SRR15539829;46;45;0.565217391304348;20;26;0.0652173913043478;0.434782608695652
Control.SRR15539829;39;45;0.615384615384615;15;24;0.115384615384615;0.384615384615385
Control.SRR15539829;48;45;0.416666666666667;28;20;0.0833333333333333;0.416666666666667
Control.SRR15539829;44;45;0.431818181818182;25;19;0.0681818181818182;0.431818181818182
Control.SRR15539829;45;45;0.533333333333333;21;24;0.0333333333333333;0.466666666666667
Control.SRR15539829;48;45;0.520833333333333;23;25;0.0208333333333334;0.479166666666667
Control.SRR15539829;48;45;0.416666666666667;28;20;0.0833333333333333;0.416666666666667
Control.SRR15539829;43;45;0.441860465116279;24;19;0.0581395348837209;0.441860465116279
Control.SRR15539829;44;45;0.522727272727273;21;23;0.0227272727272727;0.477272727272727
Control.SRR15539829;40;45;0.475;21;19;0.025;0.475
Control.SRR15539829;39;45;0.641025641025641;14;25;0.141025641025641;0.358974358974359
Control.SRR15539829;43;45;0.558139534883721;19;24;0.0581395348837209;0.441860465116279
Control.SRR15539829;43;45;0.511627906976744;21;22;0.0116279069767442;0.488372093023256
Control.SRR15539829;42;45;0.523809523809524;20;22;0.0238095238095238;0.476190476190476
Control.SRR15539829;41;45;0.48780487804878;21;20;0.0121951219512195;0.48780487804878
Control.SRR15539829;47;45;0.531914893617021;22;25;0.0319148936170213;0.468085106382979
Control.SRR15539829;41;45;0.414634146341463;24;17;0.0853658536585366;0.414634146341463
Control.SRR15539829;43;45;0.534883720930233;20;23;0.0348837209302325;0.465116279069767
Control.SRR15539829;38;45;0.552631578947368;17;21;0.0526315789473685;0.447368421052632
Control.SRR15539829;39;45;0.512820512820513;19;20;0.0128205128205128;0.487179487179487
Control.SRR15539829;45;45;0.488888888888889;23;22;0.0111111111111111;0.488888888888889
Control.SRR15539829;43;45;0.488372093023256;22;21;0.0116279069767442;0.488372093023256
Control.SRR15539829;48;45;0.604166666666667;19;29;0.104166666666667;0.395833333333333
Control.SRR15539829;41;45;0.51219512195122;20;21;0.0121951219512195;0.48780487804878
Control.SRR15539829;39;45;0.435897435897436;22;17;0.0641025641025641;0.435897435897436
Control.SRR15539829;49;45;0.510204081632653;24;25;0.0102040816326531;0.489795918367347
Control.SRR15539829;49;45;0.428571428571429;28;21;0.0714285714285715;0.428571428571429
Control.SRR15539829;46;45;0.391304347826087;28;18;0.108695652173913;0.391304347826087
Control.SRR15539829;47;45;0.553191489361702;21;26;0.0531914893617021;0.446808510638298
Control.SRR15539829;39;45;0.435897435897436;22;17;0.0641025641025641;0.435897435897436
Control.SRR15539829;38;45;0.5;19;19;0;0.5
Control.SRR15539829;46;45;0.565217391304348;20;26;0.0652173913043478;0.434782608695652
Control.SRR15539829;47;45;0.553191489361702;21;26;0.0531914893617021;0.446808510638298
Control.SRR15539829;41;45;0.585365853658537;17;24;0.0853658536585366;0.414634146341463
Control.SRR15539829;46;45;0.5;23;23;0;0.5
Control.SRR15539829;46;45;0.543478260869565;21;25;0.0434782608695652;0.456521739130435
Control.SRR15539829;49;45;0.530612244897959;23;26;0.0306122448979592;0.469387755102041
Control.SRR15539829;48;45;0.479166666666667;25;23;0.0208333333333333;0.479166666666667
Control.SRR15539829;48;45;0.583333333333333;20;28;0.0833333333333334;0.416666666666667
Control.SRR15539829;48;45;0.416666666666667;28;20;0.0833333333333333;0.416666666666667
Control.SRR15539829;49;45;0.591836734693878;20;29;0.0918367346938775;0.408163265306122
Control.SRR15539829;45;45;0.555555555555556;20;25;0.0555555555555556;0.444444444444444
Control.SRR15539829;46;45;0.58695652173913;19;27;0.0869565217391305;0.41304347826087
Control.SRR15539829;50;45;0.52;24;26;0.02;0.48
Control.SRR15539829;48;45;0.541666666666667;22;26;0.0416666666666666;0.458333333333333
Control.SRR15539829;50;45;0.42;29;21;0.08;0.42
Control.SRR15539829;43;45;0.465116279069767;23;20;0.0348837209302326;0.465116279069767
Control.SRR15539829;50;45;0.44;28;22;0.06;0.44
Control.SRR15539829;48;45;0.4375;27;21;0.0625;0.4375
Control.SRR15539829;39;45;0.512820512820513;19;20;0.0128205128205128;0.487179487179487
Control.SRR15539829;41;45;0.463414634146341;22;19;0.0365853658536585;0.463414634146341
Control.SRR15539829;49;45;0.387755102040816;30;19;0.112244897959184;0.387755102040816
Control.SRR15539829;46;45;0.521739130434783;22;24;0.0217391304347826;0.478260869565217
Control.SRR15539829;42;45;0.523809523809524;20;22;0.0238095238095238;0.476190476190476
Control.SRR15539829;42;45;0.547619047619048;19;23;0.0476190476190477;0.452380952380952
Control.SRR15539829;40;45;0.525;19;21;0.025;0.475
Control.SRR15539829;50;45;0.34;33;17;0.16;0.34
Control.SRR15539829;49;45;0.408163265306122;29;20;0.0918367346938775;0.408163265306122
Control.SRR15539829;38;45;0.473684210526316;20;18;0.0263157894736842;0.473684210526316
Control.SRR15539829;42;45;0.476190476190476;22;20;0.0238095238095238;0.476190476190476
Control.SRR15539829;50;45;0.48;26;24;0.02;0.48
Control.SRR15539829;50;45;0.48;26;24;0.02;0.48
Control.SRR15539829;49;45;0.510204081632653;24;25;0.0102040816326531;0.489795918367347
Control.SRR15539829;50;45;0.5;25;25;0;0.5
Control.SRR15539829;44;45;0.545454545454545;20;24;0.0454545454545454;0.454545454545455
Control.SRR15539829;50;45;0.54;23;27;0.04;0.46
Control.SRR15539829;45;45;0.444444444444444;25;20;0.0555555555555556;0.444444444444444
Control.SRR15539829;48;45;0.583333333333333;20;28;0.0833333333333334;0.416666666666667
Control.SRR15539829;48;45;0.604166666666667;19;29;0.104166666666667;0.395833333333333
Control.SRR15539829;45;45;0.4;27;18;0.1;0.4
Control.SRR15539829;47;45;0.404255319148936;28;19;0.0957446808510639;0.404255319148936
Control.SRR15539829;50;45;0.46;27;23;0.04;0.46
Control.SRR15539829;47;45;0.446808510638298;26;21;0.0531914893617021;0.446808510638298
Control.SRR15539829;41;45;0.365853658536585;26;15;0.134146341463415;0.365853658536585
Control.SRR15539829;44;45;0.522727272727273;21;23;0.0227272727272727;0.477272727272727
Control.SRR15539829;49;45;0.469387755102041;26;23;0.0306122448979592;0.469387755102041
Control.SRR15539829;42;45;0.452380952380952;23;19;0.0476190476190476;0.452380952380952
Control.SRR15539829;48;45;0.583333333333333;20;28;0.0833333333333334;0.416666666666667
Control.SRR15539829;45;45;0.488888888888889;23;22;0.0111111111111111;0.488888888888889
Control.SRR15539829;38;45;0.447368421052632;21;17;0.0526315789473684;0.447368421052632
Control.SRR15539829;41;45;0.536585365853659;19;22;0.0365853658536586;0.463414634146341
Control.SRR15539829;46;45;0.543478260869565;21;25;0.0434782608695652;0.456521739130435
Control.SRR15539829;45;45;0.488888888888889;23;22;0.0111111111111111;0.488888888888889
Control.SRR15539829;42;45;0.571428571428571;18;24;0.0714285714285714;0.428571428571429
Control.SRR15539829;45;45;0.4;27;18;0.1;0.4
Control.SRR15539829;42;45;0.357142857142857;27;15;0.142857142857143;0.357142857142857
Control.SRR15539829;50;45;0.52;24;26;0.02;0.48
Control.SRR15539829;46;45;0.5;23;23;0;0.5
Control.SRR15539829;50;45;0.44;28;22;0.06;0.44
Control.SRR15539829;43;45;0.395348837209302;26;17;0.104651162790698;0.395348837209302
Control.SRR15539829;48;45;0.604166666666667;19;29;0.104166666666667;0.395833333333333
Control.SRR15539829;50;45;0.48;26;24;0.02;0.48
Control.SRR15539829;43;45;0.418604651162791;25;18;0.0813953488372093;0.418604651162791
Control.SRR15539829;43;45;0.651162790697674;15;28;0.151162790697674;0.348837209302326
Control.SRR15539829;43;45;0.604651162790698;17;26;0.104651162790698;0.395348837209302
Control.SRR15539829;47;45;0.48936170212766;24;23;0.0106382978723404;0.48936170212766
Control.SRR15539829;47;45;0.404255319148936;28;19;0.0957446808510639;0.404255319148936
Control.SRR15539829;48;45;0.5;24;24;0;0.5
Control.SRR15539829;48;45;0.5;24;24;0;0.5
Control.SRR15539829;50;45;0.54;23;27;0.04;0.46
Control.SRR15539829;47;45;0.425531914893617;27;20;0.074468085106383;0.425531914893617
Control.SRR15539829;43;45;0.558139534883721;19;24;0.0581395348837209;0.441860465116279
Control.SRR15539829;50;45;0.48;26;24;0.02;0.48
Control.SRR15539829;49;45;0.551020408163265;22;27;0.0510204081632653;0.448979591836735
Control.SRR15539829;49;45;0.551020408163265;22;27;0.0510204081632653;0.448979591836735
Control.SRR15539829;43;45;0.511627906976744;21;22;0.0116279069767442;0.488372093023256
Control.SRR15539829;47;45;0.468085106382979;25;22;0.0319148936170213;0.468085106382979
Control.SRR15539829;46;45;0.521739130434783;22;24;0.0217391304347826;0.478260869565217
Control.SRR15539829;38;45;0.526315789473684;18;20;0.0263157894736842;0.473684210526316
Control.SRR15539829;42;45;0.5;21;21;0;0.5
Control.SRR15539829;41;45;0.658536585365854;14;27;0.158536585365854;0.341463414634146
Control.SRR15539829;38;45;0.552631578947368;17;21;0.0526315789473685;0.447368421052632
Control.SRR15539829;38;45;0.526315789473684;18;20;0.0263157894736842;0.473684210526316
Control.SRR15539829;42;45;0.571428571428571;18;24;0.0714285714285714;0.428571428571429
Control.SRR15539829;41;45;0.536585365853659;19;22;0.0365853658536586;0.463414634146341
Control.SRR15539829;47;45;0.425531914893617;27;20;0.074468085106383;0.425531914893617
Control.SRR15539829;50;45;0.52;24;26;0.02;0.48
Control.SRR15539829;48;45;0.4375;27;21;0.0625;0.4375
Control.SRR15539829;41;45;0.560975609756098;18;23;0.0609756097560976;0.439024390243902
Control.SRR15539829;48;45;0.458333333333333;26;22;0.0416666666666667;0.458333333333333
Control.SRR15539829;49;45;0.530612244897959;23;26;0.0306122448979592;0.469387755102041
Control.SRR15539829;45;45;0.533333333333333;21;24;0.0333333333333333;0.466666666666667
Control.SRR15539829;39;45;0.487179487179487;20;19;0.0128205128205128;0.487179487179487
Control.SRR15539829;45;45;0.511111111111111;22;23;0.0111111111111111;0.488888888888889
Control.SRR15539829;46;45;0.5;23;23;0;0.5
Control.SRR15539829;39;45;0.487179487179487;20;19;0.0128205128205128;0.487179487179487
Control.SRR15539829;43;45;0.395348837209302;26;17;0.104651162790698;0.395348837209302
Control.SRR15539829;45;45;0.488888888888889;23;22;0.0111111111111111;0.488888888888889
Control.SRR15539829;41;45;0.439024390243902;23;18;0.0609756097560976;0.439024390243902
Control.SRR15539829;41;45;0.536585365853659;19;22;0.0365853658536586;0.463414634146341
Control.SRR15539829;45;45;0.488888888888889;23;22;0.0111111111111111;0.488888888888889
Control.SRR15539829;43;45;0.372093023255814;27;16;0.127906976744186;0.372093023255814
Control.SRR15539829;44;45;0.477272727272727;23;21;0.0227272727272727;0.477272727272727
Control.SRR15539829;43;45;0.325581395348837;29;14;0.174418604651163;0.325581395348837
Control.SRR15539829;44;45;0.386363636363636;27;17;0.113636363636364;0.386363636363636
Control.SRR15539829;39;45;0.512820512820513;19;20;0.0128205128205128;0.487179487179487
Control.SRR15539829;50;45;0.54;23;27;0.04;0.46
Control.SRR15539829;47;45;0.382978723404255;29;18;0.117021276595745;0.382978723404255
Control.SRR15539829;45;45;0.533333333333333;21;24;0.0333333333333333;0.466666666666667
Control.SRR15539829;48;45;0.6875;15;33;0.1875;0.3125
Control.SRR15539829;45;45;0.422222222222222;26;19;0.0777777777777778;0.422222222222222
Control.SRR15539829;47;45;0.446808510638298;26;21;0.0531914893617021;0.446808510638298
Control.SRR15539829;43;45;0.581395348837209;18;25;0.0813953488372093;0.418604651162791
Control.SRR15539829;40;45;0.425;23;17;0.075;0.425
Control.SRR15539829;42;45;0.380952380952381;26;16;0.119047619047619;0.380952380952381
Control.SRR15539829;43;45;0.465116279069767;23;20;0.0348837209302326;0.465116279069767
Control.SRR15539829;43;45;0.511627906976744;21;22;0.0116279069767442;0.488372093023256
Control.SRR15539829;50;45;0.54;23;27;0.04;0.46
Control.SRR15539829;48;45;0.520833333333333;23;25;0.0208333333333334;0.479166666666667
Control.SRR15539829;48;45;0.416666666666667;28;20;0.0833333333333333;0.416666666666667
Control.SRR15539829;42;45;0.595238095238095;17;25;0.0952380952380952;0.404761904761905
Control.SRR15539829;38;45;0.526315789473684;18;20;0.0263157894736842;0.473684210526316
Control.SRR15539829;49;45;0.612244897959184;19;30;0.112244897959184;0.387755102040816
Control.SRR15539829;50;45;0.46;27;23;0.04;0.46
Control.SRR15539829;49;45;0.448979591836735;27;22;0.0510204081632653;0.448979591836735
Control.SRR15539829;44;45;0.5;22;22;0;0.5
Control.SRR15539829;40;45;0.375;25;15;0.125;0.375
Control.SRR15539829;50;45;0.44;28;22;0.06;0.44
Control.SRR15539829;46;45;0.58695652173913;19;27;0.0869565217391305;0.41304347826087
Control.SRR15539829;41;45;0.463414634146341;22;19;0.0365853658536585;0.463414634146341
Control.SRR15539829;47;45;0.48936170212766;24;23;0.0106382978723404;0.48936170212766
Control.SRR15539829;49;45;0.551020408163265;22;27;0.0510204081632653;0.448979591836735
Control.SRR15539829;49;45;0.408163265306122;29;20;0.0918367346938775;0.408163265306122
Control.SRR15539829;41;45;0.536585365853659;19;22;0.0365853658536586;0.463414634146341
Control.SRR15539829;48;45;0.458333333333333;26;22;0.0416666666666667;0.458333333333333
Control.SRR15539829;48;45;0.5625;21;27;0.0625;0.4375
Control.SRR15539829;48;45;0.541666666666667;22;26;0.0416666666666666;0.458333333333333
Control.SRR15539829;38;45;0.578947368421053;16;22;0.0789473684210527;0.421052631578947
Control.SRR15539829;49;45;0.428571428571429;28;21;0.0714285714285715;0.428571428571429
Control.SRR15539829;45;45;0.577777777777778;19;26;0.0777777777777777;0.422222222222222
Control.SRR15539829;48;45;0.5;24;24;0;0.5
Control.SRR15539829;43;45;0.372093023255814;27;16;0.127906976744186;0.372093023255814
Control.SRR15539829;49;45;0.469387755102041;26;23;0.0306122448979592;0.469387755102041
Control.SRR15539829;47;45;0.553191489361702;21;26;0.0531914893617021;0.446808510638298
Control.SRR15539829;47;45;0.51063829787234;23;24;0.0106382978723404;0.48936170212766
Control.SRR15539829;48;45;0.5;24;24;0;0.5
Control.SRR15539829;45;45;0.488888888888889;23;22;0.0111111111111111;0.488888888888889
Control.SRR15539829;40;45;0.475;21;19;0.025;0.475
Control.SRR15539829;50;45;0.56;22;28;0.0600000000000001;0.44
Control.SRR15539829;42;45;0.547619047619048;19;23;0.0476190476190477;0.452380952380952
Control.SRR15539829;47;45;0.51063829787234;23;24;0.0106382978723404;0.48936170212766
Control.SRR15539829;49;45;0.448979591836735;27;22;0.0510204081632653;0.448979591836735
Control.SRR15539829;44;45;0.522727272727273;21;23;0.0227272727272727;0.477272727272727
Control.SRR15539829;46;45;0.478260869565217;24;22;0.0217391304347826;0.478260869565217
Control.SRR15539829;39;45;0.487179487179487;20;19;0.0128205128205128;0.487179487179487
Control.SRR15539829;48;45;0.416666666666667;28;20;0.0833333333333333;0.416666666666667
Control.SRR15539829;50;45;0.4;30;20;0.1;0.4
Control.SRR15539829;44;45;0.454545454545455;24;20;0.0454545454545455;0.454545454545455
Control.SRR15539829;46;45;0.478260869565217;24;22;0.0217391304347826;0.478260869565217
Control.SRR15539829;47;45;0.404255319148936;28;19;0.0957446808510639;0.404255319148936
Control.SRR15539829;38;45;0.552631578947368;17;21;0.0526315789473685;0.447368421052632
Control.SRR15539829;50;45;0.38;31;19;0.12;0.38
Control.SRR15539829;44;45;0.5;22;22;0;0.5
Control.SRR15539829;38;45;0.526315789473684;18;20;0.0263157894736842;0.473684210526316
Control.SRR15539829;40;45;0.525;19;21;0.025;0.475
Control.SRR15539829;45;45;0.488888888888889;23;22;0.0111111111111111;0.488888888888889
Control.SRR15539829;42;45;0.5;21;21;0;0.5
Control.SRR15539829;46;45;0.478260869565217;24;22;0.0217391304347826;0.478260869565217
Control.SRR15539829;49;45;0.530612244897959;23;26;0.0306122448979592;0.469387755102041
Control.SRR15539829;45;45;0.4;27;18;0.1;0.4
Control.SRR15539829;47;45;0.48936170212766;24;23;0.0106382978723404;0.48936170212766
Control.SRR15539829;45;45;0.488888888888889;23;22;0.0111111111111111;0.488888888888889
Control.SRR15539829;47;45;0.468085106382979;25;22;0.0319148936170213;0.468085106382979
Control.SRR15539829;50;45;0.54;23;27;0.04;0.46
Control.SRR15539829;48;45;0.395833333333333;29;19;0.104166666666667;0.395833333333333
Control.SRR15539829;47;45;0.574468085106383;20;27;0.074468085106383;0.425531914893617
Control.SRR15539829;41;45;0.48780487804878;21;20;0.0121951219512195;0.48780487804878
Control.SRR15539829;39;45;0.41025641025641;23;16;0.0897435897435898;0.41025641025641
Control.SRR15539829;46;45;0.5;23;23;0;0.5
Control.SRR15539829;49;45;0.489795918367347;25;24;0.0102040816326531;0.489795918367347
Control.SRR15539829;50;45;0.58;21;29;0.08;0.42
Control.SRR15539829;47;45;0.404255319148936;28;19;0.0957446808510639;0.404255319148936
Control.SRR15539829;47;45;0.468085106382979;25;22;0.0319148936170213;0.468085106382979
Control.SRR15539829;47;45;0.595744680851064;19;28;0.0957446808510638;0.404255319148936
Control.SRR15539829;46;45;0.369565217391304;29;17;0.130434782608696;0.369565217391304
Control.SRR15539829;48;45;0.520833333333333;23;25;0.0208333333333334;0.479166666666667
Control.SRR15539829;50;45;0.6;20;30;0.1;0.4
Control.SRR15539829;45;45;0.466666666666667;24;21;0.0333333333333333;0.466666666666667
Control.SRR15539829;41;45;0.536585365853659;19;22;0.0365853658536586;0.463414634146341
Control.SRR15539829;38;45;0.394736842105263;23;15;0.105263157894737;0.394736842105263
Control.SRR15539829;46;45;0.5;23;23;0;0.5
Control.SRR15539829;40;45;0.35;26;14;0.15;0.35
Control.SRR15539829;40;45;0.65;14;26;0.15;0.35
Control.SRR15539829;46;45;0.565217391304348;20;26;0.0652173913043478;0.434782608695652
Control.SRR15539829;47;45;0.51063829787234;23;24;0.0106382978723404;0.48936170212766
Control.SRR15539829;46;45;0.5;23;23;0;0.5
Control.SRR15539829;40;45;0.425;23;17;0.075;0.425
Control.SRR15539829;44;45;0.477272727272727;23;21;0.0227272727272727;0.477272727272727
Control.SRR15539829;47;45;0.48936170212766;24;23;0.0106382978723404;0.48936170212766
Control.SRR15539829;43;45;0.511627906976744;21;22;0.0116279069767442;0.488372093023256
Control.SRR15539829;45;45;0.622222222222222;17;28;0.122222222222222;0.377777777777778
Control.SRR15539829;41;45;0.48780487804878;21;20;0.0121951219512195;0.48780487804878
Control.SRR15539829;49;45;0.489795918367347;25;24;0.0102040816326531;0.489795918367347
Control.SRR15539829;46;45;0.369565217391304;29;17;0.130434782608696;0.369565217391304
Control.SRR15539829;45;45;0.533333333333333;21;24;0.0333333333333333;0.466666666666667
Control.SRR15539829;50;45;0.5;25;25;0;0.5
Control.SRR15539829;50;45;0.4;30;20;0.1;0.4
Control.SRR15539829;47;45;0.446808510638298;26;21;0.0531914893617021;0.446808510638298
Control.SRR15539829;49;45;0.428571428571429;28;21;0.0714285714285715;0.428571428571429
Control.SRR15539829;50;45;0.46;27;23;0.04;0.46
Control.SRR15539829;47;45;0.48936170212766;24;23;0.0106382978723404;0.48936170212766
Control.SRR15539829;40;45;0.55;18;22;0.05;0.45
Control.SRR15539829;41;45;0.463414634146341;22;19;0.0365853658536585;0.463414634146341
Control.SRR15539829;44;45;0.5;22;22;0;0.5
Control.SRR15539829;50;45;0.46;27;23;0.04;0.46
Control.SRR15539829;49;45;0.469387755102041;26;23;0.0306122448979592;0.469387755102041
Control.SRR15539829;50;45;0.56;22;28;0.0600000000000001;0.44
Control.SRR15539829;40;45;0.475;21;19;0.025;0.475
Control.SRR15539829;43;45;0.465116279069767;23;20;0.0348837209302326;0.465116279069767
Control.SRR15539829;41;45;0.51219512195122;20;21;0.0121951219512195;0.48780487804878
Control.SRR15539829;45;45;0.466666666666667;24;21;0.0333333333333333;0.466666666666667
Control.SRR15539829;47;45;0.595744680851064;19;28;0.0957446808510638;0.404255319148936
Control.SRR15539829;41;45;0.390243902439024;25;16;0.109756097560976;0.390243902439024
Control.SRR15539829;45;45;0.466666666666667;24;21;0.0333333333333333;0.466666666666667
Control.SRR15539829;49;45;0.489795918367347;25;24;0.0102040816326531;0.489795918367347
Control.SRR15539829;43;45;0.581395348837209;18;25;0.0813953488372093;0.418604651162791
Control.SRR15539829;40;45;0.525;19;21;0.025;0.475
Control.SRR15539829;40;45;0.45;22;18;0.05;0.45
Control.SRR15539829;45;45;0.511111111111111;22;23;0.0111111111111111;0.488888888888889
Control.SRR15539829;45;45;0.466666666666667;24;21;0.0333333333333333;0.466666666666667
Control.SRR15539829;43;45;0.418604651162791;25;18;0.0813953488372093;0.418604651162791
Control.SRR15539829;47;45;0.382978723404255;29;18;0.117021276595745;0.382978723404255
Control.SRR15539829;50;45;0.48;26;24;0.02;0.48
Control.SRR15539829;41;45;0.585365853658537;17;24;0.0853658536585366;0.414634146341463
Control.SRR15539829;44;45;0.409090909090909;26;18;0.0909090909090909;0.409090909090909
Control.SRR15539829;46;45;0.521739130434783;22;24;0.0217391304347826;0.478260869565217
Control.SRR15539829;46;45;0.58695652173913;19;27;0.0869565217391305;0.41304347826087
Control.SRR15539829;44;45;0.590909090909091;18;26;0.0909090909090909;0.409090909090909
Control.SRR15539829;47;45;0.595744680851064;19;28;0.0957446808510638;0.404255319148936
Control.SRR15539829;49;45;0.448979591836735;27;22;0.0510204081632653;0.448979591836735
Control.SRR15539829;45;45;0.533333333333333;21;24;0.0333333333333333;0.466666666666667
Control.SRR15539829;43;45;0.558139534883721;19;24;0.0581395348837209;0.441860465116279
Control.SRR15539829;42;45;0.452380952380952;23;19;0.0476190476190476;0.452380952380952
Control.SRR15539829;46;45;0.58695652173913;19;27;0.0869565217391305;0.41304347826087
Control.SRR15539829;49;45;0.530612244897959;23;26;0.0306122448979592;0.469387755102041
Control.SRR15539829;40;45;0.4;24;16;0.1;0.4
Control.SRR15539829;50;45;0.58;21;29;0.08;0.42
Control.SRR15539829;38;45;0.5;19;19;0;0.5
Control.SRR15539829;42;45;0.595238095238095;17;25;0.0952380952380952;0.404761904761905
Control.SRR15539829;44;45;0.590909090909091;18;26;0.0909090909090909;0.409090909090909
Control.SRR15539829;49;45;0.551020408163265;22;27;0.0510204081632653;0.448979591836735
Control.SRR15539829;45;45;0.355555555555556;29;16;0.144444444444444;0.355555555555556
Control.SRR15539829;47;45;0.595744680851064;19;28;0.0957446808510638;0.404255319148936
Control.SRR15539829;38;45;0.552631578947368;17;21;0.0526315789473685;0.447368421052632
Control.SRR15539829;43;45;0.418604651162791;25;18;0.0813953488372093;0.418604651162791
Control.SRR15539829;43;45;0.465116279069767;23;20;0.0348837209302326;0.465116279069767
Control.SRR15539829;49;45;0.489795918367347;25;24;0.0102040816326531;0.489795918367347
Control.SRR15539829;47;45;0.531914893617021;22;25;0.0319148936170213;0.468085106382979
Control.SRR15539829;42;45;0.452380952380952;23;19;0.0476190476190476;0.452380952380952
Control.SRR15539829;46;45;0.521739130434783;22;24;0.0217391304347826;0.478260869565217
Control.SRR15539829;47;45;0.531914893617021;22;25;0.0319148936170213;0.468085106382979
Control.SRR15539829;39;45;0.461538461538462;21;18;0.0384615384615384;0.461538461538462
Control.SRR15539829;50;45;0.56;22;28;0.0600000000000001;0.44
Control.SRR15539829;42;45;0.404761904761905;25;17;0.0952380952380952;0.404761904761905
Control.SRR15539829;42;45;0.523809523809524;20;22;0.0238095238095238;0.476190476190476
Control.SRR15539829;47;45;0.468085106382979;25;22;0.0319148936170213;0.468085106382979
Control.SRR15539829;39;45;0.538461538461538;18;21;0.0384615384615384;0.461538461538462
Control.SRR15539829;49;45;0.63265306122449;18;31;0.13265306122449;0.36734693877551
Control.SRR15539829;43;45;0.465116279069767;23;20;0.0348837209302326;0.465116279069767
Control.SRR15539829;44;45;0.409090909090909;26;18;0.0909090909090909;0.409090909090909
Control.SRR15539829;39;45;0.41025641025641;23;16;0.0897435897435898;0.41025641025641
Control.SRR15539829;45;45;0.488888888888889;23;22;0.0111111111111111;0.488888888888889
Control.SRR15539829;44;45;0.477272727272727;23;21;0.0227272727272727;0.477272727272727
Control.SRR15539829;39;45;0.487179487179487;20;19;0.0128205128205128;0.487179487179487
Control.SRR15539829;41;45;0.536585365853659;19;22;0.0365853658536586;0.463414634146341
Control.SRR15539829;50;45;0.36;32;18;0.14;0.36
Control.SRR15539829;50;45;0.44;28;22;0.06;0.44
Control.SRR15539829;43;45;0.418604651162791;25;18;0.0813953488372093;0.418604651162791
Control.SRR15539829;43;45;0.581395348837209;18;25;0.0813953488372093;0.418604651162791
Control.SRR15539829;46;45;0.456521739130435;25;21;0.0434782608695652;0.456521739130435
Control.SRR15539829;49;45;0.489795918367347;25;24;0.0102040816326531;0.489795918367347
Control.SRR15539829;49;45;0.489795918367347;25;24;0.0102040816326531;0.489795918367347
Control.SRR15539829;40;45;0.475;21;19;0.025;0.475
Control.SRR15539829;39;45;0.487179487179487;20;19;0.0128205128205128;0.487179487179487
Control.SRR15539829;44;45;0.454545454545455;24;20;0.0454545454545455;0.454545454545455
Control.SRR15539829;41;45;0.560975609756098;18;23;0.0609756097560976;0.439024390243902
Control.SRR15539829;47;45;0.48936170212766;24;23;0.0106382978723404;0.48936170212766
Control.SRR15539829;42;45;0.523809523809524;20;22;0.0238095238095238;0.476190476190476
Control.SRR15539829;49;45;0.469387755102041;26;23;0.0306122448979592;0.469387755102041
Control.SRR15539829;48;45;0.458333333333333;26;22;0.0416666666666667;0.458333333333333
Control.SRR15539829;50;45;0.52;24;26;0.02;0.48
Control.SRR15539829;43;45;0.604651162790698;17;26;0.104651162790698;0.395348837209302
Control.SRR15539829;48;45;0.416666666666667;28;20;0.0833333333333333;0.416666666666667
Control.SRR15539829;39;45;0.564102564102564;17;22;0.0641025641025641;0.435897435897436
Control.SRR15539829;48;45;0.458333333333333;26;22;0.0416666666666667;0.458333333333333
Control.SRR15539829;40;45;0.4;24;16;0.1;0.4
Control.SRR15539829;49;45;0.428571428571429;28;21;0.0714285714285715;0.428571428571429
Control.SRR15539829;44;45;0.613636363636364;17;27;0.113636363636364;0.386363636363636
Control.SRR15539829;41;45;0.439024390243902;23;18;0.0609756097560976;0.439024390243902
Control.SRR15539829;43;45;0.488372093023256;22;21;0.0116279069767442;0.488372093023256
Control.SRR15539829;50;45;0.48;26;24;0.02;0.48
Control.SRR15539829;50;45;0.56;22;28;0.0600000000000001;0.44
Control.SRR15539829;39;45;0.615384615384615;15;24;0.115384615384615;0.384615384615385
Control.SRR15539829;41;45;0.439024390243902;23;18;0.0609756097560976;0.439024390243902
Control.SRR15539829;44;45;0.568181818181818;19;25;0.0681818181818182;0.431818181818182
Control.SRR15539829;47;45;0.595744680851064;19;28;0.0957446808510638;0.404255319148936
Control.SRR15539829;41;45;0.48780487804878;21;20;0.0121951219512195;0.48780487804878
Control.SRR15539829;46;45;0.41304347826087;27;19;0.0869565217391304;0.41304347826087
Control.SRR15539829;50;45;0.56;22;28;0.0600000000000001;0.44
Control.SRR15539829;44;45;0.522727272727273;21;23;0.0227272727272727;0.477272727272727
Control.SRR15539829;44;45;0.409090909090909;26;18;0.0909090909090909;0.409090909090909
Control.SRR15539829;45;45;0.377777777777778;28;17;0.122222222222222;0.377777777777778
Control.SRR15539829;47;45;0.617021276595745;18;29;0.117021276595745;0.382978723404255
Control.SRR15539829;47;45;0.446808510638298;26;21;0.0531914893617021;0.446808510638298
Control.SRR15539829;42;45;0.523809523809524;20;22;0.0238095238095238;0.476190476190476
Control.SRR15539829;39;45;0.538461538461538;18;21;0.0384615384615384;0.461538461538462
Control.SRR15539829;50;45;0.52;24;26;0.02;0.48
Control.SRR15539829;43;45;0.534883720930233;20;23;0.0348837209302325;0.465116279069767
Control.SRR15539829;38;45;0.552631578947368;17;21;0.0526315789473685;0.447368421052632
Control.SRR15539829;47;45;0.425531914893617;27;20;0.074468085106383;0.425531914893617
Control.SRR15539829;39;45;0.461538461538462;21;18;0.0384615384615384;0.461538461538462
Control.SRR15539829;40;45;0.425;23;17;0.075;0.425
Control.SRR15539829;44;45;0.522727272727273;21;23;0.0227272727272727;0.477272727272727
Control.SRR15539829;41;45;0.48780487804878;21;20;0.0121951219512195;0.48780487804878
Control.SRR15539829;44;45;0.454545454545455;24;20;0.0454545454545455;0.454545454545455
Control.SRR15539829;41;45;0.560975609756098;18;23;0.0609756097560976;0.439024390243902
Control.SRR15539829;39;45;0.461538461538462;21;18;0.0384615384615384;0.461538461538462
Control.SRR15539829;43;45;0.627906976744186;16;27;0.127906976744186;0.372093023255814
Control.SRR15539829;47;45;0.446808510638298;26;21;0.0531914893617021;0.446808510638298
Control.SRR15539829;50;45;0.42;29;21;0.08;0.42
Control.SRR15539829;41;45;0.560975609756098;18;23;0.0609756097560976;0.439024390243902
Control.SRR15539829;49;45;0.612244897959184;19;30;0.112244897959184;0.387755102040816
Control.SRR15539829;46;45;0.565217391304348;20;26;0.0652173913043478;0.434782608695652
Control.SRR15539829;38;45;0.552631578947368;17;21;0.0526315789473685;0.447368421052632
Control.SRR15539829;47;45;0.574468085106383;20;27;0.074468085106383;0.425531914893617
Control.SRR15539829;45;45;0.511111111111111;22;23;0.0111111111111111;0.488888888888889
Control.SRR15539829;50;45;0.54;23;27;0.04;0.46
Control.SRR15539829;48;45;0.5;24;24;0;0.5
Control.SRR15539829;42;45;0.452380952380952;23;19;0.0476190476190476;0.452380952380952
Control.SRR15539829;44;45;0.568181818181818;19;25;0.0681818181818182;0.431818181818182
Control.SRR15539829;46;45;0.5;23;23;0;0.5
Control.SRR15539829;44;45;0.454545454545455;24;20;0.0454545454545455;0.454545454545455
Control.SRR15539829;44;45;0.522727272727273;21;23;0.0227272727272727;0.477272727272727
Control.SRR15539829;48;45;0.395833333333333;29;19;0.104166666666667;0.395833333333333
Control.SRR15539829;48;45;0.4375;27;21;0.0625;0.4375
Control.SRR15539829;41;45;0.51219512195122;20;21;0.0121951219512195;0.48780487804878
Control.SRR15539829;40;45;0.4;24;16;0.1;0.4
Control.SRR15539829;49;45;0.489795918367347;25;24;0.0102040816326531;0.489795918367347
Control.SRR15539829;46;45;0.565217391304348;20;26;0.0652173913043478;0.434782608695652
Control.SRR15539829;46;45;0.5;23;23;0;0.5
Control.SRR15539829;50;45;0.54;23;27;0.04;0.46
Control.SRR15539829;50;45;0.46;27;23;0.04;0.46
Control.SRR15539829;40;45;0.525;19;21;0.025;0.475
Control.SRR15539829;48;45;0.4375;27;21;0.0625;0.4375
Control.SRR15539829;47;45;0.425531914893617;27;20;0.074468085106383;0.425531914893617
Control.SRR15539829;48;45;0.395833333333333;29;19;0.104166666666667;0.395833333333333
Control.SRR15539829;45;45;0.6;18;27;0.1;0.4
Control.SRR15539829;49;45;0.36734693877551;31;18;0.13265306122449;0.36734693877551
Control.SRR15539829;43;45;0.558139534883721;19;24;0.0581395348837209;0.441860465116279
Control.SRR15539829;38;45;0.578947368421053;16;22;0.0789473684210527;0.421052631578947
Control.SRR15539829;39;45;0.564102564102564;17;22;0.0641025641025641;0.435897435897436
Control.SRR15539829;40;45;0.45;22;18;0.05;0.45
Control.SRR15539829;42;45;0.452380952380952;23;19;0.0476190476190476;0.452380952380952
Control.SRR15539829;47;45;0.425531914893617;27;20;0.074468085106383;0.425531914893617
Control.SRR15539829;39;45;0.41025641025641;23;16;0.0897435897435898;0.41025641025641
Control.SRR15539829;50;45;0.38;31;19;0.12;0.38
Control.SRR15539829;47;45;0.51063829787234;23;24;0.0106382978723404;0.48936170212766
Control.SRR15539829;42;45;0.476190476190476;22;20;0.0238095238095238;0.476190476190476
Control.SRR15539829;48;45;0.479166666666667;25;23;0.0208333333333333;0.479166666666667
Control.SRR15539829;47;45;0.446808510638298;26;21;0.0531914893617021;0.446808510638298
Control.SRR15539829;50;45;0.42;29;21;0.08;0.42
Control.SRR15539829;50;45;0.62;19;31;0.12;0.38
Control.SRR15539829;42;45;0.571428571428571;18;24;0.0714285714285714;0.428571428571429
Control.SRR15539829;47;45;0.595744680851064;19;28;0.0957446808510638;0.404255319148936
Control.SRR15539829;50;45;0.58;21;29;0.08;0.42
Control.SRR15539829;41;45;0.51219512195122;20;21;0.0121951219512195;0.48780487804878
Control.SRR15539829;45;45;0.555555555555556;20;25;0.0555555555555556;0.444444444444444
Control.SRR15539829;46;45;0.456521739130435;25;21;0.0434782608695652;0.456521739130435
Control.SRR15539829;44;45;0.477272727272727;23;21;0.0227272727272727;0.477272727272727
Control.SRR15539829;39;45;0.435897435897436;22;17;0.0641025641025641;0.435897435897436
Control.SRR15539829;41;45;0.439024390243902;23;18;0.0609756097560976;0.439024390243902
Control.SRR15539829;50;45;0.6;20;30;0.1;0.4
Control.SRR15539829;46;45;0.521739130434783;22;24;0.0217391304347826;0.478260869565217
Control.SRR15539829;47;45;0.425531914893617;27;20;0.074468085106383;0.425531914893617
Control.SRR15539829;42;45;0.619047619047619;16;26;0.119047619047619;0.380952380952381
Control.SRR15539829;42;45;0.595238095238095;17;25;0.0952380952380952;0.404761904761905
Control.SRR15539829;52;45;0.442307692307692;29;23;0.0576923076923077;0.442307692307692
Control.SRR15539829;52;45;0.5;26;26;0;0.5
Control.SRR15539829;43;45;0.581395348837209;18;25;0.0813953488372093;0.418604651162791
Control.SRR15539829;43;45;0.488372093023256;22;21;0.0116279069767442;0.488372093023256
Control.SRR15539829;43;45;0.581395348837209;18;25;0.0813953488372093;0.418604651162791
Control.SRR15539829;45;45;0.622222222222222;17;28;0.122222222222222;0.377777777777778
Control.SRR15539829;43;45;0.395348837209302;26;17;0.104651162790698;0.395348837209302
Control.SRR15539829;42;45;0.619047619047619;16;26;0.119047619047619;0.380952380952381
Control.SRR15539829;48;45;0.520833333333333;23;25;0.0208333333333334;0.479166666666667
Control.SRR15539829;45;45;0.533333333333333;21;24;0.0333333333333333;0.466666666666667
Control.SRR15539829;48;45;0.541666666666667;22;26;0.0416666666666666;0.458333333333333
Control.SRR15539829;48;45;0.541666666666667;22;26;0.0416666666666666;0.458333333333333
Control.SRR15539829;43;45;0.604651162790698;17;26;0.104651162790698;0.395348837209302
Control.SRR15539829;52;45;0.576923076923077;22;30;0.0769230769230769;0.423076923076923
Control.SRR15539829;52;45;0.403846153846154;31;21;0.0961538461538461;0.403846153846154
Control.SRR15539829;48;45;0.5;24;24;0;0.5
Control.SRR15539829;42;45;0.595238095238095;17;25;0.0952380952380952;0.404761904761905
Control.SRR15539829;44;45;0.545454545454545;20;24;0.0454545454545454;0.454545454545455
Control.SRR15539829;48;45;0.5625;21;27;0.0625;0.4375
Control.SRR15539829;52;45;0.576923076923077;22;30;0.0769230769230769;0.423076923076923
Control.SRR15539829;42;45;0.5;21;21;0;0.5
Control.SRR15539829;44;45;0.409090909090909;26;18;0.0909090909090909;0.409090909090909
Control.SRR15539829;50;45;0.52;24;26;0.02;0.48
Control.SRR15539829;44;45;0.522727272727273;21;23;0.0227272727272727;0.477272727272727
Control.SRR15539829;49;45;0.510204081632653;24;25;0.0102040816326531;0.489795918367347
Control.SRR15539829;43;45;0.488372093023256;22;21;0.0116279069767442;0.488372093023256
Control.SRR15539829;44;45;0.568181818181818;19;25;0.0681818181818182;0.431818181818182
Control.SRR15539829;43;45;0.395348837209302;26;17;0.104651162790698;0.395348837209302
Control.SRR15539829;41;45;0.414634146341463;24;17;0.0853658536585366;0.414634146341463
Control.SRR15539829;42;45;0.452380952380952;23;19;0.0476190476190476;0.452380952380952
Control.SRR15539829;41;45;0.682926829268293;13;28;0.182926829268293;0.317073170731707
Control.SRR15539829;47;45;0.659574468085106;16;31;0.159574468085106;0.340425531914894
Control.SRR15539829;47;45;0.404255319148936;28;19;0.0957446808510639;0.404255319148936
Control.SRR15539829;51;45;0.490196078431373;26;25;0.00980392156862747;0.490196078431373
Control.SRR15539829;50;45;0.5;25;25;0;0.5
Control.SRR15539829;44;45;0.522727272727273;21;23;0.0227272727272727;0.477272727272727
Control.SRR15539829;44;45;0.454545454545455;24;20;0.0454545454545455;0.454545454545455
Control.SRR15539829;48;45;0.479166666666667;25;23;0.0208333333333333;0.479166666666667
Control.SRR15539829;48;45;0.541666666666667;22;26;0.0416666666666666;0.458333333333333
Control.SRR15539829;52;45;0.480769230769231;27;25;0.0192307692307692;0.480769230769231
Control.SRR15539829;52;45;0.442307692307692;29;23;0.0576923076923077;0.442307692307692
Control.SRR15539829;46;45;0.478260869565217;24;22;0.0217391304347826;0.478260869565217
Control.SRR15539829;44;45;0.5;22;22;0;0.5
Control.SRR15539829;46;45;0.5;23;23;0;0.5
Control.SRR15539829;50;45;0.5;25;25;0;0.5
Control.SRR15539829;45;45;0.488888888888889;23;22;0.0111111111111111;0.488888888888889
Control.SRR15539829;43;45;0.511627906976744;21;22;0.0116279069767442;0.488372093023256
Control.SRR15539829;49;45;0.489795918367347;25;24;0.0102040816326531;0.489795918367347
Control.SRR15539829;41;45;0.536585365853659;19;22;0.0365853658536586;0.463414634146341
Control.SRR15539829;40;45;0.55;18;22;0.05;0.45
Control.SRR15539829;40;45;0.425;23;17;0.075;0.425
Control.SRR15539829;47;45;0.48936170212766;24;23;0.0106382978723404;0.48936170212766
Control.SRR15539829;47;45;0.468085106382979;25;22;0.0319148936170213;0.468085106382979
Control.SRR15539829;45;45;0.577777777777778;19;26;0.0777777777777777;0.422222222222222
Control.SRR15539829;52;45;0.442307692307692;29;23;0.0576923076923077;0.442307692307692
Control.SRR15539829;51;45;0.470588235294118;27;24;0.0294117647058824;0.470588235294118
Control.SRR15539829;46;45;0.478260869565217;24;22;0.0217391304347826;0.478260869565217
Control.SRR15539829;48;45;0.395833333333333;29;19;0.104166666666667;0.395833333333333
Control.SRR15539829;44;45;0.613636363636364;17;27;0.113636363636364;0.386363636363636
Control.SRR15539829;45;45;0.622222222222222;17;28;0.122222222222222;0.377777777777778
Control.SRR15539829;45;45;0.444444444444444;25;20;0.0555555555555556;0.444444444444444
Control.SRR15539829;52;45;0.423076923076923;30;22;0.0769230769230769;0.423076923076923
Control.SRR15539829;48;45;0.5;24;24;0;0.5
Control.SRR15539829;49;45;0.653061224489796;17;32;0.153061224489796;0.346938775510204
Control.SRR15539829;45;45;0.577777777777778;19;26;0.0777777777777777;0.422222222222222
Control.SRR15539829;51;45;0.392156862745098;31;20;0.107843137254902;0.392156862745098
Control.SRR15539829;50;45;0.52;24;26;0.02;0.48
Control.SRR15539829;46;45;0.58695652173913;19;27;0.0869565217391305;0.41304347826087
Control.SRR15539829;49;45;0.653061224489796;17;32;0.153061224489796;0.346938775510204
Control.SRR15539829;46;45;0.565217391304348;20;26;0.0652173913043478;0.434782608695652
Control.SRR15539829;43;45;0.558139534883721;19;24;0.0581395348837209;0.441860465116279
Control.SRR15539829;49;45;0.428571428571429;28;21;0.0714285714285715;0.428571428571429
Control.SRR15539829;41;45;0.560975609756098;18;23;0.0609756097560976;0.439024390243902
Control.SRR15539829;45;45;0.488888888888889;23;22;0.0111111111111111;0.488888888888889
Control.SRR15539829;47;45;0.638297872340426;17;30;0.138297872340426;0.361702127659574
Control.SRR15539829;41;45;0.48780487804878;21;20;0.0121951219512195;0.48780487804878
Control.SRR15539829;40;45;0.625;15;25;0.125;0.375
Control.SRR15539829;51;45;0.509803921568627;25;26;0.00980392156862742;0.490196078431373
Control.SRR15539829;40;45;0.375;25;15;0.125;0.375
Control.SRR15539829;45;45;0.488888888888889;23;22;0.0111111111111111;0.488888888888889
Control.SRR15539829;45;45;0.444444444444444;25;20;0.0555555555555556;0.444444444444444
Control.SRR15539829;46;45;0.282608695652174;33;13;0.217391304347826;0.282608695652174
Control.SRR15539829;48;45;0.541666666666667;22;26;0.0416666666666666;0.458333333333333
Control.SRR15539829;49;45;0.510204081632653;24;25;0.0102040816326531;0.489795918367347
Control.SRR15539829;46;45;0.434782608695652;26;20;0.0652173913043478;0.434782608695652
Control.SRR15539829;52;45;0.346153846153846;34;18;0.153846153846154;0.346153846153846
Control.SRR15539829;49;45;0.510204081632653;24;25;0.0102040816326531;0.489795918367347
Control.SRR15539829;48;45;0.5;24;24;0;0.5
Control.SRR15539829;45;45;0.311111111111111;31;14;0.188888888888889;0.311111111111111
Control.SRR15539829;52;45;0.596153846153846;21;31;0.0961538461538461;0.403846153846154
Control.SRR15539829;44;45;0.545454545454545;20;24;0.0454545454545454;0.454545454545455
Control.SRR15539829;51;45;0.647058823529412;18;33;0.147058823529412;0.352941176470588
Control.SRR15539829;43;45;0.604651162790698;17;26;0.104651162790698;0.395348837209302
Control.SRR15539829;47;45;0.51063829787234;23;24;0.0106382978723404;0.48936170212766
Control.SRR15539829;42;45;0.523809523809524;20;22;0.0238095238095238;0.476190476190476
Control.SRR15539829;44;45;0.431818181818182;25;19;0.0681818181818182;0.431818181818182
Control.SRR15539829;43;45;0.465116279069767;23;20;0.0348837209302326;0.465116279069767
Control.SRR15539829;44;45;0.522727272727273;21;23;0.0227272727272727;0.477272727272727
Control.SRR15539829;47;45;0.319148936170213;32;15;0.180851063829787;0.319148936170213
Control.SRR15539829;47;45;0.553191489361702;21;26;0.0531914893617021;0.446808510638298
Control.SRR15539829;48;45;0.416666666666667;28;20;0.0833333333333333;0.416666666666667
Control.SRR15539829;43;45;0.534883720930233;20;23;0.0348837209302325;0.465116279069767
Control.SRR15539829;40;45;0.625;15;25;0.125;0.375
Control.SRR15539829;49;45;0.591836734693878;20;29;0.0918367346938775;0.408163265306122
Control.SRR15539829;42;45;0.428571428571429;24;18;0.0714285714285715;0.428571428571429
Control.SRR15539829;50;45;0.46;27;23;0.04;0.46
Control.SRR15539829;52;45;0.596153846153846;21;31;0.0961538461538461;0.403846153846154
Control.SRR15539829;41;45;0.439024390243902;23;18;0.0609756097560976;0.439024390243902
Control.SRR15539829;48;45;0.5;24;24;0;0.5
Control.SRR15539829;42;45;0.428571428571429;24;18;0.0714285714285715;0.428571428571429
Control.SRR15539829;42;45;0.380952380952381;26;16;0.119047619047619;0.380952380952381
Control.SRR15539829;43;45;0.511627906976744;21;22;0.0116279069767442;0.488372093023256
Control.SRR15539829;45;45;0.488888888888889;23;22;0.0111111111111111;0.488888888888889
Control.SRR15539829;41;45;0.51219512195122;20;21;0.0121951219512195;0.48780487804878
Control.SRR15539829;40;45;0.4;24;16;0.1;0.4
Control.SRR15539829;40;45;0.625;15;25;0.125;0.375
Control.SRR15539829;42;45;0.428571428571429;24;18;0.0714285714285715;0.428571428571429
Control.SRR15539829;42;45;0.357142857142857;27;15;0.142857142857143;0.357142857142857
Control.SRR15539829;47;45;0.48936170212766;24;23;0.0106382978723404;0.48936170212766
Control.SRR15539829;45;45;0.4;27;18;0.1;0.4
Control.SRR15539829;40;45;0.425;23;17;0.075;0.425
Control.SRR15539829;46;45;0.391304347826087;28;18;0.108695652173913;0.391304347826087
Control.SRR15539829;47;45;0.51063829787234;23;24;0.0106382978723404;0.48936170212766
Control.SRR15539829;41;45;0.48780487804878;21;20;0.0121951219512195;0.48780487804878
Control.SRR15539829;51;45;0.549019607843137;23;28;0.0490196078431373;0.450980392156863
Control.SRR15539829;50;45;0.54;23;27;0.04;0.46
Control.SRR15539829;51;45;0.568627450980392;22;29;0.0686274509803921;0.431372549019608
Control.SRR15539829;49;45;0.489795918367347;25;24;0.0102040816326531;0.489795918367347
Control.SRR15539829;52;45;0.557692307692308;23;29;0.0576923076923077;0.442307692307692
Control.SRR15539829;51;45;0.549019607843137;23;28;0.0490196078431373;0.450980392156863
Control.SRR15539829;46;45;0.434782608695652;26;20;0.0652173913043478;0.434782608695652
Control.SRR15539829;40;45;0.575;17;23;0.075;0.425
Control.SRR15539829;42;45;0.523809523809524;20;22;0.0238095238095238;0.476190476190476
Control.SRR15539829;44;45;0.409090909090909;26;18;0.0909090909090909;0.409090909090909
Control.SRR15539829;44;45;0.431818181818182;25;19;0.0681818181818182;0.431818181818182
Control.SRR15539829;42;45;0.571428571428571;18;24;0.0714285714285714;0.428571428571429
Control.SRR15539829;43;45;0.534883720930233;20;23;0.0348837209302325;0.465116279069767
Control.SRR15539829;50;45;0.48;26;24;0.02;0.48
Control.SRR15539829;42;45;0.5;21;21;0;0.5
Control.SRR15539829;47;45;0.425531914893617;27;20;0.074468085106383;0.425531914893617
Control.SRR15539829;50;45;0.46;27;23;0.04;0.46
Control.SRR15539829;40;45;0.525;19;21;0.025;0.475
Control.SRR15539829;51;45;0.588235294117647;21;30;0.0882352941176471;0.411764705882353
Control.SRR15539829;43;45;0.604651162790698;17;26;0.104651162790698;0.395348837209302
Control.SRR15539829;44;45;0.5;22;22;0;0.5
Control.SRR15539829;41;45;0.585365853658537;17;24;0.0853658536585366;0.414634146341463
Control.SRR15539829;45;45;0.644444444444444;16;29;0.144444444444444;0.355555555555556
Control.SRR15539829;48;45;0.458333333333333;26;22;0.0416666666666667;0.458333333333333
Control.SRR15539829;42;45;0.595238095238095;17;25;0.0952380952380952;0.404761904761905
Control.SRR15539829;43;45;0.395348837209302;26;17;0.104651162790698;0.395348837209302
Control.SRR15539829;47;45;0.51063829787234;23;24;0.0106382978723404;0.48936170212766
Control.SRR15539829;50;45;0.54;23;27;0.04;0.46
Control.SRR15539829;41;45;0.609756097560976;16;25;0.109756097560976;0.390243902439024
Control.SRR15539829;49;45;0.530612244897959;23;26;0.0306122448979592;0.469387755102041
Control.SRR15539829;44;45;0.431818181818182;25;19;0.0681818181818182;0.431818181818182
Control.SRR15539829;46;45;0.391304347826087;28;18;0.108695652173913;0.391304347826087
Control.SRR15539829;45;45;0.444444444444444;25;20;0.0555555555555556;0.444444444444444
Control.SRR15539829;50;45;0.48;26;24;0.02;0.48
Control.SRR15539829;49;45;0.653061224489796;17;32;0.153061224489796;0.346938775510204
Control.SRR15539829;50;45;0.42;29;21;0.08;0.42
Control.SRR15539829;43;45;0.511627906976744;21;22;0.0116279069767442;0.488372093023256
Control.SRR15539829;47;45;0.595744680851064;19;28;0.0957446808510638;0.404255319148936
Control.SRR15539829;52;45;0.384615384615385;32;20;0.115384615384615;0.384615384615385
Control.SRR15539829;50;45;0.44;28;22;0.06;0.44
Control.SRR15539829;52;45;0.384615384615385;32;20;0.115384615384615;0.384615384615385
Control.SRR15539829;49;45;0.428571428571429;28;21;0.0714285714285715;0.428571428571429
Control.SRR15539829;50;45;0.48;26;24;0.02;0.48
Control.SRR15539829;51;45;0.509803921568627;25;26;0.00980392156862742;0.490196078431373
Control.SRR15539829;52;45;0.5;26;26;0;0.5
Control.SRR15539829;41;45;0.51219512195122;20;21;0.0121951219512195;0.48780487804878
Control.SRR15539829;46;45;0.434782608695652;26;20;0.0652173913043478;0.434782608695652
Control.SRR15539829;43;45;0.511627906976744;21;22;0.0116279069767442;0.488372093023256
Control.SRR15539829;50;45;0.5;25;25;0;0.5
Control.SRR15539829;49;45;0.448979591836735;27;22;0.0510204081632653;0.448979591836735
Control.SRR15539829;47;45;0.425531914893617;27;20;0.074468085106383;0.425531914893617
Control.SRR15539829;51;45;0.372549019607843;32;19;0.127450980392157;0.372549019607843
Control.SRR15539829;42;45;0.547619047619048;19;23;0.0476190476190477;0.452380952380952
Control.SRR15539829;48;45;0.541666666666667;22;26;0.0416666666666666;0.458333333333333
Control.SRR15539829;47;45;0.531914893617021;22;25;0.0319148936170213;0.468085106382979
Control.SRR15539829;44;45;0.545454545454545;20;24;0.0454545454545454;0.454545454545455
Control.SRR15539829;44;45;0.477272727272727;23;21;0.0227272727272727;0.477272727272727
Control.SRR15539829;50;45;0.44;28;22;0.06;0.44
Control.SRR15539829;48;45;0.479166666666667;25;23;0.0208333333333333;0.479166666666667
Control.SRR15539829;46;45;0.5;23;23;0;0.5
Control.SRR15539829;49;45;0.510204081632653;24;25;0.0102040816326531;0.489795918367347
Control.SRR15539829;49;45;0.510204081632653;24;25;0.0102040816326531;0.489795918367347
Control.SRR15539829;46;45;0.478260869565217;24;22;0.0217391304347826;0.478260869565217
Control.SRR15539829;48;45;0.604166666666667;19;29;0.104166666666667;0.395833333333333
Control.SRR15539829;47;45;0.617021276595745;18;29;0.117021276595745;0.382978723404255
Control.SRR15539829;48;45;0.479166666666667;25;23;0.0208333333333333;0.479166666666667
Control.SRR15539829;43;45;0.534883720930233;20;23;0.0348837209302325;0.465116279069767
Control.SRR15539829;46;45;0.652173913043478;16;30;0.152173913043478;0.347826086956522
Control.SRR15539829;42;45;0.476190476190476;22;20;0.0238095238095238;0.476190476190476
Control.SRR15539829;42;45;0.595238095238095;17;25;0.0952380952380952;0.404761904761905
Control.SRR15539829;50;45;0.42;29;21;0.08;0.42
Control.SRR15539829;47;45;0.48936170212766;24;23;0.0106382978723404;0.48936170212766
Control.SRR15539829;46;45;0.58695652173913;19;27;0.0869565217391305;0.41304347826087
Control.SRR15539829;43;45;0.581395348837209;18;25;0.0813953488372093;0.418604651162791
Control.SRR15539829;50;45;0.5;25;25;0;0.5
Control.SRR15539829;50;45;0.52;24;26;0.02;0.48
Control.SRR15539829;43;45;0.372093023255814;27;16;0.127906976744186;0.372093023255814
Control.SRR15539829;48;45;0.520833333333333;23;25;0.0208333333333334;0.479166666666667
Control.SRR15539829;40;45;0.425;23;17;0.075;0.425
Control.SRR15539829;48;45;0.4375;27;21;0.0625;0.4375
Control.SRR15539829;48;45;0.625;18;30;0.125;0.375
Control.SRR15539829;43;45;0.604651162790698;17;26;0.104651162790698;0.395348837209302
Control.SRR15539829;47;45;0.48936170212766;24;23;0.0106382978723404;0.48936170212766
Control.SRR15539829;50;45;0.46;27;23;0.04;0.46
Control.SRR15539829;45;45;0.422222222222222;26;19;0.0777777777777778;0.422222222222222
Control.SRR15539829;47;45;0.425531914893617;27;20;0.074468085106383;0.425531914893617
Control.SRR15539829;50;45;0.52;24;26;0.02;0.48
Control.SRR15539829;44;45;0.545454545454545;20;24;0.0454545454545454;0.454545454545455
Control.SRR15539829;46;45;0.41304347826087;27;19;0.0869565217391304;0.41304347826087
Control.SRR15539829;51;45;0.529411764705882;24;27;0.0294117647058824;0.470588235294118
Control.SRR15539829;46;45;0.521739130434783;22;24;0.0217391304347826;0.478260869565217
Control.SRR15539829;42;45;0.452380952380952;23;19;0.0476190476190476;0.452380952380952
Control.SRR15539829;45;45;0.555555555555556;20;25;0.0555555555555556;0.444444444444444
Control.SRR15539829;43;45;0.581395348837209;18;25;0.0813953488372093;0.418604651162791
Control.SRR15539829;52;45;0.596153846153846;21;31;0.0961538461538461;0.403846153846154
Control.SRR15539829;51;45;0.588235294117647;21;30;0.0882352941176471;0.411764705882353
Control.SRR15539829;42;45;0.380952380952381;26;16;0.119047619047619;0.380952380952381
Control.SRR15539829;44;45;0.613636363636364;17;27;0.113636363636364;0.386363636363636
Control.SRR15539829;47;45;0.595744680851064;19;28;0.0957446808510638;0.404255319148936
Control.SRR15539829;50;45;0.56;22;28;0.0600000000000001;0.44
Control.SRR15539829;50;45;0.6;20;30;0.1;0.4
Control.SRR15539829;45;45;0.577777777777778;19;26;0.0777777777777777;0.422222222222222
Control.SRR15539829;50;45;0.5;25;25;0;0.5
Control.SRR15539829;40;45;0.45;22;18;0.05;0.45
Control.SRR15539829;44;45;0.477272727272727;23;21;0.0227272727272727;0.477272727272727
Control.SRR15539829;46;45;0.5;23;23;0;0.5
Control.SRR15539829;46;45;0.391304347826087;28;18;0.108695652173913;0.391304347826087
Control.SRR15539829;52;45;0.480769230769231;27;25;0.0192307692307692;0.480769230769231
Control.SRR15539829;44;45;0.431818181818182;25;19;0.0681818181818182;0.431818181818182
Control.SRR15539829;42;45;0.595238095238095;17;25;0.0952380952380952;0.404761904761905
Control.SRR15539829;41;45;0.463414634146341;22;19;0.0365853658536585;0.463414634146341
Control.SRR15539829;45;45;0.4;27;18;0.1;0.4
Control.SRR15539829;47;45;0.425531914893617;27;20;0.074468085106383;0.425531914893617
Control.SRR15539829;48;45;0.479166666666667;25;23;0.0208333333333333;0.479166666666667
Control.SRR15539829;51;45;0.450980392156863;28;23;0.0490196078431372;0.450980392156863
Control.SRR15539829;46;45;0.521739130434783;22;24;0.0217391304347826;0.478260869565217
Control.SRR15539829;49;45;0.408163265306122;29;20;0.0918367346938775;0.408163265306122
Control.SRR15539829;46;45;0.478260869565217;24;22;0.0217391304347826;0.478260869565217
Control.SRR15539829;47;45;0.51063829787234;23;24;0.0106382978723404;0.48936170212766
Control.SRR15539829;51;45;0.490196078431373;26;25;0.00980392156862747;0.490196078431373
Control.SRR15539829;45;45;0.533333333333333;21;24;0.0333333333333333;0.466666666666667
Control.SRR15539829;47;45;0.382978723404255;29;18;0.117021276595745;0.382978723404255
Control.SRR15539829;49;45;0.489795918367347;25;24;0.0102040816326531;0.489795918367347
Control.SRR15539829;48;45;0.5;24;24;0;0.5
Control.SRR15539829;45;45;0.311111111111111;31;14;0.188888888888889;0.311111111111111
Control.SRR15539829;45;45;0.4;27;18;0.1;0.4
Control.SRR15539829;46;45;0.521739130434783;22;24;0.0217391304347826;0.478260869565217
Control.SRR15539829;46;45;0.521739130434783;22;24;0.0217391304347826;0.478260869565217
Control.SRR15539829;40;45;0.6;16;24;0.1;0.4
Control.SRR15539829;48;45;0.479166666666667;25;23;0.0208333333333333;0.479166666666667
Control.SRR15539829;40;45;0.575;17;23;0.075;0.425
Control.SRR15539829;51;45;0.549019607843137;23;28;0.0490196078431373;0.450980392156863
Control.SRR15539829;47;45;0.425531914893617;27;20;0.074468085106383;0.425531914893617
Control.SRR15539829;48;45;0.520833333333333;23;25;0.0208333333333334;0.479166666666667
Control.SRR15539829;49;45;0.551020408163265;22;27;0.0510204081632653;0.448979591836735
Control.SRR15539829;49;45;0.591836734693878;20;29;0.0918367346938775;0.408163265306122
Control.SRR15539829;42;45;0.5;21;21;0;0.5
Control.SRR15539829;42;45;0.619047619047619;16;26;0.119047619047619;0.380952380952381
Control.SRR15539829;40;45;0.425;23;17;0.075;0.425
Control.SRR15539829;48;45;0.541666666666667;22;26;0.0416666666666666;0.458333333333333
Control.SRR15539829;52;45;0.557692307692308;23;29;0.0576923076923077;0.442307692307692
Control.SRR15539829;50;45;0.34;33;17;0.16;0.34
Control.SRR15539829;51;45;0.568627450980392;22;29;0.0686274509803921;0.431372549019608
Control.SRR15539829;49;45;0.36734693877551;31;18;0.13265306122449;0.36734693877551
Control.SRR15539829;51;45;0.490196078431373;26;25;0.00980392156862747;0.490196078431373
Control.SRR15539829;51;45;0.607843137254902;20;31;0.107843137254902;0.392156862745098
Control.SRR15539829;46;45;0.5;23;23;0;0.5
Control.SRR15539829;52;45;0.480769230769231;27;25;0.0192307692307692;0.480769230769231
Control.SRR15539829;46;45;0.543478260869565;21;25;0.0434782608695652;0.456521739130435
Control.SRR15539829;50;45;0.52;24;26;0.02;0.48
Control.SRR15539829;44;45;0.386363636363636;27;17;0.113636363636364;0.386363636363636
Control.SRR15539829;48;45;0.583333333333333;20;28;0.0833333333333334;0.416666666666667
Control.SRR15539829;48;45;0.604166666666667;19;29;0.104166666666667;0.395833333333333
Control.SRR15539829;50;45;0.6;20;30;0.1;0.4
Control.SRR15539829;49;45;0.510204081632653;24;25;0.0102040816326531;0.489795918367347
Control.SRR15539829;45;45;0.577777777777778;19;26;0.0777777777777777;0.422222222222222
Control.SRR15539829;52;45;0.5;26;26;0;0.5
Control.SRR15539829;51;45;0.607843137254902;20;31;0.107843137254902;0.392156862745098
Control.SRR15539829;44;45;0.5;22;22;0;0.5
Control.SRR15539829;47;45;0.553191489361702;21;26;0.0531914893617021;0.446808510638298
Control.SRR15539829;45;45;0.422222222222222;26;19;0.0777777777777778;0.422222222222222
Control.SRR15539829;45;45;0.533333333333333;21;24;0.0333333333333333;0.466666666666667
Control.SRR15539829;48;45;0.604166666666667;19;29;0.104166666666667;0.395833333333333
Control.SRR15539829;48;45;0.4375;27;21;0.0625;0.4375
Control.SRR15539829;52;45;0.5;26;26;0;0.5
Control.SRR15539829;49;45;0.489795918367347;25;24;0.0102040816326531;0.489795918367347
Control.SRR15539829;51;45;0.509803921568627;25;26;0.00980392156862742;0.490196078431373
Control.SRR15539829;51;45;0.490196078431373;26;25;0.00980392156862747;0.490196078431373
Control.SRR15539829;40;45;0.625;15;25;0.125;0.375
Control.SRR15539829;50;45;0.52;24;26;0.02;0.48
Control.SRR15539829;44;45;0.545454545454545;20;24;0.0454545454545454;0.454545454545455
Control.SRR15539829;42;45;0.452380952380952;23;19;0.0476190476190476;0.452380952380952
Control.SRR15539829;47;45;0.446808510638298;26;21;0.0531914893617021;0.446808510638298
Control.SRR15539829;46;45;0.5;23;23;0;0.5
Control.SRR15539829;43;45;0.534883720930233;20;23;0.0348837209302325;0.465116279069767
Control.SRR15539829;44;45;0.5;22;22;0;0.5
Control.SRR15539829;51;45;0.607843137254902;20;31;0.107843137254902;0.392156862745098
Control.SRR15539829;46;45;0.41304347826087;27;19;0.0869565217391304;0.41304347826087
Control.SRR15539829;44;45;0.477272727272727;23;21;0.0227272727272727;0.477272727272727
Control.SRR15539829;43;45;0.720930232558139;12;31;0.220930232558139;0.27906976744186
Control.SRR15539829;43;45;0.488372093023256;22;21;0.0116279069767442;0.488372093023256
Control.SRR15539829;48;45;0.604166666666667;19;29;0.104166666666667;0.395833333333333
Control.SRR15539829;46;45;0.41304347826087;27;19;0.0869565217391304;0.41304347826087
Control.SRR15539829;47;45;0.531914893617021;22;25;0.0319148936170213;0.468085106382979
Control.SRR15539829;42;45;0.595238095238095;17;25;0.0952380952380952;0.404761904761905
Control.SRR15539829;51;45;0.450980392156863;28;23;0.0490196078431372;0.450980392156863
Control.SRR15539829;42;45;0.547619047619048;19;23;0.0476190476190477;0.452380952380952
Control.SRR15539829;40;45;0.55;18;22;0.05;0.45
Control.SRR15539829;40;45;0.525;19;21;0.025;0.475
Control.SRR15539829;43;45;0.534883720930233;20;23;0.0348837209302325;0.465116279069767
Control.SRR15539829;52;45;0.538461538461538;24;28;0.0384615384615384;0.461538461538462
Control.SRR15539829;47;45;0.468085106382979;25;22;0.0319148936170213;0.468085106382979
Control.SRR15539829;48;45;0.5;24;24;0;0.5
Control.SRR15539829;46;45;0.369565217391304;29;17;0.130434782608696;0.369565217391304
Control.SRR15539829;41;45;0.560975609756098;18;23;0.0609756097560976;0.439024390243902
Control.SRR15539829;41;45;0.439024390243902;23;18;0.0609756097560976;0.439024390243902
Control.SRR15539829;41;45;0.463414634146341;22;19;0.0365853658536585;0.463414634146341
Control.SRR15539829;49;45;0.346938775510204;32;17;0.153061224489796;0.346938775510204
Control.SRR15539829;46;45;0.41304347826087;27;19;0.0869565217391304;0.41304347826087
Control.SRR15539829;47;45;0.404255319148936;28;19;0.0957446808510639;0.404255319148936
Control.SRR15539829;51;45;0.411764705882353;30;21;0.0882352941176471;0.411764705882353
Control.SRR15539829;47;45;0.638297872340426;17;30;0.138297872340426;0.361702127659574
Control.SRR15539829;44;45;0.522727272727273;21;23;0.0227272727272727;0.477272727272727
Control.SRR15539829;42;45;0.547619047619048;19;23;0.0476190476190477;0.452380952380952
Control.SRR15539829;44;45;0.431818181818182;25;19;0.0681818181818182;0.431818181818182
Control.SRR15539829;40;45;0.575;17;23;0.075;0.425
Control.SRR15539829;45;45;0.422222222222222;26;19;0.0777777777777778;0.422222222222222
Control.SRR15539829;45;45;0.577777777777778;19;26;0.0777777777777777;0.422222222222222
Control.SRR15539829;46;45;0.478260869565217;24;22;0.0217391304347826;0.478260869565217
Control.SRR15539829;46;45;0.456521739130435;25;21;0.0434782608695652;0.456521739130435
Control.SRR15539829;44;45;0.5;22;22;0;0.5
Control.SRR15539829;50;45;0.38;31;19;0.12;0.38
Control.SRR15539829;49;45;0.469387755102041;26;23;0.0306122448979592;0.469387755102041
Control.SRR15539829;43;45;0.441860465116279;24;19;0.0581395348837209;0.441860465116279
Control.SRR15539829;48;45;0.520833333333333;23;25;0.0208333333333334;0.479166666666667
Control.SRR15539829;46;45;0.58695652173913;19;27;0.0869565217391305;0.41304347826087
Control.SRR15539829;40;45;0.55;18;22;0.05;0.45
Control.SRR15539829;43;45;0.418604651162791;25;18;0.0813953488372093;0.418604651162791
Control.SRR15539829;52;45;0.5;26;26;0;0.5
Control.SRR15539829;49;45;0.612244897959184;19;30;0.112244897959184;0.387755102040816
Control.SRR15539829;43;45;0.581395348837209;18;25;0.0813953488372093;0.418604651162791
Control.SRR15539829;41;45;0.585365853658537;17;24;0.0853658536585366;0.414634146341463
Control.SRR15539829;50;45;0.46;27;23;0.04;0.46
Control.SRR15539829;48;45;0.479166666666667;25;23;0.0208333333333333;0.479166666666667
Control.SRR15539829;48;45;0.5;24;24;0;0.5
Control.SRR15539829;41;45;0.48780487804878;21;20;0.0121951219512195;0.48780487804878
Control.SRR15539829;46;45;0.478260869565217;24;22;0.0217391304347826;0.478260869565217
Control.SRR15539829;43;45;0.488372093023256;22;21;0.0116279069767442;0.488372093023256
Control.SRR15539829;43;45;0.558139534883721;19;24;0.0581395348837209;0.441860465116279
Control.SRR15539829;45;45;0.555555555555556;20;25;0.0555555555555556;0.444444444444444
Control.SRR15539829;40;45;0.675;13;27;0.175;0.325
Control.SRR15539829;42;45;0.476190476190476;22;20;0.0238095238095238;0.476190476190476
Control.SRR15539829;45;45;0.533333333333333;21;24;0.0333333333333333;0.466666666666667
Control.SRR15539829;46;45;0.543478260869565;21;25;0.0434782608695652;0.456521739130435
Control.SRR15539829;46;45;0.5;23;23;0;0.5
Control.SRR15539829;44;45;0.477272727272727;23;21;0.0227272727272727;0.477272727272727
Control.SRR15539829;46;45;0.58695652173913;19;27;0.0869565217391305;0.41304347826087
Control.SRR15539829;46;45;0.521739130434783;22;24;0.0217391304347826;0.478260869565217
Control.SRR15539829;41;45;0.463414634146341;22;19;0.0365853658536585;0.463414634146341
Control.SRR15539829;50;45;0.52;24;26;0.02;0.48
Control.SRR15539829;40;45;0.3;28;12;0.2;0.3
Control.SRR15539829;47;45;0.468085106382979;25;22;0.0319148936170213;0.468085106382979
Control.SRR15539829;51;45;0.588235294117647;21;30;0.0882352941176471;0.411764705882353
Control.SRR15539829;40;45;0.45;22;18;0.05;0.45
Control.SRR15539829;44;45;0.522727272727273;21;23;0.0227272727272727;0.477272727272727
Control.SRR15539829;41;45;0.48780487804878;21;20;0.0121951219512195;0.48780487804878
Control.SRR15539829;51;45;0.490196078431373;26;25;0.00980392156862747;0.490196078431373
Control.SRR15539829;50;45;0.42;29;21;0.08;0.42
Control.SRR15539829;44;45;0.545454545454545;20;24;0.0454545454545454;0.454545454545455
Control.SRR15539829;47;45;0.446808510638298;26;21;0.0531914893617021;0.446808510638298
Control.SRR15539829;51;45;0.490196078431373;26;25;0.00980392156862747;0.490196078431373
Control.SRR15539829;42;45;0.476190476190476;22;20;0.0238095238095238;0.476190476190476
Control.SRR15539829;48;45;0.645833333333333;17;31;0.145833333333333;0.354166666666667
Control.SRR15539829;51;45;0.588235294117647;21;30;0.0882352941176471;0.411764705882353
Control.SRR15539829;49;45;0.428571428571429;28;21;0.0714285714285715;0.428571428571429
Control.SRR15539829;45;45;0.4;27;18;0.1;0.4
Control.SRR15539829;47;45;0.48936170212766;24;23;0.0106382978723404;0.48936170212766
Control.SRR15539829;44;45;0.545454545454545;20;24;0.0454545454545454;0.454545454545455
Control.SRR15539829;44;45;0.613636363636364;17;27;0.113636363636364;0.386363636363636
Control.SRR15539829;48;45;0.479166666666667;25;23;0.0208333333333333;0.479166666666667
Control.SRR15539829;49;45;0.571428571428571;21;28;0.0714285714285714;0.428571428571429
Control.SRR15539829;46;45;0.521739130434783;22;24;0.0217391304347826;0.478260869565217
Control.SRR15539829;48;45;0.5;24;24;0;0.5
Control.SRR15539829;48;45;0.5;24;24;0;0.5
Control.SRR15539829;41;45;0.51219512195122;20;21;0.0121951219512195;0.48780487804878
Control.SRR15539829;41;45;0.536585365853659;19;22;0.0365853658536586;0.463414634146341
Control.SRR15539829;51;45;0.529411764705882;24;27;0.0294117647058824;0.470588235294118
Control.SRR15539829;50;45;0.48;26;24;0.02;0.48
Control.SRR15539829;52;45;0.769230769230769;12;40;0.269230769230769;0.230769230769231
Control.SRR15539829;51;45;0.509803921568627;25;26;0.00980392156862742;0.490196078431373
Control.SRR15539829;43;45;0.418604651162791;25;18;0.0813953488372093;0.418604651162791
Control.SRR15539829;40;45;0.575;17;23;0.075;0.425
Control.SRR15539829;46;45;0.41304347826087;27;19;0.0869565217391304;0.41304347826087
Control.SRR15539829;52;45;0.519230769230769;25;27;0.0192307692307693;0.480769230769231
Control.SRR15539829;52;45;0.480769230769231;27;25;0.0192307692307692;0.480769230769231
Control.SRR15539829;51;45;0.431372549019608;29;22;0.0686274509803921;0.431372549019608
Control.SRR15539829;41;45;0.585365853658537;17;24;0.0853658536585366;0.414634146341463
Control.SRR15539829;45;45;0.6;18;27;0.1;0.4
Control.SRR15539829;49;45;0.489795918367347;25;24;0.0102040816326531;0.489795918367347
Control.SRR15539829;42;45;0.595238095238095;17;25;0.0952380952380952;0.404761904761905
Control.SRR15539829;40;45;0.525;19;21;0.025;0.475
Control.SRR15539829;48;45;0.520833333333333;23;25;0.0208333333333334;0.479166666666667
Control.SRR15539829;42;45;0.5;21;21;0;0.5
Control.SRR15539829;46;45;0.521739130434783;22;24;0.0217391304347826;0.478260869565217
Control.SRR15539829;45;45;0.511111111111111;22;23;0.0111111111111111;0.488888888888889
Control.SRR15539829;47;45;0.48936170212766;24;23;0.0106382978723404;0.48936170212766
Control.SRR15539829;44;45;0.5;22;22;0;0.5
Control.SRR15539829;42;45;0.404761904761905;25;17;0.0952380952380952;0.404761904761905
Control.SRR15539829;42;45;0.5;21;21;0;0.5
Control.SRR15539829;43;45;0.534883720930233;20;23;0.0348837209302325;0.465116279069767
Control.SRR15539829;48;45;0.583333333333333;20;28;0.0833333333333334;0.416666666666667
Control.SRR15539829;50;45;0.48;26;24;0.02;0.48
Control.SRR15539829;41;45;0.48780487804878;21;20;0.0121951219512195;0.48780487804878
Control.SRR15539829;46;45;0.41304347826087;27;19;0.0869565217391304;0.41304347826087
Control.SRR15539829;52;45;0.403846153846154;31;21;0.0961538461538461;0.403846153846154
Control.SRR15539829;47;45;0.468085106382979;25;22;0.0319148936170213;0.468085106382979
Control.SRR15539829;43;45;0.465116279069767;23;20;0.0348837209302326;0.465116279069767
Control.SRR15539829;49;45;0.408163265306122;29;20;0.0918367346938775;0.408163265306122
Control.SRR15539829;41;45;0.463414634146341;22;19;0.0365853658536585;0.463414634146341
Control.SRR15539829;47;45;0.531914893617021;22;25;0.0319148936170213;0.468085106382979
Control.SRR15539829;44;45;0.613636363636364;17;27;0.113636363636364;0.386363636363636
Control.SRR15539829;51;45;0.490196078431373;26;25;0.00980392156862747;0.490196078431373
Control.SRR15539829;46;45;0.608695652173913;18;28;0.108695652173913;0.391304347826087
Control.SRR15539829;40;45;0.425;23;17;0.075;0.425
Control.SRR15539829;40;45;0.5;20;20;0;0.5
Control.SRR15539829;46;45;0.565217391304348;20;26;0.0652173913043478;0.434782608695652
Control.SRR15539829;48;45;0.479166666666667;25;23;0.0208333333333333;0.479166666666667
Control.SRR15539829;42;45;0.428571428571429;24;18;0.0714285714285715;0.428571428571429
Control.SRR15539829;40;45;0.35;26;14;0.15;0.35
Control.SRR15539829;46;45;0.543478260869565;21;25;0.0434782608695652;0.456521739130435
Control.SRR15539829;52;45;0.480769230769231;27;25;0.0192307692307692;0.480769230769231
Control.SRR15539829;50;45;0.6;20;30;0.1;0.4
Control.SRR15539829;47;45;0.574468085106383;20;27;0.074468085106383;0.425531914893617
Control.SRR15539829;46;45;0.456521739130435;25;21;0.0434782608695652;0.456521739130435
Control.SRR15539829;50;45;0.4;30;20;0.1;0.4
Control.SRR15539829;47;45;0.531914893617021;22;25;0.0319148936170213;0.468085106382979
Control.SRR15539829;51;45;0.411764705882353;30;21;0.0882352941176471;0.411764705882353
Control.SRR15539829;46;45;0.565217391304348;20;26;0.0652173913043478;0.434782608695652
Control.SRR15539829;50;45;0.52;24;26;0.02;0.48
Control.SRR15539829;44;45;0.454545454545455;24;20;0.0454545454545455;0.454545454545455
Control.SRR15539829;49;45;0.408163265306122;29;20;0.0918367346938775;0.408163265306122
Control.SRR15539829;45;45;0.511111111111111;22;23;0.0111111111111111;0.488888888888889
Control.SRR15539829;49;45;0.408163265306122;29;20;0.0918367346938775;0.408163265306122
Control.SRR15539829;52;45;0.615384615384615;20;32;0.115384615384615;0.384615384615385
Control.SRR15539829;51;45;0.549019607843137;23;28;0.0490196078431373;0.450980392156863
Control.SRR15539829;44;45;0.590909090909091;18;26;0.0909090909090909;0.409090909090909
Control.SRR15539829;50;45;0.38;31;19;0.12;0.38
Control.SRR15539829;48;45;0.375;30;18;0.125;0.375
Control.SRR15539829;50;45;0.46;27;23;0.04;0.46
Control.SRR15539829;42;45;0.5;21;21;0;0.5
Control.SRR15539829;48;45;0.458333333333333;26;22;0.0416666666666667;0.458333333333333
Control.SRR15539829;52;45;0.557692307692308;23;29;0.0576923076923077;0.442307692307692
Control.SRR15539829;51;45;0.529411764705882;24;27;0.0294117647058824;0.470588235294118
Control.SRR15539829;48;45;0.458333333333333;26;22;0.0416666666666667;0.458333333333333
Control.SRR15539829;52;45;0.480769230769231;27;25;0.0192307692307692;0.480769230769231
Control.SRR15539829;52;45;0.384615384615385;32;20;0.115384615384615;0.384615384615385
Control.SRR15539829;47;45;0.553191489361702;21;26;0.0531914893617021;0.446808510638298
Control.SRR15539829;51;45;0.450980392156863;28;23;0.0490196078431372;0.450980392156863
Control.SRR15539829;44;45;0.409090909090909;26;18;0.0909090909090909;0.409090909090909
Control.SRR15539829;52;45;0.5;26;26;0;0.5
Control.SRR15539829;49;45;0.510204081632653;24;25;0.0102040816326531;0.489795918367347
Control.SRR15539829;48;45;0.520833333333333;23;25;0.0208333333333334;0.479166666666667
Control.SRR15539829;47;45;0.553191489361702;21;26;0.0531914893617021;0.446808510638298
Control.SRR15539829;49;45;0.510204081632653;24;25;0.0102040816326531;0.489795918367347
Control.SRR15539829;52;45;0.480769230769231;27;25;0.0192307692307692;0.480769230769231
Control.SRR15539829;50;45;0.44;28;22;0.06;0.44
Control.SRR15539829;40;45;0.475;21;19;0.025;0.475
Control.SRR15539829;45;45;0.444444444444444;25;20;0.0555555555555556;0.444444444444444
Control.SRR15539829;40;45;0.5;20;20;0;0.5
Control.SRR15539829;48;45;0.5;24;24;0;0.5
Control.SRR15539829;41;45;0.560975609756098;18;23;0.0609756097560976;0.439024390243902
Control.SRR15539829;49;45;0.551020408163265;22;27;0.0510204081632653;0.448979591836735
Control.SRR15539829;42;45;0.619047619047619;16;26;0.119047619047619;0.380952380952381
Control.SRR15539829;52;45;0.5;26;26;0;0.5
Control.SRR15539829;40;45;0.525;19;21;0.025;0.475
Control.SRR15539829;40;45;0.55;18;22;0.05;0.45
Control.SRR15539829;49;45;0.408163265306122;29;20;0.0918367346938775;0.408163265306122
Control.SRR15539829;47;45;0.446808510638298;26;21;0.0531914893617021;0.446808510638298
Control.SRR15539829;49;45;0.510204081632653;24;25;0.0102040816326531;0.489795918367347
Control.SRR15539829;42;45;0.523809523809524;20;22;0.0238095238095238;0.476190476190476
Control.SRR15539829;50;45;0.46;27;23;0.04;0.46
Control.SRR15539829;45;45;0.422222222222222;26;19;0.0777777777777778;0.422222222222222
Control.SRR15539829;45;45;0.355555555555556;29;16;0.144444444444444;0.355555555555556
Control.SRR15539829;49;45;0.510204081632653;24;25;0.0102040816326531;0.489795918367347
Control.SRR15539829;46;45;0.456521739130435;25;21;0.0434782608695652;0.456521739130435
Control.SRR15539829;44;45;0.522727272727273;21;23;0.0227272727272727;0.477272727272727
Control.SRR15539829;48;45;0.5625;21;27;0.0625;0.4375
Control.SRR15539829;43;45;0.395348837209302;26;17;0.104651162790698;0.395348837209302
Control.SRR15539829;51;45;0.392156862745098;31;20;0.107843137254902;0.392156862745098
Control.SRR15539829;45;45;0.444444444444444;25;20;0.0555555555555556;0.444444444444444
Control.SRR15539829;49;45;0.510204081632653;24;25;0.0102040816326531;0.489795918367347
Control.SRR15539829;43;45;0.534883720930233;20;23;0.0348837209302325;0.465116279069767
Control.SRR15539829;48;45;0.5;24;24;0;0.5
Control.SRR15539829;50;45;0.48;26;24;0.02;0.48
Control.SRR15539829;51;45;0.529411764705882;24;27;0.0294117647058824;0.470588235294118
Control.SRR15539829;48;45;0.479166666666667;25;23;0.0208333333333333;0.479166666666667
Control.SRR15539829;45;45;0.533333333333333;21;24;0.0333333333333333;0.466666666666667
Control.SRR15539829;46;45;0.608695652173913;18;28;0.108695652173913;0.391304347826087
Control.SRR15539829;46;45;0.456521739130435;25;21;0.0434782608695652;0.456521739130435
Control.SRR15539829;41;45;0.414634146341463;24;17;0.0853658536585366;0.414634146341463
Control.SRR15539829;49;45;0.530612244897959;23;26;0.0306122448979592;0.469387755102041
Control.SRR15539829;41;45;0.48780487804878;21;20;0.0121951219512195;0.48780487804878
Control.SRR15539829;49;45;0.428571428571429;28;21;0.0714285714285715;0.428571428571429
Control.SRR15539829;41;45;0.51219512195122;20;21;0.0121951219512195;0.48780487804878
Control.SRR15539829;45;45;0.444444444444444;25;20;0.0555555555555556;0.444444444444444
Control.SRR15539829;48;45;0.5;24;24;0;0.5
Control.SRR15539829;51;45;0.549019607843137;23;28;0.0490196078431373;0.450980392156863
Control.SRR15539829;47;45;0.446808510638298;26;21;0.0531914893617021;0.446808510638298
Control.SRR15539829;44;45;0.477272727272727;23;21;0.0227272727272727;0.477272727272727
Control.SRR15539829;45;45;0.533333333333333;21;24;0.0333333333333333;0.466666666666667
Control.SRR15539829;43;45;0.581395348837209;18;25;0.0813953488372093;0.418604651162791
Control.SRR15539829;42;45;0.404761904761905;25;17;0.0952380952380952;0.404761904761905
Control.SRR15539829;44;45;0.522727272727273;21;23;0.0227272727272727;0.477272727272727
Control.SRR15539829;42;45;0.547619047619048;19;23;0.0476190476190477;0.452380952380952
Control.SRR15539829;44;45;0.522727272727273;21;23;0.0227272727272727;0.477272727272727
Control.SRR15539829;46;45;0.456521739130435;25;21;0.0434782608695652;0.456521739130435
Control.SRR15539829;49;45;0.551020408163265;22;27;0.0510204081632653;0.448979591836735
Control.SRR15539829;46;45;0.434782608695652;26;20;0.0652173913043478;0.434782608695652
Control.SRR15539829;43;45;0.418604651162791;25;18;0.0813953488372093;0.418604651162791
Control.SRR15539829;45;45;0.533333333333333;21;24;0.0333333333333333;0.466666666666667
Control.SRR15539829;47;45;0.425531914893617;27;20;0.074468085106383;0.425531914893617
Control.SRR15539829;43;45;0.488372093023256;22;21;0.0116279069767442;0.488372093023256
Control.SRR15539829;41;45;0.585365853658537;17;24;0.0853658536585366;0.414634146341463
Control.SRR15539829;41;45;0.292682926829268;29;12;0.207317073170732;0.292682926829268
Control.SRR15539829;40;45;0.45;22;18;0.05;0.45
Control.SRR15539829;42;45;0.5;21;21;0;0.5
Control.SRR15539829;40;45;0.45;22;18;0.05;0.45
Control.SRR15539829;43;45;0.302325581395349;30;13;0.197674418604651;0.302325581395349
Control.SRR15539829;45;45;0.622222222222222;17;28;0.122222222222222;0.377777777777778
Control.SRR15539829;45;45;0.555555555555556;20;25;0.0555555555555556;0.444444444444444
Control.SRR15539829;47;45;0.617021276595745;18;29;0.117021276595745;0.382978723404255
Control.SRR15539829;44;45;0.454545454545455;24;20;0.0454545454545455;0.454545454545455
Control.SRR15539829;50;45;0.5;25;25;0;0.5
Control.SRR15539829;51;45;0.450980392156863;28;23;0.0490196078431372;0.450980392156863
Control.SRR15539829;40;45;0.55;18;22;0.05;0.45
Control.SRR15539829;52;45;0.423076923076923;30;22;0.0769230769230769;0.423076923076923
Control.SRR15539829;40;45;0.55;18;22;0.05;0.45
Control.SRR15539829;50;45;0.36;32;18;0.14;0.36
Control.SRR15539829;45;45;0.488888888888889;23;22;0.0111111111111111;0.488888888888889
Control.SRR15539829;44;45;0.568181818181818;19;25;0.0681818181818182;0.431818181818182
Control.SRR15539829;42;45;0.523809523809524;20;22;0.0238095238095238;0.476190476190476
Control.SRR15539829;40;45;0.525;19;21;0.025;0.475
Control.SRR15539829;41;45;0.634146341463415;15;26;0.134146341463415;0.365853658536585
Control.SRR15539829;44;45;0.454545454545455;24;20;0.0454545454545455;0.454545454545455
Control.SRR15539829;45;45;0.422222222222222;26;19;0.0777777777777778;0.422222222222222
Control.SRR15539829;44;45;0.522727272727273;21;23;0.0227272727272727;0.477272727272727
Control.SRR15539829;46;45;0.434782608695652;26;20;0.0652173913043478;0.434782608695652
Control.SRR15539829;48;45;0.5625;21;27;0.0625;0.4375
Control.SRR15539829;46;45;0.456521739130435;25;21;0.0434782608695652;0.456521739130435
Control.SRR15539829;51;45;0.549019607843137;23;28;0.0490196078431373;0.450980392156863
Control.SRR15539829;42;45;0.380952380952381;26;16;0.119047619047619;0.380952380952381
Control.SRR15539829;52;45;0.480769230769231;27;25;0.0192307692307692;0.480769230769231
Control.SRR15539829;40;45;0.575;17;23;0.075;0.425
Control.SRR15539829;46;45;0.260869565217391;34;12;0.239130434782609;0.260869565217391
Control.SRR15539829;43;45;0.627906976744186;16;27;0.127906976744186;0.372093023255814
Control.SRR15539829;50;45;0.38;31;19;0.12;0.38
Control.SRR15539829;45;45;0.377777777777778;28;17;0.122222222222222;0.377777777777778
Control.SRR15539829;42;45;0.476190476190476;22;20;0.0238095238095238;0.476190476190476
Control.SRR15539829;45;45;0.488888888888889;23;22;0.0111111111111111;0.488888888888889
Control.SRR15539829;49;45;0.489795918367347;25;24;0.0102040816326531;0.489795918367347
Control.SRR15539829;43;45;0.511627906976744;21;22;0.0116279069767442;0.488372093023256
Control.SRR15539829;44;45;0.522727272727273;21;23;0.0227272727272727;0.477272727272727
Control.SRR15539829;40;45;0.6;16;24;0.1;0.4
Control.SRR15539829;40;45;0.475;21;19;0.025;0.475
Control.SRR15539829;48;45;0.625;18;30;0.125;0.375
Control.SRR15539829;52;45;0.596153846153846;21;31;0.0961538461538461;0.403846153846154
Control.SRR15539829;43;45;0.488372093023256;22;21;0.0116279069767442;0.488372093023256
Control.SRR15539829;46;45;0.521739130434783;22;24;0.0217391304347826;0.478260869565217
Control.SRR15539829;48;45;0.333333333333333;32;16;0.166666666666667;0.333333333333333
Control.SRR15539829;48;45;0.479166666666667;25;23;0.0208333333333333;0.479166666666667
Control.SRR15539829;50;45;0.4;30;20;0.1;0.4
Control.SRR15539829;45;45;0.422222222222222;26;19;0.0777777777777778;0.422222222222222
Control.SRR15539829;40;45;0.5;20;20;0;0.5
Control.SRR15539829;42;45;0.428571428571429;24;18;0.0714285714285715;0.428571428571429
Control.SRR15539829;45;45;0.466666666666667;24;21;0.0333333333333333;0.466666666666667
Control.SRR15539829;44;45;0.5;22;22;0;0.5
Control.SRR15539829;43;45;0.325581395348837;29;14;0.174418604651163;0.325581395348837
Control.SRR15539829;52;45;0.442307692307692;29;23;0.0576923076923077;0.442307692307692
Control.SRR15539829;52;45;0.576923076923077;22;30;0.0769230769230769;0.423076923076923
Control.SRR15539829;46;45;0.456521739130435;25;21;0.0434782608695652;0.456521739130435
Control.SRR15539829;47;45;0.340425531914894;31;16;0.159574468085106;0.340425531914894
Control.SRR15539829;42;45;0.5;21;21;0;0.5
Control.SRR15539829;50;45;0.44;28;22;0.06;0.44
Control.SRR15539829;52;45;0.384615384615385;32;20;0.115384615384615;0.384615384615385
Control.SRR15539829;50;45;0.5;25;25;0;0.5
Control.SRR15539829;40;45;0.5;20;20;0;0.5
Control.SRR15539829;41;45;0.463414634146341;22;19;0.0365853658536585;0.463414634146341
Control.SRR15539829;46;45;0.565217391304348;20;26;0.0652173913043478;0.434782608695652
Control.SRR15539829;48;45;0.479166666666667;25;23;0.0208333333333333;0.479166666666667
Control.SRR15539829;42;45;0.571428571428571;18;24;0.0714285714285714;0.428571428571429
Control.SRR15539829;42;45;0.571428571428571;18;24;0.0714285714285714;0.428571428571429
Control.SRR15539829;49;45;0.551020408163265;22;27;0.0510204081632653;0.448979591836735
Control.SRR15539829;43;45;0.511627906976744;21;22;0.0116279069767442;0.488372093023256
Control.SRR15539829;50;45;0.48;26;24;0.02;0.48
Control.SRR15539829;45;45;0.533333333333333;21;24;0.0333333333333333;0.466666666666667
Control.SRR15539829;45;45;0.533333333333333;21;24;0.0333333333333333;0.466666666666667
Control.SRR15539829;44;45;0.477272727272727;23;21;0.0227272727272727;0.477272727272727
Control.SRR15539829;44;45;0.477272727272727;23;21;0.0227272727272727;0.477272727272727
Control.SRR15539829;47;45;0.404255319148936;28;19;0.0957446808510639;0.404255319148936
Control.SRR15539829;42;45;0.476190476190476;22;20;0.0238095238095238;0.476190476190476
Control.SRR15539829;48;45;0.645833333333333;17;31;0.145833333333333;0.354166666666667
Control.SRR15539829;50;45;0.54;23;27;0.04;0.46
Control.SRR15539829;42;45;0.5;21;21;0;0.5
Control.SRR15539829;44;45;0.454545454545455;24;20;0.0454545454545455;0.454545454545455
Control.SRR15539829;43;45;0.534883720930233;20;23;0.0348837209302325;0.465116279069767
Control.SRR15539829;52;45;0.480769230769231;27;25;0.0192307692307692;0.480769230769231
Control.SRR15539829;43;45;0.418604651162791;25;18;0.0813953488372093;0.418604651162791
Control.SRR15539829;43;45;0.465116279069767;23;20;0.0348837209302326;0.465116279069767
Control.SRR15539829;41;45;0.48780487804878;21;20;0.0121951219512195;0.48780487804878
Control.SRR15539829;45;45;0.488888888888889;23;22;0.0111111111111111;0.488888888888889
Control.SRR15539829;41;45;0.585365853658537;17;24;0.0853658536585366;0.414634146341463
Control.SRR15539829;40;45;0.45;22;18;0.05;0.45
Control.SRR15539829;42;45;0.547619047619048;19;23;0.0476190476190477;0.452380952380952
Control.SRR15539829;49;45;0.469387755102041;26;23;0.0306122448979592;0.469387755102041
Control.SRR15539829;51;45;0.470588235294118;27;24;0.0294117647058824;0.470588235294118
Control.SRR15539829;49;45;0.551020408163265;22;27;0.0510204081632653;0.448979591836735
Control.SRR15539829;42;45;0.404761904761905;25;17;0.0952380952380952;0.404761904761905
Control.SRR15539829;42;45;0.666666666666667;14;28;0.166666666666667;0.333333333333333
Control.SRR15539829;41;45;0.609756097560976;16;25;0.109756097560976;0.390243902439024
Control.SRR15539829;45;45;0.444444444444444;25;20;0.0555555555555556;0.444444444444444
Control.SRR15539829;44;45;0.477272727272727;23;21;0.0227272727272727;0.477272727272727
Control.SRR15539829;47;45;0.574468085106383;20;27;0.074468085106383;0.425531914893617
Control.SRR15539829;44;45;0.545454545454545;20;24;0.0454545454545454;0.454545454545455
Control.SRR15539829;47;45;0.425531914893617;27;20;0.074468085106383;0.425531914893617
Control.SRR15539829;43;45;0.488372093023256;22;21;0.0116279069767442;0.488372093023256
Control.SRR15539829;46;45;0.543478260869565;21;25;0.0434782608695652;0.456521739130435
Control.SRR15539829;49;45;0.469387755102041;26;23;0.0306122448979592;0.469387755102041
Control.SRR15539829;49;45;0.551020408163265;22;27;0.0510204081632653;0.448979591836735
Control.SRR15539829;52;45;0.5;26;26;0;0.5
Control.SRR15539829;40;45;0.625;15;25;0.125;0.375
Control.SRR15539829;48;45;0.541666666666667;22;26;0.0416666666666666;0.458333333333333
Control.SRR15539829;48;45;0.520833333333333;23;25;0.0208333333333334;0.479166666666667
Control.SRR15539829;50;45;0.52;24;26;0.02;0.48
Control.SRR15539829;50;45;0.56;22;28;0.0600000000000001;0.44
Control.SRR15539829;42;45;0.452380952380952;23;19;0.0476190476190476;0.452380952380952
Control.SRR15539829;46;45;0.608695652173913;18;28;0.108695652173913;0.391304347826087
Control.SRR15539829;46;45;0.456521739130435;25;21;0.0434782608695652;0.456521739130435
Control.SRR15539829;42;45;0.452380952380952;23;19;0.0476190476190476;0.452380952380952
Control.SRR15539829;40;45;0.375;25;15;0.125;0.375
Control.SRR15539829;52;45;0.384615384615385;32;20;0.115384615384615;0.384615384615385
Control.SRR15539829;47;45;0.382978723404255;29;18;0.117021276595745;0.382978723404255
Control.SRR15539829;45;45;0.444444444444444;25;20;0.0555555555555556;0.444444444444444
Control.SRR15539829;43;45;0.441860465116279;24;19;0.0581395348837209;0.441860465116279
Control.SRR15539829;43;45;0.534883720930233;20;23;0.0348837209302325;0.465116279069767
Control.SRR15539829;41;45;0.536585365853659;19;22;0.0365853658536586;0.463414634146341
Control.SRR15539829;40;45;0.5;20;20;0;0.5
Control.SRR15539829;42;45;0.547619047619048;19;23;0.0476190476190477;0.452380952380952
Control.SRR15539829;49;45;0.448979591836735;27;22;0.0510204081632653;0.448979591836735
Control.SRR15539829;47;45;0.531914893617021;22;25;0.0319148936170213;0.468085106382979
Control.SRR15539829;46;45;0.478260869565217;24;22;0.0217391304347826;0.478260869565217
Control.SRR15539829;48;45;0.375;30;18;0.125;0.375
Control.SRR15539829;48;45;0.520833333333333;23;25;0.0208333333333334;0.479166666666667
Control.SRR15539829;41;45;0.585365853658537;17;24;0.0853658536585366;0.414634146341463
Control.SRR15539829;45;45;0.555555555555556;20;25;0.0555555555555556;0.444444444444444
Control.SRR15539829;45;45;0.4;27;18;0.1;0.4
Control.SRR15539829;52;45;0.519230769230769;25;27;0.0192307692307693;0.480769230769231
Control.SRR15539829;43;45;0.465116279069767;23;20;0.0348837209302326;0.465116279069767
Control.SRR15539829;45;45;0.444444444444444;25;20;0.0555555555555556;0.444444444444444
Control.SRR15539829;47;45;0.51063829787234;23;24;0.0106382978723404;0.48936170212766
Control.SRR15539829;51;45;0.450980392156863;28;23;0.0490196078431372;0.450980392156863
Control.SRR15539829;41;45;0.463414634146341;22;19;0.0365853658536585;0.463414634146341
Control.SRR15539829;48;45;0.479166666666667;25;23;0.0208333333333333;0.479166666666667
Control.SRR15539829;47;45;0.553191489361702;21;26;0.0531914893617021;0.446808510638298
Control.SRR15539829;42;45;0.523809523809524;20;22;0.0238095238095238;0.476190476190476
Control.SRR15539829;46;45;0.543478260869565;21;25;0.0434782608695652;0.456521739130435
Control.SRR15539829;40;45;0.45;22;18;0.05;0.45
Control.SRR15539829;49;45;0.591836734693878;20;29;0.0918367346938775;0.408163265306122
Control.SRR15539829;49;45;0.408163265306122;29;20;0.0918367346938775;0.408163265306122
Control.SRR15539829;49;45;0.530612244897959;23;26;0.0306122448979592;0.469387755102041
Control.SRR15539829;44;45;0.363636363636364;28;16;0.136363636363636;0.363636363636364
Control.SRR15539829;42;45;0.476190476190476;22;20;0.0238095238095238;0.476190476190476
Control.SRR15539829;44;45;0.522727272727273;21;23;0.0227272727272727;0.477272727272727
Control.SRR15539829;46;45;0.5;23;23;0;0.5
Control.SRR15539829;49;45;0.469387755102041;26;23;0.0306122448979592;0.469387755102041
Control.SRR15539829;40;45;0.575;17;23;0.075;0.425
Control.SRR15539829;43;45;0.558139534883721;19;24;0.0581395348837209;0.441860465116279
Control.SRR15539829;47;45;0.468085106382979;25;22;0.0319148936170213;0.468085106382979
Control.SRR15539829;39;45;0.41025641025641;23;16;0.0897435897435898;0.41025641025641
Control.SRR15539829;40;45;0.4;24;16;0.1;0.4
Control.SRR15539829;48;45;0.645833333333333;17;31;0.145833333333333;0.354166666666667
Control.SRR15539829;51;45;0.490196078431373;26;25;0.00980392156862747;0.490196078431373
Control.SRR15539829;39;45;0.564102564102564;17;22;0.0641025641025641;0.435897435897436
Control.SRR15539829;42;45;0.5;21;21;0;0.5
Control.SRR15539829;49;45;0.326530612244898;33;16;0.173469387755102;0.326530612244898
Control.SRR15539829;43;45;0.581395348837209;18;25;0.0813953488372093;0.418604651162791
Control.SRR15539829;45;45;0.422222222222222;26;19;0.0777777777777778;0.422222222222222
Control.SRR15539829;48;45;0.479166666666667;25;23;0.0208333333333333;0.479166666666667
Control.SRR15539829;41;45;0.414634146341463;24;17;0.0853658536585366;0.414634146341463
Control.SRR15539829;39;45;0.461538461538462;21;18;0.0384615384615384;0.461538461538462
Control.SRR15539829;42;45;0.452380952380952;23;19;0.0476190476190476;0.452380952380952
Control.SRR15539829;42;45;0.476190476190476;22;20;0.0238095238095238;0.476190476190476
Control.SRR15539829;41;45;0.48780487804878;21;20;0.0121951219512195;0.48780487804878
Control.SRR15539829;44;45;0.590909090909091;18;26;0.0909090909090909;0.409090909090909
Control.SRR15539829;40;45;0.475;21;19;0.025;0.475
Control.SRR15539829;42;45;0.571428571428571;18;24;0.0714285714285714;0.428571428571429
Control.SRR15539829;44;45;0.568181818181818;19;25;0.0681818181818182;0.431818181818182
Control.SRR15539829;49;45;0.469387755102041;26;23;0.0306122448979592;0.469387755102041
Control.SRR15539829;42;45;0.476190476190476;22;20;0.0238095238095238;0.476190476190476
Control.SRR15539829;44;45;0.545454545454545;20;24;0.0454545454545454;0.454545454545455
Control.SRR15539829;40;45;0.5;20;20;0;0.5
Control.SRR15539829;47;45;0.531914893617021;22;25;0.0319148936170213;0.468085106382979
Control.SRR15539829;49;45;0.591836734693878;20;29;0.0918367346938775;0.408163265306122
Control.SRR15539829;42;45;0.5;21;21;0;0.5
Control.SRR15539829;40;45;0.475;21;19;0.025;0.475
Control.SRR15539829;49;45;0.530612244897959;23;26;0.0306122448979592;0.469387755102041
Control.SRR15539829;44;45;0.5;22;22;0;0.5
Control.SRR15539829;45;45;0.555555555555556;20;25;0.0555555555555556;0.444444444444444
Control.SRR15539829;41;45;0.585365853658537;17;24;0.0853658536585366;0.414634146341463
Control.SRR15539829;42;45;0.380952380952381;26;16;0.119047619047619;0.380952380952381
Control.SRR15539829;46;45;0.434782608695652;26;20;0.0652173913043478;0.434782608695652
Control.SRR15539829;47;45;0.553191489361702;21;26;0.0531914893617021;0.446808510638298
Control.SRR15539829;48;45;0.458333333333333;26;22;0.0416666666666667;0.458333333333333
Control.SRR15539829;46;45;0.5;23;23;0;0.5
Control.SRR15539829;42;45;0.619047619047619;16;26;0.119047619047619;0.380952380952381
Control.SRR15539829;41;45;0.365853658536585;26;15;0.134146341463415;0.365853658536585
Control.SRR15539829;40;45;0.375;25;15;0.125;0.375
Control.SRR15539829;50;45;0.46;27;23;0.04;0.46
Control.SRR15539829;47;45;0.468085106382979;25;22;0.0319148936170213;0.468085106382979
Control.SRR15539829;46;45;0.478260869565217;24;22;0.0217391304347826;0.478260869565217
Control.SRR15539829;44;45;0.409090909090909;26;18;0.0909090909090909;0.409090909090909
Control.SRR15539829;40;45;0.5;20;20;0;0.5
Control.SRR15539829;41;45;0.634146341463415;15;26;0.134146341463415;0.365853658536585
Control.SRR15539829;40;45;0.525;19;21;0.025;0.475
Control.SRR15539829;46;45;0.456521739130435;25;21;0.0434782608695652;0.456521739130435
Control.SRR15539829;44;45;0.477272727272727;23;21;0.0227272727272727;0.477272727272727
Control.SRR15539829;48;45;0.416666666666667;28;20;0.0833333333333333;0.416666666666667
Control.SRR15539829;45;45;0.688888888888889;14;31;0.188888888888889;0.311111111111111
Control.SRR15539829;39;45;0.487179487179487;20;19;0.0128205128205128;0.487179487179487
Control.SRR15539829;46;45;0.260869565217391;34;12;0.239130434782609;0.260869565217391
Control.SRR15539829;47;45;0.48936170212766;24;23;0.0106382978723404;0.48936170212766
Control.SRR15539829;50;45;0.46;27;23;0.04;0.46
Control.SRR15539829;42;45;0.380952380952381;26;16;0.119047619047619;0.380952380952381
Control.SRR15539829;40;45;0.35;26;14;0.15;0.35
Control.SRR15539829;46;45;0.478260869565217;24;22;0.0217391304347826;0.478260869565217
Control.SRR15539829;41;45;0.439024390243902;23;18;0.0609756097560976;0.439024390243902
Control.SRR15539829;44;45;0.590909090909091;18;26;0.0909090909090909;0.409090909090909
Control.SRR15539829;47;45;0.48936170212766;24;23;0.0106382978723404;0.48936170212766
Control.SRR15539829;48;45;0.729166666666667;13;35;0.229166666666667;0.270833333333333
Control.SRR15539829;49;45;0.510204081632653;24;25;0.0102040816326531;0.489795918367347
Control.SRR15539829;40;45;0.425;23;17;0.075;0.425
Control.SRR15539829;40;45;0.45;22;18;0.05;0.45
Control.SRR15539829;42;45;0.357142857142857;27;15;0.142857142857143;0.357142857142857
Control.SRR15539829;41;45;0.414634146341463;24;17;0.0853658536585366;0.414634146341463
Control.SRR15539829;44;45;0.477272727272727;23;21;0.0227272727272727;0.477272727272727
Control.SRR15539829;44;45;0.454545454545455;24;20;0.0454545454545455;0.454545454545455
Control.SRR15539829;40;45;0.35;26;14;0.15;0.35
Control.SRR15539829;45;45;0.4;27;18;0.1;0.4
Control.SRR15539829;40;45;0.7;12;28;0.2;0.3
Control.SRR15539829;48;45;0.5;24;24;0;0.5
Control.SRR15539829;43;45;0.465116279069767;23;20;0.0348837209302326;0.465116279069767
Control.SRR15539829;46;45;0.630434782608696;17;29;0.130434782608696;0.369565217391304
Control.SRR15539829;40;45;0.35;26;14;0.15;0.35
Control.SRR15539829;43;45;0.511627906976744;21;22;0.0116279069767442;0.488372093023256
Control.SRR15539829;49;45;0.510204081632653;24;25;0.0102040816326531;0.489795918367347
Control.SRR15539829;51;45;0.529411764705882;24;27;0.0294117647058824;0.470588235294118
Control.SRR15539829;43;45;0.418604651162791;25;18;0.0813953488372093;0.418604651162791
Control.SRR15539829;44;45;0.5;22;22;0;0.5
Control.SRR15539829;49;45;0.489795918367347;25;24;0.0102040816326531;0.489795918367347
Control.SRR15539829;46;45;0.456521739130435;25;21;0.0434782608695652;0.456521739130435
Control.SRR15539829;41;45;0.609756097560976;16;25;0.109756097560976;0.390243902439024
Control.SRR15539829;42;45;0.476190476190476;22;20;0.0238095238095238;0.476190476190476
Control.SRR15539829;44;45;0.5;22;22;0;0.5
Control.SRR15539829;43;45;0.465116279069767;23;20;0.0348837209302326;0.465116279069767
Control.SRR15539829;48;45;0.541666666666667;22;26;0.0416666666666666;0.458333333333333
Control.SRR15539829;40;45;0.6;16;24;0.1;0.4
Control.SRR15539829;42;45;0.357142857142857;27;15;0.142857142857143;0.357142857142857
Control.SRR15539829;40;45;0.55;18;22;0.05;0.45
Control.SRR15539829;50;45;0.56;22;28;0.0600000000000001;0.44
Control.SRR15539829;45;45;0.533333333333333;21;24;0.0333333333333333;0.466666666666667
Control.SRR15539829;42;45;0.5;21;21;0;0.5
Control.SRR15539829;50;45;0.5;25;25;0;0.5
Control.SRR15539829;50;45;0.54;23;27;0.04;0.46
Control.SRR15539829;47;45;0.340425531914894;31;16;0.159574468085106;0.340425531914894
Control.SRR15539829;50;45;0.54;23;27;0.04;0.46
Control.SRR15539829;43;45;0.418604651162791;25;18;0.0813953488372093;0.418604651162791
Control.SRR15539829;48;45;0.5625;21;27;0.0625;0.4375
Control.SRR15539829;43;45;0.441860465116279;24;19;0.0581395348837209;0.441860465116279
Control.SRR15539829;40;45;0.325;27;13;0.175;0.325
Control.SRR15539829;40;45;0.55;18;22;0.05;0.45
Control.SRR15539829;45;45;0.422222222222222;26;19;0.0777777777777778;0.422222222222222
Control.SRR15539829;50;45;0.44;28;22;0.06;0.44
Control.SRR15539829;45;45;0.4;27;18;0.1;0.4
Control.SRR15539829;41;45;0.560975609756098;18;23;0.0609756097560976;0.439024390243902
Control.SRR15539829;44;45;0.477272727272727;23;21;0.0227272727272727;0.477272727272727
Control.SRR15539829;51;45;0.549019607843137;23;28;0.0490196078431373;0.450980392156863
Control.SRR15539829;47;45;0.553191489361702;21;26;0.0531914893617021;0.446808510638298
Control.SRR15539829;47;45;0.531914893617021;22;25;0.0319148936170213;0.468085106382979
Control.SRR15539829;48;45;0.5625;21;27;0.0625;0.4375
Control.SRR15539829;47;45;0.446808510638298;26;21;0.0531914893617021;0.446808510638298
Control.SRR15539829;43;45;0.511627906976744;21;22;0.0116279069767442;0.488372093023256
Control.SRR15539829;42;45;0.404761904761905;25;17;0.0952380952380952;0.404761904761905
Control.SRR15539829;42;45;0.642857142857143;15;27;0.142857142857143;0.357142857142857
Control.SRR15539829;44;45;0.5;22;22;0;0.5
Control.SRR15539829;39;45;0.564102564102564;17;22;0.0641025641025641;0.435897435897436
Control.SRR15539829;42;45;0.428571428571429;24;18;0.0714285714285715;0.428571428571429
Control.SRR15539829;50;45;0.4;30;20;0.1;0.4
Control.SRR15539829;48;45;0.458333333333333;26;22;0.0416666666666667;0.458333333333333
Control.SRR15539829;46;45;0.521739130434783;22;24;0.0217391304347826;0.478260869565217
Control.SRR15539829;40;45;0.5;20;20;0;0.5
Control.SRR15539829;44;45;0.477272727272727;23;21;0.0227272727272727;0.477272727272727
Control.SRR15539829;50;45;0.44;28;22;0.06;0.44
Control.SRR15539829;41;45;0.48780487804878;21;20;0.0121951219512195;0.48780487804878
Control.SRR15539829;40;45;0.375;25;15;0.125;0.375
Control.SRR15539829;44;45;0.613636363636364;17;27;0.113636363636364;0.386363636363636
Control.SRR15539829;45;45;0.377777777777778;28;17;0.122222222222222;0.377777777777778
Control.SRR15539829;44;45;0.681818181818182;14;30;0.181818181818182;0.318181818181818
Control.SRR15539829;42;45;0.714285714285714;12;30;0.214285714285714;0.285714285714286
Control.SRR15539829;51;45;0.549019607843137;23;28;0.0490196078431373;0.450980392156863
Control.SRR15539829;48;45;0.4375;27;21;0.0625;0.4375
Control.SRR15539829;40;45;0.55;18;22;0.05;0.45
Control.SRR15539829;40;45;0.45;22;18;0.05;0.45
Control.SRR15539829;48;45;0.5;24;24;0;0.5
Control.SRR15539829;40;45;0.475;21;19;0.025;0.475
Control.SRR15539829;41;45;0.585365853658537;17;24;0.0853658536585366;0.414634146341463
Control.SRR15539829;50;45;0.58;21;29;0.08;0.42
Control.SRR15539829;46;45;0.521739130434783;22;24;0.0217391304347826;0.478260869565217
Control.SRR15539829;45;45;0.422222222222222;26;19;0.0777777777777778;0.422222222222222
Control.SRR15539829;46;45;0.521739130434783;22;24;0.0217391304347826;0.478260869565217
Control.SRR15539829;51;45;0.431372549019608;29;22;0.0686274509803921;0.431372549019608
Control.SRR15539829;49;45;0.408163265306122;29;20;0.0918367346938775;0.408163265306122
Control.SRR15539829;51;45;0.470588235294118;27;24;0.0294117647058824;0.470588235294118
Control.SRR15539829;46;45;0.58695652173913;19;27;0.0869565217391305;0.41304347826087
Control.SRR15539829;51;45;0.431372549019608;29;22;0.0686274509803921;0.431372549019608
Control.SRR15539829;43;45;0.511627906976744;21;22;0.0116279069767442;0.488372093023256
Control.SRR15539829;45;45;0.444444444444444;25;20;0.0555555555555556;0.444444444444444
Control.SRR15539829;48;45;0.479166666666667;25;23;0.0208333333333333;0.479166666666667
Control.SRR15539829;47;45;0.595744680851064;19;28;0.0957446808510638;0.404255319148936
Control.SRR15539829;43;45;0.511627906976744;21;22;0.0116279069767442;0.488372093023256
Control.SRR15539829;44;45;0.363636363636364;28;16;0.136363636363636;0.363636363636364
Control.SRR15539829;40;45;0.65;14;26;0.15;0.35
Control.SRR15539829;44;45;0.454545454545455;24;20;0.0454545454545455;0.454545454545455
Control.SRR15539829;46;45;0.478260869565217;24;22;0.0217391304347826;0.478260869565217
Control.SRR15539829;46;45;0.652173913043478;16;30;0.152173913043478;0.347826086956522
Control.SRR15539829;40;45;0.4;24;16;0.1;0.4
Control.SRR15539829;45;45;0.577777777777778;19;26;0.0777777777777777;0.422222222222222
Control.SRR15539829;48;45;0.583333333333333;20;28;0.0833333333333334;0.416666666666667
Control.SRR15539829;48;45;0.5;24;24;0;0.5
Control.SRR15539829;41;45;0.439024390243902;23;18;0.0609756097560976;0.439024390243902
Control.SRR15539829;40;45;0.5;20;20;0;0.5
Control.SRR15539829;44;45;0.363636363636364;28;16;0.136363636363636;0.363636363636364
Control.SRR15539829;42;45;0.452380952380952;23;19;0.0476190476190476;0.452380952380952
Control.SRR15539829;49;45;0.448979591836735;27;22;0.0510204081632653;0.448979591836735
Control.SRR15539829;46;45;0.652173913043478;16;30;0.152173913043478;0.347826086956522
Control.SRR15539829;51;45;0.509803921568627;25;26;0.00980392156862742;0.490196078431373
Control.SRR15539829;51;45;0.431372549019608;29;22;0.0686274509803921;0.431372549019608
Control.SRR15539829;48;45;0.583333333333333;20;28;0.0833333333333334;0.416666666666667
Control.SRR15539829;41;45;0.48780487804878;21;20;0.0121951219512195;0.48780487804878
Control.SRR15539829;42;45;0.428571428571429;24;18;0.0714285714285715;0.428571428571429
Control.SRR15539829;42;45;0.547619047619048;19;23;0.0476190476190477;0.452380952380952
Control.SRR15539829;47;45;0.404255319148936;28;19;0.0957446808510639;0.404255319148936
Control.SRR15539829;50;45;0.44;28;22;0.06;0.44
Control.SRR15539829;41;45;0.48780487804878;21;20;0.0121951219512195;0.48780487804878
Control.SRR15539829;44;45;0.681818181818182;14;30;0.181818181818182;0.318181818181818
Control.SRR15539829;43;45;0.488372093023256;22;21;0.0116279069767442;0.488372093023256
Control.SRR15539829;39;45;0.487179487179487;20;19;0.0128205128205128;0.487179487179487
Control.SRR15539829;46;45;0.521739130434783;22;24;0.0217391304347826;0.478260869565217
Control.SRR15539829;51;45;0.431372549019608;29;22;0.0686274509803921;0.431372549019608
Control.SRR15539829;43;45;0.418604651162791;25;18;0.0813953488372093;0.418604651162791
Control.SRR15539829;48;45;0.5;24;24;0;0.5
Control.SRR15539829;48;45;0.5;24;24;0;0.5
Control.SRR15539829;45;45;0.511111111111111;22;23;0.0111111111111111;0.488888888888889
Control.SRR15539829;44;45;0.409090909090909;26;18;0.0909090909090909;0.409090909090909
Control.SRR15539829;47;45;0.553191489361702;21;26;0.0531914893617021;0.446808510638298
Control.SRR15539829;45;45;0.577777777777778;19;26;0.0777777777777777;0.422222222222222
Control.SRR15539829;41;45;0.585365853658537;17;24;0.0853658536585366;0.414634146341463
Control.SRR15539829;40;45;0.525;19;21;0.025;0.475
Control.SRR15539829;49;45;0.551020408163265;22;27;0.0510204081632653;0.448979591836735
Control.SRR15539829;41;45;0.439024390243902;23;18;0.0609756097560976;0.439024390243902
Control.SRR15539829;43;45;0.465116279069767;23;20;0.0348837209302326;0.465116279069767
Control.SRR15539829;40;45;0.625;15;25;0.125;0.375
Control.SRR15539829;41;45;0.439024390243902;23;18;0.0609756097560976;0.439024390243902
Control.SRR15539829;41;45;0.439024390243902;23;18;0.0609756097560976;0.439024390243902
Control.SRR15539829;39;45;0.58974358974359;16;23;0.0897435897435898;0.41025641025641
Control.SRR15539829;45;45;0.511111111111111;22;23;0.0111111111111111;0.488888888888889
Control.SRR15539829;42;45;0.380952380952381;26;16;0.119047619047619;0.380952380952381
Control.SRR15539829;44;45;0.386363636363636;27;17;0.113636363636364;0.386363636363636
Control.SRR15539829;42;45;0.452380952380952;23;19;0.0476190476190476;0.452380952380952
Control.SRR15539829;45;45;0.6;18;27;0.1;0.4
Control.SRR15539829;39;45;0.333333333333333;26;13;0.166666666666667;0.333333333333333
Control.SRR15539829;43;45;0.558139534883721;19;24;0.0581395348837209;0.441860465116279
Control.SRR15539829;44;45;0.431818181818182;25;19;0.0681818181818182;0.431818181818182
Control.SRR15539829;43;45;0.534883720930233;20;23;0.0348837209302325;0.465116279069767
Control.SRR15539829;47;45;0.425531914893617;27;20;0.074468085106383;0.425531914893617
Control.SRR15539829;50;45;0.62;19;31;0.12;0.38
Control.SRR15539829;46;45;0.521739130434783;22;24;0.0217391304347826;0.478260869565217
Control.SRR15539829;48;45;0.354166666666667;31;17;0.145833333333333;0.354166666666667
Control.SRR15539829;44;45;0.545454545454545;20;24;0.0454545454545454;0.454545454545455
Control.SRR15539829;45;45;0.555555555555556;20;25;0.0555555555555556;0.444444444444444
Control.SRR15539829;43;45;0.465116279069767;23;20;0.0348837209302326;0.465116279069767
Control.SRR15539829;44;45;0.545454545454545;20;24;0.0454545454545454;0.454545454545455
Control.SRR15539829;40;45;0.475;21;19;0.025;0.475
Control.SRR15539829;46;45;0.58695652173913;19;27;0.0869565217391305;0.41304347826087
Control.SRR15539829;45;45;0.555555555555556;20;25;0.0555555555555556;0.444444444444444
Control.SRR15539829;42;45;0.547619047619048;19;23;0.0476190476190477;0.452380952380952
Control.SRR15539829;40;45;0.5;20;20;0;0.5
Control.SRR15539829;48;45;0.645833333333333;17;31;0.145833333333333;0.354166666666667
Control.SRR15539829;39;45;0.512820512820513;19;20;0.0128205128205128;0.487179487179487
Control.SRR15539829;42;45;0.428571428571429;24;18;0.0714285714285715;0.428571428571429
Control.SRR15539829;50;45;0.58;21;29;0.08;0.42
Control.SRR15539829;51;45;0.529411764705882;24;27;0.0294117647058824;0.470588235294118
Control.SRR15539829;49;45;0.489795918367347;25;24;0.0102040816326531;0.489795918367347
Control.SRR15539829;47;45;0.531914893617021;22;25;0.0319148936170213;0.468085106382979
Control.SRR15539829;50;45;0.54;23;27;0.04;0.46
Control.SRR15539829;47;45;0.48936170212766;24;23;0.0106382978723404;0.48936170212766
Control.SRR15539829;45;45;0.466666666666667;24;21;0.0333333333333333;0.466666666666667
Control.SRR15539829;40;45;0.65;14;26;0.15;0.35
Control.SRR15539829;46;45;0.521739130434783;22;24;0.0217391304347826;0.478260869565217
Control.SRR15539829;45;45;0.511111111111111;22;23;0.0111111111111111;0.488888888888889
Control.SRR15539829;43;45;0.488372093023256;22;21;0.0116279069767442;0.488372093023256
Control.SRR15539829;42;45;0.571428571428571;18;24;0.0714285714285714;0.428571428571429
Control.SRR15539829;51;45;0.411764705882353;30;21;0.0882352941176471;0.411764705882353
Control.SRR15539829;42;45;0.476190476190476;22;20;0.0238095238095238;0.476190476190476
Control.SRR15539829;43;45;0.581395348837209;18;25;0.0813953488372093;0.418604651162791
Control.SRR15539829;50;45;0.62;19;31;0.12;0.38
Control.SRR15539829;43;45;0.558139534883721;19;24;0.0581395348837209;0.441860465116279
Control.SRR15539829;42;45;0.523809523809524;20;22;0.0238095238095238;0.476190476190476
Control.SRR15539829;50;45;0.5;25;25;0;0.5
Control.SRR15539829;47;45;0.51063829787234;23;24;0.0106382978723404;0.48936170212766
Control.SRR15539829;47;45;0.595744680851064;19;28;0.0957446808510638;0.404255319148936
Control.SRR15539829;42;45;0.476190476190476;22;20;0.0238095238095238;0.476190476190476
Control.SRR15539829;43;45;0.418604651162791;25;18;0.0813953488372093;0.418604651162791
Control.SRR15539829;42;45;0.523809523809524;20;22;0.0238095238095238;0.476190476190476
Control.SRR15539829;39;45;0.461538461538462;21;18;0.0384615384615384;0.461538461538462
Control.SRR15539829;46;45;0.434782608695652;26;20;0.0652173913043478;0.434782608695652
Control.SRR15539829;43;45;0.558139534883721;19;24;0.0581395348837209;0.441860465116279
Control.SRR15539829;48;45;0.583333333333333;20;28;0.0833333333333334;0.416666666666667
Control.SRR15539829;45;45;0.422222222222222;26;19;0.0777777777777778;0.422222222222222
Control.SRR15539829;46;45;0.5;23;23;0;0.5
Control.SRR15539829;45;45;0.466666666666667;24;21;0.0333333333333333;0.466666666666667
Control.SRR15539829;39;45;0.58974358974359;16;23;0.0897435897435898;0.41025641025641
Control.SRR15539829;50;45;0.42;29;21;0.08;0.42
Control.SRR15539829;43;45;0.511627906976744;21;22;0.0116279069767442;0.488372093023256
Control.SRR15539829;44;45;0.545454545454545;20;24;0.0454545454545454;0.454545454545455
Control.SRR15539829;42;45;0.380952380952381;26;16;0.119047619047619;0.380952380952381
Control.SRR15539829;45;45;0.466666666666667;24;21;0.0333333333333333;0.466666666666667
Control.SRR15539829;50;45;0.46;27;23;0.04;0.46
Control.SRR15539829;41;45;0.48780487804878;21;20;0.0121951219512195;0.48780487804878
Control.SRR15539829;40;45;0.425;23;17;0.075;0.425
Control.SRR15539829;41;45;0.48780487804878;21;20;0.0121951219512195;0.48780487804878
Control.SRR15539829;44;45;0.409090909090909;26;18;0.0909090909090909;0.409090909090909
Control.SRR15539829;43;45;0.488372093023256;22;21;0.0116279069767442;0.488372093023256
Control.SRR15539829;44;45;0.431818181818182;25;19;0.0681818181818182;0.431818181818182
Control.SRR15539829;46;45;0.58695652173913;19;27;0.0869565217391305;0.41304347826087
Control.SRR15539829;51;45;0.529411764705882;24;27;0.0294117647058824;0.470588235294118
Control.SRR15539829;39;45;0.384615384615385;24;15;0.115384615384615;0.384615384615385
Control.SRR15539829;50;45;0.32;34;16;0.18;0.32
Control.SRR15539829;44;45;0.318181818181818;30;14;0.181818181818182;0.318181818181818
Control.SRR15539829;50;45;0.5;25;25;0;0.5
Control.SRR15539829;49;45;0.571428571428571;21;28;0.0714285714285714;0.428571428571429
Control.SRR15539829;49;45;0.469387755102041;26;23;0.0306122448979592;0.469387755102041
Control.SRR15539829;50;45;0.5;25;25;0;0.5
Control.SRR15539829;51;45;0.490196078431373;26;25;0.00980392156862747;0.490196078431373
Control.SRR15539829;43;45;0.627906976744186;16;27;0.127906976744186;0.372093023255814
Control.SRR15539829;42;45;0.595238095238095;17;25;0.0952380952380952;0.404761904761905
Control.SRR15539829;48;45;0.479166666666667;25;23;0.0208333333333333;0.479166666666667
Control.SRR15539829;43;45;0.534883720930233;20;23;0.0348837209302325;0.465116279069767
Control.SRR15539829;40;45;0.525;19;21;0.025;0.475
Control.SRR15539829;45;45;0.466666666666667;24;21;0.0333333333333333;0.466666666666667
Control.SRR15539829;39;45;0.41025641025641;23;16;0.0897435897435898;0.41025641025641
Control.SRR15539829;48;45;0.479166666666667;25;23;0.0208333333333333;0.479166666666667
Control.SRR15539829;46;45;0.369565217391304;29;17;0.130434782608696;0.369565217391304
Control.SRR15539829;51;45;0.509803921568627;25;26;0.00980392156862742;0.490196078431373
Control.SRR15539829;47;45;0.468085106382979;25;22;0.0319148936170213;0.468085106382979
Control.SRR15539829;46;45;0.5;23;23;0;0.5
Control.SRR15539829;49;45;0.510204081632653;24;25;0.0102040816326531;0.489795918367347
Control.SRR15539829;46;45;0.478260869565217;24;22;0.0217391304347826;0.478260869565217
Control.SRR15539829;43;45;0.511627906976744;21;22;0.0116279069767442;0.488372093023256
Control.SRR15539829;41;45;0.463414634146341;22;19;0.0365853658536585;0.463414634146341
Control.SRR15539829;39;45;0.564102564102564;17;22;0.0641025641025641;0.435897435897436
Control.SRR15539829;50;45;0.5;25;25;0;0.5
Control.SRR15539829;51;45;0.392156862745098;31;20;0.107843137254902;0.392156862745098
Control.SRR15539829;42;45;0.452380952380952;23;19;0.0476190476190476;0.452380952380952
Control.SRR15539829;44;45;0.363636363636364;28;16;0.136363636363636;0.363636363636364
Control.SRR15539829;43;45;0.465116279069767;23;20;0.0348837209302326;0.465116279069767
Control.SRR15539829;46;45;0.521739130434783;22;24;0.0217391304347826;0.478260869565217
Control.SRR15539829;46;45;0.5;23;23;0;0.5
Control.SRR15539829;51;45;0.490196078431373;26;25;0.00980392156862747;0.490196078431373
Control.SRR15539829;40;45;0.55;18;22;0.05;0.45
Control.SRR15539829;48;45;0.4375;27;21;0.0625;0.4375
Control.SRR15539829;47;45;0.404255319148936;28;19;0.0957446808510639;0.404255319148936
Control.SRR15539829;44;45;0.454545454545455;24;20;0.0454545454545455;0.454545454545455
Control.SRR15539829;51;45;0.529411764705882;24;27;0.0294117647058824;0.470588235294118
Control.SRR15539829;39;45;0.512820512820513;19;20;0.0128205128205128;0.487179487179487
Control.SRR15539829;50;45;0.52;24;26;0.02;0.48
Control.SRR15539829;47;45;0.425531914893617;27;20;0.074468085106383;0.425531914893617
Control.SRR15539829;51;45;0.529411764705882;24;27;0.0294117647058824;0.470588235294118
Control.SRR15539829;49;45;0.448979591836735;27;22;0.0510204081632653;0.448979591836735
Control.SRR15539829;44;45;0.568181818181818;19;25;0.0681818181818182;0.431818181818182
Control.SRR15539829;48;45;0.479166666666667;25;23;0.0208333333333333;0.479166666666667
Control.SRR15539829;47;45;0.446808510638298;26;21;0.0531914893617021;0.446808510638298
Control.SRR15539829;48;45;0.520833333333333;23;25;0.0208333333333334;0.479166666666667
Control.SRR15539829;46;45;0.282608695652174;33;13;0.217391304347826;0.282608695652174
Control.SRR15539829;51;45;0.470588235294118;27;24;0.0294117647058824;0.470588235294118
Control.SRR15539829;51;45;0.588235294117647;21;30;0.0882352941176471;0.411764705882353
Control.SRR15539829;48;45;0.5;24;24;0;0.5
Control.SRR15539829;51;45;0.470588235294118;27;24;0.0294117647058824;0.470588235294118
Control.SRR15539829;45;45;0.511111111111111;22;23;0.0111111111111111;0.488888888888889
Control.SRR15539829;49;45;0.36734693877551;31;18;0.13265306122449;0.36734693877551
Control.SRR15539829;44;45;0.5;22;22;0;0.5
Control.SRR15539829;42;45;0.476190476190476;22;20;0.0238095238095238;0.476190476190476
Control.SRR15539829;40;45;0.475;21;19;0.025;0.475
Control.SRR15539829;49;45;0.448979591836735;27;22;0.0510204081632653;0.448979591836735
Control.SRR15539829;50;45;0.54;23;27;0.04;0.46
Control.SRR15539829;45;45;0.533333333333333;21;24;0.0333333333333333;0.466666666666667
Control.SRR15539829;47;45;0.51063829787234;23;24;0.0106382978723404;0.48936170212766
Control.SRR15539829;47;45;0.468085106382979;25;22;0.0319148936170213;0.468085106382979
Control.SRR15539829;41;45;0.585365853658537;17;24;0.0853658536585366;0.414634146341463
Control.SRR15539829;50;45;0.5;25;25;0;0.5
Control.SRR15539829;47;45;0.425531914893617;27;20;0.074468085106383;0.425531914893617
Control.SRR15539829;41;45;0.439024390243902;23;18;0.0609756097560976;0.439024390243902
Control.SRR15539829;48;45;0.583333333333333;20;28;0.0833333333333334;0.416666666666667
Control.SRR15539829;49;45;0.591836734693878;20;29;0.0918367346938775;0.408163265306122
Control.SRR15539829;46;45;0.391304347826087;28;18;0.108695652173913;0.391304347826087
Control.SRR15539829;44;45;0.568181818181818;19;25;0.0681818181818182;0.431818181818182
Control.SRR15539829;44;45;0.5;22;22;0;0.5
Control.SRR15539829;47;45;0.446808510638298;26;21;0.0531914893617021;0.446808510638298
Control.SRR15539829;47;45;0.48936170212766;24;23;0.0106382978723404;0.48936170212766
Control.SRR15539829;51;45;0.529411764705882;24;27;0.0294117647058824;0.470588235294118
Control.SRR15539829;45;45;0.533333333333333;21;24;0.0333333333333333;0.466666666666667
Control.SRR15539829;42;45;0.452380952380952;23;19;0.0476190476190476;0.452380952380952
Control.SRR15539829;40;45;0.475;21;19;0.025;0.475
Control.SRR15539829;44;45;0.409090909090909;26;18;0.0909090909090909;0.409090909090909
Control.SRR15539829;43;45;0.511627906976744;21;22;0.0116279069767442;0.488372093023256
Control.SRR15539829;44;45;0.477272727272727;23;21;0.0227272727272727;0.477272727272727
Control.SRR15539829;49;45;0.469387755102041;26;23;0.0306122448979592;0.469387755102041
Control.SRR15539829;42;45;0.380952380952381;26;16;0.119047619047619;0.380952380952381
Control.SRR15539829;45;45;0.555555555555556;20;25;0.0555555555555556;0.444444444444444
Control.SRR15539829;47;45;0.446808510638298;26;21;0.0531914893617021;0.446808510638298
Control.SRR15539829;51;45;0.392156862745098;31;20;0.107843137254902;0.392156862745098
Control.SRR15539829;46;45;0.565217391304348;20;26;0.0652173913043478;0.434782608695652
Control.SRR15539829;46;45;0.41304347826087;27;19;0.0869565217391304;0.41304347826087
Control.SRR15539829;42;45;0.523809523809524;20;22;0.0238095238095238;0.476190476190476
Control.SRR15539829;42;45;0.476190476190476;22;20;0.0238095238095238;0.476190476190476
Control.SRR15539829;43;45;0.511627906976744;21;22;0.0116279069767442;0.488372093023256
Control.SRR15539829;47;45;0.51063829787234;23;24;0.0106382978723404;0.48936170212766
Control.SRR15539829;46;45;0.565217391304348;20;26;0.0652173913043478;0.434782608695652
Control.SRR15539829;44;45;0.590909090909091;18;26;0.0909090909090909;0.409090909090909
Control.SRR15539829;44;45;0.431818181818182;25;19;0.0681818181818182;0.431818181818182
Control.SRR15539829;46;45;0.456521739130435;25;21;0.0434782608695652;0.456521739130435
Control.SRR15539829;40;45;0.425;23;17;0.075;0.425
Control.SRR15539829;42;45;0.5;21;21;0;0.5
Control.SRR15539829;39;45;0.564102564102564;17;22;0.0641025641025641;0.435897435897436
Control.SRR15539829;51;45;0.450980392156863;28;23;0.0490196078431372;0.450980392156863
Control.SRR15539829;51;45;0.568627450980392;22;29;0.0686274509803921;0.431372549019608
Control.SRR15539829;44;45;0.431818181818182;25;19;0.0681818181818182;0.431818181818182
Control.SRR15539829;48;45;0.458333333333333;26;22;0.0416666666666667;0.458333333333333
Control.SRR15539829;51;45;0.509803921568627;25;26;0.00980392156862742;0.490196078431373
Control.SRR15539829;51;45;0.470588235294118;27;24;0.0294117647058824;0.470588235294118
Control.SRR15539829;51;45;0.509803921568627;25;26;0.00980392156862742;0.490196078431373
Control.SRR15539829;49;45;0.428571428571429;28;21;0.0714285714285715;0.428571428571429
Control.SRR15539829;51;45;0.529411764705882;24;27;0.0294117647058824;0.470588235294118
Control.SRR15539829;46;45;0.58695652173913;19;27;0.0869565217391305;0.41304347826087
Control.SRR15539829;47;45;0.531914893617021;22;25;0.0319148936170213;0.468085106382979
Control.SRR15539829;46;45;0.565217391304348;20;26;0.0652173913043478;0.434782608695652
Control.SRR15539829;44;45;0.568181818181818;19;25;0.0681818181818182;0.431818181818182
Control.SRR15539829;44;45;0.431818181818182;25;19;0.0681818181818182;0.431818181818182
Control.SRR15539829;45;45;0.644444444444444;16;29;0.144444444444444;0.355555555555556
Control.SRR15539829;50;45;0.44;28;22;0.06;0.44
Control.SRR15539829;47;45;0.595744680851064;19;28;0.0957446808510638;0.404255319148936
Control.SRR15539829;47;45;0.574468085106383;20;27;0.074468085106383;0.425531914893617
Control.SRR15539829;43;45;0.488372093023256;22;21;0.0116279069767442;0.488372093023256
Control.SRR15539829;40;45;0.475;21;19;0.025;0.475
Control.SRR15539829;45;45;0.511111111111111;22;23;0.0111111111111111;0.488888888888889
Control.SRR15539829;45;45;0.488888888888889;23;22;0.0111111111111111;0.488888888888889
Control.SRR15539829;49;45;0.489795918367347;25;24;0.0102040816326531;0.489795918367347
Control.SRR15539829;50;45;0.42;29;21;0.08;0.42
Control.SRR15539829;47;45;0.425531914893617;27;20;0.074468085106383;0.425531914893617
Control.SRR15539829;44;45;0.5;22;22;0;0.5
Control.SRR15539829;42;45;0.404761904761905;25;17;0.0952380952380952;0.404761904761905
Control.SRR15539829;47;45;0.574468085106383;20;27;0.074468085106383;0.425531914893617
Control.SRR15539829;48;45;0.354166666666667;31;17;0.145833333333333;0.354166666666667
Control.SRR15539829;42;45;0.452380952380952;23;19;0.0476190476190476;0.452380952380952
Control.SRR15539829;50;45;0.46;27;23;0.04;0.46
Control.SRR15539829;50;45;0.48;26;24;0.02;0.48
Control.SRR15539829;41;45;0.463414634146341;22;19;0.0365853658536585;0.463414634146341
Control.SRR15539829;45;45;0.555555555555556;20;25;0.0555555555555556;0.444444444444444
Control.SRR15539829;41;45;0.414634146341463;24;17;0.0853658536585366;0.414634146341463
Control.SRR15539829;50;45;0.42;29;21;0.08;0.42
Control.SRR15539829;44;45;0.522727272727273;21;23;0.0227272727272727;0.477272727272727
Control.SRR15539829;45;45;0.555555555555556;20;25;0.0555555555555556;0.444444444444444
Control.SRR15539829;40;45;0.5;20;20;0;0.5
Control.SRR15539829;46;45;0.5;23;23;0;0.5
Control.SRR15539829;39;45;0.538461538461538;18;21;0.0384615384615384;0.461538461538462
Control.SRR15539829;49;45;0.428571428571429;28;21;0.0714285714285715;0.428571428571429
Control.SRR15539829;48;45;0.395833333333333;29;19;0.104166666666667;0.395833333333333
Control.SRR15539829;41;45;0.609756097560976;16;25;0.109756097560976;0.390243902439024
Control.SRR15539829;51;45;0.568627450980392;22;29;0.0686274509803921;0.431372549019608
Control.SRR15539829;44;45;0.522727272727273;21;23;0.0227272727272727;0.477272727272727
Control.SRR15539829;48;45;0.583333333333333;20;28;0.0833333333333334;0.416666666666667
Control.SRR15539829;46;45;0.521739130434783;22;24;0.0217391304347826;0.478260869565217
Control.SRR15539829;45;45;0.466666666666667;24;21;0.0333333333333333;0.466666666666667
Control.SRR15539829;46;45;0.521739130434783;22;24;0.0217391304347826;0.478260869565217
Control.SRR15539829;49;45;0.510204081632653;24;25;0.0102040816326531;0.489795918367347
Control.SRR15539829;50;45;0.54;23;27;0.04;0.46
Control.SRR15539829;51;45;0.529411764705882;24;27;0.0294117647058824;0.470588235294118
Control.SRR15539829;48;45;0.520833333333333;23;25;0.0208333333333334;0.479166666666667
Control.SRR15539829;50;45;0.52;24;26;0.02;0.48
Control.SRR15539829;48;45;0.458333333333333;26;22;0.0416666666666667;0.458333333333333
Control.SRR15539829;49;45;0.551020408163265;22;27;0.0510204081632653;0.448979591836735
Control.SRR15539829;39;45;0.512820512820513;19;20;0.0128205128205128;0.487179487179487
Control.SRR15539829;39;45;0.564102564102564;17;22;0.0641025641025641;0.435897435897436
Control.SRR15539829;50;45;0.56;22;28;0.0600000000000001;0.44
Control.SRR15539829;40;45;0.55;18;22;0.05;0.45
Control.SRR15539829;51;45;0.509803921568627;25;26;0.00980392156862742;0.490196078431373
Control.SRR15539829;44;45;0.386363636363636;27;17;0.113636363636364;0.386363636363636
Control.SRR15539829;46;45;0.434782608695652;26;20;0.0652173913043478;0.434782608695652
Control.SRR15539829;48;45;0.541666666666667;22;26;0.0416666666666666;0.458333333333333
Control.SRR15539829;44;45;0.590909090909091;18;26;0.0909090909090909;0.409090909090909
Control.SRR15539829;51;45;0.431372549019608;29;22;0.0686274509803921;0.431372549019608
Control.SRR15539829;46;45;0.434782608695652;26;20;0.0652173913043478;0.434782608695652
Control.SRR15539829;51;45;0.490196078431373;26;25;0.00980392156862747;0.490196078431373
Control.SRR15539829;43;45;0.27906976744186;31;12;0.22093023255814;0.27906976744186
Control.SRR15539829;49;45;0.510204081632653;24;25;0.0102040816326531;0.489795918367347
Control.SRR15539829;44;45;0.409090909090909;26;18;0.0909090909090909;0.409090909090909
Control.SRR15539829;46;45;0.608695652173913;18;28;0.108695652173913;0.391304347826087
Control.SRR15539829;46;45;0.543478260869565;21;25;0.0434782608695652;0.456521739130435
Control.SRR15539829;41;45;0.414634146341463;24;17;0.0853658536585366;0.414634146341463
Control.SRR15539829;47;45;0.595744680851064;19;28;0.0957446808510638;0.404255319148936
Control.SRR15539829;49;45;0.489795918367347;25;24;0.0102040816326531;0.489795918367347
Control.SRR15539829;46;45;0.630434782608696;17;29;0.130434782608696;0.369565217391304
Control.SRR15539829;49;45;0.510204081632653;24;25;0.0102040816326531;0.489795918367347
Control.SRR15539829;42;45;0.523809523809524;20;22;0.0238095238095238;0.476190476190476
Control.SRR15539829;44;45;0.409090909090909;26;18;0.0909090909090909;0.409090909090909
Control.SRR15539829;45;45;0.533333333333333;21;24;0.0333333333333333;0.466666666666667
Control.SRR15539829;49;45;0.489795918367347;25;24;0.0102040816326531;0.489795918367347
Control.SRR15539829;39;45;0.487179487179487;20;19;0.0128205128205128;0.487179487179487
Control.SRR15539829;39;45;0.564102564102564;17;22;0.0641025641025641;0.435897435897436
Control.SRR15539829;43;45;0.465116279069767;23;20;0.0348837209302326;0.465116279069767
Control.SRR15539829;43;45;0.581395348837209;18;25;0.0813953488372093;0.418604651162791
Control.SRR15539829;47;45;0.446808510638298;26;21;0.0531914893617021;0.446808510638298
Control.SRR15539829;49;45;0.469387755102041;26;23;0.0306122448979592;0.469387755102041
Control.SRR15539829;39;45;0.487179487179487;20;19;0.0128205128205128;0.487179487179487
Control.SRR15539829;48;45;0.645833333333333;17;31;0.145833333333333;0.354166666666667
Control.SRR15539829;49;45;0.489795918367347;25;24;0.0102040816326531;0.489795918367347
Control.SRR15539829;46;45;0.565217391304348;20;26;0.0652173913043478;0.434782608695652
Control.SRR15539829;47;45;0.574468085106383;20;27;0.074468085106383;0.425531914893617
Control.SRR15539829;39;45;0.461538461538462;21;18;0.0384615384615384;0.461538461538462
Control.SRR15539829;49;45;0.510204081632653;24;25;0.0102040816326531;0.489795918367347
Control.SRR15539829;48;45;0.541666666666667;22;26;0.0416666666666666;0.458333333333333
Control.SRR15539829;42;45;0.523809523809524;20;22;0.0238095238095238;0.476190476190476
Control.SRR15539829;45;45;0.488888888888889;23;22;0.0111111111111111;0.488888888888889
Control.SRR15539829;47;45;0.446808510638298;26;21;0.0531914893617021;0.446808510638298
Control.SRR15539829;45;45;0.511111111111111;22;23;0.0111111111111111;0.488888888888889
Control.SRR15539829;44;45;0.477272727272727;23;21;0.0227272727272727;0.477272727272727
Control.SRR15539829;46;45;0.434782608695652;26;20;0.0652173913043478;0.434782608695652
Control.SRR15539829;47;45;0.617021276595745;18;29;0.117021276595745;0.382978723404255
Control.SRR15539829;50;45;0.54;23;27;0.04;0.46
Control.SRR15539829;46;45;0.5;23;23;0;0.5
Control.SRR15539829;46;45;0.369565217391304;29;17;0.130434782608696;0.369565217391304
Control.SRR15539829;47;45;0.553191489361702;21;26;0.0531914893617021;0.446808510638298
Control.SRR15539829;48;45;0.583333333333333;20;28;0.0833333333333334;0.416666666666667
Control.SRR15539829;47;45;0.531914893617021;22;25;0.0319148936170213;0.468085106382979
Control.SRR15539829;46;45;0.456521739130435;25;21;0.0434782608695652;0.456521739130435
Control.SRR15539829;43;45;0.465116279069767;23;20;0.0348837209302326;0.465116279069767
Control.SRR15539829;49;45;0.408163265306122;29;20;0.0918367346938775;0.408163265306122
Control.SRR15539829;43;45;0.488372093023256;22;21;0.0116279069767442;0.488372093023256
Control.SRR15539829;42;45;0.452380952380952;23;19;0.0476190476190476;0.452380952380952
Control.SRR15539829;43;45;0.627906976744186;16;27;0.127906976744186;0.372093023255814
Control.SRR15539829;39;45;0.358974358974359;25;14;0.141025641025641;0.358974358974359
Control.SRR15539829;49;45;0.510204081632653;24;25;0.0102040816326531;0.489795918367347
Control.SRR15539829;49;45;0.408163265306122;29;20;0.0918367346938775;0.408163265306122
Control.SRR15539829;45;45;0.466666666666667;24;21;0.0333333333333333;0.466666666666667
Control.SRR15539829;40;45;0.375;25;15;0.125;0.375
Control.SRR15539829;48;45;0.479166666666667;25;23;0.0208333333333333;0.479166666666667
Control.SRR15539829;39;45;0.564102564102564;17;22;0.0641025641025641;0.435897435897436
Control.SRR15539829;50;45;0.46;27;23;0.04;0.46
Control.SRR15539829;47;45;0.531914893617021;22;25;0.0319148936170213;0.468085106382979
Control.SRR15539829;47;45;0.425531914893617;27;20;0.074468085106383;0.425531914893617
Control.SRR15539829;51;45;0.431372549019608;29;22;0.0686274509803921;0.431372549019608
Control.SRR15539829;42;45;0.571428571428571;18;24;0.0714285714285714;0.428571428571429
Control.SRR15539829;46;45;0.478260869565217;24;22;0.0217391304347826;0.478260869565217
Control.SRR15539829;51;45;0.470588235294118;27;24;0.0294117647058824;0.470588235294118
Control.SRR15539829;49;45;0.408163265306122;29;20;0.0918367346938775;0.408163265306122
Control.SRR15539829;40;45;0.55;18;22;0.05;0.45
Control.SRR15539829;39;45;0.358974358974359;25;14;0.141025641025641;0.358974358974359
Control.SRR15539829;41;45;0.536585365853659;19;22;0.0365853658536586;0.463414634146341
Control.SRR15539829;46;45;0.565217391304348;20;26;0.0652173913043478;0.434782608695652
Control.SRR15539829;41;45;0.439024390243902;23;18;0.0609756097560976;0.439024390243902
Control.SRR15539829;42;45;0.380952380952381;26;16;0.119047619047619;0.380952380952381
Control.SRR15539829;40;45;0.55;18;22;0.05;0.45
Control.SRR15539829;49;45;0.571428571428571;21;28;0.0714285714285714;0.428571428571429
Control.SRR15539829;47;45;0.51063829787234;23;24;0.0106382978723404;0.48936170212766
Control.SRR15539829;42;45;0.523809523809524;20;22;0.0238095238095238;0.476190476190476
Control.SRR15539829;39;45;0.512820512820513;19;20;0.0128205128205128;0.487179487179487
Control.SRR15539829;40;45;0.475;21;19;0.025;0.475
Control.SRR15539829;48;45;0.541666666666667;22;26;0.0416666666666666;0.458333333333333
Control.SRR15539829;41;45;0.731707317073171;11;30;0.231707317073171;0.268292682926829
Control.SRR15539829;41;45;0.463414634146341;22;19;0.0365853658536585;0.463414634146341
Control.SRR15539829;49;45;0.469387755102041;26;23;0.0306122448979592;0.469387755102041
Control.SRR15539829;42;45;0.428571428571429;24;18;0.0714285714285715;0.428571428571429
Control.SRR15539829;40;45;0.45;22;18;0.05;0.45
Control.SRR15539829;47;45;0.617021276595745;18;29;0.117021276595745;0.382978723404255
Control.SRR15539829;43;45;0.418604651162791;25;18;0.0813953488372093;0.418604651162791
Control.SRR15539829;40;45;0.4;24;16;0.1;0.4
Control.SRR15539829;42;45;0.428571428571429;24;18;0.0714285714285715;0.428571428571429
Control.SRR15539829;44;45;0.477272727272727;23;21;0.0227272727272727;0.477272727272727
Control.SRR15539829;43;45;0.581395348837209;18;25;0.0813953488372093;0.418604651162791
Control.SRR15539829;51;45;0.392156862745098;31;20;0.107843137254902;0.392156862745098
Control.SRR15539829;46;45;0.58695652173913;19;27;0.0869565217391305;0.41304347826087
Control.SRR15539829;43;45;0.465116279069767;23;20;0.0348837209302326;0.465116279069767
Control.SRR15539829;50;45;0.44;28;22;0.06;0.44
Control.SRR15539829;43;45;0.441860465116279;24;19;0.0581395348837209;0.441860465116279
Control.SRR15539829;43;45;0.534883720930233;20;23;0.0348837209302325;0.465116279069767
Control.SRR15539829;45;45;0.6;18;27;0.1;0.4
Control.SRR15539829;45;45;0.533333333333333;21;24;0.0333333333333333;0.466666666666667
Control.SRR15539829;49;45;0.510204081632653;24;25;0.0102040816326531;0.489795918367347
Control.SRR15539829;41;45;0.48780487804878;21;20;0.0121951219512195;0.48780487804878
Control.SRR15539829;45;45;0.488888888888889;23;22;0.0111111111111111;0.488888888888889
Control.SRR15539829;51;45;0.470588235294118;27;24;0.0294117647058824;0.470588235294118
Control.SRR15539829;45;45;0.4;27;18;0.1;0.4
Control.SRR15539829;45;45;0.355555555555556;29;16;0.144444444444444;0.355555555555556
Control.SRR15539829;49;45;0.510204081632653;24;25;0.0102040816326531;0.489795918367347
Control.SRR15539829;49;45;0.551020408163265;22;27;0.0510204081632653;0.448979591836735
Control.SRR15539829;50;45;0.54;23;27;0.04;0.46
Control.SRR15539829;47;45;0.425531914893617;27;20;0.074468085106383;0.425531914893617
Control.SRR15539829;51;45;0.627450980392157;19;32;0.127450980392157;0.372549019607843
Control.SRR15539829;48;45;0.583333333333333;20;28;0.0833333333333334;0.416666666666667
Control.SRR15539829;48;45;0.5;24;24;0;0.5
Control.SRR15539829;40;45;0.525;19;21;0.025;0.475
Control.SRR15539829;44;45;0.386363636363636;27;17;0.113636363636364;0.386363636363636
Control.SRR15539829;42;45;0.428571428571429;24;18;0.0714285714285715;0.428571428571429
Control.SRR15539829;49;45;0.591836734693878;20;29;0.0918367346938775;0.408163265306122
Control.SRR15539829;51;45;0.529411764705882;24;27;0.0294117647058824;0.470588235294118
Control.SRR15539829;41;45;0.585365853658537;17;24;0.0853658536585366;0.414634146341463
Control.SRR15539829;48;45;0.458333333333333;26;22;0.0416666666666667;0.458333333333333
Control.SRR15539829;46;45;0.5;23;23;0;0.5
Control.SRR15539829;51;45;0.490196078431373;26;25;0.00980392156862747;0.490196078431373
Control.SRR15539829;50;45;0.6;20;30;0.1;0.4
Control.SRR15539829;42;45;0.428571428571429;24;18;0.0714285714285715;0.428571428571429
Control.SRR15539829;49;45;0.26530612244898;36;13;0.23469387755102;0.26530612244898
Control.SRR15539829;53;45;0.471698113207547;28;25;0.0283018867924528;0.471698113207547
Control.SRR15539829;45;45;0.555555555555556;20;25;0.0555555555555556;0.444444444444444
Control.SRR15539829;52;45;0.5;26;26;0;0.5
Control.SRR15539829;43;45;0.488372093023256;22;21;0.0116279069767442;0.488372093023256
Control.SRR15539829;41;45;0.51219512195122;20;21;0.0121951219512195;0.48780487804878
Control.SRR15539829;41;45;0.48780487804878;21;20;0.0121951219512195;0.48780487804878
Control.SRR15539829;40;45;0.525;19;21;0.025;0.475
Control.SRR15539829;49;45;0.489795918367347;25;24;0.0102040816326531;0.489795918367347
Control.SRR15539829;43;45;0.558139534883721;19;24;0.0581395348837209;0.441860465116279
Control.SRR15539829;44;45;0.5;22;22;0;0.5
Control.SRR15539829;46;45;0.565217391304348;20;26;0.0652173913043478;0.434782608695652
Control.SRR15539829;40;45;0.55;18;22;0.05;0.45
Control.SRR15539829;46;45;0.456521739130435;25;21;0.0434782608695652;0.456521739130435
Control.SRR15539829;52;45;0.615384615384615;20;32;0.115384615384615;0.384615384615385
Control.SRR15539829;49;45;0.387755102040816;30;19;0.112244897959184;0.387755102040816
Control.SRR15539829;46;45;0.478260869565217;24;22;0.0217391304347826;0.478260869565217
Control.SRR15539829;49;45;0.510204081632653;24;25;0.0102040816326531;0.489795918367347
Control.SRR15539829;46;45;0.456521739130435;25;21;0.0434782608695652;0.456521739130435
Control.SRR15539829;43;45;0.604651162790698;17;26;0.104651162790698;0.395348837209302
Control.SRR15539829;51;45;0.431372549019608;29;22;0.0686274509803921;0.431372549019608
Control.SRR15539829;44;45;0.318181818181818;30;14;0.181818181818182;0.318181818181818
Control.SRR15539829;50;45;0.44;28;22;0.06;0.44
Control.SRR15539829;49;45;0.571428571428571;21;28;0.0714285714285714;0.428571428571429
Control.SRR15539829;49;45;0.408163265306122;29;20;0.0918367346938775;0.408163265306122
Control.SRR15539829;54;45;0.537037037037037;25;29;0.0370370370370371;0.462962962962963
Control.SRR15539829;46;45;0.41304347826087;27;19;0.0869565217391304;0.41304347826087
Control.SRR15539829;46;45;0.521739130434783;22;24;0.0217391304347826;0.478260869565217
Control.SRR15539829;48;45;0.5;24;24;0;0.5
Control.SRR15539829;43;45;0.395348837209302;26;17;0.104651162790698;0.395348837209302
Control.SRR15539829;47;45;0.595744680851064;19;28;0.0957446808510638;0.404255319148936
Control.SRR15539829;47;45;0.531914893617021;22;25;0.0319148936170213;0.468085106382979
Control.SRR15539829;51;45;0.490196078431373;26;25;0.00980392156862747;0.490196078431373
Control.SRR15539829;46;45;0.521739130434783;22;24;0.0217391304347826;0.478260869565217
Control.SRR15539829;41;45;0.560975609756098;18;23;0.0609756097560976;0.439024390243902
Control.SRR15539829;42;45;0.452380952380952;23;19;0.0476190476190476;0.452380952380952
Control.SRR15539829;45;45;0.422222222222222;26;19;0.0777777777777778;0.422222222222222
Control.SRR15539829;48;45;0.541666666666667;22;26;0.0416666666666666;0.458333333333333
Control.SRR15539829;44;45;0.522727272727273;21;23;0.0227272727272727;0.477272727272727
Control.SRR15539829;51;45;0.490196078431373;26;25;0.00980392156862747;0.490196078431373
Control.SRR15539829;50;45;0.58;21;29;0.08;0.42
Control.SRR15539829;51;45;0.333333333333333;34;17;0.166666666666667;0.333333333333333
Control.SRR15539829;45;45;0.444444444444444;25;20;0.0555555555555556;0.444444444444444
Control.SRR15539829;46;45;0.5;23;23;0;0.5
Control.SRR15539829;42;45;0.523809523809524;20;22;0.0238095238095238;0.476190476190476
Control.SRR15539829;44;45;0.522727272727273;21;23;0.0227272727272727;0.477272727272727
Control.SRR15539829;41;45;0.560975609756098;18;23;0.0609756097560976;0.439024390243902
Control.SRR15539829;52;45;0.480769230769231;27;25;0.0192307692307692;0.480769230769231
Control.SRR15539829;47;45;0.468085106382979;25;22;0.0319148936170213;0.468085106382979
Control.SRR15539829;45;45;0.422222222222222;26;19;0.0777777777777778;0.422222222222222
Control.SRR15539829;48;45;0.583333333333333;20;28;0.0833333333333334;0.416666666666667
Control.SRR15539829;40;45;0.525;19;21;0.025;0.475
Control.SRR15539829;45;45;0.6;18;27;0.1;0.4
Control.SRR15539829;41;45;0.463414634146341;22;19;0.0365853658536585;0.463414634146341
Control.SRR15539829;54;45;0.407407407407407;32;22;0.0925925925925926;0.407407407407407
Control.SRR15539829;44;45;0.590909090909091;18;26;0.0909090909090909;0.409090909090909
Control.SRR15539829;53;45;0.490566037735849;27;26;0.00943396226415094;0.490566037735849
Control.SRR15539829;46;45;0.478260869565217;24;22;0.0217391304347826;0.478260869565217
Control.SRR15539829;49;45;0.530612244897959;23;26;0.0306122448979592;0.469387755102041
Control.SRR15539829;49;45;0.428571428571429;28;21;0.0714285714285715;0.428571428571429
Control.SRR15539829;47;45;0.404255319148936;28;19;0.0957446808510639;0.404255319148936
Control.SRR15539829;41;45;0.414634146341463;24;17;0.0853658536585366;0.414634146341463
Control.SRR15539829;41;45;0.48780487804878;21;20;0.0121951219512195;0.48780487804878
Control.SRR15539829;50;45;0.34;33;17;0.16;0.34
Control.SRR15539829;52;45;0.596153846153846;21;31;0.0961538461538461;0.403846153846154
Control.SRR15539829;42;45;0.452380952380952;23;19;0.0476190476190476;0.452380952380952
Control.SRR15539829;40;45;0.425;23;17;0.075;0.425
Control.SRR15539829;41;45;0.560975609756098;18;23;0.0609756097560976;0.439024390243902
Control.SRR15539829;44;45;0.454545454545455;24;20;0.0454545454545455;0.454545454545455
Control.SRR15539829;41;45;0.463414634146341;22;19;0.0365853658536585;0.463414634146341
Control.SRR15539829;43;45;0.558139534883721;19;24;0.0581395348837209;0.441860465116279
Control.SRR15539829;52;45;0.557692307692308;23;29;0.0576923076923077;0.442307692307692
Control.SRR15539829;40;45;0.45;22;18;0.05;0.45
Control.SRR15539829;47;45;0.531914893617021;22;25;0.0319148936170213;0.468085106382979
Control.SRR15539829;52;45;0.442307692307692;29;23;0.0576923076923077;0.442307692307692
Control.SRR15539829;50;45;0.52;24;26;0.02;0.48
Control.SRR15539829;48;45;0.5;24;24;0;0.5
Control.SRR15539829;49;45;0.591836734693878;20;29;0.0918367346938775;0.408163265306122
Control.SRR15539829;53;45;0.566037735849057;23;30;0.0660377358490566;0.433962264150943
Control.SRR15539829;45;45;0.533333333333333;21;24;0.0333333333333333;0.466666666666667
Control.SRR15539829;51;45;0.313725490196078;35;16;0.186274509803922;0.313725490196078
Control.SRR15539829;44;45;0.545454545454545;20;24;0.0454545454545454;0.454545454545455
Control.SRR15539829;46;45;0.58695652173913;19;27;0.0869565217391305;0.41304347826087
Control.SRR15539829;46;45;0.5;23;23;0;0.5
Control.SRR15539829;48;45;0.458333333333333;26;22;0.0416666666666667;0.458333333333333
Control.SRR15539829;45;45;0.511111111111111;22;23;0.0111111111111111;0.488888888888889
Control.SRR15539829;43;45;0.511627906976744;21;22;0.0116279069767442;0.488372093023256
Control.SRR15539829;54;45;0.555555555555556;24;30;0.0555555555555556;0.444444444444444
Control.SRR15539829;40;45;0.4;24;16;0.1;0.4
Control.SRR15539829;48;45;0.416666666666667;28;20;0.0833333333333333;0.416666666666667
Control.SRR15539829;45;45;0.488888888888889;23;22;0.0111111111111111;0.488888888888889
Control.SRR15539829;41;45;0.48780487804878;21;20;0.0121951219512195;0.48780487804878
Control.SRR15539829;40;45;0.5;20;20;0;0.5
Control.SRR15539829;40;45;0.475;21;19;0.025;0.475
Control.SRR15539829;47;45;0.361702127659574;30;17;0.138297872340426;0.361702127659574
Control.SRR15539829;41;45;0.585365853658537;17;24;0.0853658536585366;0.414634146341463
Control.SRR15539829;45;45;0.533333333333333;21;24;0.0333333333333333;0.466666666666667
Control.SRR15539829;52;45;0.5;26;26;0;0.5
Control.SRR15539829;48;45;0.458333333333333;26;22;0.0416666666666667;0.458333333333333
Control.SRR15539829;45;45;0.533333333333333;21;24;0.0333333333333333;0.466666666666667
Control.SRR15539829;48;45;0.375;30;18;0.125;0.375
Control.SRR15539829;48;45;0.541666666666667;22;26;0.0416666666666666;0.458333333333333
Control.SRR15539829;41;45;0.439024390243902;23;18;0.0609756097560976;0.439024390243902
Control.SRR15539829;54;45;0.462962962962963;29;25;0.037037037037037;0.462962962962963
Control.SRR15539829;40;45;0.425;23;17;0.075;0.425
Control.SRR15539829;41;45;0.560975609756098;18;23;0.0609756097560976;0.439024390243902
Control.SRR15539829;44;45;0.590909090909091;18;26;0.0909090909090909;0.409090909090909
Control.SRR15539829;41;45;0.48780487804878;21;20;0.0121951219512195;0.48780487804878
Control.SRR15539829;44;45;0.386363636363636;27;17;0.113636363636364;0.386363636363636
Control.SRR15539829;42;45;0.547619047619048;19;23;0.0476190476190477;0.452380952380952
Control.SRR15539829;47;45;0.425531914893617;27;20;0.074468085106383;0.425531914893617
Control.SRR15539829;43;45;0.488372093023256;22;21;0.0116279069767442;0.488372093023256
Control.SRR15539829;44;45;0.5;22;22;0;0.5
Control.SRR15539829;47;45;0.446808510638298;26;21;0.0531914893617021;0.446808510638298
Control.SRR15539829;42;45;0.404761904761905;25;17;0.0952380952380952;0.404761904761905
Control.SRR15539829;53;45;0.415094339622642;31;22;0.0849056603773585;0.415094339622642
Control.SRR15539829;46;45;0.456521739130435;25;21;0.0434782608695652;0.456521739130435
Control.SRR15539829;45;45;0.466666666666667;24;21;0.0333333333333333;0.466666666666667
Control.SRR15539829;40;45;0.475;21;19;0.025;0.475
Control.SRR15539829;46;45;0.347826086956522;30;16;0.152173913043478;0.347826086956522
Control.SRR15539829;45;45;0.488888888888889;23;22;0.0111111111111111;0.488888888888889
Control.SRR15539829;40;45;0.625;15;25;0.125;0.375
Control.SRR15539829;51;45;0.411764705882353;30;21;0.0882352941176471;0.411764705882353
Control.SRR15539829;40;45;0.375;25;15;0.125;0.375
Control.SRR15539829;40;45;0.55;18;22;0.05;0.45
Control.SRR15539829;41;45;0.439024390243902;23;18;0.0609756097560976;0.439024390243902
Control.SRR15539829;44;45;0.522727272727273;21;23;0.0227272727272727;0.477272727272727
Control.SRR15539829;41;45;0.390243902439024;25;16;0.109756097560976;0.390243902439024
Control.SRR15539829;48;45;0.604166666666667;19;29;0.104166666666667;0.395833333333333
Control.SRR15539829;47;45;0.553191489361702;21;26;0.0531914893617021;0.446808510638298
Control.SRR15539829;47;45;0.404255319148936;28;19;0.0957446808510639;0.404255319148936
Control.SRR15539829;40;45;0.55;18;22;0.05;0.45
Control.SRR15539829;40;45;0.6;16;24;0.1;0.4
Control.SRR15539829;53;45;0.433962264150943;30;23;0.0660377358490566;0.433962264150943
Control.SRR15539829;41;45;0.536585365853659;19;22;0.0365853658536586;0.463414634146341
Control.SRR15539829;52;45;0.384615384615385;32;20;0.115384615384615;0.384615384615385
Control.SRR15539829;46;45;0.434782608695652;26;20;0.0652173913043478;0.434782608695652
Control.SRR15539829;46;45;0.456521739130435;25;21;0.0434782608695652;0.456521739130435
Control.SRR15539829;53;45;0.547169811320755;24;29;0.0471698113207547;0.452830188679245
Control.SRR15539829;54;45;0.518518518518518;26;28;0.0185185185185185;0.481481481481481
Control.SRR15539829;45;45;0.4;27;18;0.1;0.4
Control.SRR15539829;48;45;0.6875;15;33;0.1875;0.3125
Control.SRR15539829;54;45;0.537037037037037;25;29;0.0370370370370371;0.462962962962963
Control.SRR15539829;52;45;0.596153846153846;21;31;0.0961538461538461;0.403846153846154
Control.SRR15539829;44;45;0.454545454545455;24;20;0.0454545454545455;0.454545454545455
Control.SRR15539829;47;45;0.531914893617021;22;25;0.0319148936170213;0.468085106382979
Control.SRR15539829;49;45;0.571428571428571;21;28;0.0714285714285714;0.428571428571429
Control.SRR15539829;52;45;0.519230769230769;25;27;0.0192307692307693;0.480769230769231
Control.SRR15539829;54;45;0.351851851851852;35;19;0.148148148148148;0.351851851851852
Control.SRR15539829;47;45;0.361702127659574;30;17;0.138297872340426;0.361702127659574
Control.SRR15539829;45;45;0.444444444444444;25;20;0.0555555555555556;0.444444444444444
Control.SRR15539829;41;45;0.51219512195122;20;21;0.0121951219512195;0.48780487804878
Control.SRR15539829;48;45;0.375;30;18;0.125;0.375
Control.SRR15539829;43;45;0.465116279069767;23;20;0.0348837209302326;0.465116279069767
Control.SRR15539829;43;45;0.627906976744186;16;27;0.127906976744186;0.372093023255814
Control.SRR15539829;49;45;0.510204081632653;24;25;0.0102040816326531;0.489795918367347
Control.SRR15539829;42;45;0.595238095238095;17;25;0.0952380952380952;0.404761904761905
Control.SRR15539829;51;45;0.490196078431373;26;25;0.00980392156862747;0.490196078431373
Control.SRR15539829;41;45;0.439024390243902;23;18;0.0609756097560976;0.439024390243902
Control.SRR15539829;47;45;0.382978723404255;29;18;0.117021276595745;0.382978723404255
Control.SRR15539829;47;45;0.468085106382979;25;22;0.0319148936170213;0.468085106382979
Control.SRR15539829;40;45;0.5;20;20;0;0.5
Control.SRR15539829;40;45;0.4;24;16;0.1;0.4
Control.SRR15539829;41;45;0.463414634146341;22;19;0.0365853658536585;0.463414634146341
Control.SRR15539829;41;45;0.51219512195122;20;21;0.0121951219512195;0.48780487804878
Control.SRR15539829;54;45;0.537037037037037;25;29;0.0370370370370371;0.462962962962963
Control.SRR15539829;44;45;0.568181818181818;19;25;0.0681818181818182;0.431818181818182
Control.SRR15539829;40;45;0.55;18;22;0.05;0.45
Control.SRR15539829;52;45;0.576923076923077;22;30;0.0769230769230769;0.423076923076923
Control.SRR15539829;41;45;0.560975609756098;18;23;0.0609756097560976;0.439024390243902
Control.SRR15539829;40;45;0.475;21;19;0.025;0.475
Control.SRR15539829;46;45;0.543478260869565;21;25;0.0434782608695652;0.456521739130435
Control.SRR15539829;41;45;0.439024390243902;23;18;0.0609756097560976;0.439024390243902
Control.SRR15539829;45;45;0.6;18;27;0.1;0.4
Control.SRR15539829;45;45;0.422222222222222;26;19;0.0777777777777778;0.422222222222222
Control.SRR15539829;45;45;0.511111111111111;22;23;0.0111111111111111;0.488888888888889
Control.SRR15539829;40;45;0.5;20;20;0;0.5
Control.SRR15539829;52;45;0.384615384615385;32;20;0.115384615384615;0.384615384615385
Control.SRR15539829;43;45;0.395348837209302;26;17;0.104651162790698;0.395348837209302
Control.SRR15539829;47;45;0.553191489361702;21;26;0.0531914893617021;0.446808510638298
Control.SRR15539829;51;45;0.392156862745098;31;20;0.107843137254902;0.392156862745098
Control.SRR15539829;46;45;0.58695652173913;19;27;0.0869565217391305;0.41304347826087
Control.SRR15539829;51;45;0.490196078431373;26;25;0.00980392156862747;0.490196078431373
Control.SRR15539829;52;45;0.596153846153846;21;31;0.0961538461538461;0.403846153846154
Control.SRR15539829;47;45;0.468085106382979;25;22;0.0319148936170213;0.468085106382979
Control.SRR15539829;47;45;0.446808510638298;26;21;0.0531914893617021;0.446808510638298
Control.SRR15539829;46;45;0.565217391304348;20;26;0.0652173913043478;0.434782608695652
Control.SRR15539829;44;45;0.522727272727273;21;23;0.0227272727272727;0.477272727272727
Control.SRR15539829;41;45;0.51219512195122;20;21;0.0121951219512195;0.48780487804878
Control.SRR15539829;44;45;0.363636363636364;28;16;0.136363636363636;0.363636363636364
Control.SRR15539829;48;45;0.520833333333333;23;25;0.0208333333333334;0.479166666666667
Control.SRR15539829;41;45;0.48780487804878;21;20;0.0121951219512195;0.48780487804878
Control.SRR15539829;52;45;0.461538461538462;28;24;0.0384615384615384;0.461538461538462
Control.SRR15539829;53;45;0.528301886792453;25;28;0.0283018867924528;0.471698113207547
Control.SRR15539829;44;45;0.545454545454545;20;24;0.0454545454545454;0.454545454545455
Control.SRR15539829;44;45;0.477272727272727;23;21;0.0227272727272727;0.477272727272727
Control.SRR15539829;41;45;0.51219512195122;20;21;0.0121951219512195;0.48780487804878
Control.SRR15539829;40;45;0.425;23;17;0.075;0.425
Control.SRR15539829;43;45;0.511627906976744;21;22;0.0116279069767442;0.488372093023256
Control.SRR15539829;47;45;0.531914893617021;22;25;0.0319148936170213;0.468085106382979
Control.SRR15539829;54;45;0.481481481481481;28;26;0.0185185185185185;0.481481481481481
Control.SRR15539829;48;45;0.458333333333333;26;22;0.0416666666666667;0.458333333333333
Control.SRR15539829;52;45;0.538461538461538;24;28;0.0384615384615384;0.461538461538462
Control.SRR15539829;54;45;0.592592592592593;22;32;0.0925925925925926;0.407407407407407
Control.SRR15539829;47;45;0.531914893617021;22;25;0.0319148936170213;0.468085106382979
Control.SRR15539829;41;45;0.536585365853659;19;22;0.0365853658536586;0.463414634146341
Control.SRR15539829;51;45;0.588235294117647;21;30;0.0882352941176471;0.411764705882353
Control.SRR15539829;50;45;0.48;26;24;0.02;0.48
Control.SRR15539829;48;45;0.375;30;18;0.125;0.375
Control.SRR15539829;54;45;0.574074074074074;23;31;0.0740740740740741;0.425925925925926
Control.SRR15539829;54;45;0.462962962962963;29;25;0.037037037037037;0.462962962962963
Control.SRR15539829;52;45;0.576923076923077;22;30;0.0769230769230769;0.423076923076923
Control.SRR15539829;41;45;0.536585365853659;19;22;0.0365853658536586;0.463414634146341
Control.SRR15539829;45;45;0.644444444444444;16;29;0.144444444444444;0.355555555555556
Control.SRR15539829;43;45;0.604651162790698;17;26;0.104651162790698;0.395348837209302
Control.SRR15539829;53;45;0.490566037735849;27;26;0.00943396226415094;0.490566037735849
Control.SRR15539829;52;45;0.576923076923077;22;30;0.0769230769230769;0.423076923076923
Control.SRR15539829;44;45;0.613636363636364;17;27;0.113636363636364;0.386363636363636
Control.SRR15539829;45;45;0.555555555555556;20;25;0.0555555555555556;0.444444444444444
Control.SRR15539829;43;45;0.395348837209302;26;17;0.104651162790698;0.395348837209302
Control.SRR15539829;42;45;0.452380952380952;23;19;0.0476190476190476;0.452380952380952
Control.SRR15539829;49;45;0.510204081632653;24;25;0.0102040816326531;0.489795918367347
Control.SRR15539829;54;45;0.444444444444444;30;24;0.0555555555555556;0.444444444444444
Control.SRR15539829;51;45;0.450980392156863;28;23;0.0490196078431372;0.450980392156863
Control.SRR15539829;41;45;0.585365853658537;17;24;0.0853658536585366;0.414634146341463
Control.SRR15539829;47;45;0.574468085106383;20;27;0.074468085106383;0.425531914893617
Control.SRR15539829;45;45;0.488888888888889;23;22;0.0111111111111111;0.488888888888889
Control.SRR15539829;41;45;0.51219512195122;20;21;0.0121951219512195;0.48780487804878
Control.SRR15539829;53;45;0.528301886792453;25;28;0.0283018867924528;0.471698113207547
Control.SRR15539829;44;45;0.568181818181818;19;25;0.0681818181818182;0.431818181818182
Control.SRR15539829;43;45;0.488372093023256;22;21;0.0116279069767442;0.488372093023256
Control.SRR15539829;52;45;0.423076923076923;30;22;0.0769230769230769;0.423076923076923
Control.SRR15539829;44;45;0.545454545454545;20;24;0.0454545454545454;0.454545454545455
Control.SRR15539829;50;45;0.54;23;27;0.04;0.46
Control.SRR15539829;48;45;0.520833333333333;23;25;0.0208333333333334;0.479166666666667
Control.SRR15539829;50;45;0.4;30;20;0.1;0.4
Control.SRR15539829;49;45;0.489795918367347;25;24;0.0102040816326531;0.489795918367347
Control.SRR15539829;50;45;0.6;20;30;0.1;0.4
Control.SRR15539829;50;45;0.46;27;23;0.04;0.46
Control.SRR15539829;47;45;0.574468085106383;20;27;0.074468085106383;0.425531914893617
Control.SRR15539829;43;45;0.465116279069767;23;20;0.0348837209302326;0.465116279069767
Control.SRR15539829;48;45;0.520833333333333;23;25;0.0208333333333334;0.479166666666667
Control.SRR15539829;50;45;0.6;20;30;0.1;0.4
Control.SRR15539829;40;45;0.6;16;24;0.1;0.4
Control.SRR15539829;40;45;0.45;22;18;0.05;0.45
Control.SRR15539829;49;45;0.346938775510204;32;17;0.153061224489796;0.346938775510204
Control.SRR15539829;46;45;0.434782608695652;26;20;0.0652173913043478;0.434782608695652
Control.SRR15539829;52;45;0.5;26;26;0;0.5
Control.SRR15539829;47;45;0.425531914893617;27;20;0.074468085106383;0.425531914893617
Control.SRR15539829;48;45;0.395833333333333;29;19;0.104166666666667;0.395833333333333
Control.SRR15539829;51;45;0.588235294117647;21;30;0.0882352941176471;0.411764705882353
Control.SRR15539829;51;45;0.411764705882353;30;21;0.0882352941176471;0.411764705882353
Control.SRR15539829;49;45;0.469387755102041;26;23;0.0306122448979592;0.469387755102041
Control.SRR15539829;45;45;0.555555555555556;20;25;0.0555555555555556;0.444444444444444
Control.SRR15539829;53;45;0.509433962264151;26;27;0.00943396226415094;0.490566037735849
Control.SRR15539829;48;45;0.4375;27;21;0.0625;0.4375
Control.SRR15539829;48;45;0.291666666666667;34;14;0.208333333333333;0.291666666666667
Control.SRR15539829;48;45;0.5;24;24;0;0.5
Control.SRR15539829;46;45;0.434782608695652;26;20;0.0652173913043478;0.434782608695652
Control.SRR15539829;54;45;0.5;27;27;0;0.5
Control.SRR15539829;44;45;0.636363636363636;16;28;0.136363636363636;0.363636363636364
Control.SRR15539829;53;45;0.452830188679245;29;24;0.0471698113207547;0.452830188679245
Control.SRR15539829;48;45;0.395833333333333;29;19;0.104166666666667;0.395833333333333
Control.SRR15539829;51;45;0.450980392156863;28;23;0.0490196078431372;0.450980392156863
Control.SRR15539829;40;45;0.4;24;16;0.1;0.4
Control.SRR15539829;40;45;0.425;23;17;0.075;0.425
Control.SRR15539829;44;45;0.545454545454545;20;24;0.0454545454545454;0.454545454545455
Control.SRR15539829;50;45;0.56;22;28;0.0600000000000001;0.44
Control.SRR15539829;48;45;0.541666666666667;22;26;0.0416666666666666;0.458333333333333
Control.SRR15539829;50;45;0.5;25;25;0;0.5
Control.SRR15539829;46;45;0.5;23;23;0;0.5
Control.SRR15539829;48;45;0.375;30;18;0.125;0.375
Control.SRR15539829;52;45;0.461538461538462;28;24;0.0384615384615384;0.461538461538462
Control.SRR15539829;43;45;0.581395348837209;18;25;0.0813953488372093;0.418604651162791
Control.SRR15539829;43;45;0.488372093023256;22;21;0.0116279069767442;0.488372093023256
Control.SRR15539829;46;45;0.543478260869565;21;25;0.0434782608695652;0.456521739130435
Control.SRR15539829;51;45;0.411764705882353;30;21;0.0882352941176471;0.411764705882353
Control.SRR15539829;48;45;0.4375;27;21;0.0625;0.4375
Control.SRR15539829;46;45;0.456521739130435;25;21;0.0434782608695652;0.456521739130435
Control.SRR15539829;44;45;0.454545454545455;24;20;0.0454545454545455;0.454545454545455
Control.SRR15539829;42;45;0.571428571428571;18;24;0.0714285714285714;0.428571428571429
Control.SRR15539829;43;45;0.511627906976744;21;22;0.0116279069767442;0.488372093023256
Control.SRR15539829;40;45;0.45;22;18;0.05;0.45
Control.SRR15539829;40;45;0.55;18;22;0.05;0.45
Control.SRR15539829;46;45;0.608695652173913;18;28;0.108695652173913;0.391304347826087
Control.SRR15539829;43;45;0.395348837209302;26;17;0.104651162790698;0.395348837209302
Control.SRR15539829;41;45;0.365853658536585;26;15;0.134146341463415;0.365853658536585
Control.SRR15539829;41;45;0.414634146341463;24;17;0.0853658536585366;0.414634146341463
Control.SRR15539829;44;45;0.5;22;22;0;0.5
Control.SRR15539829;45;45;0.4;27;18;0.1;0.4
Control.SRR15539829;48;45;0.666666666666667;16;32;0.166666666666667;0.333333333333333
Control.SRR15539829;51;45;0.490196078431373;26;25;0.00980392156862747;0.490196078431373
Control.SRR15539829;51;45;0.568627450980392;22;29;0.0686274509803921;0.431372549019608
Control.SRR15539829;46;45;0.434782608695652;26;20;0.0652173913043478;0.434782608695652
Control.SRR15539829;48;45;0.458333333333333;26;22;0.0416666666666667;0.458333333333333
Control.SRR15539829;51;45;0.431372549019608;29;22;0.0686274509803921;0.431372549019608
Control.SRR15539829;51;45;0.392156862745098;31;20;0.107843137254902;0.392156862745098
Control.SRR15539829;43;45;0.581395348837209;18;25;0.0813953488372093;0.418604651162791
Control.SRR15539829;50;45;0.48;26;24;0.02;0.48
Control.SRR15539829;41;45;0.560975609756098;18;23;0.0609756097560976;0.439024390243902
Control.SRR15539829;42;45;0.571428571428571;18;24;0.0714285714285714;0.428571428571429
Control.SRR15539829;46;45;0.543478260869565;21;25;0.0434782608695652;0.456521739130435
Control.SRR15539829;45;45;0.444444444444444;25;20;0.0555555555555556;0.444444444444444
Control.SRR15539829;43;45;0.488372093023256;22;21;0.0116279069767442;0.488372093023256
Control.SRR15539829;52;45;0.403846153846154;31;21;0.0961538461538461;0.403846153846154
Control.SRR15539829;44;45;0.5;22;22;0;0.5
Control.SRR15539829;45;45;0.4;27;18;0.1;0.4
Control.SRR15539829;46;45;0.565217391304348;20;26;0.0652173913043478;0.434782608695652
Control.SRR15539829;46;45;0.565217391304348;20;26;0.0652173913043478;0.434782608695652
Control.SRR15539829;51;45;0.470588235294118;27;24;0.0294117647058824;0.470588235294118
Control.SRR15539829;47;45;0.425531914893617;27;20;0.074468085106383;0.425531914893617
Control.SRR15539829;42;45;0.476190476190476;22;20;0.0238095238095238;0.476190476190476
Control.SRR15539829;47;45;0.595744680851064;19;28;0.0957446808510638;0.404255319148936
Control.SRR15539829;44;45;0.431818181818182;25;19;0.0681818181818182;0.431818181818182
Control.SRR15539829;42;45;0.571428571428571;18;24;0.0714285714285714;0.428571428571429
Control.SRR15539829;49;45;0.571428571428571;21;28;0.0714285714285714;0.428571428571429
Control.SRR15539829;47;45;0.659574468085106;16;31;0.159574468085106;0.340425531914894
Control.SRR15539829;48;45;0.4375;27;21;0.0625;0.4375
Control.SRR15539829;48;45;0.583333333333333;20;28;0.0833333333333334;0.416666666666667
Control.SRR15539829;50;45;0.5;25;25;0;0.5
Control.SRR15539829;52;45;0.480769230769231;27;25;0.0192307692307692;0.480769230769231
Control.SRR15539829;46;45;0.630434782608696;17;29;0.130434782608696;0.369565217391304
Control.SRR15539829;45;45;0.533333333333333;21;24;0.0333333333333333;0.466666666666667
Control.SRR15539829;53;45;0.433962264150943;30;23;0.0660377358490566;0.433962264150943
Control.SRR15539829;42;45;0.523809523809524;20;22;0.0238095238095238;0.476190476190476
Control.SRR15539829;51;45;0.509803921568627;25;26;0.00980392156862742;0.490196078431373
Control.SRR15539829;49;45;0.510204081632653;24;25;0.0102040816326531;0.489795918367347
Control.SRR15539829;42;45;0.547619047619048;19;23;0.0476190476190477;0.452380952380952
Control.SRR15539829;51;45;0.411764705882353;30;21;0.0882352941176471;0.411764705882353
Control.SRR15539829;50;45;0.56;22;28;0.0600000000000001;0.44
Control.SRR15539829;44;45;0.409090909090909;26;18;0.0909090909090909;0.409090909090909
Control.SRR15539829;51;45;0.549019607843137;23;28;0.0490196078431373;0.450980392156863
Control.SRR15539829;50;45;0.46;27;23;0.04;0.46
Control.SRR15539829;53;45;0.566037735849057;23;30;0.0660377358490566;0.433962264150943
Control.SRR15539829;40;45;0.45;22;18;0.05;0.45
Control.SRR15539829;44;45;0.409090909090909;26;18;0.0909090909090909;0.409090909090909
Control.SRR15539829;45;45;0.488888888888889;23;22;0.0111111111111111;0.488888888888889
Control.SRR15539829;51;45;0.450980392156863;28;23;0.0490196078431372;0.450980392156863
Control.SRR15539829;52;45;0.596153846153846;21;31;0.0961538461538461;0.403846153846154
Control.SRR15539829;46;45;0.58695652173913;19;27;0.0869565217391305;0.41304347826087
Control.SRR15539829;43;45;0.372093023255814;27;16;0.127906976744186;0.372093023255814
Control.SRR15539829;42;45;0.595238095238095;17;25;0.0952380952380952;0.404761904761905
Control.SRR15539829;46;45;0.41304347826087;27;19;0.0869565217391304;0.41304347826087
Control.SRR15539829;41;45;0.463414634146341;22;19;0.0365853658536585;0.463414634146341
Control.SRR15539829;49;45;0.36734693877551;31;18;0.13265306122449;0.36734693877551
Control.SRR15539829;41;45;0.48780487804878;21;20;0.0121951219512195;0.48780487804878
Control.SRR15539829;50;45;0.4;30;20;0.1;0.4
Control.SRR15539829;46;45;0.478260869565217;24;22;0.0217391304347826;0.478260869565217
Control.SRR15539829;40;45;0.525;19;21;0.025;0.475
Control.SRR15539829;42;45;0.452380952380952;23;19;0.0476190476190476;0.452380952380952
Control.SRR15539829;48;45;0.4375;27;21;0.0625;0.4375
Control.SRR15539829;42;45;0.428571428571429;24;18;0.0714285714285715;0.428571428571429
Control.SRR15539829;54;45;0.462962962962963;29;25;0.037037037037037;0.462962962962963
Control.SRR15539829;43;45;0.465116279069767;23;20;0.0348837209302326;0.465116279069767
Control.SRR15539829;49;45;0.387755102040816;30;19;0.112244897959184;0.387755102040816
Control.SRR15539829;43;45;0.441860465116279;24;19;0.0581395348837209;0.441860465116279
Control.SRR15539829;40;45;0.425;23;17;0.075;0.425
Control.SRR15539829;47;45;0.531914893617021;22;25;0.0319148936170213;0.468085106382979
Control.SRR15539829;41;45;0.414634146341463;24;17;0.0853658536585366;0.414634146341463
Control.SRR15539829;46;45;0.478260869565217;24;22;0.0217391304347826;0.478260869565217
Control.SRR15539829;53;45;0.433962264150943;30;23;0.0660377358490566;0.433962264150943
Control.SRR15539829;42;45;0.404761904761905;25;17;0.0952380952380952;0.404761904761905
Control.SRR15539829;41;45;0.560975609756098;18;23;0.0609756097560976;0.439024390243902
Control.SRR15539829;46;45;0.565217391304348;20;26;0.0652173913043478;0.434782608695652
Control.SRR15539829;41;45;0.560975609756098;18;23;0.0609756097560976;0.439024390243902
Control.SRR15539829;47;45;0.446808510638298;26;21;0.0531914893617021;0.446808510638298
Control.SRR15539829;43;45;0.651162790697674;15;28;0.151162790697674;0.348837209302326
Control.SRR15539829;44;45;0.409090909090909;26;18;0.0909090909090909;0.409090909090909
Control.SRR15539829;54;45;0.574074074074074;23;31;0.0740740740740741;0.425925925925926
Control.SRR15539829;53;45;0.339622641509434;35;18;0.160377358490566;0.339622641509434
Control.SRR15539829;49;45;0.510204081632653;24;25;0.0102040816326531;0.489795918367347
Control.SRR15539829;48;45;0.4375;27;21;0.0625;0.4375
Control.SRR15539829;47;45;0.531914893617021;22;25;0.0319148936170213;0.468085106382979
Control.SRR15539829;41;45;0.560975609756098;18;23;0.0609756097560976;0.439024390243902
Control.SRR15539829;43;45;0.697674418604651;13;30;0.197674418604651;0.302325581395349
Control.SRR15539829;41;45;0.536585365853659;19;22;0.0365853658536586;0.463414634146341
Control.SRR15539829;47;45;0.51063829787234;23;24;0.0106382978723404;0.48936170212766
Control.SRR15539829;48;45;0.395833333333333;29;19;0.104166666666667;0.395833333333333
Control.SRR15539829;47;45;0.51063829787234;23;24;0.0106382978723404;0.48936170212766
Control.SRR15539829;44;45;0.545454545454545;20;24;0.0454545454545454;0.454545454545455
Control.SRR15539829;48;45;0.520833333333333;23;25;0.0208333333333334;0.479166666666667
Control.SRR15539829;47;45;0.574468085106383;20;27;0.074468085106383;0.425531914893617
Control.SRR15539829;48;45;0.541666666666667;22;26;0.0416666666666666;0.458333333333333
Control.SRR15539829;51;45;0.431372549019608;29;22;0.0686274509803921;0.431372549019608
Control.SRR15539829;45;45;0.422222222222222;26;19;0.0777777777777778;0.422222222222222
Control.SRR15539829;43;45;0.604651162790698;17;26;0.104651162790698;0.395348837209302
Control.SRR15539829;44;45;0.522727272727273;21;23;0.0227272727272727;0.477272727272727
Control.SRR15539829;51;45;0.509803921568627;25;26;0.00980392156862742;0.490196078431373
Control.SRR15539829;47;45;0.446808510638298;26;21;0.0531914893617021;0.446808510638298
Control.SRR15539829;41;45;0.463414634146341;22;19;0.0365853658536585;0.463414634146341
Control.SRR15539829;44;45;0.386363636363636;27;17;0.113636363636364;0.386363636363636
Control.SRR15539829;46;45;0.543478260869565;21;25;0.0434782608695652;0.456521739130435
Control.SRR15539829;48;45;0.520833333333333;23;25;0.0208333333333334;0.479166666666667
Control.SRR15539829;41;45;0.585365853658537;17;24;0.0853658536585366;0.414634146341463
Control.SRR15539829;52;45;0.538461538461538;24;28;0.0384615384615384;0.461538461538462
Control.SRR15539829;51;45;0.647058823529412;18;33;0.147058823529412;0.352941176470588
Control.SRR15539829;51;45;0.490196078431373;26;25;0.00980392156862747;0.490196078431373
Control.SRR15539829;51;45;0.666666666666667;17;34;0.166666666666667;0.333333333333333
Control.SRR15539829;42;45;0.595238095238095;17;25;0.0952380952380952;0.404761904761905
Control.SRR15539829;46;45;0.565217391304348;20;26;0.0652173913043478;0.434782608695652
Control.SRR15539829;40;45;0.625;15;25;0.125;0.375
Control.SRR15539829;44;45;0.431818181818182;25;19;0.0681818181818182;0.431818181818182
Control.SRR15539829;51;45;0.450980392156863;28;23;0.0490196078431372;0.450980392156863
Control.SRR15539829;44;45;0.454545454545455;24;20;0.0454545454545455;0.454545454545455
Control.SRR15539829;48;45;0.645833333333333;17;31;0.145833333333333;0.354166666666667
Control.SRR15539829;42;45;0.404761904761905;25;17;0.0952380952380952;0.404761904761905
Control.SRR15539829;40;45;0.35;26;14;0.15;0.35
Control.SRR15539829;43;45;0.418604651162791;25;18;0.0813953488372093;0.418604651162791
Control.SRR15539829;44;45;0.477272727272727;23;21;0.0227272727272727;0.477272727272727
Control.SRR15539829;54;45;0.592592592592593;22;32;0.0925925925925926;0.407407407407407
Control.SRR15539829;42;45;0.357142857142857;27;15;0.142857142857143;0.357142857142857
Control.SRR15539829;44;45;0.409090909090909;26;18;0.0909090909090909;0.409090909090909
Control.SRR15539829;42;45;0.547619047619048;19;23;0.0476190476190477;0.452380952380952
Control.SRR15539829;45;45;0.4;27;18;0.1;0.4
Control.SRR15539829;54;45;0.574074074074074;23;31;0.0740740740740741;0.425925925925926
Control.SRR15539829;43;45;0.488372093023256;22;21;0.0116279069767442;0.488372093023256
Control.SRR15539829;43;45;0.558139534883721;19;24;0.0581395348837209;0.441860465116279
Control.SRR15539829;48;45;0.520833333333333;23;25;0.0208333333333334;0.479166666666667
Control.SRR15539829;49;45;0.428571428571429;28;21;0.0714285714285715;0.428571428571429
Control.SRR15539829;53;45;0.433962264150943;30;23;0.0660377358490566;0.433962264150943
Control.SRR15539829;51;45;0.549019607843137;23;28;0.0490196078431373;0.450980392156863
Control.SRR15539829;52;45;0.5;26;26;0;0.5
Control.SRR15539829;51;45;0.470588235294118;27;24;0.0294117647058824;0.470588235294118
Control.SRR15539829;42;45;0.5;21;21;0;0.5
Control.SRR15539829;45;45;0.577777777777778;19;26;0.0777777777777777;0.422222222222222
Control.SRR15539829;46;45;0.478260869565217;24;22;0.0217391304347826;0.478260869565217
Control.SRR15539829;51;45;0.431372549019608;29;22;0.0686274509803921;0.431372549019608
Control.SRR15539829;46;45;0.543478260869565;21;25;0.0434782608695652;0.456521739130435
Control.SRR15539829;54;45;0.407407407407407;32;22;0.0925925925925926;0.407407407407407
Control.SRR15539829;41;45;0.439024390243902;23;18;0.0609756097560976;0.439024390243902
Control.SRR15539829;44;45;0.454545454545455;24;20;0.0454545454545455;0.454545454545455
Control.SRR15539829;42;45;0.380952380952381;26;16;0.119047619047619;0.380952380952381
Control.SRR15539829;49;45;0.408163265306122;29;20;0.0918367346938775;0.408163265306122
Control.SRR15539829;52;45;0.480769230769231;27;25;0.0192307692307692;0.480769230769231
Control.SRR15539829;48;45;0.395833333333333;29;19;0.104166666666667;0.395833333333333
Control.SRR15539829;53;45;0.433962264150943;30;23;0.0660377358490566;0.433962264150943
Control.SRR15539829;41;45;0.536585365853659;19;22;0.0365853658536586;0.463414634146341
Control.SRR15539829;53;45;0.39622641509434;32;21;0.10377358490566;0.39622641509434
Control.SRR15539829;47;45;0.425531914893617;27;20;0.074468085106383;0.425531914893617
Control.SRR15539829;51;45;0.568627450980392;22;29;0.0686274509803921;0.431372549019608
Control.SRR15539829;48;45;0.479166666666667;25;23;0.0208333333333333;0.479166666666667
Control.SRR15539829;45;45;0.511111111111111;22;23;0.0111111111111111;0.488888888888889
Control.SRR15539829;42;45;0.404761904761905;25;17;0.0952380952380952;0.404761904761905
Control.SRR15539829;53;45;0.509433962264151;26;27;0.00943396226415094;0.490566037735849
Control.SRR15539829;42;45;0.428571428571429;24;18;0.0714285714285715;0.428571428571429
Control.SRR15539829;42;45;0.476190476190476;22;20;0.0238095238095238;0.476190476190476
Control.SRR15539829;44;45;0.659090909090909;15;29;0.159090909090909;0.340909090909091
Control.SRR15539829;51;45;0.411764705882353;30;21;0.0882352941176471;0.411764705882353
Control.SRR15539829;54;45;0.518518518518518;26;28;0.0185185185185185;0.481481481481481
Control.SRR15539829;41;45;0.536585365853659;19;22;0.0365853658536586;0.463414634146341
Control.SRR15539829;47;45;0.574468085106383;20;27;0.074468085106383;0.425531914893617
Control.SRR15539829;53;45;0.490566037735849;27;26;0.00943396226415094;0.490566037735849
Control.SRR15539829;52;45;0.519230769230769;25;27;0.0192307692307693;0.480769230769231
Control.SRR15539829;50;45;0.44;28;22;0.06;0.44
Control.SRR15539829;47;45;0.595744680851064;19;28;0.0957446808510638;0.404255319148936
Control.SRR15539829;50;45;0.46;27;23;0.04;0.46
Control.SRR15539829;40;45;0.425;23;17;0.075;0.425
Control.SRR15539829;46;45;0.543478260869565;21;25;0.0434782608695652;0.456521739130435
Control.SRR15539829;50;45;0.46;27;23;0.04;0.46
Control.SRR15539829;50;45;0.56;22;28;0.0600000000000001;0.44
Control.SRR15539829;54;45;0.5;27;27;0;0.5
Control.SRR15539829;42;45;0.428571428571429;24;18;0.0714285714285715;0.428571428571429
Control.SRR15539829;49;45;0.571428571428571;21;28;0.0714285714285714;0.428571428571429
Control.SRR15539829;51;45;0.627450980392157;19;32;0.127450980392157;0.372549019607843
Control.SRR15539829;45;45;0.422222222222222;26;19;0.0777777777777778;0.422222222222222
Control.SRR15539829;46;45;0.434782608695652;26;20;0.0652173913043478;0.434782608695652
Control.SRR15539829;47;45;0.382978723404255;29;18;0.117021276595745;0.382978723404255
Control.SRR15539829;47;45;0.48936170212766;24;23;0.0106382978723404;0.48936170212766
Control.SRR15539829;45;45;0.577777777777778;19;26;0.0777777777777777;0.422222222222222
Control.SRR15539829;51;45;0.529411764705882;24;27;0.0294117647058824;0.470588235294118
Control.SRR15539829;54;45;0.537037037037037;25;29;0.0370370370370371;0.462962962962963
Control.SRR15539829;48;45;0.4375;27;21;0.0625;0.4375
Control.SRR15539829;51;45;0.411764705882353;30;21;0.0882352941176471;0.411764705882353
Control.SRR15539829;43;45;0.651162790697674;15;28;0.151162790697674;0.348837209302326
Control.SRR15539829;51;45;0.392156862745098;31;20;0.107843137254902;0.392156862745098
Control.SRR15539829;52;45;0.480769230769231;27;25;0.0192307692307692;0.480769230769231
Control.SRR15539829;46;45;0.434782608695652;26;20;0.0652173913043478;0.434782608695652
Control.SRR15539829;42;45;0.523809523809524;20;22;0.0238095238095238;0.476190476190476
Control.SRR15539829;47;45;0.574468085106383;20;27;0.074468085106383;0.425531914893617
Control.SRR15539829;51;45;0.529411764705882;24;27;0.0294117647058824;0.470588235294118
Control.SRR15539829;53;45;0.584905660377358;22;31;0.0849056603773585;0.415094339622642
Control.SRR15539829;51;45;0.509803921568627;25;26;0.00980392156862742;0.490196078431373
Control.SRR15539829;46;45;0.456521739130435;25;21;0.0434782608695652;0.456521739130435
Control.SRR15539829;41;45;0.560975609756098;18;23;0.0609756097560976;0.439024390243902
Control.SRR15539829;47;45;0.382978723404255;29;18;0.117021276595745;0.382978723404255
Control.SRR15539829;49;45;0.530612244897959;23;26;0.0306122448979592;0.469387755102041
Control.SRR15539829;47;45;0.446808510638298;26;21;0.0531914893617021;0.446808510638298
Control.SRR15539829;42;45;0.5;21;21;0;0.5
Control.SRR15539829;48;45;0.333333333333333;32;16;0.166666666666667;0.333333333333333
Control.SRR15539829;44;45;0.477272727272727;23;21;0.0227272727272727;0.477272727272727
Control.SRR15539829;43;45;0.534883720930233;20;23;0.0348837209302325;0.465116279069767
Control.SRR15539829;47;45;0.574468085106383;20;27;0.074468085106383;0.425531914893617
Control.SRR15539829;44;45;0.454545454545455;24;20;0.0454545454545455;0.454545454545455
Control.SRR15539829;49;45;0.469387755102041;26;23;0.0306122448979592;0.469387755102041
Control.SRR15539829;44;45;0.568181818181818;19;25;0.0681818181818182;0.431818181818182
Control.SRR15539829;45;45;0.488888888888889;23;22;0.0111111111111111;0.488888888888889
Control.SRR15539829;46;45;0.652173913043478;16;30;0.152173913043478;0.347826086956522
Control.SRR15539829;43;45;0.674418604651163;14;29;0.174418604651163;0.325581395348837
Control.SRR15539829;47;45;0.382978723404255;29;18;0.117021276595745;0.382978723404255
Control.SRR15539829;48;45;0.520833333333333;23;25;0.0208333333333334;0.479166666666667
Control.SRR15539829;45;45;0.422222222222222;26;19;0.0777777777777778;0.422222222222222
Control.SRR15539829;48;45;0.354166666666667;31;17;0.145833333333333;0.354166666666667
Control.SRR15539829;43;45;0.511627906976744;21;22;0.0116279069767442;0.488372093023256
Control.SRR15539829;48;45;0.645833333333333;17;31;0.145833333333333;0.354166666666667
Control.SRR15539829;54;45;0.518518518518518;26;28;0.0185185185185185;0.481481481481481
Control.SRR15539829;48;45;0.541666666666667;22;26;0.0416666666666666;0.458333333333333
Control.SRR15539829;43;45;0.488372093023256;22;21;0.0116279069767442;0.488372093023256
Control.SRR15539829;53;45;0.433962264150943;30;23;0.0660377358490566;0.433962264150943
Control.SRR15539829;53;45;0.584905660377358;22;31;0.0849056603773585;0.415094339622642
Control.SRR15539829;50;45;0.64;18;32;0.14;0.36
Control.SRR15539829;51;45;0.647058823529412;18;33;0.147058823529412;0.352941176470588
Control.SRR15539829;48;45;0.583333333333333;20;28;0.0833333333333334;0.416666666666667
Control.SRR15539829;50;45;0.4;30;20;0.1;0.4
Control.SRR15539829;41;45;0.439024390243902;23;18;0.0609756097560976;0.439024390243902
Control.SRR15539829;48;45;0.395833333333333;29;19;0.104166666666667;0.395833333333333
Control.SRR15539829;45;45;0.533333333333333;21;24;0.0333333333333333;0.466666666666667
Control.SRR15539829;52;45;0.442307692307692;29;23;0.0576923076923077;0.442307692307692
Control.SRR15539829;50;45;0.36;32;18;0.14;0.36
Control.SRR15539829;48;45;0.458333333333333;26;22;0.0416666666666667;0.458333333333333
Control.SRR15539829;52;45;0.673076923076923;17;35;0.173076923076923;0.326923076923077
Control.SRR15539829;44;45;0.590909090909091;18;26;0.0909090909090909;0.409090909090909
Control.SRR15539829;48;45;0.5;24;24;0;0.5
Control.SRR15539829;50;45;0.42;29;21;0.08;0.42
Control.SRR15539829;46;45;0.5;23;23;0;0.5
Control.SRR15539829;46;45;0.456521739130435;25;21;0.0434782608695652;0.456521739130435
Control.SRR15539829;42;45;0.380952380952381;26;16;0.119047619047619;0.380952380952381
Control.SRR15539829;40;45;0.525;19;21;0.025;0.475
Control.SRR15539829;45;45;0.466666666666667;24;21;0.0333333333333333;0.466666666666667
Control.SRR15539829;42;45;0.476190476190476;22;20;0.0238095238095238;0.476190476190476
Control.SRR15539829;52;45;0.461538461538462;28;24;0.0384615384615384;0.461538461538462
Control.SRR15539829;44;45;0.5;22;22;0;0.5
Control.SRR15539829;43;45;0.651162790697674;15;28;0.151162790697674;0.348837209302326
Control.SRR15539829;51;45;0.588235294117647;21;30;0.0882352941176471;0.411764705882353
Control.SRR15539829;52;45;0.557692307692308;23;29;0.0576923076923077;0.442307692307692
Control.SRR15539829;53;45;0.471698113207547;28;25;0.0283018867924528;0.471698113207547
Control.SRR15539829;48;45;0.604166666666667;19;29;0.104166666666667;0.395833333333333
Control.SRR15539829;50;45;0.52;24;26;0.02;0.48
Control.SRR15539829;53;45;0.415094339622642;31;22;0.0849056603773585;0.415094339622642
Control.SRR15539829;41;45;0.609756097560976;16;25;0.109756097560976;0.390243902439024
Control.SRR15539829;48;45;0.520833333333333;23;25;0.0208333333333334;0.479166666666667
Control.SRR15539829;49;45;0.489795918367347;25;24;0.0102040816326531;0.489795918367347
Control.SRR15539829;48;45;0.520833333333333;23;25;0.0208333333333334;0.479166666666667
Control.SRR15539829;42;45;0.476190476190476;22;20;0.0238095238095238;0.476190476190476
Control.SRR15539829;45;45;0.555555555555556;20;25;0.0555555555555556;0.444444444444444
Control.SRR15539829;49;45;0.428571428571429;28;21;0.0714285714285715;0.428571428571429
Control.SRR15539829;49;45;0.510204081632653;24;25;0.0102040816326531;0.489795918367347
Control.SRR15539829;50;45;0.44;28;22;0.06;0.44
Control.SRR15539829;42;45;0.523809523809524;20;22;0.0238095238095238;0.476190476190476
Control.SRR15539829;50;45;0.38;31;19;0.12;0.38
Control.SRR15539829;54;45;0.555555555555556;24;30;0.0555555555555556;0.444444444444444
Control.SRR15539829;52;45;0.403846153846154;31;21;0.0961538461538461;0.403846153846154
Control.SRR15539829;53;45;0.471698113207547;28;25;0.0283018867924528;0.471698113207547
Control.SRR15539829;47;45;0.425531914893617;27;20;0.074468085106383;0.425531914893617
Control.SRR15539829;50;45;0.52;24;26;0.02;0.48
Control.SRR15539829;50;45;0.44;28;22;0.06;0.44
Control.SRR15539829;49;45;0.489795918367347;25;24;0.0102040816326531;0.489795918367347
Control.SRR15539829;53;45;0.566037735849057;23;30;0.0660377358490566;0.433962264150943
Control.SRR15539829;51;45;0.470588235294118;27;24;0.0294117647058824;0.470588235294118
Control.SRR15539829;40;45;0.4;24;16;0.1;0.4
Control.SRR15539829;54;45;0.37037037037037;34;20;0.12962962962963;0.37037037037037
Control.SRR15539829;52;45;0.403846153846154;31;21;0.0961538461538461;0.403846153846154
Control.SRR15539829;42;45;0.547619047619048;19;23;0.0476190476190477;0.452380952380952
Control.SRR15539829;51;45;0.490196078431373;26;25;0.00980392156862747;0.490196078431373
Control.SRR15539829;53;45;0.433962264150943;30;23;0.0660377358490566;0.433962264150943
Control.SRR15539829;51;45;0.490196078431373;26;25;0.00980392156862747;0.490196078431373
Control.SRR15539829;53;45;0.377358490566038;33;20;0.122641509433962;0.377358490566038
Control.SRR15539829;51;45;0.509803921568627;25;26;0.00980392156862742;0.490196078431373
Control.SRR15539829;42;45;0.547619047619048;19;23;0.0476190476190477;0.452380952380952
Control.SRR15539829;47;45;0.638297872340426;17;30;0.138297872340426;0.361702127659574
Control.SRR15539829;50;45;0.44;28;22;0.06;0.44
Control.SRR15539829;44;45;0.522727272727273;21;23;0.0227272727272727;0.477272727272727
Control.SRR15539829;42;45;0.571428571428571;18;24;0.0714285714285714;0.428571428571429
Control.SRR15539829;49;45;0.36734693877551;31;18;0.13265306122449;0.36734693877551
Control.SRR15539829;48;45;0.541666666666667;22;26;0.0416666666666666;0.458333333333333
Control.SRR15539829;46;45;0.391304347826087;28;18;0.108695652173913;0.391304347826087
Control.SRR15539829;41;45;0.634146341463415;15;26;0.134146341463415;0.365853658536585
Control.SRR15539829;40;45;0.625;15;25;0.125;0.375
Control.SRR15539829;41;45;0.48780487804878;21;20;0.0121951219512195;0.48780487804878
Control.SRR15539829;48;45;0.520833333333333;23;25;0.0208333333333334;0.479166666666667
Control.SRR15539829;45;45;0.4;27;18;0.1;0.4
Control.SRR15539829;50;45;0.38;31;19;0.12;0.38
Control.SRR15539829;40;45;0.3;28;12;0.2;0.3
Control.SRR15539829;54;45;0.62962962962963;20;34;0.12962962962963;0.37037037037037
Control.SRR15539829;43;45;0.465116279069767;23;20;0.0348837209302326;0.465116279069767
Control.SRR15539829;53;45;0.528301886792453;25;28;0.0283018867924528;0.471698113207547
Control.SRR15539829;48;45;0.541666666666667;22;26;0.0416666666666666;0.458333333333333
Control.SRR15539829;43;45;0.441860465116279;24;19;0.0581395348837209;0.441860465116279
Control.SRR15539829;41;45;0.51219512195122;20;21;0.0121951219512195;0.48780487804878
Control.SRR15539829;49;45;0.469387755102041;26;23;0.0306122448979592;0.469387755102041
Control.SRR15539829;49;45;0.530612244897959;23;26;0.0306122448979592;0.469387755102041
Control.SRR15539829;53;45;0.452830188679245;29;24;0.0471698113207547;0.452830188679245
Control.SRR15539829;49;45;0.469387755102041;26;23;0.0306122448979592;0.469387755102041
Control.SRR15539829;43;45;0.395348837209302;26;17;0.104651162790698;0.395348837209302
Control.SRR15539829;45;45;0.377777777777778;28;17;0.122222222222222;0.377777777777778
Control.SRR15539829;51;45;0.411764705882353;30;21;0.0882352941176471;0.411764705882353
Control.SRR15539829;50;45;0.52;24;26;0.02;0.48
Control.SRR15539829;47;45;0.468085106382979;25;22;0.0319148936170213;0.468085106382979
Control.SRR15539829;43;45;0.488372093023256;22;21;0.0116279069767442;0.488372093023256
Control.SRR15539829;53;45;0.566037735849057;23;30;0.0660377358490566;0.433962264150943
Control.SRR15539829;41;45;0.536585365853659;19;22;0.0365853658536586;0.463414634146341
Control.SRR15539829;52;45;0.576923076923077;22;30;0.0769230769230769;0.423076923076923
Control.SRR15539829;45;45;0.422222222222222;26;19;0.0777777777777778;0.422222222222222
Control.SRR15539829;44;45;0.522727272727273;21;23;0.0227272727272727;0.477272727272727
Control.SRR15539829;45;45;0.488888888888889;23;22;0.0111111111111111;0.488888888888889
Control.SRR15539829;43;45;0.418604651162791;25;18;0.0813953488372093;0.418604651162791
Control.SRR15539829;50;45;0.68;16;34;0.18;0.32
Control.SRR15539829;52;45;0.634615384615385;19;33;0.134615384615385;0.365384615384615
Control.SRR15539829;46;45;0.521739130434783;22;24;0.0217391304347826;0.478260869565217
Control.SRR15539829;46;45;0.5;23;23;0;0.5
Control.SRR15539829;54;45;0.648148148148148;19;35;0.148148148148148;0.351851851851852
Control.SRR15539829;40;45;0.425;23;17;0.075;0.425
Control.SRR15539829;44;45;0.522727272727273;21;23;0.0227272727272727;0.477272727272727
Control.SRR15539829;44;45;0.5;22;22;0;0.5
Control.SRR15539829;45;45;0.444444444444444;25;20;0.0555555555555556;0.444444444444444
Control.SRR15539829;46;45;0.58695652173913;19;27;0.0869565217391305;0.41304347826087
Control.SRR15539829;44;45;0.454545454545455;24;20;0.0454545454545455;0.454545454545455
Control.SRR15539829;43;45;0.511627906976744;21;22;0.0116279069767442;0.488372093023256
Control.SRR15539829;44;45;0.522727272727273;21;23;0.0227272727272727;0.477272727272727
Control.SRR15539829;48;45;0.625;18;30;0.125;0.375
Control.SRR15539829;48;45;0.5;24;24;0;0.5
Control.SRR15539829;45;45;0.488888888888889;23;22;0.0111111111111111;0.488888888888889
Control.SRR15539829;49;45;0.387755102040816;30;19;0.112244897959184;0.387755102040816
Control.SRR15539829;43;45;0.465116279069767;23;20;0.0348837209302326;0.465116279069767
Control.SRR15539829;47;45;0.446808510638298;26;21;0.0531914893617021;0.446808510638298
Control.SRR15539829;48;45;0.5;24;24;0;0.5
Control.SRR15539829;43;45;0.511627906976744;21;22;0.0116279069767442;0.488372093023256
Control.SRR15539829;49;45;0.530612244897959;23;26;0.0306122448979592;0.469387755102041
Control.SRR15539829;46;45;0.543478260869565;21;25;0.0434782608695652;0.456521739130435
Control.SRR15539829;41;45;0.560975609756098;18;23;0.0609756097560976;0.439024390243902
Control.SRR15539829;45;45;0.444444444444444;25;20;0.0555555555555556;0.444444444444444
Control.SRR15539829;50;45;0.62;19;31;0.12;0.38
Control.SRR15539829;51;45;0.392156862745098;31;20;0.107843137254902;0.392156862745098
Control.SRR15539829;49;45;0.408163265306122;29;20;0.0918367346938775;0.408163265306122
Control.SRR15539829;54;45;0.574074074074074;23;31;0.0740740740740741;0.425925925925926
Control.SRR15539829;43;45;0.488372093023256;22;21;0.0116279069767442;0.488372093023256
Control.SRR15539829;51;45;0.607843137254902;20;31;0.107843137254902;0.392156862745098
Control.SRR15539829;41;45;0.439024390243902;23;18;0.0609756097560976;0.439024390243902
Control.SRR15539829;54;45;0.5;27;27;0;0.5
Control.SRR15539829;54;45;0.555555555555556;24;30;0.0555555555555556;0.444444444444444
Control.SRR15539829;41;45;0.463414634146341;22;19;0.0365853658536585;0.463414634146341
Control.SRR15539829;43;45;0.325581395348837;29;14;0.174418604651163;0.325581395348837
Control.SRR15539829;50;45;0.56;22;28;0.0600000000000001;0.44
Control.SRR15539829;51;45;0.372549019607843;32;19;0.127450980392157;0.372549019607843
Control.SRR15539829;51;45;0.411764705882353;30;21;0.0882352941176471;0.411764705882353
Control.SRR15539829;50;45;0.52;24;26;0.02;0.48
Control.SRR15539829;49;45;0.551020408163265;22;27;0.0510204081632653;0.448979591836735
Control.SRR15539829;51;45;0.450980392156863;28;23;0.0490196078431372;0.450980392156863
Control.SRR15539829;48;45;0.541666666666667;22;26;0.0416666666666666;0.458333333333333
Control.SRR15539829;46;45;0.478260869565217;24;22;0.0217391304347826;0.478260869565217
Control.SRR15539829;46;45;0.434782608695652;26;20;0.0652173913043478;0.434782608695652
Control.SRR15539829;48;45;0.541666666666667;22;26;0.0416666666666666;0.458333333333333
Control.SRR15539829;45;45;0.4;27;18;0.1;0.4
Control.SRR15539829;43;45;0.534883720930233;20;23;0.0348837209302325;0.465116279069767
Control.SRR15539829;47;45;0.446808510638298;26;21;0.0531914893617021;0.446808510638298
Control.SRR15539829;52;45;0.538461538461538;24;28;0.0384615384615384;0.461538461538462
Control.SRR15539829;52;45;0.384615384615385;32;20;0.115384615384615;0.384615384615385
Control.SRR15539829;46;45;0.5;23;23;0;0.5
Control.SRR15539829;49;45;0.612244897959184;19;30;0.112244897959184;0.387755102040816
Control.SRR15539829;54;45;0.462962962962963;29;25;0.037037037037037;0.462962962962963
Control.SRR15539829;48;45;0.604166666666667;19;29;0.104166666666667;0.395833333333333
Control.SRR15539829;52;45;0.5;26;26;0;0.5
Control.SRR15539829;41;45;0.48780487804878;21;20;0.0121951219512195;0.48780487804878
Control.SRR15539829;42;45;0.523809523809524;20;22;0.0238095238095238;0.476190476190476
Control.SRR15539829;53;45;0.509433962264151;26;27;0.00943396226415094;0.490566037735849
Control.SRR15539829;46;45;0.478260869565217;24;22;0.0217391304347826;0.478260869565217
Control.SRR15539829;41;45;0.536585365853659;19;22;0.0365853658536586;0.463414634146341
Control.SRR15539829;43;45;0.488372093023256;22;21;0.0116279069767442;0.488372093023256
Control.SRR15539829;41;45;0.414634146341463;24;17;0.0853658536585366;0.414634146341463
Control.SRR15539829;50;45;0.6;20;30;0.1;0.4
Control.SRR15539829;44;45;0.454545454545455;24;20;0.0454545454545455;0.454545454545455
Control.SRR15539829;49;45;0.428571428571429;28;21;0.0714285714285715;0.428571428571429
Control.SRR15539829;54;45;0.462962962962963;29;25;0.037037037037037;0.462962962962963
Control.SRR15539829;43;45;0.511627906976744;21;22;0.0116279069767442;0.488372093023256
Control.SRR15539829;50;45;0.52;24;26;0.02;0.48
Control.SRR15539829;42;45;0.428571428571429;24;18;0.0714285714285715;0.428571428571429
Control.SRR15539829;54;45;0.5;27;27;0;0.5
Control.SRR15539829;47;45;0.468085106382979;25;22;0.0319148936170213;0.468085106382979
Control.SRR15539829;51;45;0.607843137254902;20;31;0.107843137254902;0.392156862745098
Control.SRR15539829;49;45;0.408163265306122;29;20;0.0918367346938775;0.408163265306122
Control.SRR15539829;47;45;0.468085106382979;25;22;0.0319148936170213;0.468085106382979
Control.SRR15539829;46;45;0.434782608695652;26;20;0.0652173913043478;0.434782608695652
Control.SRR15539829;45;45;0.533333333333333;21;24;0.0333333333333333;0.466666666666667
Control.SRR15539829;46;45;0.478260869565217;24;22;0.0217391304347826;0.478260869565217
Control.SRR15539829;47;45;0.468085106382979;25;22;0.0319148936170213;0.468085106382979
Control.SRR15539829;49;45;0.469387755102041;26;23;0.0306122448979592;0.469387755102041
Control.SRR15539829;50;45;0.56;22;28;0.0600000000000001;0.44
Control.SRR15539829;49;45;0.510204081632653;24;25;0.0102040816326531;0.489795918367347
Control.SRR15539829;41;45;0.536585365853659;19;22;0.0365853658536586;0.463414634146341
Control.SRR15539829;42;45;0.642857142857143;15;27;0.142857142857143;0.357142857142857
Control.SRR15539829;49;45;0.408163265306122;29;20;0.0918367346938775;0.408163265306122
Control.SRR15539829;49;45;0.530612244897959;23;26;0.0306122448979592;0.469387755102041
Control.SRR15539829;50;45;0.58;21;29;0.08;0.42
Control.SRR15539829;42;45;0.571428571428571;18;24;0.0714285714285714;0.428571428571429
Control.SRR15539829;47;45;0.595744680851064;19;28;0.0957446808510638;0.404255319148936
Control.SRR15539829;47;45;0.446808510638298;26;21;0.0531914893617021;0.446808510638298
Control.SRR15539829;43;45;0.441860465116279;24;19;0.0581395348837209;0.441860465116279
Control.SRR15539829;48;45;0.520833333333333;23;25;0.0208333333333334;0.479166666666667
Control.SRR15539829;45;45;0.466666666666667;24;21;0.0333333333333333;0.466666666666667
Control.SRR15539829;43;45;0.604651162790698;17;26;0.104651162790698;0.395348837209302
Control.SRR15539829;52;45;0.480769230769231;27;25;0.0192307692307692;0.480769230769231
Control.SRR15539829;51;45;0.431372549019608;29;22;0.0686274509803921;0.431372549019608
Control.SRR15539829;48;45;0.458333333333333;26;22;0.0416666666666667;0.458333333333333
Control.SRR15539829;48;45;0.604166666666667;19;29;0.104166666666667;0.395833333333333
Control.SRR15539829;45;45;0.466666666666667;24;21;0.0333333333333333;0.466666666666667
Control.SRR15539829;40;45;0.375;25;15;0.125;0.375
Control.SRR15539829;46;45;0.521739130434783;22;24;0.0217391304347826;0.478260869565217
Control.SRR15539829;46;45;0.41304347826087;27;19;0.0869565217391304;0.41304347826087
Control.SRR15539829;46;45;0.478260869565217;24;22;0.0217391304347826;0.478260869565217
Control.SRR15539829;51;45;0.470588235294118;27;24;0.0294117647058824;0.470588235294118
Control.SRR15539829;41;45;0.463414634146341;22;19;0.0365853658536585;0.463414634146341
Control.SRR15539829;50;45;0.48;26;24;0.02;0.48
Control.SRR15539829;52;45;0.519230769230769;25;27;0.0192307692307693;0.480769230769231
Control.SRR15539829;41;45;0.414634146341463;24;17;0.0853658536585366;0.414634146341463
Control.SRR15539829;43;45;0.488372093023256;22;21;0.0116279069767442;0.488372093023256
Control.SRR15539829;41;45;0.536585365853659;19;22;0.0365853658536586;0.463414634146341
Control.SRR15539829;43;45;0.488372093023256;22;21;0.0116279069767442;0.488372093023256
Control.SRR15539829;42;45;0.404761904761905;25;17;0.0952380952380952;0.404761904761905
Control.SRR15539829;40;45;0.525;19;21;0.025;0.475
Control.SRR15539829;50;45;0.56;22;28;0.0600000000000001;0.44
Control.SRR15539829;40;45;0.55;18;22;0.05;0.45
Control.SRR15539829;43;45;0.511627906976744;21;22;0.0116279069767442;0.488372093023256
Control.SRR15539829;43;45;0.488372093023256;22;21;0.0116279069767442;0.488372093023256
Control.SRR15539829;47;45;0.531914893617021;22;25;0.0319148936170213;0.468085106382979
Control.SRR15539829;44;45;0.522727272727273;21;23;0.0227272727272727;0.477272727272727
Control.SRR15539829;42;45;0.547619047619048;19;23;0.0476190476190477;0.452380952380952
Control.SRR15539829;46;45;0.521739130434783;22;24;0.0217391304347826;0.478260869565217
Control.SRR15539829;52;45;0.423076923076923;30;22;0.0769230769230769;0.423076923076923
Control.SRR15539829;49;45;0.530612244897959;23;26;0.0306122448979592;0.469387755102041
Control.SRR15539829;40;45;0.45;22;18;0.05;0.45
Control.SRR15539829;51;45;0.509803921568627;25;26;0.00980392156862742;0.490196078431373
Control.SRR15539829;44;45;0.477272727272727;23;21;0.0227272727272727;0.477272727272727
Control.SRR15539829;45;45;0.533333333333333;21;24;0.0333333333333333;0.466666666666667
Control.SRR15539829;40;45;0.475;21;19;0.025;0.475
Control.SRR15539829;47;45;0.446808510638298;26;21;0.0531914893617021;0.446808510638298
Control.SRR15539829;48;45;0.5625;21;27;0.0625;0.4375
Control.SRR15539829;42;45;0.428571428571429;24;18;0.0714285714285715;0.428571428571429
Control.SRR15539829;52;45;0.557692307692308;23;29;0.0576923076923077;0.442307692307692
Control.SRR15539829;50;45;0.46;27;23;0.04;0.46
Control.SRR15539829;44;45;0.568181818181818;19;25;0.0681818181818182;0.431818181818182
Control.SRR15539829;46;45;0.478260869565217;24;22;0.0217391304347826;0.478260869565217
Control.SRR15539829;41;45;0.536585365853659;19;22;0.0365853658536586;0.463414634146341
Control.SRR15539829;46;45;0.391304347826087;28;18;0.108695652173913;0.391304347826087
Control.SRR15539829;43;45;0.534883720930233;20;23;0.0348837209302325;0.465116279069767
Control.SRR15539829;47;45;0.48936170212766;24;23;0.0106382978723404;0.48936170212766
Control.SRR15539829;42;45;0.595238095238095;17;25;0.0952380952380952;0.404761904761905
Control.SRR15539829;51;45;0.627450980392157;19;32;0.127450980392157;0.372549019607843
Control.SRR15539829;47;45;0.531914893617021;22;25;0.0319148936170213;0.468085106382979
Control.SRR15539829;43;45;0.418604651162791;25;18;0.0813953488372093;0.418604651162791
Control.SRR15539829;46;45;0.543478260869565;21;25;0.0434782608695652;0.456521739130435
Control.SRR15539829;51;45;0.509803921568627;25;26;0.00980392156862742;0.490196078431373
Control.SRR15539829;44;45;0.477272727272727;23;21;0.0227272727272727;0.477272727272727
Control.SRR15539829;50;45;0.46;27;23;0.04;0.46
Control.SRR15539829;47;45;0.553191489361702;21;26;0.0531914893617021;0.446808510638298
Control.SRR15539829;40;45;0.5;20;20;0;0.5
Control.SRR15539829;41;45;0.48780487804878;21;20;0.0121951219512195;0.48780487804878
Control.SRR15539829;49;45;0.489795918367347;25;24;0.0102040816326531;0.489795918367347
Control.SRR15539829;43;45;0.558139534883721;19;24;0.0581395348837209;0.441860465116279
Control.SRR15539829;42;45;0.404761904761905;25;17;0.0952380952380952;0.404761904761905
Control.SRR15539829;42;45;0.476190476190476;22;20;0.0238095238095238;0.476190476190476
Control.SRR15539829;51;45;0.470588235294118;27;24;0.0294117647058824;0.470588235294118
Control.SRR15539829;52;45;0.403846153846154;31;21;0.0961538461538461;0.403846153846154
Control.SRR15539829;44;45;0.522727272727273;21;23;0.0227272727272727;0.477272727272727
Control.SRR15539829;45;45;0.533333333333333;21;24;0.0333333333333333;0.466666666666667
Control.SRR15539829;49;45;0.530612244897959;23;26;0.0306122448979592;0.469387755102041
Control.SRR15539829;51;45;0.588235294117647;21;30;0.0882352941176471;0.411764705882353
Control.SRR15539829;46;45;0.5;23;23;0;0.5
Control.SRR15539829;45;45;0.422222222222222;26;19;0.0777777777777778;0.422222222222222
Control.SRR15539829;47;45;0.468085106382979;25;22;0.0319148936170213;0.468085106382979
Control.SRR15539829;48;45;0.458333333333333;26;22;0.0416666666666667;0.458333333333333
Control.SRR15539829;50;45;0.5;25;25;0;0.5
Control.SRR15539829;46;45;0.543478260869565;21;25;0.0434782608695652;0.456521739130435
Control.SRR15539829;42;45;0.571428571428571;18;24;0.0714285714285714;0.428571428571429
Control.SRR15539829;45;45;0.377777777777778;28;17;0.122222222222222;0.377777777777778
Control.SRR15539829;50;45;0.48;26;24;0.02;0.48
Control.SRR15539829;49;45;0.653061224489796;17;32;0.153061224489796;0.346938775510204
Control.SRR15539829;51;45;0.490196078431373;26;25;0.00980392156862747;0.490196078431373
Control.SRR15539829;41;45;0.585365853658537;17;24;0.0853658536585366;0.414634146341463
Control.SRR15539829;45;45;0.488888888888889;23;22;0.0111111111111111;0.488888888888889
Control.SRR15539829;40;45;0.45;22;18;0.05;0.45
Control.SRR15539829;47;45;0.340425531914894;31;16;0.159574468085106;0.340425531914894
Control.SRR15539829;51;45;0.549019607843137;23;28;0.0490196078431373;0.450980392156863
Control.SRR15539829;44;45;0.590909090909091;18;26;0.0909090909090909;0.409090909090909
Control.SRR15539829;52;45;0.5;26;26;0;0.5
Control.SRR15539829;44;45;0.5;22;22;0;0.5
Control.SRR15539829;46;45;0.456521739130435;25;21;0.0434782608695652;0.456521739130435
Control.SRR15539829;45;45;0.511111111111111;22;23;0.0111111111111111;0.488888888888889
Control.SRR15539829;42;45;0.476190476190476;22;20;0.0238095238095238;0.476190476190476
Control.SRR15539829;43;45;0.581395348837209;18;25;0.0813953488372093;0.418604651162791
Control.SRR15539829;48;45;0.520833333333333;23;25;0.0208333333333334;0.479166666666667
Control.SRR15539829;41;45;0.48780487804878;21;20;0.0121951219512195;0.48780487804878
Control.SRR15539829;43;45;0.372093023255814;27;16;0.127906976744186;0.372093023255814
Control.SRR15539829;52;45;0.557692307692308;23;29;0.0576923076923077;0.442307692307692
Control.SRR15539829;46;45;0.521739130434783;22;24;0.0217391304347826;0.478260869565217
Control.SRR15539829;44;45;0.454545454545455;24;20;0.0454545454545455;0.454545454545455
Control.SRR15539829;42;45;0.476190476190476;22;20;0.0238095238095238;0.476190476190476
Control.SRR15539829;41;45;0.48780487804878;21;20;0.0121951219512195;0.48780487804878
Control.SRR15539829;46;45;0.630434782608696;17;29;0.130434782608696;0.369565217391304
Control.SRR15539829;43;45;0.395348837209302;26;17;0.104651162790698;0.395348837209302
Control.SRR15539829;48;45;0.520833333333333;23;25;0.0208333333333334;0.479166666666667
Control.SRR15539829;41;45;0.51219512195122;20;21;0.0121951219512195;0.48780487804878
Control.SRR15539829;40;45;0.375;25;15;0.125;0.375
Control.SRR15539829;44;45;0.477272727272727;23;21;0.0227272727272727;0.477272727272727
Control.SRR15539829;42;45;0.428571428571429;24;18;0.0714285714285715;0.428571428571429
Control.SRR15539829;41;45;0.51219512195122;20;21;0.0121951219512195;0.48780487804878
Control.SRR15539829;44;45;0.477272727272727;23;21;0.0227272727272727;0.477272727272727
Control.SRR15539829;45;45;0.466666666666667;24;21;0.0333333333333333;0.466666666666667
Control.SRR15539829;42;45;0.547619047619048;19;23;0.0476190476190477;0.452380952380952
Control.SRR15539829;41;45;0.585365853658537;17;24;0.0853658536585366;0.414634146341463
Control.SRR15539829;51;45;0.509803921568627;25;26;0.00980392156862742;0.490196078431373
Control.SRR15539829;49;45;0.551020408163265;22;27;0.0510204081632653;0.448979591836735
Control.SRR15539829;46;45;0.58695652173913;19;27;0.0869565217391305;0.41304347826087
Control.SRR15539829;50;45;0.48;26;24;0.02;0.48
Control.SRR15539829;49;45;0.428571428571429;28;21;0.0714285714285715;0.428571428571429
Control.SRR15539829;40;45;0.525;19;21;0.025;0.475
Control.SRR15539829;41;45;0.463414634146341;22;19;0.0365853658536585;0.463414634146341
Control.SRR15539829;46;45;0.369565217391304;29;17;0.130434782608696;0.369565217391304
Control.SRR15539829;42;45;0.452380952380952;23;19;0.0476190476190476;0.452380952380952
Control.SRR15539829;41;45;0.585365853658537;17;24;0.0853658536585366;0.414634146341463
Control.SRR15539829;46;45;0.478260869565217;24;22;0.0217391304347826;0.478260869565217
Control.SRR15539829;49;45;0.469387755102041;26;23;0.0306122448979592;0.469387755102041
Control.SRR15539829;51;45;0.450980392156863;28;23;0.0490196078431372;0.450980392156863
Control.SRR15539829;40;45;0.45;22;18;0.05;0.45
Control.SRR15539829;44;45;0.568181818181818;19;25;0.0681818181818182;0.431818181818182
Control.SRR15539829;50;45;0.58;21;29;0.08;0.42
Control.SRR15539829;48;45;0.458333333333333;26;22;0.0416666666666667;0.458333333333333
Control.SRR15539829;43;45;0.534883720930233;20;23;0.0348837209302325;0.465116279069767
Control.SRR15539829;44;45;0.431818181818182;25;19;0.0681818181818182;0.431818181818182
Control.SRR15539829;42;45;0.5;21;21;0;0.5
Control.SRR15539829;42;45;0.523809523809524;20;22;0.0238095238095238;0.476190476190476
Control.SRR15539829;45;45;0.577777777777778;19;26;0.0777777777777777;0.422222222222222
Control.SRR15539829;41;45;0.536585365853659;19;22;0.0365853658536586;0.463414634146341
Control.SRR15539829;40;45;0.35;26;14;0.15;0.35
Control.SRR15539829;50;45;0.5;25;25;0;0.5
Control.SRR15539829;40;45;0.375;25;15;0.125;0.375
Control.SRR15539829;41;45;0.536585365853659;19;22;0.0365853658536586;0.463414634146341
Control.SRR15539829;40;45;0.55;18;22;0.05;0.45
Control.SRR15539829;40;45;0.45;22;18;0.05;0.45
Control.SRR15539829;44;45;0.454545454545455;24;20;0.0454545454545455;0.454545454545455
Control.SRR15539829;52;45;0.576923076923077;22;30;0.0769230769230769;0.423076923076923
Control.SRR15539829;51;45;0.509803921568627;25;26;0.00980392156862742;0.490196078431373
Control.SRR15539829;44;45;0.590909090909091;18;26;0.0909090909090909;0.409090909090909
Control.SRR15539829;44;45;0.636363636363636;16;28;0.136363636363636;0.363636363636364
Control.SRR15539829;43;45;0.534883720930233;20;23;0.0348837209302325;0.465116279069767
Control.SRR15539829;40;45;0.4;24;16;0.1;0.4
Control.SRR15539829;47;45;0.51063829787234;23;24;0.0106382978723404;0.48936170212766
Control.SRR15539829;43;45;0.511627906976744;21;22;0.0116279069767442;0.488372093023256
Control.SRR15539829;44;45;0.545454545454545;20;24;0.0454545454545454;0.454545454545455
Control.SRR15539829;41;45;0.390243902439024;25;16;0.109756097560976;0.390243902439024
Control.SRR15539829;49;45;0.387755102040816;30;19;0.112244897959184;0.387755102040816
Control.SRR15539829;43;45;0.558139534883721;19;24;0.0581395348837209;0.441860465116279
Control.SRR15539829;44;45;0.5;22;22;0;0.5
Control.SRR15539829;42;45;0.428571428571429;24;18;0.0714285714285715;0.428571428571429
Control.SRR15539829;42;45;0.452380952380952;23;19;0.0476190476190476;0.452380952380952
Control.SRR15539829;51;45;0.529411764705882;24;27;0.0294117647058824;0.470588235294118
Control.SRR15539829;48;45;0.354166666666667;31;17;0.145833333333333;0.354166666666667
Control.SRR15539829;40;45;0.6;16;24;0.1;0.4
Control.SRR15539829;43;45;0.558139534883721;19;24;0.0581395348837209;0.441860465116279
Control.SRR15539829;52;45;0.442307692307692;29;23;0.0576923076923077;0.442307692307692
Control.SRR15539829;42;45;0.619047619047619;16;26;0.119047619047619;0.380952380952381
Control.SRR15539829;44;45;0.522727272727273;21;23;0.0227272727272727;0.477272727272727
Control.SRR15539829;44;45;0.5;22;22;0;0.5
Control.SRR15539829;43;45;0.604651162790698;17;26;0.104651162790698;0.395348837209302
Control.SRR15539829;52;45;0.5;26;26;0;0.5
Control.SRR15539829;49;45;0.571428571428571;21;28;0.0714285714285714;0.428571428571429
Control.SRR15539829;47;45;0.531914893617021;22;25;0.0319148936170213;0.468085106382979
Control.SRR15539829;42;45;0.523809523809524;20;22;0.0238095238095238;0.476190476190476
Control.SRR15539829;48;45;0.458333333333333;26;22;0.0416666666666667;0.458333333333333
Control.SRR15539829;43;45;0.511627906976744;21;22;0.0116279069767442;0.488372093023256
Control.SRR15539829;43;45;0.488372093023256;22;21;0.0116279069767442;0.488372093023256
Control.SRR15539829;52;45;0.557692307692308;23;29;0.0576923076923077;0.442307692307692
Control.SRR15539829;40;45;0.475;21;19;0.025;0.475
Control.SRR15539829;43;45;0.511627906976744;21;22;0.0116279069767442;0.488372093023256
Control.SRR15539829;42;45;0.380952380952381;26;16;0.119047619047619;0.380952380952381
Control.SRR15539829;45;45;0.444444444444444;25;20;0.0555555555555556;0.444444444444444
Control.SRR15539829;41;45;0.463414634146341;22;19;0.0365853658536585;0.463414634146341
Control.SRR15539829;45;45;0.555555555555556;20;25;0.0555555555555556;0.444444444444444
Control.SRR15539829;48;45;0.5;24;24;0;0.5
Control.SRR15539829;44;45;0.477272727272727;23;21;0.0227272727272727;0.477272727272727
Control.SRR15539829;43;45;0.558139534883721;19;24;0.0581395348837209;0.441860465116279
Control.SRR15539829;44;45;0.522727272727273;21;23;0.0227272727272727;0.477272727272727
Control.SRR15539829;48;45;0.4375;27;21;0.0625;0.4375
Control.SRR15539829;51;45;0.372549019607843;32;19;0.127450980392157;0.372549019607843
Control.SRR15539829;42;45;0.523809523809524;20;22;0.0238095238095238;0.476190476190476
Control.SRR15539829;52;45;0.384615384615385;32;20;0.115384615384615;0.384615384615385
Control.SRR15539829;46;45;0.41304347826087;27;19;0.0869565217391304;0.41304347826087
Control.SRR15539829;43;45;0.511627906976744;21;22;0.0116279069767442;0.488372093023256
Control.SRR15539829;45;45;0.622222222222222;17;28;0.122222222222222;0.377777777777778
Control.SRR15539829;52;45;0.442307692307692;29;23;0.0576923076923077;0.442307692307692
Control.SRR15539829;45;45;0.555555555555556;20;25;0.0555555555555556;0.444444444444444
Control.SRR15539829;42;45;0.404761904761905;25;17;0.0952380952380952;0.404761904761905
Control.SRR15539829;50;45;0.58;21;29;0.08;0.42
Control.SRR15539829;51;45;0.529411764705882;24;27;0.0294117647058824;0.470588235294118
Control.SRR15539829;41;45;0.560975609756098;18;23;0.0609756097560976;0.439024390243902
Control.SRR15539829;46;45;0.434782608695652;26;20;0.0652173913043478;0.434782608695652
Control.SRR15539829;48;45;0.583333333333333;20;28;0.0833333333333334;0.416666666666667
Control.SRR15539829;48;45;0.479166666666667;25;23;0.0208333333333333;0.479166666666667
Control.SRR15539829;47;45;0.425531914893617;27;20;0.074468085106383;0.425531914893617
Control.SRR15539829;40;45;0.625;15;25;0.125;0.375
Control.SRR15539829;40;45;0.525;19;21;0.025;0.475
Control.SRR15539829;43;45;0.604651162790698;17;26;0.104651162790698;0.395348837209302
Control.SRR15539829;45;45;0.422222222222222;26;19;0.0777777777777778;0.422222222222222
Control.SRR15539829;43;45;0.441860465116279;24;19;0.0581395348837209;0.441860465116279
Control.SRR15539829;47;45;0.51063829787234;23;24;0.0106382978723404;0.48936170212766
Control.SRR15539829;40;45;0.525;19;21;0.025;0.475
Control.SRR15539829;42;45;0.428571428571429;24;18;0.0714285714285715;0.428571428571429
Control.SRR15539829;47;45;0.51063829787234;23;24;0.0106382978723404;0.48936170212766
Control.SRR15539829;46;45;0.5;23;23;0;0.5
Control.SRR15539829;47;45;0.404255319148936;28;19;0.0957446808510639;0.404255319148936
Control.SRR15539829;48;45;0.520833333333333;23;25;0.0208333333333334;0.479166666666667
Control.SRR15539829;43;45;0.418604651162791;25;18;0.0813953488372093;0.418604651162791
Control.SRR15539829;49;45;0.306122448979592;34;15;0.193877551020408;0.306122448979592
Control.SRR15539829;50;45;0.48;26;24;0.02;0.48
Control.SRR15539829;46;45;0.565217391304348;20;26;0.0652173913043478;0.434782608695652
Control.SRR15539829;41;45;0.463414634146341;22;19;0.0365853658536585;0.463414634146341
Control.SRR15539829;42;45;0.452380952380952;23;19;0.0476190476190476;0.452380952380952
Control.SRR15539829;40;45;0.475;21;19;0.025;0.475
Control.SRR15539829;47;45;0.361702127659574;30;17;0.138297872340426;0.361702127659574
Control.SRR15539829;49;45;0.448979591836735;27;22;0.0510204081632653;0.448979591836735
Control.SRR15539829;45;45;0.444444444444444;25;20;0.0555555555555556;0.444444444444444
Control.SRR15539829;43;45;0.488372093023256;22;21;0.0116279069767442;0.488372093023256
Control.SRR15539829;47;45;0.446808510638298;26;21;0.0531914893617021;0.446808510638298
Control.SRR15539829;42;45;0.523809523809524;20;22;0.0238095238095238;0.476190476190476
Control.SRR15539829;48;45;0.583333333333333;20;28;0.0833333333333334;0.416666666666667
Control.SRR15539829;43;45;0.511627906976744;21;22;0.0116279069767442;0.488372093023256
Control.SRR15539829;50;45;0.42;29;21;0.08;0.42
Control.SRR15539829;48;45;0.375;30;18;0.125;0.375
Control.SRR15539829;41;45;0.48780487804878;21;20;0.0121951219512195;0.48780487804878
Control.SRR15539829;46;45;0.521739130434783;22;24;0.0217391304347826;0.478260869565217
Control.SRR15539829;47;45;0.468085106382979;25;22;0.0319148936170213;0.468085106382979
Control.SRR15539829;49;45;0.448979591836735;27;22;0.0510204081632653;0.448979591836735
Control.SRR15539829;42;45;0.547619047619048;19;23;0.0476190476190477;0.452380952380952
Control.SRR15539829;46;45;0.456521739130435;25;21;0.0434782608695652;0.456521739130435
Control.SRR15539829;43;45;0.441860465116279;24;19;0.0581395348837209;0.441860465116279
Control.SRR15539829;40;45;0.625;15;25;0.125;0.375
Control.SRR15539829;48;45;0.541666666666667;22;26;0.0416666666666666;0.458333333333333
Control.SRR15539829;41;45;0.414634146341463;24;17;0.0853658536585366;0.414634146341463
Control.SRR15539829;41;45;0.609756097560976;16;25;0.109756097560976;0.390243902439024
Control.SRR15539829;42;45;0.476190476190476;22;20;0.0238095238095238;0.476190476190476
Control.SRR15539829;47;45;0.425531914893617;27;20;0.074468085106383;0.425531914893617
Control.SRR15539829;45;45;0.577777777777778;19;26;0.0777777777777777;0.422222222222222
Control.SRR15539829;46;45;0.478260869565217;24;22;0.0217391304347826;0.478260869565217
Control.SRR15539829;50;45;0.56;22;28;0.0600000000000001;0.44
Control.SRR15539829;47;45;0.48936170212766;24;23;0.0106382978723404;0.48936170212766
Control.SRR15539829;46;45;0.41304347826087;27;19;0.0869565217391304;0.41304347826087
Control.SRR15539829;44;45;0.454545454545455;24;20;0.0454545454545455;0.454545454545455
Control.SRR15539829;46;45;0.521739130434783;22;24;0.0217391304347826;0.478260869565217
Control.SRR15539829;52;45;0.557692307692308;23;29;0.0576923076923077;0.442307692307692
Control.SRR15539829;51;45;0.529411764705882;24;27;0.0294117647058824;0.470588235294118
Control.SRR15539829;41;45;0.439024390243902;23;18;0.0609756097560976;0.439024390243902
Control.SRR15539829;41;45;0.560975609756098;18;23;0.0609756097560976;0.439024390243902
Control.SRR15539829;41;45;0.390243902439024;25;16;0.109756097560976;0.390243902439024
Control.SRR15539829;40;45;0.6;16;24;0.1;0.4
Control.SRR15539829;40;45;0.45;22;18;0.05;0.45
Control.SRR15539829;48;45;0.4375;27;21;0.0625;0.4375
Control.SRR15539829;50;45;0.48;26;24;0.02;0.48
Control.SRR15539829;51;45;0.509803921568627;25;26;0.00980392156862742;0.490196078431373
Control.SRR15539829;47;45;0.48936170212766;24;23;0.0106382978723404;0.48936170212766
Control.SRR15539829;40;45;0.6;16;24;0.1;0.4
Control.SRR15539829;40;45;0.675;13;27;0.175;0.325
Control.SRR15539829;49;45;0.408163265306122;29;20;0.0918367346938775;0.408163265306122
Control.SRR15539829;46;45;0.565217391304348;20;26;0.0652173913043478;0.434782608695652
Control.SRR15539829;43;45;0.441860465116279;24;19;0.0581395348837209;0.441860465116279
Control.SRR15539829;42;45;0.619047619047619;16;26;0.119047619047619;0.380952380952381
Control.SRR15539829;43;45;0.488372093023256;22;21;0.0116279069767442;0.488372093023256
Control.SRR15539829;45;45;0.533333333333333;21;24;0.0333333333333333;0.466666666666667
Control.SRR15539829;44;45;0.409090909090909;26;18;0.0909090909090909;0.409090909090909
Control.SRR15539829;42;45;0.404761904761905;25;17;0.0952380952380952;0.404761904761905
Control.SRR15539829;51;45;0.431372549019608;29;22;0.0686274509803921;0.431372549019608
Control.SRR15539829;51;45;0.529411764705882;24;27;0.0294117647058824;0.470588235294118
Control.SRR15539829;40;45;0.625;15;25;0.125;0.375
Control.SRR15539829;48;45;0.375;30;18;0.125;0.375
Control.SRR15539829;45;45;0.622222222222222;17;28;0.122222222222222;0.377777777777778
Control.SRR15539829;40;45;0.425;23;17;0.075;0.425
Control.SRR15539829;51;45;0.549019607843137;23;28;0.0490196078431373;0.450980392156863
Control.SRR15539829;52;45;0.423076923076923;30;22;0.0769230769230769;0.423076923076923
Control.SRR15539829;47;45;0.553191489361702;21;26;0.0531914893617021;0.446808510638298
Control.SRR15539829;46;45;0.41304347826087;27;19;0.0869565217391304;0.41304347826087
Control.SRR15539829;51;45;0.607843137254902;20;31;0.107843137254902;0.392156862745098
Control.SRR15539829;45;45;0.444444444444444;25;20;0.0555555555555556;0.444444444444444
Control.SRR15539829;46;45;0.478260869565217;24;22;0.0217391304347826;0.478260869565217
Control.SRR15539829;47;45;0.468085106382979;25;22;0.0319148936170213;0.468085106382979
Control.SRR15539829;42;45;0.642857142857143;15;27;0.142857142857143;0.357142857142857
Control.SRR15539829;43;45;0.511627906976744;21;22;0.0116279069767442;0.488372093023256
Control.SRR15539829;40;45;0.4;24;16;0.1;0.4
Control.SRR15539829;43;45;0.418604651162791;25;18;0.0813953488372093;0.418604651162791
Control.SRR15539829;43;45;0.372093023255814;27;16;0.127906976744186;0.372093023255814
Control.SRR15539829;48;45;0.416666666666667;28;20;0.0833333333333333;0.416666666666667
Control.SRR15539829;50;45;0.64;18;32;0.14;0.36
Control.SRR15539829;50;45;0.38;31;19;0.12;0.38
Control.SRR15539829;47;45;0.425531914893617;27;20;0.074468085106383;0.425531914893617
Control.SRR15539829;45;45;0.488888888888889;23;22;0.0111111111111111;0.488888888888889
Control.SRR15539829;45;45;0.555555555555556;20;25;0.0555555555555556;0.444444444444444
Control.SRR15539829;45;45;0.511111111111111;22;23;0.0111111111111111;0.488888888888889
Control.SRR15539829;46;45;0.543478260869565;21;25;0.0434782608695652;0.456521739130435
Control.SRR15539829;52;45;0.442307692307692;29;23;0.0576923076923077;0.442307692307692
Control.SRR15539829;44;45;0.363636363636364;28;16;0.136363636363636;0.363636363636364
Control.SRR15539829;52;45;0.461538461538462;28;24;0.0384615384615384;0.461538461538462
Control.SRR15539829;50;45;0.46;27;23;0.04;0.46
Control.SRR15539829;49;45;0.530612244897959;23;26;0.0306122448979592;0.469387755102041
Control.SRR15539829;47;45;0.595744680851064;19;28;0.0957446808510638;0.404255319148936
Control.SRR15539829;49;45;0.510204081632653;24;25;0.0102040816326531;0.489795918367347
Control.SRR15539829;47;45;0.51063829787234;23;24;0.0106382978723404;0.48936170212766
Control.SRR15539829;49;45;0.448979591836735;27;22;0.0510204081632653;0.448979591836735
Control.SRR15539829;48;45;0.625;18;30;0.125;0.375
Control.SRR15539829;51;45;0.372549019607843;32;19;0.127450980392157;0.372549019607843
Control.SRR15539829;50;45;0.44;28;22;0.06;0.44
Control.SRR15539829;44;45;0.409090909090909;26;18;0.0909090909090909;0.409090909090909
Control.SRR15539829;45;45;0.422222222222222;26;19;0.0777777777777778;0.422222222222222
Control.SRR15539829;46;45;0.5;23;23;0;0.5
Control.SRR15539829;43;45;0.372093023255814;27;16;0.127906976744186;0.372093023255814
Control.SRR15539829;42;45;0.404761904761905;25;17;0.0952380952380952;0.404761904761905
Control.SRR15539829;46;45;0.630434782608696;17;29;0.130434782608696;0.369565217391304
Control.SRR15539829;51;45;0.470588235294118;27;24;0.0294117647058824;0.470588235294118
Control.SRR15539829;48;45;0.354166666666667;31;17;0.145833333333333;0.354166666666667
Control.SRR15539829;45;45;0.511111111111111;22;23;0.0111111111111111;0.488888888888889
Control.SRR15539829;45;45;0.555555555555556;20;25;0.0555555555555556;0.444444444444444
Control.SRR15539829;43;45;0.534883720930233;20;23;0.0348837209302325;0.465116279069767
Control.SRR15539829;46;45;0.608695652173913;18;28;0.108695652173913;0.391304347826087
Control.SRR15539829;41;45;0.51219512195122;20;21;0.0121951219512195;0.48780487804878
Control.SRR15539829;45;45;0.622222222222222;17;28;0.122222222222222;0.377777777777778
Control.SRR15539829;47;45;0.468085106382979;25;22;0.0319148936170213;0.468085106382979
Control.SRR15539829;50;45;0.42;29;21;0.08;0.42
Control.SRR15539829;51;45;0.588235294117647;21;30;0.0882352941176471;0.411764705882353
Control.SRR15539829;49;45;0.448979591836735;27;22;0.0510204081632653;0.448979591836735
Control.SRR15539829;48;45;0.458333333333333;26;22;0.0416666666666667;0.458333333333333
Control.SRR15539829;41;45;0.682926829268293;13;28;0.182926829268293;0.317073170731707
Control.SRR15539829;49;45;0.469387755102041;26;23;0.0306122448979592;0.469387755102041
Control.SRR15539829;51;45;0.450980392156863;28;23;0.0490196078431372;0.450980392156863
Control.SRR15539829;43;45;0.465116279069767;23;20;0.0348837209302326;0.465116279069767
Control.SRR15539829;51;45;0.549019607843137;23;28;0.0490196078431373;0.450980392156863
Control.SRR15539829;44;45;0.454545454545455;24;20;0.0454545454545455;0.454545454545455
Control.SRR15539829;49;45;0.530612244897959;23;26;0.0306122448979592;0.469387755102041
Control.SRR15539829;49;45;0.489795918367347;25;24;0.0102040816326531;0.489795918367347
Control.SRR15539829;43;45;0.558139534883721;19;24;0.0581395348837209;0.441860465116279
Control.SRR15539829;49;45;0.530612244897959;23;26;0.0306122448979592;0.469387755102041
Control.SRR15539829;40;45;0.6;16;24;0.1;0.4
Control.SRR15539829;48;45;0.583333333333333;20;28;0.0833333333333334;0.416666666666667
Control.SRR15539829;43;45;0.488372093023256;22;21;0.0116279069767442;0.488372093023256
Control.SRR15539829;51;45;0.490196078431373;26;25;0.00980392156862747;0.490196078431373
Control.SRR15539829;52;45;0.5;26;26;0;0.5
Control.SRR15539829;47;45;0.404255319148936;28;19;0.0957446808510639;0.404255319148936
Control.SRR15539829;48;45;0.479166666666667;25;23;0.0208333333333333;0.479166666666667
Control.SRR15539829;45;45;0.466666666666667;24;21;0.0333333333333333;0.466666666666667
Control.SRR15539829;42;45;0.404761904761905;25;17;0.0952380952380952;0.404761904761905
Control.SRR15539829;46;45;0.478260869565217;24;22;0.0217391304347826;0.478260869565217
Control.SRR15539829;44;45;0.454545454545455;24;20;0.0454545454545455;0.454545454545455
Control.SRR15539829;41;45;0.609756097560976;16;25;0.109756097560976;0.390243902439024
Control.SRR15539829;52;45;0.519230769230769;25;27;0.0192307692307693;0.480769230769231
Control.SRR15539829;42;45;0.571428571428571;18;24;0.0714285714285714;0.428571428571429
Control.SRR15539829;44;45;0.590909090909091;18;26;0.0909090909090909;0.409090909090909
Control.SRR15539829;41;45;0.609756097560976;16;25;0.109756097560976;0.390243902439024
Control.SRR15539829;42;45;0.476190476190476;22;20;0.0238095238095238;0.476190476190476
Control.SRR15539829;41;45;0.463414634146341;22;19;0.0365853658536585;0.463414634146341
Control.SRR15539829;48;45;0.583333333333333;20;28;0.0833333333333334;0.416666666666667
Control.SRR15539829;47;45;0.404255319148936;28;19;0.0957446808510639;0.404255319148936
Control.SRR15539829;46;45;0.434782608695652;26;20;0.0652173913043478;0.434782608695652
Control.SRR15539829;43;45;0.558139534883721;19;24;0.0581395348837209;0.441860465116279
Control.SRR15539829;42;45;0.547619047619048;19;23;0.0476190476190477;0.452380952380952
Control.SRR15539829;41;45;0.536585365853659;19;22;0.0365853658536586;0.463414634146341
Control.SRR15539829;43;45;0.604651162790698;17;26;0.104651162790698;0.395348837209302
Control.SRR15539829;46;45;0.565217391304348;20;26;0.0652173913043478;0.434782608695652
Control.SRR15539829;40;45;0.625;15;25;0.125;0.375
Control.SRR15539829;52;45;0.480769230769231;27;25;0.0192307692307692;0.480769230769231
Control.SRR15539829;48;45;0.4375;27;21;0.0625;0.4375
Control.SRR15539829;52;45;0.423076923076923;30;22;0.0769230769230769;0.423076923076923
Control.SRR15539829;48;45;0.4375;27;21;0.0625;0.4375
Control.SRR15539829;50;45;0.46;27;23;0.04;0.46
Control.SRR15539829;50;45;0.5;25;25;0;0.5
Control.SRR15539829;48;45;0.541666666666667;22;26;0.0416666666666666;0.458333333333333
Control.SRR15539829;52;45;0.442307692307692;29;23;0.0576923076923077;0.442307692307692
Control.SRR15539829;41;45;0.536585365853659;19;22;0.0365853658536586;0.463414634146341
Control.SRR15539829;49;45;0.448979591836735;27;22;0.0510204081632653;0.448979591836735
Control.SRR15539829;50;45;0.64;18;32;0.14;0.36
Control.SRR15539829;43;45;0.441860465116279;24;19;0.0581395348837209;0.441860465116279
Control.SRR15539829;50;45;0.54;23;27;0.04;0.46
Control.SRR15539829;50;45;0.52;24;26;0.02;0.48
Control.SRR15539829;51;45;0.509803921568627;25;26;0.00980392156862742;0.490196078431373
Control.SRR15539829;49;45;0.469387755102041;26;23;0.0306122448979592;0.469387755102041
Control.SRR15539829;47;45;0.48936170212766;24;23;0.0106382978723404;0.48936170212766
Control.SRR15539829;42;45;0.547619047619048;19;23;0.0476190476190477;0.452380952380952
Control.SRR15539829;48;45;0.5625;21;27;0.0625;0.4375
Control.SRR15539829;50;45;0.56;22;28;0.0600000000000001;0.44
Control.SRR15539829;45;45;0.6;18;27;0.1;0.4
Control.SRR15539829;41;45;0.634146341463415;15;26;0.134146341463415;0.365853658536585
Control.SRR15539829;45;45;0.644444444444444;16;29;0.144444444444444;0.355555555555556
Control.SRR15539829;46;45;0.326086956521739;31;15;0.173913043478261;0.326086956521739
Control.SRR15539829;48;45;0.416666666666667;28;20;0.0833333333333333;0.416666666666667
Control.SRR15539829;46;45;0.5;23;23;0;0.5
Control.SRR15539829;46;45;0.391304347826087;28;18;0.108695652173913;0.391304347826087
Control.SRR15539829;50;45;0.56;22;28;0.0600000000000001;0.44
Control.SRR15539829;49;45;0.571428571428571;21;28;0.0714285714285714;0.428571428571429
Control.SRR15539829;45;45;0.4;27;18;0.1;0.4
Control.SRR15539829;44;45;0.568181818181818;19;25;0.0681818181818182;0.431818181818182
Control.SRR15539829;49;45;0.510204081632653;24;25;0.0102040816326531;0.489795918367347
Control.SRR15539829;50;45;0.62;19;31;0.12;0.38
Control.SRR15539829;43;45;0.581395348837209;18;25;0.0813953488372093;0.418604651162791
Control.SRR15539829;46;45;0.478260869565217;24;22;0.0217391304347826;0.478260869565217
Control.SRR15539829;49;45;0.408163265306122;29;20;0.0918367346938775;0.408163265306122
Control.SRR15539829;43;45;0.418604651162791;25;18;0.0813953488372093;0.418604651162791
Control.SRR15539829;45;45;0.377777777777778;28;17;0.122222222222222;0.377777777777778
Control.SRR15539829;44;45;0.522727272727273;21;23;0.0227272727272727;0.477272727272727
Control.SRR15539829;50;45;0.42;29;21;0.08;0.42
Control.SRR15539829;46;45;0.565217391304348;20;26;0.0652173913043478;0.434782608695652
Control.SRR15539829;47;45;0.531914893617021;22;25;0.0319148936170213;0.468085106382979
Control.SRR15539829;45;45;0.422222222222222;26;19;0.0777777777777778;0.422222222222222
Control.SRR15539829;40;45;0.625;15;25;0.125;0.375
Control.SRR15539829;51;45;0.490196078431373;26;25;0.00980392156862747;0.490196078431373
Control.SRR15539829;46;45;0.478260869565217;24;22;0.0217391304347826;0.478260869565217
Control.SRR15539829;49;45;0.489795918367347;25;24;0.0102040816326531;0.489795918367347
Control.SRR15539829;49;45;0.428571428571429;28;21;0.0714285714285715;0.428571428571429
Control.SRR15539829;49;45;0.510204081632653;24;25;0.0102040816326531;0.489795918367347
Control.SRR15539829;43;45;0.418604651162791;25;18;0.0813953488372093;0.418604651162791
Control.SRR15539829;47;45;0.404255319148936;28;19;0.0957446808510639;0.404255319148936
Control.SRR15539829;41;45;0.585365853658537;17;24;0.0853658536585366;0.414634146341463
Control.SRR15539829;48;45;0.458333333333333;26;22;0.0416666666666667;0.458333333333333
Control.SRR15539829;44;45;0.5;22;22;0;0.5
Control.SRR15539829;46;45;0.478260869565217;24;22;0.0217391304347826;0.478260869565217
Control.SRR15539829;47;45;0.48936170212766;24;23;0.0106382978723404;0.48936170212766
Control.SRR15539829;50;45;0.6;20;30;0.1;0.4
Control.SRR15539829;52;45;0.615384615384615;20;32;0.115384615384615;0.384615384615385
Control.SRR15539829;52;45;0.423076923076923;30;22;0.0769230769230769;0.423076923076923
Control.SRR15539829;48;45;0.5;24;24;0;0.5
Control.SRR15539829;50;45;0.42;29;21;0.08;0.42
Control.SRR15539829;48;45;0.520833333333333;23;25;0.0208333333333334;0.479166666666667
Control.SRR15539829;52;45;0.538461538461538;24;28;0.0384615384615384;0.461538461538462
Control.SRR15539829;50;45;0.54;23;27;0.04;0.46
Control.SRR15539829;45;45;0.466666666666667;24;21;0.0333333333333333;0.466666666666667
Control.SRR15539829;46;45;0.434782608695652;26;20;0.0652173913043478;0.434782608695652
Control.SRR15539829;41;45;0.536585365853659;19;22;0.0365853658536586;0.463414634146341
Control.SRR15539829;41;45;0.536585365853659;19;22;0.0365853658536586;0.463414634146341
Control.SRR15539829;50;45;0.6;20;30;0.1;0.4
Control.SRR15539829;43;45;0.534883720930233;20;23;0.0348837209302325;0.465116279069767
Control.SRR15539829;46;45;0.456521739130435;25;21;0.0434782608695652;0.456521739130435
Control.SRR15539829;45;45;0.422222222222222;26;19;0.0777777777777778;0.422222222222222
Control.SRR15539829;46;45;0.434782608695652;26;20;0.0652173913043478;0.434782608695652
Control.SRR15539829;43;45;0.581395348837209;18;25;0.0813953488372093;0.418604651162791
Control.SRR15539829;41;45;0.48780487804878;21;20;0.0121951219512195;0.48780487804878
Control.SRR15539829;43;45;0.465116279069767;23;20;0.0348837209302326;0.465116279069767
Control.SRR15539829;40;45;0.5;20;20;0;0.5
Control.SRR15539829;49;45;0.489795918367347;25;24;0.0102040816326531;0.489795918367347
Control.SRR15539829;41;45;0.463414634146341;22;19;0.0365853658536585;0.463414634146341
Control.SRR15539829;41;45;0.414634146341463;24;17;0.0853658536585366;0.414634146341463
Control.SRR15539829;52;45;0.5;26;26;0;0.5
Control.SRR15539829;47;45;0.51063829787234;23;24;0.0106382978723404;0.48936170212766
Control.SRR15539829;50;45;0.48;26;24;0.02;0.48
Control.SRR15539829;50;45;0.52;24;26;0.02;0.48
Control.SRR15539829;46;45;0.543478260869565;21;25;0.0434782608695652;0.456521739130435
Control.SRR15539829;42;45;0.5;21;21;0;0.5
Control.SRR15539829;41;45;0.317073170731707;28;13;0.182926829268293;0.317073170731707
Control.SRR15539829;41;45;0.439024390243902;23;18;0.0609756097560976;0.439024390243902
Control.SRR15539829;47;45;0.680851063829787;15;32;0.180851063829787;0.319148936170213
Control.SRR15539829;44;45;0.568181818181818;19;25;0.0681818181818182;0.431818181818182
Control.SRR15539829;43;45;0.511627906976744;21;22;0.0116279069767442;0.488372093023256
Control.SRR15539829;51;45;0.588235294117647;21;30;0.0882352941176471;0.411764705882353
Control.SRR15539829;48;45;0.4375;27;21;0.0625;0.4375
Control.SRR15539829;48;45;0.5625;21;27;0.0625;0.4375
Control.SRR15539829;46;45;0.434782608695652;26;20;0.0652173913043478;0.434782608695652
Control.SRR15539829;52;45;0.576923076923077;22;30;0.0769230769230769;0.423076923076923
Control.SRR15539829;43;45;0.395348837209302;26;17;0.104651162790698;0.395348837209302
Control.SRR15539829;46;45;0.5;23;23;0;0.5
Control.SRR15539829;43;45;0.604651162790698;17;26;0.104651162790698;0.395348837209302
Control.SRR15539829;52;45;0.557692307692308;23;29;0.0576923076923077;0.442307692307692
Control.SRR15539829;50;45;0.52;24;26;0.02;0.48
Control.SRR15539829;44;45;0.409090909090909;26;18;0.0909090909090909;0.409090909090909
Control.SRR15539829;49;45;0.408163265306122;29;20;0.0918367346938775;0.408163265306122
Control.SRR15539829;50;45;0.5;25;25;0;0.5
Control.SRR15539829;46;45;0.456521739130435;25;21;0.0434782608695652;0.456521739130435
Control.SRR15539829;51;45;0.490196078431373;26;25;0.00980392156862747;0.490196078431373
Control.SRR15539829;47;45;0.48936170212766;24;23;0.0106382978723404;0.48936170212766
Control.SRR15539829;50;45;0.62;19;31;0.12;0.38
Control.SRR15539829;46;45;0.521739130434783;22;24;0.0217391304347826;0.478260869565217
Control.SRR15539829;50;45;0.44;28;22;0.06;0.44
Control.SRR15539829;50;45;0.6;20;30;0.1;0.4
Control.SRR15539829;49;45;0.571428571428571;21;28;0.0714285714285714;0.428571428571429
Control.SRR15539829;40;45;0.575;17;23;0.075;0.425
Control.SRR15539829;40;45;0.6;16;24;0.1;0.4
Control.SRR15539829;41;45;0.536585365853659;19;22;0.0365853658536586;0.463414634146341
Control.SRR15539829;47;45;0.531914893617021;22;25;0.0319148936170213;0.468085106382979
Control.SRR15539829;47;45;0.553191489361702;21;26;0.0531914893617021;0.446808510638298
Control.SRR15539829;40;45;0.625;15;25;0.125;0.375
Control.SRR15539829;41;45;0.51219512195122;20;21;0.0121951219512195;0.48780487804878
Control.SRR15539829;51;45;0.490196078431373;26;25;0.00980392156862747;0.490196078431373
Control.SRR15539829;44;45;0.568181818181818;19;25;0.0681818181818182;0.431818181818182
Control.SRR15539829;51;45;0.470588235294118;27;24;0.0294117647058824;0.470588235294118
Control.SRR15539829;46;45;0.456521739130435;25;21;0.0434782608695652;0.456521739130435
Control.SRR15539829;45;45;0.444444444444444;25;20;0.0555555555555556;0.444444444444444
Control.SRR15539829;45;45;0.555555555555556;20;25;0.0555555555555556;0.444444444444444
Control.SRR15539829;44;45;0.568181818181818;19;25;0.0681818181818182;0.431818181818182
Control.SRR15539829;52;45;0.5;26;26;0;0.5
Control.SRR15539829;47;45;0.553191489361702;21;26;0.0531914893617021;0.446808510638298
Control.SRR15539829;52;45;0.538461538461538;24;28;0.0384615384615384;0.461538461538462
Control.SRR15539829;49;45;0.571428571428571;21;28;0.0714285714285714;0.428571428571429
Control.SRR15539829;45;45;0.577777777777778;19;26;0.0777777777777777;0.422222222222222
Control.SRR15539829;46;45;0.58695652173913;19;27;0.0869565217391305;0.41304347826087
Control.SRR15539829;42;45;0.571428571428571;18;24;0.0714285714285714;0.428571428571429
Control.SRR15539829;50;45;0.44;28;22;0.06;0.44
Control.SRR15539829;46;45;0.5;23;23;0;0.5
Control.SRR15539829;50;45;0.58;21;29;0.08;0.42
Control.SRR15539829;52;45;0.634615384615385;19;33;0.134615384615385;0.365384615384615
Control.SRR15539829;44;45;0.590909090909091;18;26;0.0909090909090909;0.409090909090909
Control.SRR15539829;50;45;0.44;28;22;0.06;0.44
Control.SRR15539829;51;45;0.411764705882353;30;21;0.0882352941176471;0.411764705882353
Control.SRR15539829;44;45;0.454545454545455;24;20;0.0454545454545455;0.454545454545455
Control.SRR15539829;42;45;0.476190476190476;22;20;0.0238095238095238;0.476190476190476
Control.SRR15539829;52;45;0.461538461538462;28;24;0.0384615384615384;0.461538461538462
Control.SRR15539829;43;45;0.627906976744186;16;27;0.127906976744186;0.372093023255814
Control.SRR15539829;42;45;0.571428571428571;18;24;0.0714285714285714;0.428571428571429
Control.SRR15539829;52;45;0.557692307692308;23;29;0.0576923076923077;0.442307692307692
Control.SRR15539829;52;45;0.442307692307692;29;23;0.0576923076923077;0.442307692307692
Control.SRR15539829;48;45;0.479166666666667;25;23;0.0208333333333333;0.479166666666667
Control.SRR15539829;49;45;0.36734693877551;31;18;0.13265306122449;0.36734693877551
Control.SRR15539829;52;45;0.519230769230769;25;27;0.0192307692307693;0.480769230769231
Control.SRR15539829;40;45;0.6;16;24;0.1;0.4
Control.SRR15539829;52;45;0.480769230769231;27;25;0.0192307692307692;0.480769230769231
Control.SRR15539829;41;45;0.48780487804878;21;20;0.0121951219512195;0.48780487804878
Control.SRR15539829;47;45;0.617021276595745;18;29;0.117021276595745;0.382978723404255
Control.SRR15539829;43;45;0.418604651162791;25;18;0.0813953488372093;0.418604651162791
Control.SRR15539829;49;45;0.63265306122449;18;31;0.13265306122449;0.36734693877551
Control.SRR15539829;49;45;0.489795918367347;25;24;0.0102040816326531;0.489795918367347
Control.SRR15539829;52;45;0.519230769230769;25;27;0.0192307692307693;0.480769230769231
Control.SRR15539829;50;45;0.5;25;25;0;0.5
Control.SRR15539829;49;45;0.591836734693878;20;29;0.0918367346938775;0.408163265306122
Control.SRR15539829;47;45;0.638297872340426;17;30;0.138297872340426;0.361702127659574
Control.SRR15539829;44;45;0.636363636363636;16;28;0.136363636363636;0.363636363636364
Control.SRR15539829;50;45;0.5;25;25;0;0.5
Control.SRR15539829;50;45;0.42;29;21;0.08;0.42
Control.SRR15539829;46;45;0.543478260869565;21;25;0.0434782608695652;0.456521739130435
Control.SRR15539829;48;45;0.395833333333333;29;19;0.104166666666667;0.395833333333333
Control.SRR15539829;49;45;0.510204081632653;24;25;0.0102040816326531;0.489795918367347
Control.SRR15539829;50;45;0.54;23;27;0.04;0.46
Control.SRR15539829;52;45;0.346153846153846;34;18;0.153846153846154;0.346153846153846
Control.SRR15539829;40;45;0.55;18;22;0.05;0.45
Control.SRR15539829;41;45;0.390243902439024;25;16;0.109756097560976;0.390243902439024
Control.SRR15539829;48;45;0.5;24;24;0;0.5
Control.SRR15539829;50;45;0.44;28;22;0.06;0.44
Control.SRR15539829;40;45;0.525;19;21;0.025;0.475
Control.SRR15539829;46;45;0.521739130434783;22;24;0.0217391304347826;0.478260869565217
Control.SRR15539829;44;45;0.477272727272727;23;21;0.0227272727272727;0.477272727272727
Control.SRR15539829;45;45;0.333333333333333;30;15;0.166666666666667;0.333333333333333
Control.SRR15539829;41;45;0.536585365853659;19;22;0.0365853658536586;0.463414634146341
Control.SRR15539829;49;45;0.653061224489796;17;32;0.153061224489796;0.346938775510204
Control.SRR15539829;41;45;0.536585365853659;19;22;0.0365853658536586;0.463414634146341
Control.SRR15539829;51;45;0.411764705882353;30;21;0.0882352941176471;0.411764705882353
Control.SRR15539829;43;45;0.465116279069767;23;20;0.0348837209302326;0.465116279069767
Control.SRR15539829;45;45;0.6;18;27;0.1;0.4
Control.SRR15539829;44;45;0.477272727272727;23;21;0.0227272727272727;0.477272727272727
Control.SRR15539829;48;45;0.625;18;30;0.125;0.375
Control.SRR15539829;50;45;0.5;25;25;0;0.5
Control.SRR15539829;50;45;0.52;24;26;0.02;0.48
Control.SRR15539829;49;45;0.510204081632653;24;25;0.0102040816326531;0.489795918367347
Control.SRR15539829;47;45;0.468085106382979;25;22;0.0319148936170213;0.468085106382979
Control.SRR15539829;47;45;0.553191489361702;21;26;0.0531914893617021;0.446808510638298
Control.SRR15539829;48;45;0.5;24;24;0;0.5
Control.SRR15539829;44;45;0.522727272727273;21;23;0.0227272727272727;0.477272727272727
Control.SRR15539829;48;45;0.479166666666667;25;23;0.0208333333333333;0.479166666666667
Control.SRR15539829;41;45;0.365853658536585;26;15;0.134146341463415;0.365853658536585
Control.SRR15539829;42;45;0.619047619047619;16;26;0.119047619047619;0.380952380952381
Control.SRR15539829;40;45;0.625;15;25;0.125;0.375
Control.SRR15539829;46;45;0.456521739130435;25;21;0.0434782608695652;0.456521739130435
Control.SRR15539829;50;45;0.52;24;26;0.02;0.48
Control.SRR15539829;52;45;0.538461538461538;24;28;0.0384615384615384;0.461538461538462
Control.SRR15539829;49;45;0.530612244897959;23;26;0.0306122448979592;0.469387755102041
Control.SRR15539829;45;45;0.511111111111111;22;23;0.0111111111111111;0.488888888888889
Control.SRR15539829;46;45;0.608695652173913;18;28;0.108695652173913;0.391304347826087
Control.SRR15539829;46;45;0.652173913043478;16;30;0.152173913043478;0.347826086956522
Control.SRR15539829;49;45;0.428571428571429;28;21;0.0714285714285715;0.428571428571429
Control.SRR15539829;46;45;0.521739130434783;22;24;0.0217391304347826;0.478260869565217
Control.SRR15539829;45;45;0.466666666666667;24;21;0.0333333333333333;0.466666666666667
Control.SRR15539829;52;45;0.653846153846154;18;34;0.153846153846154;0.346153846153846
Control.SRR15539829;51;45;0.450980392156863;28;23;0.0490196078431372;0.450980392156863
Control.SRR15539829;49;45;0.591836734693878;20;29;0.0918367346938775;0.408163265306122
Control.SRR15539829;41;45;0.414634146341463;24;17;0.0853658536585366;0.414634146341463
Control.SRR15539829;44;45;0.477272727272727;23;21;0.0227272727272727;0.477272727272727
Control.SRR15539829;46;45;0.456521739130435;25;21;0.0434782608695652;0.456521739130435
Control.SRR15539829;49;45;0.448979591836735;27;22;0.0510204081632653;0.448979591836735
Control.SRR15539829;52;45;0.346153846153846;34;18;0.153846153846154;0.346153846153846
Control.SRR15539829;44;45;0.431818181818182;25;19;0.0681818181818182;0.431818181818182
Control.SRR15539829;52;45;0.423076923076923;30;22;0.0769230769230769;0.423076923076923
Control.SRR15539829;50;45;0.62;19;31;0.12;0.38
Control.SRR15539829;43;45;0.534883720930233;20;23;0.0348837209302325;0.465116279069767
Control.SRR15539829;44;45;0.522727272727273;21;23;0.0227272727272727;0.477272727272727
Control.SRR15539829;47;45;0.48936170212766;24;23;0.0106382978723404;0.48936170212766
Control.SRR15539829;46;45;0.543478260869565;21;25;0.0434782608695652;0.456521739130435
Control.SRR15539829;52;45;0.461538461538462;28;24;0.0384615384615384;0.461538461538462
Control.SRR15539829;43;45;0.418604651162791;25;18;0.0813953488372093;0.418604651162791
Control.SRR15539829;42;45;0.547619047619048;19;23;0.0476190476190477;0.452380952380952
Control.SRR15539829;52;45;0.461538461538462;28;24;0.0384615384615384;0.461538461538462
Control.SRR15539829;45;45;0.622222222222222;17;28;0.122222222222222;0.377777777777778
Control.SRR15539829;50;45;0.52;24;26;0.02;0.48
Control.SRR15539829;42;45;0.476190476190476;22;20;0.0238095238095238;0.476190476190476
Control.SRR15539829;43;45;0.534883720930233;20;23;0.0348837209302325;0.465116279069767
Control.SRR15539829;49;45;0.489795918367347;25;24;0.0102040816326531;0.489795918367347
Control.SRR15539829;43;45;0.441860465116279;24;19;0.0581395348837209;0.441860465116279
Control.SRR15539829;44;45;0.454545454545455;24;20;0.0454545454545455;0.454545454545455
Control.SRR15539829;46;45;0.565217391304348;20;26;0.0652173913043478;0.434782608695652
Control.SRR15539829;48;45;0.541666666666667;22;26;0.0416666666666666;0.458333333333333
Control.SRR15539829;40;45;0.4;24;16;0.1;0.4
Control.SRR15539829;50;45;0.56;22;28;0.0600000000000001;0.44
Control.SRR15539829;51;45;0.470588235294118;27;24;0.0294117647058824;0.470588235294118
Control.SRR15539829;40;45;0.35;26;14;0.15;0.35
Control.SRR15539829;48;45;0.541666666666667;22;26;0.0416666666666666;0.458333333333333
Control.SRR15539829;43;45;0.488372093023256;22;21;0.0116279069767442;0.488372093023256
Control.SRR15539829;40;45;0.575;17;23;0.075;0.425
Control.SRR15539829;43;45;0.627906976744186;16;27;0.127906976744186;0.372093023255814
Control.SRR15539829;47;45;0.382978723404255;29;18;0.117021276595745;0.382978723404255
Control.SRR15539829;41;45;0.51219512195122;20;21;0.0121951219512195;0.48780487804878
Control.SRR15539829;49;45;0.510204081632653;24;25;0.0102040816326531;0.489795918367347
Control.SRR15539829;51;45;0.568627450980392;22;29;0.0686274509803921;0.431372549019608
Control.SRR15539829;50;45;0.42;29;21;0.08;0.42
Control.SRR15539829;41;45;0.463414634146341;22;19;0.0365853658536585;0.463414634146341
Control.SRR15539829;43;45;0.558139534883721;19;24;0.0581395348837209;0.441860465116279
Control.SRR15539829;50;45;0.5;25;25;0;0.5
Control.SRR15539829;46;45;0.630434782608696;17;29;0.130434782608696;0.369565217391304
Control.SRR15539829;41;45;0.48780487804878;21;20;0.0121951219512195;0.48780487804878
Control.SRR15539829;45;45;0.444444444444444;25;20;0.0555555555555556;0.444444444444444
Control.SRR15539829;51;45;0.607843137254902;20;31;0.107843137254902;0.392156862745098
Control.SRR15539829;51;45;0.568627450980392;22;29;0.0686274509803921;0.431372549019608
Control.SRR15539829;50;45;0.42;29;21;0.08;0.42
Control.SRR15539829;42;45;0.595238095238095;17;25;0.0952380952380952;0.404761904761905
Control.SRR15539829;50;45;0.54;23;27;0.04;0.46
Control.SRR15539829;43;45;0.465116279069767;23;20;0.0348837209302326;0.465116279069767
Control.SRR15539829;43;45;0.511627906976744;21;22;0.0116279069767442;0.488372093023256
Control.SRR15539829;50;45;0.5;25;25;0;0.5
Control.SRR15539829;50;45;0.5;25;25;0;0.5
Control.SRR15539829;40;45;0.35;26;14;0.15;0.35
Control.SRR15539829;50;45;0.62;19;31;0.12;0.38
Control.SRR15539829;48;45;0.458333333333333;26;22;0.0416666666666667;0.458333333333333
Control.SRR15539829;48;45;0.5625;21;27;0.0625;0.4375
Control.SRR15539829;52;45;0.365384615384615;33;19;0.134615384615385;0.365384615384615
Control.SRR15539829;48;45;0.520833333333333;23;25;0.0208333333333334;0.479166666666667
Control.SRR15539829;43;45;0.604651162790698;17;26;0.104651162790698;0.395348837209302
Control.SRR15539829;46;45;0.565217391304348;20;26;0.0652173913043478;0.434782608695652
Control.SRR15539829;49;45;0.571428571428571;21;28;0.0714285714285714;0.428571428571429
Control.SRR15539829;48;45;0.5;24;24;0;0.5
Control.SRR15539829;46;45;0.434782608695652;26;20;0.0652173913043478;0.434782608695652
Control.SRR15539829;42;45;0.523809523809524;20;22;0.0238095238095238;0.476190476190476
Control.SRR15539829;52;45;0.442307692307692;29;23;0.0576923076923077;0.442307692307692
Control.SRR15539829;44;45;0.409090909090909;26;18;0.0909090909090909;0.409090909090909
Control.SRR15539829;40;45;0.45;22;18;0.05;0.45
Control.SRR15539829;45;45;0.488888888888889;23;22;0.0111111111111111;0.488888888888889
Control.SRR15539829;49;45;0.428571428571429;28;21;0.0714285714285715;0.428571428571429
Control.SRR15539829;52;45;0.538461538461538;24;28;0.0384615384615384;0.461538461538462
Control.SRR15539829;47;45;0.531914893617021;22;25;0.0319148936170213;0.468085106382979
Control.SRR15539829;44;45;0.477272727272727;23;21;0.0227272727272727;0.477272727272727
Control.SRR15539829;47;45;0.51063829787234;23;24;0.0106382978723404;0.48936170212766
Control.SRR15539829;44;45;0.386363636363636;27;17;0.113636363636364;0.386363636363636
Control.SRR15539829;43;45;0.604651162790698;17;26;0.104651162790698;0.395348837209302
Control.SRR15539829;43;45;0.441860465116279;24;19;0.0581395348837209;0.441860465116279
Control.SRR15539829;43;45;0.441860465116279;24;19;0.0581395348837209;0.441860465116279
Control.SRR15539829;52;45;0.423076923076923;30;22;0.0769230769230769;0.423076923076923
Control.SRR15539829;50;45;0.56;22;28;0.0600000000000001;0.44
Control.SRR15539829;50;45;0.54;23;27;0.04;0.46
Control.SRR15539829;51;45;0.411764705882353;30;21;0.0882352941176471;0.411764705882353
Control.SRR15539829;46;45;0.41304347826087;27;19;0.0869565217391304;0.41304347826087
Control.SRR15539829;47;45;0.48936170212766;24;23;0.0106382978723404;0.48936170212766
Control.SRR15539829;44;45;0.5;22;22;0;0.5
Control.SRR15539829;42;45;0.547619047619048;19;23;0.0476190476190477;0.452380952380952
Control.SRR15539829;43;45;0.511627906976744;21;22;0.0116279069767442;0.488372093023256
Control.SRR15539829;51;45;0.549019607843137;23;28;0.0490196078431373;0.450980392156863
Control.SRR15539829;43;45;0.488372093023256;22;21;0.0116279069767442;0.488372093023256
Control.SRR15539829;46;45;0.521739130434783;22;24;0.0217391304347826;0.478260869565217
Control.SRR15539829;48;45;0.5;24;24;0;0.5
Control.SRR15539829;50;45;0.46;27;23;0.04;0.46
Control.SRR15539829;40;45;0.575;17;23;0.075;0.425
Control.SRR15539829;46;45;0.652173913043478;16;30;0.152173913043478;0.347826086956522
Control.SRR15539829;46;45;0.41304347826087;27;19;0.0869565217391304;0.41304347826087
Control.SRR15539829;43;45;0.511627906976744;21;22;0.0116279069767442;0.488372093023256
Control.SRR15539829;49;45;0.346938775510204;32;17;0.153061224489796;0.346938775510204
Control.SRR15539829;51;45;0.509803921568627;25;26;0.00980392156862742;0.490196078431373
Control.SRR15539829;44;45;0.636363636363636;16;28;0.136363636363636;0.363636363636364
Control.SRR15539829;41;45;0.463414634146341;22;19;0.0365853658536585;0.463414634146341
Control.SRR15539829;41;45;0.585365853658537;17;24;0.0853658536585366;0.414634146341463
Control.SRR15539829;46;45;0.478260869565217;24;22;0.0217391304347826;0.478260869565217
Control.SRR15539829;46;45;0.608695652173913;18;28;0.108695652173913;0.391304347826087
Control.SRR15539829;46;45;0.630434782608696;17;29;0.130434782608696;0.369565217391304
Control.SRR15539829;46;45;0.369565217391304;29;17;0.130434782608696;0.369565217391304
Control.SRR15539829;47;45;0.574468085106383;20;27;0.074468085106383;0.425531914893617
Control.SRR15539829;43;45;0.441860465116279;24;19;0.0581395348837209;0.441860465116279
Control.SRR15539829;52;45;0.365384615384615;33;19;0.134615384615385;0.365384615384615
Control.SRR15539829;52;45;0.461538461538462;28;24;0.0384615384615384;0.461538461538462
Control.SRR15539829;43;45;0.558139534883721;19;24;0.0581395348837209;0.441860465116279
Control.SRR15539829;44;45;0.5;22;22;0;0.5
Control.SRR15539829;40;45;0.45;22;18;0.05;0.45
Control.SRR15539829;51;45;0.490196078431373;26;25;0.00980392156862747;0.490196078431373
Control.SRR15539829;41;45;0.414634146341463;24;17;0.0853658536585366;0.414634146341463
Control.SRR15539829;50;45;0.58;21;29;0.08;0.42
Control.SRR15539829;50;45;0.56;22;28;0.0600000000000001;0.44
Control.SRR15539829;45;45;0.4;27;18;0.1;0.4
Control.SRR15539829;48;45;0.5;24;24;0;0.5
Control.SRR15539829;41;45;0.560975609756098;18;23;0.0609756097560976;0.439024390243902
Control.SRR15539829;49;45;0.469387755102041;26;23;0.0306122448979592;0.469387755102041
Control.SRR15539829;49;45;0.530612244897959;23;26;0.0306122448979592;0.469387755102041
Control.SRR15539829;51;45;0.431372549019608;29;22;0.0686274509803921;0.431372549019608
Control.SRR15539829;50;45;0.56;22;28;0.0600000000000001;0.44
Control.SRR15539829;51;45;0.549019607843137;23;28;0.0490196078431373;0.450980392156863
Control.SRR15539829;43;45;0.558139534883721;19;24;0.0581395348837209;0.441860465116279
Control.SRR15539829;42;45;0.619047619047619;16;26;0.119047619047619;0.380952380952381
Control.SRR15539829;48;45;0.604166666666667;19;29;0.104166666666667;0.395833333333333
Control.SRR15539829;51;45;0.411764705882353;30;21;0.0882352941176471;0.411764705882353
Control.SRR15539829;46;45;0.5;23;23;0;0.5
Control.SRR15539829;51;45;0.431372549019608;29;22;0.0686274509803921;0.431372549019608
Control.SRR15539829;43;45;0.534883720930233;20;23;0.0348837209302325;0.465116279069767
Control.SRR15539829;49;45;0.428571428571429;28;21;0.0714285714285715;0.428571428571429
Control.SRR15539829;43;45;0.465116279069767;23;20;0.0348837209302326;0.465116279069767
Control.SRR15539829;50;45;0.52;24;26;0.02;0.48
Control.SRR15539829;47;45;0.48936170212766;24;23;0.0106382978723404;0.48936170212766
Control.SRR15539829;44;45;0.431818181818182;25;19;0.0681818181818182;0.431818181818182
Control.SRR15539829;41;45;0.463414634146341;22;19;0.0365853658536585;0.463414634146341
Control.SRR15539829;42;45;0.642857142857143;15;27;0.142857142857143;0.357142857142857
Control.SRR15539829;40;45;0.525;19;21;0.025;0.475
Control.SRR15539829;52;45;0.576923076923077;22;30;0.0769230769230769;0.423076923076923
Control.SRR15539829;40;45;0.45;22;18;0.05;0.45
Control.SRR15539829;41;45;0.365853658536585;26;15;0.134146341463415;0.365853658536585
Control.SRR15539829;42;45;0.476190476190476;22;20;0.0238095238095238;0.476190476190476
Control.SRR15539829;48;45;0.458333333333333;26;22;0.0416666666666667;0.458333333333333
Control.SRR15539829;50;45;0.38;31;19;0.12;0.38
Control.SRR15539829;46;45;0.652173913043478;16;30;0.152173913043478;0.347826086956522
Control.SRR15539829;43;45;0.441860465116279;24;19;0.0581395348837209;0.441860465116279
Control.SRR15539829;49;45;0.489795918367347;25;24;0.0102040816326531;0.489795918367347
Control.SRR15539829;41;45;0.48780487804878;21;20;0.0121951219512195;0.48780487804878
Control.SRR15539829;46;45;0.478260869565217;24;22;0.0217391304347826;0.478260869565217
Control.SRR15539829;44;45;0.477272727272727;23;21;0.0227272727272727;0.477272727272727
Control.SRR15539829;48;45;0.583333333333333;20;28;0.0833333333333334;0.416666666666667
Control.SRR15539829;47;45;0.382978723404255;29;18;0.117021276595745;0.382978723404255
Control.SRR15539829;42;45;0.5;21;21;0;0.5
Control.SRR15539829;41;45;0.48780487804878;21;20;0.0121951219512195;0.48780487804878
Control.SRR15539829;41;45;0.609756097560976;16;25;0.109756097560976;0.390243902439024
Control.SRR15539829;41;45;0.414634146341463;24;17;0.0853658536585366;0.414634146341463
Control.SRR15539829;48;45;0.520833333333333;23;25;0.0208333333333334;0.479166666666667
Control.SRR15539829;41;45;0.51219512195122;20;21;0.0121951219512195;0.48780487804878
Control.SRR15539829;42;45;0.547619047619048;19;23;0.0476190476190477;0.452380952380952
Control.SRR15539829;47;45;0.468085106382979;25;22;0.0319148936170213;0.468085106382979
Control.SRR15539829;42;45;0.642857142857143;15;27;0.142857142857143;0.357142857142857
Control.SRR15539829;50;45;0.4;30;20;0.1;0.4
Control.SRR15539829;47;45;0.48936170212766;24;23;0.0106382978723404;0.48936170212766
Control.SRR15539829;47;45;0.574468085106383;20;27;0.074468085106383;0.425531914893617
Control.SRR15539829;47;45;0.531914893617021;22;25;0.0319148936170213;0.468085106382979
Control.SRR15539829;43;45;0.604651162790698;17;26;0.104651162790698;0.395348837209302
Control.SRR15539829;46;45;0.434782608695652;26;20;0.0652173913043478;0.434782608695652
Control.SRR15539829;41;45;0.439024390243902;23;18;0.0609756097560976;0.439024390243902
Control.SRR15539829;43;45;0.441860465116279;24;19;0.0581395348837209;0.441860465116279
Control.SRR15539829;52;45;0.519230769230769;25;27;0.0192307692307693;0.480769230769231
Control.SRR15539829;48;45;0.541666666666667;22;26;0.0416666666666666;0.458333333333333
Control.SRR15539829;52;45;0.403846153846154;31;21;0.0961538461538461;0.403846153846154
Control.SRR15539829;51;45;0.529411764705882;24;27;0.0294117647058824;0.470588235294118
Control.SRR15539829;47;45;0.595744680851064;19;28;0.0957446808510638;0.404255319148936
Control.SRR15539829;49;45;0.469387755102041;26;23;0.0306122448979592;0.469387755102041
Control.SRR15539829;51;45;0.490196078431373;26;25;0.00980392156862747;0.490196078431373
Control.SRR15539829;50;45;0.58;21;29;0.08;0.42
Control.SRR15539829;51;45;0.549019607843137;23;28;0.0490196078431373;0.450980392156863
Control.SRR15539829;50;45;0.36;32;18;0.14;0.36
Control.SRR15539829;48;45;0.541666666666667;22;26;0.0416666666666666;0.458333333333333
Control.SRR15539829;44;45;0.363636363636364;28;16;0.136363636363636;0.363636363636364
Control.SRR15539829;51;45;0.411764705882353;30;21;0.0882352941176471;0.411764705882353
Control.SRR15539829;49;45;0.469387755102041;26;23;0.0306122448979592;0.469387755102041
Control.SRR15539829;46;45;0.5;23;23;0;0.5
Control.SRR15539829;47;45;0.531914893617021;22;25;0.0319148936170213;0.468085106382979
Control.SRR15539829;45;45;0.422222222222222;26;19;0.0777777777777778;0.422222222222222
Control.SRR15539829;51;45;0.470588235294118;27;24;0.0294117647058824;0.470588235294118
Control.SRR15539829;45;45;0.377777777777778;28;17;0.122222222222222;0.377777777777778
Control.SRR15539829;51;45;0.490196078431373;26;25;0.00980392156862747;0.490196078431373
Control.SRR15539829;48;45;0.5625;21;27;0.0625;0.4375
Control.SRR15539829;49;45;0.489795918367347;25;24;0.0102040816326531;0.489795918367347
Control.SRR15539829;43;45;0.581395348837209;18;25;0.0813953488372093;0.418604651162791
Control.SRR15539829;44;45;0.522727272727273;21;23;0.0227272727272727;0.477272727272727
Control.SRR15539829;48;45;0.5;24;24;0;0.5
Control.SRR15539829;50;45;0.54;23;27;0.04;0.46
Control.SRR15539829;45;45;0.555555555555556;20;25;0.0555555555555556;0.444444444444444
Control.SRR15539829;40;45;0.55;18;22;0.05;0.45
Control.SRR15539829;40;45;0.575;17;23;0.075;0.425
Control.SRR15539829;50;45;0.48;26;24;0.02;0.48
Control.SRR15539829;40;45;0.45;22;18;0.05;0.45
Control.SRR15539829;44;45;0.522727272727273;21;23;0.0227272727272727;0.477272727272727
Control.SRR15539829;44;45;0.590909090909091;18;26;0.0909090909090909;0.409090909090909
Control.SRR15539829;47;45;0.48936170212766;24;23;0.0106382978723404;0.48936170212766
Control.SRR15539829;40;45;0.575;17;23;0.075;0.425
Control.SRR15539829;44;45;0.636363636363636;16;28;0.136363636363636;0.363636363636364
Control.SRR15539829;51;45;0.509803921568627;25;26;0.00980392156862742;0.490196078431373
Control.SRR15539829;40;45;0.55;18;22;0.05;0.45
Control.SRR15539829;51;45;0.529411764705882;24;27;0.0294117647058824;0.470588235294118
Control.SRR15539829;49;45;0.489795918367347;25;24;0.0102040816326531;0.489795918367347
Control.SRR15539829;41;45;0.463414634146341;22;19;0.0365853658536585;0.463414634146341
Control.SRR15539829;45;45;0.4;27;18;0.1;0.4
Control.SRR15539829;44;45;0.545454545454545;20;24;0.0454545454545454;0.454545454545455
Control.SRR15539829;40;45;0.425;23;17;0.075;0.425
Control.SRR15539829;41;45;0.439024390243902;23;18;0.0609756097560976;0.439024390243902
Control.SRR15539829;49;45;0.510204081632653;24;25;0.0102040816326531;0.489795918367347
Control.SRR15539829;49;45;0.571428571428571;21;28;0.0714285714285714;0.428571428571429
Control.SRR15539829;43;45;0.348837209302326;28;15;0.151162790697674;0.348837209302326
Control.SRR15539829;41;45;0.48780487804878;21;20;0.0121951219512195;0.48780487804878
Control.SRR15539829;42;45;0.595238095238095;17;25;0.0952380952380952;0.404761904761905
Control.SRR15539829;45;45;0.488888888888889;23;22;0.0111111111111111;0.488888888888889
Control.SRR15539829;44;45;0.409090909090909;26;18;0.0909090909090909;0.409090909090909
Control.SRR15539829;45;45;0.466666666666667;24;21;0.0333333333333333;0.466666666666667
Control.SRR15539829;46;45;0.543478260869565;21;25;0.0434782608695652;0.456521739130435
Control.SRR15539829;40;45;0.55;18;22;0.05;0.45
Control.SRR15539829;48;45;0.520833333333333;23;25;0.0208333333333334;0.479166666666667
Control.SRR15539829;45;45;0.511111111111111;22;23;0.0111111111111111;0.488888888888889
Control.SRR15539829;40;45;0.4;24;16;0.1;0.4
Control.SRR15539829;47;45;0.446808510638298;26;21;0.0531914893617021;0.446808510638298
Control.SRR15539829;42;45;0.571428571428571;18;24;0.0714285714285714;0.428571428571429
Control.SRR15539829;48;45;0.5;24;24;0;0.5
Control.SRR15539829;41;45;0.48780487804878;21;20;0.0121951219512195;0.48780487804878
Control.SRR15539829;45;45;0.577777777777778;19;26;0.0777777777777777;0.422222222222222
Control.SRR15539829;52;45;0.346153846153846;34;18;0.153846153846154;0.346153846153846
Control.SRR15539829;52;45;0.653846153846154;18;34;0.153846153846154;0.346153846153846
Control.SRR15539829;47;45;0.468085106382979;25;22;0.0319148936170213;0.468085106382979
Control.SRR15539829;46;45;0.5;23;23;0;0.5
Control.SRR15539829;47;45;0.468085106382979;25;22;0.0319148936170213;0.468085106382979
Control.SRR15539829;50;45;0.36;32;18;0.14;0.36
Control.SRR15539829;45;45;0.622222222222222;17;28;0.122222222222222;0.377777777777778
Control.SRR15539829;43;45;0.465116279069767;23;20;0.0348837209302326;0.465116279069767
Control.SRR15539829;46;45;0.456521739130435;25;21;0.0434782608695652;0.456521739130435
Control.SRR15539829;40;45;0.5;20;20;0;0.5
Control.SRR15539829;48;45;0.458333333333333;26;22;0.0416666666666667;0.458333333333333
Control.SRR15539829;42;45;0.523809523809524;20;22;0.0238095238095238;0.476190476190476
Control.SRR15539829;50;45;0.5;25;25;0;0.5
Control.SRR15539829;43;45;0.581395348837209;18;25;0.0813953488372093;0.418604651162791
Control.SRR15539829;48;45;0.5;24;24;0;0.5
Control.SRR15539829;43;45;0.534883720930233;20;23;0.0348837209302325;0.465116279069767
Control.SRR15539829;49;45;0.489795918367347;25;24;0.0102040816326531;0.489795918367347
Control.SRR15539829;40;45;0.425;23;17;0.075;0.425
Control.SRR15539829;43;45;0.441860465116279;24;19;0.0581395348837209;0.441860465116279
Control.SRR15539829;46;45;0.434782608695652;26;20;0.0652173913043478;0.434782608695652
Control.SRR15539829;45;45;0.622222222222222;17;28;0.122222222222222;0.377777777777778
Control.SRR15539829;45;45;0.422222222222222;26;19;0.0777777777777778;0.422222222222222
Control.SRR15539829;49;45;0.428571428571429;28;21;0.0714285714285715;0.428571428571429
Control.SRR15539829;51;45;0.392156862745098;31;20;0.107843137254902;0.392156862745098
Control.SRR15539829;51;45;0.549019607843137;23;28;0.0490196078431373;0.450980392156863
Control.SRR15539829;44;45;0.386363636363636;27;17;0.113636363636364;0.386363636363636
Control.SRR15539829;51;45;0.392156862745098;31;20;0.107843137254902;0.392156862745098
Control.SRR15539829;50;45;0.46;27;23;0.04;0.46
Control.SRR15539829;51;45;0.431372549019608;29;22;0.0686274509803921;0.431372549019608
Control.SRR15539829;48;45;0.479166666666667;25;23;0.0208333333333333;0.479166666666667
Control.SRR15539829;45;45;0.511111111111111;22;23;0.0111111111111111;0.488888888888889
Control.SRR15539829;43;45;0.465116279069767;23;20;0.0348837209302326;0.465116279069767
Control.SRR15539829;51;45;0.509803921568627;25;26;0.00980392156862742;0.490196078431373
Control.SRR15539829;49;45;0.469387755102041;26;23;0.0306122448979592;0.469387755102041
Control.SRR15539829;51;45;0.509803921568627;25;26;0.00980392156862742;0.490196078431373
Control.SRR15539829;52;45;0.5;26;26;0;0.5
Control.SRR15539829;50;45;0.56;22;28;0.0600000000000001;0.44
Control.SRR15539829;43;45;0.418604651162791;25;18;0.0813953488372093;0.418604651162791
Control.SRR15539829;47;45;0.425531914893617;27;20;0.074468085106383;0.425531914893617
Control.SRR15539829;51;45;0.549019607843137;23;28;0.0490196078431373;0.450980392156863
Control.SRR15539829;46;45;0.391304347826087;28;18;0.108695652173913;0.391304347826087
Control.SRR15539829;43;45;0.372093023255814;27;16;0.127906976744186;0.372093023255814
Control.SRR15539829;40;45;0.5;20;20;0;0.5
Control.SRR15539829;44;45;0.477272727272727;23;21;0.0227272727272727;0.477272727272727
Control.SRR15539829;43;45;0.488372093023256;22;21;0.0116279069767442;0.488372093023256
Control.SRR15539829;45;45;0.6;18;27;0.1;0.4
Control.SRR15539829;43;45;0.441860465116279;24;19;0.0581395348837209;0.441860465116279
Control.SRR15539829;46;45;0.565217391304348;20;26;0.0652173913043478;0.434782608695652
Control.SRR15539829;52;45;0.442307692307692;29;23;0.0576923076923077;0.442307692307692
Control.SRR15539829;49;45;0.428571428571429;28;21;0.0714285714285715;0.428571428571429
Control.SRR15539829;41;45;0.536585365853659;19;22;0.0365853658536586;0.463414634146341
Control.SRR15539829;46;45;0.478260869565217;24;22;0.0217391304347826;0.478260869565217
Control.SRR15539829;49;45;0.510204081632653;24;25;0.0102040816326531;0.489795918367347
Control.SRR15539829;46;45;0.521739130434783;22;24;0.0217391304347826;0.478260869565217
Control.SRR15539829;41;45;0.48780487804878;21;20;0.0121951219512195;0.48780487804878
Control.SRR15539829;43;45;0.348837209302326;28;15;0.151162790697674;0.348837209302326
Control.SRR15539829;49;45;0.428571428571429;28;21;0.0714285714285715;0.428571428571429
Control.SRR15539829;52;45;0.615384615384615;20;32;0.115384615384615;0.384615384615385
Control.SRR15539829;50;45;0.52;24;26;0.02;0.48
Control.SRR15539829;50;45;0.52;24;26;0.02;0.48
Control.SRR15539829;40;45;0.575;17;23;0.075;0.425
Control.SRR15539829;47;45;0.468085106382979;25;22;0.0319148936170213;0.468085106382979
Control.SRR15539829;41;45;0.51219512195122;20;21;0.0121951219512195;0.48780487804878
Control.SRR15539829;46;45;0.521739130434783;22;24;0.0217391304347826;0.478260869565217
Control.SRR15539829;43;45;0.488372093023256;22;21;0.0116279069767442;0.488372093023256
Control.SRR15539829;45;45;0.488888888888889;23;22;0.0111111111111111;0.488888888888889
Control.SRR15539829;42;45;0.404761904761905;25;17;0.0952380952380952;0.404761904761905
Control.SRR15539829;41;45;0.560975609756098;18;23;0.0609756097560976;0.439024390243902
Control.SRR15539829;49;45;0.428571428571429;28;21;0.0714285714285715;0.428571428571429
Control.SRR15539829;40;45;0.525;19;21;0.025;0.475
Control.SRR15539829;44;45;0.522727272727273;21;23;0.0227272727272727;0.477272727272727
Control.SRR15539829;45;45;0.444444444444444;25;20;0.0555555555555556;0.444444444444444
Control.SRR15539829;49;45;0.612244897959184;19;30;0.112244897959184;0.387755102040816
Control.SRR15539829;46;45;0.608695652173913;18;28;0.108695652173913;0.391304347826087
Control.SRR15539829;48;45;0.5625;21;27;0.0625;0.4375
Control.SRR15539829;43;45;0.604651162790698;17;26;0.104651162790698;0.395348837209302
Control.SRR15539829;52;45;0.557692307692308;23;29;0.0576923076923077;0.442307692307692
Control.SRR15539829;45;45;0.511111111111111;22;23;0.0111111111111111;0.488888888888889
Control.SRR15539829;40;45;0.425;23;17;0.075;0.425
Control.SRR15539829;44;45;0.5;22;22;0;0.5
Control.SRR15539829;41;45;0.51219512195122;20;21;0.0121951219512195;0.48780487804878
Control.SRR15539829;46;45;0.543478260869565;21;25;0.0434782608695652;0.456521739130435
Control.SRR15539829;43;45;0.651162790697674;15;28;0.151162790697674;0.348837209302326
Control.SRR15539829;43;45;0.488372093023256;22;21;0.0116279069767442;0.488372093023256
Control.SRR15539829;42;45;0.5;21;21;0;0.5
Control.SRR15539829;44;45;0.522727272727273;21;23;0.0227272727272727;0.477272727272727
Control.SRR15539829;42;45;0.285714285714286;30;12;0.214285714285714;0.285714285714286
Control.SRR15539829;42;45;0.357142857142857;27;15;0.142857142857143;0.357142857142857
Control.SRR15539829;51;45;0.509803921568627;25;26;0.00980392156862742;0.490196078431373
Control.SRR15539829;49;45;0.612244897959184;19;30;0.112244897959184;0.387755102040816
Control.SRR15539829;43;45;0.465116279069767;23;20;0.0348837209302326;0.465116279069767
Control.SRR15539829;48;45;0.395833333333333;29;19;0.104166666666667;0.395833333333333
Control.SRR15539829;43;45;0.488372093023256;22;21;0.0116279069767442;0.488372093023256
Control.SRR15539829;45;45;0.511111111111111;22;23;0.0111111111111111;0.488888888888889
Control.SRR15539829;47;45;0.574468085106383;20;27;0.074468085106383;0.425531914893617
Control.SRR15539829;49;45;0.387755102040816;30;19;0.112244897959184;0.387755102040816
Control.SRR15539829;52;45;0.461538461538462;28;24;0.0384615384615384;0.461538461538462
Control.SRR15539829;40;45;0.525;19;21;0.025;0.475
Control.SRR15539829;45;45;0.555555555555556;20;25;0.0555555555555556;0.444444444444444
Control.SRR15539829;49;45;0.428571428571429;28;21;0.0714285714285715;0.428571428571429
Control.SRR15539829;43;45;0.465116279069767;23;20;0.0348837209302326;0.465116279069767
Control.SRR15539829;51;45;0.509803921568627;25;26;0.00980392156862742;0.490196078431373
Control.SRR15539829;48;45;0.416666666666667;28;20;0.0833333333333333;0.416666666666667
Control.SRR15539829;44;45;0.5;22;22;0;0.5
Control.SRR15539829;45;45;0.377777777777778;28;17;0.122222222222222;0.377777777777778
Control.SRR15539829;51;45;0.588235294117647;21;30;0.0882352941176471;0.411764705882353
Control.SRR15539829;49;45;0.673469387755102;16;33;0.173469387755102;0.326530612244898
Control.SRR15539829;42;45;0.452380952380952;23;19;0.0476190476190476;0.452380952380952
Control.SRR15539829;46;45;0.456521739130435;25;21;0.0434782608695652;0.456521739130435
Control.SRR15539829;44;45;0.5;22;22;0;0.5
Control.SRR15539829;45;45;0.488888888888889;23;22;0.0111111111111111;0.488888888888889
Control.SRR15539829;52;45;0.538461538461538;24;28;0.0384615384615384;0.461538461538462
Control.SRR15539829;52;45;0.596153846153846;21;31;0.0961538461538461;0.403846153846154
Control.SRR15539829;45;45;0.577777777777778;19;26;0.0777777777777777;0.422222222222222
Control.SRR15539829;44;45;0.659090909090909;15;29;0.159090909090909;0.340909090909091
Control.SRR15539829;52;45;0.557692307692308;23;29;0.0576923076923077;0.442307692307692
Control.SRR15539829;49;45;0.469387755102041;26;23;0.0306122448979592;0.469387755102041
Control.SRR15539829;46;45;0.41304347826087;27;19;0.0869565217391304;0.41304347826087
Control.SRR15539829;46;45;0.456521739130435;25;21;0.0434782608695652;0.456521739130435
Control.SRR15539829;49;45;0.530612244897959;23;26;0.0306122448979592;0.469387755102041
Control.SRR15539829;44;45;0.522727272727273;21;23;0.0227272727272727;0.477272727272727
Control.SRR15539829;49;45;0.510204081632653;24;25;0.0102040816326531;0.489795918367347
Control.SRR15539829;44;45;0.545454545454545;20;24;0.0454545454545454;0.454545454545455
Control.SRR15539829;48;45;0.5625;21;27;0.0625;0.4375
Control.SRR15539829;41;45;0.390243902439024;25;16;0.109756097560976;0.390243902439024
Control.SRR15539829;47;45;0.446808510638298;26;21;0.0531914893617021;0.446808510638298
Control.SRR15539829;47;45;0.425531914893617;27;20;0.074468085106383;0.425531914893617
Control.SRR15539829;49;45;0.530612244897959;23;26;0.0306122448979592;0.469387755102041
Control.SRR15539829;48;45;0.520833333333333;23;25;0.0208333333333334;0.479166666666667
Control.SRR15539829;48;45;0.5625;21;27;0.0625;0.4375
Control.SRR15539829;48;45;0.625;18;30;0.125;0.375
Control.SRR15539829;43;45;0.534883720930233;20;23;0.0348837209302325;0.465116279069767
Control.SRR15539829;47;45;0.574468085106383;20;27;0.074468085106383;0.425531914893617
Control.SRR15539829;40;45;0.45;22;18;0.05;0.45
Control.SRR15539829;42;45;0.476190476190476;22;20;0.0238095238095238;0.476190476190476
Control.SRR15539829;48;45;0.416666666666667;28;20;0.0833333333333333;0.416666666666667
Control.SRR15539829;45;45;0.622222222222222;17;28;0.122222222222222;0.377777777777778
Control.SRR15539829;45;45;0.466666666666667;24;21;0.0333333333333333;0.466666666666667
Control.SRR15539829;51;45;0.529411764705882;24;27;0.0294117647058824;0.470588235294118
Control.SRR15539829;49;45;0.469387755102041;26;23;0.0306122448979592;0.469387755102041
Control.SRR15539829;40;45;0.5;20;20;0;0.5
Control.SRR15539829;50;45;0.44;28;22;0.06;0.44
Control.SRR15539829;40;45;0.375;25;15;0.125;0.375
Control.SRR15539829;46;45;0.41304347826087;27;19;0.0869565217391304;0.41304347826087
Control.SRR15539829;41;45;0.48780487804878;21;20;0.0121951219512195;0.48780487804878
Control.SRR15539829;45;45;0.555555555555556;20;25;0.0555555555555556;0.444444444444444
Control.SRR15539829;50;45;0.5;25;25;0;0.5
Control.SRR15539829;40;45;0.525;19;21;0.025;0.475
Control.SRR15539829;46;45;0.5;23;23;0;0.5
Control.SRR15539829;42;45;0.452380952380952;23;19;0.0476190476190476;0.452380952380952
Control.SRR15539829;44;45;0.363636363636364;28;16;0.136363636363636;0.363636363636364
Control.SRR15539829;44;45;0.522727272727273;21;23;0.0227272727272727;0.477272727272727
Control.SRR15539829;51;45;0.490196078431373;26;25;0.00980392156862747;0.490196078431373
Control.SRR15539829;51;45;0.529411764705882;24;27;0.0294117647058824;0.470588235294118
Control.SRR15539829;51;45;0.529411764705882;24;27;0.0294117647058824;0.470588235294118
Control.SRR15539829;45;45;0.555555555555556;20;25;0.0555555555555556;0.444444444444444
Control.SRR15539829;43;45;0.534883720930233;20;23;0.0348837209302325;0.465116279069767
Control.SRR15539829;50;45;0.52;24;26;0.02;0.48
Control.SRR15539829;47;45;0.51063829787234;23;24;0.0106382978723404;0.48936170212766
Control.SRR15539829;48;45;0.520833333333333;23;25;0.0208333333333334;0.479166666666667
Control.SRR15539829;49;45;0.408163265306122;29;20;0.0918367346938775;0.408163265306122
Control.SRR15539829;44;45;0.522727272727273;21;23;0.0227272727272727;0.477272727272727
Control.SRR15539829;40;45;0.475;21;19;0.025;0.475
Control.SRR15539829;47;45;0.595744680851064;19;28;0.0957446808510638;0.404255319148936
Control.SRR15539829;45;45;0.4;27;18;0.1;0.4
Control.SRR15539829;44;45;0.431818181818182;25;19;0.0681818181818182;0.431818181818182
Control.SRR15539829;44;45;0.431818181818182;25;19;0.0681818181818182;0.431818181818182
Control.SRR15539829;46;45;0.5;23;23;0;0.5
Control.SRR15539829;46;45;0.695652173913043;14;32;0.195652173913043;0.304347826086957
Control.SRR15539829;52;45;0.403846153846154;31;21;0.0961538461538461;0.403846153846154
Control.SRR15539829;41;45;0.365853658536585;26;15;0.134146341463415;0.365853658536585
Control.SRR15539829;51;45;0.470588235294118;27;24;0.0294117647058824;0.470588235294118
Control.SRR15539829;52;45;0.557692307692308;23;29;0.0576923076923077;0.442307692307692
Control.SRR15539829;42;45;0.476190476190476;22;20;0.0238095238095238;0.476190476190476
Control.SRR15539829;48;45;0.5;24;24;0;0.5
Control.SRR15539829;43;45;0.488372093023256;22;21;0.0116279069767442;0.488372093023256
Control.SRR15539829;48;45;0.541666666666667;22;26;0.0416666666666666;0.458333333333333
Control.SRR15539829;47;45;0.531914893617021;22;25;0.0319148936170213;0.468085106382979
Control.SRR15539829;41;45;0.439024390243902;23;18;0.0609756097560976;0.439024390243902
Control.SRR15539829;41;45;0.414634146341463;24;17;0.0853658536585366;0.414634146341463
Control.SRR15539829;44;45;0.454545454545455;24;20;0.0454545454545455;0.454545454545455
Control.SRR15539829;44;45;0.590909090909091;18;26;0.0909090909090909;0.409090909090909
Control.SRR15539829;40;45;0.575;17;23;0.075;0.425
Control.SRR15539829;43;45;0.534883720930233;20;23;0.0348837209302325;0.465116279069767
Control.SRR15539829;44;45;0.590909090909091;18;26;0.0909090909090909;0.409090909090909
Control.SRR15539829;46;45;0.630434782608696;17;29;0.130434782608696;0.369565217391304
Control.SRR15539829;41;45;0.48780487804878;21;20;0.0121951219512195;0.48780487804878
Control.SRR15539829;40;45;0.475;21;19;0.025;0.475
Control.SRR15539829;45;45;0.333333333333333;30;15;0.166666666666667;0.333333333333333
Control.SRR15539829;46;45;0.5;23;23;0;0.5
Control.SRR15539829;48;45;0.5;24;24;0;0.5
Control.SRR15539829;44;45;0.409090909090909;26;18;0.0909090909090909;0.409090909090909
Control.SRR15539829;45;45;0.266666666666667;33;12;0.233333333333333;0.266666666666667
Control.SRR15539829;44;45;0.545454545454545;20;24;0.0454545454545454;0.454545454545455
Control.SRR15539829;41;45;0.634146341463415;15;26;0.134146341463415;0.365853658536585
Control.SRR15539829;47;45;0.425531914893617;27;20;0.074468085106383;0.425531914893617
Control.SRR15539829;45;45;0.511111111111111;22;23;0.0111111111111111;0.488888888888889
Control.SRR15539829;49;45;0.36734693877551;31;18;0.13265306122449;0.36734693877551
Control.SRR15539829;41;45;0.585365853658537;17;24;0.0853658536585366;0.414634146341463
Control.SRR15539829;49;45;0.489795918367347;25;24;0.0102040816326531;0.489795918367347
Control.SRR15539829;41;45;0.365853658536585;26;15;0.134146341463415;0.365853658536585
Control.SRR15539829;47;45;0.48936170212766;24;23;0.0106382978723404;0.48936170212766
Control.SRR15539829;40;45;0.6;16;24;0.1;0.4
Control.SRR15539829;42;45;0.571428571428571;18;24;0.0714285714285714;0.428571428571429
Control.SRR15539829;45;45;0.466666666666667;24;21;0.0333333333333333;0.466666666666667
Control.SRR15539829;46;45;0.543478260869565;21;25;0.0434782608695652;0.456521739130435
Control.SRR15539829;51;45;0.450980392156863;28;23;0.0490196078431372;0.450980392156863
Control.SRR15539829;46;45;0.565217391304348;20;26;0.0652173913043478;0.434782608695652
Control.SRR15539829;41;45;0.536585365853659;19;22;0.0365853658536586;0.463414634146341
Control.SRR15539829;51;45;0.431372549019608;29;22;0.0686274509803921;0.431372549019608
Control.SRR15539829;42;45;0.428571428571429;24;18;0.0714285714285715;0.428571428571429
Control.SRR15539829;42;45;0.476190476190476;22;20;0.0238095238095238;0.476190476190476
Control.SRR15539829;43;45;0.604651162790698;17;26;0.104651162790698;0.395348837209302
Control.SRR15539829;41;45;0.48780487804878;21;20;0.0121951219512195;0.48780487804878
Control.SRR15539829;41;45;0.51219512195122;20;21;0.0121951219512195;0.48780487804878
Control.SRR15539829;48;45;0.416666666666667;28;20;0.0833333333333333;0.416666666666667
Control.SRR15539829;40;45;0.525;19;21;0.025;0.475
Control.SRR15539829;43;45;0.465116279069767;23;20;0.0348837209302326;0.465116279069767
Control.SRR15539829;41;45;0.48780487804878;21;20;0.0121951219512195;0.48780487804878
Control.SRR15539829;41;45;0.51219512195122;20;21;0.0121951219512195;0.48780487804878
Control.SRR15539829;41;45;0.390243902439024;25;16;0.109756097560976;0.390243902439024
Control.SRR15539829;43;45;0.418604651162791;25;18;0.0813953488372093;0.418604651162791
Control.SRR15539829;49;45;0.591836734693878;20;29;0.0918367346938775;0.408163265306122
Control.SRR15539829;47;45;0.51063829787234;23;24;0.0106382978723404;0.48936170212766
Control.SRR15539829;48;45;0.583333333333333;20;28;0.0833333333333334;0.416666666666667
Control.SRR15539829;50;45;0.4;30;20;0.1;0.4
Control.SRR15539829;48;45;0.5;24;24;0;0.5
Control.SRR15539829;44;45;0.477272727272727;23;21;0.0227272727272727;0.477272727272727
Control.SRR15539829;51;45;0.411764705882353;30;21;0.0882352941176471;0.411764705882353
Control.SRR15539829;42;45;0.476190476190476;22;20;0.0238095238095238;0.476190476190476
Control.SRR15539829;47;45;0.553191489361702;21;26;0.0531914893617021;0.446808510638298
Control.SRR15539829;48;45;0.416666666666667;28;20;0.0833333333333333;0.416666666666667
Control.SRR15539829;41;45;0.536585365853659;19;22;0.0365853658536586;0.463414634146341
Control.SRR15539829;40;45;0.45;22;18;0.05;0.45
Control.SRR15539829;40;45;0.525;19;21;0.025;0.475
Control.SRR15539829;49;45;0.571428571428571;21;28;0.0714285714285714;0.428571428571429
Control.SRR15539829;50;45;0.46;27;23;0.04;0.46
Control.SRR15539829;42;45;0.452380952380952;23;19;0.0476190476190476;0.452380952380952
Control.SRR15539829;40;45;0.325;27;13;0.175;0.325
Control.SRR15539829;46;45;0.478260869565217;24;22;0.0217391304347826;0.478260869565217
Control.SRR15539829;49;45;0.510204081632653;24;25;0.0102040816326531;0.489795918367347
Control.SRR15539829;52;45;0.480769230769231;27;25;0.0192307692307692;0.480769230769231
Control.SRR15539829;45;45;0.577777777777778;19;26;0.0777777777777777;0.422222222222222
Control.SRR15539829;50;45;0.5;25;25;0;0.5
Control.SRR15539829;41;45;0.560975609756098;18;23;0.0609756097560976;0.439024390243902
Control.SRR15539829;48;45;0.520833333333333;23;25;0.0208333333333334;0.479166666666667
Control.SRR15539829;43;45;0.441860465116279;24;19;0.0581395348837209;0.441860465116279
Control.SRR15539829;46;45;0.456521739130435;25;21;0.0434782608695652;0.456521739130435
Control.SRR15539829;40;45;0.525;19;21;0.025;0.475
Control.SRR15539829;43;45;0.465116279069767;23;20;0.0348837209302326;0.465116279069767
Control.SRR15539829;47;45;0.48936170212766;24;23;0.0106382978723404;0.48936170212766
Control.SRR15539829;43;45;0.534883720930233;20;23;0.0348837209302325;0.465116279069767
Control.SRR15539829;40;45;0.525;19;21;0.025;0.475
Control.SRR15539829;51;45;0.607843137254902;20;31;0.107843137254902;0.392156862745098
Control.SRR15539829;49;45;0.510204081632653;24;25;0.0102040816326531;0.489795918367347
Control.SRR15539829;44;45;0.5;22;22;0;0.5
Control.SRR15539829;44;45;0.5;22;22;0;0.5
Control.SRR15539829;52;45;0.384615384615385;32;20;0.115384615384615;0.384615384615385
Control.SRR15539829;49;45;0.428571428571429;28;21;0.0714285714285715;0.428571428571429
Control.SRR15539829;47;45;0.446808510638298;26;21;0.0531914893617021;0.446808510638298
Control.SRR15539829;40;45;0.525;19;21;0.025;0.475
Control.SRR15539829;51;45;0.549019607843137;23;28;0.0490196078431373;0.450980392156863
Control.SRR15539829;42;45;0.595238095238095;17;25;0.0952380952380952;0.404761904761905
Control.SRR15539829;40;45;0.5;20;20;0;0.5
Control.SRR15539829;47;45;0.404255319148936;28;19;0.0957446808510639;0.404255319148936
Control.SRR15539829;46;45;0.478260869565217;24;22;0.0217391304347826;0.478260869565217
Control.SRR15539829;45;45;0.444444444444444;25;20;0.0555555555555556;0.444444444444444
Control.SRR15539829;51;45;0.568627450980392;22;29;0.0686274509803921;0.431372549019608
Control.SRR15539829;47;45;0.51063829787234;23;24;0.0106382978723404;0.48936170212766
Control.SRR15539829;47;45;0.574468085106383;20;27;0.074468085106383;0.425531914893617
Control.SRR15539829;41;45;0.536585365853659;19;22;0.0365853658536586;0.463414634146341
Control.SRR15539829;49;45;0.489795918367347;25;24;0.0102040816326531;0.489795918367347
Control.SRR15539829;52;45;0.538461538461538;24;28;0.0384615384615384;0.461538461538462
Control.SRR15539829;52;45;0.365384615384615;33;19;0.134615384615385;0.365384615384615
Control.SRR15539829;46;45;0.347826086956522;30;16;0.152173913043478;0.347826086956522
Control.SRR15539829;42;45;0.5;21;21;0;0.5
Control.SRR15539829;47;45;0.595744680851064;19;28;0.0957446808510638;0.404255319148936
Control.SRR15539829;42;45;0.452380952380952;23;19;0.0476190476190476;0.452380952380952
Control.SRR15539829;48;45;0.354166666666667;31;17;0.145833333333333;0.354166666666667
Control.SRR15539829;45;45;0.466666666666667;24;21;0.0333333333333333;0.466666666666667
Control.SRR15539829;43;45;0.395348837209302;26;17;0.104651162790698;0.395348837209302
Control.SRR15539829;41;45;0.439024390243902;23;18;0.0609756097560976;0.439024390243902
Control.SRR15539829;49;45;0.408163265306122;29;20;0.0918367346938775;0.408163265306122
Control.SRR15539829;40;45;0.575;17;23;0.075;0.425
Control.SRR15539829;50;45;0.5;25;25;0;0.5
Control.SRR15539829;49;45;0.469387755102041;26;23;0.0306122448979592;0.469387755102041
Control.SRR15539829;52;45;0.519230769230769;25;27;0.0192307692307693;0.480769230769231
Control.SRR15539829;40;45;0.35;26;14;0.15;0.35
Control.SRR15539829;45;45;0.555555555555556;20;25;0.0555555555555556;0.444444444444444
Control.SRR15539829;52;45;0.519230769230769;25;27;0.0192307692307693;0.480769230769231
Control.SRR15539829;46;45;0.58695652173913;19;27;0.0869565217391305;0.41304347826087
Control.SRR15539829;46;45;0.478260869565217;24;22;0.0217391304347826;0.478260869565217
Control.SRR15539829;49;45;0.489795918367347;25;24;0.0102040816326531;0.489795918367347
Control.SRR15539829;43;45;0.372093023255814;27;16;0.127906976744186;0.372093023255814
Control.SRR15539829;50;45;0.56;22;28;0.0600000000000001;0.44
Control.SRR15539829;40;45;0.675;13;27;0.175;0.325
Control.SRR15539829;43;45;0.558139534883721;19;24;0.0581395348837209;0.441860465116279
Control.SRR15539829;46;45;0.456521739130435;25;21;0.0434782608695652;0.456521739130435
Control.SRR15539829;45;45;0.533333333333333;21;24;0.0333333333333333;0.466666666666667
Control.SRR15539829;46;45;0.565217391304348;20;26;0.0652173913043478;0.434782608695652
Control.SRR15539829;46;45;0.41304347826087;27;19;0.0869565217391304;0.41304347826087
Control.SRR15539829;51;45;0.490196078431373;26;25;0.00980392156862747;0.490196078431373
Control.SRR15539829;50;45;0.52;24;26;0.02;0.48
Control.SRR15539829;46;45;0.391304347826087;28;18;0.108695652173913;0.391304347826087
Control.SRR15539829;48;45;0.5;24;24;0;0.5
Control.SRR15539829;44;45;0.522727272727273;21;23;0.0227272727272727;0.477272727272727
Control.SRR15539829;40;45;0.425;23;17;0.075;0.425
Control.SRR15539829;49;45;0.510204081632653;24;25;0.0102040816326531;0.489795918367347
Control.SRR15539829;43;45;0.465116279069767;23;20;0.0348837209302326;0.465116279069767
Control.SRR15539829;42;45;0.523809523809524;20;22;0.0238095238095238;0.476190476190476
Control.SRR15539829;49;45;0.530612244897959;23;26;0.0306122448979592;0.469387755102041
Control.SRR15539829;51;45;0.490196078431373;26;25;0.00980392156862747;0.490196078431373
Control.SRR15539829;52;45;0.557692307692308;23;29;0.0576923076923077;0.442307692307692
Control.SRR15539829;52;45;0.461538461538462;28;24;0.0384615384615384;0.461538461538462
Control.SRR15539829;45;45;0.466666666666667;24;21;0.0333333333333333;0.466666666666667
Control.SRR15539829;43;45;0.395348837209302;26;17;0.104651162790698;0.395348837209302
Control.SRR15539829;45;45;0.422222222222222;26;19;0.0777777777777778;0.422222222222222
Control.SRR15539829;50;45;0.52;24;26;0.02;0.48
Control.SRR15539829;50;45;0.4;30;20;0.1;0.4
Control.SRR15539829;49;45;0.551020408163265;22;27;0.0510204081632653;0.448979591836735
Control.SRR15539829;45;45;0.422222222222222;26;19;0.0777777777777778;0.422222222222222
Control.SRR15539829;47;45;0.595744680851064;19;28;0.0957446808510638;0.404255319148936
Control.SRR15539829;51;45;0.470588235294118;27;24;0.0294117647058824;0.470588235294118
Control.SRR15539829;49;45;0.551020408163265;22;27;0.0510204081632653;0.448979591836735
Control.SRR15539829;42;45;0.547619047619048;19;23;0.0476190476190477;0.452380952380952
Control.SRR15539829;42;45;0.523809523809524;20;22;0.0238095238095238;0.476190476190476
Control.SRR15539829;42;45;0.5;21;21;0;0.5
Control.SRR15539829;46;45;0.478260869565217;24;22;0.0217391304347826;0.478260869565217
Control.SRR15539829;48;45;0.395833333333333;29;19;0.104166666666667;0.395833333333333
Control.SRR15539829;43;45;0.465116279069767;23;20;0.0348837209302326;0.465116279069767
Control.SRR15539829;47;45;0.51063829787234;23;24;0.0106382978723404;0.48936170212766
Control.SRR15539829;47;45;0.468085106382979;25;22;0.0319148936170213;0.468085106382979
Control.SRR15539829;42;45;0.476190476190476;22;20;0.0238095238095238;0.476190476190476
Control.SRR15539829;41;45;0.48780487804878;21;20;0.0121951219512195;0.48780487804878
Control.SRR15539829;49;45;0.530612244897959;23;26;0.0306122448979592;0.469387755102041
Control.SRR15539829;45;45;0.466666666666667;24;21;0.0333333333333333;0.466666666666667
Control.SRR15539829;40;45;0.55;18;22;0.05;0.45
Control.SRR15539829;41;45;0.536585365853659;19;22;0.0365853658536586;0.463414634146341
Control.SRR15539829;43;45;0.581395348837209;18;25;0.0813953488372093;0.418604651162791
Control.SRR15539829;51;45;0.549019607843137;23;28;0.0490196078431373;0.450980392156863
Control.SRR15539829;47;45;0.553191489361702;21;26;0.0531914893617021;0.446808510638298
Control.SRR15539829;47;45;0.48936170212766;24;23;0.0106382978723404;0.48936170212766
Control.SRR15539829;46;45;0.391304347826087;28;18;0.108695652173913;0.391304347826087
Control.SRR15539829;45;45;0.444444444444444;25;20;0.0555555555555556;0.444444444444444
Control.SRR15539829;41;45;0.560975609756098;18;23;0.0609756097560976;0.439024390243902
Control.SRR15539829;41;45;0.536585365853659;19;22;0.0365853658536586;0.463414634146341
Control.SRR15539829;45;45;0.422222222222222;26;19;0.0777777777777778;0.422222222222222
Control.SRR15539829;45;45;0.444444444444444;25;20;0.0555555555555556;0.444444444444444
Control.SRR15539829;52;45;0.365384615384615;33;19;0.134615384615385;0.365384615384615
Control.SRR15539829;49;45;0.530612244897959;23;26;0.0306122448979592;0.469387755102041
Control.SRR15539829;46;45;0.565217391304348;20;26;0.0652173913043478;0.434782608695652
Control.SRR15539829;46;45;0.478260869565217;24;22;0.0217391304347826;0.478260869565217
Control.SRR15539829;44;45;0.363636363636364;28;16;0.136363636363636;0.363636363636364
Control.SRR15539829;44;45;0.363636363636364;28;16;0.136363636363636;0.363636363636364
Control.SRR15539829;45;45;0.511111111111111;22;23;0.0111111111111111;0.488888888888889
Control.SRR15539829;42;45;0.571428571428571;18;24;0.0714285714285714;0.428571428571429
Control.SRR15539829;45;45;0.422222222222222;26;19;0.0777777777777778;0.422222222222222
Control.SRR15539829;50;45;0.44;28;22;0.06;0.44
Control.SRR15539829;46;45;0.5;23;23;0;0.5
Control.SRR15539829;45;45;0.555555555555556;20;25;0.0555555555555556;0.444444444444444
Control.SRR15539829;44;45;0.431818181818182;25;19;0.0681818181818182;0.431818181818182
Control.SRR15539829;40;45;0.525;19;21;0.025;0.475
Control.SRR15539829;50;45;0.54;23;27;0.04;0.46
Control.SRR15539829;45;45;0.466666666666667;24;21;0.0333333333333333;0.466666666666667
Control.SRR15539829;44;45;0.454545454545455;24;20;0.0454545454545455;0.454545454545455
Control.SRR15539829;40;45;0.6;16;24;0.1;0.4
Control.SRR15539829;47;45;0.574468085106383;20;27;0.074468085106383;0.425531914893617
Control.SRR15539829;47;45;0.51063829787234;23;24;0.0106382978723404;0.48936170212766
Control.SRR15539829;42;45;0.571428571428571;18;24;0.0714285714285714;0.428571428571429
Control.SRR15539829;50;45;0.5;25;25;0;0.5
Control.SRR15539829;45;45;0.622222222222222;17;28;0.122222222222222;0.377777777777778
Control.SRR15539829;43;45;0.465116279069767;23;20;0.0348837209302326;0.465116279069767
Control.SRR15539829;49;45;0.408163265306122;29;20;0.0918367346938775;0.408163265306122
Control.SRR15539829;48;45;0.5625;21;27;0.0625;0.4375
Control.SRR15539829;48;45;0.625;18;30;0.125;0.375
Control.SRR15539829;50;45;0.52;24;26;0.02;0.48
Control.SRR15539829;47;45;0.638297872340426;17;30;0.138297872340426;0.361702127659574
Control.SRR15539829;49;45;0.469387755102041;26;23;0.0306122448979592;0.469387755102041
Control.SRR15539829;41;45;0.414634146341463;24;17;0.0853658536585366;0.414634146341463
Control.SRR15539829;49;45;0.510204081632653;24;25;0.0102040816326531;0.489795918367347
Control.SRR15539829;45;45;0.555555555555556;20;25;0.0555555555555556;0.444444444444444
Control.SRR15539829;48;45;0.375;30;18;0.125;0.375
Control.SRR15539829;49;45;0.530612244897959;23;26;0.0306122448979592;0.469387755102041
Control.SRR15539829;45;45;0.444444444444444;25;20;0.0555555555555556;0.444444444444444
Control.SRR15539829;51;45;0.470588235294118;27;24;0.0294117647058824;0.470588235294118
Control.SRR15539829;46;45;0.543478260869565;21;25;0.0434782608695652;0.456521739130435
Control.SRR15539829;51;45;0.431372549019608;29;22;0.0686274509803921;0.431372549019608
Control.SRR15539829;43;45;0.604651162790698;17;26;0.104651162790698;0.395348837209302
Control.SRR15539829;44;45;0.409090909090909;26;18;0.0909090909090909;0.409090909090909
Control.SRR15539829;47;45;0.531914893617021;22;25;0.0319148936170213;0.468085106382979
Control.SRR15539829;41;45;0.51219512195122;20;21;0.0121951219512195;0.48780487804878
Control.SRR15539829;48;45;0.583333333333333;20;28;0.0833333333333334;0.416666666666667
Control.SRR15539829;43;45;0.604651162790698;17;26;0.104651162790698;0.395348837209302
Control.SRR15539829;45;45;0.577777777777778;19;26;0.0777777777777777;0.422222222222222
Control.SRR15539829;50;45;0.54;23;27;0.04;0.46
Control.SRR15539829;50;45;0.56;22;28;0.0600000000000001;0.44
Control.SRR15539829;50;45;0.48;26;24;0.02;0.48
Control.SRR15539829;49;45;0.428571428571429;28;21;0.0714285714285715;0.428571428571429
Control.SRR15539829;41;45;0.48780487804878;21;20;0.0121951219512195;0.48780487804878
Control.SRR15539829;43;45;0.465116279069767;23;20;0.0348837209302326;0.465116279069767
Control.SRR15539829;43;45;0.511627906976744;21;22;0.0116279069767442;0.488372093023256
Control.SRR15539829;40;45;0.325;27;13;0.175;0.325
Control.SRR15539829;40;45;0.35;26;14;0.15;0.35
Control.SRR15539829;50;45;0.48;26;24;0.02;0.48
Control.SRR15539829;48;45;0.645833333333333;17;31;0.145833333333333;0.354166666666667
Control.SRR15539829;51;45;0.411764705882353;30;21;0.0882352941176471;0.411764705882353
Control.SRR15539829;52;45;0.442307692307692;29;23;0.0576923076923077;0.442307692307692
Control.SRR15539829;49;45;0.408163265306122;29;20;0.0918367346938775;0.408163265306122
Control.SRR15539829;51;45;0.549019607843137;23;28;0.0490196078431373;0.450980392156863
Control.SRR15539829;50;45;0.5;25;25;0;0.5
Control.SRR15539829;48;45;0.458333333333333;26;22;0.0416666666666667;0.458333333333333
Control.SRR15539829;42;45;0.476190476190476;22;20;0.0238095238095238;0.476190476190476
Control.SRR15539829;50;45;0.48;26;24;0.02;0.48
Control.SRR15539829;47;45;0.553191489361702;21;26;0.0531914893617021;0.446808510638298
Control.SRR15539829;48;45;0.458333333333333;26;22;0.0416666666666667;0.458333333333333
Control.SRR15539829;45;45;0.4;27;18;0.1;0.4
Control.SRR15539829;45;45;0.511111111111111;22;23;0.0111111111111111;0.488888888888889
Control.SRR15539829;47;45;0.446808510638298;26;21;0.0531914893617021;0.446808510638298
Control.SRR15539829;47;45;0.468085106382979;25;22;0.0319148936170213;0.468085106382979
Control.SRR15539829;43;45;0.465116279069767;23;20;0.0348837209302326;0.465116279069767
Control.SRR15539829;51;45;0.725490196078431;14;37;0.225490196078431;0.274509803921569
Control.SRR15539829;46;45;0.543478260869565;21;25;0.0434782608695652;0.456521739130435
Control.SRR15539829;50;45;0.62;19;31;0.12;0.38
Control.SRR15539829;40;45;0.45;22;18;0.05;0.45
Control.SRR15539829;46;45;0.456521739130435;25;21;0.0434782608695652;0.456521739130435
Control.SRR15539829;51;45;0.431372549019608;29;22;0.0686274509803921;0.431372549019608
Control.SRR15539829;44;45;0.386363636363636;27;17;0.113636363636364;0.386363636363636
Control.SRR15539829;49;45;0.530612244897959;23;26;0.0306122448979592;0.469387755102041
Control.SRR15539829;48;45;0.416666666666667;28;20;0.0833333333333333;0.416666666666667
Control.SRR15539829;40;45;0.475;21;19;0.025;0.475
Control.SRR15539829;47;45;0.446808510638298;26;21;0.0531914893617021;0.446808510638298
Control.SRR15539829;51;45;0.411764705882353;30;21;0.0882352941176471;0.411764705882353
Control.SRR15539829;41;45;0.414634146341463;24;17;0.0853658536585366;0.414634146341463
Control.SRR15539829;49;45;0.510204081632653;24;25;0.0102040816326531;0.489795918367347
Control.SRR15539829;48;45;0.583333333333333;20;28;0.0833333333333334;0.416666666666667
Control.SRR15539829;49;45;0.530612244897959;23;26;0.0306122448979592;0.469387755102041
Control.SRR15539829;45;45;0.422222222222222;26;19;0.0777777777777778;0.422222222222222
Control.SRR15539829;50;45;0.36;32;18;0.14;0.36
Control.SRR15539829;43;45;0.465116279069767;23;20;0.0348837209302326;0.465116279069767
Control.SRR15539829;41;45;0.439024390243902;23;18;0.0609756097560976;0.439024390243902
Control.SRR15539829;47;45;0.425531914893617;27;20;0.074468085106383;0.425531914893617
Control.SRR15539829;44;45;0.5;22;22;0;0.5
Control.SRR15539829;45;45;0.466666666666667;24;21;0.0333333333333333;0.466666666666667
Control.SRR15539829;49;45;0.551020408163265;22;27;0.0510204081632653;0.448979591836735
Control.SRR15539829;49;45;0.448979591836735;27;22;0.0510204081632653;0.448979591836735
Control.SRR15539829;48;45;0.520833333333333;23;25;0.0208333333333334;0.479166666666667
Control.SRR15539829;50;45;0.58;21;29;0.08;0.42
Control.SRR15539829;40;45;0.45;22;18;0.05;0.45
Control.SRR15539829;52;45;0.519230769230769;25;27;0.0192307692307693;0.480769230769231
Control.SRR15539829;49;45;0.408163265306122;29;20;0.0918367346938775;0.408163265306122
Control.SRR15539829;47;45;0.638297872340426;17;30;0.138297872340426;0.361702127659574
Control.SRR15539829;48;45;0.4375;27;21;0.0625;0.4375
Control.SRR15539829;47;45;0.425531914893617;27;20;0.074468085106383;0.425531914893617
Control.SRR15539829;43;45;0.418604651162791;25;18;0.0813953488372093;0.418604651162791
Control.SRR15539829;42;45;0.5;21;21;0;0.5
Control.SRR15539829;47;45;0.468085106382979;25;22;0.0319148936170213;0.468085106382979
Control.SRR15539829;46;45;0.521739130434783;22;24;0.0217391304347826;0.478260869565217
Control.SRR15539829;44;45;0.659090909090909;15;29;0.159090909090909;0.340909090909091
Control.SRR15539829;41;45;0.317073170731707;28;13;0.182926829268293;0.317073170731707
Control.SRR15539829;47;45;0.446808510638298;26;21;0.0531914893617021;0.446808510638298
Control.SRR15539829;47;45;0.74468085106383;12;35;0.24468085106383;0.25531914893617
Control.SRR15539829;40;45;0.575;17;23;0.075;0.425
Control.SRR15539829;47;45;0.51063829787234;23;24;0.0106382978723404;0.48936170212766
Control.SRR15539829;41;45;0.341463414634146;27;14;0.158536585365854;0.341463414634146
Control.SRR15539829;41;45;0.463414634146341;22;19;0.0365853658536585;0.463414634146341
Control.SRR15539829;44;45;0.522727272727273;21;23;0.0227272727272727;0.477272727272727
Control.SRR15539829;45;45;0.511111111111111;22;23;0.0111111111111111;0.488888888888889
Control.SRR15539829;51;45;0.588235294117647;21;30;0.0882352941176471;0.411764705882353
Control.SRR15539829;45;45;0.422222222222222;26;19;0.0777777777777778;0.422222222222222
Control.SRR15539829;50;45;0.4;30;20;0.1;0.4
Control.SRR15539829;50;45;0.48;26;24;0.02;0.48
Control.SRR15539829;51;45;0.529411764705882;24;27;0.0294117647058824;0.470588235294118
Control.SRR15539829;42;45;0.571428571428571;18;24;0.0714285714285714;0.428571428571429
Control.SRR15539829;45;45;0.466666666666667;24;21;0.0333333333333333;0.466666666666667
Control.SRR15539829;41;45;0.634146341463415;15;26;0.134146341463415;0.365853658536585
Control.SRR15539829;41;45;0.463414634146341;22;19;0.0365853658536585;0.463414634146341
Control.SRR15539829;45;45;0.422222222222222;26;19;0.0777777777777778;0.422222222222222
Control.SRR15539829;40;45;0.475;21;19;0.025;0.475
Control.SRR15539829;47;45;0.404255319148936;28;19;0.0957446808510639;0.404255319148936
Control.SRR15539829;47;45;0.553191489361702;21;26;0.0531914893617021;0.446808510638298
Control.SRR15539829;51;45;0.509803921568627;25;26;0.00980392156862742;0.490196078431373
Control.SRR15539829;40;45;0.575;17;23;0.075;0.425
Control.SRR15539829;41;45;0.536585365853659;19;22;0.0365853658536586;0.463414634146341
Control.SRR15539829;40;45;0.55;18;22;0.05;0.45
Control.SRR15539829;44;45;0.568181818181818;19;25;0.0681818181818182;0.431818181818182
Control.SRR15539829;49;45;0.591836734693878;20;29;0.0918367346938775;0.408163265306122
Control.SRR15539829;42;45;0.523809523809524;20;22;0.0238095238095238;0.476190476190476
Control.SRR15539829;41;45;0.48780487804878;21;20;0.0121951219512195;0.48780487804878
Control.SRR15539829;43;45;0.534883720930233;20;23;0.0348837209302325;0.465116279069767
Control.SRR15539829;52;45;0.423076923076923;30;22;0.0769230769230769;0.423076923076923
Control.SRR15539829;51;45;0.470588235294118;27;24;0.0294117647058824;0.470588235294118
Control.SRR15539829;52;45;0.5;26;26;0;0.5
Control.SRR15539829;46;45;0.456521739130435;25;21;0.0434782608695652;0.456521739130435
Control.SRR15539829;45;45;0.444444444444444;25;20;0.0555555555555556;0.444444444444444
Control.SRR15539829;43;45;0.581395348837209;18;25;0.0813953488372093;0.418604651162791
Control.SRR15539829;51;45;0.588235294117647;21;30;0.0882352941176471;0.411764705882353
Control.SRR15539829;50;45;0.52;24;26;0.02;0.48
Control.SRR15539829;44;45;0.5;22;22;0;0.5
Control.SRR15539829;50;45;0.66;17;33;0.16;0.34
Control.SRR15539829;51;45;0.450980392156863;28;23;0.0490196078431372;0.450980392156863
Control.SRR15539829;47;45;0.468085106382979;25;22;0.0319148936170213;0.468085106382979
Control.SRR15539829;51;45;0.431372549019608;29;22;0.0686274509803921;0.431372549019608
Control.SRR15539829;50;45;0.48;26;24;0.02;0.48
Control.SRR15539829;50;45;0.48;26;24;0.02;0.48
Control.SRR15539829;44;45;0.659090909090909;15;29;0.159090909090909;0.340909090909091
Control.SRR15539829;51;45;0.490196078431373;26;25;0.00980392156862747;0.490196078431373
Control.SRR15539829;47;45;0.531914893617021;22;25;0.0319148936170213;0.468085106382979
Control.SRR15539829;48;45;0.4375;27;21;0.0625;0.4375
Control.SRR15539829;45;45;0.422222222222222;26;19;0.0777777777777778;0.422222222222222
Control.SRR15539829;47;45;0.446808510638298;26;21;0.0531914893617021;0.446808510638298
Control.SRR15539829;51;45;0.549019607843137;23;28;0.0490196078431373;0.450980392156863
Control.SRR15539829;51;45;0.568627450980392;22;29;0.0686274509803921;0.431372549019608
Control.SRR15539829;47;45;0.51063829787234;23;24;0.0106382978723404;0.48936170212766
Control.SRR15539829;49;45;0.510204081632653;24;25;0.0102040816326531;0.489795918367347
Control.SRR15539829;44;45;0.545454545454545;20;24;0.0454545454545454;0.454545454545455
Control.SRR15539829;41;45;0.341463414634146;27;14;0.158536585365854;0.341463414634146
Control.SRR15539829;50;45;0.44;28;22;0.06;0.44
Control.SRR15539829;48;45;0.5;24;24;0;0.5
Control.SRR15539829;51;45;0.549019607843137;23;28;0.0490196078431373;0.450980392156863
Control.SRR15539829;42;45;0.547619047619048;19;23;0.0476190476190477;0.452380952380952
Control.SRR15539829;47;45;0.425531914893617;27;20;0.074468085106383;0.425531914893617
Control.SRR15539829;43;45;0.488372093023256;22;21;0.0116279069767442;0.488372093023256
Control.SRR15539829;52;45;0.461538461538462;28;24;0.0384615384615384;0.461538461538462
Control.SRR15539829;52;45;0.5;26;26;0;0.5
Control.SRR15539829;43;45;0.488372093023256;22;21;0.0116279069767442;0.488372093023256
Control.SRR15539829;44;45;0.386363636363636;27;17;0.113636363636364;0.386363636363636
Control.SRR15539829;43;45;0.534883720930233;20;23;0.0348837209302325;0.465116279069767
Control.SRR15539829;52;45;0.615384615384615;20;32;0.115384615384615;0.384615384615385
Control.SRR15539829;46;45;0.41304347826087;27;19;0.0869565217391304;0.41304347826087
Control.SRR15539829;45;45;0.466666666666667;24;21;0.0333333333333333;0.466666666666667
Control.SRR15539829;43;45;0.511627906976744;21;22;0.0116279069767442;0.488372093023256
Control.SRR15539829;43;45;0.488372093023256;22;21;0.0116279069767442;0.488372093023256
Control.SRR15539829;50;45;0.54;23;27;0.04;0.46
Control.SRR15539829;49;45;0.469387755102041;26;23;0.0306122448979592;0.469387755102041
Control.SRR15539829;43;45;0.441860465116279;24;19;0.0581395348837209;0.441860465116279
Control.SRR15539829;41;45;0.48780487804878;21;20;0.0121951219512195;0.48780487804878
Control.SRR15539829;50;45;0.44;28;22;0.06;0.44
Control.SRR15539829;42;45;0.547619047619048;19;23;0.0476190476190477;0.452380952380952
Control.SRR15539829;45;45;0.511111111111111;22;23;0.0111111111111111;0.488888888888889
Control.SRR15539829;51;45;0.588235294117647;21;30;0.0882352941176471;0.411764705882353
Control.SRR15539829;49;45;0.653061224489796;17;32;0.153061224489796;0.346938775510204
Control.SRR15539829;46;45;0.608695652173913;18;28;0.108695652173913;0.391304347826087
Control.SRR15539829;42;45;0.452380952380952;23;19;0.0476190476190476;0.452380952380952
Control.SRR15539829;50;45;0.36;32;18;0.14;0.36
Control.SRR15539829;48;45;0.666666666666667;16;32;0.166666666666667;0.333333333333333
Control.SRR15539829;48;45;0.479166666666667;25;23;0.0208333333333333;0.479166666666667
Control.SRR15539829;49;45;0.612244897959184;19;30;0.112244897959184;0.387755102040816
Control.SRR15539829;44;45;0.522727272727273;21;23;0.0227272727272727;0.477272727272727
Control.SRR15539829;52;45;0.480769230769231;27;25;0.0192307692307692;0.480769230769231
Control.SRR15539829;44;45;0.431818181818182;25;19;0.0681818181818182;0.431818181818182
Control.SRR15539829;44;45;0.590909090909091;18;26;0.0909090909090909;0.409090909090909
Control.SRR15539829;51;45;0.568627450980392;22;29;0.0686274509803921;0.431372549019608
Control.SRR15539829;50;45;0.48;26;24;0.02;0.48
Control.SRR15539829;48;45;0.541666666666667;22;26;0.0416666666666666;0.458333333333333
Control.SRR15539829;44;45;0.5;22;22;0;0.5
Control.SRR15539829;50;45;0.5;25;25;0;0.5
Control.SRR15539829;43;45;0.488372093023256;22;21;0.0116279069767442;0.488372093023256
Control.SRR15539829;46;45;0.391304347826087;28;18;0.108695652173913;0.391304347826087
Control.SRR15539829;52;45;0.519230769230769;25;27;0.0192307692307693;0.480769230769231
Control.SRR15539829;49;45;0.63265306122449;18;31;0.13265306122449;0.36734693877551
Control.SRR15539829;43;45;0.558139534883721;19;24;0.0581395348837209;0.441860465116279
Control.SRR15539829;46;45;0.369565217391304;29;17;0.130434782608696;0.369565217391304
Control.SRR15539829;48;45;0.4375;27;21;0.0625;0.4375
Control.SRR15539829;49;45;0.346938775510204;32;17;0.153061224489796;0.346938775510204
Control.SRR15539829;50;45;0.46;27;23;0.04;0.46
Control.SRR15539829;49;45;0.448979591836735;27;22;0.0510204081632653;0.448979591836735
Control.SRR15539829;45;45;0.488888888888889;23;22;0.0111111111111111;0.488888888888889
Control.SRR15539829;42;45;0.523809523809524;20;22;0.0238095238095238;0.476190476190476
Control.SRR15539829;50;45;0.48;26;24;0.02;0.48
Control.SRR15539829;49;45;0.530612244897959;23;26;0.0306122448979592;0.469387755102041
Control.SRR15539829;48;45;0.5625;21;27;0.0625;0.4375
Control.SRR15539829;47;45;0.425531914893617;27;20;0.074468085106383;0.425531914893617
Control.SRR15539829;44;45;0.545454545454545;20;24;0.0454545454545454;0.454545454545455
Control.SRR15539829;51;45;0.549019607843137;23;28;0.0490196078431373;0.450980392156863
Control.SRR15539829;47;45;0.48936170212766;24;23;0.0106382978723404;0.48936170212766
Control.SRR15539829;44;45;0.454545454545455;24;20;0.0454545454545455;0.454545454545455
Control.SRR15539829;52;45;0.557692307692308;23;29;0.0576923076923077;0.442307692307692
Control.SRR15539829;49;45;0.489795918367347;25;24;0.0102040816326531;0.489795918367347
Control.SRR15539829;44;45;0.454545454545455;24;20;0.0454545454545455;0.454545454545455
Control.SRR15539829;45;45;0.533333333333333;21;24;0.0333333333333333;0.466666666666667
Control.SRR15539829;47;45;0.404255319148936;28;19;0.0957446808510639;0.404255319148936
Control.SRR15539829;48;45;0.666666666666667;16;32;0.166666666666667;0.333333333333333
Control.SRR15539829;45;45;0.422222222222222;26;19;0.0777777777777778;0.422222222222222
Control.SRR15539829;45;45;0.444444444444444;25;20;0.0555555555555556;0.444444444444444
Control.SRR15539829;50;45;0.52;24;26;0.02;0.48
Control.SRR15539829;52;45;0.480769230769231;27;25;0.0192307692307692;0.480769230769231
Control.SRR15539829;50;45;0.48;26;24;0.02;0.48
Control.SRR15539829;49;45;0.571428571428571;21;28;0.0714285714285714;0.428571428571429
Control.SRR15539829;52;45;0.461538461538462;28;24;0.0384615384615384;0.461538461538462
Control.SRR15539829;45;45;0.577777777777778;19;26;0.0777777777777777;0.422222222222222
Control.SRR15539829;47;45;0.468085106382979;25;22;0.0319148936170213;0.468085106382979
Control.SRR15539829;46;45;0.565217391304348;20;26;0.0652173913043478;0.434782608695652
Control.SRR15539829;49;45;0.612244897959184;19;30;0.112244897959184;0.387755102040816
Control.SRR15539829;52;45;0.653846153846154;18;34;0.153846153846154;0.346153846153846
Control.SRR15539829;47;45;0.48936170212766;24;23;0.0106382978723404;0.48936170212766
Control.SRR15539829;48;45;0.458333333333333;26;22;0.0416666666666667;0.458333333333333
Control.SRR15539829;41;45;0.48780487804878;21;20;0.0121951219512195;0.48780487804878
Control.SRR15539829;41;45;0.463414634146341;22;19;0.0365853658536585;0.463414634146341
Control.SRR15539829;50;45;0.42;29;21;0.08;0.42
Control.SRR15539829;47;45;0.48936170212766;24;23;0.0106382978723404;0.48936170212766
Control.SRR15539829;45;45;0.577777777777778;19;26;0.0777777777777777;0.422222222222222
Control.SRR15539829;43;45;0.488372093023256;22;21;0.0116279069767442;0.488372093023256
Control.SRR15539829;40;45;0.5;20;20;0;0.5
Control.SRR15539829;51;45;0.372549019607843;32;19;0.127450980392157;0.372549019607843
Control.SRR15539829;51;45;0.450980392156863;28;23;0.0490196078431372;0.450980392156863
Control.SRR15539829;50;45;0.44;28;22;0.06;0.44
Control.SRR15539829;51;45;0.588235294117647;21;30;0.0882352941176471;0.411764705882353
Control.SRR15539829;45;45;0.444444444444444;25;20;0.0555555555555556;0.444444444444444
Control.SRR15539829;40;45;0.525;19;21;0.025;0.475
Control.SRR15539829;49;45;0.571428571428571;21;28;0.0714285714285714;0.428571428571429
Control.SRR15539829;51;45;0.411764705882353;30;21;0.0882352941176471;0.411764705882353
Control.SRR15539829;51;45;0.529411764705882;24;27;0.0294117647058824;0.470588235294118
Control.SRR15539829;45;45;0.466666666666667;24;21;0.0333333333333333;0.466666666666667
Control.SRR15539829;50;45;0.48;26;24;0.02;0.48
Control.SRR15539829;49;45;0.489795918367347;25;24;0.0102040816326531;0.489795918367347
Control.SRR15539829;41;45;0.439024390243902;23;18;0.0609756097560976;0.439024390243902
Control.SRR15539829;50;45;0.54;23;27;0.04;0.46
Control.SRR15539829;51;45;0.529411764705882;24;27;0.0294117647058824;0.470588235294118
Control.SRR15539829;47;45;0.553191489361702;21;26;0.0531914893617021;0.446808510638298
Control.SRR15539829;42;45;0.452380952380952;23;19;0.0476190476190476;0.452380952380952
Control.SRR15539829;49;45;0.510204081632653;24;25;0.0102040816326531;0.489795918367347
Control.SRR15539829;49;45;0.551020408163265;22;27;0.0510204081632653;0.448979591836735
Control.SRR15539829;48;45;0.541666666666667;22;26;0.0416666666666666;0.458333333333333
Control.SRR15539829;48;45;0.354166666666667;31;17;0.145833333333333;0.354166666666667
Control.SRR15539829;45;45;0.555555555555556;20;25;0.0555555555555556;0.444444444444444
Control.SRR15539829;40;45;0.575;17;23;0.075;0.425
Control.SRR15539829;49;45;0.551020408163265;22;27;0.0510204081632653;0.448979591836735
Control.SRR15539829;40;45;0.45;22;18;0.05;0.45
Control.SRR15539829;51;45;0.450980392156863;28;23;0.0490196078431372;0.450980392156863
Control.SRR15539829;41;45;0.560975609756098;18;23;0.0609756097560976;0.439024390243902
Control.SRR15539829;50;45;0.48;26;24;0.02;0.48
Control.SRR15539829;49;45;0.346938775510204;32;17;0.153061224489796;0.346938775510204
Control.SRR15539829;49;45;0.510204081632653;24;25;0.0102040816326531;0.489795918367347
Control.SRR15539829;41;45;0.463414634146341;22;19;0.0365853658536585;0.463414634146341
Control.SRR15539829;43;45;0.581395348837209;18;25;0.0813953488372093;0.418604651162791
Control.SRR15539829;49;45;0.571428571428571;21;28;0.0714285714285714;0.428571428571429
Control.SRR15539829;51;45;0.509803921568627;25;26;0.00980392156862742;0.490196078431373
Control.SRR15539829;51;45;0.509803921568627;25;26;0.00980392156862742;0.490196078431373
Control.SRR15539829;51;45;0.529411764705882;24;27;0.0294117647058824;0.470588235294118
Control.SRR15539829;51;45;0.568627450980392;22;29;0.0686274509803921;0.431372549019608
Control.SRR15539829;47;45;0.446808510638298;26;21;0.0531914893617021;0.446808510638298
Control.SRR15539829;50;45;0.5;25;25;0;0.5
Control.SRR15539829;50;45;0.42;29;21;0.08;0.42
Control.SRR15539829;48;45;0.4375;27;21;0.0625;0.4375
Control.SRR15539829;48;45;0.541666666666667;22;26;0.0416666666666666;0.458333333333333
Control.SRR15539829;44;45;0.431818181818182;25;19;0.0681818181818182;0.431818181818182
Control.SRR15539829;43;45;0.534883720930233;20;23;0.0348837209302325;0.465116279069767
Control.SRR15539829;48;45;0.520833333333333;23;25;0.0208333333333334;0.479166666666667
Control.SRR15539829;41;45;0.48780487804878;21;20;0.0121951219512195;0.48780487804878
Control.SRR15539829;47;45;0.446808510638298;26;21;0.0531914893617021;0.446808510638298
Control.SRR15539829;49;45;0.551020408163265;22;27;0.0510204081632653;0.448979591836735
Control.SRR15539829;46;45;0.608695652173913;18;28;0.108695652173913;0.391304347826087
Control.SRR15539829;41;45;0.439024390243902;23;18;0.0609756097560976;0.439024390243902
Control.SRR15539829;48;45;0.520833333333333;23;25;0.0208333333333334;0.479166666666667
Control.SRR15539829;51;45;0.509803921568627;25;26;0.00980392156862742;0.490196078431373
Control.SRR15539829;42;45;0.5;21;21;0;0.5
Control.SRR15539829;48;45;0.5;24;24;0;0.5
Control.SRR15539829;50;45;0.56;22;28;0.0600000000000001;0.44
Control.SRR15539829;48;45;0.458333333333333;26;22;0.0416666666666667;0.458333333333333
Control.SRR15539829;40;45;0.475;21;19;0.025;0.475
Control.SRR15539829;48;45;0.583333333333333;20;28;0.0833333333333334;0.416666666666667
Control.SRR15539829;51;45;0.490196078431373;26;25;0.00980392156862747;0.490196078431373
Control.SRR15539829;48;45;0.5;24;24;0;0.5
Control.SRR15539829;47;45;0.340425531914894;31;16;0.159574468085106;0.340425531914894
Control.SRR15539829;44;45;0.409090909090909;26;18;0.0909090909090909;0.409090909090909
Control.SRR15539829;51;45;0.549019607843137;23;28;0.0490196078431373;0.450980392156863
Control.SRR15539829;44;45;0.568181818181818;19;25;0.0681818181818182;0.431818181818182
Control.SRR15539829;40;45;0.525;19;21;0.025;0.475
Control.SRR15539829;47;45;0.48936170212766;24;23;0.0106382978723404;0.48936170212766
Control.SRR15539829;48;45;0.520833333333333;23;25;0.0208333333333334;0.479166666666667
Control.SRR15539829;45;45;0.555555555555556;20;25;0.0555555555555556;0.444444444444444
Control.SRR15539829;44;45;0.545454545454545;20;24;0.0454545454545454;0.454545454545455
Control.SRR15539829;51;45;0.431372549019608;29;22;0.0686274509803921;0.431372549019608
Control.SRR15539829;51;45;0.627450980392157;19;32;0.127450980392157;0.372549019607843
Control.SRR15539829;44;45;0.568181818181818;19;25;0.0681818181818182;0.431818181818182
Control.SRR15539829;51;45;0.549019607843137;23;28;0.0490196078431373;0.450980392156863
Control.SRR15539829;48;45;0.458333333333333;26;22;0.0416666666666667;0.458333333333333
Control.SRR15539829;51;45;0.352941176470588;33;18;0.147058823529412;0.352941176470588
Control.SRR15539829;41;45;0.390243902439024;25;16;0.109756097560976;0.390243902439024
Control.SRR15539829;50;45;0.42;29;21;0.08;0.42
Control.SRR15539829;52;45;0.5;26;26;0;0.5
Control.SRR15539829;45;45;0.422222222222222;26;19;0.0777777777777778;0.422222222222222
Control.SRR15539829;43;45;0.558139534883721;19;24;0.0581395348837209;0.441860465116279
Control.SRR15539829;50;45;0.44;28;22;0.06;0.44
Control.SRR15539829;46;45;0.5;23;23;0;0.5
Control.SRR15539829;44;45;0.590909090909091;18;26;0.0909090909090909;0.409090909090909
Control.SRR15539829;40;45;0.55;18;22;0.05;0.45
Control.SRR15539829;44;45;0.545454545454545;20;24;0.0454545454545454;0.454545454545455
Control.SRR15539829;42;45;0.523809523809524;20;22;0.0238095238095238;0.476190476190476
Control.SRR15539829;43;45;0.511627906976744;21;22;0.0116279069767442;0.488372093023256
Control.SRR15539829;44;45;0.454545454545455;24;20;0.0454545454545455;0.454545454545455
Control.SRR15539829;43;45;0.488372093023256;22;21;0.0116279069767442;0.488372093023256
Control.SRR15539829;50;45;0.48;26;24;0.02;0.48
Control.SRR15539829;41;45;0.48780487804878;21;20;0.0121951219512195;0.48780487804878
Control.SRR15539829;46;45;0.41304347826087;27;19;0.0869565217391304;0.41304347826087
Control.SRR15539829;43;45;0.511627906976744;21;22;0.0116279069767442;0.488372093023256
Control.SRR15539829;50;45;0.34;33;17;0.16;0.34
Control.SRR15539829;45;45;0.466666666666667;24;21;0.0333333333333333;0.466666666666667
Control.SRR15539829;52;45;0.442307692307692;29;23;0.0576923076923077;0.442307692307692
Control.SRR15539829;43;45;0.465116279069767;23;20;0.0348837209302326;0.465116279069767
Control.SRR15539829;51;45;0.450980392156863;28;23;0.0490196078431372;0.450980392156863
Control.SRR15539829;44;45;0.545454545454545;20;24;0.0454545454545454;0.454545454545455
Control.SRR15539829;46;45;0.434782608695652;26;20;0.0652173913043478;0.434782608695652
Control.SRR15539829;47;45;0.425531914893617;27;20;0.074468085106383;0.425531914893617
Control.SRR15539829;42;45;0.523809523809524;20;22;0.0238095238095238;0.476190476190476
Control.SRR15539829;42;45;0.428571428571429;24;18;0.0714285714285715;0.428571428571429
Control.SRR15539829;49;45;0.530612244897959;23;26;0.0306122448979592;0.469387755102041
Control.SRR15539829;42;45;0.5;21;21;0;0.5
Control.SRR15539829;41;45;0.51219512195122;20;21;0.0121951219512195;0.48780487804878
Control.SRR15539829;51;45;0.568627450980392;22;29;0.0686274509803921;0.431372549019608
Control.SRR15539829;46;45;0.347826086956522;30;16;0.152173913043478;0.347826086956522
Control.SRR15539829;50;45;0.56;22;28;0.0600000000000001;0.44
Control.SRR15539829;43;45;0.418604651162791;25;18;0.0813953488372093;0.418604651162791
Control.SRR15539829;51;45;0.490196078431373;26;25;0.00980392156862747;0.490196078431373
Control.SRR15539829;44;45;0.590909090909091;18;26;0.0909090909090909;0.409090909090909
Control.SRR15539829;45;45;0.4;27;18;0.1;0.4
Control.SRR15539829;48;45;0.583333333333333;20;28;0.0833333333333334;0.416666666666667
Control.SRR15539829;48;45;0.416666666666667;28;20;0.0833333333333333;0.416666666666667
Control.SRR15539829;42;45;0.571428571428571;18;24;0.0714285714285714;0.428571428571429
Control.SRR15539829;52;45;0.596153846153846;21;31;0.0961538461538461;0.403846153846154
Control.SRR15539829;51;45;0.411764705882353;30;21;0.0882352941176471;0.411764705882353
Control.SRR15539829;49;45;0.469387755102041;26;23;0.0306122448979592;0.469387755102041
Control.SRR15539829;41;45;0.439024390243902;23;18;0.0609756097560976;0.439024390243902
Control.SRR15539829;50;45;0.34;33;17;0.16;0.34
Control.SRR15539829;44;45;0.545454545454545;20;24;0.0454545454545454;0.454545454545455
Control.SRR15539829;43;45;0.581395348837209;18;25;0.0813953488372093;0.418604651162791
Control.SRR15539829;46;45;0.565217391304348;20;26;0.0652173913043478;0.434782608695652
Control.SRR15539829;51;45;0.411764705882353;30;21;0.0882352941176471;0.411764705882353
Control.SRR15539829;48;45;0.479166666666667;25;23;0.0208333333333333;0.479166666666667
Control.SRR15539829;46;45;0.521739130434783;22;24;0.0217391304347826;0.478260869565217
Control.SRR15539829;43;45;0.534883720930233;20;23;0.0348837209302325;0.465116279069767
Control.SRR15539829;48;45;0.520833333333333;23;25;0.0208333333333334;0.479166666666667
Control.SRR15539829;41;45;0.414634146341463;24;17;0.0853658536585366;0.414634146341463
Control.SRR15539829;52;45;0.461538461538462;28;24;0.0384615384615384;0.461538461538462
Control.SRR15539829;44;45;0.545454545454545;20;24;0.0454545454545454;0.454545454545455
Control.SRR15539829;52;45;0.346153846153846;34;18;0.153846153846154;0.346153846153846
Control.SRR15539829;44;45;0.522727272727273;21;23;0.0227272727272727;0.477272727272727
Control.SRR15539829;43;45;0.558139534883721;19;24;0.0581395348837209;0.441860465116279
Control.SRR15539829;47;45;0.446808510638298;26;21;0.0531914893617021;0.446808510638298
Control.SRR15539829;44;45;0.454545454545455;24;20;0.0454545454545455;0.454545454545455
Control.SRR15539829;48;45;0.645833333333333;17;31;0.145833333333333;0.354166666666667
Control.SRR15539829;41;45;0.365853658536585;26;15;0.134146341463415;0.365853658536585
Control.SRR15539829;48;45;0.541666666666667;22;26;0.0416666666666666;0.458333333333333
Control.SRR15539829;43;45;0.395348837209302;26;17;0.104651162790698;0.395348837209302
Control.SRR15539829;44;45;0.431818181818182;25;19;0.0681818181818182;0.431818181818182
Control.SRR15539829;41;45;0.51219512195122;20;21;0.0121951219512195;0.48780487804878
Control.SRR15539829;43;45;0.488372093023256;22;21;0.0116279069767442;0.488372093023256
Control.SRR15539829;40;45;0.55;18;22;0.05;0.45
Control.SRR15539829;46;45;0.5;23;23;0;0.5
Control.SRR15539829;50;45;0.54;23;27;0.04;0.46
Control.SRR15539829;45;45;0.577777777777778;19;26;0.0777777777777777;0.422222222222222
Control.SRR15539829;46;45;0.5;23;23;0;0.5
Control.SRR15539829;43;45;0.534883720930233;20;23;0.0348837209302325;0.465116279069767
Control.SRR15539829;46;45;0.369565217391304;29;17;0.130434782608696;0.369565217391304
Control.SRR15539829;49;45;0.36734693877551;31;18;0.13265306122449;0.36734693877551
Control.SRR15539829;44;45;0.5;22;22;0;0.5
Control.SRR15539829;49;45;0.408163265306122;29;20;0.0918367346938775;0.408163265306122
Control.SRR15539829;43;45;0.534883720930233;20;23;0.0348837209302325;0.465116279069767
Control.SRR15539829;52;45;0.519230769230769;25;27;0.0192307692307693;0.480769230769231
Control.SRR15539829;41;45;0.48780487804878;21;20;0.0121951219512195;0.48780487804878
Control.SRR15539829;42;45;0.547619047619048;19;23;0.0476190476190477;0.452380952380952
Control.SRR15539829;49;45;0.408163265306122;29;20;0.0918367346938775;0.408163265306122
Control.SRR15539829;51;45;0.529411764705882;24;27;0.0294117647058824;0.470588235294118
Control.SRR15539829;50;45;0.46;27;23;0.04;0.46
Control.SRR15539829;42;45;0.380952380952381;26;16;0.119047619047619;0.380952380952381
Control.SRR15539829;43;45;0.441860465116279;24;19;0.0581395348837209;0.441860465116279
Control.SRR15539829;48;45;0.541666666666667;22;26;0.0416666666666666;0.458333333333333
Control.SRR15539829;47;45;0.361702127659574;30;17;0.138297872340426;0.361702127659574
Control.SRR15539829;47;45;0.468085106382979;25;22;0.0319148936170213;0.468085106382979
Control.SRR15539829;43;45;0.511627906976744;21;22;0.0116279069767442;0.488372093023256
Control.SRR15539829;44;45;0.659090909090909;15;29;0.159090909090909;0.340909090909091
Control.SRR15539829;43;45;0.604651162790698;17;26;0.104651162790698;0.395348837209302
Control.SRR15539829;40;45;0.475;21;19;0.025;0.475
Control.SRR15539829;50;45;0.38;31;19;0.12;0.38
Control.SRR15539829;49;45;0.408163265306122;29;20;0.0918367346938775;0.408163265306122
Control.SRR15539829;44;45;0.409090909090909;26;18;0.0909090909090909;0.409090909090909
Control.SRR15539829;49;45;0.469387755102041;26;23;0.0306122448979592;0.469387755102041
Control.SRR15539829;46;45;0.565217391304348;20;26;0.0652173913043478;0.434782608695652
Control.SRR15539829;43;45;0.511627906976744;21;22;0.0116279069767442;0.488372093023256
Control.SRR15539829;44;45;0.454545454545455;24;20;0.0454545454545455;0.454545454545455
Control.SRR15539829;40;45;0.525;19;21;0.025;0.475
Control.SRR15539829;42;45;0.523809523809524;20;22;0.0238095238095238;0.476190476190476
Control.SRR15539829;45;45;0.577777777777778;19;26;0.0777777777777777;0.422222222222222
Control.SRR15539829;47;45;0.404255319148936;28;19;0.0957446808510639;0.404255319148936
Control.SRR15539829;48;45;0.416666666666667;28;20;0.0833333333333333;0.416666666666667
Control.SRR15539829;50;45;0.44;28;22;0.06;0.44
Control.SRR15539829;51;45;0.392156862745098;31;20;0.107843137254902;0.392156862745098
Control.SRR15539829;52;45;0.5;26;26;0;0.5
Control.SRR15539829;49;45;0.448979591836735;27;22;0.0510204081632653;0.448979591836735
Control.SRR15539829;41;45;0.390243902439024;25;16;0.109756097560976;0.390243902439024
Control.SRR15539829;41;45;0.48780487804878;21;20;0.0121951219512195;0.48780487804878
Control.SRR15539829;50;45;0.56;22;28;0.0600000000000001;0.44
Control.SRR15539829;51;45;0.588235294117647;21;30;0.0882352941176471;0.411764705882353
Control.SRR15539829;46;45;0.478260869565217;24;22;0.0217391304347826;0.478260869565217
Control.SRR15539829;45;45;0.311111111111111;31;14;0.188888888888889;0.311111111111111
Control.SRR15539829;45;45;0.466666666666667;24;21;0.0333333333333333;0.466666666666667
Control.SRR15539829;40;45;0.55;18;22;0.05;0.45
Control.SRR15539829;44;45;0.477272727272727;23;21;0.0227272727272727;0.477272727272727
Control.SRR15539829;40;45;0.625;15;25;0.125;0.375
Control.SRR15539829;44;45;0.363636363636364;28;16;0.136363636363636;0.363636363636364
Control.SRR15539829;51;45;0.549019607843137;23;28;0.0490196078431373;0.450980392156863
Control.SRR15539829;48;45;0.583333333333333;20;28;0.0833333333333334;0.416666666666667
Control.SRR15539829;44;45;0.522727272727273;21;23;0.0227272727272727;0.477272727272727
Control.SRR15539829;43;45;0.581395348837209;18;25;0.0813953488372093;0.418604651162791
Control.SRR15539829;50;45;0.44;28;22;0.06;0.44
Control.SRR15539829;41;45;0.658536585365854;14;27;0.158536585365854;0.341463414634146
Control.SRR15539829;48;45;0.4375;27;21;0.0625;0.4375
Control.SRR15539829;40;45;0.45;22;18;0.05;0.45
Control.SRR15539829;51;45;0.549019607843137;23;28;0.0490196078431373;0.450980392156863
Control.SRR15539829;45;45;0.4;27;18;0.1;0.4
Control.SRR15539829;52;45;0.596153846153846;21;31;0.0961538461538461;0.403846153846154
Control.SRR15539829;52;45;0.423076923076923;30;22;0.0769230769230769;0.423076923076923
Control.SRR15539829;51;45;0.509803921568627;25;26;0.00980392156862742;0.490196078431373
Control.SRR15539829;44;45;0.454545454545455;24;20;0.0454545454545455;0.454545454545455
Control.SRR15539829;49;45;0.489795918367347;25;24;0.0102040816326531;0.489795918367347
Control.SRR15539829;41;45;0.439024390243902;23;18;0.0609756097560976;0.439024390243902
Control.SRR15539829;46;45;0.391304347826087;28;18;0.108695652173913;0.391304347826087
Control.SRR15539829;44;45;0.454545454545455;24;20;0.0454545454545455;0.454545454545455
Control.SRR15539829;40;45;0.5;20;20;0;0.5
Control.SRR15539829;40;45;0.5;20;20;0;0.5
Control.SRR15539829;44;45;0.477272727272727;23;21;0.0227272727272727;0.477272727272727
Control.SRR15539829;52;45;0.403846153846154;31;21;0.0961538461538461;0.403846153846154
Control.SRR15539829;48;45;0.541666666666667;22;26;0.0416666666666666;0.458333333333333
Control.SRR15539829;40;45;0.55;18;22;0.05;0.45
Control.SRR15539829;40;45;0.4;24;16;0.1;0.4
Control.SRR15539829;40;45;0.475;21;19;0.025;0.475
Control.SRR15539829;46;45;0.652173913043478;16;30;0.152173913043478;0.347826086956522
Control.SRR15539829;52;45;0.442307692307692;29;23;0.0576923076923077;0.442307692307692
Control.SRR15539829;40;45;0.45;22;18;0.05;0.45
Control.SRR15539829;41;45;0.414634146341463;24;17;0.0853658536585366;0.414634146341463
Control.SRR15539829;49;45;0.571428571428571;21;28;0.0714285714285714;0.428571428571429
Control.SRR15539829;47;45;0.553191489361702;21;26;0.0531914893617021;0.446808510638298
Control.SRR15539829;51;45;0.529411764705882;24;27;0.0294117647058824;0.470588235294118
Control.SRR15539829;44;45;0.454545454545455;24;20;0.0454545454545455;0.454545454545455
Control.SRR15539829;43;45;0.558139534883721;19;24;0.0581395348837209;0.441860465116279
Control.SRR15539829;44;45;0.545454545454545;20;24;0.0454545454545454;0.454545454545455
Control.SRR15539829;42;45;0.523809523809524;20;22;0.0238095238095238;0.476190476190476
Control.SRR15539829;48;45;0.583333333333333;20;28;0.0833333333333334;0.416666666666667
Control.SRR15539829;46;45;0.58695652173913;19;27;0.0869565217391305;0.41304347826087
Control.SRR15539829;47;45;0.531914893617021;22;25;0.0319148936170213;0.468085106382979
Control.SRR15539829;49;45;0.653061224489796;17;32;0.153061224489796;0.346938775510204
Control.SRR15539829;41;45;0.414634146341463;24;17;0.0853658536585366;0.414634146341463
Control.SRR15539829;42;45;0.452380952380952;23;19;0.0476190476190476;0.452380952380952
Control.SRR15539829;52;45;0.480769230769231;27;25;0.0192307692307692;0.480769230769231
Control.SRR15539829;51;45;0.588235294117647;21;30;0.0882352941176471;0.411764705882353
Control.SRR15539829;43;45;0.558139534883721;19;24;0.0581395348837209;0.441860465116279
Control.SRR15539829;48;45;0.479166666666667;25;23;0.0208333333333333;0.479166666666667
Control.SRR15539829;51;45;0.490196078431373;26;25;0.00980392156862747;0.490196078431373
Control.SRR15539829;51;45;0.450980392156863;28;23;0.0490196078431372;0.450980392156863
Control.SRR15539829;52;45;0.384615384615385;32;20;0.115384615384615;0.384615384615385
Control.SRR15539829;42;45;0.452380952380952;23;19;0.0476190476190476;0.452380952380952
Control.SRR15539829;47;45;0.48936170212766;24;23;0.0106382978723404;0.48936170212766
Control.SRR15539829;44;45;0.613636363636364;17;27;0.113636363636364;0.386363636363636
Control.SRR15539829;45;45;0.488888888888889;23;22;0.0111111111111111;0.488888888888889
Control.SRR15539829;41;45;0.536585365853659;19;22;0.0365853658536586;0.463414634146341
Control.SRR15539829;42;45;0.571428571428571;18;24;0.0714285714285714;0.428571428571429
Control.SRR15539829;43;45;0.534883720930233;20;23;0.0348837209302325;0.465116279069767
Control.SRR15539829;51;45;0.490196078431373;26;25;0.00980392156862747;0.490196078431373
Control.SRR15539829;43;45;0.418604651162791;25;18;0.0813953488372093;0.418604651162791
Control.SRR15539829;46;45;0.478260869565217;24;22;0.0217391304347826;0.478260869565217
Control.SRR15539829;52;45;0.538461538461538;24;28;0.0384615384615384;0.461538461538462
Control.SRR15539829;47;45;0.553191489361702;21;26;0.0531914893617021;0.446808510638298
Control.SRR15539829;49;45;0.469387755102041;26;23;0.0306122448979592;0.469387755102041
Control.SRR15539829;52;45;0.634615384615385;19;33;0.134615384615385;0.365384615384615
Control.SRR15539829;51;45;0.509803921568627;25;26;0.00980392156862742;0.490196078431373
Control.SRR15539829;45;45;0.577777777777778;19;26;0.0777777777777777;0.422222222222222
Control.SRR15539829;46;45;0.434782608695652;26;20;0.0652173913043478;0.434782608695652
Control.SRR15539829;41;45;0.609756097560976;16;25;0.109756097560976;0.390243902439024
Control.SRR15539829;49;45;0.489795918367347;25;24;0.0102040816326531;0.489795918367347
Control.SRR15539829;50;45;0.42;29;21;0.08;0.42
Control.SRR15539829;50;45;0.44;28;22;0.06;0.44
Control.SRR15539829;49;45;0.571428571428571;21;28;0.0714285714285714;0.428571428571429
Control.SRR15539829;50;45;0.5;25;25;0;0.5
Control.SRR15539829;46;45;0.521739130434783;22;24;0.0217391304347826;0.478260869565217
Control.SRR15539829;48;45;0.416666666666667;28;20;0.0833333333333333;0.416666666666667
Control.SRR15539829;47;45;0.638297872340426;17;30;0.138297872340426;0.361702127659574
Control.SRR15539829;45;45;0.666666666666667;15;30;0.166666666666667;0.333333333333333
Control.SRR15539829;52;45;0.442307692307692;29;23;0.0576923076923077;0.442307692307692
Control.SRR15539829;44;45;0.454545454545455;24;20;0.0454545454545455;0.454545454545455
Control.SRR15539829;41;45;0.560975609756098;18;23;0.0609756097560976;0.439024390243902
Control.SRR15539829;51;45;0.549019607843137;23;28;0.0490196078431373;0.450980392156863
Control.SRR15539829;49;45;0.653061224489796;17;32;0.153061224489796;0.346938775510204
Control.SRR15539829;42;45;0.547619047619048;19;23;0.0476190476190477;0.452380952380952
Control.SRR15539829;43;45;0.558139534883721;19;24;0.0581395348837209;0.441860465116279
Control.SRR15539829;41;45;0.439024390243902;23;18;0.0609756097560976;0.439024390243902
Control.SRR15539829;45;45;0.511111111111111;22;23;0.0111111111111111;0.488888888888889
Control.SRR15539829;44;45;0.5;22;22;0;0.5
Control.SRR15539829;49;45;0.408163265306122;29;20;0.0918367346938775;0.408163265306122
Control.SRR15539829;42;45;0.476190476190476;22;20;0.0238095238095238;0.476190476190476
Control.SRR15539829;44;45;0.477272727272727;23;21;0.0227272727272727;0.477272727272727
Control.SRR15539829;48;45;0.5625;21;27;0.0625;0.4375
Control.SRR15539829;48;45;0.583333333333333;20;28;0.0833333333333334;0.416666666666667
Control.SRR15539829;47;45;0.468085106382979;25;22;0.0319148936170213;0.468085106382979
Control.SRR15539829;41;45;0.48780487804878;21;20;0.0121951219512195;0.48780487804878
Control.SRR15539829;48;45;0.479166666666667;25;23;0.0208333333333333;0.479166666666667
Control.SRR15539829;44;45;0.431818181818182;25;19;0.0681818181818182;0.431818181818182
Control.SRR15539829;42;45;0.5;21;21;0;0.5
Control.SRR15539829;41;45;0.48780487804878;21;20;0.0121951219512195;0.48780487804878
Control.SRR15539829;45;45;0.511111111111111;22;23;0.0111111111111111;0.488888888888889
Control.SRR15539829;48;45;0.479166666666667;25;23;0.0208333333333333;0.479166666666667
Control.SRR15539829;48;45;0.4375;27;21;0.0625;0.4375
Control.SRR15539829;47;45;0.617021276595745;18;29;0.117021276595745;0.382978723404255
Control.SRR15539829;41;45;0.463414634146341;22;19;0.0365853658536585;0.463414634146341
Control.SRR15539829;44;45;0.522727272727273;21;23;0.0227272727272727;0.477272727272727
Control.SRR15539829;50;45;0.48;26;24;0.02;0.48
Control.SRR15539829;44;45;0.545454545454545;20;24;0.0454545454545454;0.454545454545455
Control.SRR15539829;52;45;0.5;26;26;0;0.5
Control.SRR15539829;47;45;0.51063829787234;23;24;0.0106382978723404;0.48936170212766
Control.SRR15539829;45;45;0.444444444444444;25;20;0.0555555555555556;0.444444444444444
Control.SRR15539829;40;45;0.475;21;19;0.025;0.475
Control.SRR15539829;50;45;0.52;24;26;0.02;0.48
Control.SRR15539829;47;45;0.51063829787234;23;24;0.0106382978723404;0.48936170212766
Control.SRR15539829;44;45;0.590909090909091;18;26;0.0909090909090909;0.409090909090909
Control.SRR15539829;52;45;0.519230769230769;25;27;0.0192307692307693;0.480769230769231
Control.SRR15539829;52;45;0.480769230769231;27;25;0.0192307692307692;0.480769230769231
Control.SRR15539829;43;45;0.465116279069767;23;20;0.0348837209302326;0.465116279069767
Control.SRR15539829;48;45;0.333333333333333;32;16;0.166666666666667;0.333333333333333
Control.SRR15539829;43;45;0.558139534883721;19;24;0.0581395348837209;0.441860465116279
Control.SRR15539829;48;45;0.479166666666667;25;23;0.0208333333333333;0.479166666666667
Control.SRR15539829;43;45;0.581395348837209;18;25;0.0813953488372093;0.418604651162791
Control.SRR15539829;49;45;0.489795918367347;25;24;0.0102040816326531;0.489795918367347
Control.SRR15539829;42;45;0.452380952380952;23;19;0.0476190476190476;0.452380952380952
Control.SRR15539829;41;45;0.634146341463415;15;26;0.134146341463415;0.365853658536585
Control.SRR15539829;44;45;0.386363636363636;27;17;0.113636363636364;0.386363636363636
Control.SRR15539829;41;45;0.634146341463415;15;26;0.134146341463415;0.365853658536585
Control.SRR15539829;41;45;0.48780487804878;21;20;0.0121951219512195;0.48780487804878
Control.SRR15539829;42;45;0.476190476190476;22;20;0.0238095238095238;0.476190476190476
Control.SRR15539829;43;45;0.604651162790698;17;26;0.104651162790698;0.395348837209302
Control.SRR15539829;47;45;0.48936170212766;24;23;0.0106382978723404;0.48936170212766
Control.SRR15539829;52;45;0.519230769230769;25;27;0.0192307692307693;0.480769230769231
Control.SRR15539829;48;45;0.479166666666667;25;23;0.0208333333333333;0.479166666666667
Control.SRR15539829;48;45;0.395833333333333;29;19;0.104166666666667;0.395833333333333
Control.SRR15539829;48;45;0.520833333333333;23;25;0.0208333333333334;0.479166666666667
Control.SRR15539829;43;45;0.325581395348837;29;14;0.174418604651163;0.325581395348837
Control.SRR15539829;45;45;0.466666666666667;24;21;0.0333333333333333;0.466666666666667
Control.SRR15539829;41;45;0.609756097560976;16;25;0.109756097560976;0.390243902439024
Control.SRR15539829;45;45;0.4;27;18;0.1;0.4
Control.SRR15539829;41;45;0.51219512195122;20;21;0.0121951219512195;0.48780487804878
Control.SRR15539829;42;45;0.523809523809524;20;22;0.0238095238095238;0.476190476190476
Control.SRR15539829;43;45;0.418604651162791;25;18;0.0813953488372093;0.418604651162791
Control.SRR15539829;44;45;0.431818181818182;25;19;0.0681818181818182;0.431818181818182
Control.SRR15539829;42;45;0.619047619047619;16;26;0.119047619047619;0.380952380952381
Control.SRR15539829;46;45;0.5;23;23;0;0.5
Control.SRR15539829;45;45;0.577777777777778;19;26;0.0777777777777777;0.422222222222222
Control.SRR15539829;43;45;0.441860465116279;24;19;0.0581395348837209;0.441860465116279
Control.SRR15539829;44;45;0.5;22;22;0;0.5
Control.SRR15539829;44;45;0.5;22;22;0;0.5
Control.SRR15539829;43;45;0.511627906976744;21;22;0.0116279069767442;0.488372093023256
Control.SRR15539829;40;45;0.55;18;22;0.05;0.45
Control.SRR15539829;41;45;0.48780487804878;21;20;0.0121951219512195;0.48780487804878
Control.SRR15539829;43;45;0.441860465116279;24;19;0.0581395348837209;0.441860465116279
Control.SRR15539829;49;45;0.448979591836735;27;22;0.0510204081632653;0.448979591836735
Control.SRR15539829;45;45;0.4;27;18;0.1;0.4
Control.SRR15539829;45;45;0.533333333333333;21;24;0.0333333333333333;0.466666666666667
Control.SRR15539829;40;45;0.55;18;22;0.05;0.45
Control.SRR15539829;41;45;0.48780487804878;21;20;0.0121951219512195;0.48780487804878
Control.SRR15539829;46;45;0.456521739130435;25;21;0.0434782608695652;0.456521739130435
Control.SRR15539829;46;45;0.456521739130435;25;21;0.0434782608695652;0.456521739130435
Control.SRR15539829;50;45;0.46;27;23;0.04;0.46
Control.SRR15539829;44;45;0.5;22;22;0;0.5
Control.SRR15539829;43;45;0.581395348837209;18;25;0.0813953488372093;0.418604651162791
Control.SRR15539829;44;45;0.545454545454545;20;24;0.0454545454545454;0.454545454545455
Control.SRR15539829;45;45;0.555555555555556;20;25;0.0555555555555556;0.444444444444444
Control.SRR15539829;48;45;0.5;24;24;0;0.5
Control.SRR15539829;47;45;0.531914893617021;22;25;0.0319148936170213;0.468085106382979
Control.SRR15539829;48;45;0.479166666666667;25;23;0.0208333333333333;0.479166666666667
Control.SRR15539829;43;45;0.511627906976744;21;22;0.0116279069767442;0.488372093023256
Control.SRR15539829;46;45;0.521739130434783;22;24;0.0217391304347826;0.478260869565217
Control.SRR15539829;47;45;0.48936170212766;24;23;0.0106382978723404;0.48936170212766
Control.SRR15539829;46;45;0.456521739130435;25;21;0.0434782608695652;0.456521739130435
Control.SRR15539829;46;45;0.434782608695652;26;20;0.0652173913043478;0.434782608695652
Control.SRR15539829;42;45;0.547619047619048;19;23;0.0476190476190477;0.452380952380952
Control.SRR15539829;46;45;0.58695652173913;19;27;0.0869565217391305;0.41304347826087
Control.SRR15539829;45;45;0.533333333333333;21;24;0.0333333333333333;0.466666666666667
Control.SRR15539829;43;45;0.534883720930233;20;23;0.0348837209302325;0.465116279069767
Control.SRR15539829;43;45;0.511627906976744;21;22;0.0116279069767442;0.488372093023256
Control.SRR15539829;41;45;0.48780487804878;21;20;0.0121951219512195;0.48780487804878
Control.SRR15539829;46;45;0.521739130434783;22;24;0.0217391304347826;0.478260869565217
Control.SRR15539829;47;45;0.446808510638298;26;21;0.0531914893617021;0.446808510638298
Control.SRR15539829;43;45;0.418604651162791;25;18;0.0813953488372093;0.418604651162791
Control.SRR15539829;40;45;0.475;21;19;0.025;0.475
Control.SRR15539829;47;45;0.446808510638298;26;21;0.0531914893617021;0.446808510638298
Control.SRR15539829;49;45;0.489795918367347;25;24;0.0102040816326531;0.489795918367347
Control.SRR15539829;46;45;0.543478260869565;21;25;0.0434782608695652;0.456521739130435
Control.SRR15539829;40;45;0.45;22;18;0.05;0.45
Control.SRR15539829;45;45;0.466666666666667;24;21;0.0333333333333333;0.466666666666667
Control.SRR15539829;41;45;0.51219512195122;20;21;0.0121951219512195;0.48780487804878
Control.SRR15539829;45;45;0.577777777777778;19;26;0.0777777777777777;0.422222222222222
Control.SRR15539829;43;45;0.511627906976744;21;22;0.0116279069767442;0.488372093023256
Control.SRR15539829;41;45;0.658536585365854;14;27;0.158536585365854;0.341463414634146
Control.SRR15539829;45;45;0.466666666666667;24;21;0.0333333333333333;0.466666666666667
Control.SRR15539829;44;45;0.409090909090909;26;18;0.0909090909090909;0.409090909090909
Control.SRR15539829;50;45;0.62;19;31;0.12;0.38
Control.SRR15539829;41;45;0.609756097560976;16;25;0.109756097560976;0.390243902439024
Control.SRR15539829;40;45;0.45;22;18;0.05;0.45
Control.SRR15539829;46;45;0.456521739130435;25;21;0.0434782608695652;0.456521739130435
Control.SRR15539829;42;45;0.619047619047619;16;26;0.119047619047619;0.380952380952381
Control.SRR15539829;44;45;0.431818181818182;25;19;0.0681818181818182;0.431818181818182
Control.SRR15539829;45;45;0.488888888888889;23;22;0.0111111111111111;0.488888888888889
Control.SRR15539829;50;45;0.56;22;28;0.0600000000000001;0.44
Control.SRR15539829;48;45;0.5;24;24;0;0.5
Control.SRR15539829;41;45;0.536585365853659;19;22;0.0365853658536586;0.463414634146341
Control.SRR15539829;42;45;0.642857142857143;15;27;0.142857142857143;0.357142857142857
Control.SRR15539829;43;45;0.418604651162791;25;18;0.0813953488372093;0.418604651162791
Control.SRR15539829;41;45;0.585365853658537;17;24;0.0853658536585366;0.414634146341463
Control.SRR15539829;46;45;0.5;23;23;0;0.5
Control.SRR15539829;42;45;0.5;21;21;0;0.5
Control.SRR15539829;52;45;0.615384615384615;20;32;0.115384615384615;0.384615384615385
Control.SRR15539829;46;45;0.543478260869565;21;25;0.0434782608695652;0.456521739130435
Control.SRR15539829;43;45;0.581395348837209;18;25;0.0813953488372093;0.418604651162791
Control.SRR15539829;45;45;0.377777777777778;28;17;0.122222222222222;0.377777777777778
Control.SRR15539829;45;45;0.577777777777778;19;26;0.0777777777777777;0.422222222222222
Control.SRR15539829;41;45;0.536585365853659;19;22;0.0365853658536586;0.463414634146341
Control.SRR15539829;42;45;0.428571428571429;24;18;0.0714285714285715;0.428571428571429
Control.SRR15539829;49;45;0.510204081632653;24;25;0.0102040816326531;0.489795918367347
Control.SRR15539829;49;45;0.63265306122449;18;31;0.13265306122449;0.36734693877551
Control.SRR15539829;41;45;0.414634146341463;24;17;0.0853658536585366;0.414634146341463
Control.SRR15539829;45;45;0.533333333333333;21;24;0.0333333333333333;0.466666666666667
Control.SRR15539829;44;45;0.613636363636364;17;27;0.113636363636364;0.386363636363636
Control.SRR15539829;48;45;0.604166666666667;19;29;0.104166666666667;0.395833333333333
Control.SRR15539829;43;45;0.488372093023256;22;21;0.0116279069767442;0.488372093023256
Control.SRR15539829;40;45;0.45;22;18;0.05;0.45
Control.SRR15539829;45;45;0.422222222222222;26;19;0.0777777777777778;0.422222222222222
Control.SRR15539829;46;45;0.58695652173913;19;27;0.0869565217391305;0.41304347826087
Control.SRR15539829;44;45;0.477272727272727;23;21;0.0227272727272727;0.477272727272727
Control.SRR15539829;40;45;0.4;24;16;0.1;0.4
Control.SRR15539829;49;45;0.448979591836735;27;22;0.0510204081632653;0.448979591836735
Control.SRR15539829;48;45;0.583333333333333;20;28;0.0833333333333334;0.416666666666667
Control.SRR15539829;45;45;0.6;18;27;0.1;0.4
Control.SRR15539829;40;45;0.625;15;25;0.125;0.375
Control.SRR15539829;44;45;0.431818181818182;25;19;0.0681818181818182;0.431818181818182
Control.SRR15539829;51;45;0.470588235294118;27;24;0.0294117647058824;0.470588235294118
Control.SRR15539829;41;45;0.390243902439024;25;16;0.109756097560976;0.390243902439024
Control.SRR15539829;41;45;0.48780487804878;21;20;0.0121951219512195;0.48780487804878
Control.SRR15539829;49;45;0.448979591836735;27;22;0.0510204081632653;0.448979591836735
Control.SRR15539829;44;45;0.5;22;22;0;0.5
Control.SRR15539829;47;45;0.595744680851064;19;28;0.0957446808510638;0.404255319148936
Control.SRR15539829;44;45;0.568181818181818;19;25;0.0681818181818182;0.431818181818182
Control.SRR15539829;51;45;0.549019607843137;23;28;0.0490196078431373;0.450980392156863
Control.SRR15539829;41;45;0.463414634146341;22;19;0.0365853658536585;0.463414634146341
Control.SRR15539829;43;45;0.465116279069767;23;20;0.0348837209302326;0.465116279069767
Control.SRR15539829;47;45;0.48936170212766;24;23;0.0106382978723404;0.48936170212766
Control.SRR15539829;44;45;0.590909090909091;18;26;0.0909090909090909;0.409090909090909
Control.SRR15539829;40;45;0.525;19;21;0.025;0.475
Control.SRR15539829;40;45;0.525;19;21;0.025;0.475
Control.SRR15539829;47;45;0.404255319148936;28;19;0.0957446808510639;0.404255319148936
Control.SRR15539829;51;45;0.588235294117647;21;30;0.0882352941176471;0.411764705882353
Control.SRR15539829;44;45;0.568181818181818;19;25;0.0681818181818182;0.431818181818182
Control.SRR15539829;50;45;0.44;28;22;0.06;0.44
Control.SRR15539829;42;45;0.476190476190476;22;20;0.0238095238095238;0.476190476190476
Control.SRR15539829;48;45;0.5;24;24;0;0.5
Control.SRR15539829;43;45;0.488372093023256;22;21;0.0116279069767442;0.488372093023256
Control.SRR15539829;51;45;0.490196078431373;26;25;0.00980392156862747;0.490196078431373
Control.SRR15539829;46;45;0.608695652173913;18;28;0.108695652173913;0.391304347826087
Control.SRR15539829;44;45;0.386363636363636;27;17;0.113636363636364;0.386363636363636
Control.SRR15539829;42;45;0.571428571428571;18;24;0.0714285714285714;0.428571428571429
Control.SRR15539829;46;45;0.369565217391304;29;17;0.130434782608696;0.369565217391304
Control.SRR15539829;40;45;0.375;25;15;0.125;0.375
Control.SRR15539829;41;45;0.48780487804878;21;20;0.0121951219512195;0.48780487804878
Control.SRR15539829;51;45;0.490196078431373;26;25;0.00980392156862747;0.490196078431373
Control.SRR15539829;45;45;0.533333333333333;21;24;0.0333333333333333;0.466666666666667
Control.SRR15539829;42;45;0.619047619047619;16;26;0.119047619047619;0.380952380952381
Control.SRR15539829;42;45;0.5;21;21;0;0.5
Control.SRR15539829;48;45;0.479166666666667;25;23;0.0208333333333333;0.479166666666667
Control.SRR15539829;51;45;0.549019607843137;23;28;0.0490196078431373;0.450980392156863
Control.SRR15539829;44;45;0.545454545454545;20;24;0.0454545454545454;0.454545454545455
Control.SRR15539829;49;45;0.489795918367347;25;24;0.0102040816326531;0.489795918367347
Control.SRR15539829;43;45;0.604651162790698;17;26;0.104651162790698;0.395348837209302
Control.SRR15539829;51;45;0.529411764705882;24;27;0.0294117647058824;0.470588235294118
Control.SRR15539829;51;45;0.490196078431373;26;25;0.00980392156862747;0.490196078431373
Control.SRR15539829;46;45;0.565217391304348;20;26;0.0652173913043478;0.434782608695652
Control.SRR15539829;51;45;0.686274509803922;16;35;0.186274509803922;0.313725490196078
Control.SRR15539829;48;45;0.458333333333333;26;22;0.0416666666666667;0.458333333333333
Control.SRR15539829;48;45;0.458333333333333;26;22;0.0416666666666667;0.458333333333333
Control.SRR15539829;47;45;0.51063829787234;23;24;0.0106382978723404;0.48936170212766
Control.SRR15539829;44;45;0.431818181818182;25;19;0.0681818181818182;0.431818181818182
Control.SRR15539829;49;45;0.469387755102041;26;23;0.0306122448979592;0.469387755102041
Control.SRR15539829;41;45;0.560975609756098;18;23;0.0609756097560976;0.439024390243902
Control.SRR15539829;42;45;0.5;21;21;0;0.5
Control.SRR15539829;44;45;0.522727272727273;21;23;0.0227272727272727;0.477272727272727
Control.SRR15539829;48;45;0.479166666666667;25;23;0.0208333333333333;0.479166666666667
Control.SRR15539829;50;45;0.42;29;21;0.08;0.42
Control.SRR15539829;40;45;0.55;18;22;0.05;0.45
Control.SRR15539829;49;45;0.469387755102041;26;23;0.0306122448979592;0.469387755102041
Control.SRR15539829;48;45;0.666666666666667;16;32;0.166666666666667;0.333333333333333
Control.SRR15539829;40;45;0.55;18;22;0.05;0.45
Control.SRR15539829;50;45;0.58;21;29;0.08;0.42
Control.SRR15539829;44;45;0.545454545454545;20;24;0.0454545454545454;0.454545454545455
Control.SRR15539829;51;45;0.549019607843137;23;28;0.0490196078431373;0.450980392156863
Control.SRR15539829;41;45;0.341463414634146;27;14;0.158536585365854;0.341463414634146
Control.SRR15539829;51;45;0.490196078431373;26;25;0.00980392156862747;0.490196078431373
Control.SRR15539829;50;45;0.6;20;30;0.1;0.4
Control.SRR15539829;43;45;0.465116279069767;23;20;0.0348837209302326;0.465116279069767
Control.SRR15539829;46;45;0.543478260869565;21;25;0.0434782608695652;0.456521739130435
Control.SRR15539829;49;45;0.571428571428571;21;28;0.0714285714285714;0.428571428571429
Control.SRR15539829;44;45;0.5;22;22;0;0.5
Control.SRR15539829;47;45;0.531914893617021;22;25;0.0319148936170213;0.468085106382979
Control.SRR15539829;48;45;0.458333333333333;26;22;0.0416666666666667;0.458333333333333
Control.SRR15539829;49;45;0.530612244897959;23;26;0.0306122448979592;0.469387755102041
Control.SRR15539829;47;45;0.553191489361702;21;26;0.0531914893617021;0.446808510638298
Control.SRR15539829;45;45;0.555555555555556;20;25;0.0555555555555556;0.444444444444444
Control.SRR15539829;46;45;0.434782608695652;26;20;0.0652173913043478;0.434782608695652
Control.SRR15539829;51;45;0.431372549019608;29;22;0.0686274509803921;0.431372549019608
Control.SRR15539829;48;45;0.5625;21;27;0.0625;0.4375
Control.SRR15539829;49;45;0.510204081632653;24;25;0.0102040816326531;0.489795918367347
Control.SRR15539829;49;45;0.612244897959184;19;30;0.112244897959184;0.387755102040816
Control.SRR15539829;46;45;0.565217391304348;20;26;0.0652173913043478;0.434782608695652
Control.SRR15539829;47;45;0.382978723404255;29;18;0.117021276595745;0.382978723404255
Control.SRR15539829;48;45;0.458333333333333;26;22;0.0416666666666667;0.458333333333333
Control.SRR15539829;42;45;0.476190476190476;22;20;0.0238095238095238;0.476190476190476
Control.SRR15539829;46;45;0.391304347826087;28;18;0.108695652173913;0.391304347826087
Control.SRR15539829;43;45;0.488372093023256;22;21;0.0116279069767442;0.488372093023256
Control.SRR15539829;40;45;0.45;22;18;0.05;0.45
Control.SRR15539829;41;45;0.414634146341463;24;17;0.0853658536585366;0.414634146341463
Control.SRR15539829;46;45;0.58695652173913;19;27;0.0869565217391305;0.41304347826087
Control.SRR15539829;45;45;0.555555555555556;20;25;0.0555555555555556;0.444444444444444
Control.SRR15539829;49;45;0.571428571428571;21;28;0.0714285714285714;0.428571428571429
Control.SRR15539829;48;45;0.5;24;24;0;0.5
Control.SRR15539829;49;45;0.428571428571429;28;21;0.0714285714285715;0.428571428571429
Control.SRR15539829;48;45;0.5625;21;27;0.0625;0.4375
Control.SRR15539829;43;45;0.581395348837209;18;25;0.0813953488372093;0.418604651162791
Control.SRR15539829;45;45;0.444444444444444;25;20;0.0555555555555556;0.444444444444444
Control.SRR15539829;43;45;0.558139534883721;19;24;0.0581395348837209;0.441860465116279
Control.SRR15539829;41;45;0.439024390243902;23;18;0.0609756097560976;0.439024390243902
Control.SRR15539829;41;45;0.317073170731707;28;13;0.182926829268293;0.317073170731707
Control.SRR15539829;43;45;0.418604651162791;25;18;0.0813953488372093;0.418604651162791
Control.SRR15539829;48;45;0.541666666666667;22;26;0.0416666666666666;0.458333333333333
Control.SRR15539829;49;45;0.448979591836735;27;22;0.0510204081632653;0.448979591836735
Control.SRR15539829;46;45;0.652173913043478;16;30;0.152173913043478;0.347826086956522
Control.SRR15539829;51;45;0.470588235294118;27;24;0.0294117647058824;0.470588235294118
Control.SRR15539829;43;45;0.465116279069767;23;20;0.0348837209302326;0.465116279069767
Control.SRR15539829;51;45;0.470588235294118;27;24;0.0294117647058824;0.470588235294118
Control.SRR15539829;52;45;0.615384615384615;20;32;0.115384615384615;0.384615384615385
Control.SRR15539829;42;45;0.30952380952381;29;13;0.19047619047619;0.30952380952381
Control.SRR15539829;44;45;0.613636363636364;17;27;0.113636363636364;0.386363636363636
Control.SRR15539829;40;45;0.5;20;20;0;0.5
Control.SRR15539829;47;45;0.404255319148936;28;19;0.0957446808510639;0.404255319148936
Control.SRR15539829;43;45;0.488372093023256;22;21;0.0116279069767442;0.488372093023256
Control.SRR15539829;48;45;0.5;24;24;0;0.5
Control.SRR15539829;51;45;0.549019607843137;23;28;0.0490196078431373;0.450980392156863
Control.SRR15539829;50;45;0.4;30;20;0.1;0.4
Control.SRR15539829;49;45;0.653061224489796;17;32;0.153061224489796;0.346938775510204
Control.SRR15539829;42;45;0.476190476190476;22;20;0.0238095238095238;0.476190476190476
Control.SRR15539829;47;45;0.468085106382979;25;22;0.0319148936170213;0.468085106382979
Control.SRR15539829;49;45;0.551020408163265;22;27;0.0510204081632653;0.448979591836735
Control.SRR15539829;42;45;0.428571428571429;24;18;0.0714285714285715;0.428571428571429
Control.SRR15539829;41;45;0.48780487804878;21;20;0.0121951219512195;0.48780487804878
Control.SRR15539829;49;45;0.408163265306122;29;20;0.0918367346938775;0.408163265306122
Control.SRR15539829;48;45;0.583333333333333;20;28;0.0833333333333334;0.416666666666667
Control.SRR15539829;48;45;0.541666666666667;22;26;0.0416666666666666;0.458333333333333
Control.SRR15539829;40;45;0.525;19;21;0.025;0.475
Control.SRR15539829;41;45;0.560975609756098;18;23;0.0609756097560976;0.439024390243902
Control.SRR15539829;42;45;0.452380952380952;23;19;0.0476190476190476;0.452380952380952
Control.SRR15539829;42;45;0.380952380952381;26;16;0.119047619047619;0.380952380952381
Control.SRR15539829;49;45;0.510204081632653;24;25;0.0102040816326531;0.489795918367347
Control.SRR15539829;45;45;0.444444444444444;25;20;0.0555555555555556;0.444444444444444
Control.SRR15539829;43;45;0.534883720930233;20;23;0.0348837209302325;0.465116279069767
Control.SRR15539829;47;45;0.553191489361702;21;26;0.0531914893617021;0.446808510638298
Control.SRR15539829;52;45;0.519230769230769;25;27;0.0192307692307693;0.480769230769231
Control.SRR15539829;52;45;0.653846153846154;18;34;0.153846153846154;0.346153846153846
Control.SRR15539829;43;45;0.395348837209302;26;17;0.104651162790698;0.395348837209302
Control.SRR15539829;40;45;0.575;17;23;0.075;0.425
Control.SRR15539829;52;45;0.576923076923077;22;30;0.0769230769230769;0.423076923076923
Control.SRR15539829;45;45;0.377777777777778;28;17;0.122222222222222;0.377777777777778
Control.SRR15539829;41;45;0.634146341463415;15;26;0.134146341463415;0.365853658536585
Control.SRR15539829;43;45;0.488372093023256;22;21;0.0116279069767442;0.488372093023256
Control.SRR15539829;41;45;0.51219512195122;20;21;0.0121951219512195;0.48780487804878
Control.SRR15539829;40;45;0.45;22;18;0.05;0.45
Control.SRR15539829;47;45;0.446808510638298;26;21;0.0531914893617021;0.446808510638298
Control.SRR15539829;49;45;0.36734693877551;31;18;0.13265306122449;0.36734693877551
Control.SRR15539829;51;45;0.529411764705882;24;27;0.0294117647058824;0.470588235294118
Control.SRR15539829;43;45;0.534883720930233;20;23;0.0348837209302325;0.465116279069767
Control.SRR15539829;45;45;0.688888888888889;14;31;0.188888888888889;0.311111111111111
Control.SRR15539829;41;45;0.48780487804878;21;20;0.0121951219512195;0.48780487804878
Control.SRR15539829;41;45;0.439024390243902;23;18;0.0609756097560976;0.439024390243902
Control.SRR15539829;45;45;0.577777777777778;19;26;0.0777777777777777;0.422222222222222
Control.SRR15539829;48;45;0.4375;27;21;0.0625;0.4375
Control.SRR15539829;47;45;0.595744680851064;19;28;0.0957446808510638;0.404255319148936
Control.SRR15539829;45;45;0.444444444444444;25;20;0.0555555555555556;0.444444444444444
Control.SRR15539829;52;45;0.384615384615385;32;20;0.115384615384615;0.384615384615385
Control.SRR15539829;46;45;0.5;23;23;0;0.5
Control.SRR15539829;44;45;0.477272727272727;23;21;0.0227272727272727;0.477272727272727
Control.SRR15539829;51;45;0.490196078431373;26;25;0.00980392156862747;0.490196078431373
Control.SRR15539829;44;45;0.568181818181818;19;25;0.0681818181818182;0.431818181818182
Control.SRR15539829;46;45;0.41304347826087;27;19;0.0869565217391304;0.41304347826087
Control.SRR15539829;47;45;0.51063829787234;23;24;0.0106382978723404;0.48936170212766
Control.SRR15539829;45;45;0.466666666666667;24;21;0.0333333333333333;0.466666666666667
Control.SRR15539829;52;45;0.538461538461538;24;28;0.0384615384615384;0.461538461538462
Control.SRR15539829;46;45;0.434782608695652;26;20;0.0652173913043478;0.434782608695652
Control.SRR15539829;43;45;0.534883720930233;20;23;0.0348837209302325;0.465116279069767
Control.SRR15539829;49;45;0.63265306122449;18;31;0.13265306122449;0.36734693877551
Control.SRR15539829;51;45;0.450980392156863;28;23;0.0490196078431372;0.450980392156863
Control.SRR15539829;47;45;0.51063829787234;23;24;0.0106382978723404;0.48936170212766
Control.SRR15539829;50;45;0.46;27;23;0.04;0.46
Control.SRR15539829;42;45;0.547619047619048;19;23;0.0476190476190477;0.452380952380952
Control.SRR15539829;40;45;0.425;23;17;0.075;0.425
Control.SRR15539829;42;45;0.547619047619048;19;23;0.0476190476190477;0.452380952380952
Control.SRR15539829;41;45;0.51219512195122;20;21;0.0121951219512195;0.48780487804878
Control.SRR15539829;45;45;0.466666666666667;24;21;0.0333333333333333;0.466666666666667
Control.SRR15539829;49;45;0.428571428571429;28;21;0.0714285714285715;0.428571428571429
Control.SRR15539829;47;45;0.48936170212766;24;23;0.0106382978723404;0.48936170212766
Control.SRR15539829;41;45;0.365853658536585;26;15;0.134146341463415;0.365853658536585
Control.SRR15539829;47;45;0.574468085106383;20;27;0.074468085106383;0.425531914893617
Control.SRR15539829;47;45;0.425531914893617;27;20;0.074468085106383;0.425531914893617
Control.SRR15539829;51;45;0.431372549019608;29;22;0.0686274509803921;0.431372549019608
Control.SRR15539829;51;45;0.509803921568627;25;26;0.00980392156862742;0.490196078431373
Control.SRR15539829;48;45;0.541666666666667;22;26;0.0416666666666666;0.458333333333333
Control.SRR15539829;43;45;0.511627906976744;21;22;0.0116279069767442;0.488372093023256
Control.SRR15539829;46;45;0.630434782608696;17;29;0.130434782608696;0.369565217391304
Control.SRR15539829;48;45;0.395833333333333;29;19;0.104166666666667;0.395833333333333
Control.SRR15539829;44;45;0.545454545454545;20;24;0.0454545454545454;0.454545454545455
Control.SRR15539829;49;45;0.571428571428571;21;28;0.0714285714285714;0.428571428571429
Control.SRR15539829;52;45;0.538461538461538;24;28;0.0384615384615384;0.461538461538462
Control.SRR15539829;43;45;0.465116279069767;23;20;0.0348837209302326;0.465116279069767
Control.SRR15539829;49;45;0.571428571428571;21;28;0.0714285714285714;0.428571428571429
Control.SRR15539829;47;45;0.574468085106383;20;27;0.074468085106383;0.425531914893617
Control.SRR15539829;45;45;0.355555555555556;29;16;0.144444444444444;0.355555555555556
Control.SRR15539829;44;45;0.636363636363636;16;28;0.136363636363636;0.363636363636364
Control.SRR15539829;46;45;0.5;23;23;0;0.5
Control.SRR15539829;45;45;0.533333333333333;21;24;0.0333333333333333;0.466666666666667
Control.SRR15539829;50;45;0.4;30;20;0.1;0.4
Control.SRR15539829;47;45;0.553191489361702;21;26;0.0531914893617021;0.446808510638298
Control.SRR15539829;48;45;0.625;18;30;0.125;0.375
Control.SRR15539829;43;45;0.558139534883721;19;24;0.0581395348837209;0.441860465116279
Control.SRR15539829;43;45;0.488372093023256;22;21;0.0116279069767442;0.488372093023256
Control.SRR15539829;46;45;0.5;23;23;0;0.5
Control.SRR15539829;41;45;0.439024390243902;23;18;0.0609756097560976;0.439024390243902
Control.SRR15539829;42;45;0.523809523809524;20;22;0.0238095238095238;0.476190476190476
Control.SRR15539829;43;45;0.581395348837209;18;25;0.0813953488372093;0.418604651162791
Control.SRR15539829;44;45;0.454545454545455;24;20;0.0454545454545455;0.454545454545455
Control.SRR15539829;40;45;0.475;21;19;0.025;0.475
Control.SRR15539829;48;45;0.5;24;24;0;0.5
Control.SRR15539829;41;45;0.414634146341463;24;17;0.0853658536585366;0.414634146341463
Control.SRR15539829;47;45;0.595744680851064;19;28;0.0957446808510638;0.404255319148936
Control.SRR15539829;51;45;0.470588235294118;27;24;0.0294117647058824;0.470588235294118
Control.SRR15539829;46;45;0.565217391304348;20;26;0.0652173913043478;0.434782608695652
Control.SRR15539829;45;45;0.444444444444444;25;20;0.0555555555555556;0.444444444444444
Control.SRR15539829;44;45;0.613636363636364;17;27;0.113636363636364;0.386363636363636
Control.SRR15539829;41;45;0.439024390243902;23;18;0.0609756097560976;0.439024390243902
Control.SRR15539829;41;45;0.463414634146341;22;19;0.0365853658536585;0.463414634146341
Control.SRR15539829;44;45;0.477272727272727;23;21;0.0227272727272727;0.477272727272727
Control.SRR15539829;44;45;0.454545454545455;24;20;0.0454545454545455;0.454545454545455
Control.SRR15539829;40;45;0.525;19;21;0.025;0.475
Control.SRR15539829;46;45;0.565217391304348;20;26;0.0652173913043478;0.434782608695652
Control.SRR15539829;45;45;0.511111111111111;22;23;0.0111111111111111;0.488888888888889
Control.SRR15539829;51;45;0.431372549019608;29;22;0.0686274509803921;0.431372549019608
Control.SRR15539829;47;45;0.468085106382979;25;22;0.0319148936170213;0.468085106382979
Control.SRR15539829;47;45;0.425531914893617;27;20;0.074468085106383;0.425531914893617
Control.SRR15539829;50;45;0.44;28;22;0.06;0.44
Control.SRR15539829;52;45;0.5;26;26;0;0.5
Control.SRR15539829;50;45;0.48;26;24;0.02;0.48
Control.SRR15539829;52;45;0.596153846153846;21;31;0.0961538461538461;0.403846153846154
Control.SRR15539829;48;45;0.4375;27;21;0.0625;0.4375
Control.SRR15539829;49;45;0.571428571428571;21;28;0.0714285714285714;0.428571428571429
Control.SRR15539829;43;45;0.465116279069767;23;20;0.0348837209302326;0.465116279069767
Control.SRR15539829;45;45;0.511111111111111;22;23;0.0111111111111111;0.488888888888889
Control.SRR15539829;49;45;0.510204081632653;24;25;0.0102040816326531;0.489795918367347
Control.SRR15539829;49;45;0.428571428571429;28;21;0.0714285714285715;0.428571428571429
Control.SRR15539829;47;45;0.361702127659574;30;17;0.138297872340426;0.361702127659574
Control.SRR15539829;48;45;0.604166666666667;19;29;0.104166666666667;0.395833333333333
Control.SRR15539829;41;45;0.463414634146341;22;19;0.0365853658536585;0.463414634146341
Control.SRR15539829;43;45;0.534883720930233;20;23;0.0348837209302325;0.465116279069767
Control.SRR15539829;49;45;0.448979591836735;27;22;0.0510204081632653;0.448979591836735
Control.SRR15539829;45;45;0.466666666666667;24;21;0.0333333333333333;0.466666666666667
Control.SRR15539829;50;45;0.5;25;25;0;0.5
Control.SRR15539829;47;45;0.48936170212766;24;23;0.0106382978723404;0.48936170212766
Control.SRR15539829;44;45;0.477272727272727;23;21;0.0227272727272727;0.477272727272727
Control.SRR15539829;47;45;0.51063829787234;23;24;0.0106382978723404;0.48936170212766
Control.SRR15539829;48;45;0.5;24;24;0;0.5
Control.SRR15539829;46;45;0.543478260869565;21;25;0.0434782608695652;0.456521739130435
Control.SRR15539829;48;45;0.5;24;24;0;0.5
Control.SRR15539829;41;45;0.536585365853659;19;22;0.0365853658536586;0.463414634146341
Control.SRR15539829;45;45;0.488888888888889;23;22;0.0111111111111111;0.488888888888889
Control.SRR15539829;47;45;0.51063829787234;23;24;0.0106382978723404;0.48936170212766
Control.SRR15539829;40;45;0.375;25;15;0.125;0.375
Control.SRR15539829;46;45;0.456521739130435;25;21;0.0434782608695652;0.456521739130435
Control.SRR15539829;42;45;0.476190476190476;22;20;0.0238095238095238;0.476190476190476
Control.SRR15539829;43;45;0.534883720930233;20;23;0.0348837209302325;0.465116279069767
Control.SRR15539829;50;45;0.6;20;30;0.1;0.4
Control.SRR15539829;41;45;0.536585365853659;19;22;0.0365853658536586;0.463414634146341
Control.SRR15539829;50;45;0.58;21;29;0.08;0.42
Control.SRR15539829;49;45;0.510204081632653;24;25;0.0102040816326531;0.489795918367347
Control.SRR15539829;40;45;0.6;16;24;0.1;0.4
Control.SRR15539829;45;45;0.488888888888889;23;22;0.0111111111111111;0.488888888888889
Control.SRR15539829;46;45;0.434782608695652;26;20;0.0652173913043478;0.434782608695652
Control.SRR15539829;48;45;0.458333333333333;26;22;0.0416666666666667;0.458333333333333
Control.SRR15539829;43;45;0.511627906976744;21;22;0.0116279069767442;0.488372093023256
Control.SRR15539829;47;45;0.51063829787234;23;24;0.0106382978723404;0.48936170212766
Control.SRR15539829;47;45;0.531914893617021;22;25;0.0319148936170213;0.468085106382979
Control.SRR15539829;43;45;0.674418604651163;14;29;0.174418604651163;0.325581395348837
Control.SRR15539829;51;45;0.568627450980392;22;29;0.0686274509803921;0.431372549019608
Control.SRR15539829;46;45;0.41304347826087;27;19;0.0869565217391304;0.41304347826087
Control.SRR15539829;45;45;0.511111111111111;22;23;0.0111111111111111;0.488888888888889
Control.SRR15539829;46;45;0.456521739130435;25;21;0.0434782608695652;0.456521739130435
Control.SRR15539829;46;45;0.521739130434783;22;24;0.0217391304347826;0.478260869565217
Control.SRR15539829;51;45;0.549019607843137;23;28;0.0490196078431373;0.450980392156863
Control.SRR15539829;41;45;0.560975609756098;18;23;0.0609756097560976;0.439024390243902
Control.SRR15539829;50;45;0.38;31;19;0.12;0.38
Control.SRR15539829;48;45;0.416666666666667;28;20;0.0833333333333333;0.416666666666667
Control.SRR15539829;50;45;0.46;27;23;0.04;0.46
Control.SRR15539829;50;45;0.48;26;24;0.02;0.48
Control.SRR15539829;49;45;0.530612244897959;23;26;0.0306122448979592;0.469387755102041
Control.SRR15539829;52;45;0.461538461538462;28;24;0.0384615384615384;0.461538461538462
Control.SRR15539829;43;45;0.558139534883721;19;24;0.0581395348837209;0.441860465116279
Control.SRR15539829;40;45;0.525;19;21;0.025;0.475
Control.SRR15539829;48;45;0.541666666666667;22;26;0.0416666666666666;0.458333333333333
Control.SRR15539829;43;45;0.465116279069767;23;20;0.0348837209302326;0.465116279069767
Control.SRR15539829;45;45;0.577777777777778;19;26;0.0777777777777777;0.422222222222222
Control.SRR15539829;41;45;0.48780487804878;21;20;0.0121951219512195;0.48780487804878
Control.SRR15539829;41;45;0.292682926829268;29;12;0.207317073170732;0.292682926829268
Control.SRR15539829;52;45;0.519230769230769;25;27;0.0192307692307693;0.480769230769231
Control.SRR15539829;47;45;0.574468085106383;20;27;0.074468085106383;0.425531914893617
Control.SRR15539829;45;45;0.422222222222222;26;19;0.0777777777777778;0.422222222222222
Control.SRR15539829;49;45;0.612244897959184;19;30;0.112244897959184;0.387755102040816
Control.SRR15539829;47;45;0.638297872340426;17;30;0.138297872340426;0.361702127659574
Control.SRR15539829;45;45;0.533333333333333;21;24;0.0333333333333333;0.466666666666667
Control.SRR15539829;45;45;0.555555555555556;20;25;0.0555555555555556;0.444444444444444
Control.SRR15539829;51;45;0.549019607843137;23;28;0.0490196078431373;0.450980392156863
Control.SRR15539829;43;45;0.651162790697674;15;28;0.151162790697674;0.348837209302326
Control.SRR15539829;43;45;0.511627906976744;21;22;0.0116279069767442;0.488372093023256
Control.SRR15539829;50;45;0.5;25;25;0;0.5
Control.SRR15539829;48;45;0.541666666666667;22;26;0.0416666666666666;0.458333333333333
Control.SRR15539829;41;45;0.585365853658537;17;24;0.0853658536585366;0.414634146341463
Control.SRR15539829;52;45;0.538461538461538;24;28;0.0384615384615384;0.461538461538462
Control.SRR15539829;44;45;0.522727272727273;21;23;0.0227272727272727;0.477272727272727
Control.SRR15539829;46;45;0.5;23;23;0;0.5
Control.SRR15539829;47;45;0.446808510638298;26;21;0.0531914893617021;0.446808510638298
Control.SRR15539829;45;45;0.444444444444444;25;20;0.0555555555555556;0.444444444444444
Control.SRR15539829;51;45;0.529411764705882;24;27;0.0294117647058824;0.470588235294118
Control.SRR15539829;50;45;0.52;24;26;0.02;0.48
Control.SRR15539829;42;45;0.452380952380952;23;19;0.0476190476190476;0.452380952380952
Control.SRR15539829;50;45;0.46;27;23;0.04;0.46
Control.SRR15539829;40;45;0.5;20;20;0;0.5
Control.SRR15539829;43;45;0.441860465116279;24;19;0.0581395348837209;0.441860465116279
Control.SRR15539829;50;45;0.48;26;24;0.02;0.48
Control.SRR15539829;42;45;0.476190476190476;22;20;0.0238095238095238;0.476190476190476
Control.SRR15539829;46;45;0.543478260869565;21;25;0.0434782608695652;0.456521739130435
Control.SRR15539829;46;45;0.5;23;23;0;0.5
Control.SRR15539829;44;45;0.477272727272727;23;21;0.0227272727272727;0.477272727272727
Control.SRR15539829;52;45;0.442307692307692;29;23;0.0576923076923077;0.442307692307692
Control.SRR15539829;50;45;0.58;21;29;0.08;0.42
Control.SRR15539829;50;45;0.54;23;27;0.04;0.46
Control.SRR15539829;42;45;0.666666666666667;14;28;0.166666666666667;0.333333333333333
Control.SRR15539829;49;45;0.571428571428571;21;28;0.0714285714285714;0.428571428571429
Control.SRR15539829;41;45;0.48780487804878;21;20;0.0121951219512195;0.48780487804878
Control.SRR15539829;43;45;0.511627906976744;21;22;0.0116279069767442;0.488372093023256
Control.SRR15539829;40;45;0.4;24;16;0.1;0.4
Control.SRR15539829;41;45;0.463414634146341;22;19;0.0365853658536585;0.463414634146341
Control.SRR15539829;45;45;0.422222222222222;26;19;0.0777777777777778;0.422222222222222
Control.SRR15539829;43;45;0.511627906976744;21;22;0.0116279069767442;0.488372093023256
Control.SRR15539829;40;45;0.525;19;21;0.025;0.475
Control.SRR15539829;44;45;0.477272727272727;23;21;0.0227272727272727;0.477272727272727
Control.SRR15539829;40;45;0.6;16;24;0.1;0.4
Control.SRR15539829;47;45;0.446808510638298;26;21;0.0531914893617021;0.446808510638298
Control.SRR15539829;42;45;0.547619047619048;19;23;0.0476190476190477;0.452380952380952
Control.SRR15539829;51;45;0.509803921568627;25;26;0.00980392156862742;0.490196078431373
Control.SRR15539829;50;45;0.64;18;32;0.14;0.36
Control.SRR15539829;49;45;0.571428571428571;21;28;0.0714285714285714;0.428571428571429
Control.SRR15539829;47;45;0.446808510638298;26;21;0.0531914893617021;0.446808510638298
Control.SRR15539829;43;45;0.511627906976744;21;22;0.0116279069767442;0.488372093023256
Control.SRR15539829;44;45;0.477272727272727;23;21;0.0227272727272727;0.477272727272727
Control.SRR15539829;52;45;0.442307692307692;29;23;0.0576923076923077;0.442307692307692
Control.SRR15539829;49;45;0.551020408163265;22;27;0.0510204081632653;0.448979591836735
Control.SRR15539829;50;45;0.46;27;23;0.04;0.46
Control.SRR15539829;51;45;0.549019607843137;23;28;0.0490196078431373;0.450980392156863
Control.SRR15539829;43;45;0.534883720930233;20;23;0.0348837209302325;0.465116279069767
Control.SRR15539829;46;45;0.391304347826087;28;18;0.108695652173913;0.391304347826087
Control.SRR15539829;49;45;0.387755102040816;30;19;0.112244897959184;0.387755102040816
Control.SRR15539829;44;45;0.5;22;22;0;0.5
Control.SRR15539829;52;45;0.5;26;26;0;0.5
Control.SRR15539829;49;45;0.448979591836735;27;22;0.0510204081632653;0.448979591836735
Control.SRR15539829;50;45;0.54;23;27;0.04;0.46
Control.SRR15539829;50;45;0.58;21;29;0.08;0.42
Control.SRR15539829;46;45;0.456521739130435;25;21;0.0434782608695652;0.456521739130435
Control.SRR15539829;49;45;0.408163265306122;29;20;0.0918367346938775;0.408163265306122
Control.SRR15539829;44;45;0.477272727272727;23;21;0.0227272727272727;0.477272727272727
Control.SRR15539829;51;45;0.549019607843137;23;28;0.0490196078431373;0.450980392156863
Control.SRR15539829;52;45;0.5;26;26;0;0.5
Control.SRR15539829;47;45;0.51063829787234;23;24;0.0106382978723404;0.48936170212766
Control.SRR15539829;49;45;0.551020408163265;22;27;0.0510204081632653;0.448979591836735
Control.SRR15539829;47;45;0.51063829787234;23;24;0.0106382978723404;0.48936170212766
Control.SRR15539829;42;45;0.404761904761905;25;17;0.0952380952380952;0.404761904761905
Control.SRR15539829;45;45;0.355555555555556;29;16;0.144444444444444;0.355555555555556
Control.SRR15539829;47;45;0.574468085106383;20;27;0.074468085106383;0.425531914893617
Control.SRR15539829;46;45;0.58695652173913;19;27;0.0869565217391305;0.41304347826087
Control.SRR15539829;43;45;0.488372093023256;22;21;0.0116279069767442;0.488372093023256
Control.SRR15539829;41;45;0.365853658536585;26;15;0.134146341463415;0.365853658536585
Control.SRR15539829;41;45;0.48780487804878;21;20;0.0121951219512195;0.48780487804878
Control.SRR15539829;48;45;0.5;24;24;0;0.5
Control.SRR15539829;44;45;0.5;22;22;0;0.5
Control.SRR15539829;47;45;0.425531914893617;27;20;0.074468085106383;0.425531914893617
Control.SRR15539829;52;45;0.5;26;26;0;0.5
Control.SRR15539829;44;45;0.477272727272727;23;21;0.0227272727272727;0.477272727272727
Control.SRR15539829;46;45;0.456521739130435;25;21;0.0434782608695652;0.456521739130435
Control.SRR15539829;46;45;0.543478260869565;21;25;0.0434782608695652;0.456521739130435
Control.SRR15539829;52;45;0.365384615384615;33;19;0.134615384615385;0.365384615384615
Control.SRR15539829;49;45;0.510204081632653;24;25;0.0102040816326531;0.489795918367347
Control.SRR15539829;50;45;0.52;24;26;0.02;0.48
Control.SRR15539829;51;45;0.529411764705882;24;27;0.0294117647058824;0.470588235294118
Control.SRR15539829;49;45;0.571428571428571;21;28;0.0714285714285714;0.428571428571429
Control.SRR15539829;50;45;0.46;27;23;0.04;0.46
Control.SRR15539829;51;45;0.450980392156863;28;23;0.0490196078431372;0.450980392156863
Control.SRR15539829;50;45;0.44;28;22;0.06;0.44
Control.SRR15539829;42;45;0.523809523809524;20;22;0.0238095238095238;0.476190476190476
Control.SRR15539829;48;45;0.5;24;24;0;0.5
Control.SRR15539829;47;45;0.659574468085106;16;31;0.159574468085106;0.340425531914894
Control.SRR15539829;45;45;0.533333333333333;21;24;0.0333333333333333;0.466666666666667
Control.SRR15539829;48;45;0.604166666666667;19;29;0.104166666666667;0.395833333333333
Control.SRR15539829;43;45;0.581395348837209;18;25;0.0813953488372093;0.418604651162791
Control.SRR15539829;49;45;0.489795918367347;25;24;0.0102040816326531;0.489795918367347
Control.SRR15539829;51;45;0.372549019607843;32;19;0.127450980392157;0.372549019607843
Control.SRR15539829;42;45;0.595238095238095;17;25;0.0952380952380952;0.404761904761905
Control.SRR15539829;43;45;0.534883720930233;20;23;0.0348837209302325;0.465116279069767
Control.SRR15539829;47;45;0.446808510638298;26;21;0.0531914893617021;0.446808510638298
Control.SRR15539829;48;45;0.395833333333333;29;19;0.104166666666667;0.395833333333333
Control.SRR15539829;43;45;0.418604651162791;25;18;0.0813953488372093;0.418604651162791
Control.SRR15539829;49;45;0.510204081632653;24;25;0.0102040816326531;0.489795918367347
Control.SRR15539829;46;45;0.543478260869565;21;25;0.0434782608695652;0.456521739130435
Control.SRR15539829;49;45;0.591836734693878;20;29;0.0918367346938775;0.408163265306122
Control.SRR15539829;42;45;0.619047619047619;16;26;0.119047619047619;0.380952380952381
Control.SRR15539829;44;45;0.613636363636364;17;27;0.113636363636364;0.386363636363636
Control.SRR15539829;43;45;0.441860465116279;24;19;0.0581395348837209;0.441860465116279
Control.SRR15539829;49;45;0.469387755102041;26;23;0.0306122448979592;0.469387755102041
Control.SRR15539829;47;45;0.468085106382979;25;22;0.0319148936170213;0.468085106382979
Control.SRR15539829;49;45;0.408163265306122;29;20;0.0918367346938775;0.408163265306122
Control.SRR15539829;51;45;0.392156862745098;31;20;0.107843137254902;0.392156862745098
Control.SRR15539829;50;45;0.66;17;33;0.16;0.34
Control.SRR15539829;42;45;0.523809523809524;20;22;0.0238095238095238;0.476190476190476
Control.SRR15539829;50;45;0.52;24;26;0.02;0.48
Control.SRR15539829;47;45;0.48936170212766;24;23;0.0106382978723404;0.48936170212766
Control.SRR15539829;49;45;0.469387755102041;26;23;0.0306122448979592;0.469387755102041
Control.SRR15539829;44;45;0.477272727272727;23;21;0.0227272727272727;0.477272727272727
Control.SRR15539829;42;45;0.476190476190476;22;20;0.0238095238095238;0.476190476190476
Control.SRR15539829;52;45;0.423076923076923;30;22;0.0769230769230769;0.423076923076923
Control.SRR15539829;44;45;0.477272727272727;23;21;0.0227272727272727;0.477272727272727
Control.SRR15539829;40;45;0.5;20;20;0;0.5
Control.SRR15539829;40;45;0.425;23;17;0.075;0.425
Control.SRR15539829;44;45;0.454545454545455;24;20;0.0454545454545455;0.454545454545455
Control.SRR15539829;43;45;0.581395348837209;18;25;0.0813953488372093;0.418604651162791
Control.SRR15539829;51;45;0.607843137254902;20;31;0.107843137254902;0.392156862745098
Control.SRR15539829;42;45;0.452380952380952;23;19;0.0476190476190476;0.452380952380952
Control.SRR15539829;43;45;0.558139534883721;19;24;0.0581395348837209;0.441860465116279
Control.SRR15539829;47;45;0.531914893617021;22;25;0.0319148936170213;0.468085106382979
Control.SRR15539829;49;45;0.571428571428571;21;28;0.0714285714285714;0.428571428571429
Control.SRR15539829;47;45;0.531914893617021;22;25;0.0319148936170213;0.468085106382979
Control.SRR15539829;40;45;0.65;14;26;0.15;0.35
Control.SRR15539829;40;45;0.575;17;23;0.075;0.425
Control.SRR15539829;43;45;0.488372093023256;22;21;0.0116279069767442;0.488372093023256
Control.SRR15539829;49;45;0.510204081632653;24;25;0.0102040816326531;0.489795918367347
Control.SRR15539829;51;45;0.549019607843137;23;28;0.0490196078431373;0.450980392156863
Control.SRR15539829;43;45;0.697674418604651;13;30;0.197674418604651;0.302325581395349
Control.SRR15539829;43;45;0.581395348837209;18;25;0.0813953488372093;0.418604651162791
Control.SRR15539829;46;45;0.543478260869565;21;25;0.0434782608695652;0.456521739130435
Control.SRR15539829;52;45;0.480769230769231;27;25;0.0192307692307692;0.480769230769231
Control.SRR15539829;43;45;0.395348837209302;26;17;0.104651162790698;0.395348837209302
Control.SRR15539829;47;45;0.404255319148936;28;19;0.0957446808510639;0.404255319148936
Control.SRR15539829;52;45;0.5;26;26;0;0.5
Control.SRR15539829;46;45;0.521739130434783;22;24;0.0217391304347826;0.478260869565217
Control.SRR15539829;46;45;0.521739130434783;22;24;0.0217391304347826;0.478260869565217
Control.SRR15539829;49;45;0.591836734693878;20;29;0.0918367346938775;0.408163265306122
Control.SRR15539829;52;45;0.384615384615385;32;20;0.115384615384615;0.384615384615385
Control.SRR15539829;52;45;0.576923076923077;22;30;0.0769230769230769;0.423076923076923
Control.SRR15539829;46;45;0.41304347826087;27;19;0.0869565217391304;0.41304347826087
Control.SRR15539829;43;45;0.372093023255814;27;16;0.127906976744186;0.372093023255814
Control.SRR15539829;47;45;0.404255319148936;28;19;0.0957446808510639;0.404255319148936
Control.SRR15539829;44;45;0.318181818181818;30;14;0.181818181818182;0.318181818181818
Control.SRR15539829;49;45;0.510204081632653;24;25;0.0102040816326531;0.489795918367347
Control.SRR15539829;48;45;0.5;24;24;0;0.5
Control.SRR15539829;45;45;0.488888888888889;23;22;0.0111111111111111;0.488888888888889
Control.SRR15539829;49;45;0.551020408163265;22;27;0.0510204081632653;0.448979591836735
Control.SRR15539829;40;45;0.475;21;19;0.025;0.475
Control.SRR15539829;46;45;0.5;23;23;0;0.5
Control.SRR15539829;41;45;0.414634146341463;24;17;0.0853658536585366;0.414634146341463
Control.SRR15539829;45;45;0.4;27;18;0.1;0.4
Control.SRR15539829;47;45;0.574468085106383;20;27;0.074468085106383;0.425531914893617
Control.SRR15539829;44;45;0.409090909090909;26;18;0.0909090909090909;0.409090909090909
Control.SRR15539829;44;45;0.477272727272727;23;21;0.0227272727272727;0.477272727272727
Control.SRR15539829;49;45;0.612244897959184;19;30;0.112244897959184;0.387755102040816
Control.SRR15539829;47;45;0.425531914893617;27;20;0.074468085106383;0.425531914893617
Control.SRR15539829;49;45;0.469387755102041;26;23;0.0306122448979592;0.469387755102041
Control.SRR15539829;51;45;0.470588235294118;27;24;0.0294117647058824;0.470588235294118
Control.SRR15539829;50;45;0.48;26;24;0.02;0.48
Control.SRR15539829;52;45;0.576923076923077;22;30;0.0769230769230769;0.423076923076923
Control.SRR15539829;45;45;0.466666666666667;24;21;0.0333333333333333;0.466666666666667
Control.SRR15539829;42;45;0.571428571428571;18;24;0.0714285714285714;0.428571428571429
Control.SRR15539829;44;45;0.5;22;22;0;0.5
Control.SRR15539829;45;45;0.6;18;27;0.1;0.4
Control.SRR15539829;51;45;0.627450980392157;19;32;0.127450980392157;0.372549019607843
Control.SRR15539829;51;45;0.647058823529412;18;33;0.147058823529412;0.352941176470588
Control.SRR15539829;43;45;0.558139534883721;19;24;0.0581395348837209;0.441860465116279
Control.SRR15539829;44;45;0.409090909090909;26;18;0.0909090909090909;0.409090909090909
Control.SRR15539829;44;45;0.545454545454545;20;24;0.0454545454545454;0.454545454545455
Control.SRR15539829;51;45;0.509803921568627;25;26;0.00980392156862742;0.490196078431373
Control.SRR15539829;47;45;0.595744680851064;19;28;0.0957446808510638;0.404255319148936
Control.SRR15539829;46;45;0.5;23;23;0;0.5
Control.SRR15539829;43;45;0.511627906976744;21;22;0.0116279069767442;0.488372093023256
Control.SRR15539829;40;45;0.525;19;21;0.025;0.475
Control.SRR15539829;51;45;0.509803921568627;25;26;0.00980392156862742;0.490196078431373
Control.SRR15539829;50;45;0.52;24;26;0.02;0.48
Control.SRR15539829;44;45;0.409090909090909;26;18;0.0909090909090909;0.409090909090909
Control.SRR15539829;46;45;0.543478260869565;21;25;0.0434782608695652;0.456521739130435
Control.SRR15539829;42;45;0.452380952380952;23;19;0.0476190476190476;0.452380952380952
Control.SRR15539829;47;45;0.553191489361702;21;26;0.0531914893617021;0.446808510638298
Control.SRR15539829;46;45;0.456521739130435;25;21;0.0434782608695652;0.456521739130435
Control.SRR15539829;44;45;0.568181818181818;19;25;0.0681818181818182;0.431818181818182
Control.SRR15539829;49;45;0.428571428571429;28;21;0.0714285714285715;0.428571428571429
Control.SRR15539829;46;45;0.41304347826087;27;19;0.0869565217391304;0.41304347826087
Control.SRR15539829;46;45;0.58695652173913;19;27;0.0869565217391305;0.41304347826087
Control.SRR15539829;45;45;0.555555555555556;20;25;0.0555555555555556;0.444444444444444
Control.SRR15539829;45;45;0.577777777777778;19;26;0.0777777777777777;0.422222222222222
Control.SRR15539829;49;45;0.510204081632653;24;25;0.0102040816326531;0.489795918367347
Control.SRR15539829;45;45;0.577777777777778;19;26;0.0777777777777777;0.422222222222222
Control.SRR15539829;51;45;0.490196078431373;26;25;0.00980392156862747;0.490196078431373
Control.SRR15539829;44;45;0.477272727272727;23;21;0.0227272727272727;0.477272727272727
Control.SRR15539829;43;45;0.511627906976744;21;22;0.0116279069767442;0.488372093023256
Control.SRR15539829;40;45;0.625;15;25;0.125;0.375
Control.SRR15539829;40;45;0.4;24;16;0.1;0.4
Control.SRR15539829;51;45;0.627450980392157;19;32;0.127450980392157;0.372549019607843
Control.SRR15539829;42;45;0.476190476190476;22;20;0.0238095238095238;0.476190476190476
Control.SRR15539829;43;45;0.581395348837209;18;25;0.0813953488372093;0.418604651162791
Control.SRR15539829;45;45;0.488888888888889;23;22;0.0111111111111111;0.488888888888889
Control.SRR15539829;48;45;0.541666666666667;22;26;0.0416666666666666;0.458333333333333
Control.SRR15539829;48;45;0.479166666666667;25;23;0.0208333333333333;0.479166666666667
Control.SRR15539829;49;45;0.489795918367347;25;24;0.0102040816326531;0.489795918367347
Control.SRR15539829;41;45;0.560975609756098;18;23;0.0609756097560976;0.439024390243902
Control.SRR15539829;43;45;0.465116279069767;23;20;0.0348837209302326;0.465116279069767
Control.SRR15539829;49;45;0.469387755102041;26;23;0.0306122448979592;0.469387755102041
Control.SRR15539829;49;45;0.63265306122449;18;31;0.13265306122449;0.36734693877551
Control.SRR15539829;44;45;0.681818181818182;14;30;0.181818181818182;0.318181818181818
Control.SRR15539829;44;45;0.590909090909091;18;26;0.0909090909090909;0.409090909090909
Control.SRR15539829;51;45;0.549019607843137;23;28;0.0490196078431373;0.450980392156863
Control.SRR15539829;47;45;0.574468085106383;20;27;0.074468085106383;0.425531914893617
Control.SRR15539829;49;45;0.489795918367347;25;24;0.0102040816326531;0.489795918367347
Control.SRR15539829;42;45;0.523809523809524;20;22;0.0238095238095238;0.476190476190476
Control.SRR15539829;49;45;0.551020408163265;22;27;0.0510204081632653;0.448979591836735
Control.SRR15539829;51;45;0.392156862745098;31;20;0.107843137254902;0.392156862745098
Control.SRR15539829;47;45;0.574468085106383;20;27;0.074468085106383;0.425531914893617
Control.SRR15539829;46;45;0.652173913043478;16;30;0.152173913043478;0.347826086956522
Control.SRR15539829;44;45;0.409090909090909;26;18;0.0909090909090909;0.409090909090909
Control.SRR15539829;51;45;0.470588235294118;27;24;0.0294117647058824;0.470588235294118
Control.SRR15539829;40;45;0.575;17;23;0.075;0.425
Control.SRR15539829;42;45;0.523809523809524;20;22;0.0238095238095238;0.476190476190476
Control.SRR15539829;43;45;0.511627906976744;21;22;0.0116279069767442;0.488372093023256
Control.SRR15539829;40;45;0.55;18;22;0.05;0.45
Control.SRR15539829;50;45;0.54;23;27;0.04;0.46
Control.SRR15539829;48;45;0.479166666666667;25;23;0.0208333333333333;0.479166666666667
Control.SRR15539829;50;45;0.36;32;18;0.14;0.36
Control.SRR15539829;50;45;0.42;29;21;0.08;0.42
Control.SRR15539829;48;45;0.5;24;24;0;0.5
Control.SRR15539829;50;45;0.56;22;28;0.0600000000000001;0.44
Control.SRR15539829;48;45;0.541666666666667;22;26;0.0416666666666666;0.458333333333333
Control.SRR15539829;45;45;0.577777777777778;19;26;0.0777777777777777;0.422222222222222
Control.SRR15539829;49;45;0.387755102040816;30;19;0.112244897959184;0.387755102040816
Control.SRR15539829;49;45;0.489795918367347;25;24;0.0102040816326531;0.489795918367347
Control.SRR15539829;50;45;0.36;32;18;0.14;0.36
Control.SRR15539829;42;45;0.595238095238095;17;25;0.0952380952380952;0.404761904761905
Control.SRR15539829;48;45;0.5;24;24;0;0.5
Control.SRR15539829;43;45;0.395348837209302;26;17;0.104651162790698;0.395348837209302
Control.SRR15539829;51;45;0.529411764705882;24;27;0.0294117647058824;0.470588235294118
Control.SRR15539829;45;45;0.511111111111111;22;23;0.0111111111111111;0.488888888888889
Control.SRR15539829;42;45;0.547619047619048;19;23;0.0476190476190477;0.452380952380952
Control.SRR15539829;40;45;0.375;25;15;0.125;0.375
Control.SRR15539829;48;45;0.395833333333333;29;19;0.104166666666667;0.395833333333333
Control.SRR15539829;50;45;0.44;28;22;0.06;0.44
Control.SRR15539829;45;45;0.622222222222222;17;28;0.122222222222222;0.377777777777778
Control.SRR15539829;51;45;0.470588235294118;27;24;0.0294117647058824;0.470588235294118
Control.SRR15539829;50;45;0.46;27;23;0.04;0.46
Control.SRR15539829;51;45;0.490196078431373;26;25;0.00980392156862747;0.490196078431373
Control.SRR15539829;43;45;0.465116279069767;23;20;0.0348837209302326;0.465116279069767
Control.SRR15539829;40;45;0.625;15;25;0.125;0.375
Control.SRR15539829;47;45;0.425531914893617;27;20;0.074468085106383;0.425531914893617
Control.SRR15539829;44;45;0.522727272727273;21;23;0.0227272727272727;0.477272727272727
Control.SRR15539829;41;45;0.48780487804878;21;20;0.0121951219512195;0.48780487804878
Control.SRR15539829;41;45;0.48780487804878;21;20;0.0121951219512195;0.48780487804878
Control.SRR15539829;52;45;0.5;26;26;0;0.5
Control.SRR15539829;42;45;0.333333333333333;28;14;0.166666666666667;0.333333333333333
Control.SRR15539829;42;45;0.452380952380952;23;19;0.0476190476190476;0.452380952380952
Control.SRR15539829;42;45;0.476190476190476;22;20;0.0238095238095238;0.476190476190476
Control.SRR15539829;49;45;0.387755102040816;30;19;0.112244897959184;0.387755102040816
Control.SRR15539829;49;45;0.387755102040816;30;19;0.112244897959184;0.387755102040816
Control.SRR15539829;40;45;0.475;21;19;0.025;0.475
Control.SRR15539829;43;45;0.534883720930233;20;23;0.0348837209302325;0.465116279069767
Control.SRR15539829;42;45;0.452380952380952;23;19;0.0476190476190476;0.452380952380952
Control.SRR15539829;43;45;0.465116279069767;23;20;0.0348837209302326;0.465116279069767
Control.SRR15539829;41;45;0.51219512195122;20;21;0.0121951219512195;0.48780487804878
Control.SRR15539829;43;45;0.325581395348837;29;14;0.174418604651163;0.325581395348837
Control.SRR15539829;51;45;0.588235294117647;21;30;0.0882352941176471;0.411764705882353
Control.SRR15539829;52;45;0.480769230769231;27;25;0.0192307692307692;0.480769230769231
Control.SRR15539829;48;45;0.4375;27;21;0.0625;0.4375
Control.SRR15539829;52;45;0.596153846153846;21;31;0.0961538461538461;0.403846153846154
Control.SRR15539829;48;45;0.4375;27;21;0.0625;0.4375
Control.SRR15539829;41;45;0.536585365853659;19;22;0.0365853658536586;0.463414634146341
Control.SRR15539829;50;45;0.4;30;20;0.1;0.4
Control.SRR15539829;52;45;0.326923076923077;35;17;0.173076923076923;0.326923076923077
Control.SRR15539829;51;45;0.450980392156863;28;23;0.0490196078431372;0.450980392156863
Control.SRR15539829;46;45;0.369565217391304;29;17;0.130434782608696;0.369565217391304
Control.SRR15539829;41;45;0.463414634146341;22;19;0.0365853658536585;0.463414634146341
Control.SRR15539829;42;45;0.5;21;21;0;0.5
Control.SRR15539829;47;45;0.51063829787234;23;24;0.0106382978723404;0.48936170212766
Control.SRR15539829;47;45;0.446808510638298;26;21;0.0531914893617021;0.446808510638298
Control.SRR15539829;41;45;0.48780487804878;21;20;0.0121951219512195;0.48780487804878
Control.SRR15539829;52;45;0.423076923076923;30;22;0.0769230769230769;0.423076923076923
Control.SRR15539829;41;45;0.439024390243902;23;18;0.0609756097560976;0.439024390243902
Control.SRR15539829;40;45;0.425;23;17;0.075;0.425
Control.SRR15539829;50;45;0.54;23;27;0.04;0.46
Control.SRR15539829;52;45;0.423076923076923;30;22;0.0769230769230769;0.423076923076923
Control.SRR15539829;52;45;0.576923076923077;22;30;0.0769230769230769;0.423076923076923
Control.SRR15539829;50;45;0.46;27;23;0.04;0.46
Control.SRR15539829;50;45;0.52;24;26;0.02;0.48
Control.SRR15539829;50;45;0.48;26;24;0.02;0.48
Control.SRR15539829;51;45;0.509803921568627;25;26;0.00980392156862742;0.490196078431373
Control.SRR15539829;44;45;0.5;22;22;0;0.5
Control.SRR15539829;43;45;0.465116279069767;23;20;0.0348837209302326;0.465116279069767
Control.SRR15539829;42;45;0.476190476190476;22;20;0.0238095238095238;0.476190476190476
Control.SRR15539829;43;45;0.534883720930233;20;23;0.0348837209302325;0.465116279069767
Control.SRR15539829;52;45;0.461538461538462;28;24;0.0384615384615384;0.461538461538462
Control.SRR15539829;45;45;0.488888888888889;23;22;0.0111111111111111;0.488888888888889
Control.SRR15539829;44;45;0.545454545454545;20;24;0.0454545454545454;0.454545454545455
Control.SRR15539829;41;45;0.414634146341463;24;17;0.0853658536585366;0.414634146341463
Control.SRR15539829;50;45;0.52;24;26;0.02;0.48
Control.SRR15539829;46;45;0.434782608695652;26;20;0.0652173913043478;0.434782608695652
Control.SRR15539829;45;45;0.555555555555556;20;25;0.0555555555555556;0.444444444444444
Control.SRR15539829;41;45;0.51219512195122;20;21;0.0121951219512195;0.48780487804878
Control.SRR15539829;50;45;0.64;18;32;0.14;0.36
Control.SRR15539829;41;45;0.292682926829268;29;12;0.207317073170732;0.292682926829268
Control.SRR15539829;40;45;0.375;25;15;0.125;0.375
Control.SRR15539829;42;45;0.547619047619048;19;23;0.0476190476190477;0.452380952380952
Control.SRR15539829;49;45;0.489795918367347;25;24;0.0102040816326531;0.489795918367347
Control.SRR15539829;46;45;0.478260869565217;24;22;0.0217391304347826;0.478260869565217
Control.SRR15539829;46;45;0.434782608695652;26;20;0.0652173913043478;0.434782608695652
Control.SRR15539829;48;45;0.375;30;18;0.125;0.375
Control.SRR15539829;49;45;0.530612244897959;23;26;0.0306122448979592;0.469387755102041
Control.SRR15539829;47;45;0.659574468085106;16;31;0.159574468085106;0.340425531914894
Control.SRR15539829;45;45;0.6;18;27;0.1;0.4
Control.SRR15539829;52;45;0.538461538461538;24;28;0.0384615384615384;0.461538461538462
Control.SRR15539829;47;45;0.48936170212766;24;23;0.0106382978723404;0.48936170212766
Control.SRR15539829;44;45;0.545454545454545;20;24;0.0454545454545454;0.454545454545455
Control.SRR15539829;51;45;0.529411764705882;24;27;0.0294117647058824;0.470588235294118
Control.SRR15539829;46;45;0.5;23;23;0;0.5
Control.SRR15539829;44;45;0.522727272727273;21;23;0.0227272727272727;0.477272727272727
Control.SRR15539829;40;45;0.45;22;18;0.05;0.45
Control.SRR15539829;48;45;0.520833333333333;23;25;0.0208333333333334;0.479166666666667
Control.SRR15539829;44;45;0.477272727272727;23;21;0.0227272727272727;0.477272727272727
Control.SRR15539829;47;45;0.468085106382979;25;22;0.0319148936170213;0.468085106382979
Control.SRR15539829;48;45;0.541666666666667;22;26;0.0416666666666666;0.458333333333333
Control.SRR15539829;50;45;0.5;25;25;0;0.5
Control.SRR15539829;50;45;0.62;19;31;0.12;0.38
Control.SRR15539829;49;45;0.489795918367347;25;24;0.0102040816326531;0.489795918367347
Control.SRR15539829;41;45;0.585365853658537;17;24;0.0853658536585366;0.414634146341463
Control.SRR15539829;49;45;0.571428571428571;21;28;0.0714285714285714;0.428571428571429
Control.SRR15539829;50;45;0.48;26;24;0.02;0.48
Control.SRR15539829;46;45;0.543478260869565;21;25;0.0434782608695652;0.456521739130435
Control.SRR15539829;47;45;0.446808510638298;26;21;0.0531914893617021;0.446808510638298
Control.SRR15539829;41;45;0.365853658536585;26;15;0.134146341463415;0.365853658536585
Control.SRR15539829;51;45;0.470588235294118;27;24;0.0294117647058824;0.470588235294118
Control.SRR15539829;51;45;0.568627450980392;22;29;0.0686274509803921;0.431372549019608
Control.SRR15539829;50;45;0.58;21;29;0.08;0.42
Control.SRR15539829;43;45;0.348837209302326;28;15;0.151162790697674;0.348837209302326
Control.SRR15539829;40;45;0.5;20;20;0;0.5
Control.SRR15539829;50;45;0.5;25;25;0;0.5
Control.SRR15539829;43;45;0.348837209302326;28;15;0.151162790697674;0.348837209302326
Control.SRR15539829;43;45;0.581395348837209;18;25;0.0813953488372093;0.418604651162791
Control.SRR15539829;46;45;0.41304347826087;27;19;0.0869565217391304;0.41304347826087
Control.SRR15539829;43;45;0.511627906976744;21;22;0.0116279069767442;0.488372093023256
Control.SRR15539829;40;45;0.625;15;25;0.125;0.375
Control.SRR15539829;52;45;0.442307692307692;29;23;0.0576923076923077;0.442307692307692
Control.SRR15539829;40;45;0.625;15;25;0.125;0.375
Control.SRR15539829;44;45;0.454545454545455;24;20;0.0454545454545455;0.454545454545455
Control.SRR15539829;40;45;0.4;24;16;0.1;0.4
Control.SRR15539829;49;45;0.510204081632653;24;25;0.0102040816326531;0.489795918367347
Control.SRR15539829;45;45;0.511111111111111;22;23;0.0111111111111111;0.488888888888889
Control.SRR15539829;46;45;0.565217391304348;20;26;0.0652173913043478;0.434782608695652
Control.SRR15539829;46;45;0.434782608695652;26;20;0.0652173913043478;0.434782608695652
Control.SRR15539829;41;45;0.317073170731707;28;13;0.182926829268293;0.317073170731707
Control.SRR15539829;44;45;0.5;22;22;0;0.5
Control.SRR15539829;43;45;0.488372093023256;22;21;0.0116279069767442;0.488372093023256
Control.SRR15539829;45;45;0.444444444444444;25;20;0.0555555555555556;0.444444444444444
Control.SRR15539829;45;45;0.6;18;27;0.1;0.4
Control.SRR15539829;44;45;0.522727272727273;21;23;0.0227272727272727;0.477272727272727
Control.SRR15539829;49;45;0.448979591836735;27;22;0.0510204081632653;0.448979591836735
Control.SRR15539829;41;45;0.51219512195122;20;21;0.0121951219512195;0.48780487804878
Control.SRR15539829;51;45;0.509803921568627;25;26;0.00980392156862742;0.490196078431373
Control.SRR15539829;42;45;0.333333333333333;28;14;0.166666666666667;0.333333333333333
Control.SRR15539829;42;45;0.619047619047619;16;26;0.119047619047619;0.380952380952381
Control.SRR15539829;49;45;0.387755102040816;30;19;0.112244897959184;0.387755102040816
Control.SRR15539829;52;45;0.519230769230769;25;27;0.0192307692307693;0.480769230769231
Control.SRR15539829;47;45;0.574468085106383;20;27;0.074468085106383;0.425531914893617
Control.SRR15539829;49;45;0.551020408163265;22;27;0.0510204081632653;0.448979591836735
Control.SRR15539829;52;45;0.403846153846154;31;21;0.0961538461538461;0.403846153846154
Control.SRR15539829;51;45;0.568627450980392;22;29;0.0686274509803921;0.431372549019608
Control.SRR15539829;50;45;0.5;25;25;0;0.5
Control.SRR15539829;45;45;0.444444444444444;25;20;0.0555555555555556;0.444444444444444
Control.SRR15539829;47;45;0.595744680851064;19;28;0.0957446808510638;0.404255319148936
Control.SRR15539829;43;45;0.348837209302326;28;15;0.151162790697674;0.348837209302326
Control.SRR15539829;44;45;0.590909090909091;18;26;0.0909090909090909;0.409090909090909
Control.SRR15539829;45;45;0.6;18;27;0.1;0.4
Control.SRR15539829;51;45;0.647058823529412;18;33;0.147058823529412;0.352941176470588
Control.SRR15539829;42;45;0.476190476190476;22;20;0.0238095238095238;0.476190476190476
Control.SRR15539829;49;45;0.489795918367347;25;24;0.0102040816326531;0.489795918367347
Control.SRR15539829;48;45;0.5;24;24;0;0.5
Control.SRR15539829;49;45;0.428571428571429;28;21;0.0714285714285715;0.428571428571429
Control.SRR15539829;45;45;0.533333333333333;21;24;0.0333333333333333;0.466666666666667
Control.SRR15539829;52;45;0.461538461538462;28;24;0.0384615384615384;0.461538461538462
Control.SRR15539829;46;45;0.478260869565217;24;22;0.0217391304347826;0.478260869565217
Control.SRR15539829;50;45;0.42;29;21;0.08;0.42
Control.SRR15539829;48;45;0.5625;21;27;0.0625;0.4375
Control.SRR15539829;48;45;0.520833333333333;23;25;0.0208333333333334;0.479166666666667
Control.SRR15539829;48;45;0.416666666666667;28;20;0.0833333333333333;0.416666666666667
Control.SRR15539829;50;45;0.42;29;21;0.08;0.42
Control.SRR15539829;52;45;0.480769230769231;27;25;0.0192307692307692;0.480769230769231
Control.SRR15539829;46;45;0.5;23;23;0;0.5
Control.SRR15539829;47;45;0.595744680851064;19;28;0.0957446808510638;0.404255319148936
Control.SRR15539829;51;45;0.529411764705882;24;27;0.0294117647058824;0.470588235294118
Control.SRR15539829;46;45;0.369565217391304;29;17;0.130434782608696;0.369565217391304
Control.SRR15539829;49;45;0.551020408163265;22;27;0.0510204081632653;0.448979591836735
Control.SRR15539829;47;45;0.48936170212766;24;23;0.0106382978723404;0.48936170212766
Control.SRR15539829;48;45;0.625;18;30;0.125;0.375
Control.SRR15539829;50;45;0.42;29;21;0.08;0.42
Control.SRR15539829;44;45;0.613636363636364;17;27;0.113636363636364;0.386363636363636
Control.SRR15539829;42;45;0.571428571428571;18;24;0.0714285714285714;0.428571428571429
Control.SRR15539829;47;45;0.468085106382979;25;22;0.0319148936170213;0.468085106382979
Control.SRR15539829;47;45;0.51063829787234;23;24;0.0106382978723404;0.48936170212766
Control.SRR15539829;47;45;0.425531914893617;27;20;0.074468085106383;0.425531914893617
Control.SRR15539829;40;45;0.45;22;18;0.05;0.45
Control.SRR15539829;43;45;0.465116279069767;23;20;0.0348837209302326;0.465116279069767
Control.SRR15539829;40;45;0.575;17;23;0.075;0.425
Control.SRR15539829;41;45;0.536585365853659;19;22;0.0365853658536586;0.463414634146341
Control.SRR15539829;43;45;0.418604651162791;25;18;0.0813953488372093;0.418604651162791
Control.SRR15539829;50;45;0.4;30;20;0.1;0.4
Control.SRR15539829;45;45;0.555555555555556;20;25;0.0555555555555556;0.444444444444444
Control.SRR15539829;50;45;0.48;26;24;0.02;0.48
Control.SRR15539829;46;45;0.5;23;23;0;0.5
Control.SRR15539829;42;45;0.476190476190476;22;20;0.0238095238095238;0.476190476190476
Control.SRR15539829;47;45;0.51063829787234;23;24;0.0106382978723404;0.48936170212766
Control.SRR15539829;52;45;0.615384615384615;20;32;0.115384615384615;0.384615384615385
Control.SRR15539829;41;45;0.51219512195122;20;21;0.0121951219512195;0.48780487804878
Control.SRR15539829;42;45;0.428571428571429;24;18;0.0714285714285715;0.428571428571429
Control.SRR15539829;48;45;0.645833333333333;17;31;0.145833333333333;0.354166666666667
Control.SRR15539829;49;45;0.387755102040816;30;19;0.112244897959184;0.387755102040816
Control.SRR15539829;41;45;0.48780487804878;21;20;0.0121951219512195;0.48780487804878
Control.SRR15539829;45;45;0.488888888888889;23;22;0.0111111111111111;0.488888888888889
Control.SRR15539829;47;45;0.425531914893617;27;20;0.074468085106383;0.425531914893617
Control.SRR15539829;49;45;0.489795918367347;25;24;0.0102040816326531;0.489795918367347
Control.SRR15539829;47;45;0.553191489361702;21;26;0.0531914893617021;0.446808510638298
Control.SRR15539829;52;45;0.5;26;26;0;0.5
Control.SRR15539829;43;45;0.418604651162791;25;18;0.0813953488372093;0.418604651162791
Control.SRR15539829;51;45;0.529411764705882;24;27;0.0294117647058824;0.470588235294118
Control.SRR15539829;40;45;0.425;23;17;0.075;0.425
Control.SRR15539829;43;45;0.511627906976744;21;22;0.0116279069767442;0.488372093023256
Control.SRR15539829;40;45;0.45;22;18;0.05;0.45
Control.SRR15539829;41;45;0.48780487804878;21;20;0.0121951219512195;0.48780487804878
Control.SRR15539829;52;45;0.557692307692308;23;29;0.0576923076923077;0.442307692307692
Control.SRR15539829;50;45;0.5;25;25;0;0.5
Control.SRR15539829;52;45;0.461538461538462;28;24;0.0384615384615384;0.461538461538462
Control.SRR15539829;41;45;0.585365853658537;17;24;0.0853658536585366;0.414634146341463
Control.SRR15539829;42;45;0.595238095238095;17;25;0.0952380952380952;0.404761904761905
Control.SRR15539829;46;45;0.391304347826087;28;18;0.108695652173913;0.391304347826087
Control.SRR15539829;42;45;0.547619047619048;19;23;0.0476190476190477;0.452380952380952
Control.SRR15539829;40;45;0.375;25;15;0.125;0.375
Control.SRR15539829;45;45;0.422222222222222;26;19;0.0777777777777778;0.422222222222222
Control.SRR15539829;48;45;0.5625;21;27;0.0625;0.4375
Control.SRR15539829;51;45;0.529411764705882;24;27;0.0294117647058824;0.470588235294118
Control.SRR15539829;41;45;0.414634146341463;24;17;0.0853658536585366;0.414634146341463
Control.SRR15539829;42;45;0.547619047619048;19;23;0.0476190476190477;0.452380952380952
Control.SRR15539829;44;45;0.590909090909091;18;26;0.0909090909090909;0.409090909090909
Control.SRR15539829;47;45;0.595744680851064;19;28;0.0957446808510638;0.404255319148936
Control.SRR15539829;41;45;0.48780487804878;21;20;0.0121951219512195;0.48780487804878
Control.SRR15539829;42;45;0.404761904761905;25;17;0.0952380952380952;0.404761904761905
Control.SRR15539829;52;45;0.5;26;26;0;0.5
Control.SRR15539829;42;45;0.547619047619048;19;23;0.0476190476190477;0.452380952380952
Control.SRR15539829;43;45;0.534883720930233;20;23;0.0348837209302325;0.465116279069767
Control.SRR15539829;42;45;0.452380952380952;23;19;0.0476190476190476;0.452380952380952
Control.SRR15539829;45;45;0.444444444444444;25;20;0.0555555555555556;0.444444444444444
Control.SRR15539829;43;45;0.372093023255814;27;16;0.127906976744186;0.372093023255814
Control.SRR15539829;42;45;0.476190476190476;22;20;0.0238095238095238;0.476190476190476
Control.SRR15539829;48;45;0.541666666666667;22;26;0.0416666666666666;0.458333333333333
Control.SRR15539829;44;45;0.522727272727273;21;23;0.0227272727272727;0.477272727272727
Control.SRR15539829;45;45;0.511111111111111;22;23;0.0111111111111111;0.488888888888889
Control.SRR15539829;40;45;0.675;13;27;0.175;0.325
Control.SRR15539829;50;45;0.38;31;19;0.12;0.38
Control.SRR15539829;47;45;0.446808510638298;26;21;0.0531914893617021;0.446808510638298
Control.SRR15539829;51;45;0.470588235294118;27;24;0.0294117647058824;0.470588235294118
Control.SRR15539829;50;45;0.54;23;27;0.04;0.46
Control.SRR15539829;43;45;0.558139534883721;19;24;0.0581395348837209;0.441860465116279
Control.SRR15539829;48;45;0.5625;21;27;0.0625;0.4375
Control.SRR15539829;49;45;0.489795918367347;25;24;0.0102040816326531;0.489795918367347
Control.SRR15539829;48;45;0.520833333333333;23;25;0.0208333333333334;0.479166666666667
Control.SRR15539829;40;45;0.525;19;21;0.025;0.475
Control.SRR15539829;43;45;0.395348837209302;26;17;0.104651162790698;0.395348837209302
Control.SRR15539829;44;45;0.545454545454545;20;24;0.0454545454545454;0.454545454545455
Control.SRR15539829;46;45;0.5;23;23;0;0.5
Control.SRR15539829;44;45;0.613636363636364;17;27;0.113636363636364;0.386363636363636
Control.SRR15539829;51;45;0.568627450980392;22;29;0.0686274509803921;0.431372549019608
Control.SRR15539829;51;45;0.509803921568627;25;26;0.00980392156862742;0.490196078431373
Control.SRR15539829;49;45;0.551020408163265;22;27;0.0510204081632653;0.448979591836735
Control.SRR15539829;45;45;0.511111111111111;22;23;0.0111111111111111;0.488888888888889
Control.SRR15539829;40;45;0.45;22;18;0.05;0.45
Control.SRR15539829;44;45;0.431818181818182;25;19;0.0681818181818182;0.431818181818182
Control.SRR15539829;46;45;0.521739130434783;22;24;0.0217391304347826;0.478260869565217
Control.SRR15539829;51;45;0.549019607843137;23;28;0.0490196078431373;0.450980392156863
Control.SRR15539829;51;45;0.490196078431373;26;25;0.00980392156862747;0.490196078431373
Control.SRR15539829;45;45;0.444444444444444;25;20;0.0555555555555556;0.444444444444444
Control.SRR15539829;50;45;0.52;24;26;0.02;0.48
Control.SRR15539829;46;45;0.456521739130435;25;21;0.0434782608695652;0.456521739130435
Control.SRR15539829;43;45;0.534883720930233;20;23;0.0348837209302325;0.465116279069767
Control.SRR15539829;45;45;0.444444444444444;25;20;0.0555555555555556;0.444444444444444
Control.SRR15539829;42;45;0.380952380952381;26;16;0.119047619047619;0.380952380952381
Control.SRR15539829;40;45;0.425;23;17;0.075;0.425
Control.SRR15539829;41;45;0.51219512195122;20;21;0.0121951219512195;0.48780487804878
Control.SRR15539829;52;45;0.538461538461538;24;28;0.0384615384615384;0.461538461538462
Control.SRR15539829;47;45;0.468085106382979;25;22;0.0319148936170213;0.468085106382979
Control.SRR15539829;49;45;0.469387755102041;26;23;0.0306122448979592;0.469387755102041
Control.SRR15539829;47;45;0.617021276595745;18;29;0.117021276595745;0.382978723404255
Control.SRR15539829;45;45;0.511111111111111;22;23;0.0111111111111111;0.488888888888889
Control.SRR15539829;45;45;0.511111111111111;22;23;0.0111111111111111;0.488888888888889
Control.SRR15539829;44;45;0.431818181818182;25;19;0.0681818181818182;0.431818181818182
Control.SRR15539829;40;45;0.5;20;20;0;0.5
Control.SRR15539829;42;45;0.452380952380952;23;19;0.0476190476190476;0.452380952380952
Control.SRR15539829;42;45;0.452380952380952;23;19;0.0476190476190476;0.452380952380952
Control.SRR15539829;51;45;0.431372549019608;29;22;0.0686274509803921;0.431372549019608
Control.SRR15539829;46;45;0.41304347826087;27;19;0.0869565217391304;0.41304347826087
Control.SRR15539829;46;45;0.434782608695652;26;20;0.0652173913043478;0.434782608695652
Control.SRR15539829;43;45;0.465116279069767;23;20;0.0348837209302326;0.465116279069767
Control.SRR15539829;46;45;0.565217391304348;20;26;0.0652173913043478;0.434782608695652
Control.SRR15539829;47;45;0.638297872340426;17;30;0.138297872340426;0.361702127659574
Control.SRR15539829;46;45;0.630434782608696;17;29;0.130434782608696;0.369565217391304
Control.SRR15539829;45;45;0.6;18;27;0.1;0.4
Control.SRR15539829;47;45;0.425531914893617;27;20;0.074468085106383;0.425531914893617
Control.SRR15539829;45;45;0.444444444444444;25;20;0.0555555555555556;0.444444444444444
Control.SRR15539829;52;45;0.615384615384615;20;32;0.115384615384615;0.384615384615385
Control.SRR15539829;45;45;0.422222222222222;26;19;0.0777777777777778;0.422222222222222
Control.SRR15539829;43;45;0.488372093023256;22;21;0.0116279069767442;0.488372093023256
Control.SRR15539829;47;45;0.51063829787234;23;24;0.0106382978723404;0.48936170212766
Control.SRR15539829;40;45;0.5;20;20;0;0.5
Control.SRR15539829;43;45;0.511627906976744;21;22;0.0116279069767442;0.488372093023256
Control.SRR15539829;52;45;0.596153846153846;21;31;0.0961538461538461;0.403846153846154
Control.SRR15539829;44;45;0.454545454545455;24;20;0.0454545454545455;0.454545454545455
Control.SRR15539829;46;45;0.543478260869565;21;25;0.0434782608695652;0.456521739130435
Control.SRR15539829;43;45;0.558139534883721;19;24;0.0581395348837209;0.441860465116279
Control.SRR15539829;41;45;0.609756097560976;16;25;0.109756097560976;0.390243902439024
Control.SRR15539829;42;45;0.476190476190476;22;20;0.0238095238095238;0.476190476190476
Control.SRR15539829;47;45;0.48936170212766;24;23;0.0106382978723404;0.48936170212766
Control.SRR15539829;48;45;0.541666666666667;22;26;0.0416666666666666;0.458333333333333
Control.SRR15539829;48;45;0.583333333333333;20;28;0.0833333333333334;0.416666666666667
Control.SRR15539829;42;45;0.452380952380952;23;19;0.0476190476190476;0.452380952380952
Control.SRR15539829;42;45;0.357142857142857;27;15;0.142857142857143;0.357142857142857
Control.SRR15539829;52;45;0.519230769230769;25;27;0.0192307692307693;0.480769230769231
Control.SRR15539829;43;45;0.488372093023256;22;21;0.0116279069767442;0.488372093023256
Control.SRR15539829;51;45;0.509803921568627;25;26;0.00980392156862742;0.490196078431373
Control.SRR15539829;45;45;0.533333333333333;21;24;0.0333333333333333;0.466666666666667
Control.SRR15539829;47;45;0.425531914893617;27;20;0.074468085106383;0.425531914893617
Control.SRR15539829;49;45;0.489795918367347;25;24;0.0102040816326531;0.489795918367347
Control.SRR15539829;45;45;0.355555555555556;29;16;0.144444444444444;0.355555555555556
Control.SRR15539829;40;45;0.375;25;15;0.125;0.375
Control.SRR15539829;52;45;0.519230769230769;25;27;0.0192307692307693;0.480769230769231
Control.SRR15539829;46;45;0.652173913043478;16;30;0.152173913043478;0.347826086956522
Control.SRR15539829;40;45;0.5;20;20;0;0.5
Control.SRR15539829;45;45;0.422222222222222;26;19;0.0777777777777778;0.422222222222222
Control.SRR15539829;48;45;0.458333333333333;26;22;0.0416666666666667;0.458333333333333
Control.SRR15539829;42;45;0.738095238095238;11;31;0.238095238095238;0.261904761904762
Control.SRR15539829;49;45;0.408163265306122;29;20;0.0918367346938775;0.408163265306122
Control.SRR15539829;45;45;0.466666666666667;24;21;0.0333333333333333;0.466666666666667
Control.SRR15539829;46;45;0.434782608695652;26;20;0.0652173913043478;0.434782608695652
Control.SRR15539829;41;45;0.560975609756098;18;23;0.0609756097560976;0.439024390243902
Control.SRR15539829;46;45;0.456521739130435;25;21;0.0434782608695652;0.456521739130435
Control.SRR15539829;44;45;0.522727272727273;21;23;0.0227272727272727;0.477272727272727
Control.SRR15539829;46;45;0.543478260869565;21;25;0.0434782608695652;0.456521739130435
Control.SRR15539829;43;45;0.488372093023256;22;21;0.0116279069767442;0.488372093023256
Control.SRR15539829;47;45;0.446808510638298;26;21;0.0531914893617021;0.446808510638298
Control.SRR15539829;46;45;0.521739130434783;22;24;0.0217391304347826;0.478260869565217
Control.SRR15539829;40;45;0.475;21;19;0.025;0.475
Control.SRR15539829;43;45;0.511627906976744;21;22;0.0116279069767442;0.488372093023256
Control.SRR15539829;51;45;0.490196078431373;26;25;0.00980392156862747;0.490196078431373
Control.SRR15539829;45;45;0.511111111111111;22;23;0.0111111111111111;0.488888888888889
Control.SRR15539829;48;45;0.583333333333333;20;28;0.0833333333333334;0.416666666666667
Control.SRR15539829;52;45;0.519230769230769;25;27;0.0192307692307693;0.480769230769231
Control.SRR15539829;46;45;0.434782608695652;26;20;0.0652173913043478;0.434782608695652
Control.SRR15539829;42;45;0.428571428571429;24;18;0.0714285714285715;0.428571428571429
Control.SRR15539829;47;45;0.382978723404255;29;18;0.117021276595745;0.382978723404255
Control.SRR15539829;50;45;0.48;26;24;0.02;0.48
Control.SRR15539829;50;45;0.46;27;23;0.04;0.46
Control.SRR15539829;43;45;0.418604651162791;25;18;0.0813953488372093;0.418604651162791
Control.SRR15539829;52;45;0.557692307692308;23;29;0.0576923076923077;0.442307692307692
Control.SRR15539829;45;45;0.555555555555556;20;25;0.0555555555555556;0.444444444444444
Control.SRR15539829;49;45;0.530612244897959;23;26;0.0306122448979592;0.469387755102041
Control.SRR15539829;42;45;0.452380952380952;23;19;0.0476190476190476;0.452380952380952
Control.SRR15539829;41;45;0.463414634146341;22;19;0.0365853658536585;0.463414634146341
Control.SRR15539829;48;45;0.3125;33;15;0.1875;0.3125
Control.SRR15539829;41;45;0.390243902439024;25;16;0.109756097560976;0.390243902439024
Control.SRR15539829;42;45;0.595238095238095;17;25;0.0952380952380952;0.404761904761905
Control.SRR15539829;46;45;0.630434782608696;17;29;0.130434782608696;0.369565217391304
Control.SRR15539829;44;45;0.431818181818182;25;19;0.0681818181818182;0.431818181818182
Control.SRR15539829;42;45;0.571428571428571;18;24;0.0714285714285714;0.428571428571429
Control.SRR15539829;46;45;0.608695652173913;18;28;0.108695652173913;0.391304347826087
Control.SRR15539829;44;45;0.431818181818182;25;19;0.0681818181818182;0.431818181818182
Control.SRR15539829;46;45;0.434782608695652;26;20;0.0652173913043478;0.434782608695652
Control.SRR15539829;47;45;0.638297872340426;17;30;0.138297872340426;0.361702127659574
Control.SRR15539829;40;45;0.475;21;19;0.025;0.475
Control.SRR15539829;41;45;0.585365853658537;17;24;0.0853658536585366;0.414634146341463
Control.SRR15539829;49;45;0.428571428571429;28;21;0.0714285714285715;0.428571428571429
Control.SRR15539829;44;45;0.568181818181818;19;25;0.0681818181818182;0.431818181818182
Control.SRR15539829;50;45;0.44;28;22;0.06;0.44
Control.SRR15539829;48;45;0.458333333333333;26;22;0.0416666666666667;0.458333333333333
Control.SRR15539829;43;45;0.558139534883721;19;24;0.0581395348837209;0.441860465116279
Control.SRR15539829;40;45;0.35;26;14;0.15;0.35
Control.SRR15539829;42;45;0.476190476190476;22;20;0.0238095238095238;0.476190476190476
Control.SRR15539829;40;45;0.55;18;22;0.05;0.45
Control.SRR15539829;41;45;0.390243902439024;25;16;0.109756097560976;0.390243902439024
Control.SRR15539829;43;45;0.488372093023256;22;21;0.0116279069767442;0.488372093023256
Control.SRR15539829;42;45;0.595238095238095;17;25;0.0952380952380952;0.404761904761905
Control.SRR15539829;50;45;0.42;29;21;0.08;0.42
Control.SRR15539829;52;45;0.557692307692308;23;29;0.0576923076923077;0.442307692307692
Control.SRR15539829;49;45;0.591836734693878;20;29;0.0918367346938775;0.408163265306122
Control.SRR15539829;42;45;0.523809523809524;20;22;0.0238095238095238;0.476190476190476
Control.SRR15539829;41;45;0.463414634146341;22;19;0.0365853658536585;0.463414634146341
Control.SRR15539829;41;45;0.463414634146341;22;19;0.0365853658536585;0.463414634146341
Control.SRR15539829;42;45;0.595238095238095;17;25;0.0952380952380952;0.404761904761905
Control.SRR15539829;40;45;0.5;20;20;0;0.5
Control.SRR15539829;51;45;0.431372549019608;29;22;0.0686274509803921;0.431372549019608
Control.SRR15539829;41;45;0.463414634146341;22;19;0.0365853658536585;0.463414634146341
Control.SRR15539829;47;45;0.574468085106383;20;27;0.074468085106383;0.425531914893617
Control.SRR15539829;46;45;0.521739130434783;22;24;0.0217391304347826;0.478260869565217
Control.SRR15539829;43;45;0.581395348837209;18;25;0.0813953488372093;0.418604651162791
Control.SRR15539829;47;45;0.617021276595745;18;29;0.117021276595745;0.382978723404255
Control.SRR15539829;48;45;0.520833333333333;23;25;0.0208333333333334;0.479166666666667
Control.SRR15539829;49;45;0.448979591836735;27;22;0.0510204081632653;0.448979591836735
Control.SRR15539829;40;45;0.525;19;21;0.025;0.475
Control.SRR15539829;49;45;0.510204081632653;24;25;0.0102040816326531;0.489795918367347
Control.SRR15539829;40;45;0.425;23;17;0.075;0.425
Control.SRR15539829;49;45;0.448979591836735;27;22;0.0510204081632653;0.448979591836735
Control.SRR15539829;46;45;0.565217391304348;20;26;0.0652173913043478;0.434782608695652
Control.SRR15539829;51;45;0.274509803921569;37;14;0.225490196078431;0.274509803921569
Control.SRR15539829;50;45;0.42;29;21;0.08;0.42
Control.SRR15539829;52;45;0.442307692307692;29;23;0.0576923076923077;0.442307692307692
Control.SRR15539829;51;45;0.372549019607843;32;19;0.127450980392157;0.372549019607843
Control.SRR15539829;42;45;0.357142857142857;27;15;0.142857142857143;0.357142857142857
Control.SRR15539829;42;45;0.452380952380952;23;19;0.0476190476190476;0.452380952380952
Control.SRR15539829;48;45;0.541666666666667;22;26;0.0416666666666666;0.458333333333333
Control.SRR15539829;42;45;0.428571428571429;24;18;0.0714285714285715;0.428571428571429
Control.SRR15539829;40;45;0.65;14;26;0.15;0.35
Control.SRR15539829;44;45;0.454545454545455;24;20;0.0454545454545455;0.454545454545455
Control.SRR15539829;45;45;0.577777777777778;19;26;0.0777777777777777;0.422222222222222
Control.SRR15539829;43;45;0.465116279069767;23;20;0.0348837209302326;0.465116279069767
Control.SRR15539829;43;45;0.511627906976744;21;22;0.0116279069767442;0.488372093023256
Control.SRR15539829;44;45;0.5;22;22;0;0.5
Control.SRR15539829;40;45;0.5;20;20;0;0.5
Control.SRR15539829;42;45;0.595238095238095;17;25;0.0952380952380952;0.404761904761905
Control.SRR15539829;51;45;0.450980392156863;28;23;0.0490196078431372;0.450980392156863
Control.SRR15539829;48;45;0.541666666666667;22;26;0.0416666666666666;0.458333333333333
Control.SRR15539829;52;45;0.596153846153846;21;31;0.0961538461538461;0.403846153846154
Control.SRR15539829;43;45;0.511627906976744;21;22;0.0116279069767442;0.488372093023256
Control.SRR15539829;47;45;0.340425531914894;31;16;0.159574468085106;0.340425531914894
Control.SRR15539829;42;45;0.404761904761905;25;17;0.0952380952380952;0.404761904761905
Control.SRR15539829;44;45;0.590909090909091;18;26;0.0909090909090909;0.409090909090909
Control.SRR15539829;45;45;0.666666666666667;15;30;0.166666666666667;0.333333333333333
Control.SRR15539829;45;45;0.577777777777778;19;26;0.0777777777777777;0.422222222222222
Control.SRR15539829;41;45;0.585365853658537;17;24;0.0853658536585366;0.414634146341463
Control.SRR15539829;40;45;0.575;17;23;0.075;0.425
Control.SRR15539829;51;45;0.568627450980392;22;29;0.0686274509803921;0.431372549019608
Control.SRR15539829;47;45;0.531914893617021;22;25;0.0319148936170213;0.468085106382979
Control.SRR15539829;49;45;0.510204081632653;24;25;0.0102040816326531;0.489795918367347
Control.SRR15539829;47;45;0.48936170212766;24;23;0.0106382978723404;0.48936170212766
Control.SRR15539829;42;45;0.523809523809524;20;22;0.0238095238095238;0.476190476190476
Control.SRR15539829;48;45;0.458333333333333;26;22;0.0416666666666667;0.458333333333333
Control.SRR15539829;52;45;0.519230769230769;25;27;0.0192307692307693;0.480769230769231
Control.SRR15539829;52;45;0.596153846153846;21;31;0.0961538461538461;0.403846153846154
Control.SRR15539829;50;45;0.48;26;24;0.02;0.48
Control.SRR15539829;49;45;0.408163265306122;29;20;0.0918367346938775;0.408163265306122
Control.SRR15539829;51;45;0.549019607843137;23;28;0.0490196078431373;0.450980392156863
Control.SRR15539829;44;45;0.340909090909091;29;15;0.159090909090909;0.340909090909091
Control.SRR15539829;46;45;0.608695652173913;18;28;0.108695652173913;0.391304347826087
Control.SRR15539829;41;45;0.536585365853659;19;22;0.0365853658536586;0.463414634146341
Control.SRR15539829;45;45;0.377777777777778;28;17;0.122222222222222;0.377777777777778
Control.SRR15539829;44;45;0.454545454545455;24;20;0.0454545454545455;0.454545454545455
Control.SRR15539829;47;45;0.531914893617021;22;25;0.0319148936170213;0.468085106382979
Control.SRR15539829;49;45;0.489795918367347;25;24;0.0102040816326531;0.489795918367347
Control.SRR15539829;50;45;0.56;22;28;0.0600000000000001;0.44
Control.SRR15539829;43;45;0.418604651162791;25;18;0.0813953488372093;0.418604651162791
Control.SRR15539829;51;45;0.509803921568627;25;26;0.00980392156862742;0.490196078431373
Control.SRR15539829;51;45;0.490196078431373;26;25;0.00980392156862747;0.490196078431373
Control.SRR15539829;49;45;0.346938775510204;32;17;0.153061224489796;0.346938775510204
Control.SRR15539829;48;45;0.520833333333333;23;25;0.0208333333333334;0.479166666666667
Control.SRR15539829;43;45;0.465116279069767;23;20;0.0348837209302326;0.465116279069767
Control.SRR15539829;43;45;0.488372093023256;22;21;0.0116279069767442;0.488372093023256
Control.SRR15539829;46;45;0.5;23;23;0;0.5
Control.SRR15539829;45;45;0.488888888888889;23;22;0.0111111111111111;0.488888888888889
Control.SRR15539829;44;45;0.590909090909091;18;26;0.0909090909090909;0.409090909090909
Control.SRR15539829;49;45;0.489795918367347;25;24;0.0102040816326531;0.489795918367347
Control.SRR15539829;44;45;0.522727272727273;21;23;0.0227272727272727;0.477272727272727
Control.SRR15539829;46;45;0.608695652173913;18;28;0.108695652173913;0.391304347826087
Control.SRR15539829;52;45;0.480769230769231;27;25;0.0192307692307692;0.480769230769231
Control.SRR15539829;49;45;0.489795918367347;25;24;0.0102040816326531;0.489795918367347
Control.SRR15539829;46;45;0.456521739130435;25;21;0.0434782608695652;0.456521739130435
Control.SRR15539829;45;45;0.488888888888889;23;22;0.0111111111111111;0.488888888888889
Control.SRR15539829;46;45;0.543478260869565;21;25;0.0434782608695652;0.456521739130435
Control.SRR15539829;47;45;0.574468085106383;20;27;0.074468085106383;0.425531914893617
Control.SRR15539829;51;45;0.647058823529412;18;33;0.147058823529412;0.352941176470588
Control.SRR15539829;50;45;0.4;30;20;0.1;0.4
Control.SRR15539829;52;45;0.557692307692308;23;29;0.0576923076923077;0.442307692307692
Control.SRR15539829;41;45;0.439024390243902;23;18;0.0609756097560976;0.439024390243902
Control.SRR15539829;41;45;0.463414634146341;22;19;0.0365853658536585;0.463414634146341
Control.SRR15539829;40;45;0.475;21;19;0.025;0.475
Control.SRR15539829;40;45;0.5;20;20;0;0.5
Control.SRR15539829;41;45;0.463414634146341;22;19;0.0365853658536585;0.463414634146341
Control.SRR15539829;45;45;0.622222222222222;17;28;0.122222222222222;0.377777777777778
Control.SRR15539829;47;45;0.51063829787234;23;24;0.0106382978723404;0.48936170212766
Control.SRR15539829;42;45;0.571428571428571;18;24;0.0714285714285714;0.428571428571429
Control.SRR15539829;50;45;0.58;21;29;0.08;0.42
Control.SRR15539829;49;45;0.63265306122449;18;31;0.13265306122449;0.36734693877551
Control.SRR15539829;45;45;0.466666666666667;24;21;0.0333333333333333;0.466666666666667
Control.SRR15539829;43;45;0.651162790697674;15;28;0.151162790697674;0.348837209302326
Control.SRR15539829;43;45;0.488372093023256;22;21;0.0116279069767442;0.488372093023256
Control.SRR15539829;46;45;0.521739130434783;22;24;0.0217391304347826;0.478260869565217
Control.SRR15539829;52;45;0.519230769230769;25;27;0.0192307692307693;0.480769230769231
Control.SRR15539829;48;45;0.5;24;24;0;0.5
Control.SRR15539829;50;45;0.56;22;28;0.0600000000000001;0.44
Control.SRR15539829;52;45;0.442307692307692;29;23;0.0576923076923077;0.442307692307692
Control.SRR15539829;47;45;0.425531914893617;27;20;0.074468085106383;0.425531914893617
Control.SRR15539829;41;45;0.48780487804878;21;20;0.0121951219512195;0.48780487804878
Control.SRR15539829;50;45;0.54;23;27;0.04;0.46
Control.SRR15539829;44;45;0.477272727272727;23;21;0.0227272727272727;0.477272727272727
Control.SRR15539829;50;45;0.44;28;22;0.06;0.44
Control.SRR15539829;44;45;0.5;22;22;0;0.5
Control.SRR15539829;42;45;0.523809523809524;20;22;0.0238095238095238;0.476190476190476
Control.SRR15539829;44;45;0.409090909090909;26;18;0.0909090909090909;0.409090909090909
Control.SRR15539829;43;45;0.465116279069767;23;20;0.0348837209302326;0.465116279069767
Control.SRR15539829;41;45;0.560975609756098;18;23;0.0609756097560976;0.439024390243902
Control.SRR15539829;46;45;0.5;23;23;0;0.5
Control.SRR15539829;43;45;0.651162790697674;15;28;0.151162790697674;0.348837209302326
Control.SRR15539829;42;45;0.523809523809524;20;22;0.0238095238095238;0.476190476190476
Control.SRR15539829;44;45;0.409090909090909;26;18;0.0909090909090909;0.409090909090909
Control.SRR15539829;47;45;0.468085106382979;25;22;0.0319148936170213;0.468085106382979
Control.SRR15539829;44;45;0.545454545454545;20;24;0.0454545454545454;0.454545454545455
Control.SRR15539829;47;45;0.531914893617021;22;25;0.0319148936170213;0.468085106382979
Control.SRR15539829;45;45;0.422222222222222;26;19;0.0777777777777778;0.422222222222222
Control.SRR15539829;50;45;0.54;23;27;0.04;0.46
Control.SRR15539829;50;45;0.54;23;27;0.04;0.46
Control.SRR15539829;50;45;0.46;27;23;0.04;0.46
Control.SRR15539829;46;45;0.58695652173913;19;27;0.0869565217391305;0.41304347826087
Control.SRR15539829;47;45;0.382978723404255;29;18;0.117021276595745;0.382978723404255
Control.SRR15539829;47;45;0.425531914893617;27;20;0.074468085106383;0.425531914893617
Control.SRR15539829;46;45;0.434782608695652;26;20;0.0652173913043478;0.434782608695652
Control.SRR15539829;50;45;0.44;28;22;0.06;0.44
Control.SRR15539829;46;45;0.58695652173913;19;27;0.0869565217391305;0.41304347826087
Control.SRR15539829;52;45;0.480769230769231;27;25;0.0192307692307692;0.480769230769231
Control.SRR15539829;48;45;0.458333333333333;26;22;0.0416666666666667;0.458333333333333
Control.SRR15539829;41;45;0.463414634146341;22;19;0.0365853658536585;0.463414634146341
Control.SRR15539829;49;45;0.510204081632653;24;25;0.0102040816326531;0.489795918367347
Control.SRR15539829;50;45;0.5;25;25;0;0.5
Control.SRR15539829;44;45;0.545454545454545;20;24;0.0454545454545454;0.454545454545455
Control.SRR15539829;43;45;0.627906976744186;16;27;0.127906976744186;0.372093023255814
Control.SRR15539829;42;45;0.595238095238095;17;25;0.0952380952380952;0.404761904761905
Control.SRR15539829;49;45;0.551020408163265;22;27;0.0510204081632653;0.448979591836735
Control.SRR15539829;45;45;0.555555555555556;20;25;0.0555555555555556;0.444444444444444
Control.SRR15539829;43;45;0.465116279069767;23;20;0.0348837209302326;0.465116279069767
Control.SRR15539829;46;45;0.543478260869565;21;25;0.0434782608695652;0.456521739130435
Control.SRR15539829;52;45;0.615384615384615;20;32;0.115384615384615;0.384615384615385
Control.SRR15539829;40;45;0.475;21;19;0.025;0.475
Control.SRR15539829;46;45;0.434782608695652;26;20;0.0652173913043478;0.434782608695652
Control.SRR15539829;45;45;0.555555555555556;20;25;0.0555555555555556;0.444444444444444
Control.SRR15539829;45;45;0.511111111111111;22;23;0.0111111111111111;0.488888888888889
Control.SRR15539829;40;45;0.475;21;19;0.025;0.475
Control.SRR15539829;40;45;0.525;19;21;0.025;0.475
Control.SRR15539829;44;45;0.545454545454545;20;24;0.0454545454545454;0.454545454545455
Control.SRR15539829;52;45;0.634615384615385;19;33;0.134615384615385;0.365384615384615
Control.SRR15539829;40;45;0.5;20;20;0;0.5
Control.SRR15539829;41;45;0.560975609756098;18;23;0.0609756097560976;0.439024390243902
Control.SRR15539829;43;45;0.627906976744186;16;27;0.127906976744186;0.372093023255814
Control.SRR15539829;48;45;0.541666666666667;22;26;0.0416666666666666;0.458333333333333
Control.SRR15539829;45;45;0.444444444444444;25;20;0.0555555555555556;0.444444444444444
Control.SRR15539829;44;45;0.545454545454545;20;24;0.0454545454545454;0.454545454545455
Control.SRR15539829;43;45;0.488372093023256;22;21;0.0116279069767442;0.488372093023256
Control.SRR15539829;47;45;0.595744680851064;19;28;0.0957446808510638;0.404255319148936
Control.SRR15539829;49;45;0.693877551020408;15;34;0.193877551020408;0.306122448979592
Control.SRR15539829;46;45;0.478260869565217;24;22;0.0217391304347826;0.478260869565217
Control.SRR15539829;44;45;0.409090909090909;26;18;0.0909090909090909;0.409090909090909
Control.SRR15539829;49;45;0.510204081632653;24;25;0.0102040816326531;0.489795918367347
Control.SRR15539829;43;45;0.488372093023256;22;21;0.0116279069767442;0.488372093023256
Control.SRR15539829;44;45;0.568181818181818;19;25;0.0681818181818182;0.431818181818182
Control.SRR15539829;50;45;0.62;19;31;0.12;0.38
Control.SRR15539829;45;45;0.533333333333333;21;24;0.0333333333333333;0.466666666666667
Control.SRR15539829;46;45;0.608695652173913;18;28;0.108695652173913;0.391304347826087
Control.SRR15539829;48;45;0.458333333333333;26;22;0.0416666666666667;0.458333333333333
Control.SRR15539829;41;45;0.365853658536585;26;15;0.134146341463415;0.365853658536585
Control.SRR15539829;48;45;0.458333333333333;26;22;0.0416666666666667;0.458333333333333
Control.SRR15539829;48;45;0.6875;15;33;0.1875;0.3125
Control.SRR15539829;47;45;0.404255319148936;28;19;0.0957446808510639;0.404255319148936
Control.SRR15539829;48;45;0.541666666666667;22;26;0.0416666666666666;0.458333333333333
Control.SRR15539829;44;45;0.545454545454545;20;24;0.0454545454545454;0.454545454545455
Control.SRR15539829;45;45;0.711111111111111;13;32;0.211111111111111;0.288888888888889
Control.SRR15539829;40;45;0.55;18;22;0.05;0.45
Control.SRR15539829;44;45;0.636363636363636;16;28;0.136363636363636;0.363636363636364
Control.SRR15539829;44;45;0.454545454545455;24;20;0.0454545454545455;0.454545454545455
Control.SRR15539829;50;45;0.56;22;28;0.0600000000000001;0.44
Control.SRR15539829;45;45;0.533333333333333;21;24;0.0333333333333333;0.466666666666667
Control.SRR15539829;43;45;0.465116279069767;23;20;0.0348837209302326;0.465116279069767
Control.SRR15539829;50;45;0.6;20;30;0.1;0.4
Control.SRR15539829;46;45;0.434782608695652;26;20;0.0652173913043478;0.434782608695652
Control.SRR15539829;48;45;0.458333333333333;26;22;0.0416666666666667;0.458333333333333
Control.SRR15539829;51;45;0.470588235294118;27;24;0.0294117647058824;0.470588235294118
Control.SRR15539829;51;45;0.529411764705882;24;27;0.0294117647058824;0.470588235294118
Control.SRR15539829;44;45;0.409090909090909;26;18;0.0909090909090909;0.409090909090909
Control.SRR15539829;50;45;0.52;24;26;0.02;0.48
Control.SRR15539829;48;45;0.5625;21;27;0.0625;0.4375
Control.SRR15539829;46;45;0.521739130434783;22;24;0.0217391304347826;0.478260869565217
Control.SRR15539829;42;45;0.404761904761905;25;17;0.0952380952380952;0.404761904761905
Control.SRR15539829;40;45;0.45;22;18;0.05;0.45
Control.SRR15539829;51;45;0.509803921568627;25;26;0.00980392156862742;0.490196078431373
Control.SRR15539829;45;45;0.622222222222222;17;28;0.122222222222222;0.377777777777778
Control.SRR15539829;42;45;0.5;21;21;0;0.5
Control.SRR15539829;44;45;0.386363636363636;27;17;0.113636363636364;0.386363636363636
Control.SRR15539829;41;45;0.390243902439024;25;16;0.109756097560976;0.390243902439024
Control.SRR15539829;45;45;0.533333333333333;21;24;0.0333333333333333;0.466666666666667
Control.SRR15539829;48;45;0.458333333333333;26;22;0.0416666666666667;0.458333333333333
Control.SRR15539829;48;45;0.4375;27;21;0.0625;0.4375
Control.SRR15539829;40;45;0.475;21;19;0.025;0.475
Control.SRR15539829;49;45;0.510204081632653;24;25;0.0102040816326531;0.489795918367347
Control.SRR15539829;50;45;0.52;24;26;0.02;0.48
Control.SRR15539829;44;45;0.454545454545455;24;20;0.0454545454545455;0.454545454545455
Control.SRR15539829;44;45;0.295454545454545;31;13;0.204545454545455;0.295454545454545
Control.SRR15539829;47;45;0.595744680851064;19;28;0.0957446808510638;0.404255319148936
Control.SRR15539829;50;45;0.5;25;25;0;0.5
Control.SRR15539829;43;45;0.372093023255814;27;16;0.127906976744186;0.372093023255814
Control.SRR15539829;44;45;0.5;22;22;0;0.5
Control.SRR15539829;43;45;0.534883720930233;20;23;0.0348837209302325;0.465116279069767
Control.SRR15539829;44;45;0.545454545454545;20;24;0.0454545454545454;0.454545454545455
Control.SRR15539829;42;45;0.404761904761905;25;17;0.0952380952380952;0.404761904761905
Control.SRR15539829;50;45;0.4;30;20;0.1;0.4
Control.SRR15539829;44;45;0.681818181818182;14;30;0.181818181818182;0.318181818181818
Control.SRR15539829;51;45;0.647058823529412;18;33;0.147058823529412;0.352941176470588
Control.SRR15539829;41;45;0.463414634146341;22;19;0.0365853658536585;0.463414634146341
Control.SRR15539829;40;45;0.575;17;23;0.075;0.425
Control.SRR15539829;46;45;0.41304347826087;27;19;0.0869565217391304;0.41304347826087
Control.SRR15539829;40;45;0.5;20;20;0;0.5
Control.SRR15539829;44;45;0.522727272727273;21;23;0.0227272727272727;0.477272727272727
Control.SRR15539829;40;45;0.6;16;24;0.1;0.4
Control.SRR15539829;42;45;0.476190476190476;22;20;0.0238095238095238;0.476190476190476
Control.SRR15539829;42;45;0.523809523809524;20;22;0.0238095238095238;0.476190476190476
Control.SRR15539829;48;45;0.5;24;24;0;0.5
Control.SRR15539829;44;45;0.454545454545455;24;20;0.0454545454545455;0.454545454545455
Control.SRR15539829;41;45;0.609756097560976;16;25;0.109756097560976;0.390243902439024
Control.SRR15539829;45;45;0.555555555555556;20;25;0.0555555555555556;0.444444444444444
Control.SRR15539829;41;45;0.707317073170732;12;29;0.207317073170732;0.292682926829268
Control.SRR15539829;41;45;0.463414634146341;22;19;0.0365853658536585;0.463414634146341
Control.SRR15539829;42;45;0.5;21;21;0;0.5
Control.SRR15539829;51;45;0.352941176470588;33;18;0.147058823529412;0.352941176470588
Control.SRR15539829;42;45;0.452380952380952;23;19;0.0476190476190476;0.452380952380952
Control.SRR15539829;41;45;0.51219512195122;20;21;0.0121951219512195;0.48780487804878
Control.SRR15539829;40;45;0.6;16;24;0.1;0.4
Control.SRR15539829;45;45;0.577777777777778;19;26;0.0777777777777777;0.422222222222222
Control.SRR15539829;41;45;0.51219512195122;20;21;0.0121951219512195;0.48780487804878
Control.SRR15539829;43;45;0.511627906976744;21;22;0.0116279069767442;0.488372093023256
Control.SRR15539829;40;45;0.425;23;17;0.075;0.425
Control.SRR15539829;48;45;0.416666666666667;28;20;0.0833333333333333;0.416666666666667
Control.SRR15539829;41;45;0.48780487804878;21;20;0.0121951219512195;0.48780487804878
Control.SRR15539829;46;45;0.543478260869565;21;25;0.0434782608695652;0.456521739130435
Control.SRR15539829;40;45;0.5;20;20;0;0.5
Control.SRR15539829;40;45;0.55;18;22;0.05;0.45
Control.SRR15539829;43;45;0.558139534883721;19;24;0.0581395348837209;0.441860465116279
Control.SRR15539829;50;45;0.34;33;17;0.16;0.34
Control.SRR15539829;45;45;0.644444444444444;16;29;0.144444444444444;0.355555555555556
Control.SRR15539829;46;45;0.608695652173913;18;28;0.108695652173913;0.391304347826087
Control.SRR15539829;48;45;0.395833333333333;29;19;0.104166666666667;0.395833333333333
Control.SRR15539829;44;45;0.5;22;22;0;0.5
Control.SRR15539829;47;45;0.446808510638298;26;21;0.0531914893617021;0.446808510638298
Control.SRR15539829;50;45;0.56;22;28;0.0600000000000001;0.44
Control.SRR15539829;40;45;0.475;21;19;0.025;0.475
Control.SRR15539829;45;45;0.577777777777778;19;26;0.0777777777777777;0.422222222222222
Control.SRR15539829;50;45;0.48;26;24;0.02;0.48
Control.SRR15539829;40;45;0.425;23;17;0.075;0.425
Control.SRR15539829;50;45;0.56;22;28;0.0600000000000001;0.44
Control.SRR15539829;43;45;0.581395348837209;18;25;0.0813953488372093;0.418604651162791
Control.SRR15539829;50;45;0.46;27;23;0.04;0.46
Control.SRR15539829;48;45;0.5;24;24;0;0.5
Control.SRR15539829;42;45;0.476190476190476;22;20;0.0238095238095238;0.476190476190476
Control.SRR15539829;50;45;0.5;25;25;0;0.5
Control.SRR15539829;44;45;0.5;22;22;0;0.5
Control.SRR15539829;47;45;0.382978723404255;29;18;0.117021276595745;0.382978723404255
Control.SRR15539829;40;45;0.525;19;21;0.025;0.475
Control.SRR15539829;51;45;0.647058823529412;18;33;0.147058823529412;0.352941176470588
Control.SRR15539829;44;45;0.431818181818182;25;19;0.0681818181818182;0.431818181818182
Control.SRR15539829;43;45;0.465116279069767;23;20;0.0348837209302326;0.465116279069767
Control.SRR15539829;40;45;0.525;19;21;0.025;0.475
Control.SRR15539829;43;45;0.744186046511628;11;32;0.244186046511628;0.255813953488372
Control.SRR15539829;49;45;0.612244897959184;19;30;0.112244897959184;0.387755102040816
Control.SRR15539829;42;45;0.5;21;21;0;0.5
Control.SRR15539829;48;45;0.583333333333333;20;28;0.0833333333333334;0.416666666666667
Control.SRR15539829;52;45;0.461538461538462;28;24;0.0384615384615384;0.461538461538462
Control.SRR15539829;41;45;0.51219512195122;20;21;0.0121951219512195;0.48780487804878
Control.SRR15539829;43;45;0.465116279069767;23;20;0.0348837209302326;0.465116279069767
Control.SRR15539829;51;45;0.490196078431373;26;25;0.00980392156862747;0.490196078431373
Control.SRR15539829;42;45;0.357142857142857;27;15;0.142857142857143;0.357142857142857
Control.SRR15539829;46;45;0.391304347826087;28;18;0.108695652173913;0.391304347826087
Control.SRR15539829;50;45;0.7;15;35;0.2;0.3
Control.SRR15539829;49;45;0.469387755102041;26;23;0.0306122448979592;0.469387755102041
Control.SRR15539829;49;45;0.469387755102041;26;23;0.0306122448979592;0.469387755102041
Control.SRR15539829;44;45;0.613636363636364;17;27;0.113636363636364;0.386363636363636
Control.SRR15539829;47;45;0.659574468085106;16;31;0.159574468085106;0.340425531914894
Control.SRR15539829;40;45;0.5;20;20;0;0.5
Control.SRR15539829;42;45;0.5;21;21;0;0.5
Control.SRR15539829;48;45;0.479166666666667;25;23;0.0208333333333333;0.479166666666667
Control.SRR15539829;41;45;0.390243902439024;25;16;0.109756097560976;0.390243902439024
Control.SRR15539829;44;45;0.590909090909091;18;26;0.0909090909090909;0.409090909090909
Control.SRR15539829;43;45;0.488372093023256;22;21;0.0116279069767442;0.488372093023256
Control.SRR15539829;52;45;0.5;26;26;0;0.5
Control.SRR15539829;42;45;0.476190476190476;22;20;0.0238095238095238;0.476190476190476
Control.SRR15539829;45;45;0.444444444444444;25;20;0.0555555555555556;0.444444444444444
Control.SRR15539829;40;45;0.475;21;19;0.025;0.475
Control.SRR15539829;50;45;0.4;30;20;0.1;0.4
Control.SRR15539829;50;45;0.54;23;27;0.04;0.46
Control.SRR15539829;42;45;0.619047619047619;16;26;0.119047619047619;0.380952380952381
Control.SRR15539829;45;45;0.466666666666667;24;21;0.0333333333333333;0.466666666666667
Control.SRR15539829;48;45;0.625;18;30;0.125;0.375
Control.SRR15539829;50;45;0.52;24;26;0.02;0.48
Control.SRR15539829;47;45;0.468085106382979;25;22;0.0319148936170213;0.468085106382979
Control.SRR15539829;47;45;0.531914893617021;22;25;0.0319148936170213;0.468085106382979
Control.SRR15539829;48;45;0.416666666666667;28;20;0.0833333333333333;0.416666666666667
Control.SRR15539829;43;45;0.441860465116279;24;19;0.0581395348837209;0.441860465116279
Control.SRR15539829;46;45;0.456521739130435;25;21;0.0434782608695652;0.456521739130435
Control.SRR15539829;44;45;0.522727272727273;21;23;0.0227272727272727;0.477272727272727
Control.SRR15539829;48;45;0.520833333333333;23;25;0.0208333333333334;0.479166666666667
Control.SRR15539829;50;45;0.46;27;23;0.04;0.46
Control.SRR15539829;46;45;0.521739130434783;22;24;0.0217391304347826;0.478260869565217
Control.SRR15539829;40;45;0.55;18;22;0.05;0.45
Control.SRR15539829;50;45;0.46;27;23;0.04;0.46
Control.SRR15539829;51;45;0.470588235294118;27;24;0.0294117647058824;0.470588235294118
Control.SRR15539829;44;45;0.568181818181818;19;25;0.0681818181818182;0.431818181818182
Control.SRR15539829;44;45;0.5;22;22;0;0.5
Control.SRR15539829;44;45;0.5;22;22;0;0.5
Control.SRR15539829;48;45;0.625;18;30;0.125;0.375
Control.SRR15539829;52;45;0.538461538461538;24;28;0.0384615384615384;0.461538461538462
Control.SRR15539829;41;45;0.414634146341463;24;17;0.0853658536585366;0.414634146341463
Control.SRR15539829;48;45;0.395833333333333;29;19;0.104166666666667;0.395833333333333
Control.SRR15539829;46;45;0.58695652173913;19;27;0.0869565217391305;0.41304347826087
Control.SRR15539829;41;45;0.365853658536585;26;15;0.134146341463415;0.365853658536585
Control.SRR15539829;41;45;0.365853658536585;26;15;0.134146341463415;0.365853658536585
Control.SRR15539829;42;45;0.5;21;21;0;0.5
Control.SRR15539829;42;45;0.523809523809524;20;22;0.0238095238095238;0.476190476190476
Control.SRR15539829;43;45;0.488372093023256;22;21;0.0116279069767442;0.488372093023256
Control.SRR15539829;44;45;0.590909090909091;18;26;0.0909090909090909;0.409090909090909
Control.SRR15539829;50;45;0.5;25;25;0;0.5
Control.SRR15539829;40;45;0.425;23;17;0.075;0.425
Control.SRR15539829;43;45;0.488372093023256;22;21;0.0116279069767442;0.488372093023256
Control.SRR15539829;47;45;0.51063829787234;23;24;0.0106382978723404;0.48936170212766
Control.SRR15539829;52;45;0.519230769230769;25;27;0.0192307692307693;0.480769230769231
Control.SRR15539829;47;45;0.531914893617021;22;25;0.0319148936170213;0.468085106382979
Control.SRR15539829;48;45;0.541666666666667;22;26;0.0416666666666666;0.458333333333333
Control.SRR15539829;43;45;0.441860465116279;24;19;0.0581395348837209;0.441860465116279
Control.SRR15539829;52;45;0.5;26;26;0;0.5
Control.SRR15539829;48;45;0.5;24;24;0;0.5
Control.SRR15539829;47;45;0.595744680851064;19;28;0.0957446808510638;0.404255319148936
Control.SRR15539829;41;45;0.365853658536585;26;15;0.134146341463415;0.365853658536585
Control.SRR15539829;50;45;0.44;28;22;0.06;0.44
Control.SRR15539829;49;45;0.571428571428571;21;28;0.0714285714285714;0.428571428571429
Control.SRR15539829;47;45;0.574468085106383;20;27;0.074468085106383;0.425531914893617
Control.SRR15539829;45;45;0.466666666666667;24;21;0.0333333333333333;0.466666666666667
Control.SRR15539829;47;45;0.446808510638298;26;21;0.0531914893617021;0.446808510638298
Control.SRR15539829;49;45;0.408163265306122;29;20;0.0918367346938775;0.408163265306122
Control.SRR15539829;44;45;0.522727272727273;21;23;0.0227272727272727;0.477272727272727
Control.SRR15539829;45;45;0.488888888888889;23;22;0.0111111111111111;0.488888888888889
Control.SRR15539829;45;45;0.488888888888889;23;22;0.0111111111111111;0.488888888888889
Control.SRR15539829;48;45;0.541666666666667;22;26;0.0416666666666666;0.458333333333333
Control.SRR15539829;47;45;0.48936170212766;24;23;0.0106382978723404;0.48936170212766
Control.SRR15539829;52;45;0.461538461538462;28;24;0.0384615384615384;0.461538461538462
Control.SRR15539829;41;45;0.634146341463415;15;26;0.134146341463415;0.365853658536585
Control.SRR15539829;48;45;0.458333333333333;26;22;0.0416666666666667;0.458333333333333
Control.SRR15539829;43;45;0.418604651162791;25;18;0.0813953488372093;0.418604651162791
Control.SRR15539829;48;45;0.520833333333333;23;25;0.0208333333333334;0.479166666666667
Control.SRR15539829;47;45;0.446808510638298;26;21;0.0531914893617021;0.446808510638298
Control.SRR15539829;48;45;0.4375;27;21;0.0625;0.4375
Control.SRR15539829;43;45;0.558139534883721;19;24;0.0581395348837209;0.441860465116279
Control.SRR15539829;49;45;0.428571428571429;28;21;0.0714285714285715;0.428571428571429
Control.SRR15539829;43;45;0.534883720930233;20;23;0.0348837209302325;0.465116279069767
Control.SRR15539829;46;45;0.347826086956522;30;16;0.152173913043478;0.347826086956522
Control.SRR15539829;43;45;0.651162790697674;15;28;0.151162790697674;0.348837209302326
Control.SRR15539829;47;45;0.617021276595745;18;29;0.117021276595745;0.382978723404255
Control.SRR15539829;43;45;0.465116279069767;23;20;0.0348837209302326;0.465116279069767
Control.SRR15539829;48;45;0.458333333333333;26;22;0.0416666666666667;0.458333333333333
Control.SRR15539829;51;45;0.490196078431373;26;25;0.00980392156862747;0.490196078431373
Control.SRR15539829;41;45;0.48780487804878;21;20;0.0121951219512195;0.48780487804878
Control.SRR15539829;42;45;0.69047619047619;13;29;0.19047619047619;0.30952380952381
Control.SRR15539829;42;45;0.476190476190476;22;20;0.0238095238095238;0.476190476190476
Control.SRR15539829;51;45;0.568627450980392;22;29;0.0686274509803921;0.431372549019608
Control.SRR15539829;41;45;0.658536585365854;14;27;0.158536585365854;0.341463414634146
Control.SRR15539829;46;45;0.456521739130435;25;21;0.0434782608695652;0.456521739130435
Control.SRR15539829;41;45;0.560975609756098;18;23;0.0609756097560976;0.439024390243902
Control.SRR15539829;45;45;0.333333333333333;30;15;0.166666666666667;0.333333333333333
Control.SRR15539829;44;45;0.522727272727273;21;23;0.0227272727272727;0.477272727272727
Control.SRR15539829;41;45;0.634146341463415;15;26;0.134146341463415;0.365853658536585
Control.SRR15539829;45;45;0.577777777777778;19;26;0.0777777777777777;0.422222222222222
Control.SRR15539829;43;45;0.488372093023256;22;21;0.0116279069767442;0.488372093023256
Control.SRR15539829;45;45;0.355555555555556;29;16;0.144444444444444;0.355555555555556
Control.SRR15539829;48;45;0.479166666666667;25;23;0.0208333333333333;0.479166666666667
Control.SRR15539829;42;45;0.547619047619048;19;23;0.0476190476190477;0.452380952380952
Control.SRR15539829;41;45;0.585365853658537;17;24;0.0853658536585366;0.414634146341463
Control.SRR15539829;47;45;0.531914893617021;22;25;0.0319148936170213;0.468085106382979
Control.SRR15539829;42;45;0.547619047619048;19;23;0.0476190476190477;0.452380952380952
Control.SRR15539829;45;45;0.533333333333333;21;24;0.0333333333333333;0.466666666666667
Control.SRR15539829;40;45;0.525;19;21;0.025;0.475
Control.SRR15539829;46;45;0.391304347826087;28;18;0.108695652173913;0.391304347826087
Control.SRR15539829;49;45;0.571428571428571;21;28;0.0714285714285714;0.428571428571429
Control.SRR15539829;46;45;0.58695652173913;19;27;0.0869565217391305;0.41304347826087
Control.SRR15539829;47;45;0.531914893617021;22;25;0.0319148936170213;0.468085106382979
Control.SRR15539829;45;45;0.488888888888889;23;22;0.0111111111111111;0.488888888888889
Control.SRR15539829;44;45;0.522727272727273;21;23;0.0227272727272727;0.477272727272727
Control.SRR15539829;42;45;0.452380952380952;23;19;0.0476190476190476;0.452380952380952
Control.SRR15539829;43;45;0.534883720930233;20;23;0.0348837209302325;0.465116279069767
Control.SRR15539829;50;45;0.38;31;19;0.12;0.38
Control.SRR15539829;47;45;0.468085106382979;25;22;0.0319148936170213;0.468085106382979
Control.SRR15539829;41;45;0.536585365853659;19;22;0.0365853658536586;0.463414634146341
Control.SRR15539829;40;45;0.4;24;16;0.1;0.4
Control.SRR15539829;43;45;0.534883720930233;20;23;0.0348837209302325;0.465116279069767
Control.SRR15539829;48;45;0.5625;21;27;0.0625;0.4375
Control.SRR15539829;44;45;0.522727272727273;21;23;0.0227272727272727;0.477272727272727
Control.SRR15539829;41;45;0.48780487804878;21;20;0.0121951219512195;0.48780487804878
Control.SRR15539829;47;45;0.574468085106383;20;27;0.074468085106383;0.425531914893617
Control.SRR15539829;46;45;0.478260869565217;24;22;0.0217391304347826;0.478260869565217
Control.SRR15539829;43;45;0.558139534883721;19;24;0.0581395348837209;0.441860465116279
Control.SRR15539829;50;45;0.6;20;30;0.1;0.4
Control.SRR15539829;42;45;0.452380952380952;23;19;0.0476190476190476;0.452380952380952
Control.SRR15539829;42;45;0.595238095238095;17;25;0.0952380952380952;0.404761904761905
Control.SRR15539829;48;45;0.416666666666667;28;20;0.0833333333333333;0.416666666666667
Control.SRR15539829;43;45;0.534883720930233;20;23;0.0348837209302325;0.465116279069767
Control.SRR15539829;50;45;0.5;25;25;0;0.5
Control.SRR15539829;47;45;0.553191489361702;21;26;0.0531914893617021;0.446808510638298
Control.SRR15539829;46;45;0.58695652173913;19;27;0.0869565217391305;0.41304347826087
Control.SRR15539829;44;45;0.454545454545455;24;20;0.0454545454545455;0.454545454545455
Control.SRR15539829;40;45;0.475;21;19;0.025;0.475
Control.SRR15539829;44;45;0.522727272727273;21;23;0.0227272727272727;0.477272727272727
Control.SRR15539829;49;45;0.448979591836735;27;22;0.0510204081632653;0.448979591836735
Control.SRR15539829;48;45;0.479166666666667;25;23;0.0208333333333333;0.479166666666667
Control.SRR15539829;46;45;0.434782608695652;26;20;0.0652173913043478;0.434782608695652
Control.SRR15539829;42;45;0.619047619047619;16;26;0.119047619047619;0.380952380952381
Control.SRR15539829;48;45;0.5625;21;27;0.0625;0.4375
Control.SRR15539829;45;45;0.422222222222222;26;19;0.0777777777777778;0.422222222222222
Control.SRR15539829;47;45;0.51063829787234;23;24;0.0106382978723404;0.48936170212766
Control.SRR15539829;41;45;0.51219512195122;20;21;0.0121951219512195;0.48780487804878
Control.SRR15539829;52;45;0.576923076923077;22;30;0.0769230769230769;0.423076923076923
Control.SRR15539829;50;45;0.48;26;24;0.02;0.48
Control.SRR15539829;49;45;0.448979591836735;27;22;0.0510204081632653;0.448979591836735
Control.SRR15539829;50;45;0.52;24;26;0.02;0.48
Control.SRR15539829;41;45;0.585365853658537;17;24;0.0853658536585366;0.414634146341463
Control.SRR15539829;45;45;0.4;27;18;0.1;0.4
Control.SRR15539829;42;45;0.476190476190476;22;20;0.0238095238095238;0.476190476190476
Control.SRR15539829;49;45;0.36734693877551;31;18;0.13265306122449;0.36734693877551
Control.SRR15539829;47;45;0.553191489361702;21;26;0.0531914893617021;0.446808510638298
Control.SRR15539829;44;45;0.477272727272727;23;21;0.0227272727272727;0.477272727272727
Control.SRR15539829;41;45;0.463414634146341;22;19;0.0365853658536585;0.463414634146341
Control.SRR15539829;48;45;0.458333333333333;26;22;0.0416666666666667;0.458333333333333
Control.SRR15539829;42;45;0.523809523809524;20;22;0.0238095238095238;0.476190476190476
Control.SRR15539829;47;45;0.446808510638298;26;21;0.0531914893617021;0.446808510638298
Control.SRR15539829;45;45;0.466666666666667;24;21;0.0333333333333333;0.466666666666667
Control.SRR15539829;45;45;0.6;18;27;0.1;0.4
Control.SRR15539829;40;45;0.475;21;19;0.025;0.475
Control.SRR15539829;50;45;0.66;17;33;0.16;0.34
Control.SRR15539829;47;45;0.425531914893617;27;20;0.074468085106383;0.425531914893617
Control.SRR15539829;40;45;0.425;23;17;0.075;0.425
Control.SRR15539829;43;45;0.488372093023256;22;21;0.0116279069767442;0.488372093023256
Control.SRR15539829;40;45;0.425;23;17;0.075;0.425
Control.SRR15539829;44;45;0.522727272727273;21;23;0.0227272727272727;0.477272727272727
Control.SRR15539829;46;45;0.521739130434783;22;24;0.0217391304347826;0.478260869565217
Control.SRR15539829;48;45;0.520833333333333;23;25;0.0208333333333334;0.479166666666667
Control.SRR15539829;40;45;0.425;23;17;0.075;0.425
Control.SRR15539829;45;45;0.444444444444444;25;20;0.0555555555555556;0.444444444444444
Control.SRR15539829;42;45;0.380952380952381;26;16;0.119047619047619;0.380952380952381
Control.SRR15539829;46;45;0.521739130434783;22;24;0.0217391304347826;0.478260869565217
Control.SRR15539829;47;45;0.51063829787234;23;24;0.0106382978723404;0.48936170212766
Control.SRR15539829;44;45;0.545454545454545;20;24;0.0454545454545454;0.454545454545455
Control.SRR15539829;40;45;0.425;23;17;0.075;0.425
Control.SRR15539829;40;45;0.45;22;18;0.05;0.45
Control.SRR15539829;41;45;0.536585365853659;19;22;0.0365853658536586;0.463414634146341
Control.SRR15539829;47;45;0.425531914893617;27;20;0.074468085106383;0.425531914893617
Control.SRR15539829;44;45;0.522727272727273;21;23;0.0227272727272727;0.477272727272727
Control.SRR15539829;40;45;0.6;16;24;0.1;0.4
Control.SRR15539829;40;45;0.5;20;20;0;0.5
Control.SRR15539829;45;45;0.355555555555556;29;16;0.144444444444444;0.355555555555556
Control.SRR15539829;43;45;0.558139534883721;19;24;0.0581395348837209;0.441860465116279
Control.SRR15539829;52;45;0.480769230769231;27;25;0.0192307692307692;0.480769230769231
Control.SRR15539829;43;45;0.488372093023256;22;21;0.0116279069767442;0.488372093023256
Control.SRR15539829;43;45;0.465116279069767;23;20;0.0348837209302326;0.465116279069767
Control.SRR15539829;43;45;0.395348837209302;26;17;0.104651162790698;0.395348837209302
Control.SRR15539829;42;45;0.5;21;21;0;0.5
Control.SRR15539829;50;45;0.42;29;21;0.08;0.42
Control.SRR15539829;46;45;0.521739130434783;22;24;0.0217391304347826;0.478260869565217
Control.SRR15539829;43;45;0.511627906976744;21;22;0.0116279069767442;0.488372093023256
Control.SRR15539829;47;45;0.659574468085106;16;31;0.159574468085106;0.340425531914894
Control.SRR15539829;41;45;0.658536585365854;14;27;0.158536585365854;0.341463414634146
Control.SRR15539829;45;45;0.555555555555556;20;25;0.0555555555555556;0.444444444444444
Control.SRR15539829;44;45;0.431818181818182;25;19;0.0681818181818182;0.431818181818182
Control.SRR15539829;42;45;0.428571428571429;24;18;0.0714285714285715;0.428571428571429
Control.SRR15539829;41;45;0.439024390243902;23;18;0.0609756097560976;0.439024390243902
Control.SRR15539829;46;45;0.58695652173913;19;27;0.0869565217391305;0.41304347826087
Control.SRR15539829;51;45;0.509803921568627;25;26;0.00980392156862742;0.490196078431373
Control.SRR15539829;42;45;0.452380952380952;23;19;0.0476190476190476;0.452380952380952
Control.SRR15539829;40;45;0.625;15;25;0.125;0.375
Control.SRR15539829;48;45;0.625;18;30;0.125;0.375
Control.SRR15539829;44;45;0.477272727272727;23;21;0.0227272727272727;0.477272727272727
Control.SRR15539829;40;45;0.625;15;25;0.125;0.375
Control.SRR15539829;45;45;0.377777777777778;28;17;0.122222222222222;0.377777777777778
Control.SRR15539829;46;45;0.41304347826087;27;19;0.0869565217391304;0.41304347826087
Control.SRR15539829;43;45;0.465116279069767;23;20;0.0348837209302326;0.465116279069767
Control.SRR15539829;45;45;0.555555555555556;20;25;0.0555555555555556;0.444444444444444
Control.SRR15539829;51;45;0.549019607843137;23;28;0.0490196078431373;0.450980392156863
Control.SRR15539829;50;45;0.5;25;25;0;0.5
Control.SRR15539829;41;45;0.48780487804878;21;20;0.0121951219512195;0.48780487804878
Control.SRR15539829;48;45;0.4375;27;21;0.0625;0.4375
Control.SRR15539829;41;45;0.463414634146341;22;19;0.0365853658536585;0.463414634146341
Control.SRR15539829;42;45;0.380952380952381;26;16;0.119047619047619;0.380952380952381
Control.SRR15539829;42;45;0.619047619047619;16;26;0.119047619047619;0.380952380952381
Control.SRR15539829;46;45;0.58695652173913;19;27;0.0869565217391305;0.41304347826087
Control.SRR15539829;41;45;0.390243902439024;25;16;0.109756097560976;0.390243902439024
Control.SRR15539829;43;45;0.581395348837209;18;25;0.0813953488372093;0.418604651162791
Control.SRR15539829;51;45;0.411764705882353;30;21;0.0882352941176471;0.411764705882353
Control.SRR15539829;45;45;0.488888888888889;23;22;0.0111111111111111;0.488888888888889
Control.SRR15539829;45;45;0.511111111111111;22;23;0.0111111111111111;0.488888888888889
Control.SRR15539829;48;45;0.520833333333333;23;25;0.0208333333333334;0.479166666666667
Control.SRR15539829;49;45;0.469387755102041;26;23;0.0306122448979592;0.469387755102041
Control.SRR15539829;48;45;0.541666666666667;22;26;0.0416666666666666;0.458333333333333
Control.SRR15539829;49;45;0.571428571428571;21;28;0.0714285714285714;0.428571428571429
Control.SRR15539829;47;45;0.404255319148936;28;19;0.0957446808510639;0.404255319148936
Control.SRR15539829;43;45;0.465116279069767;23;20;0.0348837209302326;0.465116279069767
Control.SRR15539829;43;45;0.581395348837209;18;25;0.0813953488372093;0.418604651162791
Control.SRR15539829;43;45;0.465116279069767;23;20;0.0348837209302326;0.465116279069767
Control.SRR15539829;41;45;0.463414634146341;22;19;0.0365853658536585;0.463414634146341
Control.SRR15539829;51;45;0.568627450980392;22;29;0.0686274509803921;0.431372549019608
Control.SRR15539829;45;45;0.355555555555556;29;16;0.144444444444444;0.355555555555556
Control.SRR15539829;41;45;0.658536585365854;14;27;0.158536585365854;0.341463414634146
Control.SRR15539829;44;45;0.454545454545455;24;20;0.0454545454545455;0.454545454545455
Control.SRR15539829;50;45;0.44;28;22;0.06;0.44
Control.SRR15539829;51;45;0.529411764705882;24;27;0.0294117647058824;0.470588235294118
Control.SRR15539829;50;45;0.58;21;29;0.08;0.42
Control.SRR15539829;52;45;0.365384615384615;33;19;0.134615384615385;0.365384615384615
Control.SRR15539829;41;45;0.317073170731707;28;13;0.182926829268293;0.317073170731707
Control.SRR15539829;45;45;0.422222222222222;26;19;0.0777777777777778;0.422222222222222
Control.SRR15539829;42;45;0.476190476190476;22;20;0.0238095238095238;0.476190476190476
Control.SRR15539829;45;45;0.6;18;27;0.1;0.4
Control.SRR15539829;40;45;0.475;21;19;0.025;0.475
Control.SRR15539829;50;45;0.54;23;27;0.04;0.46
Control.SRR15539829;43;45;0.441860465116279;24;19;0.0581395348837209;0.441860465116279
Control.SRR15539829;52;45;0.557692307692308;23;29;0.0576923076923077;0.442307692307692
Control.SRR15539829;49;45;0.428571428571429;28;21;0.0714285714285715;0.428571428571429
Control.SRR15539829;52;45;0.461538461538462;28;24;0.0384615384615384;0.461538461538462
Control.SRR15539829;40;45;0.525;19;21;0.025;0.475
Control.SRR15539829;42;45;0.476190476190476;22;20;0.0238095238095238;0.476190476190476
Control.SRR15539829;50;45;0.38;31;19;0.12;0.38
Control.SRR15539829;46;45;0.543478260869565;21;25;0.0434782608695652;0.456521739130435
Control.SRR15539829;48;45;0.520833333333333;23;25;0.0208333333333334;0.479166666666667
Control.SRR15539829;41;45;0.439024390243902;23;18;0.0609756097560976;0.439024390243902
Control.SRR15539829;41;45;0.463414634146341;22;19;0.0365853658536585;0.463414634146341
Control.SRR15539829;45;45;0.533333333333333;21;24;0.0333333333333333;0.466666666666667
Control.SRR15539829;47;45;0.48936170212766;24;23;0.0106382978723404;0.48936170212766
Control.SRR15539829;49;45;0.510204081632653;24;25;0.0102040816326531;0.489795918367347
Control.SRR15539829;49;45;0.428571428571429;28;21;0.0714285714285715;0.428571428571429
Control.SRR15539829;42;45;0.476190476190476;22;20;0.0238095238095238;0.476190476190476
Control.SRR15539829;51;45;0.470588235294118;27;24;0.0294117647058824;0.470588235294118
Control.SRR15539829;48;45;0.333333333333333;32;16;0.166666666666667;0.333333333333333
Control.SRR15539829;42;45;0.5;21;21;0;0.5
Control.SRR15539829;46;45;0.41304347826087;27;19;0.0869565217391304;0.41304347826087
Control.SRR15539829;52;45;0.480769230769231;27;25;0.0192307692307692;0.480769230769231
Control.SRR15539829;42;45;0.452380952380952;23;19;0.0476190476190476;0.452380952380952
Control.SRR15539829;43;45;0.720930232558139;12;31;0.220930232558139;0.27906976744186
Control.SRR15539829;52;45;0.5;26;26;0;0.5
Control.SRR15539829;47;45;0.425531914893617;27;20;0.074468085106383;0.425531914893617
Control.SRR15539829;47;45;0.51063829787234;23;24;0.0106382978723404;0.48936170212766
Control.SRR15539829;45;45;0.555555555555556;20;25;0.0555555555555556;0.444444444444444
Control.SRR15539829;42;45;0.428571428571429;24;18;0.0714285714285715;0.428571428571429
Control.SRR15539829;42;45;0.380952380952381;26;16;0.119047619047619;0.380952380952381
Control.SRR15539829;50;45;0.5;25;25;0;0.5
Control.SRR15539829;51;45;0.431372549019608;29;22;0.0686274509803921;0.431372549019608
Control.SRR15539829;48;45;0.479166666666667;25;23;0.0208333333333333;0.479166666666667
Control.SRR15539829;42;45;0.619047619047619;16;26;0.119047619047619;0.380952380952381
Control.SRR15539829;41;45;0.390243902439024;25;16;0.109756097560976;0.390243902439024
Control.SRR15539829;52;45;0.480769230769231;27;25;0.0192307692307692;0.480769230769231
Control.SRR15539829;48;45;0.416666666666667;28;20;0.0833333333333333;0.416666666666667
Control.SRR15539829;44;45;0.522727272727273;21;23;0.0227272727272727;0.477272727272727
Control.SRR15539829;49;45;0.612244897959184;19;30;0.112244897959184;0.387755102040816
Control.SRR15539829;49;45;0.510204081632653;24;25;0.0102040816326531;0.489795918367347
Control.SRR15539829;46;45;0.347826086956522;30;16;0.152173913043478;0.347826086956522
Control.SRR15539829;49;45;0.673469387755102;16;33;0.173469387755102;0.326530612244898
Control.SRR15539829;44;45;0.5;22;22;0;0.5
Control.SRR15539829;41;45;0.51219512195122;20;21;0.0121951219512195;0.48780487804878
Control.SRR15539829;42;45;0.380952380952381;26;16;0.119047619047619;0.380952380952381
Control.SRR15539829;43;45;0.627906976744186;16;27;0.127906976744186;0.372093023255814
Control.SRR15539829;41;45;0.51219512195122;20;21;0.0121951219512195;0.48780487804878
Control.SRR15539829;45;45;0.444444444444444;25;20;0.0555555555555556;0.444444444444444
Control.SRR15539829;50;45;0.44;28;22;0.06;0.44
Control.SRR15539829;42;45;0.428571428571429;24;18;0.0714285714285715;0.428571428571429
Control.SRR15539829;48;45;0.458333333333333;26;22;0.0416666666666667;0.458333333333333
Control.SRR15539829;45;45;0.6;18;27;0.1;0.4
Control.SRR15539829;50;45;0.4;30;20;0.1;0.4
Control.SRR15539829;45;45;0.444444444444444;25;20;0.0555555555555556;0.444444444444444
Control.SRR15539829;41;45;0.51219512195122;20;21;0.0121951219512195;0.48780487804878
Control.SRR15539829;51;45;0.450980392156863;28;23;0.0490196078431372;0.450980392156863
Control.SRR15539829;51;45;0.549019607843137;23;28;0.0490196078431373;0.450980392156863
Control.SRR15539829;48;45;0.5;24;24;0;0.5
Control.SRR15539829;46;45;0.41304347826087;27;19;0.0869565217391304;0.41304347826087
Control.SRR15539829;47;45;0.51063829787234;23;24;0.0106382978723404;0.48936170212766
Control.SRR15539829;50;45;0.62;19;31;0.12;0.38
Control.SRR15539829;44;45;0.431818181818182;25;19;0.0681818181818182;0.431818181818182
Control.SRR15539829;45;45;0.377777777777778;28;17;0.122222222222222;0.377777777777778
Control.SRR15539829;46;45;0.41304347826087;27;19;0.0869565217391304;0.41304347826087
Control.SRR15539829;42;45;0.333333333333333;28;14;0.166666666666667;0.333333333333333
Control.SRR15539829;40;45;0.4;24;16;0.1;0.4
Control.SRR15539829;51;45;0.392156862745098;31;20;0.107843137254902;0.392156862745098
Control.SRR15539829;46;45;0.41304347826087;27;19;0.0869565217391304;0.41304347826087
Control.SRR15539829;51;45;0.627450980392157;19;32;0.127450980392157;0.372549019607843
Control.SRR15539829;46;45;0.565217391304348;20;26;0.0652173913043478;0.434782608695652
Control.SRR15539829;43;45;0.534883720930233;20;23;0.0348837209302325;0.465116279069767
Control.SRR15539829;52;45;0.596153846153846;21;31;0.0961538461538461;0.403846153846154
Control.SRR15539829;50;45;0.58;21;29;0.08;0.42
Control.SRR15539829;44;45;0.568181818181818;19;25;0.0681818181818182;0.431818181818182
Control.SRR15539829;46;45;0.456521739130435;25;21;0.0434782608695652;0.456521739130435
Control.SRR15539829;43;45;0.418604651162791;25;18;0.0813953488372093;0.418604651162791
Control.SRR15539829;45;45;0.488888888888889;23;22;0.0111111111111111;0.488888888888889
Control.SRR15539829;52;45;0.538461538461538;24;28;0.0384615384615384;0.461538461538462
Control.SRR15539829;47;45;0.595744680851064;19;28;0.0957446808510638;0.404255319148936
Control.SRR15539829;43;45;0.558139534883721;19;24;0.0581395348837209;0.441860465116279
Control.SRR15539829;42;45;0.333333333333333;28;14;0.166666666666667;0.333333333333333
Control.SRR15539829;45;45;0.466666666666667;24;21;0.0333333333333333;0.466666666666667
Control.SRR15539829;52;45;0.461538461538462;28;24;0.0384615384615384;0.461538461538462
Control.SRR15539829;46;45;0.5;23;23;0;0.5
Control.SRR15539829;45;45;0.4;27;18;0.1;0.4
Control.SRR15539829;50;45;0.52;24;26;0.02;0.48
Control.SRR15539829;40;45;0.475;21;19;0.025;0.475
Control.SRR15539829;47;45;0.48936170212766;24;23;0.0106382978723404;0.48936170212766
Control.SRR15539829;46;45;0.456521739130435;25;21;0.0434782608695652;0.456521739130435
Control.SRR15539829;45;45;0.488888888888889;23;22;0.0111111111111111;0.488888888888889
Control.SRR15539829;44;45;0.454545454545455;24;20;0.0454545454545455;0.454545454545455
Control.SRR15539829;48;45;0.6875;15;33;0.1875;0.3125
Control.SRR15539829;49;45;0.530612244897959;23;26;0.0306122448979592;0.469387755102041
Control.SRR15539829;44;45;0.568181818181818;19;25;0.0681818181818182;0.431818181818182
Control.SRR15539829;41;45;0.560975609756098;18;23;0.0609756097560976;0.439024390243902
Control.SRR15539829;43;45;0.488372093023256;22;21;0.0116279069767442;0.488372093023256
Control.SRR15539829;46;45;0.434782608695652;26;20;0.0652173913043478;0.434782608695652
Control.SRR15539829;45;45;0.533333333333333;21;24;0.0333333333333333;0.466666666666667
Control.SRR15539829;46;45;0.58695652173913;19;27;0.0869565217391305;0.41304347826087
Control.SRR15539829;51;45;0.490196078431373;26;25;0.00980392156862747;0.490196078431373
Control.SRR15539829;46;45;0.608695652173913;18;28;0.108695652173913;0.391304347826087
Control.SRR15539829;47;45;0.595744680851064;19;28;0.0957446808510638;0.404255319148936
Control.SRR15539829;52;45;0.461538461538462;28;24;0.0384615384615384;0.461538461538462
Control.SRR15539829;47;45;0.48936170212766;24;23;0.0106382978723404;0.48936170212766
Control.SRR15539829;51;45;0.549019607843137;23;28;0.0490196078431373;0.450980392156863
Control.SRR15539829;50;45;0.5;25;25;0;0.5
Control.SRR15539829;41;45;0.463414634146341;22;19;0.0365853658536585;0.463414634146341
Control.SRR15539829;46;45;0.434782608695652;26;20;0.0652173913043478;0.434782608695652
Control.SRR15539829;45;45;0.377777777777778;28;17;0.122222222222222;0.377777777777778
Control.SRR15539829;40;45;0.525;19;21;0.025;0.475
Control.SRR15539829;48;45;0.395833333333333;29;19;0.104166666666667;0.395833333333333
Control.SRR15539829;44;45;0.386363636363636;27;17;0.113636363636364;0.386363636363636
Control.SRR15539829;46;45;0.478260869565217;24;22;0.0217391304347826;0.478260869565217
Control.SRR15539829;45;45;0.511111111111111;22;23;0.0111111111111111;0.488888888888889
Control.SRR15539829;42;45;0.476190476190476;22;20;0.0238095238095238;0.476190476190476
Control.SRR15539829;48;45;0.6875;15;33;0.1875;0.3125
Control.SRR15539829;43;45;0.511627906976744;21;22;0.0116279069767442;0.488372093023256
Control.SRR15539829;40;45;0.4;24;16;0.1;0.4
Control.SRR15539829;46;45;0.58695652173913;19;27;0.0869565217391305;0.41304347826087
Control.SRR15539829;47;45;0.404255319148936;28;19;0.0957446808510639;0.404255319148936
Control.SRR15539829;47;45;0.531914893617021;22;25;0.0319148936170213;0.468085106382979
Control.SRR15539829;52;45;0.403846153846154;31;21;0.0961538461538461;0.403846153846154
Control.SRR15539829;47;45;0.574468085106383;20;27;0.074468085106383;0.425531914893617
Control.SRR15539829;46;45;0.58695652173913;19;27;0.0869565217391305;0.41304347826087
Control.SRR15539829;46;45;0.5;23;23;0;0.5
Control.SRR15539829;44;45;0.545454545454545;20;24;0.0454545454545454;0.454545454545455
Control.SRR15539829;41;45;0.48780487804878;21;20;0.0121951219512195;0.48780487804878
Control.SRR15539829;52;45;0.423076923076923;30;22;0.0769230769230769;0.423076923076923
Control.SRR15539829;47;45;0.553191489361702;21;26;0.0531914893617021;0.446808510638298
Control.SRR15539829;49;45;0.448979591836735;27;22;0.0510204081632653;0.448979591836735
Control.SRR15539829;51;45;0.490196078431373;26;25;0.00980392156862747;0.490196078431373
Control.SRR15539829;47;45;0.404255319148936;28;19;0.0957446808510639;0.404255319148936
Control.SRR15539829;44;45;0.636363636363636;16;28;0.136363636363636;0.363636363636364
Control.SRR15539829;51;45;0.529411764705882;24;27;0.0294117647058824;0.470588235294118
Control.SRR15539829;47;45;0.595744680851064;19;28;0.0957446808510638;0.404255319148936
Control.SRR15539829;43;45;0.581395348837209;18;25;0.0813953488372093;0.418604651162791
Control.SRR15539829;40;45;0.475;21;19;0.025;0.475
Control.SRR15539829;51;45;0.431372549019608;29;22;0.0686274509803921;0.431372549019608
Control.SRR15539829;50;45;0.58;21;29;0.08;0.42
Control.SRR15539829;42;45;0.5;21;21;0;0.5
Control.SRR15539829;52;45;0.384615384615385;32;20;0.115384615384615;0.384615384615385
Control.SRR15539829;46;45;0.608695652173913;18;28;0.108695652173913;0.391304347826087
Control.SRR15539829;42;45;0.571428571428571;18;24;0.0714285714285714;0.428571428571429
Control.SRR15539829;47;45;0.404255319148936;28;19;0.0957446808510639;0.404255319148936
Control.SRR15539829;52;45;0.442307692307692;29;23;0.0576923076923077;0.442307692307692
Control.SRR15539829;45;45;0.6;18;27;0.1;0.4
Control.SRR15539829;44;45;0.568181818181818;19;25;0.0681818181818182;0.431818181818182
Control.SRR15539829;50;45;0.48;26;24;0.02;0.48
Control.SRR15539829;51;45;0.549019607843137;23;28;0.0490196078431373;0.450980392156863
Control.SRR15539829;48;45;0.4375;27;21;0.0625;0.4375
Control.SRR15539829;48;45;0.5;24;24;0;0.5
Control.SRR15539829;48;45;0.5625;21;27;0.0625;0.4375
Control.SRR15539829;40;45;0.425;23;17;0.075;0.425
Control.SRR15539829;40;45;0.5;20;20;0;0.5
Control.SRR15539829;48;45;0.458333333333333;26;22;0.0416666666666667;0.458333333333333
Control.SRR15539829;40;45;0.5;20;20;0;0.5
Control.SRR15539829;51;45;0.529411764705882;24;27;0.0294117647058824;0.470588235294118
Control.SRR15539829;42;45;0.5;21;21;0;0.5
Control.SRR15539829;49;45;0.510204081632653;24;25;0.0102040816326531;0.489795918367347
Control.SRR15539829;47;45;0.595744680851064;19;28;0.0957446808510638;0.404255319148936
Control.SRR15539829;44;45;0.386363636363636;27;17;0.113636363636364;0.386363636363636
Control.SRR15539829;52;45;0.480769230769231;27;25;0.0192307692307692;0.480769230769231
Control.SRR15539829;45;45;0.488888888888889;23;22;0.0111111111111111;0.488888888888889
Control.SRR15539829;47;45;0.468085106382979;25;22;0.0319148936170213;0.468085106382979
Control.SRR15539829;51;45;0.509803921568627;25;26;0.00980392156862742;0.490196078431373
Control.SRR15539829;45;45;0.577777777777778;19;26;0.0777777777777777;0.422222222222222
Control.SRR15539829;52;45;0.5;26;26;0;0.5
Control.SRR15539829;41;45;0.463414634146341;22;19;0.0365853658536585;0.463414634146341
Control.SRR15539829;41;45;0.585365853658537;17;24;0.0853658536585366;0.414634146341463
Control.SRR15539829;49;45;0.612244897959184;19;30;0.112244897959184;0.387755102040816
Control.SRR15539829;42;45;0.523809523809524;20;22;0.0238095238095238;0.476190476190476
Control.SRR15539829;51;45;0.411764705882353;30;21;0.0882352941176471;0.411764705882353
Control.SRR15539829;44;45;0.545454545454545;20;24;0.0454545454545454;0.454545454545455
Control.SRR15539829;45;45;0.4;27;18;0.1;0.4
Control.SRR15539829;49;45;0.571428571428571;21;28;0.0714285714285714;0.428571428571429
Control.SRR15539829;41;45;0.560975609756098;18;23;0.0609756097560976;0.439024390243902
Control.SRR15539829;49;45;0.448979591836735;27;22;0.0510204081632653;0.448979591836735
Control.SRR15539829;49;45;0.387755102040816;30;19;0.112244897959184;0.387755102040816
Control.SRR15539829;52;45;0.615384615384615;20;32;0.115384615384615;0.384615384615385
Control.SRR15539829;41;45;0.536585365853659;19;22;0.0365853658536586;0.463414634146341
Control.SRR15539829;46;45;0.478260869565217;24;22;0.0217391304347826;0.478260869565217
Control.SRR15539829;48;45;0.5;24;24;0;0.5
Control.SRR15539829;43;45;0.511627906976744;21;22;0.0116279069767442;0.488372093023256
Control.SRR15539829;46;45;0.695652173913043;14;32;0.195652173913043;0.304347826086957
Control.SRR15539829;50;45;0.48;26;24;0.02;0.48
Control.SRR15539829;42;45;0.642857142857143;15;27;0.142857142857143;0.357142857142857
Control.SRR15539829;43;45;0.441860465116279;24;19;0.0581395348837209;0.441860465116279
Control.SRR15539829;52;45;0.634615384615385;19;33;0.134615384615385;0.365384615384615
Control.SRR15539829;51;45;0.450980392156863;28;23;0.0490196078431372;0.450980392156863
Control.SRR15539829;49;45;0.571428571428571;21;28;0.0714285714285714;0.428571428571429
Control.SRR15539829;50;45;0.6;20;30;0.1;0.4
Control.SRR15539829;50;45;0.56;22;28;0.0600000000000001;0.44
Control.SRR15539829;40;45;0.55;18;22;0.05;0.45
Control.SRR15539829;46;45;0.478260869565217;24;22;0.0217391304347826;0.478260869565217
Control.SRR15539829;45;45;0.511111111111111;22;23;0.0111111111111111;0.488888888888889
Control.SRR15539829;46;45;0.478260869565217;24;22;0.0217391304347826;0.478260869565217
Control.SRR15539829;46;45;0.369565217391304;29;17;0.130434782608696;0.369565217391304
Control.SRR15539829;45;45;0.533333333333333;21;24;0.0333333333333333;0.466666666666667
Control.SRR15539829;44;45;0.5;22;22;0;0.5
Control.SRR15539829;42;45;0.642857142857143;15;27;0.142857142857143;0.357142857142857
Control.SRR15539829;42;45;0.5;21;21;0;0.5
Control.SRR15539829;42;45;0.428571428571429;24;18;0.0714285714285715;0.428571428571429
Control.SRR15539829;43;45;0.604651162790698;17;26;0.104651162790698;0.395348837209302
Control.SRR15539829;50;45;0.64;18;32;0.14;0.36
Control.SRR15539829;50;45;0.54;23;27;0.04;0.46
Control.SRR15539829;40;45;0.35;26;14;0.15;0.35
Control.SRR15539829;51;45;0.450980392156863;28;23;0.0490196078431372;0.450980392156863
Control.SRR15539829;42;45;0.69047619047619;13;29;0.19047619047619;0.30952380952381
Control.SRR15539829;49;45;0.448979591836735;27;22;0.0510204081632653;0.448979591836735
Control.SRR15539829;41;45;0.658536585365854;14;27;0.158536585365854;0.341463414634146
Control.SRR15539829;51;45;0.529411764705882;24;27;0.0294117647058824;0.470588235294118
Control.SRR15539829;45;45;0.444444444444444;25;20;0.0555555555555556;0.444444444444444
Control.SRR15539829;51;45;0.529411764705882;24;27;0.0294117647058824;0.470588235294118
Control.SRR15539829;43;45;0.465116279069767;23;20;0.0348837209302326;0.465116279069767
Control.SRR15539829;48;45;0.583333333333333;20;28;0.0833333333333334;0.416666666666667
Control.SRR15539829;51;45;0.431372549019608;29;22;0.0686274509803921;0.431372549019608
Control.SRR15539829;46;45;0.478260869565217;24;22;0.0217391304347826;0.478260869565217
Control.SRR15539829;45;45;0.488888888888889;23;22;0.0111111111111111;0.488888888888889
Control.SRR15539829;47;45;0.702127659574468;14;33;0.202127659574468;0.297872340425532
Control.SRR15539829;41;45;0.414634146341463;24;17;0.0853658536585366;0.414634146341463
Control.SRR15539829;47;45;0.468085106382979;25;22;0.0319148936170213;0.468085106382979
Control.SRR15539829;48;45;0.5;24;24;0;0.5
Control.SRR15539829;52;45;0.519230769230769;25;27;0.0192307692307693;0.480769230769231
Control.SRR15539829;50;45;0.5;25;25;0;0.5
Control.SRR15539829;52;45;0.538461538461538;24;28;0.0384615384615384;0.461538461538462
Control.SRR15539829;47;45;0.617021276595745;18;29;0.117021276595745;0.382978723404255
Control.SRR15539829;43;45;0.697674418604651;13;30;0.197674418604651;0.302325581395349
Control.SRR15539829;46;45;0.543478260869565;21;25;0.0434782608695652;0.456521739130435
Control.SRR15539829;44;45;0.5;22;22;0;0.5
Control.SRR15539829;51;45;0.529411764705882;24;27;0.0294117647058824;0.470588235294118
Control.SRR15539829;42;45;0.452380952380952;23;19;0.0476190476190476;0.452380952380952
Control.SRR15539829;50;45;0.4;30;20;0.1;0.4
Control.SRR15539829;41;45;0.365853658536585;26;15;0.134146341463415;0.365853658536585
Control.SRR15539829;48;45;0.5;24;24;0;0.5
Control.SRR15539829;42;45;0.404761904761905;25;17;0.0952380952380952;0.404761904761905
Control.SRR15539829;41;45;0.560975609756098;18;23;0.0609756097560976;0.439024390243902
Control.SRR15539829;46;45;0.456521739130435;25;21;0.0434782608695652;0.456521739130435
Control.SRR15539829;47;45;0.468085106382979;25;22;0.0319148936170213;0.468085106382979
Control.SRR15539829;48;45;0.458333333333333;26;22;0.0416666666666667;0.458333333333333
Control.SRR15539829;46;45;0.543478260869565;21;25;0.0434782608695652;0.456521739130435
Control.SRR15539829;45;45;0.688888888888889;14;31;0.188888888888889;0.311111111111111
Control.SRR15539829;44;45;0.613636363636364;17;27;0.113636363636364;0.386363636363636
Control.SRR15539829;40;45;0.45;22;18;0.05;0.45
Control.SRR15539829;48;45;0.5625;21;27;0.0625;0.4375
Control.SRR15539829;46;45;0.521739130434783;22;24;0.0217391304347826;0.478260869565217
Control.SRR15539829;51;45;0.529411764705882;24;27;0.0294117647058824;0.470588235294118
Control.SRR15539829;49;45;0.530612244897959;23;26;0.0306122448979592;0.469387755102041
Control.SRR15539829;51;45;0.490196078431373;26;25;0.00980392156862747;0.490196078431373
Control.SRR15539829;47;45;0.51063829787234;23;24;0.0106382978723404;0.48936170212766
Control.SRR15539829;46;45;0.58695652173913;19;27;0.0869565217391305;0.41304347826087
Control.SRR15539829;42;45;0.523809523809524;20;22;0.0238095238095238;0.476190476190476
Control.SRR15539829;50;45;0.48;26;24;0.02;0.48
Control.SRR15539829;40;45;0.6;16;24;0.1;0.4
Control.SRR15539829;42;45;0.547619047619048;19;23;0.0476190476190477;0.452380952380952
Control.SRR15539829;40;45;0.525;19;21;0.025;0.475
Control.SRR15539829;44;45;0.522727272727273;21;23;0.0227272727272727;0.477272727272727
Control.SRR15539829;50;45;0.54;23;27;0.04;0.46
Control.SRR15539829;47;45;0.468085106382979;25;22;0.0319148936170213;0.468085106382979
Control.SRR15539829;48;45;0.5;24;24;0;0.5
Control.SRR15539829;51;45;0.470588235294118;27;24;0.0294117647058824;0.470588235294118
Control.SRR15539829;52;45;0.461538461538462;28;24;0.0384615384615384;0.461538461538462
Control.SRR15539829;51;45;0.549019607843137;23;28;0.0490196078431373;0.450980392156863
Control.SRR15539829;44;45;0.386363636363636;27;17;0.113636363636364;0.386363636363636
Control.SRR15539829;49;45;0.551020408163265;22;27;0.0510204081632653;0.448979591836735
Control.SRR15539829;41;45;0.463414634146341;22;19;0.0365853658536585;0.463414634146341
Control.SRR15539829;50;45;0.54;23;27;0.04;0.46
Control.SRR15539829;49;45;0.510204081632653;24;25;0.0102040816326531;0.489795918367347
Control.SRR15539829;43;45;0.534883720930233;20;23;0.0348837209302325;0.465116279069767
Control.SRR15539829;41;45;0.414634146341463;24;17;0.0853658536585366;0.414634146341463
Control.SRR15539829;45;45;0.444444444444444;25;20;0.0555555555555556;0.444444444444444
Control.SRR15539829;44;45;0.477272727272727;23;21;0.0227272727272727;0.477272727272727
Control.SRR15539829;43;45;0.627906976744186;16;27;0.127906976744186;0.372093023255814
Control.SRR15539829;42;45;0.5;21;21;0;0.5
Control.SRR15539829;42;45;0.452380952380952;23;19;0.0476190476190476;0.452380952380952
Control.SRR15539829;51;45;0.588235294117647;21;30;0.0882352941176471;0.411764705882353
Control.SRR15539829;43;45;0.581395348837209;18;25;0.0813953488372093;0.418604651162791
Control.SRR15539829;48;45;0.645833333333333;17;31;0.145833333333333;0.354166666666667
Control.SRR15539829;40;45;0.6;16;24;0.1;0.4
Control.SRR15539829;46;45;0.652173913043478;16;30;0.152173913043478;0.347826086956522
Control.SRR15539829;49;45;0.551020408163265;22;27;0.0510204081632653;0.448979591836735
Control.SRR15539829;45;45;0.466666666666667;24;21;0.0333333333333333;0.466666666666667
Control.SRR15539829;50;45;0.58;21;29;0.08;0.42
Control.SRR15539829;51;45;0.450980392156863;28;23;0.0490196078431372;0.450980392156863
Control.SRR15539829;49;45;0.673469387755102;16;33;0.173469387755102;0.326530612244898
Control.SRR15539829;51;45;0.509803921568627;25;26;0.00980392156862742;0.490196078431373
Control.SRR15539829;51;45;0.411764705882353;30;21;0.0882352941176471;0.411764705882353
Control.SRR15539829;46;45;0.434782608695652;26;20;0.0652173913043478;0.434782608695652
Control.SRR15539829;52;45;0.442307692307692;29;23;0.0576923076923077;0.442307692307692
Control.SRR15539829;52;45;0.461538461538462;28;24;0.0384615384615384;0.461538461538462
Control.SRR15539829;42;45;0.571428571428571;18;24;0.0714285714285714;0.428571428571429
Control.SRR15539829;51;45;0.411764705882353;30;21;0.0882352941176471;0.411764705882353
Control.SRR15539829;50;45;0.48;26;24;0.02;0.48
Control.SRR15539829;45;45;0.466666666666667;24;21;0.0333333333333333;0.466666666666667
Control.SRR15539829;51;45;0.450980392156863;28;23;0.0490196078431372;0.450980392156863
Control.SRR15539829;40;45;0.375;25;15;0.125;0.375
Control.SRR15539829;44;45;0.659090909090909;15;29;0.159090909090909;0.340909090909091
Control.SRR15539829;44;45;0.568181818181818;19;25;0.0681818181818182;0.431818181818182
Control.SRR15539829;52;45;0.538461538461538;24;28;0.0384615384615384;0.461538461538462
Control.SRR15539829;44;45;0.5;22;22;0;0.5
Control.SRR15539829;43;45;0.441860465116279;24;19;0.0581395348837209;0.441860465116279
Control.SRR15539829;46;45;0.543478260869565;21;25;0.0434782608695652;0.456521739130435
Control.SRR15539829;40;45;0.475;21;19;0.025;0.475
Control.SRR15539829;43;45;0.372093023255814;27;16;0.127906976744186;0.372093023255814
Control.SRR15539829;48;45;0.5;24;24;0;0.5
Control.SRR15539829;52;45;0.480769230769231;27;25;0.0192307692307692;0.480769230769231
Control.SRR15539829;51;45;0.450980392156863;28;23;0.0490196078431372;0.450980392156863
Control.SRR15539829;42;45;0.523809523809524;20;22;0.0238095238095238;0.476190476190476
Control.SRR15539829;46;45;0.478260869565217;24;22;0.0217391304347826;0.478260869565217
Control.SRR15539829;47;45;0.617021276595745;18;29;0.117021276595745;0.382978723404255
Control.SRR15539829;49;45;0.510204081632653;24;25;0.0102040816326531;0.489795918367347
Control.SRR15539829;43;45;0.511627906976744;21;22;0.0116279069767442;0.488372093023256
Control.SRR15539829;51;45;0.607843137254902;20;31;0.107843137254902;0.392156862745098
Control.SRR15539829;47;45;0.425531914893617;27;20;0.074468085106383;0.425531914893617
Control.SRR15539829;45;45;0.577777777777778;19;26;0.0777777777777777;0.422222222222222
Control.SRR15539829;43;45;0.465116279069767;23;20;0.0348837209302326;0.465116279069767
Control.SRR15539829;43;45;0.604651162790698;17;26;0.104651162790698;0.395348837209302
Control.SRR15539829;44;45;0.295454545454545;31;13;0.204545454545455;0.295454545454545
Control.SRR15539829;44;45;0.477272727272727;23;21;0.0227272727272727;0.477272727272727
Control.SRR15539829;44;45;0.522727272727273;21;23;0.0227272727272727;0.477272727272727
Control.SRR15539829;43;45;0.465116279069767;23;20;0.0348837209302326;0.465116279069767
Control.SRR15539829;44;45;0.590909090909091;18;26;0.0909090909090909;0.409090909090909
Control.SRR15539829;45;45;0.422222222222222;26;19;0.0777777777777778;0.422222222222222
Control.SRR15539829;50;45;0.58;21;29;0.08;0.42
Control.SRR15539829;51;45;0.588235294117647;21;30;0.0882352941176471;0.411764705882353
Control.SRR15539829;45;45;0.533333333333333;21;24;0.0333333333333333;0.466666666666667
Control.SRR15539829;51;45;0.509803921568627;25;26;0.00980392156862742;0.490196078431373
Control.SRR15539829;51;45;0.470588235294118;27;24;0.0294117647058824;0.470588235294118
Control.SRR15539829;47;45;0.446808510638298;26;21;0.0531914893617021;0.446808510638298
Control.SRR15539829;51;45;0.411764705882353;30;21;0.0882352941176471;0.411764705882353
Control.SRR15539829;49;45;0.448979591836735;27;22;0.0510204081632653;0.448979591836735
Control.SRR15539829;46;45;0.608695652173913;18;28;0.108695652173913;0.391304347826087
Control.SRR15539829;47;45;0.340425531914894;31;16;0.159574468085106;0.340425531914894
Control.SRR15539829;43;45;0.488372093023256;22;21;0.0116279069767442;0.488372093023256
Control.SRR15539829;42;45;0.523809523809524;20;22;0.0238095238095238;0.476190476190476
Control.SRR15539829;40;45;0.55;18;22;0.05;0.45
Control.SRR15539829;48;45;0.583333333333333;20;28;0.0833333333333334;0.416666666666667
Control.SRR15539829;48;45;0.583333333333333;20;28;0.0833333333333334;0.416666666666667
Control.SRR15539829;52;45;0.461538461538462;28;24;0.0384615384615384;0.461538461538462
Control.SRR15539829;47;45;0.51063829787234;23;24;0.0106382978723404;0.48936170212766
Control.SRR15539829;51;45;0.509803921568627;25;26;0.00980392156862742;0.490196078431373
Control.SRR15539829;42;45;0.30952380952381;29;13;0.19047619047619;0.30952380952381
Control.SRR15539829;40;45;0.55;18;22;0.05;0.45
Control.SRR15539829;45;45;0.466666666666667;24;21;0.0333333333333333;0.466666666666667
Control.SRR15539829;44;45;0.386363636363636;27;17;0.113636363636364;0.386363636363636
Control.SRR15539829;50;45;0.5;25;25;0;0.5
Control.SRR15539829;48;45;0.541666666666667;22;26;0.0416666666666666;0.458333333333333
Control.SRR15539829;48;45;0.520833333333333;23;25;0.0208333333333334;0.479166666666667
Control.SRR15539829;51;45;0.490196078431373;26;25;0.00980392156862747;0.490196078431373
Control.SRR15539829;52;45;0.423076923076923;30;22;0.0769230769230769;0.423076923076923
Control.SRR15539829;47;45;0.468085106382979;25;22;0.0319148936170213;0.468085106382979
Control.SRR15539829;40;45;0.475;21;19;0.025;0.475
Control.SRR15539829;50;45;0.7;15;35;0.2;0.3
Control.SRR15539829;52;45;0.538461538461538;24;28;0.0384615384615384;0.461538461538462
Control.SRR15539829;52;45;0.346153846153846;34;18;0.153846153846154;0.346153846153846
Control.SRR15539829;52;45;0.557692307692308;23;29;0.0576923076923077;0.442307692307692
Control.SRR15539829;40;45;0.45;22;18;0.05;0.45
Control.SRR15539829;41;45;0.560975609756098;18;23;0.0609756097560976;0.439024390243902
Control.SRR15539829;44;45;0.613636363636364;17;27;0.113636363636364;0.386363636363636
Control.SRR15539829;52;45;0.576923076923077;22;30;0.0769230769230769;0.423076923076923
Control.SRR15539829;45;45;0.4;27;18;0.1;0.4
Control.SRR15539829;43;45;0.488372093023256;22;21;0.0116279069767442;0.488372093023256
Control.SRR15539829;50;45;0.46;27;23;0.04;0.46
Control.SRR15539829;47;45;0.553191489361702;21;26;0.0531914893617021;0.446808510638298
Control.SRR15539829;47;45;0.723404255319149;13;34;0.223404255319149;0.276595744680851
Control.SRR15539829;50;45;0.52;24;26;0.02;0.48
Control.SRR15539829;44;45;0.409090909090909;26;18;0.0909090909090909;0.409090909090909
Control.SRR15539829;46;45;0.456521739130435;25;21;0.0434782608695652;0.456521739130435
Control.SRR15539829;52;45;0.615384615384615;20;32;0.115384615384615;0.384615384615385
Control.SRR15539829;47;45;0.446808510638298;26;21;0.0531914893617021;0.446808510638298
Control.SRR15539829;40;45;0.4;24;16;0.1;0.4
Control.SRR15539829;43;45;0.441860465116279;24;19;0.0581395348837209;0.441860465116279
Control.SRR15539829;42;45;0.547619047619048;19;23;0.0476190476190477;0.452380952380952
Control.SRR15539829;41;45;0.439024390243902;23;18;0.0609756097560976;0.439024390243902
Control.SRR15539829;47;45;0.48936170212766;24;23;0.0106382978723404;0.48936170212766
Control.SRR15539829;47;45;0.574468085106383;20;27;0.074468085106383;0.425531914893617
Control.SRR15539829;49;45;0.530612244897959;23;26;0.0306122448979592;0.469387755102041
Control.SRR15539829;40;45;0.5;20;20;0;0.5
Control.SRR15539829;44;45;0.454545454545455;24;20;0.0454545454545455;0.454545454545455
Control.SRR15539829;50;45;0.38;31;19;0.12;0.38
Control.SRR15539829;44;45;0.454545454545455;24;20;0.0454545454545455;0.454545454545455
Control.SRR15539829;41;45;0.414634146341463;24;17;0.0853658536585366;0.414634146341463
Control.SRR15539829;40;45;0.525;19;21;0.025;0.475
Control.SRR15539829;50;45;0.56;22;28;0.0600000000000001;0.44
Control.SRR15539829;46;45;0.478260869565217;24;22;0.0217391304347826;0.478260869565217
Control.SRR15539829;42;45;0.523809523809524;20;22;0.0238095238095238;0.476190476190476
Control.SRR15539829;41;45;0.463414634146341;22;19;0.0365853658536585;0.463414634146341
Control.SRR15539829;48;45;0.395833333333333;29;19;0.104166666666667;0.395833333333333
Control.SRR15539829;48;45;0.4375;27;21;0.0625;0.4375
Control.SRR15539829;46;45;0.543478260869565;21;25;0.0434782608695652;0.456521739130435
Control.SRR15539829;46;45;0.521739130434783;22;24;0.0217391304347826;0.478260869565217
Control.SRR15539829;48;45;0.5;24;24;0;0.5
Control.SRR15539829;50;45;0.52;24;26;0.02;0.48
Control.SRR15539829;48;45;0.333333333333333;32;16;0.166666666666667;0.333333333333333
Control.SRR15539829;45;45;0.355555555555556;29;16;0.144444444444444;0.355555555555556
Control.SRR15539829;46;45;0.608695652173913;18;28;0.108695652173913;0.391304347826087
Control.SRR15539829;52;45;0.5;26;26;0;0.5
Control.SRR15539829;41;45;0.560975609756098;18;23;0.0609756097560976;0.439024390243902
Control.SRR15539829;41;45;0.560975609756098;18;23;0.0609756097560976;0.439024390243902
Control.SRR15539829;46;45;0.5;23;23;0;0.5
Control.SRR15539829;50;45;0.54;23;27;0.04;0.46
Control.SRR15539829;52;45;0.538461538461538;24;28;0.0384615384615384;0.461538461538462
Control.SRR15539829;44;45;0.5;22;22;0;0.5
Control.SRR15539829;47;45;0.51063829787234;23;24;0.0106382978723404;0.48936170212766
Control.SRR15539829;51;45;0.352941176470588;33;18;0.147058823529412;0.352941176470588
Control.SRR15539829;50;45;0.44;28;22;0.06;0.44
Control.SRR15539829;50;45;0.46;27;23;0.04;0.46
Control.SRR15539829;50;45;0.62;19;31;0.12;0.38
Control.SRR15539829;50;45;0.42;29;21;0.08;0.42
Control.SRR15539829;48;45;0.458333333333333;26;22;0.0416666666666667;0.458333333333333
Control.SRR15539829;42;45;0.571428571428571;18;24;0.0714285714285714;0.428571428571429
Control.SRR15539829;42;45;0.571428571428571;18;24;0.0714285714285714;0.428571428571429
Control.SRR15539829;49;45;0.306122448979592;34;15;0.193877551020408;0.306122448979592
Control.SRR15539829;51;45;0.686274509803922;16;35;0.186274509803922;0.313725490196078
Control.SRR15539829;52;45;0.461538461538462;28;24;0.0384615384615384;0.461538461538462
Control.SRR15539829;44;45;0.477272727272727;23;21;0.0227272727272727;0.477272727272727
Control.SRR15539829;50;45;0.46;27;23;0.04;0.46
Control.SRR15539829;52;45;0.5;26;26;0;0.5
Control.SRR15539829;51;45;0.568627450980392;22;29;0.0686274509803921;0.431372549019608
Control.SRR15539829;48;45;0.5;24;24;0;0.5
Control.SRR15539829;42;45;0.547619047619048;19;23;0.0476190476190477;0.452380952380952
Control.SRR15539829;52;45;0.596153846153846;21;31;0.0961538461538461;0.403846153846154
Control.SRR15539829;48;45;0.479166666666667;25;23;0.0208333333333333;0.479166666666667
Control.SRR15539829;45;45;0.511111111111111;22;23;0.0111111111111111;0.488888888888889
Control.SRR15539829;48;45;0.520833333333333;23;25;0.0208333333333334;0.479166666666667
Control.SRR15539829;44;45;0.545454545454545;20;24;0.0454545454545454;0.454545454545455
Control.SRR15539829;47;45;0.425531914893617;27;20;0.074468085106383;0.425531914893617
Control.SRR15539829;43;45;0.488372093023256;22;21;0.0116279069767442;0.488372093023256
Control.SRR15539829;49;45;0.510204081632653;24;25;0.0102040816326531;0.489795918367347
Control.SRR15539829;45;45;0.4;27;18;0.1;0.4
Control.SRR15539829;45;45;0.488888888888889;23;22;0.0111111111111111;0.488888888888889
Control.SRR15539829;51;45;0.549019607843137;23;28;0.0490196078431373;0.450980392156863
Control.SRR15539829;46;45;0.41304347826087;27;19;0.0869565217391304;0.41304347826087
Control.SRR15539829;42;45;0.571428571428571;18;24;0.0714285714285714;0.428571428571429
Control.SRR15539829;44;45;0.5;22;22;0;0.5
Control.SRR15539829;43;45;0.558139534883721;19;24;0.0581395348837209;0.441860465116279
Control.SRR15539829;42;45;0.5;21;21;0;0.5
Control.SRR15539829;48;45;0.520833333333333;23;25;0.0208333333333334;0.479166666666667
Control.SRR15539829;52;45;0.538461538461538;24;28;0.0384615384615384;0.461538461538462
Control.SRR15539829;46;45;0.565217391304348;20;26;0.0652173913043478;0.434782608695652
Control.SRR15539829;51;45;0.509803921568627;25;26;0.00980392156862742;0.490196078431373
Control.SRR15539829;49;45;0.448979591836735;27;22;0.0510204081632653;0.448979591836735
Control.SRR15539829;43;45;0.465116279069767;23;20;0.0348837209302326;0.465116279069767
Control.SRR15539829;50;45;0.48;26;24;0.02;0.48
Control.SRR15539829;50;45;0.54;23;27;0.04;0.46
Control.SRR15539829;43;45;0.465116279069767;23;20;0.0348837209302326;0.465116279069767
Control.SRR15539829;41;45;0.48780487804878;21;20;0.0121951219512195;0.48780487804878
Control.SRR15539829;44;45;0.659090909090909;15;29;0.159090909090909;0.340909090909091
Control.SRR15539829;43;45;0.581395348837209;18;25;0.0813953488372093;0.418604651162791
Control.SRR15539829;45;45;0.355555555555556;29;16;0.144444444444444;0.355555555555556
Control.SRR15539829;46;45;0.434782608695652;26;20;0.0652173913043478;0.434782608695652
Control.SRR15539829;45;45;0.577777777777778;19;26;0.0777777777777777;0.422222222222222
Control.SRR15539829;43;45;0.511627906976744;21;22;0.0116279069767442;0.488372093023256
Control.SRR15539829;43;45;0.511627906976744;21;22;0.0116279069767442;0.488372093023256
Control.SRR15539829;41;45;0.682926829268293;13;28;0.182926829268293;0.317073170731707
Control.SRR15539829;43;45;0.465116279069767;23;20;0.0348837209302326;0.465116279069767
Control.SRR15539829;41;45;0.439024390243902;23;18;0.0609756097560976;0.439024390243902
Control.SRR15539829;40;45;0.65;14;26;0.15;0.35
Control.SRR15539829;48;45;0.458333333333333;26;22;0.0416666666666667;0.458333333333333
Control.SRR15539829;41;45;0.390243902439024;25;16;0.109756097560976;0.390243902439024
Control.SRR15539829;49;45;0.510204081632653;24;25;0.0102040816326531;0.489795918367347
Control.SRR15539829;45;45;0.466666666666667;24;21;0.0333333333333333;0.466666666666667
Control.SRR15539829;50;45;0.52;24;26;0.02;0.48
Control.SRR15539829;41;45;0.51219512195122;20;21;0.0121951219512195;0.48780487804878
Control.SRR15539829;46;45;0.41304347826087;27;19;0.0869565217391304;0.41304347826087
Control.SRR15539829;47;45;0.574468085106383;20;27;0.074468085106383;0.425531914893617
Control.SRR15539829;42;45;0.547619047619048;19;23;0.0476190476190477;0.452380952380952
Control.SRR15539829;48;45;0.479166666666667;25;23;0.0208333333333333;0.479166666666667
Control.SRR15539829;40;45;0.55;18;22;0.05;0.45
Control.SRR15539829;40;45;0.575;17;23;0.075;0.425
Control.SRR15539829;44;45;0.522727272727273;21;23;0.0227272727272727;0.477272727272727
Control.SRR15539829;52;45;0.461538461538462;28;24;0.0384615384615384;0.461538461538462
Control.SRR15539829;45;45;0.422222222222222;26;19;0.0777777777777778;0.422222222222222
Control.SRR15539829;43;45;0.488372093023256;22;21;0.0116279069767442;0.488372093023256
Control.SRR15539829;44;45;0.386363636363636;27;17;0.113636363636364;0.386363636363636
Control.SRR15539829;51;45;0.588235294117647;21;30;0.0882352941176471;0.411764705882353
Control.SRR15539829;43;45;0.465116279069767;23;20;0.0348837209302326;0.465116279069767
Control.SRR15539829;42;45;0.571428571428571;18;24;0.0714285714285714;0.428571428571429
Control.SRR15539829;45;45;0.533333333333333;21;24;0.0333333333333333;0.466666666666667
Control.SRR15539829;49;45;0.448979591836735;27;22;0.0510204081632653;0.448979591836735
Control.SRR15539829;45;45;0.4;27;18;0.1;0.4
Control.SRR15539829;48;45;0.583333333333333;20;28;0.0833333333333334;0.416666666666667
Control.SRR15539829;44;45;0.636363636363636;16;28;0.136363636363636;0.363636363636364
Control.SRR15539829;47;45;0.574468085106383;20;27;0.074468085106383;0.425531914893617
Control.SRR15539829;52;45;0.461538461538462;28;24;0.0384615384615384;0.461538461538462
Control.SRR15539829;46;45;0.608695652173913;18;28;0.108695652173913;0.391304347826087
Control.SRR15539829;48;45;0.395833333333333;29;19;0.104166666666667;0.395833333333333
Control.SRR15539829;50;45;0.4;30;20;0.1;0.4
Control.SRR15539829;51;45;0.529411764705882;24;27;0.0294117647058824;0.470588235294118
Control.SRR15539829;49;45;0.387755102040816;30;19;0.112244897959184;0.387755102040816
Control.SRR15539829;42;45;0.452380952380952;23;19;0.0476190476190476;0.452380952380952
Control.SRR15539829;49;45;0.551020408163265;22;27;0.0510204081632653;0.448979591836735
Control.SRR15539829;45;45;0.466666666666667;24;21;0.0333333333333333;0.466666666666667
Control.SRR15539829;44;45;0.590909090909091;18;26;0.0909090909090909;0.409090909090909
Control.SRR15539829;49;45;0.551020408163265;22;27;0.0510204081632653;0.448979591836735
Control.SRR15539829;47;45;0.638297872340426;17;30;0.138297872340426;0.361702127659574
Control.SRR15539829;50;45;0.56;22;28;0.0600000000000001;0.44
Control.SRR15539829;50;45;0.54;23;27;0.04;0.46
Control.SRR15539829;52;45;0.346153846153846;34;18;0.153846153846154;0.346153846153846
Control.SRR15539829;52;45;0.346153846153846;34;18;0.153846153846154;0.346153846153846
Control.SRR15539829;51;45;0.490196078431373;26;25;0.00980392156862747;0.490196078431373
Control.SRR15539829;47;45;0.51063829787234;23;24;0.0106382978723404;0.48936170212766
Control.SRR15539829;44;45;0.681818181818182;14;30;0.181818181818182;0.318181818181818
Control.SRR15539829;43;45;0.441860465116279;24;19;0.0581395348837209;0.441860465116279
Control.SRR15539829;50;45;0.38;31;19;0.12;0.38
Control.SRR15539829;40;45;0.45;22;18;0.05;0.45
Control.SRR15539829;42;45;0.547619047619048;19;23;0.0476190476190477;0.452380952380952
Control.SRR15539829;50;45;0.48;26;24;0.02;0.48
Control.SRR15539829;51;45;0.549019607843137;23;28;0.0490196078431373;0.450980392156863
Control.SRR15539829;44;45;0.5;22;22;0;0.5
Control.SRR15539829;40;45;0.45;22;18;0.05;0.45
Control.SRR15539829;43;45;0.581395348837209;18;25;0.0813953488372093;0.418604651162791
Control.SRR15539829;51;45;0.490196078431373;26;25;0.00980392156862747;0.490196078431373
Control.SRR15539829;47;45;0.553191489361702;21;26;0.0531914893617021;0.446808510638298
Control.SRR15539829;48;45;0.416666666666667;28;20;0.0833333333333333;0.416666666666667
Control.SRR15539829;50;45;0.36;32;18;0.14;0.36
Control.SRR15539829;52;45;0.596153846153846;21;31;0.0961538461538461;0.403846153846154
Control.SRR15539829;45;45;0.6;18;27;0.1;0.4
Control.SRR15539829;48;45;0.458333333333333;26;22;0.0416666666666667;0.458333333333333
Control.SRR15539829;48;45;0.520833333333333;23;25;0.0208333333333334;0.479166666666667
Control.SRR15539829;48;45;0.458333333333333;26;22;0.0416666666666667;0.458333333333333
Control.SRR15539829;42;45;0.595238095238095;17;25;0.0952380952380952;0.404761904761905
Control.SRR15539829;52;45;0.519230769230769;25;27;0.0192307692307693;0.480769230769231
Control.SRR15539829;49;45;0.571428571428571;21;28;0.0714285714285714;0.428571428571429
Control.SRR15539829;49;45;0.489795918367347;25;24;0.0102040816326531;0.489795918367347
Control.SRR15539829;48;45;0.458333333333333;26;22;0.0416666666666667;0.458333333333333
Control.SRR15539829;50;45;0.44;28;22;0.06;0.44
Control.SRR15539829;50;45;0.6;20;30;0.1;0.4
Control.SRR15539829;50;45;0.52;24;26;0.02;0.48
Control.SRR15539829;51;45;0.607843137254902;20;31;0.107843137254902;0.392156862745098
Control.SRR15539829;47;45;0.659574468085106;16;31;0.159574468085106;0.340425531914894
Control.SRR15539829;51;45;0.431372549019608;29;22;0.0686274509803921;0.431372549019608
Control.SRR15539829;48;45;0.479166666666667;25;23;0.0208333333333333;0.479166666666667
Control.SRR15539829;46;45;0.369565217391304;29;17;0.130434782608696;0.369565217391304
Control.SRR15539829;50;45;0.5;25;25;0;0.5
Control.SRR15539829;40;45;0.425;23;17;0.075;0.425
Control.SRR15539829;47;45;0.468085106382979;25;22;0.0319148936170213;0.468085106382979
Control.SRR15539829;44;45;0.318181818181818;30;14;0.181818181818182;0.318181818181818
Control.SRR15539829;45;45;0.511111111111111;22;23;0.0111111111111111;0.488888888888889
Control.SRR15539829;47;45;0.553191489361702;21;26;0.0531914893617021;0.446808510638298
Control.SRR15539829;51;45;0.411764705882353;30;21;0.0882352941176471;0.411764705882353
Control.SRR15539829;43;45;0.558139534883721;19;24;0.0581395348837209;0.441860465116279
Control.SRR15539829;49;45;0.510204081632653;24;25;0.0102040816326531;0.489795918367347
Control.SRR15539829;50;45;0.5;25;25;0;0.5
Control.SRR15539829;50;45;0.5;25;25;0;0.5
Control.SRR15539829;52;45;0.403846153846154;31;21;0.0961538461538461;0.403846153846154
Control.SRR15539829;49;45;0.408163265306122;29;20;0.0918367346938775;0.408163265306122
Control.SRR15539829;48;45;0.416666666666667;28;20;0.0833333333333333;0.416666666666667
Control.SRR15539829;50;45;0.54;23;27;0.04;0.46
Control.SRR15539829;43;45;0.534883720930233;20;23;0.0348837209302325;0.465116279069767
Control.SRR15539829;48;45;0.375;30;18;0.125;0.375
Control.SRR15539829;52;45;0.5;26;26;0;0.5
Control.SRR15539829;49;45;0.448979591836735;27;22;0.0510204081632653;0.448979591836735
Control.SRR15539829;47;45;0.425531914893617;27;20;0.074468085106383;0.425531914893617
Control.SRR15539829;47;45;0.51063829787234;23;24;0.0106382978723404;0.48936170212766
Control.SRR15539829;47;45;0.574468085106383;20;27;0.074468085106383;0.425531914893617
Control.SRR15539829;52;45;0.557692307692308;23;29;0.0576923076923077;0.442307692307692
Control.SRR15539829;49;45;0.571428571428571;21;28;0.0714285714285714;0.428571428571429
Control.SRR15539829;48;45;0.479166666666667;25;23;0.0208333333333333;0.479166666666667
Control.SRR15539829;51;45;0.549019607843137;23;28;0.0490196078431373;0.450980392156863
Control.SRR15539829;50;45;0.5;25;25;0;0.5
Control.SRR15539829;47;45;0.48936170212766;24;23;0.0106382978723404;0.48936170212766
Control.SRR15539829;40;45;0.4;24;16;0.1;0.4
Control.SRR15539829;51;45;0.529411764705882;24;27;0.0294117647058824;0.470588235294118
Control.SRR15539829;49;45;0.571428571428571;21;28;0.0714285714285714;0.428571428571429
Control.SRR15539829;48;45;0.5625;21;27;0.0625;0.4375
Control.SRR15539829;52;45;0.5;26;26;0;0.5
Control.SRR15539829;44;45;0.568181818181818;19;25;0.0681818181818182;0.431818181818182
Control.SRR15539829;42;45;0.380952380952381;26;16;0.119047619047619;0.380952380952381
Control.SRR15539829;44;45;0.477272727272727;23;21;0.0227272727272727;0.477272727272727
Control.SRR15539829;40;45;0.45;22;18;0.05;0.45
Control.SRR15539829;46;45;0.41304347826087;27;19;0.0869565217391304;0.41304347826087
Control.SRR15539829;47;45;0.51063829787234;23;24;0.0106382978723404;0.48936170212766
Control.SRR15539829;50;45;0.38;31;19;0.12;0.38
Control.SRR15539829;42;45;0.428571428571429;24;18;0.0714285714285715;0.428571428571429
Control.SRR15539829;43;45;0.627906976744186;16;27;0.127906976744186;0.372093023255814
Control.SRR15539829;43;45;0.581395348837209;18;25;0.0813953488372093;0.418604651162791
Control.SRR15539829;48;45;0.458333333333333;26;22;0.0416666666666667;0.458333333333333
Control.SRR15539829;49;45;0.469387755102041;26;23;0.0306122448979592;0.469387755102041
Control.SRR15539829;52;45;0.538461538461538;24;28;0.0384615384615384;0.461538461538462
Control.SRR15539829;48;45;0.479166666666667;25;23;0.0208333333333333;0.479166666666667
Control.SRR15539829;45;45;0.577777777777778;19;26;0.0777777777777777;0.422222222222222
Control.SRR15539829;46;45;0.521739130434783;22;24;0.0217391304347826;0.478260869565217
Control.SRR15539829;41;45;0.414634146341463;24;17;0.0853658536585366;0.414634146341463
Control.SRR15539829;46;45;0.391304347826087;28;18;0.108695652173913;0.391304347826087
Control.SRR15539829;49;45;0.510204081632653;24;25;0.0102040816326531;0.489795918367347
Control.SRR15539829;46;45;0.521739130434783;22;24;0.0217391304347826;0.478260869565217
Control.SRR15539829;46;45;0.391304347826087;28;18;0.108695652173913;0.391304347826087
Control.SRR15539829;51;45;0.431372549019608;29;22;0.0686274509803921;0.431372549019608
Control.SRR15539829;50;45;0.52;24;26;0.02;0.48
Control.SRR15539829;46;45;0.543478260869565;21;25;0.0434782608695652;0.456521739130435
Control.SRR15539829;52;45;0.365384615384615;33;19;0.134615384615385;0.365384615384615
Control.SRR15539829;49;45;0.428571428571429;28;21;0.0714285714285715;0.428571428571429
Control.SRR15539829;43;45;0.767441860465116;10;33;0.267441860465116;0.232558139534884
Control.SRR15539829;48;45;0.5;24;24;0;0.5
Control.SRR15539829;47;45;0.48936170212766;24;23;0.0106382978723404;0.48936170212766
Control.SRR15539829;49;45;0.469387755102041;26;23;0.0306122448979592;0.469387755102041
Control.SRR15539829;51;45;0.450980392156863;28;23;0.0490196078431372;0.450980392156863
Control.SRR15539829;49;45;0.530612244897959;23;26;0.0306122448979592;0.469387755102041
Control.SRR15539829;45;45;0.511111111111111;22;23;0.0111111111111111;0.488888888888889
Control.SRR15539829;47;45;0.361702127659574;30;17;0.138297872340426;0.361702127659574
Control.SRR15539829;50;45;0.54;23;27;0.04;0.46
Control.SRR15539829;45;45;0.533333333333333;21;24;0.0333333333333333;0.466666666666667
Control.SRR15539829;46;45;0.391304347826087;28;18;0.108695652173913;0.391304347826087
Control.SRR15539829;45;45;0.4;27;18;0.1;0.4
Control.SRR15539829;42;45;0.404761904761905;25;17;0.0952380952380952;0.404761904761905
Control.SRR15539829;41;45;0.51219512195122;20;21;0.0121951219512195;0.48780487804878
Control.SRR15539829;49;45;0.448979591836735;27;22;0.0510204081632653;0.448979591836735
Control.SRR15539829;40;45;0.425;23;17;0.075;0.425
Control.SRR15539829;44;45;0.613636363636364;17;27;0.113636363636364;0.386363636363636
Control.SRR15539829;48;45;0.458333333333333;26;22;0.0416666666666667;0.458333333333333
Control.SRR15539829;44;45;0.454545454545455;24;20;0.0454545454545455;0.454545454545455
Control.SRR15539829;48;45;0.5625;21;27;0.0625;0.4375
Control.SRR15539829;41;45;0.463414634146341;22;19;0.0365853658536585;0.463414634146341
Control.SRR15539829;45;45;0.644444444444444;16;29;0.144444444444444;0.355555555555556
Control.SRR15539829;45;45;0.466666666666667;24;21;0.0333333333333333;0.466666666666667
Control.SRR15539829;40;45;0.6;16;24;0.1;0.4
Control.SRR15539829;52;45;0.519230769230769;25;27;0.0192307692307693;0.480769230769231
Control.SRR15539829;43;45;0.534883720930233;20;23;0.0348837209302325;0.465116279069767
Control.SRR15539829;51;45;0.509803921568627;25;26;0.00980392156862742;0.490196078431373
Control.SRR15539829;51;45;0.490196078431373;26;25;0.00980392156862747;0.490196078431373
Control.SRR15539829;44;45;0.477272727272727;23;21;0.0227272727272727;0.477272727272727
Control.SRR15539829;43;45;0.441860465116279;24;19;0.0581395348837209;0.441860465116279
Control.SRR15539829;41;45;0.390243902439024;25;16;0.109756097560976;0.390243902439024
Control.SRR15539829;40;45;0.5;20;20;0;0.5
Control.SRR15539829;40;45;0.45;22;18;0.05;0.45
Control.SRR15539829;40;45;0.55;18;22;0.05;0.45
Control.SRR15539829;48;45;0.541666666666667;22;26;0.0416666666666666;0.458333333333333
Control.SRR15539829;46;45;0.478260869565217;24;22;0.0217391304347826;0.478260869565217
Control.SRR15539829;50;45;0.7;15;35;0.2;0.3
Control.SRR15539829;52;45;0.461538461538462;28;24;0.0384615384615384;0.461538461538462
Control.SRR15539829;48;45;0.395833333333333;29;19;0.104166666666667;0.395833333333333
Control.SRR15539829;47;45;0.446808510638298;26;21;0.0531914893617021;0.446808510638298
Control.SRR15539829;47;45;0.51063829787234;23;24;0.0106382978723404;0.48936170212766
Control.SRR15539829;45;45;0.511111111111111;22;23;0.0111111111111111;0.488888888888889
Control.SRR15539829;52;45;0.538461538461538;24;28;0.0384615384615384;0.461538461538462
Control.SRR15539829;47;45;0.404255319148936;28;19;0.0957446808510639;0.404255319148936
Control.SRR15539829;44;45;0.431818181818182;25;19;0.0681818181818182;0.431818181818182
Control.SRR15539829;44;45;0.409090909090909;26;18;0.0909090909090909;0.409090909090909
Control.SRR15539829;41;45;0.585365853658537;17;24;0.0853658536585366;0.414634146341463
Control.SRR15539829;41;45;0.390243902439024;25;16;0.109756097560976;0.390243902439024
Control.SRR15539829;42;45;0.428571428571429;24;18;0.0714285714285715;0.428571428571429
Control.SRR15539829;43;45;0.441860465116279;24;19;0.0581395348837209;0.441860465116279
Control.SRR15539829;51;45;0.627450980392157;19;32;0.127450980392157;0.372549019607843
Control.SRR15539829;51;45;0.352941176470588;33;18;0.147058823529412;0.352941176470588
Control.SRR15539829;41;45;0.51219512195122;20;21;0.0121951219512195;0.48780487804878
Control.SRR15539829;48;45;0.520833333333333;23;25;0.0208333333333334;0.479166666666667
Control.SRR15539829;41;45;0.439024390243902;23;18;0.0609756097560976;0.439024390243902
Control.SRR15539829;42;45;0.380952380952381;26;16;0.119047619047619;0.380952380952381
Control.SRR15539829;41;45;0.414634146341463;24;17;0.0853658536585366;0.414634146341463
Control.SRR15539829;42;45;0.523809523809524;20;22;0.0238095238095238;0.476190476190476
Control.SRR15539829;50;45;0.4;30;20;0.1;0.4
Control.SRR15539829;40;45;0.425;23;17;0.075;0.425
Control.SRR15539829;40;45;0.425;23;17;0.075;0.425
Control.SRR15539829;41;45;0.536585365853659;19;22;0.0365853658536586;0.463414634146341
Control.SRR15539829;40;45;0.425;23;17;0.075;0.425
Control.SRR15539829;46;45;0.456521739130435;25;21;0.0434782608695652;0.456521739130435
Control.SRR15539829;42;45;0.547619047619048;19;23;0.0476190476190477;0.452380952380952
Control.SRR15539829;47;45;0.531914893617021;22;25;0.0319148936170213;0.468085106382979
Control.SRR15539829;50;45;0.5;25;25;0;0.5
Control.SRR15539829;52;45;0.673076923076923;17;35;0.173076923076923;0.326923076923077
Control.SRR15539829;52;45;0.461538461538462;28;24;0.0384615384615384;0.461538461538462
Control.SRR15539829;41;45;0.463414634146341;22;19;0.0365853658536585;0.463414634146341
Control.SRR15539829;42;45;0.523809523809524;20;22;0.0238095238095238;0.476190476190476
Control.SRR15539829;42;45;0.380952380952381;26;16;0.119047619047619;0.380952380952381
Control.SRR15539829;42;45;0.595238095238095;17;25;0.0952380952380952;0.404761904761905
Control.SRR15539829;47;45;0.51063829787234;23;24;0.0106382978723404;0.48936170212766
Control.SRR15539829;43;45;0.534883720930233;20;23;0.0348837209302325;0.465116279069767
Control.SRR15539829;50;45;0.52;24;26;0.02;0.48
Control.SRR15539829;44;45;0.5;22;22;0;0.5
Control.SRR15539829;42;45;0.404761904761905;25;17;0.0952380952380952;0.404761904761905
Control.SRR15539829;46;45;0.565217391304348;20;26;0.0652173913043478;0.434782608695652
Control.SRR15539829;45;45;0.488888888888889;23;22;0.0111111111111111;0.488888888888889
Control.SRR15539829;44;45;0.568181818181818;19;25;0.0681818181818182;0.431818181818182
Control.SRR15539829;42;45;0.5;21;21;0;0.5
Control.SRR15539829;40;45;0.5;20;20;0;0.5
Control.SRR15539829;49;45;0.571428571428571;21;28;0.0714285714285714;0.428571428571429
Control.SRR15539829;46;45;0.543478260869565;21;25;0.0434782608695652;0.456521739130435
Control.SRR15539829;42;45;0.452380952380952;23;19;0.0476190476190476;0.452380952380952
Control.SRR15539829;51;45;0.470588235294118;27;24;0.0294117647058824;0.470588235294118
Control.SRR15539829;40;45;0.525;19;21;0.025;0.475
Control.SRR15539829;47;45;0.425531914893617;27;20;0.074468085106383;0.425531914893617
Control.SRR15539829;51;45;0.392156862745098;31;20;0.107843137254902;0.392156862745098
Control.SRR15539829;40;45;0.45;22;18;0.05;0.45
Control.SRR15539829;45;45;0.511111111111111;22;23;0.0111111111111111;0.488888888888889
Control.SRR15539829;46;45;0.565217391304348;20;26;0.0652173913043478;0.434782608695652
Control.SRR15539829;41;45;0.390243902439024;25;16;0.109756097560976;0.390243902439024
Control.SRR15539829;51;45;0.647058823529412;18;33;0.147058823529412;0.352941176470588
Control.SRR15539829;44;45;0.295454545454545;31;13;0.204545454545455;0.295454545454545
Control.SRR15539829;44;45;0.5;22;22;0;0.5
Control.SRR15539829;46;45;0.369565217391304;29;17;0.130434782608696;0.369565217391304
Control.SRR15539829;42;45;0.380952380952381;26;16;0.119047619047619;0.380952380952381
Control.SRR15539829;44;45;0.522727272727273;21;23;0.0227272727272727;0.477272727272727
Control.SRR15539829;41;45;0.51219512195122;20;21;0.0121951219512195;0.48780487804878
Control.SRR15539829;45;45;0.422222222222222;26;19;0.0777777777777778;0.422222222222222
Control.SRR15539829;49;45;0.510204081632653;24;25;0.0102040816326531;0.489795918367347
Control.SRR15539829;48;45;0.520833333333333;23;25;0.0208333333333334;0.479166666666667
Control.SRR15539829;50;45;0.46;27;23;0.04;0.46
Control.SRR15539829;41;45;0.414634146341463;24;17;0.0853658536585366;0.414634146341463
Control.SRR15539829;42;45;0.619047619047619;16;26;0.119047619047619;0.380952380952381
Control.SRR15539829;46;45;0.521739130434783;22;24;0.0217391304347826;0.478260869565217
Control.SRR15539829;46;45;0.521739130434783;22;24;0.0217391304347826;0.478260869565217
Control.SRR15539829;50;45;0.6;20;30;0.1;0.4
Control.SRR15539829;47;45;0.51063829787234;23;24;0.0106382978723404;0.48936170212766
Control.SRR15539829;47;45;0.468085106382979;25;22;0.0319148936170213;0.468085106382979
Control.SRR15539829;48;45;0.583333333333333;20;28;0.0833333333333334;0.416666666666667
Control.SRR15539829;46;45;0.478260869565217;24;22;0.0217391304347826;0.478260869565217
Control.SRR15539829;49;45;0.36734693877551;31;18;0.13265306122449;0.36734693877551
Control.SRR15539829;51;45;0.470588235294118;27;24;0.0294117647058824;0.470588235294118
Control.SRR15539829;46;45;0.347826086956522;30;16;0.152173913043478;0.347826086956522
Control.SRR15539829;50;45;0.56;22;28;0.0600000000000001;0.44
Control.SRR15539829;43;45;0.581395348837209;18;25;0.0813953488372093;0.418604651162791
Control.SRR15539829;44;45;0.386363636363636;27;17;0.113636363636364;0.386363636363636
Control.SRR15539829;47;45;0.446808510638298;26;21;0.0531914893617021;0.446808510638298
Control.SRR15539829;48;45;0.479166666666667;25;23;0.0208333333333333;0.479166666666667
Control.SRR15539829;51;45;0.392156862745098;31;20;0.107843137254902;0.392156862745098
Control.SRR15539829;52;45;0.519230769230769;25;27;0.0192307692307693;0.480769230769231
Control.SRR15539829;45;45;0.577777777777778;19;26;0.0777777777777777;0.422222222222222
Control.SRR15539829;52;45;0.480769230769231;27;25;0.0192307692307692;0.480769230769231
Control.SRR15539829;44;45;0.386363636363636;27;17;0.113636363636364;0.386363636363636
Control.SRR15539829;41;45;0.560975609756098;18;23;0.0609756097560976;0.439024390243902
Control.SRR15539829;45;45;0.555555555555556;20;25;0.0555555555555556;0.444444444444444
Control.SRR15539829;46;45;0.434782608695652;26;20;0.0652173913043478;0.434782608695652
Control.SRR15539829;47;45;0.468085106382979;25;22;0.0319148936170213;0.468085106382979
Control.SRR15539829;43;45;0.418604651162791;25;18;0.0813953488372093;0.418604651162791
Control.SRR15539829;49;45;0.469387755102041;26;23;0.0306122448979592;0.469387755102041
Control.SRR15539829;48;45;0.583333333333333;20;28;0.0833333333333334;0.416666666666667
Control.SRR15539829;46;45;0.5;23;23;0;0.5
Control.SRR15539829;44;45;0.454545454545455;24;20;0.0454545454545455;0.454545454545455
Control.SRR15539829;44;45;0.636363636363636;16;28;0.136363636363636;0.363636363636364
Control.SRR15539829;47;45;0.382978723404255;29;18;0.117021276595745;0.382978723404255
Control.SRR15539829;42;45;0.404761904761905;25;17;0.0952380952380952;0.404761904761905
Control.SRR15539829;41;45;0.585365853658537;17;24;0.0853658536585366;0.414634146341463
Control.SRR15539829;48;45;0.520833333333333;23;25;0.0208333333333334;0.479166666666667
Control.SRR15539829;44;45;0.363636363636364;28;16;0.136363636363636;0.363636363636364
Control.SRR15539829;50;45;0.54;23;27;0.04;0.46
Control.SRR15539829;42;45;0.523809523809524;20;22;0.0238095238095238;0.476190476190476
Control.SRR15539829;45;45;0.511111111111111;22;23;0.0111111111111111;0.488888888888889
Control.SRR15539829;47;45;0.48936170212766;24;23;0.0106382978723404;0.48936170212766
Control.SRR15539829;46;45;0.326086956521739;31;15;0.173913043478261;0.326086956521739
Control.SRR15539829;49;45;0.387755102040816;30;19;0.112244897959184;0.387755102040816
Control.SRR15539829;47;45;0.48936170212766;24;23;0.0106382978723404;0.48936170212766
Control.SRR15539829;44;45;0.477272727272727;23;21;0.0227272727272727;0.477272727272727
Control.SRR15539829;46;45;0.608695652173913;18;28;0.108695652173913;0.391304347826087
Control.SRR15539829;51;45;0.568627450980392;22;29;0.0686274509803921;0.431372549019608
Control.SRR15539829;47;45;0.51063829787234;23;24;0.0106382978723404;0.48936170212766
Control.SRR15539829;47;45;0.51063829787234;23;24;0.0106382978723404;0.48936170212766
Control.SRR15539829;46;45;0.521739130434783;22;24;0.0217391304347826;0.478260869565217
Control.SRR15539829;41;45;0.48780487804878;21;20;0.0121951219512195;0.48780487804878
Control.SRR15539829;44;45;0.5;22;22;0;0.5
Control.SRR15539829;45;45;0.555555555555556;20;25;0.0555555555555556;0.444444444444444
Control.SRR15539829;47;45;0.531914893617021;22;25;0.0319148936170213;0.468085106382979
Control.SRR15539829;40;45;0.45;22;18;0.05;0.45
Control.SRR15539829;52;45;0.519230769230769;25;27;0.0192307692307693;0.480769230769231
Control.SRR15539829;40;45;0.425;23;17;0.075;0.425
Control.SRR15539829;46;45;0.521739130434783;22;24;0.0217391304347826;0.478260869565217
Control.SRR15539829;40;45;0.525;19;21;0.025;0.475
Control.SRR15539829;44;45;0.568181818181818;19;25;0.0681818181818182;0.431818181818182
Control.SRR15539829;52;45;0.576923076923077;22;30;0.0769230769230769;0.423076923076923
Control.SRR15539829;52;45;0.538461538461538;24;28;0.0384615384615384;0.461538461538462
Control.SRR15539829;50;45;0.46;27;23;0.04;0.46
Control.SRR15539829;46;45;0.521739130434783;22;24;0.0217391304347826;0.478260869565217
Control.SRR15539829;49;45;0.591836734693878;20;29;0.0918367346938775;0.408163265306122
Control.SRR15539829;40;45;0.55;18;22;0.05;0.45
Control.SRR15539829;42;45;0.452380952380952;23;19;0.0476190476190476;0.452380952380952
Control.SRR15539829;46;45;0.478260869565217;24;22;0.0217391304347826;0.478260869565217
Control.SRR15539829;47;45;0.382978723404255;29;18;0.117021276595745;0.382978723404255
Control.SRR15539829;45;45;0.355555555555556;29;16;0.144444444444444;0.355555555555556
Control.SRR15539829;41;45;0.439024390243902;23;18;0.0609756097560976;0.439024390243902
Control.SRR15539829;44;45;0.545454545454545;20;24;0.0454545454545454;0.454545454545455
Control.SRR15539829;52;45;0.5;26;26;0;0.5
Control.SRR15539829;42;45;0.547619047619048;19;23;0.0476190476190477;0.452380952380952
Control.SRR15539829;46;45;0.543478260869565;21;25;0.0434782608695652;0.456521739130435
Control.SRR15539829;47;45;0.48936170212766;24;23;0.0106382978723404;0.48936170212766
Control.SRR15539829;44;45;0.454545454545455;24;20;0.0454545454545455;0.454545454545455
Control.SRR15539829;40;45;0.525;19;21;0.025;0.475
Control.SRR15539829;46;45;0.521739130434783;22;24;0.0217391304347826;0.478260869565217
Control.SRR15539829;41;45;0.682926829268293;13;28;0.182926829268293;0.317073170731707
Control.SRR15539829;42;45;0.523809523809524;20;22;0.0238095238095238;0.476190476190476
Control.SRR15539829;43;45;0.604651162790698;17;26;0.104651162790698;0.395348837209302
Control.SRR15539829;42;45;0.619047619047619;16;26;0.119047619047619;0.380952380952381
Control.SRR15539829;48;45;0.5;24;24;0;0.5
Control.SRR15539829;45;45;0.644444444444444;16;29;0.144444444444444;0.355555555555556
Control.SRR15539829;41;45;0.609756097560976;16;25;0.109756097560976;0.390243902439024
Control.SRR15539829;42;45;0.714285714285714;12;30;0.214285714285714;0.285714285714286
Control.SRR15539829;45;45;0.577777777777778;19;26;0.0777777777777777;0.422222222222222
Control.SRR15539829;44;45;0.409090909090909;26;18;0.0909090909090909;0.409090909090909
Control.SRR15539829;50;45;0.48;26;24;0.02;0.48
Control.SRR15539829;52;45;0.596153846153846;21;31;0.0961538461538461;0.403846153846154
Control.SRR15539829;49;45;0.530612244897959;23;26;0.0306122448979592;0.469387755102041
Control.SRR15539829;46;45;0.478260869565217;24;22;0.0217391304347826;0.478260869565217
Control.SRR15539829;41;45;0.414634146341463;24;17;0.0853658536585366;0.414634146341463
Control.SRR15539829;51;45;0.529411764705882;24;27;0.0294117647058824;0.470588235294118
Control.SRR15539829;46;45;0.673913043478261;15;31;0.173913043478261;0.326086956521739
Control.SRR15539829;44;45;0.568181818181818;19;25;0.0681818181818182;0.431818181818182
Control.SRR15539829;44;45;0.522727272727273;21;23;0.0227272727272727;0.477272727272727
Control.SRR15539829;46;45;0.58695652173913;19;27;0.0869565217391305;0.41304347826087
Control.SRR15539829;51;45;0.450980392156863;28;23;0.0490196078431372;0.450980392156863
Control.SRR15539829;49;45;0.448979591836735;27;22;0.0510204081632653;0.448979591836735
Control.SRR15539829;49;45;0.510204081632653;24;25;0.0102040816326531;0.489795918367347
Control.SRR15539829;52;45;0.403846153846154;31;21;0.0961538461538461;0.403846153846154
Control.SRR15539829;49;45;0.448979591836735;27;22;0.0510204081632653;0.448979591836735
Control.SRR15539829;46;45;0.456521739130435;25;21;0.0434782608695652;0.456521739130435
Control.SRR15539829;40;45;0.4;24;16;0.1;0.4
Control.SRR15539829;42;45;0.404761904761905;25;17;0.0952380952380952;0.404761904761905
Control.SRR15539829;42;45;0.5;21;21;0;0.5
Control.SRR15539829;52;45;0.596153846153846;21;31;0.0961538461538461;0.403846153846154
Control.SRR15539829;42;45;0.5;21;21;0;0.5
Control.SRR15539829;50;45;0.4;30;20;0.1;0.4
Control.SRR15539829;47;45;0.446808510638298;26;21;0.0531914893617021;0.446808510638298
Control.SRR15539829;48;45;0.479166666666667;25;23;0.0208333333333333;0.479166666666667
Control.SRR15539829;45;45;0.488888888888889;23;22;0.0111111111111111;0.488888888888889
Control.SRR15539829;51;45;0.627450980392157;19;32;0.127450980392157;0.372549019607843
Control.SRR15539829;49;45;0.591836734693878;20;29;0.0918367346938775;0.408163265306122
Control.SRR15539829;46;45;0.565217391304348;20;26;0.0652173913043478;0.434782608695652
Control.SRR15539829;52;45;0.5;26;26;0;0.5
Control.SRR15539829;42;45;0.523809523809524;20;22;0.0238095238095238;0.476190476190476
Control.SRR15539829;44;45;0.568181818181818;19;25;0.0681818181818182;0.431818181818182
Control.SRR15539829;46;45;0.5;23;23;0;0.5
Control.SRR15539829;49;45;0.530612244897959;23;26;0.0306122448979592;0.469387755102041
Control.SRR15539829;40;45;0.425;23;17;0.075;0.425
Control.SRR15539829;44;45;0.522727272727273;21;23;0.0227272727272727;0.477272727272727
Control.SRR15539829;50;45;0.62;19;31;0.12;0.38
Control.SRR15539829;48;45;0.541666666666667;22;26;0.0416666666666666;0.458333333333333
Control.SRR15539829;41;45;0.317073170731707;28;13;0.182926829268293;0.317073170731707
Control.SRR15539829;40;45;0.45;22;18;0.05;0.45
Control.SRR15539829;50;45;0.42;29;21;0.08;0.42
Control.SRR15539829;47;45;0.48936170212766;24;23;0.0106382978723404;0.48936170212766
Control.SRR15539829;49;45;0.530612244897959;23;26;0.0306122448979592;0.469387755102041
Control.SRR15539829;51;45;0.450980392156863;28;23;0.0490196078431372;0.450980392156863
Control.SRR15539829;40;45;0.6;16;24;0.1;0.4
Control.SRR15539829;40;45;0.55;18;22;0.05;0.45
Control.SRR15539829;44;45;0.613636363636364;17;27;0.113636363636364;0.386363636363636
Control.SRR15539829;44;45;0.5;22;22;0;0.5
Control.SRR15539829;43;45;0.604651162790698;17;26;0.104651162790698;0.395348837209302
Control.SRR15539829;41;45;0.390243902439024;25;16;0.109756097560976;0.390243902439024
Control.SRR15539829;45;45;0.555555555555556;20;25;0.0555555555555556;0.444444444444444
Control.SRR15539829;49;45;0.510204081632653;24;25;0.0102040816326531;0.489795918367347
Control.SRR15539829;43;45;0.511627906976744;21;22;0.0116279069767442;0.488372093023256
Control.SRR15539829;52;45;0.480769230769231;27;25;0.0192307692307692;0.480769230769231
Control.SRR15539829;44;45;0.590909090909091;18;26;0.0909090909090909;0.409090909090909
Control.SRR15539829;46;45;0.521739130434783;22;24;0.0217391304347826;0.478260869565217
Control.SRR15539829;48;45;0.416666666666667;28;20;0.0833333333333333;0.416666666666667
Control.SRR15539829;46;45;0.434782608695652;26;20;0.0652173913043478;0.434782608695652
Control.SRR15539829;47;45;0.574468085106383;20;27;0.074468085106383;0.425531914893617
Control.SRR15539829;44;45;0.454545454545455;24;20;0.0454545454545455;0.454545454545455
Control.SRR15539829;43;45;0.604651162790698;17;26;0.104651162790698;0.395348837209302
Control.SRR15539829;46;45;0.434782608695652;26;20;0.0652173913043478;0.434782608695652
Control.SRR15539829;45;45;0.488888888888889;23;22;0.0111111111111111;0.488888888888889
Control.SRR15539829;52;45;0.480769230769231;27;25;0.0192307692307692;0.480769230769231
Control.SRR15539829;40;45;0.45;22;18;0.05;0.45
Control.SRR15539829;47;45;0.617021276595745;18;29;0.117021276595745;0.382978723404255
Control.SRR15539829;47;45;0.468085106382979;25;22;0.0319148936170213;0.468085106382979
Control.SRR15539829;49;45;0.428571428571429;28;21;0.0714285714285715;0.428571428571429
Control.SRR15539829;48;45;0.5625;21;27;0.0625;0.4375
Control.SRR15539829;49;45;0.530612244897959;23;26;0.0306122448979592;0.469387755102041
Control.SRR15539829;46;45;0.434782608695652;26;20;0.0652173913043478;0.434782608695652
Control.SRR15539829;47;45;0.382978723404255;29;18;0.117021276595745;0.382978723404255
Control.SRR15539829;42;45;0.595238095238095;17;25;0.0952380952380952;0.404761904761905
Control.SRR15539829;41;45;0.48780487804878;21;20;0.0121951219512195;0.48780487804878
Control.SRR15539829;41;45;0.365853658536585;26;15;0.134146341463415;0.365853658536585
Control.SRR15539829;50;45;0.54;23;27;0.04;0.46
Control.SRR15539829;51;45;0.450980392156863;28;23;0.0490196078431372;0.450980392156863
Control.SRR15539829;47;45;0.446808510638298;26;21;0.0531914893617021;0.446808510638298
Control.SRR15539829;47;45;0.531914893617021;22;25;0.0319148936170213;0.468085106382979
Control.SRR15539829;44;45;0.431818181818182;25;19;0.0681818181818182;0.431818181818182
Control.SRR15539829;50;45;0.54;23;27;0.04;0.46
Control.SRR15539829;50;45;0.42;29;21;0.08;0.42
Control.SRR15539829;44;45;0.477272727272727;23;21;0.0227272727272727;0.477272727272727
Control.SRR15539829;40;45;0.425;23;17;0.075;0.425
Control.SRR15539829;42;45;0.476190476190476;22;20;0.0238095238095238;0.476190476190476
Control.SRR15539829;47;45;0.297872340425532;33;14;0.202127659574468;0.297872340425532
Control.SRR15539829;45;45;0.488888888888889;23;22;0.0111111111111111;0.488888888888889
Control.SRR15539829;48;45;0.4375;27;21;0.0625;0.4375
Control.SRR15539829;40;45;0.6;16;24;0.1;0.4
Control.SRR15539829;40;45;0.55;18;22;0.05;0.45
Control.SRR15539829;42;45;0.428571428571429;24;18;0.0714285714285715;0.428571428571429
Control.SRR15539829;45;45;0.577777777777778;19;26;0.0777777777777777;0.422222222222222
Control.SRR15539829;45;45;0.444444444444444;25;20;0.0555555555555556;0.444444444444444
Control.SRR15539829;50;45;0.5;25;25;0;0.5
Control.SRR15539829;50;45;0.6;20;30;0.1;0.4
Control.SRR15539829;46;45;0.391304347826087;28;18;0.108695652173913;0.391304347826087
Control.SRR15539829;48;45;0.4375;27;21;0.0625;0.4375
Control.SRR15539829;50;45;0.56;22;28;0.0600000000000001;0.44
Control.SRR15539829;45;45;0.444444444444444;25;20;0.0555555555555556;0.444444444444444
Control.SRR15539829;44;45;0.431818181818182;25;19;0.0681818181818182;0.431818181818182
Control.SRR15539829;46;45;0.565217391304348;20;26;0.0652173913043478;0.434782608695652
Control.SRR15539829;48;45;0.541666666666667;22;26;0.0416666666666666;0.458333333333333
Control.SRR15539829;46;45;0.521739130434783;22;24;0.0217391304347826;0.478260869565217
Control.SRR15539829;48;45;0.5625;21;27;0.0625;0.4375
Control.SRR15539829;52;45;0.384615384615385;32;20;0.115384615384615;0.384615384615385
Control.SRR15539829;41;45;0.560975609756098;18;23;0.0609756097560976;0.439024390243902
Control.SRR15539829;48;45;0.541666666666667;22;26;0.0416666666666666;0.458333333333333
Control.SRR15539829;46;45;0.543478260869565;21;25;0.0434782608695652;0.456521739130435
Control.SRR15539829;48;45;0.416666666666667;28;20;0.0833333333333333;0.416666666666667
Control.SRR15539829;52;45;0.461538461538462;28;24;0.0384615384615384;0.461538461538462
Control.SRR15539829;46;45;0.369565217391304;29;17;0.130434782608696;0.369565217391304
Control.SRR15539829;50;45;0.5;25;25;0;0.5
Control.SRR15539829;41;45;0.51219512195122;20;21;0.0121951219512195;0.48780487804878
Control.SRR15539829;48;45;0.458333333333333;26;22;0.0416666666666667;0.458333333333333
Control.SRR15539829;40;45;0.6;16;24;0.1;0.4
Control.SRR15539829;45;45;0.533333333333333;21;24;0.0333333333333333;0.466666666666667
Control.SRR15539829;49;45;0.469387755102041;26;23;0.0306122448979592;0.469387755102041
Control.SRR15539829;47;45;0.48936170212766;24;23;0.0106382978723404;0.48936170212766
Control.SRR15539829;51;45;0.529411764705882;24;27;0.0294117647058824;0.470588235294118
Control.SRR15539829;46;45;0.521739130434783;22;24;0.0217391304347826;0.478260869565217
Control.SRR15539829;42;45;0.523809523809524;20;22;0.0238095238095238;0.476190476190476
Control.SRR15539829;40;45;0.475;21;19;0.025;0.475
Control.SRR15539829;47;45;0.531914893617021;22;25;0.0319148936170213;0.468085106382979
Control.SRR15539829;49;45;0.36734693877551;31;18;0.13265306122449;0.36734693877551
Control.SRR15539829;49;45;0.448979591836735;27;22;0.0510204081632653;0.448979591836735
Control.SRR15539829;48;45;0.520833333333333;23;25;0.0208333333333334;0.479166666666667
Control.SRR15539829;42;45;0.523809523809524;20;22;0.0238095238095238;0.476190476190476
Control.SRR15539829;41;45;0.463414634146341;22;19;0.0365853658536585;0.463414634146341
Control.SRR15539829;47;45;0.48936170212766;24;23;0.0106382978723404;0.48936170212766
Control.SRR15539829;40;45;0.65;14;26;0.15;0.35
Control.SRR15539829;42;45;0.452380952380952;23;19;0.0476190476190476;0.452380952380952
Control.SRR15539829;44;45;0.409090909090909;26;18;0.0909090909090909;0.409090909090909
Control.SRR15539829;47;45;0.425531914893617;27;20;0.074468085106383;0.425531914893617
Control.SRR15539829;47;45;0.531914893617021;22;25;0.0319148936170213;0.468085106382979
Control.SRR15539829;44;45;0.477272727272727;23;21;0.0227272727272727;0.477272727272727
Control.SRR15539829;45;45;0.488888888888889;23;22;0.0111111111111111;0.488888888888889
Control.SRR15539829;51;45;0.607843137254902;20;31;0.107843137254902;0.392156862745098
Control.SRR15539829;44;45;0.386363636363636;27;17;0.113636363636364;0.386363636363636
Control.SRR15539829;45;45;0.444444444444444;25;20;0.0555555555555556;0.444444444444444
Control.SRR15539829;44;45;0.431818181818182;25;19;0.0681818181818182;0.431818181818182
Control.SRR15539829;48;45;0.520833333333333;23;25;0.0208333333333334;0.479166666666667
Control.SRR15539829;51;45;0.450980392156863;28;23;0.0490196078431372;0.450980392156863
Control.SRR15539829;44;45;0.454545454545455;24;20;0.0454545454545455;0.454545454545455
Control.SRR15539829;50;45;0.58;21;29;0.08;0.42
Control.SRR15539829;47;45;0.595744680851064;19;28;0.0957446808510638;0.404255319148936
Control.SRR15539829;49;45;0.489795918367347;25;24;0.0102040816326531;0.489795918367347
Control.SRR15539829;40;45;0.6;16;24;0.1;0.4
Control.SRR15539829;43;45;0.348837209302326;28;15;0.151162790697674;0.348837209302326
Control.SRR15539829;43;45;0.511627906976744;21;22;0.0116279069767442;0.488372093023256
Control.SRR15539829;51;45;0.392156862745098;31;20;0.107843137254902;0.392156862745098
Control.SRR15539829;41;45;0.585365853658537;17;24;0.0853658536585366;0.414634146341463
Control.SRR15539829;47;45;0.51063829787234;23;24;0.0106382978723404;0.48936170212766
Control.SRR15539829;45;45;0.4;27;18;0.1;0.4
Control.SRR15539829;46;45;0.326086956521739;31;15;0.173913043478261;0.326086956521739
Control.SRR15539829;45;45;0.466666666666667;24;21;0.0333333333333333;0.466666666666667
Control.SRR15539829;45;45;0.533333333333333;21;24;0.0333333333333333;0.466666666666667
Control.SRR15539829;47;45;0.553191489361702;21;26;0.0531914893617021;0.446808510638298
Control.SRR15539829;46;45;0.369565217391304;29;17;0.130434782608696;0.369565217391304
Control.SRR15539829;44;45;0.545454545454545;20;24;0.0454545454545454;0.454545454545455
Control.SRR15539829;43;45;0.534883720930233;20;23;0.0348837209302325;0.465116279069767
Control.SRR15539829;48;45;0.541666666666667;22;26;0.0416666666666666;0.458333333333333
Control.SRR15539829;52;45;0.519230769230769;25;27;0.0192307692307693;0.480769230769231
Control.SRR15539829;45;45;0.533333333333333;21;24;0.0333333333333333;0.466666666666667
Control.SRR15539829;51;45;0.470588235294118;27;24;0.0294117647058824;0.470588235294118
Control.SRR15539829;51;45;0.549019607843137;23;28;0.0490196078431373;0.450980392156863
Control.SRR15539829;44;45;0.340909090909091;29;15;0.159090909090909;0.340909090909091
Control.SRR15539829;50;45;0.64;18;32;0.14;0.36
Control.SRR15539829;52;45;0.615384615384615;20;32;0.115384615384615;0.384615384615385
Control.SRR15539829;44;45;0.568181818181818;19;25;0.0681818181818182;0.431818181818182
Control.SRR15539829;47;45;0.382978723404255;29;18;0.117021276595745;0.382978723404255
Control.SRR15539829;48;45;0.479166666666667;25;23;0.0208333333333333;0.479166666666667
Control.SRR15539829;43;45;0.465116279069767;23;20;0.0348837209302326;0.465116279069767
Control.SRR15539829;46;45;0.5;23;23;0;0.5
Control.SRR15539829;40;45;0.625;15;25;0.125;0.375
Control.SRR15539829;48;45;0.395833333333333;29;19;0.104166666666667;0.395833333333333
Control.SRR15539829;44;45;0.5;22;22;0;0.5
Control.SRR15539829;46;45;0.5;23;23;0;0.5
Control.SRR15539829;43;45;0.348837209302326;28;15;0.151162790697674;0.348837209302326
Control.SRR15539829;42;45;0.642857142857143;15;27;0.142857142857143;0.357142857142857
Control.SRR15539829;51;45;0.490196078431373;26;25;0.00980392156862747;0.490196078431373
Control.SRR15539829;40;45;0.6;16;24;0.1;0.4
Control.SRR15539829;43;45;0.511627906976744;21;22;0.0116279069767442;0.488372093023256
Control.SRR15539829;41;45;0.585365853658537;17;24;0.0853658536585366;0.414634146341463
Control.SRR15539829;41;45;0.585365853658537;17;24;0.0853658536585366;0.414634146341463
Control.SRR15539829;45;45;0.533333333333333;21;24;0.0333333333333333;0.466666666666667
Control.SRR15539829;50;45;0.56;22;28;0.0600000000000001;0.44
Control.SRR15539829;51;45;0.490196078431373;26;25;0.00980392156862747;0.490196078431373
Control.SRR15539829;48;45;0.333333333333333;32;16;0.166666666666667;0.333333333333333
Control.SRR15539829;40;45;0.525;19;21;0.025;0.475
Control.SRR15539829;52;45;0.480769230769231;27;25;0.0192307692307692;0.480769230769231
Control.SRR15539829;51;45;0.549019607843137;23;28;0.0490196078431373;0.450980392156863
Control.SRR15539829;52;45;0.519230769230769;25;27;0.0192307692307693;0.480769230769231
Control.SRR15539829;43;45;0.511627906976744;21;22;0.0116279069767442;0.488372093023256
Control.SRR15539829;48;45;0.4375;27;21;0.0625;0.4375
Control.SRR15539829;48;45;0.479166666666667;25;23;0.0208333333333333;0.479166666666667
Control.SRR15539829;45;45;0.511111111111111;22;23;0.0111111111111111;0.488888888888889
Control.SRR15539829;46;45;0.41304347826087;27;19;0.0869565217391304;0.41304347826087
Control.SRR15539829;44;45;0.454545454545455;24;20;0.0454545454545455;0.454545454545455
Control.SRR15539829;43;45;0.465116279069767;23;20;0.0348837209302326;0.465116279069767
Control.SRR15539829;49;45;0.489795918367347;25;24;0.0102040816326531;0.489795918367347
Control.SRR15539829;45;45;0.6;18;27;0.1;0.4
Control.SRR15539829;45;45;0.511111111111111;22;23;0.0111111111111111;0.488888888888889
Control.SRR15539829;47;45;0.25531914893617;35;12;0.24468085106383;0.25531914893617
Control.SRR15539829;41;45;0.439024390243902;23;18;0.0609756097560976;0.439024390243902
Control.SRR15539829;51;45;0.392156862745098;31;20;0.107843137254902;0.392156862745098
Control.SRR15539829;48;45;0.3125;33;15;0.1875;0.3125
Control.SRR15539829;51;45;0.549019607843137;23;28;0.0490196078431373;0.450980392156863
Control.SRR15539829;52;45;0.576923076923077;22;30;0.0769230769230769;0.423076923076923
Control.SRR15539829;51;45;0.411764705882353;30;21;0.0882352941176471;0.411764705882353
Control.SRR15539829;49;45;0.510204081632653;24;25;0.0102040816326531;0.489795918367347
Control.SRR15539829;44;45;0.522727272727273;21;23;0.0227272727272727;0.477272727272727
Control.SRR15539829;40;45;0.625;15;25;0.125;0.375
Control.SRR15539829;40;45;0.525;19;21;0.025;0.475
Control.SRR15539829;49;45;0.571428571428571;21;28;0.0714285714285714;0.428571428571429
Control.SRR15539829;51;45;0.509803921568627;25;26;0.00980392156862742;0.490196078431373
Control.SRR15539829;45;45;0.6;18;27;0.1;0.4
Control.SRR15539829;44;45;0.409090909090909;26;18;0.0909090909090909;0.409090909090909
Control.SRR15539829;51;45;0.529411764705882;24;27;0.0294117647058824;0.470588235294118
Control.SRR15539829;48;45;0.520833333333333;23;25;0.0208333333333334;0.479166666666667
Control.SRR15539829;46;45;0.58695652173913;19;27;0.0869565217391305;0.41304347826087
Control.SRR15539829;43;45;0.441860465116279;24;19;0.0581395348837209;0.441860465116279
Control.SRR15539829;41;45;0.439024390243902;23;18;0.0609756097560976;0.439024390243902
Control.SRR15539829;48;45;0.625;18;30;0.125;0.375
Control.SRR15539829;52;45;0.538461538461538;24;28;0.0384615384615384;0.461538461538462
Control.SRR15539829;48;45;0.5;24;24;0;0.5
Control.SRR15539829;44;45;0.386363636363636;27;17;0.113636363636364;0.386363636363636
Control.SRR15539829;48;45;0.479166666666667;25;23;0.0208333333333333;0.479166666666667
Control.SRR15539829;45;45;0.466666666666667;24;21;0.0333333333333333;0.466666666666667
Control.SRR15539829;45;45;0.422222222222222;26;19;0.0777777777777778;0.422222222222222
Control.SRR15539829;40;45;0.525;19;21;0.025;0.475
Control.SRR15539829;41;45;0.414634146341463;24;17;0.0853658536585366;0.414634146341463
Control.SRR15539829;44;45;0.590909090909091;18;26;0.0909090909090909;0.409090909090909
Control.SRR15539829;43;45;0.558139534883721;19;24;0.0581395348837209;0.441860465116279
Control.SRR15539829;49;45;0.408163265306122;29;20;0.0918367346938775;0.408163265306122
Control.SRR15539829;48;45;0.375;30;18;0.125;0.375
Control.SRR15539829;45;45;0.488888888888889;23;22;0.0111111111111111;0.488888888888889
Control.SRR15539829;45;45;0.555555555555556;20;25;0.0555555555555556;0.444444444444444
Control.SRR15539829;43;45;0.465116279069767;23;20;0.0348837209302326;0.465116279069767
Control.SRR15539829;44;45;0.590909090909091;18;26;0.0909090909090909;0.409090909090909
Control.SRR15539829;49;45;0.469387755102041;26;23;0.0306122448979592;0.469387755102041
Control.SRR15539829;50;45;0.58;21;29;0.08;0.42
Control.SRR15539829;51;45;0.431372549019608;29;22;0.0686274509803921;0.431372549019608
Control.SRR15539829;49;45;0.63265306122449;18;31;0.13265306122449;0.36734693877551
Control.SRR15539829;51;45;0.450980392156863;28;23;0.0490196078431372;0.450980392156863
Control.SRR15539829;51;45;0.529411764705882;24;27;0.0294117647058824;0.470588235294118
Control.SRR15539829;44;45;0.431818181818182;25;19;0.0681818181818182;0.431818181818182
Control.SRR15539829;40;45;0.6;16;24;0.1;0.4
Control.SRR15539829;41;45;0.560975609756098;18;23;0.0609756097560976;0.439024390243902
Control.SRR15539829;45;45;0.577777777777778;19;26;0.0777777777777777;0.422222222222222
Control.SRR15539829;49;45;0.530612244897959;23;26;0.0306122448979592;0.469387755102041
Control.SRR15539829;44;45;0.5;22;22;0;0.5
Control.SRR15539829;40;45;0.525;19;21;0.025;0.475
Control.SRR15539829;40;45;0.5;20;20;0;0.5
Control.SRR15539829;51;45;0.392156862745098;31;20;0.107843137254902;0.392156862745098
Control.SRR15539829;52;45;0.442307692307692;29;23;0.0576923076923077;0.442307692307692
Control.SRR15539829;52;45;0.480769230769231;27;25;0.0192307692307692;0.480769230769231
Control.SRR15539829;51;45;0.509803921568627;25;26;0.00980392156862742;0.490196078431373
Control.SRR15539829;49;45;0.469387755102041;26;23;0.0306122448979592;0.469387755102041
Control.SRR15539829;45;45;0.4;27;18;0.1;0.4
Control.SRR15539829;49;45;0.612244897959184;19;30;0.112244897959184;0.387755102040816
Control.SRR15539829;48;45;0.604166666666667;19;29;0.104166666666667;0.395833333333333
Control.SRR15539829;45;45;0.4;27;18;0.1;0.4
Control.SRR15539829;50;45;0.52;24;26;0.02;0.48
Control.SRR15539829;48;45;0.5625;21;27;0.0625;0.4375
Control.SRR15539829;52;45;0.480769230769231;27;25;0.0192307692307692;0.480769230769231
Control.SRR15539829;41;45;0.609756097560976;16;25;0.109756097560976;0.390243902439024
Control.SRR15539829;40;45;0.325;27;13;0.175;0.325
Control.SRR15539829;49;45;0.530612244897959;23;26;0.0306122448979592;0.469387755102041
Control.SRR15539829;43;45;0.534883720930233;20;23;0.0348837209302325;0.465116279069767
Control.SRR15539829;46;45;0.521739130434783;22;24;0.0217391304347826;0.478260869565217
Control.SRR15539829;47;45;0.48936170212766;24;23;0.0106382978723404;0.48936170212766
Control.SRR15539829;45;45;0.511111111111111;22;23;0.0111111111111111;0.488888888888889
Control.SRR15539829;45;45;0.511111111111111;22;23;0.0111111111111111;0.488888888888889
Control.SRR15539829;41;45;0.365853658536585;26;15;0.134146341463415;0.365853658536585
Control.SRR15539829;41;45;0.48780487804878;21;20;0.0121951219512195;0.48780487804878
Control.SRR15539829;45;45;0.511111111111111;22;23;0.0111111111111111;0.488888888888889
Control.SRR15539829;47;45;0.531914893617021;22;25;0.0319148936170213;0.468085106382979
Control.SRR15539829;51;45;0.450980392156863;28;23;0.0490196078431372;0.450980392156863
Control.SRR15539829;52;45;0.480769230769231;27;25;0.0192307692307692;0.480769230769231
Control.SRR15539829;40;45;0.5;20;20;0;0.5
Control.SRR15539829;49;45;0.510204081632653;24;25;0.0102040816326531;0.489795918367347
Control.SRR15539829;50;45;0.6;20;30;0.1;0.4
Control.SRR15539829;45;45;0.466666666666667;24;21;0.0333333333333333;0.466666666666667
Control.SRR15539829;48;45;0.416666666666667;28;20;0.0833333333333333;0.416666666666667
Control.SRR15539829;48;45;0.479166666666667;25;23;0.0208333333333333;0.479166666666667
Control.SRR15539829;43;45;0.441860465116279;24;19;0.0581395348837209;0.441860465116279
Control.SRR15539829;45;45;0.533333333333333;21;24;0.0333333333333333;0.466666666666667
Control.SRR15539829;41;45;0.48780487804878;21;20;0.0121951219512195;0.48780487804878
Control.SRR15539829;44;45;0.409090909090909;26;18;0.0909090909090909;0.409090909090909
Control.SRR15539829;41;45;0.48780487804878;21;20;0.0121951219512195;0.48780487804878
Control.SRR15539829;41;45;0.365853658536585;26;15;0.134146341463415;0.365853658536585
Control.SRR15539829;44;45;0.477272727272727;23;21;0.0227272727272727;0.477272727272727
Control.SRR15539829;47;45;0.468085106382979;25;22;0.0319148936170213;0.468085106382979
Control.SRR15539829;43;45;0.441860465116279;24;19;0.0581395348837209;0.441860465116279
Control.SRR15539829;51;45;0.470588235294118;27;24;0.0294117647058824;0.470588235294118
Control.SRR15539829;43;45;0.488372093023256;22;21;0.0116279069767442;0.488372093023256
Control.SRR15539829;47;45;0.574468085106383;20;27;0.074468085106383;0.425531914893617
Control.SRR15539829;50;45;0.54;23;27;0.04;0.46
Control.SRR15539829;51;45;0.529411764705882;24;27;0.0294117647058824;0.470588235294118
Control.SRR15539829;52;45;0.442307692307692;29;23;0.0576923076923077;0.442307692307692
Control.SRR15539829;42;45;0.642857142857143;15;27;0.142857142857143;0.357142857142857
Control.SRR15539829;47;45;0.638297872340426;17;30;0.138297872340426;0.361702127659574
Control.SRR15539829;50;45;0.54;23;27;0.04;0.46
Control.SRR15539829;45;45;0.666666666666667;15;30;0.166666666666667;0.333333333333333
Control.SRR15539829;43;45;0.441860465116279;24;19;0.0581395348837209;0.441860465116279
Control.SRR15539829;51;45;0.450980392156863;28;23;0.0490196078431372;0.450980392156863
Control.SRR15539829;43;45;0.627906976744186;16;27;0.127906976744186;0.372093023255814
Control.SRR15539829;45;45;0.533333333333333;21;24;0.0333333333333333;0.466666666666667
Control.SRR15539829;42;45;0.523809523809524;20;22;0.0238095238095238;0.476190476190476
Control.SRR15539829;48;45;0.395833333333333;29;19;0.104166666666667;0.395833333333333
Control.SRR15539829;47;45;0.48936170212766;24;23;0.0106382978723404;0.48936170212766
Control.SRR15539829;41;45;0.609756097560976;16;25;0.109756097560976;0.390243902439024
Control.SRR15539829;50;45;0.44;28;22;0.06;0.44
Control.SRR15539829;44;45;0.590909090909091;18;26;0.0909090909090909;0.409090909090909
Control.SRR15539829;42;45;0.476190476190476;22;20;0.0238095238095238;0.476190476190476
Control.SRR15539829;46;45;0.5;23;23;0;0.5
Control.SRR15539829;50;45;0.5;25;25;0;0.5
Control.SRR15539829;50;45;0.5;25;25;0;0.5
Control.SRR15539829;41;45;0.414634146341463;24;17;0.0853658536585366;0.414634146341463
Control.SRR15539829;48;45;0.479166666666667;25;23;0.0208333333333333;0.479166666666667
Control.SRR15539829;42;45;0.476190476190476;22;20;0.0238095238095238;0.476190476190476
Control.SRR15539829;44;45;0.5;22;22;0;0.5
Control.SRR15539829;44;45;0.454545454545455;24;20;0.0454545454545455;0.454545454545455
Control.SRR15539829;44;45;0.522727272727273;21;23;0.0227272727272727;0.477272727272727
Control.SRR15539829;43;45;0.581395348837209;18;25;0.0813953488372093;0.418604651162791
Control.SRR15539829;52;45;0.5;26;26;0;0.5
Control.SRR15539829;44;45;0.477272727272727;23;21;0.0227272727272727;0.477272727272727
Control.SRR15539829;46;45;0.456521739130435;25;21;0.0434782608695652;0.456521739130435
Control.SRR15539829;44;45;0.545454545454545;20;24;0.0454545454545454;0.454545454545455
Control.SRR15539829;45;45;0.4;27;18;0.1;0.4
Control.SRR15539829;43;45;0.441860465116279;24;19;0.0581395348837209;0.441860465116279
Control.SRR15539829;42;45;0.571428571428571;18;24;0.0714285714285714;0.428571428571429
Control.SRR15539829;40;45;0.475;21;19;0.025;0.475
Control.SRR15539829;40;45;0.6;16;24;0.1;0.4
Control.SRR15539829;44;45;0.636363636363636;16;28;0.136363636363636;0.363636363636364
Control.SRR15539829;47;45;0.425531914893617;27;20;0.074468085106383;0.425531914893617
Control.SRR15539829;41;45;0.585365853658537;17;24;0.0853658536585366;0.414634146341463
Control.SRR15539829;49;45;0.387755102040816;30;19;0.112244897959184;0.387755102040816
Control.SRR15539829;48;45;0.395833333333333;29;19;0.104166666666667;0.395833333333333
Control.SRR15539829;49;45;0.448979591836735;27;22;0.0510204081632653;0.448979591836735
Control.SRR15539829;49;45;0.408163265306122;29;20;0.0918367346938775;0.408163265306122
Control.SRR15539829;47;45;0.468085106382979;25;22;0.0319148936170213;0.468085106382979
Control.SRR15539829;46;45;0.608695652173913;18;28;0.108695652173913;0.391304347826087
Control.SRR15539829;49;45;0.489795918367347;25;24;0.0102040816326531;0.489795918367347
Control.SRR15539829;40;45;0.6;16;24;0.1;0.4
Control.SRR15539829;48;45;0.5625;21;27;0.0625;0.4375
Control.SRR15539829;49;45;0.530612244897959;23;26;0.0306122448979592;0.469387755102041
Control.SRR15539829;41;45;0.51219512195122;20;21;0.0121951219512195;0.48780487804878
Control.SRR15539829;45;45;0.444444444444444;25;20;0.0555555555555556;0.444444444444444
Control.SRR15539829;45;45;0.4;27;18;0.1;0.4
Control.SRR15539829;52;45;0.519230769230769;25;27;0.0192307692307693;0.480769230769231
Control.SRR15539829;44;45;0.545454545454545;20;24;0.0454545454545454;0.454545454545455
Control.SRR15539829;51;45;0.470588235294118;27;24;0.0294117647058824;0.470588235294118
Control.SRR15539829;50;45;0.44;28;22;0.06;0.44
Control.SRR15539829;48;45;0.4375;27;21;0.0625;0.4375
Control.SRR15539829;48;45;0.520833333333333;23;25;0.0208333333333334;0.479166666666667
Control.SRR15539829;52;45;0.403846153846154;31;21;0.0961538461538461;0.403846153846154
Control.SRR15539829;41;45;0.658536585365854;14;27;0.158536585365854;0.341463414634146
Control.SRR15539829;50;45;0.6;20;30;0.1;0.4
Control.SRR15539829;44;45;0.318181818181818;30;14;0.181818181818182;0.318181818181818
Control.SRR15539829;41;45;0.609756097560976;16;25;0.109756097560976;0.390243902439024
Control.SRR15539829;42;45;0.476190476190476;22;20;0.0238095238095238;0.476190476190476
Control.SRR15539829;42;45;0.5;21;21;0;0.5
Control.SRR15539829;46;45;0.478260869565217;24;22;0.0217391304347826;0.478260869565217
Control.SRR15539829;44;45;0.545454545454545;20;24;0.0454545454545454;0.454545454545455
Control.SRR15539829;51;45;0.450980392156863;28;23;0.0490196078431372;0.450980392156863
Control.SRR15539829;47;45;0.48936170212766;24;23;0.0106382978723404;0.48936170212766
Control.SRR15539829;46;45;0.543478260869565;21;25;0.0434782608695652;0.456521739130435
Control.SRR15539829;41;45;0.463414634146341;22;19;0.0365853658536585;0.463414634146341
Control.SRR15539829;51;45;0.549019607843137;23;28;0.0490196078431373;0.450980392156863
Control.SRR15539829;44;45;0.545454545454545;20;24;0.0454545454545454;0.454545454545455
Control.SRR15539829;49;45;0.469387755102041;26;23;0.0306122448979592;0.469387755102041
Control.SRR15539829;42;45;0.404761904761905;25;17;0.0952380952380952;0.404761904761905
Control.SRR15539829;44;45;0.477272727272727;23;21;0.0227272727272727;0.477272727272727
Control.SRR15539829;52;45;0.480769230769231;27;25;0.0192307692307692;0.480769230769231
Control.SRR15539829;46;45;0.652173913043478;16;30;0.152173913043478;0.347826086956522
Control.SRR15539829;50;45;0.44;28;22;0.06;0.44
Control.SRR15539829;52;45;0.461538461538462;28;24;0.0384615384615384;0.461538461538462
Control.SRR15539829;52;45;0.615384615384615;20;32;0.115384615384615;0.384615384615385
Control.SRR15539829;52;45;0.365384615384615;33;19;0.134615384615385;0.365384615384615
Control.SRR15539829;51;45;0.549019607843137;23;28;0.0490196078431373;0.450980392156863
Control.SRR15539829;42;45;0.452380952380952;23;19;0.0476190476190476;0.452380952380952
Control.SRR15539829;44;45;0.477272727272727;23;21;0.0227272727272727;0.477272727272727
Control.SRR15539829;42;45;0.428571428571429;24;18;0.0714285714285715;0.428571428571429
Control.SRR15539829;40;45;0.5;20;20;0;0.5
Control.SRR15539829;49;45;0.571428571428571;21;28;0.0714285714285714;0.428571428571429
Control.SRR15539829;50;45;0.54;23;27;0.04;0.46
Control.SRR15539829;43;45;0.511627906976744;21;22;0.0116279069767442;0.488372093023256
Control.SRR15539829;50;45;0.46;27;23;0.04;0.46
Control.SRR15539829;46;45;0.5;23;23;0;0.5
Control.SRR15539829;44;45;0.5;22;22;0;0.5
Control.SRR15539829;44;45;0.5;22;22;0;0.5
Control.SRR15539829;50;45;0.34;33;17;0.16;0.34
Control.SRR15539829;43;45;0.441860465116279;24;19;0.0581395348837209;0.441860465116279
Control.SRR15539829;45;45;0.4;27;18;0.1;0.4
Control.SRR15539829;40;45;0.6;16;24;0.1;0.4
Control.SRR15539829;41;45;0.585365853658537;17;24;0.0853658536585366;0.414634146341463
Control.SRR15539829;47;45;0.425531914893617;27;20;0.074468085106383;0.425531914893617
Control.SRR15539829;46;45;0.434782608695652;26;20;0.0652173913043478;0.434782608695652
Control.SRR15539829;40;45;0.575;17;23;0.075;0.425
Control.SRR15539829;48;45;0.645833333333333;17;31;0.145833333333333;0.354166666666667
Control.SRR15539829;48;45;0.5;24;24;0;0.5
Control.SRR15539829;48;45;0.479166666666667;25;23;0.0208333333333333;0.479166666666667
Control.SRR15539829;48;45;0.479166666666667;25;23;0.0208333333333333;0.479166666666667
Control.SRR15539829;46;45;0.5;23;23;0;0.5
Control.SRR15539829;40;45;0.525;19;21;0.025;0.475
Control.SRR15539829;40;45;0.5;20;20;0;0.5
Control.SRR15539829;42;45;0.595238095238095;17;25;0.0952380952380952;0.404761904761905
Control.SRR15539829;48;45;0.479166666666667;25;23;0.0208333333333333;0.479166666666667
Control.SRR15539829;43;45;0.441860465116279;24;19;0.0581395348837209;0.441860465116279
Control.SRR15539829;47;45;0.468085106382979;25;22;0.0319148936170213;0.468085106382979
Control.SRR15539829;45;45;0.555555555555556;20;25;0.0555555555555556;0.444444444444444
Control.SRR15539829;43;45;0.558139534883721;19;24;0.0581395348837209;0.441860465116279
Control.SRR15539829;49;45;0.469387755102041;26;23;0.0306122448979592;0.469387755102041
Control.SRR15539829;48;45;0.416666666666667;28;20;0.0833333333333333;0.416666666666667
Control.SRR15539829;48;45;0.375;30;18;0.125;0.375
Control.SRR15539829;45;45;0.444444444444444;25;20;0.0555555555555556;0.444444444444444
Control.SRR15539829;40;45;0.4;24;16;0.1;0.4
Control.SRR15539829;51;45;0.333333333333333;34;17;0.166666666666667;0.333333333333333
Control.SRR15539829;49;45;0.591836734693878;20;29;0.0918367346938775;0.408163265306122
Control.SRR15539829;48;45;0.5625;21;27;0.0625;0.4375
Control.SRR15539829;48;45;0.583333333333333;20;28;0.0833333333333334;0.416666666666667
Control.SRR15539829;48;45;0.4375;27;21;0.0625;0.4375
Control.SRR15539829;45;45;0.555555555555556;20;25;0.0555555555555556;0.444444444444444
Control.SRR15539829;52;45;0.442307692307692;29;23;0.0576923076923077;0.442307692307692
Control.SRR15539829;40;45;0.6;16;24;0.1;0.4
Control.SRR15539829;44;45;0.522727272727273;21;23;0.0227272727272727;0.477272727272727
Control.SRR15539829;42;45;0.476190476190476;22;20;0.0238095238095238;0.476190476190476
Control.SRR15539829;41;45;0.634146341463415;15;26;0.134146341463415;0.365853658536585
Control.SRR15539829;41;45;0.439024390243902;23;18;0.0609756097560976;0.439024390243902
Control.SRR15539829;43;45;0.465116279069767;23;20;0.0348837209302326;0.465116279069767
Control.SRR15539829;46;45;0.478260869565217;24;22;0.0217391304347826;0.478260869565217
Control.SRR15539829;50;45;0.64;18;32;0.14;0.36
Control.SRR15539829;40;45;0.375;25;15;0.125;0.375
Control.SRR15539829;40;45;0.4;24;16;0.1;0.4
Control.SRR15539829;43;45;0.674418604651163;14;29;0.174418604651163;0.325581395348837
Control.SRR15539829;48;45;0.5625;21;27;0.0625;0.4375
Control.SRR15539829;41;45;0.365853658536585;26;15;0.134146341463415;0.365853658536585
Control.SRR15539829;50;45;0.6;20;30;0.1;0.4
Control.SRR15539829;50;45;0.46;27;23;0.04;0.46
Control.SRR15539829;51;45;0.509803921568627;25;26;0.00980392156862742;0.490196078431373
Control.SRR15539829;44;45;0.522727272727273;21;23;0.0227272727272727;0.477272727272727
Control.SRR15539829;43;45;0.372093023255814;27;16;0.127906976744186;0.372093023255814
Control.SRR15539829;42;45;0.404761904761905;25;17;0.0952380952380952;0.404761904761905
Control.SRR15539829;42;45;0.523809523809524;20;22;0.0238095238095238;0.476190476190476
Control.SRR15539829;45;45;0.577777777777778;19;26;0.0777777777777777;0.422222222222222
Control.SRR15539829;45;45;0.422222222222222;26;19;0.0777777777777778;0.422222222222222
Control.SRR15539829;40;45;0.525;19;21;0.025;0.475
Control.SRR15539829;48;45;0.375;30;18;0.125;0.375
Control.SRR15539829;48;45;0.5;24;24;0;0.5
Control.SRR15539829;49;45;0.408163265306122;29;20;0.0918367346938775;0.408163265306122
Control.SRR15539829;49;45;0.530612244897959;23;26;0.0306122448979592;0.469387755102041
Control.SRR15539829;47;45;0.446808510638298;26;21;0.0531914893617021;0.446808510638298
Control.SRR15539829;50;45;0.46;27;23;0.04;0.46
Control.SRR15539829;40;45;0.55;18;22;0.05;0.45
Control.SRR15539829;50;45;0.44;28;22;0.06;0.44
Control.SRR15539829;48;45;0.5;24;24;0;0.5
Control.SRR15539829;45;45;0.577777777777778;19;26;0.0777777777777777;0.422222222222222
Control.SRR15539829;48;45;0.479166666666667;25;23;0.0208333333333333;0.479166666666667
Control.SRR15539829;50;45;0.58;21;29;0.08;0.42
Control.SRR15539829;41;45;0.658536585365854;14;27;0.158536585365854;0.341463414634146
Control.SRR15539829;48;45;0.4375;27;21;0.0625;0.4375
Control.SRR15539829;43;45;0.465116279069767;23;20;0.0348837209302326;0.465116279069767
Control.SRR15539829;51;45;0.509803921568627;25;26;0.00980392156862742;0.490196078431373
Control.SRR15539829;44;45;0.522727272727273;21;23;0.0227272727272727;0.477272727272727
Control.SRR15539829;52;45;0.538461538461538;24;28;0.0384615384615384;0.461538461538462
Control.SRR15539829;40;45;0.4;24;16;0.1;0.4
Control.SRR15539829;43;45;0.558139534883721;19;24;0.0581395348837209;0.441860465116279
Control.SRR15539829;42;45;0.523809523809524;20;22;0.0238095238095238;0.476190476190476
Control.SRR15539829;48;45;0.541666666666667;22;26;0.0416666666666666;0.458333333333333
Control.SRR15539829;43;45;0.581395348837209;18;25;0.0813953488372093;0.418604651162791
Control.SRR15539829;43;45;0.441860465116279;24;19;0.0581395348837209;0.441860465116279
Control.SRR15539829;45;45;0.511111111111111;22;23;0.0111111111111111;0.488888888888889
Control.SRR15539829;42;45;0.452380952380952;23;19;0.0476190476190476;0.452380952380952
Control.SRR15539829;45;45;0.555555555555556;20;25;0.0555555555555556;0.444444444444444
Control.SRR15539829;46;45;0.456521739130435;25;21;0.0434782608695652;0.456521739130435
Control.SRR15539829;52;45;0.480769230769231;27;25;0.0192307692307692;0.480769230769231
Control.SRR15539829;42;45;0.452380952380952;23;19;0.0476190476190476;0.452380952380952
Control.SRR15539829;43;45;0.372093023255814;27;16;0.127906976744186;0.372093023255814
Control.SRR15539829;47;45;0.48936170212766;24;23;0.0106382978723404;0.48936170212766
Control.SRR15539829;48;45;0.354166666666667;31;17;0.145833333333333;0.354166666666667
Control.SRR15539829;52;45;0.461538461538462;28;24;0.0384615384615384;0.461538461538462
Control.SRR15539829;47;45;0.468085106382979;25;22;0.0319148936170213;0.468085106382979
Control.SRR15539829;49;45;0.510204081632653;24;25;0.0102040816326531;0.489795918367347
Control.SRR15539829;45;45;0.6;18;27;0.1;0.4
Control.SRR15539829;44;45;0.477272727272727;23;21;0.0227272727272727;0.477272727272727
Control.SRR15539829;49;45;0.428571428571429;28;21;0.0714285714285715;0.428571428571429
Control.SRR15539829;44;45;0.522727272727273;21;23;0.0227272727272727;0.477272727272727
Control.SRR15539829;51;45;0.607843137254902;20;31;0.107843137254902;0.392156862745098
Control.SRR15539829;49;45;0.63265306122449;18;31;0.13265306122449;0.36734693877551
Control.SRR15539829;52;45;0.423076923076923;30;22;0.0769230769230769;0.423076923076923
Control.SRR15539829;41;45;0.560975609756098;18;23;0.0609756097560976;0.439024390243902
Control.SRR15539829;49;45;0.612244897959184;19;30;0.112244897959184;0.387755102040816
Control.SRR15539829;46;45;0.565217391304348;20;26;0.0652173913043478;0.434782608695652
Control.SRR15539829;46;45;0.543478260869565;21;25;0.0434782608695652;0.456521739130435
Control.SRR15539829;42;45;0.547619047619048;19;23;0.0476190476190477;0.452380952380952
Control.SRR15539829;48;45;0.5;24;24;0;0.5
Control.SRR15539829;45;45;0.6;18;27;0.1;0.4
Control.SRR15539829;52;45;0.480769230769231;27;25;0.0192307692307692;0.480769230769231
Control.SRR15539829;46;45;0.543478260869565;21;25;0.0434782608695652;0.456521739130435
Control.SRR15539829;46;45;0.5;23;23;0;0.5
Control.SRR15539829;46;45;0.347826086956522;30;16;0.152173913043478;0.347826086956522
Control.SRR15539829;42;45;0.571428571428571;18;24;0.0714285714285714;0.428571428571429
Control.SRR15539829;49;45;0.489795918367347;25;24;0.0102040816326531;0.489795918367347
Control.SRR15539829;47;45;0.595744680851064;19;28;0.0957446808510638;0.404255319148936
Control.SRR15539829;42;45;0.571428571428571;18;24;0.0714285714285714;0.428571428571429
Control.SRR15539829;45;45;0.644444444444444;16;29;0.144444444444444;0.355555555555556
Control.SRR15539829;52;45;0.442307692307692;29;23;0.0576923076923077;0.442307692307692
Control.SRR15539829;49;45;0.612244897959184;19;30;0.112244897959184;0.387755102040816
Control.SRR15539829;46;45;0.521739130434783;22;24;0.0217391304347826;0.478260869565217
Control.SRR15539829;45;45;0.577777777777778;19;26;0.0777777777777777;0.422222222222222
Control.SRR15539829;45;45;0.488888888888889;23;22;0.0111111111111111;0.488888888888889
Control.SRR15539829;46;45;0.456521739130435;25;21;0.0434782608695652;0.456521739130435
Control.SRR15539829;45;45;0.488888888888889;23;22;0.0111111111111111;0.488888888888889
Control.SRR15539829;44;45;0.613636363636364;17;27;0.113636363636364;0.386363636363636
Control.SRR15539829;46;45;0.608695652173913;18;28;0.108695652173913;0.391304347826087
Control.SRR15539829;45;45;0.511111111111111;22;23;0.0111111111111111;0.488888888888889
Control.SRR15539829;44;45;0.545454545454545;20;24;0.0454545454545454;0.454545454545455
Control.SRR15539829;51;45;0.392156862745098;31;20;0.107843137254902;0.392156862745098
Control.SRR15539829;45;45;0.488888888888889;23;22;0.0111111111111111;0.488888888888889
Control.SRR15539829;49;45;0.428571428571429;28;21;0.0714285714285715;0.428571428571429
Control.SRR15539829;42;45;0.619047619047619;16;26;0.119047619047619;0.380952380952381
Control.SRR15539829;42;45;0.547619047619048;19;23;0.0476190476190477;0.452380952380952
Control.SRR15539829;42;45;0.452380952380952;23;19;0.0476190476190476;0.452380952380952
Control.SRR15539829;49;45;0.469387755102041;26;23;0.0306122448979592;0.469387755102041
Control.SRR15539829;50;45;0.44;28;22;0.06;0.44
Control.SRR15539829;43;45;0.418604651162791;25;18;0.0813953488372093;0.418604651162791
Control.SRR15539829;40;45;0.55;18;22;0.05;0.45
Control.SRR15539829;42;45;0.5;21;21;0;0.5
Control.SRR15539829;43;45;0.441860465116279;24;19;0.0581395348837209;0.441860465116279
Control.SRR15539829;50;45;0.58;21;29;0.08;0.42
Control.SRR15539829;50;45;0.58;21;29;0.08;0.42
Control.SRR15539829;52;45;0.557692307692308;23;29;0.0576923076923077;0.442307692307692
Control.SRR15539829;49;45;0.36734693877551;31;18;0.13265306122449;0.36734693877551
Control.SRR15539829;42;45;0.380952380952381;26;16;0.119047619047619;0.380952380952381
Control.SRR15539829;46;45;0.456521739130435;25;21;0.0434782608695652;0.456521739130435
Control.SRR15539829;43;45;0.488372093023256;22;21;0.0116279069767442;0.488372093023256
Control.SRR15539829;49;45;0.530612244897959;23;26;0.0306122448979592;0.469387755102041
Control.SRR15539829;52;45;0.634615384615385;19;33;0.134615384615385;0.365384615384615
Control.SRR15539829;48;45;0.645833333333333;17;31;0.145833333333333;0.354166666666667
Control.SRR15539829;43;45;0.627906976744186;16;27;0.127906976744186;0.372093023255814
Control.SRR15539829;46;45;0.434782608695652;26;20;0.0652173913043478;0.434782608695652
Control.SRR15539829;50;45;0.42;29;21;0.08;0.42
Control.SRR15539829;43;45;0.558139534883721;19;24;0.0581395348837209;0.441860465116279
Control.SRR15539829;48;45;0.416666666666667;28;20;0.0833333333333333;0.416666666666667
Control.SRR15539829;45;45;0.444444444444444;25;20;0.0555555555555556;0.444444444444444
Control.SRR15539829;40;45;0.55;18;22;0.05;0.45
Control.SRR15539829;42;45;0.476190476190476;22;20;0.0238095238095238;0.476190476190476
Control.SRR15539829;43;45;0.558139534883721;19;24;0.0581395348837209;0.441860465116279
Control.SRR15539829;44;45;0.454545454545455;24;20;0.0454545454545455;0.454545454545455
Control.SRR15539829;44;45;0.568181818181818;19;25;0.0681818181818182;0.431818181818182
Control.SRR15539829;46;45;0.5;23;23;0;0.5
Control.SRR15539829;52;45;0.576923076923077;22;30;0.0769230769230769;0.423076923076923
Control.SRR15539829;42;45;0.5;21;21;0;0.5
Control.SRR15539829;50;45;0.46;27;23;0.04;0.46
Control.SRR15539829;48;45;0.520833333333333;23;25;0.0208333333333334;0.479166666666667
Control.SRR15539829;48;45;0.416666666666667;28;20;0.0833333333333333;0.416666666666667
Control.SRR15539829;41;45;0.439024390243902;23;18;0.0609756097560976;0.439024390243902
Control.SRR15539829;50;45;0.52;24;26;0.02;0.48
Control.SRR15539829;42;45;0.5;21;21;0;0.5
Control.SRR15539829;48;45;0.375;30;18;0.125;0.375
Control.SRR15539829;48;45;0.479166666666667;25;23;0.0208333333333333;0.479166666666667
Control.SRR15539829;51;45;0.549019607843137;23;28;0.0490196078431373;0.450980392156863
Control.SRR15539829;51;45;0.529411764705882;24;27;0.0294117647058824;0.470588235294118
Control.SRR15539829;52;45;0.461538461538462;28;24;0.0384615384615384;0.461538461538462
Control.SRR15539829;47;45;0.468085106382979;25;22;0.0319148936170213;0.468085106382979
Control.SRR15539829;40;45;0.625;15;25;0.125;0.375
Control.SRR15539829;49;45;0.489795918367347;25;24;0.0102040816326531;0.489795918367347
Control.SRR15539829;45;45;0.577777777777778;19;26;0.0777777777777777;0.422222222222222
Control.SRR15539829;41;45;0.609756097560976;16;25;0.109756097560976;0.390243902439024
Control.SRR15539829;51;45;0.470588235294118;27;24;0.0294117647058824;0.470588235294118
Control.SRR15539829;44;45;0.5;22;22;0;0.5
Control.SRR15539829;44;45;0.545454545454545;20;24;0.0454545454545454;0.454545454545455
Control.SRR15539829;51;45;0.529411764705882;24;27;0.0294117647058824;0.470588235294118
Control.SRR15539829;45;45;0.488888888888889;23;22;0.0111111111111111;0.488888888888889
Control.SRR15539829;47;45;0.531914893617021;22;25;0.0319148936170213;0.468085106382979
Control.SRR15539829;47;45;0.51063829787234;23;24;0.0106382978723404;0.48936170212766
Control.SRR15539829;51;45;0.470588235294118;27;24;0.0294117647058824;0.470588235294118
Control.SRR15539829;48;45;0.625;18;30;0.125;0.375
Control.SRR15539829;40;45;0.475;21;19;0.025;0.475
Control.SRR15539829;43;45;0.395348837209302;26;17;0.104651162790698;0.395348837209302
Control.SRR15539829;45;45;0.466666666666667;24;21;0.0333333333333333;0.466666666666667
Control.SRR15539829;52;45;0.5;26;26;0;0.5
Control.SRR15539829;51;45;0.450980392156863;28;23;0.0490196078431372;0.450980392156863
Control.SRR15539829;41;45;0.414634146341463;24;17;0.0853658536585366;0.414634146341463
Control.SRR15539829;50;45;0.5;25;25;0;0.5
Control.SRR15539829;47;45;0.531914893617021;22;25;0.0319148936170213;0.468085106382979
Control.SRR15539829;52;45;0.423076923076923;30;22;0.0769230769230769;0.423076923076923
Control.SRR15539829;45;45;0.488888888888889;23;22;0.0111111111111111;0.488888888888889
Control.SRR15539829;45;45;0.444444444444444;25;20;0.0555555555555556;0.444444444444444
Control.SRR15539829;42;45;0.571428571428571;18;24;0.0714285714285714;0.428571428571429
Control.SRR15539829;40;45;0.5;20;20;0;0.5
Control.SRR15539829;45;45;0.511111111111111;22;23;0.0111111111111111;0.488888888888889
Control.SRR15539829;45;45;0.6;18;27;0.1;0.4
Control.SRR15539829;47;45;0.48936170212766;24;23;0.0106382978723404;0.48936170212766
Control.SRR15539829;41;45;0.48780487804878;21;20;0.0121951219512195;0.48780487804878
Control.SRR15539829;46;45;0.478260869565217;24;22;0.0217391304347826;0.478260869565217
Control.SRR15539829;45;45;0.466666666666667;24;21;0.0333333333333333;0.466666666666667
Control.SRR15539829;51;45;0.470588235294118;27;24;0.0294117647058824;0.470588235294118
Control.SRR15539829;47;45;0.446808510638298;26;21;0.0531914893617021;0.446808510638298
Control.SRR15539829;52;45;0.538461538461538;24;28;0.0384615384615384;0.461538461538462
Control.SRR15539829;42;45;0.5;21;21;0;0.5
Control.SRR15539829;50;45;0.52;24;26;0.02;0.48
Control.SRR15539829;49;45;0.489795918367347;25;24;0.0102040816326531;0.489795918367347
Control.SRR15539829;47;45;0.51063829787234;23;24;0.0106382978723404;0.48936170212766
Control.SRR15539829;42;45;0.452380952380952;23;19;0.0476190476190476;0.452380952380952
Control.SRR15539829;43;45;0.558139534883721;19;24;0.0581395348837209;0.441860465116279
Control.SRR15539829;47;45;0.48936170212766;24;23;0.0106382978723404;0.48936170212766
Control.SRR15539829;52;45;0.519230769230769;25;27;0.0192307692307693;0.480769230769231
Control.SRR15539829;51;45;0.509803921568627;25;26;0.00980392156862742;0.490196078431373
Control.SRR15539829;44;45;0.522727272727273;21;23;0.0227272727272727;0.477272727272727
Control.SRR15539829;46;45;0.630434782608696;17;29;0.130434782608696;0.369565217391304
Control.SRR15539829;51;45;0.372549019607843;32;19;0.127450980392157;0.372549019607843
Control.SRR15539829;45;45;0.466666666666667;24;21;0.0333333333333333;0.466666666666667
Control.SRR15539829;42;45;0.547619047619048;19;23;0.0476190476190477;0.452380952380952
Control.SRR15539829;47;45;0.531914893617021;22;25;0.0319148936170213;0.468085106382979
Control.SRR15539829;49;45;0.408163265306122;29;20;0.0918367346938775;0.408163265306122
Control.SRR15539829;45;45;0.6;18;27;0.1;0.4
Control.SRR15539829;46;45;0.478260869565217;24;22;0.0217391304347826;0.478260869565217
Control.SRR15539829;47;45;0.446808510638298;26;21;0.0531914893617021;0.446808510638298
Control.SRR15539829;42;45;0.5;21;21;0;0.5
Control.SRR15539829;40;45;0.475;21;19;0.025;0.475
Control.SRR15539829;48;45;0.520833333333333;23;25;0.0208333333333334;0.479166666666667
Control.SRR15539829;43;45;0.488372093023256;22;21;0.0116279069767442;0.488372093023256
Control.SRR15539829;52;45;0.519230769230769;25;27;0.0192307692307693;0.480769230769231
Control.SRR15539829;45;45;0.511111111111111;22;23;0.0111111111111111;0.488888888888889
Control.SRR15539829;43;45;0.488372093023256;22;21;0.0116279069767442;0.488372093023256
Control.SRR15539829;52;45;0.615384615384615;20;32;0.115384615384615;0.384615384615385
Control.SRR15539829;49;45;0.571428571428571;21;28;0.0714285714285714;0.428571428571429
Control.SRR15539829;51;45;0.509803921568627;25;26;0.00980392156862742;0.490196078431373
Control.SRR15539829;49;45;0.591836734693878;20;29;0.0918367346938775;0.408163265306122
Control.SRR15539829;52;45;0.596153846153846;21;31;0.0961538461538461;0.403846153846154
Control.SRR15539829;52;45;0.538461538461538;24;28;0.0384615384615384;0.461538461538462
Control.SRR15539829;43;45;0.627906976744186;16;27;0.127906976744186;0.372093023255814
Control.SRR15539829;48;45;0.520833333333333;23;25;0.0208333333333334;0.479166666666667
Control.SRR15539829;40;45;0.325;27;13;0.175;0.325
Control.SRR15539829;40;45;0.525;19;21;0.025;0.475
Control.SRR15539829;40;45;0.5;20;20;0;0.5
Control.SRR15539829;42;45;0.619047619047619;16;26;0.119047619047619;0.380952380952381
Control.SRR15539829;45;45;0.422222222222222;26;19;0.0777777777777778;0.422222222222222
Control.SRR15539829;51;45;0.431372549019608;29;22;0.0686274509803921;0.431372549019608
Control.SRR15539829;42;45;0.452380952380952;23;19;0.0476190476190476;0.452380952380952
Control.SRR15539829;51;45;0.431372549019608;29;22;0.0686274509803921;0.431372549019608
Control.SRR15539829;46;45;0.478260869565217;24;22;0.0217391304347826;0.478260869565217
Control.SRR15539829;45;45;0.555555555555556;20;25;0.0555555555555556;0.444444444444444
Control.SRR15539829;52;45;0.538461538461538;24;28;0.0384615384615384;0.461538461538462
Control.SRR15539829;51;45;0.509803921568627;25;26;0.00980392156862742;0.490196078431373
Control.SRR15539829;47;45;0.553191489361702;21;26;0.0531914893617021;0.446808510638298
Control.SRR15539829;41;45;0.634146341463415;15;26;0.134146341463415;0.365853658536585
Control.SRR15539829;47;45;0.468085106382979;25;22;0.0319148936170213;0.468085106382979
Control.SRR15539829;51;45;0.392156862745098;31;20;0.107843137254902;0.392156862745098
Control.SRR15539829;50;45;0.5;25;25;0;0.5
Control.SRR15539829;50;45;0.54;23;27;0.04;0.46
Control.SRR15539829;51;45;0.607843137254902;20;31;0.107843137254902;0.392156862745098
Control.SRR15539829;46;45;0.608695652173913;18;28;0.108695652173913;0.391304347826087
Control.SRR15539829;43;45;0.441860465116279;24;19;0.0581395348837209;0.441860465116279
Control.SRR15539829;51;45;0.490196078431373;26;25;0.00980392156862747;0.490196078431373
Control.SRR15539829;44;45;0.522727272727273;21;23;0.0227272727272727;0.477272727272727
Control.SRR15539829;40;45;0.575;17;23;0.075;0.425
Control.SRR15539829;41;45;0.536585365853659;19;22;0.0365853658536586;0.463414634146341
Control.SRR15539829;41;45;0.48780487804878;21;20;0.0121951219512195;0.48780487804878
Control.SRR15539829;51;45;0.529411764705882;24;27;0.0294117647058824;0.470588235294118
Control.SRR15539829;42;45;0.547619047619048;19;23;0.0476190476190477;0.452380952380952
Control.SRR15539829;47;45;0.51063829787234;23;24;0.0106382978723404;0.48936170212766
Control.SRR15539829;41;45;0.48780487804878;21;20;0.0121951219512195;0.48780487804878
Control.SRR15539829;51;45;0.549019607843137;23;28;0.0490196078431373;0.450980392156863
Control.SRR15539829;50;45;0.48;26;24;0.02;0.48
Control.SRR15539829;52;45;0.519230769230769;25;27;0.0192307692307693;0.480769230769231
Control.SRR15539829;52;45;0.596153846153846;21;31;0.0961538461538461;0.403846153846154
Control.SRR15539829;46;45;0.543478260869565;21;25;0.0434782608695652;0.456521739130435
Control.SRR15539829;41;45;0.439024390243902;23;18;0.0609756097560976;0.439024390243902
Control.SRR15539829;47;45;0.531914893617021;22;25;0.0319148936170213;0.468085106382979
Control.SRR15539829;44;45;0.477272727272727;23;21;0.0227272727272727;0.477272727272727
Control.SRR15539829;49;45;0.510204081632653;24;25;0.0102040816326531;0.489795918367347
Control.SRR15539829;50;45;0.4;30;20;0.1;0.4
Control.SRR15539829;48;45;0.458333333333333;26;22;0.0416666666666667;0.458333333333333
Control.SRR15539829;47;45;0.51063829787234;23;24;0.0106382978723404;0.48936170212766
Control.SRR15539829;49;45;0.510204081632653;24;25;0.0102040816326531;0.489795918367347
Control.SRR15539829;46;45;0.58695652173913;19;27;0.0869565217391305;0.41304347826087
Control.SRR15539829;47;45;0.446808510638298;26;21;0.0531914893617021;0.446808510638298
Control.SRR15539829;49;45;0.489795918367347;25;24;0.0102040816326531;0.489795918367347
Control.SRR15539829;50;45;0.58;21;29;0.08;0.42
Control.SRR15539829;52;45;0.557692307692308;23;29;0.0576923076923077;0.442307692307692
Control.SRR15539829;40;45;0.425;23;17;0.075;0.425
Control.SRR15539829;49;45;0.530612244897959;23;26;0.0306122448979592;0.469387755102041
Control.SRR15539829;52;45;0.557692307692308;23;29;0.0576923076923077;0.442307692307692
Control.SRR15539829;43;45;0.534883720930233;20;23;0.0348837209302325;0.465116279069767
Control.SRR15539829;46;45;0.565217391304348;20;26;0.0652173913043478;0.434782608695652
Control.SRR15539829;49;45;0.448979591836735;27;22;0.0510204081632653;0.448979591836735
Control.SRR15539829;48;45;0.416666666666667;28;20;0.0833333333333333;0.416666666666667
Control.SRR15539829;49;45;0.36734693877551;31;18;0.13265306122449;0.36734693877551
Control.SRR15539829;43;45;0.511627906976744;21;22;0.0116279069767442;0.488372093023256
Control.SRR15539829;43;45;0.465116279069767;23;20;0.0348837209302326;0.465116279069767
Control.SRR15539829;50;45;0.6;20;30;0.1;0.4
Control.SRR15539829;51;45;0.568627450980392;22;29;0.0686274509803921;0.431372549019608
Control.SRR15539829;41;45;0.48780487804878;21;20;0.0121951219512195;0.48780487804878
Control.SRR15539829;42;45;0.404761904761905;25;17;0.0952380952380952;0.404761904761905
Control.SRR15539829;42;45;0.476190476190476;22;20;0.0238095238095238;0.476190476190476
Control.SRR15539829;49;45;0.571428571428571;21;28;0.0714285714285714;0.428571428571429
Control.SRR15539829;47;45;0.382978723404255;29;18;0.117021276595745;0.382978723404255
Control.SRR15539829;44;45;0.659090909090909;15;29;0.159090909090909;0.340909090909091
Control.SRR15539829;49;45;0.489795918367347;25;24;0.0102040816326531;0.489795918367347
Control.SRR15539829;50;45;0.58;21;29;0.08;0.42
Control.SRR15539829;49;45;0.571428571428571;21;28;0.0714285714285714;0.428571428571429
Control.SRR15539829;48;45;0.395833333333333;29;19;0.104166666666667;0.395833333333333
Control.SRR15539829;42;45;0.523809523809524;20;22;0.0238095238095238;0.476190476190476
Control.SRR15539829;46;45;0.478260869565217;24;22;0.0217391304347826;0.478260869565217
Control.SRR15539829;44;45;0.545454545454545;20;24;0.0454545454545454;0.454545454545455
Control.SRR15539829;44;45;0.340909090909091;29;15;0.159090909090909;0.340909090909091
Control.SRR15539829;51;45;0.490196078431373;26;25;0.00980392156862747;0.490196078431373
Control.SRR15539829;41;45;0.463414634146341;22;19;0.0365853658536585;0.463414634146341
Control.SRR15539829;51;45;0.450980392156863;28;23;0.0490196078431372;0.450980392156863
Control.SRR15539829;52;45;0.576923076923077;22;30;0.0769230769230769;0.423076923076923
Control.SRR15539829;41;45;0.51219512195122;20;21;0.0121951219512195;0.48780487804878
Control.SRR15539829;50;45;0.66;17;33;0.16;0.34
Control.SRR15539829;47;45;0.340425531914894;31;16;0.159574468085106;0.340425531914894
Control.SRR15539829;48;45;0.520833333333333;23;25;0.0208333333333334;0.479166666666667
Control.SRR15539829;52;45;0.596153846153846;21;31;0.0961538461538461;0.403846153846154
Control.SRR15539829;46;45;0.478260869565217;24;22;0.0217391304347826;0.478260869565217
Control.SRR15539829;44;45;0.522727272727273;21;23;0.0227272727272727;0.477272727272727
Control.SRR15539829;50;45;0.54;23;27;0.04;0.46
Control.SRR15539829;51;45;0.549019607843137;23;28;0.0490196078431373;0.450980392156863
Control.SRR15539829;49;45;0.510204081632653;24;25;0.0102040816326531;0.489795918367347
Control.SRR15539829;40;45;0.525;19;21;0.025;0.475
Control.SRR15539829;43;45;0.488372093023256;22;21;0.0116279069767442;0.488372093023256
Control.SRR15539829;48;45;0.270833333333333;35;13;0.229166666666667;0.270833333333333
Control.SRR15539829;49;45;0.571428571428571;21;28;0.0714285714285714;0.428571428571429
Control.SRR15539829;44;45;0.477272727272727;23;21;0.0227272727272727;0.477272727272727
Control.SRR15539829;43;45;0.558139534883721;19;24;0.0581395348837209;0.441860465116279
Control.SRR15539829;48;45;0.458333333333333;26;22;0.0416666666666667;0.458333333333333
Control.SRR15539829;42;45;0.571428571428571;18;24;0.0714285714285714;0.428571428571429
Control.SRR15539829;47;45;0.638297872340426;17;30;0.138297872340426;0.361702127659574
Control.SRR15539829;41;45;0.658536585365854;14;27;0.158536585365854;0.341463414634146
Control.SRR15539829;41;45;0.390243902439024;25;16;0.109756097560976;0.390243902439024
Control.SRR15539829;52;45;0.5;26;26;0;0.5
Control.SRR15539829;51;45;0.529411764705882;24;27;0.0294117647058824;0.470588235294118
Control.SRR15539829;51;45;0.411764705882353;30;21;0.0882352941176471;0.411764705882353
Control.SRR15539829;48;45;0.458333333333333;26;22;0.0416666666666667;0.458333333333333
Control.SRR15539829;46;45;0.41304347826087;27;19;0.0869565217391304;0.41304347826087
Control.SRR15539829;52;45;0.557692307692308;23;29;0.0576923076923077;0.442307692307692
Control.SRR15539829;43;45;0.558139534883721;19;24;0.0581395348837209;0.441860465116279
Control.SRR15539829;47;45;0.531914893617021;22;25;0.0319148936170213;0.468085106382979
Control.SRR15539829;42;45;0.357142857142857;27;15;0.142857142857143;0.357142857142857
Control.SRR15539829;42;45;0.69047619047619;13;29;0.19047619047619;0.30952380952381
Control.SRR15539829;41;45;0.51219512195122;20;21;0.0121951219512195;0.48780487804878
Control.SRR15539829;44;45;0.477272727272727;23;21;0.0227272727272727;0.477272727272727
Control.SRR15539829;42;45;0.452380952380952;23;19;0.0476190476190476;0.452380952380952
Control.SRR15539829;40;45;0.65;14;26;0.15;0.35
Control.SRR15539829;41;45;0.463414634146341;22;19;0.0365853658536585;0.463414634146341
Control.SRR15539829;47;45;0.553191489361702;21;26;0.0531914893617021;0.446808510638298
Control.SRR15539829;50;45;0.44;28;22;0.06;0.44
Control.SRR15539829;49;45;0.530612244897959;23;26;0.0306122448979592;0.469387755102041
Control.SRR15539829;52;45;0.519230769230769;25;27;0.0192307692307693;0.480769230769231
Control.SRR15539829;49;45;0.510204081632653;24;25;0.0102040816326531;0.489795918367347
Control.SRR15539829;46;45;0.521739130434783;22;24;0.0217391304347826;0.478260869565217
Control.SRR15539829;43;45;0.465116279069767;23;20;0.0348837209302326;0.465116279069767
Control.SRR15539829;52;45;0.576923076923077;22;30;0.0769230769230769;0.423076923076923
Control.SRR15539829;52;45;0.5;26;26;0;0.5
Control.SRR15539829;50;45;0.42;29;21;0.08;0.42
Control.SRR15539829;52;45;0.461538461538462;28;24;0.0384615384615384;0.461538461538462
Control.SRR15539829;48;45;0.5625;21;27;0.0625;0.4375
Control.SRR15539829;43;45;0.488372093023256;22;21;0.0116279069767442;0.488372093023256
Control.SRR15539829;50;45;0.52;24;26;0.02;0.48
Control.SRR15539829;52;45;0.442307692307692;29;23;0.0576923076923077;0.442307692307692
Control.SRR15539829;41;45;0.414634146341463;24;17;0.0853658536585366;0.414634146341463
Control.SRR15539829;45;45;0.4;27;18;0.1;0.4
Control.SRR15539829;45;45;0.577777777777778;19;26;0.0777777777777777;0.422222222222222
Control.SRR15539829;47;45;0.531914893617021;22;25;0.0319148936170213;0.468085106382979
Control.SRR15539829;49;45;0.408163265306122;29;20;0.0918367346938775;0.408163265306122
Control.SRR15539829;52;45;0.557692307692308;23;29;0.0576923076923077;0.442307692307692
Control.SRR15539829;44;45;0.454545454545455;24;20;0.0454545454545455;0.454545454545455
Control.SRR15539829;40;45;0.5;20;20;0;0.5
Control.SRR15539829;49;45;0.551020408163265;22;27;0.0510204081632653;0.448979591836735
Control.SRR15539829;52;45;0.480769230769231;27;25;0.0192307692307692;0.480769230769231
Control.SRR15539829;44;45;0.545454545454545;20;24;0.0454545454545454;0.454545454545455
Control.SRR15539829;41;45;0.365853658536585;26;15;0.134146341463415;0.365853658536585
Control.SRR15539829;48;45;0.479166666666667;25;23;0.0208333333333333;0.479166666666667
Control.SRR15539829;40;45;0.525;19;21;0.025;0.475
Control.SRR15539829;45;45;0.577777777777778;19;26;0.0777777777777777;0.422222222222222
Control.SRR15539829;51;45;0.392156862745098;31;20;0.107843137254902;0.392156862745098
Control.SRR15539829;42;45;0.523809523809524;20;22;0.0238095238095238;0.476190476190476
Control.SRR15539829;45;45;0.511111111111111;22;23;0.0111111111111111;0.488888888888889
Control.SRR15539829;50;45;0.46;27;23;0.04;0.46
Control.SRR15539829;47;45;0.531914893617021;22;25;0.0319148936170213;0.468085106382979
Control.SRR15539829;47;45;0.574468085106383;20;27;0.074468085106383;0.425531914893617
Control.SRR15539829;40;45;0.5;20;20;0;0.5
Control.SRR15539829;43;45;0.465116279069767;23;20;0.0348837209302326;0.465116279069767
Control.SRR15539829;50;45;0.52;24;26;0.02;0.48
Control.SRR15539829;41;45;0.439024390243902;23;18;0.0609756097560976;0.439024390243902
Control.SRR15539829;45;45;0.622222222222222;17;28;0.122222222222222;0.377777777777778
Control.SRR15539829;40;45;0.525;19;21;0.025;0.475
Control.SRR15539829;49;45;0.510204081632653;24;25;0.0102040816326531;0.489795918367347
Control.SRR15539829;47;45;0.468085106382979;25;22;0.0319148936170213;0.468085106382979
Control.SRR15539829;47;45;0.574468085106383;20;27;0.074468085106383;0.425531914893617
Control.SRR15539829;50;45;0.5;25;25;0;0.5
Control.SRR15539829;48;45;0.541666666666667;22;26;0.0416666666666666;0.458333333333333
Control.SRR15539829;48;45;0.520833333333333;23;25;0.0208333333333334;0.479166666666667
Control.SRR15539829;43;45;0.418604651162791;25;18;0.0813953488372093;0.418604651162791
Control.SRR15539829;47;45;0.553191489361702;21;26;0.0531914893617021;0.446808510638298
Control.SRR15539829;40;45;0.55;18;22;0.05;0.45
Control.SRR15539829;45;45;0.577777777777778;19;26;0.0777777777777777;0.422222222222222
Control.SRR15539829;45;45;0.6;18;27;0.1;0.4
Control.SRR15539829;45;45;0.444444444444444;25;20;0.0555555555555556;0.444444444444444
Control.SRR15539829;48;45;0.458333333333333;26;22;0.0416666666666667;0.458333333333333
Control.SRR15539829;49;45;0.530612244897959;23;26;0.0306122448979592;0.469387755102041
Control.SRR15539829;44;45;0.590909090909091;18;26;0.0909090909090909;0.409090909090909
Control.SRR15539829;45;45;0.488888888888889;23;22;0.0111111111111111;0.488888888888889
Control.SRR15539829;52;45;0.423076923076923;30;22;0.0769230769230769;0.423076923076923
Control.SRR15539829;46;45;0.565217391304348;20;26;0.0652173913043478;0.434782608695652
Control.SRR15539829;42;45;0.357142857142857;27;15;0.142857142857143;0.357142857142857
Control.SRR15539829;50;45;0.48;26;24;0.02;0.48
Control.SRR15539829;45;45;0.511111111111111;22;23;0.0111111111111111;0.488888888888889
Control.SRR15539829;51;45;0.627450980392157;19;32;0.127450980392157;0.372549019607843
Control.SRR15539829;44;45;0.5;22;22;0;0.5
Control.SRR15539829;48;45;0.541666666666667;22;26;0.0416666666666666;0.458333333333333
Control.SRR15539829;46;45;0.5;23;23;0;0.5
Control.SRR15539829;49;45;0.428571428571429;28;21;0.0714285714285715;0.428571428571429
Control.SRR15539829;46;45;0.652173913043478;16;30;0.152173913043478;0.347826086956522
Control.SRR15539829;46;45;0.478260869565217;24;22;0.0217391304347826;0.478260869565217
Control.SRR15539829;46;45;0.434782608695652;26;20;0.0652173913043478;0.434782608695652
Control.SRR15539829;45;45;0.644444444444444;16;29;0.144444444444444;0.355555555555556
Control.SRR15539829;40;45;0.6;16;24;0.1;0.4
Control.SRR15539829;40;45;0.65;14;26;0.15;0.35
Control.SRR15539829;43;45;0.534883720930233;20;23;0.0348837209302325;0.465116279069767
Control.SRR15539829;52;45;0.403846153846154;31;21;0.0961538461538461;0.403846153846154
Control.SRR15539829;51;45;0.450980392156863;28;23;0.0490196078431372;0.450980392156863
Control.SRR15539829;51;45;0.470588235294118;27;24;0.0294117647058824;0.470588235294118
Control.SRR15539829;48;45;0.395833333333333;29;19;0.104166666666667;0.395833333333333
Control.SRR15539829;43;45;0.511627906976744;21;22;0.0116279069767442;0.488372093023256
Control.SRR15539829;43;45;0.534883720930233;20;23;0.0348837209302325;0.465116279069767
Control.SRR15539829;49;45;0.653061224489796;17;32;0.153061224489796;0.346938775510204
Control.SRR15539829;42;45;0.5;21;21;0;0.5
Control.SRR15539829;48;45;0.458333333333333;26;22;0.0416666666666667;0.458333333333333
Control.SRR15539829;47;45;0.531914893617021;22;25;0.0319148936170213;0.468085106382979
Control.SRR15539829;45;45;0.4;27;18;0.1;0.4
Control.SRR15539829;42;45;0.547619047619048;19;23;0.0476190476190477;0.452380952380952
Control.SRR15539829;40;45;0.35;26;14;0.15;0.35
Control.SRR15539829;46;45;0.543478260869565;21;25;0.0434782608695652;0.456521739130435
Control.SRR15539829;46;45;0.478260869565217;24;22;0.0217391304347826;0.478260869565217
Control.SRR15539829;41;45;0.390243902439024;25;16;0.109756097560976;0.390243902439024
Control.SRR15539829;47;45;0.404255319148936;28;19;0.0957446808510639;0.404255319148936
Control.SRR15539829;47;45;0.48936170212766;24;23;0.0106382978723404;0.48936170212766
Control.SRR15539829;49;45;0.551020408163265;22;27;0.0510204081632653;0.448979591836735
Control.SRR15539829;49;45;0.530612244897959;23;26;0.0306122448979592;0.469387755102041
Control.SRR15539829;50;45;0.52;24;26;0.02;0.48
Control.SRR15539829;43;45;0.465116279069767;23;20;0.0348837209302326;0.465116279069767
Control.SRR15539829;51;45;0.352941176470588;33;18;0.147058823529412;0.352941176470588
Control.SRR15539829;50;45;0.48;26;24;0.02;0.48
Control.SRR15539829;45;45;0.466666666666667;24;21;0.0333333333333333;0.466666666666667
Control.SRR15539829;49;45;0.387755102040816;30;19;0.112244897959184;0.387755102040816
Control.SRR15539829;44;45;0.659090909090909;15;29;0.159090909090909;0.340909090909091
Control.SRR15539829;42;45;0.357142857142857;27;15;0.142857142857143;0.357142857142857
Control.SRR15539829;50;45;0.54;23;27;0.04;0.46
Control.SRR15539829;41;45;0.414634146341463;24;17;0.0853658536585366;0.414634146341463
Control.SRR15539829;46;45;0.456521739130435;25;21;0.0434782608695652;0.456521739130435
Control.SRR15539829;50;45;0.5;25;25;0;0.5
Control.SRR15539829;49;45;0.510204081632653;24;25;0.0102040816326531;0.489795918367347
Control.SRR15539829;41;45;0.390243902439024;25;16;0.109756097560976;0.390243902439024
Control.SRR15539829;43;45;0.465116279069767;23;20;0.0348837209302326;0.465116279069767
Control.SRR15539829;44;45;0.545454545454545;20;24;0.0454545454545454;0.454545454545455
Control.SRR15539829;48;45;0.395833333333333;29;19;0.104166666666667;0.395833333333333
Control.SRR15539829;42;45;0.619047619047619;16;26;0.119047619047619;0.380952380952381
Control.SRR15539829;47;45;0.531914893617021;22;25;0.0319148936170213;0.468085106382979
Control.SRR15539829;40;45;0.55;18;22;0.05;0.45
Control.SRR15539829;50;45;0.28;36;14;0.22;0.28
Control.SRR15539829;41;45;0.707317073170732;12;29;0.207317073170732;0.292682926829268
Control.SRR15539829;41;45;0.51219512195122;20;21;0.0121951219512195;0.48780487804878
Control.SRR15539829;51;45;0.529411764705882;24;27;0.0294117647058824;0.470588235294118
Control.SRR15539829;47;45;0.425531914893617;27;20;0.074468085106383;0.425531914893617
Control.SRR15539829;45;45;0.488888888888889;23;22;0.0111111111111111;0.488888888888889
Control.SRR15539829;45;45;0.422222222222222;26;19;0.0777777777777778;0.422222222222222
Control.SRR15539829;41;45;0.560975609756098;18;23;0.0609756097560976;0.439024390243902
Control.SRR15539829;46;45;0.456521739130435;25;21;0.0434782608695652;0.456521739130435
Control.SRR15539829;40;45;0.375;25;15;0.125;0.375
Control.SRR15539829;47;45;0.574468085106383;20;27;0.074468085106383;0.425531914893617
Control.SRR15539829;52;45;0.519230769230769;25;27;0.0192307692307693;0.480769230769231
Control.SRR15539829;51;45;0.490196078431373;26;25;0.00980392156862747;0.490196078431373
Control.SRR15539829;42;45;0.476190476190476;22;20;0.0238095238095238;0.476190476190476
Control.SRR15539829;44;45;0.386363636363636;27;17;0.113636363636364;0.386363636363636
Control.SRR15539829;48;45;0.645833333333333;17;31;0.145833333333333;0.354166666666667
Control.SRR15539829;47;45;0.48936170212766;24;23;0.0106382978723404;0.48936170212766
Control.SRR15539829;48;45;0.604166666666667;19;29;0.104166666666667;0.395833333333333
Control.SRR15539829;46;45;0.521739130434783;22;24;0.0217391304347826;0.478260869565217
Control.SRR15539829;42;45;0.571428571428571;18;24;0.0714285714285714;0.428571428571429
Control.SRR15539829;43;45;0.488372093023256;22;21;0.0116279069767442;0.488372093023256
Control.SRR15539829;49;45;0.408163265306122;29;20;0.0918367346938775;0.408163265306122
Control.SRR15539829;48;45;0.4375;27;21;0.0625;0.4375
Control.SRR15539829;47;45;0.48936170212766;24;23;0.0106382978723404;0.48936170212766
Control.SRR15539829;48;45;0.458333333333333;26;22;0.0416666666666667;0.458333333333333
Control.SRR15539829;43;45;0.372093023255814;27;16;0.127906976744186;0.372093023255814
Control.SRR15539829;49;45;0.346938775510204;32;17;0.153061224489796;0.346938775510204
Control.SRR15539829;43;45;0.418604651162791;25;18;0.0813953488372093;0.418604651162791
Control.SRR15539829;51;45;0.490196078431373;26;25;0.00980392156862747;0.490196078431373
Control.SRR15539829;40;45;0.425;23;17;0.075;0.425
Control.SRR15539829;46;45;0.608695652173913;18;28;0.108695652173913;0.391304347826087
Control.SRR15539829;41;45;0.536585365853659;19;22;0.0365853658536586;0.463414634146341
Control.SRR15539829;51;45;0.549019607843137;23;28;0.0490196078431373;0.450980392156863
Control.SRR15539829;49;45;0.489795918367347;25;24;0.0102040816326531;0.489795918367347
Control.SRR15539829;43;45;0.418604651162791;25;18;0.0813953488372093;0.418604651162791
Control.SRR15539829;39;45;0.461538461538462;21;18;0.0384615384615384;0.461538461538462
Control.SRR15539829;42;45;0.571428571428571;18;24;0.0714285714285714;0.428571428571429
Control.SRR15539829;44;45;0.454545454545455;24;20;0.0454545454545455;0.454545454545455
Control.SRR15539829;40;45;0.5;20;20;0;0.5
Control.SRR15539829;39;45;0.435897435897436;22;17;0.0641025641025641;0.435897435897436
Control.SRR15539829;44;45;0.590909090909091;18;26;0.0909090909090909;0.409090909090909
Control.SRR15539829;49;45;0.551020408163265;22;27;0.0510204081632653;0.448979591836735
Control.SRR15539829;50;45;0.56;22;28;0.0600000000000001;0.44
Control.SRR15539829;49;45;0.469387755102041;26;23;0.0306122448979592;0.469387755102041
Control.SRR15539829;48;45;0.666666666666667;16;32;0.166666666666667;0.333333333333333
Control.SRR15539829;45;45;0.488888888888889;23;22;0.0111111111111111;0.488888888888889
Control.SRR15539829;49;45;0.489795918367347;25;24;0.0102040816326531;0.489795918367347
Control.SRR15539829;44;45;0.318181818181818;30;14;0.181818181818182;0.318181818181818
Control.SRR15539829;50;45;0.5;25;25;0;0.5
Control.SRR15539829;40;45;0.65;14;26;0.15;0.35
Control.SRR15539829;48;45;0.395833333333333;29;19;0.104166666666667;0.395833333333333
Control.SRR15539829;43;45;0.534883720930233;20;23;0.0348837209302325;0.465116279069767
Control.SRR15539829;50;45;0.38;31;19;0.12;0.38
Control.SRR15539829;40;45;0.55;18;22;0.05;0.45
Control.SRR15539829;46;45;0.478260869565217;24;22;0.0217391304347826;0.478260869565217
Control.SRR15539829;41;45;0.609756097560976;16;25;0.109756097560976;0.390243902439024
Control.SRR15539829;50;45;0.38;31;19;0.12;0.38
Control.SRR15539829;46;45;0.543478260869565;21;25;0.0434782608695652;0.456521739130435
Control.SRR15539829;45;45;0.6;18;27;0.1;0.4
Control.SRR15539829;48;45;0.5;24;24;0;0.5
Control.SRR15539829;41;45;0.48780487804878;21;20;0.0121951219512195;0.48780487804878
Control.SRR15539829;46;45;0.434782608695652;26;20;0.0652173913043478;0.434782608695652
Control.SRR15539829;44;45;0.568181818181818;19;25;0.0681818181818182;0.431818181818182
Control.SRR15539829;50;45;0.4;30;20;0.1;0.4
Control.SRR15539829;51;45;0.352941176470588;33;18;0.147058823529412;0.352941176470588
Control.SRR15539829;44;45;0.590909090909091;18;26;0.0909090909090909;0.409090909090909
Control.SRR15539829;46;45;0.652173913043478;16;30;0.152173913043478;0.347826086956522
Control.SRR15539829;46;45;0.391304347826087;28;18;0.108695652173913;0.391304347826087
Control.SRR15539829;44;45;0.522727272727273;21;23;0.0227272727272727;0.477272727272727
Control.SRR15539829;50;45;0.54;23;27;0.04;0.46
Control.SRR15539829;42;45;0.404761904761905;25;17;0.0952380952380952;0.404761904761905
Control.SRR15539829;39;45;0.512820512820513;19;20;0.0128205128205128;0.487179487179487
Control.SRR15539829;46;45;0.369565217391304;29;17;0.130434782608696;0.369565217391304
Control.SRR15539829;42;45;0.523809523809524;20;22;0.0238095238095238;0.476190476190476
Control.SRR15539829;44;45;0.5;22;22;0;0.5
Control.SRR15539829;50;45;0.52;24;26;0.02;0.48
Control.SRR15539829;50;45;0.6;20;30;0.1;0.4
Control.SRR15539829;45;45;0.4;27;18;0.1;0.4
Control.SRR15539829;48;45;0.541666666666667;22;26;0.0416666666666666;0.458333333333333
Control.SRR15539829;43;45;0.604651162790698;17;26;0.104651162790698;0.395348837209302
Control.SRR15539829;43;45;0.488372093023256;22;21;0.0116279069767442;0.488372093023256
Control.SRR15539829;41;45;0.585365853658537;17;24;0.0853658536585366;0.414634146341463
Control.SRR15539829;46;45;0.391304347826087;28;18;0.108695652173913;0.391304347826087
Control.SRR15539829;43;45;0.488372093023256;22;21;0.0116279069767442;0.488372093023256
Control.SRR15539829;42;45;0.476190476190476;22;20;0.0238095238095238;0.476190476190476
Control.SRR15539829;39;45;0.512820512820513;19;20;0.0128205128205128;0.487179487179487
Control.SRR15539829;45;45;0.333333333333333;30;15;0.166666666666667;0.333333333333333
Control.SRR15539829;44;45;0.454545454545455;24;20;0.0454545454545455;0.454545454545455
Control.SRR15539829;49;45;0.510204081632653;24;25;0.0102040816326531;0.489795918367347
Control.SRR15539829;44;45;0.5;22;22;0;0.5
Control.SRR15539829;51;45;0.450980392156863;28;23;0.0490196078431372;0.450980392156863
Control.SRR15539829;45;45;0.533333333333333;21;24;0.0333333333333333;0.466666666666667
Control.SRR15539829;42;45;0.547619047619048;19;23;0.0476190476190477;0.452380952380952
Control.SRR15539829;45;45;0.533333333333333;21;24;0.0333333333333333;0.466666666666667
Control.SRR15539829;41;45;0.463414634146341;22;19;0.0365853658536585;0.463414634146341
Control.SRR15539829;44;45;0.477272727272727;23;21;0.0227272727272727;0.477272727272727
Control.SRR15539829;41;45;0.51219512195122;20;21;0.0121951219512195;0.48780487804878
Control.SRR15539829;48;45;0.458333333333333;26;22;0.0416666666666667;0.458333333333333
Control.SRR15539829;43;45;0.604651162790698;17;26;0.104651162790698;0.395348837209302
Control.SRR15539829;40;45;0.55;18;22;0.05;0.45
Control.SRR15539829;47;45;0.531914893617021;22;25;0.0319148936170213;0.468085106382979
Control.SRR15539829;51;45;0.431372549019608;29;22;0.0686274509803921;0.431372549019608
Control.SRR15539829;48;45;0.5625;21;27;0.0625;0.4375
Control.SRR15539829;40;45;0.35;26;14;0.15;0.35
Control.SRR15539829;47;45;0.595744680851064;19;28;0.0957446808510638;0.404255319148936
Control.SRR15539829;40;45;0.575;17;23;0.075;0.425
Control.SRR15539829;47;45;0.553191489361702;21;26;0.0531914893617021;0.446808510638298
Control.SRR15539829;51;45;0.607843137254902;20;31;0.107843137254902;0.392156862745098
Control.SRR15539829;50;45;0.44;28;22;0.06;0.44
Control.SRR15539829;43;45;0.511627906976744;21;22;0.0116279069767442;0.488372093023256
Control.SRR15539829;47;45;0.468085106382979;25;22;0.0319148936170213;0.468085106382979
Control.SRR15539829;42;45;0.452380952380952;23;19;0.0476190476190476;0.452380952380952
Control.SRR15539829;46;45;0.543478260869565;21;25;0.0434782608695652;0.456521739130435
Control.SRR15539829;44;45;0.545454545454545;20;24;0.0454545454545454;0.454545454545455
Control.SRR15539829;43;45;0.418604651162791;25;18;0.0813953488372093;0.418604651162791
Control.SRR15539829;40;45;0.525;19;21;0.025;0.475
Control.SRR15539829;49;45;0.408163265306122;29;20;0.0918367346938775;0.408163265306122
Control.SRR15539829;42;45;0.619047619047619;16;26;0.119047619047619;0.380952380952381
Control.SRR15539829;48;45;0.458333333333333;26;22;0.0416666666666667;0.458333333333333
Control.SRR15539829;46;45;0.543478260869565;21;25;0.0434782608695652;0.456521739130435
Control.SRR15539829;43;45;0.418604651162791;25;18;0.0813953488372093;0.418604651162791
Control.SRR15539829;43;45;0.558139534883721;19;24;0.0581395348837209;0.441860465116279
Control.SRR15539829;47;45;0.51063829787234;23;24;0.0106382978723404;0.48936170212766
Control.SRR15539829;47;45;0.468085106382979;25;22;0.0319148936170213;0.468085106382979
Control.SRR15539829;40;45;0.5;20;20;0;0.5
Control.SRR15539829;41;45;0.48780487804878;21;20;0.0121951219512195;0.48780487804878
Control.SRR15539829;42;45;0.547619047619048;19;23;0.0476190476190477;0.452380952380952
Control.SRR15539829;40;45;0.35;26;14;0.15;0.35
Control.SRR15539829;46;45;0.478260869565217;24;22;0.0217391304347826;0.478260869565217
Control.SRR15539829;39;45;0.461538461538462;21;18;0.0384615384615384;0.461538461538462
Control.SRR15539829;47;45;0.468085106382979;25;22;0.0319148936170213;0.468085106382979
Control.SRR15539829;45;45;0.555555555555556;20;25;0.0555555555555556;0.444444444444444
Control.SRR15539829;43;45;0.488372093023256;22;21;0.0116279069767442;0.488372093023256
Control.SRR15539829;39;45;0.461538461538462;21;18;0.0384615384615384;0.461538461538462
Control.SRR15539829;41;45;0.658536585365854;14;27;0.158536585365854;0.341463414634146
Control.SRR15539829;43;45;0.534883720930233;20;23;0.0348837209302325;0.465116279069767
Control.SRR15539829;43;45;0.348837209302326;28;15;0.151162790697674;0.348837209302326
Control.SRR15539829;42;45;0.5;21;21;0;0.5
Control.SRR15539829;48;45;0.541666666666667;22;26;0.0416666666666666;0.458333333333333
Control.SRR15539829;46;45;0.58695652173913;19;27;0.0869565217391305;0.41304347826087
Control.SRR15539829;40;45;0.525;19;21;0.025;0.475
Control.SRR15539829;45;45;0.422222222222222;26;19;0.0777777777777778;0.422222222222222
Control.SRR15539829;43;45;0.302325581395349;30;13;0.197674418604651;0.302325581395349
Control.SRR15539829;39;45;0.538461538461538;18;21;0.0384615384615384;0.461538461538462
Control.SRR15539829;51;45;0.450980392156863;28;23;0.0490196078431372;0.450980392156863
Control.SRR15539829;51;45;0.392156862745098;31;20;0.107843137254902;0.392156862745098
Control.SRR15539829;45;45;0.511111111111111;22;23;0.0111111111111111;0.488888888888889
Control.SRR15539829;47;45;0.531914893617021;22;25;0.0319148936170213;0.468085106382979
Control.SRR15539829;47;45;0.51063829787234;23;24;0.0106382978723404;0.48936170212766
Control.SRR15539829;51;45;0.509803921568627;25;26;0.00980392156862742;0.490196078431373
Control.SRR15539829;49;45;0.448979591836735;27;22;0.0510204081632653;0.448979591836735
Control.SRR15539829;39;45;0.461538461538462;21;18;0.0384615384615384;0.461538461538462
Control.SRR15539829;40;45;0.5;20;20;0;0.5
Control.SRR15539829;51;45;0.529411764705882;24;27;0.0294117647058824;0.470588235294118
Control.SRR15539829;50;45;0.5;25;25;0;0.5
Control.SRR15539829;40;45;0.575;17;23;0.075;0.425
Control.SRR15539829;49;45;0.571428571428571;21;28;0.0714285714285714;0.428571428571429
Control.SRR15539829;49;45;0.469387755102041;26;23;0.0306122448979592;0.469387755102041
Control.SRR15539829;48;45;0.4375;27;21;0.0625;0.4375
Control.SRR15539829;51;45;0.470588235294118;27;24;0.0294117647058824;0.470588235294118
Control.SRR15539829;42;45;0.619047619047619;16;26;0.119047619047619;0.380952380952381
Control.SRR15539829;42;45;0.547619047619048;19;23;0.0476190476190477;0.452380952380952
Control.SRR15539829;44;45;0.431818181818182;25;19;0.0681818181818182;0.431818181818182
Control.SRR15539829;42;45;0.547619047619048;19;23;0.0476190476190477;0.452380952380952
Control.SRR15539829;45;45;0.644444444444444;16;29;0.144444444444444;0.355555555555556
Control.SRR15539829;48;45;0.479166666666667;25;23;0.0208333333333333;0.479166666666667
Control.SRR15539829;43;45;0.627906976744186;16;27;0.127906976744186;0.372093023255814
Control.SRR15539829;42;45;0.642857142857143;15;27;0.142857142857143;0.357142857142857
Control.SRR15539829;41;45;0.51219512195122;20;21;0.0121951219512195;0.48780487804878
Control.SRR15539829;42;45;0.452380952380952;23;19;0.0476190476190476;0.452380952380952
Control.SRR15539829;39;45;0.538461538461538;18;21;0.0384615384615384;0.461538461538462
Control.SRR15539829;42;45;0.619047619047619;16;26;0.119047619047619;0.380952380952381
Control.SRR15539829;42;45;0.428571428571429;24;18;0.0714285714285715;0.428571428571429
Control.SRR15539829;45;45;0.4;27;18;0.1;0.4
Control.SRR15539829;43;45;0.488372093023256;22;21;0.0116279069767442;0.488372093023256
Control.SRR15539829;49;45;0.428571428571429;28;21;0.0714285714285715;0.428571428571429
Control.SRR15539829;47;45;0.553191489361702;21;26;0.0531914893617021;0.446808510638298
Control.SRR15539829;51;45;0.529411764705882;24;27;0.0294117647058824;0.470588235294118
Control.SRR15539829;50;45;0.58;21;29;0.08;0.42
Control.SRR15539829;46;45;0.5;23;23;0;0.5
Control.SRR15539829;47;45;0.51063829787234;23;24;0.0106382978723404;0.48936170212766
Control.SRR15539829;44;45;0.568181818181818;19;25;0.0681818181818182;0.431818181818182
Control.SRR15539829;41;45;0.414634146341463;24;17;0.0853658536585366;0.414634146341463
Control.SRR15539829;41;45;0.560975609756098;18;23;0.0609756097560976;0.439024390243902
Control.SRR15539829;44;45;0.454545454545455;24;20;0.0454545454545455;0.454545454545455
Control.SRR15539829;41;45;0.51219512195122;20;21;0.0121951219512195;0.48780487804878
Control.SRR15539829;51;45;0.549019607843137;23;28;0.0490196078431373;0.450980392156863
Control.SRR15539829;50;45;0.5;25;25;0;0.5
Control.SRR15539829;47;45;0.382978723404255;29;18;0.117021276595745;0.382978723404255
Control.SRR15539829;40;45;0.525;19;21;0.025;0.475
Control.SRR15539829;44;45;0.363636363636364;28;16;0.136363636363636;0.363636363636364
Control.SRR15539829;51;45;0.588235294117647;21;30;0.0882352941176471;0.411764705882353
Control.SRR15539829;44;45;0.477272727272727;23;21;0.0227272727272727;0.477272727272727
Control.SRR15539829;50;45;0.48;26;24;0.02;0.48
Control.SRR15539829;40;45;0.3;28;12;0.2;0.3
Control.SRR15539829;46;45;0.608695652173913;18;28;0.108695652173913;0.391304347826087
Control.SRR15539829;48;45;0.583333333333333;20;28;0.0833333333333334;0.416666666666667
Control.SRR15539829;42;45;0.476190476190476;22;20;0.0238095238095238;0.476190476190476
Control.SRR15539829;42;45;0.595238095238095;17;25;0.0952380952380952;0.404761904761905
Control.SRR15539829;48;45;0.5;24;24;0;0.5
Control.SRR15539829;49;45;0.551020408163265;22;27;0.0510204081632653;0.448979591836735
Control.SRR15539829;42;45;0.285714285714286;30;12;0.214285714285714;0.285714285714286
Control.SRR15539829;42;45;0.5;21;21;0;0.5
Control.SRR15539829;44;45;0.545454545454545;20;24;0.0454545454545454;0.454545454545455
Control.SRR15539829;45;45;0.466666666666667;24;21;0.0333333333333333;0.466666666666667
Control.SRR15539829;46;45;0.58695652173913;19;27;0.0869565217391305;0.41304347826087
Control.SRR15539829;49;45;0.571428571428571;21;28;0.0714285714285714;0.428571428571429
Control.SRR15539829;45;45;0.533333333333333;21;24;0.0333333333333333;0.466666666666667
Control.SRR15539829;40;45;0.45;22;18;0.05;0.45
Control.SRR15539829;39;45;0.538461538461538;18;21;0.0384615384615384;0.461538461538462
Control.SRR15539829;40;45;0.45;22;18;0.05;0.45
Control.SRR15539829;49;45;0.387755102040816;30;19;0.112244897959184;0.387755102040816
Control.SRR15539829;48;45;0.479166666666667;25;23;0.0208333333333333;0.479166666666667
Control.SRR15539829;51;45;0.490196078431373;26;25;0.00980392156862747;0.490196078431373
Control.SRR15539829;45;45;0.555555555555556;20;25;0.0555555555555556;0.444444444444444
Control.SRR15539829;45;45;0.555555555555556;20;25;0.0555555555555556;0.444444444444444
Control.SRR15539829;47;45;0.425531914893617;27;20;0.074468085106383;0.425531914893617
Control.SRR15539829;39;45;0.384615384615385;24;15;0.115384615384615;0.384615384615385
Control.SRR15539829;45;45;0.577777777777778;19;26;0.0777777777777777;0.422222222222222
Control.SRR15539829;40;45;0.425;23;17;0.075;0.425
Control.SRR15539829;45;45;0.577777777777778;19;26;0.0777777777777777;0.422222222222222
Control.SRR15539829;49;45;0.428571428571429;28;21;0.0714285714285715;0.428571428571429
Control.SRR15539829;45;45;0.555555555555556;20;25;0.0555555555555556;0.444444444444444
Control.SRR15539829;43;45;0.511627906976744;21;22;0.0116279069767442;0.488372093023256
Control.SRR15539829;43;45;0.511627906976744;21;22;0.0116279069767442;0.488372093023256
Control.SRR15539829;49;45;0.612244897959184;19;30;0.112244897959184;0.387755102040816
Control.SRR15539829;41;45;0.48780487804878;21;20;0.0121951219512195;0.48780487804878
Control.SRR15539829;44;45;0.659090909090909;15;29;0.159090909090909;0.340909090909091
Control.SRR15539829;45;45;0.533333333333333;21;24;0.0333333333333333;0.466666666666667
Control.SRR15539829;39;45;0.384615384615385;24;15;0.115384615384615;0.384615384615385
Control.SRR15539829;50;45;0.58;21;29;0.08;0.42
Control.SRR15539829;45;45;0.444444444444444;25;20;0.0555555555555556;0.444444444444444
Control.SRR15539829;48;45;0.541666666666667;22;26;0.0416666666666666;0.458333333333333
Control.SRR15539829;48;45;0.4375;27;21;0.0625;0.4375
Control.SRR15539829;43;45;0.511627906976744;21;22;0.0116279069767442;0.488372093023256
Control.SRR15539829;47;45;0.48936170212766;24;23;0.0106382978723404;0.48936170212766
Control.SRR15539829;48;45;0.541666666666667;22;26;0.0416666666666666;0.458333333333333
Control.SRR15539829;48;45;0.5625;21;27;0.0625;0.4375
Control.SRR15539829;44;45;0.295454545454545;31;13;0.204545454545455;0.295454545454545
Control.SRR15539829;44;45;0.590909090909091;18;26;0.0909090909090909;0.409090909090909
Control.SRR15539829;48;45;0.520833333333333;23;25;0.0208333333333334;0.479166666666667
Control.SRR15539829;42;45;0.547619047619048;19;23;0.0476190476190477;0.452380952380952
Control.SRR15539829;46;45;0.58695652173913;19;27;0.0869565217391305;0.41304347826087
Control.SRR15539829;44;45;0.522727272727273;21;23;0.0227272727272727;0.477272727272727
Control.SRR15539829;49;45;0.408163265306122;29;20;0.0918367346938775;0.408163265306122
Control.SRR15539829;51;45;0.450980392156863;28;23;0.0490196078431372;0.450980392156863
Control.SRR15539829;45;45;0.711111111111111;13;32;0.211111111111111;0.288888888888889
Control.SRR15539829;39;45;0.512820512820513;19;20;0.0128205128205128;0.487179487179487
Control.SRR15539829;47;45;0.617021276595745;18;29;0.117021276595745;0.382978723404255
Control.SRR15539829;50;45;0.4;30;20;0.1;0.4
Control.SRR15539829;40;45;0.5;20;20;0;0.5
Control.SRR15539829;40;45;0.575;17;23;0.075;0.425
Control.SRR15539829;51;45;0.529411764705882;24;27;0.0294117647058824;0.470588235294118
Control.SRR15539829;49;45;0.530612244897959;23;26;0.0306122448979592;0.469387755102041
Control.SRR15539829;48;45;0.354166666666667;31;17;0.145833333333333;0.354166666666667
Control.SRR15539829;50;45;0.52;24;26;0.02;0.48
Control.SRR15539829;41;45;0.51219512195122;20;21;0.0121951219512195;0.48780487804878
Control.SRR15539829;40;45;0.525;19;21;0.025;0.475
Control.SRR15539829;40;45;0.6;16;24;0.1;0.4
Control.SRR15539829;45;45;0.466666666666667;24;21;0.0333333333333333;0.466666666666667
Control.SRR15539829;44;45;0.590909090909091;18;26;0.0909090909090909;0.409090909090909
Control.SRR15539829;42;45;0.428571428571429;24;18;0.0714285714285715;0.428571428571429
Control.SRR15539829;47;45;0.531914893617021;22;25;0.0319148936170213;0.468085106382979
Control.SRR15539829;51;45;0.549019607843137;23;28;0.0490196078431373;0.450980392156863
Control.SRR15539829;50;45;0.48;26;24;0.02;0.48
Control.SRR15539829;40;45;0.55;18;22;0.05;0.45
Control.SRR15539829;46;45;0.543478260869565;21;25;0.0434782608695652;0.456521739130435
Control.SRR15539829;42;45;0.523809523809524;20;22;0.0238095238095238;0.476190476190476
Control.SRR15539829;40;45;0.575;17;23;0.075;0.425
Control.SRR15539829;39;45;0.512820512820513;19;20;0.0128205128205128;0.487179487179487
Control.SRR15539829;40;45;0.475;21;19;0.025;0.475
Control.SRR15539829;44;45;0.545454545454545;20;24;0.0454545454545454;0.454545454545455
Control.SRR15539829;47;45;0.531914893617021;22;25;0.0319148936170213;0.468085106382979
Control.SRR15539829;49;45;0.63265306122449;18;31;0.13265306122449;0.36734693877551
Control.SRR15539829;40;45;0.575;17;23;0.075;0.425
Control.SRR15539829;40;45;0.5;20;20;0;0.5
Control.SRR15539829;48;45;0.354166666666667;31;17;0.145833333333333;0.354166666666667
Control.SRR15539829;48;45;0.416666666666667;28;20;0.0833333333333333;0.416666666666667
Control.SRR15539829;40;45;0.425;23;17;0.075;0.425
Control.SRR15539829;41;45;0.536585365853659;19;22;0.0365853658536586;0.463414634146341
Control.SRR15539829;47;45;0.617021276595745;18;29;0.117021276595745;0.382978723404255
Control.SRR15539829;50;45;0.5;25;25;0;0.5
Control.SRR15539829;50;45;0.4;30;20;0.1;0.4
Control.SRR15539829;43;45;0.581395348837209;18;25;0.0813953488372093;0.418604651162791
Control.SRR15539829;51;45;0.588235294117647;21;30;0.0882352941176471;0.411764705882353
Control.SRR15539829;43;45;0.534883720930233;20;23;0.0348837209302325;0.465116279069767
Control.SRR15539829;42;45;0.428571428571429;24;18;0.0714285714285715;0.428571428571429
Control.SRR15539829;44;45;0.477272727272727;23;21;0.0227272727272727;0.477272727272727
Control.SRR15539829;41;45;0.585365853658537;17;24;0.0853658536585366;0.414634146341463
Control.SRR15539829;42;45;0.5;21;21;0;0.5
Control.SRR15539829;42;45;0.523809523809524;20;22;0.0238095238095238;0.476190476190476
Control.SRR15539829;43;45;0.534883720930233;20;23;0.0348837209302325;0.465116279069767
Control.SRR15539829;47;45;0.553191489361702;21;26;0.0531914893617021;0.446808510638298
Control.SRR15539829;44;45;0.568181818181818;19;25;0.0681818181818182;0.431818181818182
Control.SRR15539829;43;45;0.488372093023256;22;21;0.0116279069767442;0.488372093023256
Control.SRR15539829;51;45;0.450980392156863;28;23;0.0490196078431372;0.450980392156863
Control.SRR15539829;43;45;0.558139534883721;19;24;0.0581395348837209;0.441860465116279
Control.SRR15539829;48;45;0.5625;21;27;0.0625;0.4375
Control.SRR15539829;47;45;0.553191489361702;21;26;0.0531914893617021;0.446808510638298
Control.SRR15539829;44;45;0.590909090909091;18;26;0.0909090909090909;0.409090909090909
Control.SRR15539829;43;45;0.441860465116279;24;19;0.0581395348837209;0.441860465116279
Control.SRR15539829;39;45;0.256410256410256;29;10;0.243589743589744;0.256410256410256
Control.SRR15539829;50;45;0.38;31;19;0.12;0.38
Control.SRR15539829;51;45;0.568627450980392;22;29;0.0686274509803921;0.431372549019608
Control.SRR15539829;51;45;0.607843137254902;20;31;0.107843137254902;0.392156862745098
Control.SRR15539829;49;45;0.469387755102041;26;23;0.0306122448979592;0.469387755102041
Control.SRR15539829;47;45;0.48936170212766;24;23;0.0106382978723404;0.48936170212766
Control.SRR15539829;51;45;0.725490196078431;14;37;0.225490196078431;0.274509803921569
Control.SRR15539829;50;45;0.44;28;22;0.06;0.44
Control.SRR15539829;45;45;0.666666666666667;15;30;0.166666666666667;0.333333333333333
Control.SRR15539829;44;45;0.545454545454545;20;24;0.0454545454545454;0.454545454545455
Control.SRR15539829;48;45;0.520833333333333;23;25;0.0208333333333334;0.479166666666667
Control.SRR15539829;46;45;0.369565217391304;29;17;0.130434782608696;0.369565217391304
Control.SRR15539829;43;45;0.534883720930233;20;23;0.0348837209302325;0.465116279069767
Control.SRR15539829;46;45;0.565217391304348;20;26;0.0652173913043478;0.434782608695652
Control.SRR15539829;47;45;0.51063829787234;23;24;0.0106382978723404;0.48936170212766
Control.SRR15539829;42;45;0.523809523809524;20;22;0.0238095238095238;0.476190476190476
Control.SRR15539829;50;45;0.36;32;18;0.14;0.36
Control.SRR15539829;44;45;0.477272727272727;23;21;0.0227272727272727;0.477272727272727
Control.SRR15539829;39;45;0.461538461538462;21;18;0.0384615384615384;0.461538461538462
Control.SRR15539829;46;45;0.41304347826087;27;19;0.0869565217391304;0.41304347826087
Control.SRR15539829;39;45;0.512820512820513;19;20;0.0128205128205128;0.487179487179487
Control.SRR15539829;40;45;0.475;21;19;0.025;0.475
Control.SRR15539829;43;45;0.488372093023256;22;21;0.0116279069767442;0.488372093023256
Control.SRR15539829;44;45;0.477272727272727;23;21;0.0227272727272727;0.477272727272727
Control.SRR15539829;50;45;0.54;23;27;0.04;0.46
Control.SRR15539829;43;45;0.418604651162791;25;18;0.0813953488372093;0.418604651162791
Control.SRR15539829;45;45;0.555555555555556;20;25;0.0555555555555556;0.444444444444444
Control.SRR15539829;45;45;0.444444444444444;25;20;0.0555555555555556;0.444444444444444
Control.SRR15539829;50;45;0.48;26;24;0.02;0.48
Control.SRR15539829;48;45;0.4375;27;21;0.0625;0.4375
Control.SRR15539829;49;45;0.551020408163265;22;27;0.0510204081632653;0.448979591836735
Control.SRR15539829;49;45;0.448979591836735;27;22;0.0510204081632653;0.448979591836735
Control.SRR15539829;44;45;0.545454545454545;20;24;0.0454545454545454;0.454545454545455
Control.SRR15539829;39;45;0.58974358974359;16;23;0.0897435897435898;0.41025641025641
Control.SRR15539829;50;45;0.46;27;23;0.04;0.46
Control.SRR15539829;42;45;0.523809523809524;20;22;0.0238095238095238;0.476190476190476
Control.SRR15539829;40;45;0.525;19;21;0.025;0.475
Control.SRR15539829;49;45;0.63265306122449;18;31;0.13265306122449;0.36734693877551
Control.SRR15539829;51;45;0.588235294117647;21;30;0.0882352941176471;0.411764705882353
Control.SRR15539829;50;45;0.5;25;25;0;0.5
Control.SRR15539829;48;45;0.5625;21;27;0.0625;0.4375
Control.SRR15539829;45;45;0.488888888888889;23;22;0.0111111111111111;0.488888888888889
Control.SRR15539829;40;45;0.575;17;23;0.075;0.425
Control.SRR15539829;41;45;0.560975609756098;18;23;0.0609756097560976;0.439024390243902
Control.SRR15539829;47;45;0.51063829787234;23;24;0.0106382978723404;0.48936170212766
Control.SRR15539829;50;45;0.42;29;21;0.08;0.42
Control.SRR15539829;48;45;0.458333333333333;26;22;0.0416666666666667;0.458333333333333
Control.SRR15539829;44;45;0.477272727272727;23;21;0.0227272727272727;0.477272727272727
Control.SRR15539829;42;45;0.642857142857143;15;27;0.142857142857143;0.357142857142857
Control.SRR15539829;43;45;0.558139534883721;19;24;0.0581395348837209;0.441860465116279
Control.SRR15539829;51;45;0.529411764705882;24;27;0.0294117647058824;0.470588235294118
Control.SRR15539829;48;45;0.541666666666667;22;26;0.0416666666666666;0.458333333333333
Control.SRR15539829;41;45;0.48780487804878;21;20;0.0121951219512195;0.48780487804878
Control.SRR15539829;48;45;0.333333333333333;32;16;0.166666666666667;0.333333333333333
Control.SRR15539829;40;45;0.65;14;26;0.15;0.35
Control.SRR15539829;40;45;0.625;15;25;0.125;0.375
Control.SRR15539829;44;45;0.363636363636364;28;16;0.136363636363636;0.363636363636364
Control.SRR15539829;50;45;0.52;24;26;0.02;0.48
Control.SRR15539829;41;45;0.560975609756098;18;23;0.0609756097560976;0.439024390243902
Control.SRR15539829;50;45;0.56;22;28;0.0600000000000001;0.44
Control.SRR15539829;49;45;0.469387755102041;26;23;0.0306122448979592;0.469387755102041
Control.SRR15539829;51;45;0.568627450980392;22;29;0.0686274509803921;0.431372549019608
Control.SRR15539829;48;45;0.4375;27;21;0.0625;0.4375
Control.SRR15539829;49;45;0.408163265306122;29;20;0.0918367346938775;0.408163265306122
Control.SRR15539829;49;45;0.489795918367347;25;24;0.0102040816326531;0.489795918367347
Control.SRR15539829;40;45;0.45;22;18;0.05;0.45
Control.SRR15539829;49;45;0.571428571428571;21;28;0.0714285714285714;0.428571428571429
Control.SRR15539829;44;45;0.477272727272727;23;21;0.0227272727272727;0.477272727272727
Control.SRR15539829;40;45;0.525;19;21;0.025;0.475
Control.SRR15539829;41;45;0.48780487804878;21;20;0.0121951219512195;0.48780487804878
Control.SRR15539829;41;45;0.439024390243902;23;18;0.0609756097560976;0.439024390243902
Control.SRR15539829;41;45;0.585365853658537;17;24;0.0853658536585366;0.414634146341463
Control.SRR15539829;49;45;0.530612244897959;23;26;0.0306122448979592;0.469387755102041
Control.SRR15539829;49;45;0.551020408163265;22;27;0.0510204081632653;0.448979591836735
Control.SRR15539829;47;45;0.531914893617021;22;25;0.0319148936170213;0.468085106382979
Control.SRR15539829;44;45;0.522727272727273;21;23;0.0227272727272727;0.477272727272727
Control.SRR15539829;51;45;0.568627450980392;22;29;0.0686274509803921;0.431372549019608
Control.SRR15539829;46;45;0.456521739130435;25;21;0.0434782608695652;0.456521739130435
Control.SRR15539829;43;45;0.395348837209302;26;17;0.104651162790698;0.395348837209302
Control.SRR15539829;51;45;0.568627450980392;22;29;0.0686274509803921;0.431372549019608
Control.SRR15539829;42;45;0.333333333333333;28;14;0.166666666666667;0.333333333333333
Control.SRR15539829;48;45;0.583333333333333;20;28;0.0833333333333334;0.416666666666667
Control.SRR15539829;48;45;0.604166666666667;19;29;0.104166666666667;0.395833333333333
Control.SRR15539829;47;45;0.553191489361702;21;26;0.0531914893617021;0.446808510638298
Control.SRR15539829;41;45;0.439024390243902;23;18;0.0609756097560976;0.439024390243902
Control.SRR15539829;41;45;0.536585365853659;19;22;0.0365853658536586;0.463414634146341
Control.SRR15539829;49;45;0.469387755102041;26;23;0.0306122448979592;0.469387755102041
Control.SRR15539829;41;45;0.560975609756098;18;23;0.0609756097560976;0.439024390243902
Control.SRR15539829;50;45;0.5;25;25;0;0.5
Control.SRR15539829;42;45;0.476190476190476;22;20;0.0238095238095238;0.476190476190476
Control.SRR15539829;47;45;0.553191489361702;21;26;0.0531914893617021;0.446808510638298
Control.SRR15539829;49;45;0.612244897959184;19;30;0.112244897959184;0.387755102040816
Control.SRR15539829;42;45;0.619047619047619;16;26;0.119047619047619;0.380952380952381
Control.SRR15539829;40;45;0.65;14;26;0.15;0.35
Control.SRR15539829;48;45;0.625;18;30;0.125;0.375
Control.SRR15539829;50;45;0.44;28;22;0.06;0.44
Control.SRR15539829;44;45;0.477272727272727;23;21;0.0227272727272727;0.477272727272727
Control.SRR15539829;46;45;0.521739130434783;22;24;0.0217391304347826;0.478260869565217
Control.SRR15539829;47;45;0.468085106382979;25;22;0.0319148936170213;0.468085106382979
Control.SRR15539829;50;45;0.6;20;30;0.1;0.4
Control.SRR15539829;42;45;0.571428571428571;18;24;0.0714285714285714;0.428571428571429
Control.SRR15539829;41;45;0.51219512195122;20;21;0.0121951219512195;0.48780487804878
Control.SRR15539829;48;45;0.479166666666667;25;23;0.0208333333333333;0.479166666666667
Control.SRR15539829;43;45;0.418604651162791;25;18;0.0813953488372093;0.418604651162791
Control.SRR15539829;47;45;0.553191489361702;21;26;0.0531914893617021;0.446808510638298
Control.SRR15539829;50;45;0.54;23;27;0.04;0.46
Control.SRR15539829;42;45;0.404761904761905;25;17;0.0952380952380952;0.404761904761905
Control.SRR15539829;47;45;0.48936170212766;24;23;0.0106382978723404;0.48936170212766
Control.SRR15539829;46;45;0.543478260869565;21;25;0.0434782608695652;0.456521739130435
Control.SRR15539829;46;45;0.543478260869565;21;25;0.0434782608695652;0.456521739130435
Control.SRR15539829;48;45;0.458333333333333;26;22;0.0416666666666667;0.458333333333333
Control.SRR15539829;47;45;0.531914893617021;22;25;0.0319148936170213;0.468085106382979
Control.SRR15539829;49;45;0.510204081632653;24;25;0.0102040816326531;0.489795918367347
Control.SRR15539829;50;45;0.4;30;20;0.1;0.4
Control.SRR15539829;51;45;0.470588235294118;27;24;0.0294117647058824;0.470588235294118
Control.SRR15539829;39;45;0.487179487179487;20;19;0.0128205128205128;0.487179487179487
Control.SRR15539829;51;45;0.549019607843137;23;28;0.0490196078431373;0.450980392156863
Control.SRR15539829;40;45;0.45;22;18;0.05;0.45
Control.SRR15539829;41;45;0.48780487804878;21;20;0.0121951219512195;0.48780487804878
Control.SRR15539829;44;45;0.477272727272727;23;21;0.0227272727272727;0.477272727272727
Control.SRR15539829;49;45;0.428571428571429;28;21;0.0714285714285715;0.428571428571429
Control.SRR15539829;51;45;0.431372549019608;29;22;0.0686274509803921;0.431372549019608
Control.SRR15539829;43;45;0.488372093023256;22;21;0.0116279069767442;0.488372093023256
Control.SRR15539829;42;45;0.547619047619048;19;23;0.0476190476190477;0.452380952380952
Control.SRR15539829;48;45;0.4375;27;21;0.0625;0.4375
Control.SRR15539829;51;45;0.411764705882353;30;21;0.0882352941176471;0.411764705882353
Control.SRR15539829;48;45;0.479166666666667;25;23;0.0208333333333333;0.479166666666667
Control.SRR15539829;45;45;0.377777777777778;28;17;0.122222222222222;0.377777777777778
Control.SRR15539829;51;45;0.333333333333333;34;17;0.166666666666667;0.333333333333333
Control.SRR15539829;46;45;0.391304347826087;28;18;0.108695652173913;0.391304347826087
Control.SRR15539829;46;45;0.521739130434783;22;24;0.0217391304347826;0.478260869565217
Control.SRR15539829;48;45;0.541666666666667;22;26;0.0416666666666666;0.458333333333333
Control.SRR15539829;48;45;0.5625;21;27;0.0625;0.4375
Control.SRR15539829;40;45;0.425;23;17;0.075;0.425
Control.SRR15539829;41;45;0.51219512195122;20;21;0.0121951219512195;0.48780487804878
Control.SRR15539829;41;45;0.51219512195122;20;21;0.0121951219512195;0.48780487804878
Control.SRR15539829;42;45;0.5;21;21;0;0.5
Control.SRR15539829;41;45;0.536585365853659;19;22;0.0365853658536586;0.463414634146341
Control.SRR15539829;39;45;0.487179487179487;20;19;0.0128205128205128;0.487179487179487
Control.SRR15539829;43;45;0.511627906976744;21;22;0.0116279069767442;0.488372093023256
Control.SRR15539829;40;45;0.375;25;15;0.125;0.375
Control.SRR15539829;50;45;0.52;24;26;0.02;0.48
Control.SRR15539829;39;45;0.384615384615385;24;15;0.115384615384615;0.384615384615385
Control.SRR15539829;48;45;0.416666666666667;28;20;0.0833333333333333;0.416666666666667
Control.SRR15539829;44;45;0.5;22;22;0;0.5
Control.SRR15539829;40;45;0.475;21;19;0.025;0.475
Control.SRR15539829;47;45;0.48936170212766;24;23;0.0106382978723404;0.48936170212766
Control.SRR15539829;51;45;0.470588235294118;27;24;0.0294117647058824;0.470588235294118
Control.SRR15539829;40;45;0.575;17;23;0.075;0.425
Control.SRR15539829;44;45;0.545454545454545;20;24;0.0454545454545454;0.454545454545455
Control.SRR15539829;42;45;0.5;21;21;0;0.5
Control.SRR15539829;42;45;0.523809523809524;20;22;0.0238095238095238;0.476190476190476
Control.SRR15539829;40;45;0.525;19;21;0.025;0.475
Control.SRR15539829;44;45;0.477272727272727;23;21;0.0227272727272727;0.477272727272727
Control.SRR15539829;46;45;0.565217391304348;20;26;0.0652173913043478;0.434782608695652
Control.SRR15539829;49;45;0.489795918367347;25;24;0.0102040816326531;0.489795918367347
Control.SRR15539829;50;45;0.6;20;30;0.1;0.4
Control.SRR15539829;42;45;0.476190476190476;22;20;0.0238095238095238;0.476190476190476
Control.SRR15539829;46;45;0.456521739130435;25;21;0.0434782608695652;0.456521739130435
Control.SRR15539829;49;45;0.530612244897959;23;26;0.0306122448979592;0.469387755102041
Control.SRR15539829;49;45;0.489795918367347;25;24;0.0102040816326531;0.489795918367347
Control.SRR15539829;47;45;0.531914893617021;22;25;0.0319148936170213;0.468085106382979
Control.SRR15539829;46;45;0.543478260869565;21;25;0.0434782608695652;0.456521739130435
Control.SRR15539829;42;45;0.547619047619048;19;23;0.0476190476190477;0.452380952380952
Control.SRR15539829;46;45;0.391304347826087;28;18;0.108695652173913;0.391304347826087
Control.SRR15539829;45;45;0.555555555555556;20;25;0.0555555555555556;0.444444444444444
Control.SRR15539829;44;45;0.454545454545455;24;20;0.0454545454545455;0.454545454545455
Control.SRR15539829;42;45;0.5;21;21;0;0.5
Control.SRR15539829;47;45;0.574468085106383;20;27;0.074468085106383;0.425531914893617
Control.SRR15539829;47;45;0.48936170212766;24;23;0.0106382978723404;0.48936170212766
Control.SRR15539829;50;45;0.42;29;21;0.08;0.42
Control.SRR15539829;46;45;0.521739130434783;22;24;0.0217391304347826;0.478260869565217
Control.SRR15539829;48;45;0.458333333333333;26;22;0.0416666666666667;0.458333333333333
Control.SRR15539829;46;45;0.565217391304348;20;26;0.0652173913043478;0.434782608695652
Control.SRR15539829;46;45;0.369565217391304;29;17;0.130434782608696;0.369565217391304
Control.SRR15539829;40;45;0.4;24;16;0.1;0.4
Control.SRR15539829;45;45;0.377777777777778;28;17;0.122222222222222;0.377777777777778
Control.SRR15539829;45;45;0.466666666666667;24;21;0.0333333333333333;0.466666666666667
Control.SRR15539829;47;45;0.531914893617021;22;25;0.0319148936170213;0.468085106382979
Control.SRR15539829;40;45;0.55;18;22;0.05;0.45
Control.SRR15539829;40;45;0.45;22;18;0.05;0.45
Control.SRR15539829;48;45;0.458333333333333;26;22;0.0416666666666667;0.458333333333333
Control.SRR15539829;43;45;0.534883720930233;20;23;0.0348837209302325;0.465116279069767
Control.SRR15539829;49;45;0.571428571428571;21;28;0.0714285714285714;0.428571428571429
Control.SRR15539829;49;45;0.428571428571429;28;21;0.0714285714285715;0.428571428571429
Control.SRR15539829;51;45;0.529411764705882;24;27;0.0294117647058824;0.470588235294118
Control.SRR15539829;46;45;0.5;23;23;0;0.5
Control.SRR15539829;47;45;0.553191489361702;21;26;0.0531914893617021;0.446808510638298
Control.SRR15539829;48;45;0.479166666666667;25;23;0.0208333333333333;0.479166666666667
Control.SRR15539829;47;45;0.425531914893617;27;20;0.074468085106383;0.425531914893617
Control.SRR15539829;47;45;0.48936170212766;24;23;0.0106382978723404;0.48936170212766
Control.SRR15539829;48;45;0.5625;21;27;0.0625;0.4375
Control.SRR15539829;40;45;0.325;27;13;0.175;0.325
Control.SRR15539829;48;45;0.5625;21;27;0.0625;0.4375
Control.SRR15539829;42;45;0.571428571428571;18;24;0.0714285714285714;0.428571428571429
Control.SRR15539829;43;45;0.627906976744186;16;27;0.127906976744186;0.372093023255814
Control.SRR15539829;50;45;0.48;26;24;0.02;0.48
Control.SRR15539829;48;45;0.4375;27;21;0.0625;0.4375
Control.SRR15539829;49;45;0.510204081632653;24;25;0.0102040816326531;0.489795918367347
Control.SRR15539829;42;45;0.547619047619048;19;23;0.0476190476190477;0.452380952380952
Control.SRR15539829;48;45;0.458333333333333;26;22;0.0416666666666667;0.458333333333333
Control.SRR15539829;48;45;0.520833333333333;23;25;0.0208333333333334;0.479166666666667
Control.SRR15539829;39;45;0.615384615384615;15;24;0.115384615384615;0.384615384615385
Control.SRR15539829;48;45;0.4375;27;21;0.0625;0.4375
Control.SRR15539829;51;45;0.470588235294118;27;24;0.0294117647058824;0.470588235294118
Control.SRR15539829;41;45;0.658536585365854;14;27;0.158536585365854;0.341463414634146
Control.SRR15539829;47;45;0.51063829787234;23;24;0.0106382978723404;0.48936170212766
Control.SRR15539829;41;45;0.48780487804878;21;20;0.0121951219512195;0.48780487804878
Control.SRR15539829;39;45;0.538461538461538;18;21;0.0384615384615384;0.461538461538462
Control.SRR15539829;50;45;0.52;24;26;0.02;0.48
Control.SRR15539829;51;45;0.431372549019608;29;22;0.0686274509803921;0.431372549019608
Control.SRR15539829;42;45;0.642857142857143;15;27;0.142857142857143;0.357142857142857
Control.SRR15539829;48;45;0.4375;27;21;0.0625;0.4375
Control.SRR15539829;51;45;0.411764705882353;30;21;0.0882352941176471;0.411764705882353
Control.SRR15539829;44;45;0.431818181818182;25;19;0.0681818181818182;0.431818181818182
Control.SRR15539829;50;45;0.54;23;27;0.04;0.46
Control.SRR15539829;49;45;0.489795918367347;25;24;0.0102040816326531;0.489795918367347
Control.SRR15539829;40;45;0.425;23;17;0.075;0.425
Control.SRR15539829;39;45;0.487179487179487;20;19;0.0128205128205128;0.487179487179487
Control.SRR15539829;44;45;0.568181818181818;19;25;0.0681818181818182;0.431818181818182
Control.SRR15539829;45;45;0.644444444444444;16;29;0.144444444444444;0.355555555555556
Control.SRR15539829;49;45;0.591836734693878;20;29;0.0918367346938775;0.408163265306122
Control.SRR15539829;42;45;0.5;21;21;0;0.5
Control.SRR15539829;51;45;0.509803921568627;25;26;0.00980392156862742;0.490196078431373
Control.SRR15539829;49;45;0.510204081632653;24;25;0.0102040816326531;0.489795918367347
Control.SRR15539829;47;45;0.468085106382979;25;22;0.0319148936170213;0.468085106382979
Control.SRR15539829;48;45;0.583333333333333;20;28;0.0833333333333334;0.416666666666667
Control.SRR15539829;46;45;0.543478260869565;21;25;0.0434782608695652;0.456521739130435
Control.SRR15539829;50;45;0.42;29;21;0.08;0.42
Control.SRR15539829;41;45;0.682926829268293;13;28;0.182926829268293;0.317073170731707
Control.SRR15539829;42;45;0.5;21;21;0;0.5
Control.SRR15539829;51;45;0.529411764705882;24;27;0.0294117647058824;0.470588235294118
Control.SRR15539829;45;45;0.422222222222222;26;19;0.0777777777777778;0.422222222222222
Control.SRR15539829;47;45;0.468085106382979;25;22;0.0319148936170213;0.468085106382979
Control.SRR15539829;50;45;0.54;23;27;0.04;0.46
Control.SRR15539829;50;45;0.56;22;28;0.0600000000000001;0.44
Control.SRR15539829;43;45;0.465116279069767;23;20;0.0348837209302326;0.465116279069767
Control.SRR15539829;40;45;0.45;22;18;0.05;0.45
Control.SRR15539829;46;45;0.565217391304348;20;26;0.0652173913043478;0.434782608695652
Control.SRR15539829;46;45;0.347826086956522;30;16;0.152173913043478;0.347826086956522
Control.SRR15539829;45;45;0.511111111111111;22;23;0.0111111111111111;0.488888888888889
Control.SRR15539829;42;45;0.523809523809524;20;22;0.0238095238095238;0.476190476190476
Control.SRR15539829;41;45;0.51219512195122;20;21;0.0121951219512195;0.48780487804878
Control.SRR15539829;46;45;0.5;23;23;0;0.5
Control.SRR15539829;41;45;0.51219512195122;20;21;0.0121951219512195;0.48780487804878
Control.SRR15539829;48;45;0.583333333333333;20;28;0.0833333333333334;0.416666666666667
Control.SRR15539829;45;45;0.6;18;27;0.1;0.4
Control.SRR15539829;45;45;0.577777777777778;19;26;0.0777777777777777;0.422222222222222
Control.SRR15539829;48;45;0.604166666666667;19;29;0.104166666666667;0.395833333333333
Control.SRR15539829;39;45;0.461538461538462;21;18;0.0384615384615384;0.461538461538462
Control.SRR15539829;46;45;0.565217391304348;20;26;0.0652173913043478;0.434782608695652
Control.SRR15539829;51;45;0.431372549019608;29;22;0.0686274509803921;0.431372549019608
Control.SRR15539829;49;45;0.469387755102041;26;23;0.0306122448979592;0.469387755102041
Control.SRR15539829;50;45;0.44;28;22;0.06;0.44
Control.SRR15539829;51;45;0.588235294117647;21;30;0.0882352941176471;0.411764705882353
Control.SRR15539829;40;45;0.55;18;22;0.05;0.45
Control.SRR15539829;47;45;0.595744680851064;19;28;0.0957446808510638;0.404255319148936
Control.SRR15539829;44;45;0.590909090909091;18;26;0.0909090909090909;0.409090909090909
Control.SRR15539829;40;45;0.55;18;22;0.05;0.45
Control.SRR15539829;48;45;0.479166666666667;25;23;0.0208333333333333;0.479166666666667
Control.SRR15539829;46;45;0.652173913043478;16;30;0.152173913043478;0.347826086956522
Control.SRR15539829;50;45;0.58;21;29;0.08;0.42
Control.SRR15539829;46;45;0.521739130434783;22;24;0.0217391304347826;0.478260869565217
Control.SRR15539829;49;45;0.448979591836735;27;22;0.0510204081632653;0.448979591836735
Control.SRR15539829;42;45;0.642857142857143;15;27;0.142857142857143;0.357142857142857
Control.SRR15539829;42;45;0.571428571428571;18;24;0.0714285714285714;0.428571428571429
Control.SRR15539829;45;45;0.622222222222222;17;28;0.122222222222222;0.377777777777778
Control.SRR15539829;44;45;0.590909090909091;18;26;0.0909090909090909;0.409090909090909
Control.SRR15539829;45;45;0.444444444444444;25;20;0.0555555555555556;0.444444444444444
Control.SRR15539829;44;45;0.568181818181818;19;25;0.0681818181818182;0.431818181818182
Control.SRR15539829;41;45;0.463414634146341;22;19;0.0365853658536585;0.463414634146341
Control.SRR15539829;46;45;0.5;23;23;0;0.5
Control.SRR15539829;45;45;0.555555555555556;20;25;0.0555555555555556;0.444444444444444
Control.SRR15539829;50;45;0.68;16;34;0.18;0.32
Control.SRR15539829;43;45;0.488372093023256;22;21;0.0116279069767442;0.488372093023256
Control.SRR15539829;45;45;0.422222222222222;26;19;0.0777777777777778;0.422222222222222
Control.SRR15539829;46;45;0.41304347826087;27;19;0.0869565217391304;0.41304347826087
Control.SRR15539829;50;45;0.54;23;27;0.04;0.46
Control.SRR15539829;40;45;0.475;21;19;0.025;0.475
Control.SRR15539829;48;45;0.520833333333333;23;25;0.0208333333333334;0.479166666666667
Control.SRR15539829;48;45;0.333333333333333;32;16;0.166666666666667;0.333333333333333
Control.SRR15539829;50;45;0.56;22;28;0.0600000000000001;0.44
Control.SRR15539829;39;45;0.615384615384615;15;24;0.115384615384615;0.384615384615385
Control.SRR15539829;46;45;0.434782608695652;26;20;0.0652173913043478;0.434782608695652
Control.SRR15539829;40;45;0.525;19;21;0.025;0.475
Control.SRR15539829;48;45;0.541666666666667;22;26;0.0416666666666666;0.458333333333333
Control.SRR15539829;51;45;0.509803921568627;25;26;0.00980392156862742;0.490196078431373
Control.SRR15539829;48;45;0.625;18;30;0.125;0.375
Control.SRR15539829;48;45;0.458333333333333;26;22;0.0416666666666667;0.458333333333333
Control.SRR15539829;50;45;0.44;28;22;0.06;0.44
Control.SRR15539829;49;45;0.469387755102041;26;23;0.0306122448979592;0.469387755102041
Control.SRR15539829;46;45;0.521739130434783;22;24;0.0217391304347826;0.478260869565217
Control.SRR15539829;43;45;0.581395348837209;18;25;0.0813953488372093;0.418604651162791
Control.SRR15539829;47;45;0.468085106382979;25;22;0.0319148936170213;0.468085106382979
Control.SRR15539829;43;45;0.558139534883721;19;24;0.0581395348837209;0.441860465116279
Control.SRR15539829;43;45;0.418604651162791;25;18;0.0813953488372093;0.418604651162791
Control.SRR15539829;48;45;0.354166666666667;31;17;0.145833333333333;0.354166666666667
Control.SRR15539829;45;45;0.6;18;27;0.1;0.4
Control.SRR15539829;49;45;0.510204081632653;24;25;0.0102040816326531;0.489795918367347
Control.SRR15539829;45;45;0.577777777777778;19;26;0.0777777777777777;0.422222222222222
Control.SRR15539829;51;45;0.411764705882353;30;21;0.0882352941176471;0.411764705882353
Control.SRR15539829;44;45;0.431818181818182;25;19;0.0681818181818182;0.431818181818182
Control.SRR15539829;41;45;0.51219512195122;20;21;0.0121951219512195;0.48780487804878
Control.SRR15539829;46;45;0.5;23;23;0;0.5
Control.SRR15539829;40;45;0.575;17;23;0.075;0.425
Control.SRR15539829;48;45;0.541666666666667;22;26;0.0416666666666666;0.458333333333333
Control.SRR15539829;47;45;0.468085106382979;25;22;0.0319148936170213;0.468085106382979
Control.SRR15539829;40;45;0.475;21;19;0.025;0.475
Control.SRR15539829;42;45;0.5;21;21;0;0.5
Control.SRR15539829;44;45;0.409090909090909;26;18;0.0909090909090909;0.409090909090909
Control.SRR15539829;46;45;0.608695652173913;18;28;0.108695652173913;0.391304347826087
Control.SRR15539829;48;45;0.520833333333333;23;25;0.0208333333333334;0.479166666666667
Control.SRR15539829;44;45;0.386363636363636;27;17;0.113636363636364;0.386363636363636
Control.SRR15539829;47;45;0.446808510638298;26;21;0.0531914893617021;0.446808510638298
Control.SRR15539829;51;45;0.568627450980392;22;29;0.0686274509803921;0.431372549019608
Control.SRR15539829;49;45;0.510204081632653;24;25;0.0102040816326531;0.489795918367347
Control.SRR15539829;44;45;0.431818181818182;25;19;0.0681818181818182;0.431818181818182
Control.SRR15539829;45;45;0.555555555555556;20;25;0.0555555555555556;0.444444444444444
Control.SRR15539829;48;45;0.5625;21;27;0.0625;0.4375
Control.SRR15539829;41;45;0.390243902439024;25;16;0.109756097560976;0.390243902439024
Control.SRR15539829;46;45;0.58695652173913;19;27;0.0869565217391305;0.41304347826087
Control.SRR15539829;44;45;0.522727272727273;21;23;0.0227272727272727;0.477272727272727
Control.SRR15539829;43;45;0.441860465116279;24;19;0.0581395348837209;0.441860465116279
Control.SRR15539829;46;45;0.456521739130435;25;21;0.0434782608695652;0.456521739130435
Control.SRR15539829;47;45;0.48936170212766;24;23;0.0106382978723404;0.48936170212766
Control.SRR15539829;46;45;0.608695652173913;18;28;0.108695652173913;0.391304347826087
Control.SRR15539829;47;45;0.468085106382979;25;22;0.0319148936170213;0.468085106382979
Control.SRR15539829;47;45;0.48936170212766;24;23;0.0106382978723404;0.48936170212766
Control.SRR15539829;44;45;0.454545454545455;24;20;0.0454545454545455;0.454545454545455
Control.SRR15539829;45;45;0.466666666666667;24;21;0.0333333333333333;0.466666666666667
Control.SRR15539829;43;45;0.511627906976744;21;22;0.0116279069767442;0.488372093023256
Control.SRR15539829;43;45;0.511627906976744;21;22;0.0116279069767442;0.488372093023256
Control.SRR15539829;46;45;0.652173913043478;16;30;0.152173913043478;0.347826086956522
Control.SRR15539829;48;45;0.520833333333333;23;25;0.0208333333333334;0.479166666666667
Control.SRR15539829;43;45;0.488372093023256;22;21;0.0116279069767442;0.488372093023256
Control.SRR15539829;42;45;0.380952380952381;26;16;0.119047619047619;0.380952380952381
Control.SRR15539829;40;45;0.425;23;17;0.075;0.425
Control.SRR15539829;47;45;0.48936170212766;24;23;0.0106382978723404;0.48936170212766
Control.SRR15539829;44;45;0.659090909090909;15;29;0.159090909090909;0.340909090909091
Control.SRR15539829;48;45;0.5625;21;27;0.0625;0.4375
Control.SRR15539829;50;45;0.58;21;29;0.08;0.42
Control.SRR15539829;43;45;0.441860465116279;24;19;0.0581395348837209;0.441860465116279
Control.SRR15539829;51;45;0.549019607843137;23;28;0.0490196078431373;0.450980392156863
Control.SRR15539829;45;45;0.444444444444444;25;20;0.0555555555555556;0.444444444444444
Control.SRR15539829;47;45;0.51063829787234;23;24;0.0106382978723404;0.48936170212766
Control.SRR15539829;42;45;0.595238095238095;17;25;0.0952380952380952;0.404761904761905
Control.SRR15539829;44;45;0.522727272727273;21;23;0.0227272727272727;0.477272727272727
Control.SRR15539829;44;45;0.5;22;22;0;0.5
Control.SRR15539829;42;45;0.571428571428571;18;24;0.0714285714285714;0.428571428571429
Control.SRR15539829;41;45;0.560975609756098;18;23;0.0609756097560976;0.439024390243902
Control.SRR15539829;44;45;0.545454545454545;20;24;0.0454545454545454;0.454545454545455
Control.SRR15539829;39;45;0.564102564102564;17;22;0.0641025641025641;0.435897435897436
Control.SRR15539829;50;45;0.48;26;24;0.02;0.48
Control.SRR15539829;49;45;0.489795918367347;25;24;0.0102040816326531;0.489795918367347
Control.SRR15539829;45;45;0.511111111111111;22;23;0.0111111111111111;0.488888888888889
Control.SRR15539829;39;45;0.564102564102564;17;22;0.0641025641025641;0.435897435897436
Control.SRR15539829;46;45;0.543478260869565;21;25;0.0434782608695652;0.456521739130435
Control.SRR15539829;50;45;0.52;24;26;0.02;0.48
Control.SRR15539829;48;45;0.395833333333333;29;19;0.104166666666667;0.395833333333333
Control.SRR15539829;48;45;0.5;24;24;0;0.5
Control.SRR15539829;48;45;0.458333333333333;26;22;0.0416666666666667;0.458333333333333
Control.SRR15539829;43;45;0.488372093023256;22;21;0.0116279069767442;0.488372093023256
Control.SRR15539829;42;45;0.5;21;21;0;0.5
Control.SRR15539829;41;45;0.48780487804878;21;20;0.0121951219512195;0.48780487804878
Control.SRR15539829;50;45;0.5;25;25;0;0.5
Control.SRR15539829;46;45;0.565217391304348;20;26;0.0652173913043478;0.434782608695652
Control.SRR15539829;39;45;0.358974358974359;25;14;0.141025641025641;0.358974358974359
Control.SRR15539829;43;45;0.465116279069767;23;20;0.0348837209302326;0.465116279069767
Control.SRR15539829;43;45;0.604651162790698;17;26;0.104651162790698;0.395348837209302
Control.SRR15539829;43;45;0.627906976744186;16;27;0.127906976744186;0.372093023255814
Control.SRR15539829;40;45;0.6;16;24;0.1;0.4
Control.SRR15539829;40;45;0.65;14;26;0.15;0.35
Control.SRR15539829;46;45;0.456521739130435;25;21;0.0434782608695652;0.456521739130435
Control.SRR15539829;41;45;0.51219512195122;20;21;0.0121951219512195;0.48780487804878
Control.SRR15539829;43;45;0.558139534883721;19;24;0.0581395348837209;0.441860465116279
Control.SRR15539829;47;45;0.51063829787234;23;24;0.0106382978723404;0.48936170212766
Control.SRR15539829;42;45;0.452380952380952;23;19;0.0476190476190476;0.452380952380952
Control.SRR15539829;51;45;0.549019607843137;23;28;0.0490196078431373;0.450980392156863
Control.SRR15539829;45;45;0.377777777777778;28;17;0.122222222222222;0.377777777777778
Control.SRR15539829;46;45;0.478260869565217;24;22;0.0217391304347826;0.478260869565217
Control.SRR15539829;42;45;0.428571428571429;24;18;0.0714285714285715;0.428571428571429
Control.SRR15539829;41;45;0.560975609756098;18;23;0.0609756097560976;0.439024390243902
Control.SRR15539829;46;45;0.521739130434783;22;24;0.0217391304347826;0.478260869565217
Control.SRR15539829;44;45;0.636363636363636;16;28;0.136363636363636;0.363636363636364
Control.SRR15539829;41;45;0.341463414634146;27;14;0.158536585365854;0.341463414634146
Control.SRR15539829;50;45;0.56;22;28;0.0600000000000001;0.44
Control.SRR15539829;50;45;0.4;30;20;0.1;0.4
Control.SRR15539829;49;45;0.36734693877551;31;18;0.13265306122449;0.36734693877551
Control.SRR15539829;46;45;0.347826086956522;30;16;0.152173913043478;0.347826086956522
Control.SRR15539829;48;45;0.5;24;24;0;0.5
Control.SRR15539829;41;45;0.536585365853659;19;22;0.0365853658536586;0.463414634146341
Control.SRR15539829;42;45;0.476190476190476;22;20;0.0238095238095238;0.476190476190476
Control.SRR15539829;50;45;0.54;23;27;0.04;0.46
Control.SRR15539829;50;45;0.52;24;26;0.02;0.48
Control.SRR15539829;40;45;0.45;22;18;0.05;0.45
Control.SRR15539829;41;45;0.51219512195122;20;21;0.0121951219512195;0.48780487804878
Control.SRR15539829;40;45;0.625;15;25;0.125;0.375
Control.SRR15539829;48;45;0.541666666666667;22;26;0.0416666666666666;0.458333333333333
Control.SRR15539829;40;45;0.5;20;20;0;0.5
Control.SRR15539829;47;45;0.574468085106383;20;27;0.074468085106383;0.425531914893617
Control.SRR15539829;46;45;0.456521739130435;25;21;0.0434782608695652;0.456521739130435
Control.SRR15539829;43;45;0.511627906976744;21;22;0.0116279069767442;0.488372093023256
Control.SRR15539829;50;45;0.48;26;24;0.02;0.48
Control.SRR15539829;46;45;0.695652173913043;14;32;0.195652173913043;0.304347826086957
Control.SRR15539829;51;45;0.372549019607843;32;19;0.127450980392157;0.372549019607843
Control.SRR15539829;44;45;0.568181818181818;19;25;0.0681818181818182;0.431818181818182
Control.SRR15539829;48;45;0.625;18;30;0.125;0.375
Control.SRR15539829;44;45;0.454545454545455;24;20;0.0454545454545455;0.454545454545455
Control.SRR15539829;39;45;0.717948717948718;11;28;0.217948717948718;0.282051282051282
Control.SRR15539829;51;45;0.470588235294118;27;24;0.0294117647058824;0.470588235294118
Control.SRR15539829;43;45;0.627906976744186;16;27;0.127906976744186;0.372093023255814
Control.SRR15539829;42;45;0.5;21;21;0;0.5
Control.SRR15539829;39;45;0.487179487179487;20;19;0.0128205128205128;0.487179487179487
Control.SRR15539829;46;45;0.543478260869565;21;25;0.0434782608695652;0.456521739130435
Control.SRR15539829;47;45;0.48936170212766;24;23;0.0106382978723404;0.48936170212766
Control.SRR15539829;50;45;0.44;28;22;0.06;0.44
Control.SRR15539829;47;45;0.468085106382979;25;22;0.0319148936170213;0.468085106382979
Control.SRR15539829;42;45;0.5;21;21;0;0.5
Control.SRR15539829;43;45;0.558139534883721;19;24;0.0581395348837209;0.441860465116279
Control.SRR15539829;42;45;0.642857142857143;15;27;0.142857142857143;0.357142857142857
Control.SRR15539829;46;45;0.391304347826087;28;18;0.108695652173913;0.391304347826087
Control.SRR15539829;47;45;0.48936170212766;24;23;0.0106382978723404;0.48936170212766
Control.SRR15539829;42;45;0.571428571428571;18;24;0.0714285714285714;0.428571428571429
Control.SRR15539829;44;45;0.5;22;22;0;0.5
Control.SRR15539829;42;45;0.571428571428571;18;24;0.0714285714285714;0.428571428571429
Control.SRR15539829;51;45;0.627450980392157;19;32;0.127450980392157;0.372549019607843
Control.SRR15539829;41;45;0.390243902439024;25;16;0.109756097560976;0.390243902439024
Control.SRR15539829;41;45;0.439024390243902;23;18;0.0609756097560976;0.439024390243902
Control.SRR15539829;51;45;0.411764705882353;30;21;0.0882352941176471;0.411764705882353
Control.SRR15539829;48;45;0.479166666666667;25;23;0.0208333333333333;0.479166666666667
Control.SRR15539829;44;45;0.545454545454545;20;24;0.0454545454545454;0.454545454545455
Control.SRR15539829;50;45;0.48;26;24;0.02;0.48
Control.SRR15539829;48;45;0.5;24;24;0;0.5
Control.SRR15539829;51;45;0.509803921568627;25;26;0.00980392156862742;0.490196078431373
Control.SRR15539829;46;45;0.543478260869565;21;25;0.0434782608695652;0.456521739130435
Control.SRR15539829;46;45;0.521739130434783;22;24;0.0217391304347826;0.478260869565217
Control.SRR15539829;48;45;0.520833333333333;23;25;0.0208333333333334;0.479166666666667
Control.SRR15539829;44;45;0.454545454545455;24;20;0.0454545454545455;0.454545454545455
Control.SRR15539829;49;45;0.551020408163265;22;27;0.0510204081632653;0.448979591836735
Control.SRR15539829;47;45;0.48936170212766;24;23;0.0106382978723404;0.48936170212766
Control.SRR15539829;45;45;0.733333333333333;12;33;0.233333333333333;0.266666666666667
Control.SRR15539829;45;45;0.444444444444444;25;20;0.0555555555555556;0.444444444444444
Control.SRR15539829;41;45;0.536585365853659;19;22;0.0365853658536586;0.463414634146341
Control.SRR15539829;50;45;0.52;24;26;0.02;0.48
Control.SRR15539829;39;45;0.461538461538462;21;18;0.0384615384615384;0.461538461538462
Control.SRR15539829;45;45;0.466666666666667;24;21;0.0333333333333333;0.466666666666667
Control.SRR15539829;48;45;0.520833333333333;23;25;0.0208333333333334;0.479166666666667
Control.SRR15539829;42;45;0.5;21;21;0;0.5
Control.SRR15539829;40;45;0.425;23;17;0.075;0.425
Control.SRR15539829;43;45;0.441860465116279;24;19;0.0581395348837209;0.441860465116279
Control.SRR15539829;41;45;0.609756097560976;16;25;0.109756097560976;0.390243902439024
Control.SRR15539829;43;45;0.627906976744186;16;27;0.127906976744186;0.372093023255814
Control.SRR15539829;41;45;0.707317073170732;12;29;0.207317073170732;0.292682926829268
Control.SRR15539829;49;45;0.489795918367347;25;24;0.0102040816326531;0.489795918367347
Control.SRR15539829;43;45;0.441860465116279;24;19;0.0581395348837209;0.441860465116279
Control.SRR15539829;45;45;0.466666666666667;24;21;0.0333333333333333;0.466666666666667
Control.SRR15539829;49;45;0.571428571428571;21;28;0.0714285714285714;0.428571428571429
Control.SRR15539829;41;45;0.560975609756098;18;23;0.0609756097560976;0.439024390243902
Control.SRR15539829;48;45;0.541666666666667;22;26;0.0416666666666666;0.458333333333333
Control.SRR15539829;50;45;0.64;18;32;0.14;0.36
Control.SRR15539829;50;45;0.5;25;25;0;0.5
Control.SRR15539829;48;45;0.5;24;24;0;0.5
Control.SRR15539829;50;45;0.58;21;29;0.08;0.42
Control.SRR15539829;50;45;0.46;27;23;0.04;0.46
Control.SRR15539829;40;45;0.55;18;22;0.05;0.45
Control.SRR15539829;41;45;0.463414634146341;22;19;0.0365853658536585;0.463414634146341
Control.SRR15539829;41;45;0.609756097560976;16;25;0.109756097560976;0.390243902439024
Control.SRR15539829;44;45;0.568181818181818;19;25;0.0681818181818182;0.431818181818182
Control.SRR15539829;41;45;0.365853658536585;26;15;0.134146341463415;0.365853658536585
Control.SRR15539829;39;45;0.641025641025641;14;25;0.141025641025641;0.358974358974359
Control.SRR15539829;40;45;0.55;18;22;0.05;0.45
Control.SRR15539829;41;45;0.560975609756098;18;23;0.0609756097560976;0.439024390243902
Control.SRR15539829;47;45;0.51063829787234;23;24;0.0106382978723404;0.48936170212766
Control.SRR15539829;44;45;0.409090909090909;26;18;0.0909090909090909;0.409090909090909
Control.SRR15539829;41;45;0.609756097560976;16;25;0.109756097560976;0.390243902439024
Control.SRR15539829;51;45;0.470588235294118;27;24;0.0294117647058824;0.470588235294118
Control.SRR15539829;46;45;0.434782608695652;26;20;0.0652173913043478;0.434782608695652
Control.SRR15539829;51;45;0.431372549019608;29;22;0.0686274509803921;0.431372549019608
Control.SRR15539829;48;45;0.416666666666667;28;20;0.0833333333333333;0.416666666666667
Control.SRR15539829;45;45;0.355555555555556;29;16;0.144444444444444;0.355555555555556
Control.SRR15539829;50;45;0.6;20;30;0.1;0.4
Control.SRR15539829;44;45;0.409090909090909;26;18;0.0909090909090909;0.409090909090909
Control.SRR15539829;44;45;0.409090909090909;26;18;0.0909090909090909;0.409090909090909
Control.SRR15539829;40;45;0.425;23;17;0.075;0.425
Control.SRR15539829;43;45;0.441860465116279;24;19;0.0581395348837209;0.441860465116279
Control.SRR15539829;46;45;0.456521739130435;25;21;0.0434782608695652;0.456521739130435
Control.SRR15539829;48;45;0.416666666666667;28;20;0.0833333333333333;0.416666666666667
Control.SRR15539829;50;45;0.5;25;25;0;0.5
Control.SRR15539829;45;45;0.511111111111111;22;23;0.0111111111111111;0.488888888888889
Control.SRR15539829;51;45;0.450980392156863;28;23;0.0490196078431372;0.450980392156863
Control.SRR15539829;40;45;0.475;21;19;0.025;0.475
Control.SRR15539829;43;45;0.581395348837209;18;25;0.0813953488372093;0.418604651162791
Control.SRR15539829;46;45;0.391304347826087;28;18;0.108695652173913;0.391304347826087
Control.SRR15539829;48;45;0.416666666666667;28;20;0.0833333333333333;0.416666666666667
Control.SRR15539829;51;45;0.450980392156863;28;23;0.0490196078431372;0.450980392156863
Control.SRR15539829;42;45;0.428571428571429;24;18;0.0714285714285715;0.428571428571429
Control.SRR15539829;39;45;0.538461538461538;18;21;0.0384615384615384;0.461538461538462
Control.SRR15539829;51;45;0.509803921568627;25;26;0.00980392156862742;0.490196078431373
Control.SRR15539829;51;45;0.450980392156863;28;23;0.0490196078431372;0.450980392156863
Control.SRR15539829;45;45;0.533333333333333;21;24;0.0333333333333333;0.466666666666667
Control.SRR15539829;47;45;0.553191489361702;21;26;0.0531914893617021;0.446808510638298
Control.SRR15539829;40;45;0.525;19;21;0.025;0.475
Control.SRR15539829;42;45;0.452380952380952;23;19;0.0476190476190476;0.452380952380952
Control.SRR15539829;50;45;0.46;27;23;0.04;0.46
Control.SRR15539829;42;45;0.571428571428571;18;24;0.0714285714285714;0.428571428571429
Control.SRR15539829;43;45;0.325581395348837;29;14;0.174418604651163;0.325581395348837
Control.SRR15539829;47;45;0.595744680851064;19;28;0.0957446808510638;0.404255319148936
Control.SRR15539829;42;45;0.761904761904762;10;32;0.261904761904762;0.238095238095238
Control.SRR15539829;50;45;0.46;27;23;0.04;0.46
Control.SRR15539829;48;45;0.625;18;30;0.125;0.375
Control.SRR15539829;44;45;0.568181818181818;19;25;0.0681818181818182;0.431818181818182
Control.SRR15539829;40;45;0.525;19;21;0.025;0.475
Control.SRR15539829;43;45;0.534883720930233;20;23;0.0348837209302325;0.465116279069767
Control.SRR15539829;45;45;0.488888888888889;23;22;0.0111111111111111;0.488888888888889
Control.SRR15539829;47;45;0.680851063829787;15;32;0.180851063829787;0.319148936170213
Control.SRR15539829;46;45;0.434782608695652;26;20;0.0652173913043478;0.434782608695652
Control.SRR15539829;45;45;0.555555555555556;20;25;0.0555555555555556;0.444444444444444
Control.SRR15539829;48;45;0.5;24;24;0;0.5
Control.SRR15539829;47;45;0.638297872340426;17;30;0.138297872340426;0.361702127659574
Control.SRR15539829;44;45;0.522727272727273;21;23;0.0227272727272727;0.477272727272727
Control.SRR15539829;39;45;0.41025641025641;23;16;0.0897435897435898;0.41025641025641
Control.SRR15539829;41;45;0.536585365853659;19;22;0.0365853658536586;0.463414634146341
Control.SRR15539829;41;45;0.365853658536585;26;15;0.134146341463415;0.365853658536585
Control.SRR15539829;47;45;0.425531914893617;27;20;0.074468085106383;0.425531914893617
Control.SRR15539829;51;45;0.470588235294118;27;24;0.0294117647058824;0.470588235294118
Control.SRR15539829;48;45;0.416666666666667;28;20;0.0833333333333333;0.416666666666667
Control.SRR15539829;40;45;0.575;17;23;0.075;0.425
Control.SRR15539829;39;45;0.58974358974359;16;23;0.0897435897435898;0.41025641025641
Control.SRR15539829;48;45;0.541666666666667;22;26;0.0416666666666666;0.458333333333333
Control.SRR15539829;44;45;0.5;22;22;0;0.5
Control.SRR15539829;44;45;0.409090909090909;26;18;0.0909090909090909;0.409090909090909
Control.SRR15539829;50;45;0.46;27;23;0.04;0.46
Control.SRR15539829;50;45;0.48;26;24;0.02;0.48
Control.SRR15539829;47;45;0.51063829787234;23;24;0.0106382978723404;0.48936170212766
Control.SRR15539829;43;45;0.558139534883721;19;24;0.0581395348837209;0.441860465116279
Control.SRR15539829;50;45;0.5;25;25;0;0.5
Control.SRR15539829;49;45;0.489795918367347;25;24;0.0102040816326531;0.489795918367347
Control.SRR15539829;40;45;0.525;19;21;0.025;0.475
Control.SRR15539829;44;45;0.704545454545455;13;31;0.204545454545455;0.295454545454545
Control.SRR15539829;46;45;0.5;23;23;0;0.5
Control.SRR15539829;46;45;0.456521739130435;25;21;0.0434782608695652;0.456521739130435
Control.SRR15539829;44;45;0.568181818181818;19;25;0.0681818181818182;0.431818181818182
Control.SRR15539829;49;45;0.591836734693878;20;29;0.0918367346938775;0.408163265306122
Control.SRR15539829;41;45;0.585365853658537;17;24;0.0853658536585366;0.414634146341463
Control.SRR15539829;43;45;0.534883720930233;20;23;0.0348837209302325;0.465116279069767
Control.SRR15539829;46;45;0.58695652173913;19;27;0.0869565217391305;0.41304347826087
Control.SRR15539829;48;45;0.458333333333333;26;22;0.0416666666666667;0.458333333333333
Control.SRR15539829;39;45;0.384615384615385;24;15;0.115384615384615;0.384615384615385
Control.SRR15539829;40;45;0.55;18;22;0.05;0.45
Control.SRR15539829;43;45;0.581395348837209;18;25;0.0813953488372093;0.418604651162791
Control.SRR15539829;42;45;0.547619047619048;19;23;0.0476190476190477;0.452380952380952
Control.SRR15539829;39;45;0.435897435897436;22;17;0.0641025641025641;0.435897435897436
Control.SRR15539829;43;45;0.604651162790698;17;26;0.104651162790698;0.395348837209302
Control.SRR15539829;40;45;0.45;22;18;0.05;0.45
Control.SRR15539829;42;45;0.452380952380952;23;19;0.0476190476190476;0.452380952380952
Control.SRR15539829;43;45;0.651162790697674;15;28;0.151162790697674;0.348837209302326
Control.SRR15539829;42;45;0.595238095238095;17;25;0.0952380952380952;0.404761904761905
Control.SRR15539829;40;45;0.425;23;17;0.075;0.425
Control.SRR15539829;47;45;0.531914893617021;22;25;0.0319148936170213;0.468085106382979
Control.SRR15539829;46;45;0.630434782608696;17;29;0.130434782608696;0.369565217391304
Control.SRR15539829;47;45;0.574468085106383;20;27;0.074468085106383;0.425531914893617
Control.SRR15539829;45;45;0.4;27;18;0.1;0.4
Control.SRR15539829;45;45;0.533333333333333;21;24;0.0333333333333333;0.466666666666667
Control.SRR15539829;43;45;0.488372093023256;22;21;0.0116279069767442;0.488372093023256
Control.SRR15539829;48;45;0.354166666666667;31;17;0.145833333333333;0.354166666666667
Control.SRR15539829;44;45;0.454545454545455;24;20;0.0454545454545455;0.454545454545455
Control.SRR15539829;41;45;0.560975609756098;18;23;0.0609756097560976;0.439024390243902
Control.SRR15539829;46;45;0.717391304347826;13;33;0.217391304347826;0.282608695652174
Control.SRR15539829;43;45;0.651162790697674;15;28;0.151162790697674;0.348837209302326
Control.SRR15539829;42;45;0.476190476190476;22;20;0.0238095238095238;0.476190476190476
Control.SRR15539829;40;45;0.475;21;19;0.025;0.475
Control.SRR15539829;42;45;0.380952380952381;26;16;0.119047619047619;0.380952380952381
Control.SRR15539829;42;45;0.452380952380952;23;19;0.0476190476190476;0.452380952380952
Control.SRR15539829;45;45;0.444444444444444;25;20;0.0555555555555556;0.444444444444444
Control.SRR15539829;45;45;0.488888888888889;23;22;0.0111111111111111;0.488888888888889
Control.SRR15539829;42;45;0.476190476190476;22;20;0.0238095238095238;0.476190476190476
Control.SRR15539829;41;45;0.439024390243902;23;18;0.0609756097560976;0.439024390243902
Control.SRR15539829;44;45;0.477272727272727;23;21;0.0227272727272727;0.477272727272727
Control.SRR15539829;48;45;0.541666666666667;22;26;0.0416666666666666;0.458333333333333
Control.SRR15539829;45;45;0.377777777777778;28;17;0.122222222222222;0.377777777777778
Control.SRR15539829;44;45;0.431818181818182;25;19;0.0681818181818182;0.431818181818182
Control.SRR15539829;45;45;0.377777777777778;28;17;0.122222222222222;0.377777777777778
Control.SRR15539829;41;45;0.536585365853659;19;22;0.0365853658536586;0.463414634146341
Control.SRR15539829;50;45;0.48;26;24;0.02;0.48
Control.SRR15539829;47;45;0.404255319148936;28;19;0.0957446808510639;0.404255319148936
Control.SRR15539829;47;45;0.48936170212766;24;23;0.0106382978723404;0.48936170212766
Control.SRR15539829;46;45;0.5;23;23;0;0.5
Control.SRR15539829;46;45;0.543478260869565;21;25;0.0434782608695652;0.456521739130435
Control.SRR15539829;43;45;0.511627906976744;21;22;0.0116279069767442;0.488372093023256
Control.SRR15539829;40;45;0.45;22;18;0.05;0.45
Control.SRR15539829;42;45;0.523809523809524;20;22;0.0238095238095238;0.476190476190476
Control.SRR15539829;39;45;0.512820512820513;19;20;0.0128205128205128;0.487179487179487
Control.SRR15539829;47;45;0.404255319148936;28;19;0.0957446808510639;0.404255319148936
Control.SRR15539829;44;45;0.522727272727273;21;23;0.0227272727272727;0.477272727272727
Control.SRR15539829;45;45;0.577777777777778;19;26;0.0777777777777777;0.422222222222222
Control.SRR15539829;50;45;0.52;24;26;0.02;0.48
Control.SRR15539829;40;45;0.45;22;18;0.05;0.45
Control.SRR15539829;47;45;0.404255319148936;28;19;0.0957446808510639;0.404255319148936
Control.SRR15539829;40;45;0.7;12;28;0.2;0.3
Control.SRR15539829;48;45;0.416666666666667;28;20;0.0833333333333333;0.416666666666667
Control.SRR15539829;39;45;0.58974358974359;16;23;0.0897435897435898;0.41025641025641
Control.SRR15539829;47;45;0.595744680851064;19;28;0.0957446808510638;0.404255319148936
Control.SRR15539829;46;45;0.5;23;23;0;0.5
Control.SRR15539829;50;45;0.52;24;26;0.02;0.48
Control.SRR15539829;39;45;0.666666666666667;13;26;0.166666666666667;0.333333333333333
Control.SRR15539829;39;45;0.487179487179487;20;19;0.0128205128205128;0.487179487179487
Control.SRR15539829;49;45;0.591836734693878;20;29;0.0918367346938775;0.408163265306122
Control.SRR15539829;46;45;0.456521739130435;25;21;0.0434782608695652;0.456521739130435
Control.SRR15539829;43;45;0.511627906976744;21;22;0.0116279069767442;0.488372093023256
Control.SRR15539829;49;45;0.489795918367347;25;24;0.0102040816326531;0.489795918367347
Control.SRR15539829;49;45;0.591836734693878;20;29;0.0918367346938775;0.408163265306122
Control.SRR15539829;40;45;0.525;19;21;0.025;0.475
Control.SRR15539829;41;45;0.609756097560976;16;25;0.109756097560976;0.390243902439024
Control.SRR15539829;45;45;0.488888888888889;23;22;0.0111111111111111;0.488888888888889
Control.SRR15539829;51;45;0.352941176470588;33;18;0.147058823529412;0.352941176470588
Control.SRR15539829;47;45;0.531914893617021;22;25;0.0319148936170213;0.468085106382979
Control.SRR15539829;42;45;0.523809523809524;20;22;0.0238095238095238;0.476190476190476
Control.SRR15539829;50;45;0.56;22;28;0.0600000000000001;0.44
Control.SRR15539829;50;45;0.46;27;23;0.04;0.46
Control.SRR15539829;48;45;0.416666666666667;28;20;0.0833333333333333;0.416666666666667
Control.SRR15539829;47;45;0.51063829787234;23;24;0.0106382978723404;0.48936170212766
Control.SRR15539829;51;45;0.431372549019608;29;22;0.0686274509803921;0.431372549019608
Control.SRR15539829;41;45;0.463414634146341;22;19;0.0365853658536585;0.463414634146341
Control.SRR15539829;41;45;0.390243902439024;25;16;0.109756097560976;0.390243902439024
Control.SRR15539829;44;45;0.568181818181818;19;25;0.0681818181818182;0.431818181818182
Control.SRR15539829;44;45;0.5;22;22;0;0.5
Control.SRR15539829;39;45;0.41025641025641;23;16;0.0897435897435898;0.41025641025641
Control.SRR15539829;50;45;0.56;22;28;0.0600000000000001;0.44
Control.SRR15539829;48;45;0.479166666666667;25;23;0.0208333333333333;0.479166666666667
Control.SRR15539829;39;45;0.58974358974359;16;23;0.0897435897435898;0.41025641025641
Control.SRR15539829;39;45;0.435897435897436;22;17;0.0641025641025641;0.435897435897436
Control.SRR15539829;45;45;0.644444444444444;16;29;0.144444444444444;0.355555555555556
Control.SRR15539829;44;45;0.477272727272727;23;21;0.0227272727272727;0.477272727272727
Control.SRR15539829;50;45;0.46;27;23;0.04;0.46
Control.SRR15539829;48;45;0.479166666666667;25;23;0.0208333333333333;0.479166666666667
Control.SRR15539829;44;45;0.318181818181818;30;14;0.181818181818182;0.318181818181818
Control.SRR15539829;44;45;0.568181818181818;19;25;0.0681818181818182;0.431818181818182
Control.SRR15539829;41;45;0.463414634146341;22;19;0.0365853658536585;0.463414634146341
Control.SRR15539829;40;45;0.475;21;19;0.025;0.475
Control.SRR15539829;45;45;0.6;18;27;0.1;0.4
Control.SRR15539829;44;45;0.568181818181818;19;25;0.0681818181818182;0.431818181818182
Control.SRR15539829;44;45;0.590909090909091;18;26;0.0909090909090909;0.409090909090909
Control.SRR15539829;39;45;0.692307692307692;12;27;0.192307692307692;0.307692307692308
Control.SRR15539829;44;45;0.636363636363636;16;28;0.136363636363636;0.363636363636364
Control.SRR15539829;40;45;0.575;17;23;0.075;0.425
Control.SRR15539829;41;45;0.658536585365854;14;27;0.158536585365854;0.341463414634146
Control.SRR15539829;45;45;0.488888888888889;23;22;0.0111111111111111;0.488888888888889
Control.SRR15539829;47;45;0.48936170212766;24;23;0.0106382978723404;0.48936170212766
Control.SRR15539829;43;45;0.465116279069767;23;20;0.0348837209302326;0.465116279069767
Control.SRR15539829;39;45;0.384615384615385;24;15;0.115384615384615;0.384615384615385
Control.SRR15539829;39;45;0.512820512820513;19;20;0.0128205128205128;0.487179487179487
Control.SRR15539829;45;45;0.577777777777778;19;26;0.0777777777777777;0.422222222222222
Control.SRR15539829;42;45;0.428571428571429;24;18;0.0714285714285715;0.428571428571429
Control.SRR15539829;50;45;0.58;21;29;0.08;0.42
Control.SRR15539829;48;45;0.395833333333333;29;19;0.104166666666667;0.395833333333333
Control.SRR15539829;39;45;0.538461538461538;18;21;0.0384615384615384;0.461538461538462
Control.SRR15539829;43;45;0.465116279069767;23;20;0.0348837209302326;0.465116279069767
Control.SRR15539829;47;45;0.48936170212766;24;23;0.0106382978723404;0.48936170212766
Control.SRR15539829;45;45;0.466666666666667;24;21;0.0333333333333333;0.466666666666667
Control.SRR15539829;41;45;0.439024390243902;23;18;0.0609756097560976;0.439024390243902
Control.SRR15539829;42;45;0.404761904761905;25;17;0.0952380952380952;0.404761904761905
Control.SRR15539829;42;45;0.571428571428571;18;24;0.0714285714285714;0.428571428571429
Control.SRR15539829;42;45;0.523809523809524;20;22;0.0238095238095238;0.476190476190476
Control.SRR15539829;49;45;0.469387755102041;26;23;0.0306122448979592;0.469387755102041
Control.SRR15539829;44;45;0.5;22;22;0;0.5
Control.SRR15539829;43;45;0.581395348837209;18;25;0.0813953488372093;0.418604651162791
Control.SRR15539829;46;45;0.456521739130435;25;21;0.0434782608695652;0.456521739130435
Control.SRR15539829;48;45;0.458333333333333;26;22;0.0416666666666667;0.458333333333333
Control.SRR15539829;42;45;0.5;21;21;0;0.5
Control.SRR15539829;45;45;0.555555555555556;20;25;0.0555555555555556;0.444444444444444
Control.SRR15539829;42;45;0.547619047619048;19;23;0.0476190476190477;0.452380952380952
Control.SRR15539829;51;45;0.509803921568627;25;26;0.00980392156862742;0.490196078431373
Control.SRR15539829;47;45;0.531914893617021;22;25;0.0319148936170213;0.468085106382979
Control.SRR15539829;44;45;0.454545454545455;24;20;0.0454545454545455;0.454545454545455
Control.SRR15539829;49;45;0.571428571428571;21;28;0.0714285714285714;0.428571428571429
Control.SRR15539829;47;45;0.446808510638298;26;21;0.0531914893617021;0.446808510638298
Control.SRR15539829;41;45;0.634146341463415;15;26;0.134146341463415;0.365853658536585
Control.SRR15539829;41;45;0.585365853658537;17;24;0.0853658536585366;0.414634146341463
Control.SRR15539829;44;45;0.545454545454545;20;24;0.0454545454545454;0.454545454545455
Control.SRR15539829;46;45;0.565217391304348;20;26;0.0652173913043478;0.434782608695652
Control.SRR15539829;42;45;0.595238095238095;17;25;0.0952380952380952;0.404761904761905
Control.SRR15539829;49;45;0.469387755102041;26;23;0.0306122448979592;0.469387755102041
Control.SRR15539829;43;45;0.325581395348837;29;14;0.174418604651163;0.325581395348837
Control.SRR15539829;46;45;0.434782608695652;26;20;0.0652173913043478;0.434782608695652
Control.SRR15539829;49;45;0.489795918367347;25;24;0.0102040816326531;0.489795918367347
Control.SRR15539829;44;45;0.636363636363636;16;28;0.136363636363636;0.363636363636364
Control.SRR15539829;41;45;0.439024390243902;23;18;0.0609756097560976;0.439024390243902
Control.SRR15539829;42;45;0.428571428571429;24;18;0.0714285714285715;0.428571428571429
Control.SRR15539829;39;45;0.538461538461538;18;21;0.0384615384615384;0.461538461538462
Control.SRR15539829;41;45;0.560975609756098;18;23;0.0609756097560976;0.439024390243902
Control.SRR15539829;45;45;0.488888888888889;23;22;0.0111111111111111;0.488888888888889
Control.SRR15539829;47;45;0.553191489361702;21;26;0.0531914893617021;0.446808510638298
Control.SRR15539829;47;45;0.446808510638298;26;21;0.0531914893617021;0.446808510638298
Control.SRR15539829;45;45;0.488888888888889;23;22;0.0111111111111111;0.488888888888889
Control.SRR15539829;41;45;0.536585365853659;19;22;0.0365853658536586;0.463414634146341
Control.SRR15539829;43;45;0.511627906976744;21;22;0.0116279069767442;0.488372093023256
Control.SRR15539829;46;45;0.5;23;23;0;0.5
Control.SRR15539829;49;45;0.36734693877551;31;18;0.13265306122449;0.36734693877551
Control.SRR15539829;49;45;0.63265306122449;18;31;0.13265306122449;0.36734693877551
Control.SRR15539829;51;45;0.431372549019608;29;22;0.0686274509803921;0.431372549019608
Control.SRR15539829;40;45;0.525;19;21;0.025;0.475
Control.SRR15539829;41;45;0.390243902439024;25;16;0.109756097560976;0.390243902439024
Control.SRR15539829;49;45;0.530612244897959;23;26;0.0306122448979592;0.469387755102041
Control.SRR15539829;42;45;0.547619047619048;19;23;0.0476190476190477;0.452380952380952
Control.SRR15539829;47;45;0.425531914893617;27;20;0.074468085106383;0.425531914893617
Control.SRR15539829;47;45;0.425531914893617;27;20;0.074468085106383;0.425531914893617
Control.SRR15539829;42;45;0.547619047619048;19;23;0.0476190476190477;0.452380952380952
Control.SRR15539829;47;45;0.468085106382979;25;22;0.0319148936170213;0.468085106382979
Control.SRR15539829;44;45;0.477272727272727;23;21;0.0227272727272727;0.477272727272727
Control.SRR15539829;42;45;0.642857142857143;15;27;0.142857142857143;0.357142857142857
Control.SRR15539829;41;45;0.536585365853659;19;22;0.0365853658536586;0.463414634146341
Control.SRR15539829;46;45;0.434782608695652;26;20;0.0652173913043478;0.434782608695652
Control.SRR15539829;42;45;0.380952380952381;26;16;0.119047619047619;0.380952380952381
Control.SRR15539829;48;45;0.479166666666667;25;23;0.0208333333333333;0.479166666666667
Control.SRR15539829;43;45;0.511627906976744;21;22;0.0116279069767442;0.488372093023256
Control.SRR15539829;43;45;0.465116279069767;23;20;0.0348837209302326;0.465116279069767
Control.SRR15539829;41;45;0.51219512195122;20;21;0.0121951219512195;0.48780487804878
Control.SRR15539829;45;45;0.533333333333333;21;24;0.0333333333333333;0.466666666666667
Control.SRR15539829;48;45;0.604166666666667;19;29;0.104166666666667;0.395833333333333
Control.SRR15539829;49;45;0.551020408163265;22;27;0.0510204081632653;0.448979591836735
Control.SRR15539829;46;45;0.652173913043478;16;30;0.152173913043478;0.347826086956522
Control.SRR15539829;45;45;0.422222222222222;26;19;0.0777777777777778;0.422222222222222
Control.SRR15539829;44;45;0.5;22;22;0;0.5
Control.SRR15539829;42;45;0.404761904761905;25;17;0.0952380952380952;0.404761904761905
Control.SRR15539829;44;45;0.545454545454545;20;24;0.0454545454545454;0.454545454545455
Control.SRR15539829;49;45;0.428571428571429;28;21;0.0714285714285715;0.428571428571429
Control.SRR15539829;43;45;0.465116279069767;23;20;0.0348837209302326;0.465116279069767
Control.SRR15539829;44;45;0.454545454545455;24;20;0.0454545454545455;0.454545454545455
Control.SRR15539829;49;45;0.530612244897959;23;26;0.0306122448979592;0.469387755102041
Control.SRR15539829;44;45;0.454545454545455;24;20;0.0454545454545455;0.454545454545455
Control.SRR15539829;40;45;0.625;15;25;0.125;0.375
Control.SRR15539829;42;45;0.547619047619048;19;23;0.0476190476190477;0.452380952380952
Control.SRR15539829;47;45;0.595744680851064;19;28;0.0957446808510638;0.404255319148936
Control.SRR15539829;45;45;0.466666666666667;24;21;0.0333333333333333;0.466666666666667
Control.SRR15539829;44;45;0.545454545454545;20;24;0.0454545454545454;0.454545454545455
Control.SRR15539829;47;45;0.574468085106383;20;27;0.074468085106383;0.425531914893617
Control.SRR15539829;48;45;0.604166666666667;19;29;0.104166666666667;0.395833333333333
Control.SRR15539829;50;45;0.5;25;25;0;0.5
Control.SRR15539829;47;45;0.48936170212766;24;23;0.0106382978723404;0.48936170212766
Control.SRR15539829;45;45;0.466666666666667;24;21;0.0333333333333333;0.466666666666667
Control.SRR15539829;47;45;0.617021276595745;18;29;0.117021276595745;0.382978723404255
Control.SRR15539829;47;45;0.468085106382979;25;22;0.0319148936170213;0.468085106382979
Control.SRR15539829;49;45;0.346938775510204;32;17;0.153061224489796;0.346938775510204
Control.SRR15539829;47;45;0.574468085106383;20;27;0.074468085106383;0.425531914893617
Control.SRR15539829;45;45;0.533333333333333;21;24;0.0333333333333333;0.466666666666667
Control.SRR15539829;45;45;0.533333333333333;21;24;0.0333333333333333;0.466666666666667
Control.SRR15539829;39;45;0.461538461538462;21;18;0.0384615384615384;0.461538461538462
Control.SRR15539829;50;45;0.44;28;22;0.06;0.44
Control.SRR15539829;44;45;0.477272727272727;23;21;0.0227272727272727;0.477272727272727
Control.SRR15539829;51;45;0.470588235294118;27;24;0.0294117647058824;0.470588235294118
Control.SRR15539829;43;45;0.488372093023256;22;21;0.0116279069767442;0.488372093023256
Control.SRR15539829;50;45;0.58;21;29;0.08;0.42
Control.SRR15539829;49;45;0.469387755102041;26;23;0.0306122448979592;0.469387755102041
Control.SRR15539829;48;45;0.541666666666667;22;26;0.0416666666666666;0.458333333333333
Control.SRR15539829;40;45;0.525;19;21;0.025;0.475
Control.SRR15539829;44;45;0.318181818181818;30;14;0.181818181818182;0.318181818181818
Control.SRR15539829;40;45;0.425;23;17;0.075;0.425
Control.SRR15539829;48;45;0.604166666666667;19;29;0.104166666666667;0.395833333333333
Control.SRR15539829;44;45;0.522727272727273;21;23;0.0227272727272727;0.477272727272727
Control.SRR15539829;49;45;0.551020408163265;22;27;0.0510204081632653;0.448979591836735
Control.SRR15539829;46;45;0.456521739130435;25;21;0.0434782608695652;0.456521739130435
Control.SRR15539829;43;45;0.534883720930233;20;23;0.0348837209302325;0.465116279069767
Control.SRR15539829;40;45;0.475;21;19;0.025;0.475
Control.SRR15539829;50;45;0.44;28;22;0.06;0.44
Control.SRR15539829;45;45;0.444444444444444;25;20;0.0555555555555556;0.444444444444444
Control.SRR15539829;46;45;0.478260869565217;24;22;0.0217391304347826;0.478260869565217
Control.SRR15539829;40;45;0.55;18;22;0.05;0.45
Control.SRR15539829;46;45;0.565217391304348;20;26;0.0652173913043478;0.434782608695652
Control.SRR15539829;47;45;0.617021276595745;18;29;0.117021276595745;0.382978723404255
Control.SRR15539829;41;45;0.341463414634146;27;14;0.158536585365854;0.341463414634146
Control.SRR15539829;42;45;0.380952380952381;26;16;0.119047619047619;0.380952380952381
Control.SRR15539829;50;45;0.56;22;28;0.0600000000000001;0.44
Control.SRR15539829;44;45;0.545454545454545;20;24;0.0454545454545454;0.454545454545455
Control.SRR15539829;41;45;0.560975609756098;18;23;0.0609756097560976;0.439024390243902
Control.SRR15539829;44;45;0.522727272727273;21;23;0.0227272727272727;0.477272727272727
Control.SRR15539829;41;45;0.51219512195122;20;21;0.0121951219512195;0.48780487804878
Control.SRR15539829;46;45;0.478260869565217;24;22;0.0217391304347826;0.478260869565217
Control.SRR15539829;40;45;0.35;26;14;0.15;0.35
Control.SRR15539829;51;45;0.529411764705882;24;27;0.0294117647058824;0.470588235294118
Control.SRR15539829;51;45;0.411764705882353;30;21;0.0882352941176471;0.411764705882353
Control.SRR15539829;48;45;0.4375;27;21;0.0625;0.4375
Control.SRR15539829;46;45;0.434782608695652;26;20;0.0652173913043478;0.434782608695652
Control.SRR15539829;40;45;0.5;20;20;0;0.5
Control.SRR15539829;40;45;0.45;22;18;0.05;0.45
Control.SRR15539829;46;45;0.478260869565217;24;22;0.0217391304347826;0.478260869565217
Control.SRR15539829;50;45;0.46;27;23;0.04;0.46
Control.SRR15539829;46;45;0.41304347826087;27;19;0.0869565217391304;0.41304347826087
Control.SRR15539829;47;45;0.48936170212766;24;23;0.0106382978723404;0.48936170212766
Control.SRR15539829;41;45;0.51219512195122;20;21;0.0121951219512195;0.48780487804878
Control.SRR15539829;51;45;0.490196078431373;26;25;0.00980392156862747;0.490196078431373
Control.SRR15539829;39;45;0.538461538461538;18;21;0.0384615384615384;0.461538461538462
Control.SRR15539829;43;45;0.465116279069767;23;20;0.0348837209302326;0.465116279069767
Control.SRR15539829;46;45;0.543478260869565;21;25;0.0434782608695652;0.456521739130435
Control.SRR15539829;47;45;0.361702127659574;30;17;0.138297872340426;0.361702127659574
Control.SRR15539829;51;45;0.509803921568627;25;26;0.00980392156862742;0.490196078431373
Control.SRR15539829;51;45;0.470588235294118;27;24;0.0294117647058824;0.470588235294118
Control.SRR15539829;46;45;0.5;23;23;0;0.5
Control.SRR15539829;49;45;0.448979591836735;27;22;0.0510204081632653;0.448979591836735
Control.SRR15539829;50;45;0.52;24;26;0.02;0.48
Control.SRR15539829;41;45;0.463414634146341;22;19;0.0365853658536585;0.463414634146341
Control.SRR15539829;40;45;0.5;20;20;0;0.5
Control.SRR15539829;40;45;0.55;18;22;0.05;0.45
Control.SRR15539829;46;45;0.543478260869565;21;25;0.0434782608695652;0.456521739130435
Control.SRR15539829;46;45;0.456521739130435;25;21;0.0434782608695652;0.456521739130435
Control.SRR15539829;44;45;0.363636363636364;28;16;0.136363636363636;0.363636363636364
Control.SRR15539829;39;45;0.564102564102564;17;22;0.0641025641025641;0.435897435897436
Control.SRR15539829;42;45;0.571428571428571;18;24;0.0714285714285714;0.428571428571429
Control.SRR15539829;42;45;0.357142857142857;27;15;0.142857142857143;0.357142857142857
Control.SRR15539829;48;45;0.5;24;24;0;0.5
Control.SRR15539829;44;45;0.522727272727273;21;23;0.0227272727272727;0.477272727272727
Control.SRR15539829;48;45;0.4375;27;21;0.0625;0.4375
Control.SRR15539829;42;45;0.523809523809524;20;22;0.0238095238095238;0.476190476190476
Control.SRR15539829;45;45;0.466666666666667;24;21;0.0333333333333333;0.466666666666667
Control.SRR15539829;40;45;0.475;21;19;0.025;0.475
Control.SRR15539829;40;45;0.55;18;22;0.05;0.45
Control.SRR15539829;45;45;0.466666666666667;24;21;0.0333333333333333;0.466666666666667
Control.SRR15539829;50;45;0.52;24;26;0.02;0.48
Control.SRR15539829;40;45;0.45;22;18;0.05;0.45
Control.SRR15539829;50;45;0.4;30;20;0.1;0.4
Control.SRR15539829;45;45;0.422222222222222;26;19;0.0777777777777778;0.422222222222222
Control.SRR15539829;43;45;0.604651162790698;17;26;0.104651162790698;0.395348837209302
Control.SRR15539829;48;45;0.458333333333333;26;22;0.0416666666666667;0.458333333333333
Control.SRR15539829;39;45;0.58974358974359;16;23;0.0897435897435898;0.41025641025641
Control.SRR15539829;44;45;0.522727272727273;21;23;0.0227272727272727;0.477272727272727
Control.SRR15539829;45;45;0.466666666666667;24;21;0.0333333333333333;0.466666666666667
Control.SRR15539829;45;45;0.533333333333333;21;24;0.0333333333333333;0.466666666666667
Control.SRR15539829;40;45;0.4;24;16;0.1;0.4
Control.SRR15539829;47;45;0.51063829787234;23;24;0.0106382978723404;0.48936170212766
Control.SRR15539829;43;45;0.534883720930233;20;23;0.0348837209302325;0.465116279069767
Control.SRR15539829;42;45;0.666666666666667;14;28;0.166666666666667;0.333333333333333
Control.SRR15539829;41;45;0.560975609756098;18;23;0.0609756097560976;0.439024390243902
Control.SRR15539829;50;45;0.42;29;21;0.08;0.42
Control.SRR15539829;45;45;0.533333333333333;21;24;0.0333333333333333;0.466666666666667
Control.SRR15539829;45;45;0.555555555555556;20;25;0.0555555555555556;0.444444444444444
Control.SRR15539829;45;45;0.511111111111111;22;23;0.0111111111111111;0.488888888888889
Control.SRR15539829;49;45;0.551020408163265;22;27;0.0510204081632653;0.448979591836735
Control.SRR15539829;50;45;0.48;26;24;0.02;0.48
Control.SRR15539829;48;45;0.5;24;24;0;0.5
Control.SRR15539829;39;45;0.487179487179487;20;19;0.0128205128205128;0.487179487179487
Control.SRR15539829;43;45;0.441860465116279;24;19;0.0581395348837209;0.441860465116279
Control.SRR15539829;47;45;0.48936170212766;24;23;0.0106382978723404;0.48936170212766
Control.SRR15539829;51;45;0.627450980392157;19;32;0.127450980392157;0.372549019607843
Control.SRR15539829;45;45;0.466666666666667;24;21;0.0333333333333333;0.466666666666667
Control.SRR15539829;51;45;0.568627450980392;22;29;0.0686274509803921;0.431372549019608
Control.SRR15539829;44;45;0.477272727272727;23;21;0.0227272727272727;0.477272727272727
Control.SRR15539829;39;45;0.615384615384615;15;24;0.115384615384615;0.384615384615385
Control.SRR15539829;39;45;0.435897435897436;22;17;0.0641025641025641;0.435897435897436
Control.SRR15539829;39;45;0.461538461538462;21;18;0.0384615384615384;0.461538461538462
Control.SRR15539829;39;45;0.333333333333333;26;13;0.166666666666667;0.333333333333333
Control.SRR15539829;39;45;0.564102564102564;17;22;0.0641025641025641;0.435897435897436
Control.SRR15539829;46;45;0.434782608695652;26;20;0.0652173913043478;0.434782608695652
Control.SRR15539829;44;45;0.590909090909091;18;26;0.0909090909090909;0.409090909090909
Control.SRR15539829;39;45;0.512820512820513;19;20;0.0128205128205128;0.487179487179487
Control.SRR15539829;42;45;0.428571428571429;24;18;0.0714285714285715;0.428571428571429
Control.SRR15539829;48;45;0.375;30;18;0.125;0.375
Control.SRR15539829;43;45;0.418604651162791;25;18;0.0813953488372093;0.418604651162791
Control.SRR15539829;48;45;0.5625;21;27;0.0625;0.4375
Control.SRR15539829;51;45;0.529411764705882;24;27;0.0294117647058824;0.470588235294118
Control.SRR15539829;46;45;0.456521739130435;25;21;0.0434782608695652;0.456521739130435
Control.SRR15539829;42;45;0.428571428571429;24;18;0.0714285714285715;0.428571428571429
Control.SRR15539829;45;45;0.555555555555556;20;25;0.0555555555555556;0.444444444444444
Control.SRR15539829;46;45;0.478260869565217;24;22;0.0217391304347826;0.478260869565217
Control.SRR15539829;45;45;0.511111111111111;22;23;0.0111111111111111;0.488888888888889
Control.SRR15539829;51;45;0.549019607843137;23;28;0.0490196078431373;0.450980392156863
Control.SRR15539829;50;45;0.52;24;26;0.02;0.48
Control.SRR15539829;41;45;0.560975609756098;18;23;0.0609756097560976;0.439024390243902
Control.SRR15539829;46;45;0.478260869565217;24;22;0.0217391304347826;0.478260869565217
Control.SRR15539829;47;45;0.48936170212766;24;23;0.0106382978723404;0.48936170212766
Control.SRR15539829;44;45;0.431818181818182;25;19;0.0681818181818182;0.431818181818182
Control.SRR15539829;48;45;0.395833333333333;29;19;0.104166666666667;0.395833333333333
Control.SRR15539829;48;45;0.666666666666667;16;32;0.166666666666667;0.333333333333333
Control.SRR15539829;51;45;0.431372549019608;29;22;0.0686274509803921;0.431372549019608
Control.SRR15539829;41;45;0.463414634146341;22;19;0.0365853658536585;0.463414634146341
Control.SRR15539829;48;45;0.583333333333333;20;28;0.0833333333333334;0.416666666666667
Control.SRR15539829;48;45;0.541666666666667;22;26;0.0416666666666666;0.458333333333333
Control.SRR15539829;46;45;0.565217391304348;20;26;0.0652173913043478;0.434782608695652
Control.SRR15539829;45;45;0.444444444444444;25;20;0.0555555555555556;0.444444444444444
Control.SRR15539829;49;45;0.510204081632653;24;25;0.0102040816326531;0.489795918367347
Control.SRR15539829;46;45;0.565217391304348;20;26;0.0652173913043478;0.434782608695652
Control.SRR15539829;47;45;0.48936170212766;24;23;0.0106382978723404;0.48936170212766
Control.SRR15539829;45;45;0.533333333333333;21;24;0.0333333333333333;0.466666666666667
Control.SRR15539829;49;45;0.591836734693878;20;29;0.0918367346938775;0.408163265306122
Control.SRR15539829;48;45;0.416666666666667;28;20;0.0833333333333333;0.416666666666667
Control.SRR15539829;47;45;0.425531914893617;27;20;0.074468085106383;0.425531914893617
Control.SRR15539829;48;45;0.583333333333333;20;28;0.0833333333333334;0.416666666666667
Control.SRR15539829;39;45;0.538461538461538;18;21;0.0384615384615384;0.461538461538462
Control.SRR15539829;51;45;0.470588235294118;27;24;0.0294117647058824;0.470588235294118
Control.SRR15539829;44;45;0.409090909090909;26;18;0.0909090909090909;0.409090909090909
Control.SRR15539829;50;45;0.48;26;24;0.02;0.48
Control.SRR15539829;49;45;0.469387755102041;26;23;0.0306122448979592;0.469387755102041
Control.SRR15539829;45;45;0.555555555555556;20;25;0.0555555555555556;0.444444444444444
Control.SRR15539829;44;45;0.636363636363636;16;28;0.136363636363636;0.363636363636364
Control.SRR15539829;45;45;0.577777777777778;19;26;0.0777777777777777;0.422222222222222
Control.SRR15539829;44;45;0.363636363636364;28;16;0.136363636363636;0.363636363636364
Control.SRR15539829;40;45;0.45;22;18;0.05;0.45
Control.SRR15539829;45;45;0.577777777777778;19;26;0.0777777777777777;0.422222222222222
Control.SRR15539829;41;45;0.536585365853659;19;22;0.0365853658536586;0.463414634146341
Control.SRR15539829;51;45;0.450980392156863;28;23;0.0490196078431372;0.450980392156863
Control.SRR15539829;49;45;0.489795918367347;25;24;0.0102040816326531;0.489795918367347
Control.SRR15539829;39;45;0.41025641025641;23;16;0.0897435897435898;0.41025641025641
Control.SRR15539829;43;45;0.465116279069767;23;20;0.0348837209302326;0.465116279069767
Control.SRR15539829;48;45;0.583333333333333;20;28;0.0833333333333334;0.416666666666667
Control.SRR15539829;43;45;0.651162790697674;15;28;0.151162790697674;0.348837209302326
Control.SRR15539829;40;45;0.5;20;20;0;0.5
Control.SRR15539829;39;45;0.41025641025641;23;16;0.0897435897435898;0.41025641025641
Control.SRR15539829;49;45;0.551020408163265;22;27;0.0510204081632653;0.448979591836735
Control.SRR15539829;43;45;0.627906976744186;16;27;0.127906976744186;0.372093023255814
Control.SRR15539829;46;45;0.478260869565217;24;22;0.0217391304347826;0.478260869565217
Control.SRR15539829;45;45;0.488888888888889;23;22;0.0111111111111111;0.488888888888889
Control.SRR15539829;41;45;0.390243902439024;25;16;0.109756097560976;0.390243902439024
Control.SRR15539829;42;45;0.619047619047619;16;26;0.119047619047619;0.380952380952381
Control.SRR15539829;40;45;0.475;21;19;0.025;0.475
Control.SRR15539829;41;45;0.682926829268293;13;28;0.182926829268293;0.317073170731707
Control.SRR15539829;42;45;0.571428571428571;18;24;0.0714285714285714;0.428571428571429
Control.SRR15539829;45;45;0.555555555555556;20;25;0.0555555555555556;0.444444444444444
Control.SRR15539829;50;45;0.54;23;27;0.04;0.46
Control.SRR15539829;51;45;0.411764705882353;30;21;0.0882352941176471;0.411764705882353
Control.SRR15539829;51;45;0.294117647058824;36;15;0.205882352941176;0.294117647058824
Control.SRR15539829;46;45;0.5;23;23;0;0.5
Control.SRR15539829;43;45;0.558139534883721;19;24;0.0581395348837209;0.441860465116279
Control.SRR15539829;41;45;0.75609756097561;10;31;0.25609756097561;0.24390243902439
Control.SRR15539829;39;45;0.461538461538462;21;18;0.0384615384615384;0.461538461538462
Control.SRR15539829;42;45;0.404761904761905;25;17;0.0952380952380952;0.404761904761905
Control.SRR15539829;42;45;0.404761904761905;25;17;0.0952380952380952;0.404761904761905
Control.SRR15539829;45;45;0.555555555555556;20;25;0.0555555555555556;0.444444444444444
Control.SRR15539829;46;45;0.41304347826087;27;19;0.0869565217391304;0.41304347826087
Control.SRR15539829;50;45;0.52;24;26;0.02;0.48
Control.SRR15539829;45;45;0.466666666666667;24;21;0.0333333333333333;0.466666666666667
Control.SRR15539829;45;45;0.488888888888889;23;22;0.0111111111111111;0.488888888888889
Control.SRR15539829;51;45;0.509803921568627;25;26;0.00980392156862742;0.490196078431373
Control.SRR15539829;49;45;0.387755102040816;30;19;0.112244897959184;0.387755102040816
Control.SRR15539829;45;45;0.555555555555556;20;25;0.0555555555555556;0.444444444444444
Control.SRR15539829;51;45;0.607843137254902;20;31;0.107843137254902;0.392156862745098
Control.SRR15539829;50;45;0.48;26;24;0.02;0.48
Control.SRR15539829;42;45;0.642857142857143;15;27;0.142857142857143;0.357142857142857
Control.SRR15539829;44;45;0.386363636363636;27;17;0.113636363636364;0.386363636363636
Control.SRR15539829;45;45;0.488888888888889;23;22;0.0111111111111111;0.488888888888889
Control.SRR15539829;45;45;0.577777777777778;19;26;0.0777777777777777;0.422222222222222
Control.SRR15539829;40;45;0.45;22;18;0.05;0.45
Control.SRR15539829;47;45;0.468085106382979;25;22;0.0319148936170213;0.468085106382979
Control.SRR15539829;44;45;0.590909090909091;18;26;0.0909090909090909;0.409090909090909
Control.SRR15539829;45;45;0.4;27;18;0.1;0.4
Control.SRR15539829;47;45;0.531914893617021;22;25;0.0319148936170213;0.468085106382979
Control.SRR15539829;41;45;0.51219512195122;20;21;0.0121951219512195;0.48780487804878
Control.SRR15539829;39;45;0.538461538461538;18;21;0.0384615384615384;0.461538461538462
Control.SRR15539829;41;45;0.585365853658537;17;24;0.0853658536585366;0.414634146341463
Control.SRR15539829;42;45;0.476190476190476;22;20;0.0238095238095238;0.476190476190476
Control.SRR15539829;47;45;0.48936170212766;24;23;0.0106382978723404;0.48936170212766
Control.SRR15539829;49;45;0.530612244897959;23;26;0.0306122448979592;0.469387755102041
Control.SRR15539829;45;45;0.6;18;27;0.1;0.4
Control.SRR15539829;44;45;0.522727272727273;21;23;0.0227272727272727;0.477272727272727
Control.SRR15539829;40;45;0.525;19;21;0.025;0.475
Control.SRR15539829;41;45;0.560975609756098;18;23;0.0609756097560976;0.439024390243902
Control.SRR15539829;44;45;0.454545454545455;24;20;0.0454545454545455;0.454545454545455
Control.SRR15539829;46;45;0.5;23;23;0;0.5
Control.SRR15539829;49;45;0.530612244897959;23;26;0.0306122448979592;0.469387755102041
Control.SRR15539829;46;45;0.456521739130435;25;21;0.0434782608695652;0.456521739130435
Control.SRR15539829;48;45;0.5625;21;27;0.0625;0.4375
Control.SRR15539829;50;45;0.52;24;26;0.02;0.48
Control.SRR15539829;42;45;0.428571428571429;24;18;0.0714285714285715;0.428571428571429
Control.SRR15539829;43;45;0.418604651162791;25;18;0.0813953488372093;0.418604651162791
Control.SRR15539829;47;45;0.51063829787234;23;24;0.0106382978723404;0.48936170212766
Control.SRR15539829;43;45;0.558139534883721;19;24;0.0581395348837209;0.441860465116279
Control.SRR15539829;49;45;0.469387755102041;26;23;0.0306122448979592;0.469387755102041
Control.SRR15539829;47;45;0.553191489361702;21;26;0.0531914893617021;0.446808510638298
Control.SRR15539829;50;45;0.58;21;29;0.08;0.42
Control.SRR15539829;47;45;0.531914893617021;22;25;0.0319148936170213;0.468085106382979
Control.SRR15539829;41;45;0.560975609756098;18;23;0.0609756097560976;0.439024390243902
Control.SRR15539829;51;45;0.529411764705882;24;27;0.0294117647058824;0.470588235294118
Control.SRR15539829;46;45;0.41304347826087;27;19;0.0869565217391304;0.41304347826087
Control.SRR15539829;47;45;0.574468085106383;20;27;0.074468085106383;0.425531914893617
Control.SRR15539829;44;45;0.5;22;22;0;0.5
Control.SRR15539829;42;45;0.428571428571429;24;18;0.0714285714285715;0.428571428571429
Control.SRR15539829;45;45;0.555555555555556;20;25;0.0555555555555556;0.444444444444444
Control.SRR15539829;40;45;0.425;23;17;0.075;0.425
Control.SRR15539829;45;45;0.533333333333333;21;24;0.0333333333333333;0.466666666666667
Control.SRR15539829;40;45;0.575;17;23;0.075;0.425
Control.SRR15539829;42;45;0.571428571428571;18;24;0.0714285714285714;0.428571428571429
Control.SRR15539829;43;45;0.674418604651163;14;29;0.174418604651163;0.325581395348837
Control.SRR15539829;42;45;0.595238095238095;17;25;0.0952380952380952;0.404761904761905
Control.SRR15539829;45;45;0.511111111111111;22;23;0.0111111111111111;0.488888888888889
Control.SRR15539829;40;45;0.6;16;24;0.1;0.4
Control.SRR15539829;44;45;0.545454545454545;20;24;0.0454545454545454;0.454545454545455
Control.SRR15539829;45;45;0.488888888888889;23;22;0.0111111111111111;0.488888888888889
Control.SRR15539829;46;45;0.608695652173913;18;28;0.108695652173913;0.391304347826087
Control.SRR15539829;46;45;0.608695652173913;18;28;0.108695652173913;0.391304347826087
Control.SRR15539829;46;45;0.565217391304348;20;26;0.0652173913043478;0.434782608695652
Control.SRR15539829;40;45;0.45;22;18;0.05;0.45
Control.SRR15539829;39;45;0.461538461538462;21;18;0.0384615384615384;0.461538461538462
Control.SRR15539829;45;45;0.488888888888889;23;22;0.0111111111111111;0.488888888888889
Control.SRR15539829;49;45;0.428571428571429;28;21;0.0714285714285715;0.428571428571429
Control.SRR15539829;47;45;0.574468085106383;20;27;0.074468085106383;0.425531914893617
Control.SRR15539829;41;45;0.48780487804878;21;20;0.0121951219512195;0.48780487804878
Control.SRR15539829;47;45;0.468085106382979;25;22;0.0319148936170213;0.468085106382979
Control.SRR15539829;42;45;0.5;21;21;0;0.5
Control.SRR15539829;51;45;0.568627450980392;22;29;0.0686274509803921;0.431372549019608
Control.SRR15539829;42;45;0.357142857142857;27;15;0.142857142857143;0.357142857142857
Control.SRR15539829;40;45;0.4;24;16;0.1;0.4
Control.SRR15539829;39;45;0.615384615384615;15;24;0.115384615384615;0.384615384615385
Control.SRR15539829;45;45;0.511111111111111;22;23;0.0111111111111111;0.488888888888889
Control.SRR15539829;46;45;0.478260869565217;24;22;0.0217391304347826;0.478260869565217
Control.SRR15539829;40;45;0.5;20;20;0;0.5
Control.SRR15539829;42;45;0.428571428571429;24;18;0.0714285714285715;0.428571428571429
Control.SRR15539829;48;45;0.395833333333333;29;19;0.104166666666667;0.395833333333333
Control.SRR15539829;45;45;0.511111111111111;22;23;0.0111111111111111;0.488888888888889
Control.SRR15539829;39;45;0.512820512820513;19;20;0.0128205128205128;0.487179487179487
Control.SRR15539829;40;45;0.5;20;20;0;0.5
Control.SRR15539829;43;45;0.581395348837209;18;25;0.0813953488372093;0.418604651162791
Control.SRR15539829;48;45;0.4375;27;21;0.0625;0.4375
Control.SRR15539829;42;45;0.428571428571429;24;18;0.0714285714285715;0.428571428571429
Control.SRR15539829;43;45;0.558139534883721;19;24;0.0581395348837209;0.441860465116279
Control.SRR15539829;40;45;0.5;20;20;0;0.5
Control.SRR15539829;41;45;0.439024390243902;23;18;0.0609756097560976;0.439024390243902
Control.SRR15539829;39;45;0.487179487179487;20;19;0.0128205128205128;0.487179487179487
Control.SRR15539829;39;45;0.538461538461538;18;21;0.0384615384615384;0.461538461538462
Control.SRR15539829;41;45;0.560975609756098;18;23;0.0609756097560976;0.439024390243902
Control.SRR15539829;41;45;0.414634146341463;24;17;0.0853658536585366;0.414634146341463
Control.SRR15539829;50;45;0.58;21;29;0.08;0.42
Control.SRR15539829;41;45;0.439024390243902;23;18;0.0609756097560976;0.439024390243902
Control.SRR15539829;46;45;0.434782608695652;26;20;0.0652173913043478;0.434782608695652
Control.SRR15539829;47;45;0.595744680851064;19;28;0.0957446808510638;0.404255319148936
Control.SRR15539829;50;45;0.52;24;26;0.02;0.48
Control.SRR15539829;43;45;0.581395348837209;18;25;0.0813953488372093;0.418604651162791
Control.SRR15539829;44;45;0.5;22;22;0;0.5
Control.SRR15539829;39;45;0.487179487179487;20;19;0.0128205128205128;0.487179487179487
Control.SRR15539829;46;45;0.630434782608696;17;29;0.130434782608696;0.369565217391304
Control.SRR15539829;49;45;0.591836734693878;20;29;0.0918367346938775;0.408163265306122
Control.SRR15539829;51;45;0.588235294117647;21;30;0.0882352941176471;0.411764705882353
Control.SRR15539829;46;45;0.456521739130435;25;21;0.0434782608695652;0.456521739130435
Control.SRR15539829;51;45;0.588235294117647;21;30;0.0882352941176471;0.411764705882353
Control.SRR15539829;40;45;0.525;19;21;0.025;0.475
Control.SRR15539829;47;45;0.617021276595745;18;29;0.117021276595745;0.382978723404255
Control.SRR15539829;44;45;0.454545454545455;24;20;0.0454545454545455;0.454545454545455
Control.SRR15539829;49;45;0.448979591836735;27;22;0.0510204081632653;0.448979591836735
Control.SRR15539829;42;45;0.476190476190476;22;20;0.0238095238095238;0.476190476190476
Control.SRR15539829;42;45;0.5;21;21;0;0.5
Control.SRR15539829;40;45;0.575;17;23;0.075;0.425
Control.SRR15539829;41;45;0.463414634146341;22;19;0.0365853658536585;0.463414634146341
Control.SRR15539829;40;45;0.45;22;18;0.05;0.45
Control.SRR15539829;45;45;0.488888888888889;23;22;0.0111111111111111;0.488888888888889
Control.SRR15539829;49;45;0.73469387755102;13;36;0.23469387755102;0.26530612244898
Control.SRR15539829;45;45;0.422222222222222;26;19;0.0777777777777778;0.422222222222222
Control.SRR15539829;50;45;0.54;23;27;0.04;0.46
Control.SRR15539829;45;45;0.422222222222222;26;19;0.0777777777777778;0.422222222222222
Control.SRR15539829;44;45;0.454545454545455;24;20;0.0454545454545455;0.454545454545455
Control.SRR15539829;40;45;0.45;22;18;0.05;0.45
Control.SRR15539829;46;45;0.456521739130435;25;21;0.0434782608695652;0.456521739130435
Control.SRR15539829;45;45;0.466666666666667;24;21;0.0333333333333333;0.466666666666667
Control.SRR15539829;49;45;0.530612244897959;23;26;0.0306122448979592;0.469387755102041
Control.SRR15539829;40;45;0.475;21;19;0.025;0.475
Control.SRR15539829;42;45;0.5;21;21;0;0.5
Control.SRR15539829;45;45;0.511111111111111;22;23;0.0111111111111111;0.488888888888889
Control.SRR15539829;42;45;0.476190476190476;22;20;0.0238095238095238;0.476190476190476
Control.SRR15539829;46;45;0.434782608695652;26;20;0.0652173913043478;0.434782608695652
Control.SRR15539829;46;45;0.608695652173913;18;28;0.108695652173913;0.391304347826087
Control.SRR15539829;47;45;0.425531914893617;27;20;0.074468085106383;0.425531914893617
Control.SRR15539829;42;45;0.476190476190476;22;20;0.0238095238095238;0.476190476190476
Control.SRR15539829;44;45;0.568181818181818;19;25;0.0681818181818182;0.431818181818182
Control.SRR15539829;48;45;0.458333333333333;26;22;0.0416666666666667;0.458333333333333
Control.SRR15539829;42;45;0.452380952380952;23;19;0.0476190476190476;0.452380952380952
Control.SRR15539829;41;45;0.609756097560976;16;25;0.109756097560976;0.390243902439024
Control.SRR15539829;47;45;0.48936170212766;24;23;0.0106382978723404;0.48936170212766
Control.SRR15539829;44;45;0.5;22;22;0;0.5
Control.SRR15539829;44;45;0.477272727272727;23;21;0.0227272727272727;0.477272727272727
Control.SRR15539829;47;45;0.595744680851064;19;28;0.0957446808510638;0.404255319148936
Control.SRR15539829;41;45;0.463414634146341;22;19;0.0365853658536585;0.463414634146341
Control.SRR15539829;46;45;0.521739130434783;22;24;0.0217391304347826;0.478260869565217
Control.SRR15539829;42;45;0.428571428571429;24;18;0.0714285714285715;0.428571428571429
Control.SRR15539829;45;45;0.466666666666667;24;21;0.0333333333333333;0.466666666666667
Control.SRR15539829;50;45;0.44;28;22;0.06;0.44
Control.SRR15539829;40;45;0.5;20;20;0;0.5
Control.SRR15539829;43;45;0.302325581395349;30;13;0.197674418604651;0.302325581395349
Control.SRR15539829;46;45;0.58695652173913;19;27;0.0869565217391305;0.41304347826087
Control.SRR15539829;45;45;0.688888888888889;14;31;0.188888888888889;0.311111111111111
Control.SRR15539829;42;45;0.595238095238095;17;25;0.0952380952380952;0.404761904761905
Control.SRR15539829;50;45;0.56;22;28;0.0600000000000001;0.44
Control.SRR15539829;45;45;0.488888888888889;23;22;0.0111111111111111;0.488888888888889
Control.SRR15539829;41;45;0.51219512195122;20;21;0.0121951219512195;0.48780487804878
Control.SRR15539829;42;45;0.69047619047619;13;29;0.19047619047619;0.30952380952381
Control.SRR15539829;40;45;0.475;21;19;0.025;0.475
Control.SRR15539829;50;45;0.54;23;27;0.04;0.46
Control.SRR15539829;41;45;0.51219512195122;20;21;0.0121951219512195;0.48780487804878
Control.SRR15539829;42;45;0.404761904761905;25;17;0.0952380952380952;0.404761904761905
Control.SRR15539829;44;45;0.522727272727273;21;23;0.0227272727272727;0.477272727272727
Control.SRR15539829;46;45;0.565217391304348;20;26;0.0652173913043478;0.434782608695652
Control.SRR15539829;43;45;0.395348837209302;26;17;0.104651162790698;0.395348837209302
Control.SRR15539829;44;45;0.5;22;22;0;0.5
Control.SRR15539829;42;45;0.595238095238095;17;25;0.0952380952380952;0.404761904761905
Control.SRR15539829;45;45;0.6;18;27;0.1;0.4
Control.SRR15539829;43;45;0.418604651162791;25;18;0.0813953488372093;0.418604651162791
Control.SRR15539829;48;45;0.541666666666667;22;26;0.0416666666666666;0.458333333333333
Control.SRR15539829;46;45;0.521739130434783;22;24;0.0217391304347826;0.478260869565217
Control.SRR15539829;41;45;0.390243902439024;25;16;0.109756097560976;0.390243902439024
Control.SRR15539829;45;45;0.644444444444444;16;29;0.144444444444444;0.355555555555556
Control.SRR15539829;44;45;0.522727272727273;21;23;0.0227272727272727;0.477272727272727
Control.SRR15539829;43;45;0.581395348837209;18;25;0.0813953488372093;0.418604651162791
Control.SRR15539829;45;45;0.488888888888889;23;22;0.0111111111111111;0.488888888888889
Control.SRR15539829;45;45;0.511111111111111;22;23;0.0111111111111111;0.488888888888889
Control.SRR15539829;45;45;0.577777777777778;19;26;0.0777777777777777;0.422222222222222
Control.SRR15539829;42;45;0.333333333333333;28;14;0.166666666666667;0.333333333333333
Control.SRR15539829;47;45;0.617021276595745;18;29;0.117021276595745;0.382978723404255
Control.SRR15539829;48;45;0.520833333333333;23;25;0.0208333333333334;0.479166666666667
Control.SRR15539829;42;45;0.476190476190476;22;20;0.0238095238095238;0.476190476190476
Control.SRR15539829;47;45;0.48936170212766;24;23;0.0106382978723404;0.48936170212766
Control.SRR15539829;40;45;0.575;17;23;0.075;0.425
Control.SRR15539829;45;45;0.533333333333333;21;24;0.0333333333333333;0.466666666666667
Control.SRR15539829;48;45;0.458333333333333;26;22;0.0416666666666667;0.458333333333333
Control.SRR15539829;48;45;0.458333333333333;26;22;0.0416666666666667;0.458333333333333
Control.SRR15539829;43;45;0.558139534883721;19;24;0.0581395348837209;0.441860465116279
Control.SRR15539829;43;45;0.465116279069767;23;20;0.0348837209302326;0.465116279069767
Control.SRR15539829;45;45;0.533333333333333;21;24;0.0333333333333333;0.466666666666667
Control.SRR15539829;47;45;0.468085106382979;25;22;0.0319148936170213;0.468085106382979
Control.SRR15539829;51;45;0.509803921568627;25;26;0.00980392156862742;0.490196078431373
Control.SRR15539829;47;45;0.574468085106383;20;27;0.074468085106383;0.425531914893617
Control.SRR15539829;43;45;0.558139534883721;19;24;0.0581395348837209;0.441860465116279
Control.SRR15539829;39;45;0.435897435897436;22;17;0.0641025641025641;0.435897435897436
Control.SRR15539829;43;45;0.372093023255814;27;16;0.127906976744186;0.372093023255814
Control.SRR15539829;41;45;0.463414634146341;22;19;0.0365853658536585;0.463414634146341
Control.SRR15539829;39;45;0.615384615384615;15;24;0.115384615384615;0.384615384615385
Control.SRR15539829;40;45;0.325;27;13;0.175;0.325
Control.SRR15539829;42;45;0.571428571428571;18;24;0.0714285714285714;0.428571428571429
Control.SRR15539829;48;45;0.479166666666667;25;23;0.0208333333333333;0.479166666666667
Control.SRR15539829;47;45;0.638297872340426;17;30;0.138297872340426;0.361702127659574
Control.SRR15539829;47;45;0.446808510638298;26;21;0.0531914893617021;0.446808510638298
Control.SRR15539829;44;45;0.613636363636364;17;27;0.113636363636364;0.386363636363636
Control.SRR15539829;40;45;0.525;19;21;0.025;0.475
Control.SRR15539829;41;45;0.463414634146341;22;19;0.0365853658536585;0.463414634146341
Control.SRR15539829;44;45;0.477272727272727;23;21;0.0227272727272727;0.477272727272727
Control.SRR15539829;42;45;0.571428571428571;18;24;0.0714285714285714;0.428571428571429
Control.SRR15539829;44;45;0.431818181818182;25;19;0.0681818181818182;0.431818181818182
Control.SRR15539829;47;45;0.404255319148936;28;19;0.0957446808510639;0.404255319148936
Control.SRR15539829;43;45;0.534883720930233;20;23;0.0348837209302325;0.465116279069767
Control.SRR15539829;39;45;0.512820512820513;19;20;0.0128205128205128;0.487179487179487
Control.SRR15539829;39;45;0.564102564102564;17;22;0.0641025641025641;0.435897435897436
Control.SRR15539829;49;45;0.448979591836735;27;22;0.0510204081632653;0.448979591836735
Control.SRR15539829;39;45;0.564102564102564;17;22;0.0641025641025641;0.435897435897436
Control.SRR15539829;47;45;0.319148936170213;32;15;0.180851063829787;0.319148936170213
Control.SRR15539829;47;45;0.404255319148936;28;19;0.0957446808510639;0.404255319148936
Control.SRR15539829;45;45;0.444444444444444;25;20;0.0555555555555556;0.444444444444444
Control.SRR15539829;44;45;0.5;22;22;0;0.5
Control.SRR15539829;45;45;0.4;27;18;0.1;0.4
Control.SRR15539829;46;45;0.456521739130435;25;21;0.0434782608695652;0.456521739130435
Control.SRR15539829;45;45;0.555555555555556;20;25;0.0555555555555556;0.444444444444444
Control.SRR15539829;41;45;0.585365853658537;17;24;0.0853658536585366;0.414634146341463
Control.SRR15539829;40;45;0.45;22;18;0.05;0.45
Control.SRR15539829;40;45;0.45;22;18;0.05;0.45
Control.SRR15539829;46;45;0.608695652173913;18;28;0.108695652173913;0.391304347826087
Control.SRR15539829;40;45;0.475;21;19;0.025;0.475
Control.SRR15539829;43;45;0.488372093023256;22;21;0.0116279069767442;0.488372093023256
Control.SRR15539829;39;45;0.461538461538462;21;18;0.0384615384615384;0.461538461538462
Control.SRR15539829;48;45;0.625;18;30;0.125;0.375
Control.SRR15539829;42;45;0.642857142857143;15;27;0.142857142857143;0.357142857142857
Control.SRR15539829;49;45;0.530612244897959;23;26;0.0306122448979592;0.469387755102041
Control.SRR15539829;44;45;0.477272727272727;23;21;0.0227272727272727;0.477272727272727
Control.SRR15539829;44;45;0.409090909090909;26;18;0.0909090909090909;0.409090909090909
Control.SRR15539829;39;45;0.58974358974359;16;23;0.0897435897435898;0.41025641025641
Control.SRR15539829;48;45;0.625;18;30;0.125;0.375
Control.SRR15539829;44;45;0.522727272727273;21;23;0.0227272727272727;0.477272727272727
Control.SRR15539829;39;45;0.615384615384615;15;24;0.115384615384615;0.384615384615385
Control.SRR15539829;40;45;0.475;21;19;0.025;0.475
Control.SRR15539829;44;45;0.477272727272727;23;21;0.0227272727272727;0.477272727272727
Control.SRR15539829;41;45;0.51219512195122;20;21;0.0121951219512195;0.48780487804878
Control.SRR15539829;39;45;0.564102564102564;17;22;0.0641025641025641;0.435897435897436
Control.SRR15539829;46;45;0.608695652173913;18;28;0.108695652173913;0.391304347826087
Control.SRR15539829;40;45;0.575;17;23;0.075;0.425
Control.SRR15539829;43;45;0.441860465116279;24;19;0.0581395348837209;0.441860465116279
Control.SRR15539829;50;45;0.48;26;24;0.02;0.48
Control.SRR15539829;42;45;0.619047619047619;16;26;0.119047619047619;0.380952380952381
Control.SRR15539829;51;45;0.411764705882353;30;21;0.0882352941176471;0.411764705882353
Control.SRR15539829;50;45;0.5;25;25;0;0.5
Control.SRR15539829;49;45;0.408163265306122;29;20;0.0918367346938775;0.408163265306122
Control.SRR15539829;45;45;0.6;18;27;0.1;0.4
Control.SRR15539829;42;45;0.476190476190476;22;20;0.0238095238095238;0.476190476190476
Control.SRR15539829;40;45;0.425;23;17;0.075;0.425
Control.SRR15539829;43;45;0.511627906976744;21;22;0.0116279069767442;0.488372093023256
Control.SRR15539829;42;45;0.380952380952381;26;16;0.119047619047619;0.380952380952381
Control.SRR15539829;42;45;0.523809523809524;20;22;0.0238095238095238;0.476190476190476
Control.SRR15539829;39;45;0.564102564102564;17;22;0.0641025641025641;0.435897435897436
Control.SRR15539829;47;45;0.553191489361702;21;26;0.0531914893617021;0.446808510638298
Control.SRR15539829;44;45;0.545454545454545;20;24;0.0454545454545454;0.454545454545455
Control.SRR15539829;42;45;0.619047619047619;16;26;0.119047619047619;0.380952380952381
Control.SRR15539829;42;45;0.595238095238095;17;25;0.0952380952380952;0.404761904761905
Control.SRR15539829;51;45;0.490196078431373;26;25;0.00980392156862747;0.490196078431373
Control.SRR15539829;44;45;0.454545454545455;24;20;0.0454545454545455;0.454545454545455
Control.SRR15539829;45;45;0.422222222222222;26;19;0.0777777777777778;0.422222222222222
Control.SRR15539829;45;45;0.355555555555556;29;16;0.144444444444444;0.355555555555556
Control.SRR15539829;42;45;0.523809523809524;20;22;0.0238095238095238;0.476190476190476
Control.SRR15539829;43;45;0.511627906976744;21;22;0.0116279069767442;0.488372093023256
Control.SRR15539829;44;45;0.477272727272727;23;21;0.0227272727272727;0.477272727272727
Control.SRR15539829;47;45;0.531914893617021;22;25;0.0319148936170213;0.468085106382979
Control.SRR15539829;41;45;0.48780487804878;21;20;0.0121951219512195;0.48780487804878
Control.SRR15539829;50;45;0.5;25;25;0;0.5
Control.SRR15539829;49;45;0.551020408163265;22;27;0.0510204081632653;0.448979591836735
Control.SRR15539829;44;45;0.545454545454545;20;24;0.0454545454545454;0.454545454545455
Control.SRR15539829;45;45;0.644444444444444;16;29;0.144444444444444;0.355555555555556
Control.SRR15539829;43;45;0.465116279069767;23;20;0.0348837209302326;0.465116279069767
Control.SRR15539829;40;45;0.425;23;17;0.075;0.425
Control.SRR15539829;48;45;0.4375;27;21;0.0625;0.4375
Control.SRR15539829;47;45;0.468085106382979;25;22;0.0319148936170213;0.468085106382979
Control.SRR15539829;42;45;0.547619047619048;19;23;0.0476190476190477;0.452380952380952
Control.SRR15539829;40;45;0.6;16;24;0.1;0.4
Control.SRR15539829;41;45;0.51219512195122;20;21;0.0121951219512195;0.48780487804878
Control.SRR15539829;51;45;0.549019607843137;23;28;0.0490196078431373;0.450980392156863
Control.SRR15539829;39;45;0.564102564102564;17;22;0.0641025641025641;0.435897435897436
Control.SRR15539829;51;45;0.568627450980392;22;29;0.0686274509803921;0.431372549019608
Control.SRR15539829;39;45;0.58974358974359;16;23;0.0897435897435898;0.41025641025641
Control.SRR15539829;46;45;0.543478260869565;21;25;0.0434782608695652;0.456521739130435
Control.SRR15539829;46;45;0.565217391304348;20;26;0.0652173913043478;0.434782608695652
Control.SRR15539829;40;45;0.55;18;22;0.05;0.45
Control.SRR15539829;44;45;0.613636363636364;17;27;0.113636363636364;0.386363636363636
Control.SRR15539829;40;45;0.45;22;18;0.05;0.45
Control.SRR15539829;41;45;0.51219512195122;20;21;0.0121951219512195;0.48780487804878
Control.SRR15539829;40;45;0.375;25;15;0.125;0.375
Control.SRR15539829;39;45;0.435897435897436;22;17;0.0641025641025641;0.435897435897436
Control.SRR15539829;41;45;0.536585365853659;19;22;0.0365853658536586;0.463414634146341
Control.SRR15539829;46;45;0.478260869565217;24;22;0.0217391304347826;0.478260869565217
Control.SRR15539829;46;45;0.630434782608696;17;29;0.130434782608696;0.369565217391304
Control.SRR15539829;45;45;0.511111111111111;22;23;0.0111111111111111;0.488888888888889
Control.SRR15539829;49;45;0.408163265306122;29;20;0.0918367346938775;0.408163265306122
Control.SRR15539829;50;45;0.5;25;25;0;0.5
Control.SRR15539829;45;45;0.422222222222222;26;19;0.0777777777777778;0.422222222222222
Control.SRR15539829;48;45;0.479166666666667;25;23;0.0208333333333333;0.479166666666667
Control.SRR15539829;47;45;0.51063829787234;23;24;0.0106382978723404;0.48936170212766
Control.SRR15539829;40;45;0.475;21;19;0.025;0.475
Control.SRR15539829;41;45;0.585365853658537;17;24;0.0853658536585366;0.414634146341463
Control.SRR15539829;47;45;0.382978723404255;29;18;0.117021276595745;0.382978723404255
Control.SRR15539829;48;45;0.458333333333333;26;22;0.0416666666666667;0.458333333333333
Control.SRR15539829;46;45;0.456521739130435;25;21;0.0434782608695652;0.456521739130435
Control.SRR15539829;39;45;0.512820512820513;19;20;0.0128205128205128;0.487179487179487
Control.SRR15539829;45;45;0.733333333333333;12;33;0.233333333333333;0.266666666666667
Control.SRR15539829;46;45;0.41304347826087;27;19;0.0869565217391304;0.41304347826087
Control.SRR15539829;39;45;0.435897435897436;22;17;0.0641025641025641;0.435897435897436
Control.SRR15539829;45;45;0.533333333333333;21;24;0.0333333333333333;0.466666666666667
Control.SRR15539829;41;45;0.414634146341463;24;17;0.0853658536585366;0.414634146341463
Control.SRR15539829;41;45;0.414634146341463;24;17;0.0853658536585366;0.414634146341463
Control.SRR15539829;50;45;0.48;26;24;0.02;0.48
Control.SRR15539829;42;45;0.619047619047619;16;26;0.119047619047619;0.380952380952381
Control.SRR15539829;45;45;0.444444444444444;25;20;0.0555555555555556;0.444444444444444
Control.SRR15539829;46;45;0.456521739130435;25;21;0.0434782608695652;0.456521739130435
Control.SRR15539829;46;45;0.5;23;23;0;0.5
Control.SRR15539829;51;45;0.431372549019608;29;22;0.0686274509803921;0.431372549019608
Control.SRR15539829;43;45;0.441860465116279;24;19;0.0581395348837209;0.441860465116279
Control.SRR15539829;44;45;0.522727272727273;21;23;0.0227272727272727;0.477272727272727
Control.SRR15539829;48;45;0.479166666666667;25;23;0.0208333333333333;0.479166666666667
Control.SRR15539829;40;45;0.525;19;21;0.025;0.475
Control.SRR15539829;44;45;0.5;22;22;0;0.5
Control.SRR15539829;40;45;0.375;25;15;0.125;0.375
Control.SRR15539829;44;45;0.590909090909091;18;26;0.0909090909090909;0.409090909090909
Control.SRR15539829;45;45;0.533333333333333;21;24;0.0333333333333333;0.466666666666667
Control.SRR15539829;43;45;0.604651162790698;17;26;0.104651162790698;0.395348837209302
Control.SRR15539829;46;45;0.565217391304348;20;26;0.0652173913043478;0.434782608695652
Control.SRR15539829;49;45;0.428571428571429;28;21;0.0714285714285715;0.428571428571429
Control.SRR15539829;45;45;0.488888888888889;23;22;0.0111111111111111;0.488888888888889
Control.SRR15539829;49;45;0.489795918367347;25;24;0.0102040816326531;0.489795918367347
Control.SRR15539829;44;45;0.340909090909091;29;15;0.159090909090909;0.340909090909091
Control.SRR15539829;47;45;0.48936170212766;24;23;0.0106382978723404;0.48936170212766
Control.SRR15539829;44;45;0.477272727272727;23;21;0.0227272727272727;0.477272727272727
Control.SRR15539829;44;45;0.477272727272727;23;21;0.0227272727272727;0.477272727272727
Control.SRR15539829;40;45;0.45;22;18;0.05;0.45
Control.SRR15539829;42;45;0.523809523809524;20;22;0.0238095238095238;0.476190476190476
Control.SRR15539829;44;45;0.454545454545455;24;20;0.0454545454545455;0.454545454545455
Control.SRR15539829;43;45;0.488372093023256;22;21;0.0116279069767442;0.488372093023256
Control.SRR15539829;49;45;0.448979591836735;27;22;0.0510204081632653;0.448979591836735
Control.SRR15539829;39;45;0.58974358974359;16;23;0.0897435897435898;0.41025641025641
Control.SRR15539829;43;45;0.558139534883721;19;24;0.0581395348837209;0.441860465116279
Control.SRR15539829;46;45;0.5;23;23;0;0.5
Control.SRR15539829;43;45;0.488372093023256;22;21;0.0116279069767442;0.488372093023256
Control.SRR15539829;45;45;0.555555555555556;20;25;0.0555555555555556;0.444444444444444
Control.SRR15539829;50;45;0.72;14;36;0.22;0.28
Control.SRR15539829;50;45;0.54;23;27;0.04;0.46
Control.SRR15539829;45;45;0.466666666666667;24;21;0.0333333333333333;0.466666666666667
Control.SRR15539829;39;45;0.41025641025641;23;16;0.0897435897435898;0.41025641025641
Control.SRR15539829;47;45;0.48936170212766;24;23;0.0106382978723404;0.48936170212766
Control.SRR15539829;48;45;0.333333333333333;32;16;0.166666666666667;0.333333333333333
Control.SRR15539829;48;45;0.458333333333333;26;22;0.0416666666666667;0.458333333333333
Control.SRR15539829;43;45;0.488372093023256;22;21;0.0116279069767442;0.488372093023256
Control.SRR15539829;48;45;0.604166666666667;19;29;0.104166666666667;0.395833333333333
Control.SRR15539829;42;45;0.523809523809524;20;22;0.0238095238095238;0.476190476190476
Control.SRR15539829;51;45;0.588235294117647;21;30;0.0882352941176471;0.411764705882353
Control.SRR15539829;40;45;0.55;18;22;0.05;0.45
Control.SRR15539829;47;45;0.468085106382979;25;22;0.0319148936170213;0.468085106382979
Control.SRR15539829;46;45;0.543478260869565;21;25;0.0434782608695652;0.456521739130435
Control.SRR15539829;49;45;0.510204081632653;24;25;0.0102040816326531;0.489795918367347
Control.SRR15539829;43;45;0.465116279069767;23;20;0.0348837209302326;0.465116279069767
Control.SRR15539829;49;45;0.489795918367347;25;24;0.0102040816326531;0.489795918367347
Control.SRR15539829;48;45;0.5625;21;27;0.0625;0.4375
Control.SRR15539829;46;45;0.5;23;23;0;0.5
Control.SRR15539829;45;45;0.466666666666667;24;21;0.0333333333333333;0.466666666666667
Control.SRR15539829;49;45;0.551020408163265;22;27;0.0510204081632653;0.448979591836735
Control.SRR15539829;47;45;0.659574468085106;16;31;0.159574468085106;0.340425531914894
Control.SRR15539829;50;45;0.48;26;24;0.02;0.48
Control.SRR15539829;44;45;0.659090909090909;15;29;0.159090909090909;0.340909090909091
Control.SRR15539829;41;45;0.439024390243902;23;18;0.0609756097560976;0.439024390243902
Control.SRR15539829;42;45;0.404761904761905;25;17;0.0952380952380952;0.404761904761905
Control.SRR15539829;45;45;0.444444444444444;25;20;0.0555555555555556;0.444444444444444
Control.SRR15539829;50;45;0.48;26;24;0.02;0.48
Control.SRR15539829;50;45;0.48;26;24;0.02;0.48
Control.SRR15539829;48;45;0.395833333333333;29;19;0.104166666666667;0.395833333333333
Control.SRR15539829;49;45;0.571428571428571;21;28;0.0714285714285714;0.428571428571429
Control.SRR15539829;50;45;0.6;20;30;0.1;0.4
Control.SRR15539829;46;45;0.543478260869565;21;25;0.0434782608695652;0.456521739130435
Control.SRR15539829;47;45;0.574468085106383;20;27;0.074468085106383;0.425531914893617
Control.SRR15539829;44;45;0.590909090909091;18;26;0.0909090909090909;0.409090909090909
Control.SRR15539829;46;45;0.478260869565217;24;22;0.0217391304347826;0.478260869565217
Control.SRR15539829;43;45;0.651162790697674;15;28;0.151162790697674;0.348837209302326
Control.SRR15539829;48;45;0.604166666666667;19;29;0.104166666666667;0.395833333333333
Control.SRR15539829;40;45;0.475;21;19;0.025;0.475
Control.SRR15539829;47;45;0.553191489361702;21;26;0.0531914893617021;0.446808510638298
Control.SRR15539829;47;45;0.51063829787234;23;24;0.0106382978723404;0.48936170212766
Control.SRR15539829;47;45;0.468085106382979;25;22;0.0319148936170213;0.468085106382979
Control.SRR15539829;41;45;0.414634146341463;24;17;0.0853658536585366;0.414634146341463
Control.SRR15539829;43;45;0.604651162790698;17;26;0.104651162790698;0.395348837209302
Control.SRR15539829;44;45;0.5;22;22;0;0.5
Control.SRR15539829;44;45;0.522727272727273;21;23;0.0227272727272727;0.477272727272727
Control.SRR15539829;46;45;0.565217391304348;20;26;0.0652173913043478;0.434782608695652
Control.SRR15539829;43;45;0.558139534883721;19;24;0.0581395348837209;0.441860465116279
Control.SRR15539829;40;45;0.5;20;20;0;0.5
Control.SRR15539829;41;45;0.609756097560976;16;25;0.109756097560976;0.390243902439024
Control.SRR15539829;44;45;0.477272727272727;23;21;0.0227272727272727;0.477272727272727
Control.SRR15539829;43;45;0.465116279069767;23;20;0.0348837209302326;0.465116279069767
Control.SRR15539829;43;45;0.465116279069767;23;20;0.0348837209302326;0.465116279069767
Control.SRR15539829;43;45;0.534883720930233;20;23;0.0348837209302325;0.465116279069767
Control.SRR15539829;51;45;0.607843137254902;20;31;0.107843137254902;0.392156862745098
Control.SRR15539829;44;45;0.5;22;22;0;0.5
Control.SRR15539829;42;45;0.571428571428571;18;24;0.0714285714285714;0.428571428571429
Control.SRR15539829;45;45;0.466666666666667;24;21;0.0333333333333333;0.466666666666667
Control.SRR15539829;46;45;0.41304347826087;27;19;0.0869565217391304;0.41304347826087
Control.SRR15539829;39;45;0.615384615384615;15;24;0.115384615384615;0.384615384615385
Control.SRR15539829;49;45;0.551020408163265;22;27;0.0510204081632653;0.448979591836735
Control.SRR15539829;45;45;0.444444444444444;25;20;0.0555555555555556;0.444444444444444
Control.SRR15539829;40;45;0.35;26;14;0.15;0.35
Control.SRR15539829;40;45;0.3;28;12;0.2;0.3
Control.SRR15539829;39;45;0.435897435897436;22;17;0.0641025641025641;0.435897435897436
Control.SRR15539829;44;45;0.613636363636364;17;27;0.113636363636364;0.386363636363636
Control.SRR15539829;51;45;0.568627450980392;22;29;0.0686274509803921;0.431372549019608
Control.SRR15539829;50;45;0.62;19;31;0.12;0.38
Control.SRR15539829;50;45;0.54;23;27;0.04;0.46
Control.SRR15539829;40;45;0.425;23;17;0.075;0.425
Control.SRR15539829;45;45;0.422222222222222;26;19;0.0777777777777778;0.422222222222222
Control.SRR15539829;42;45;0.428571428571429;24;18;0.0714285714285715;0.428571428571429
Control.SRR15539829;43;45;0.488372093023256;22;21;0.0116279069767442;0.488372093023256
Control.SRR15539829;43;45;0.627906976744186;16;27;0.127906976744186;0.372093023255814
Control.SRR15539829;49;45;0.571428571428571;21;28;0.0714285714285714;0.428571428571429
Control.SRR15539829;41;45;0.536585365853659;19;22;0.0365853658536586;0.463414634146341
Control.SRR15539829;44;45;0.431818181818182;25;19;0.0681818181818182;0.431818181818182
Control.SRR15539829;46;45;0.369565217391304;29;17;0.130434782608696;0.369565217391304
Control.SRR15539829;43;45;0.418604651162791;25;18;0.0813953488372093;0.418604651162791
Control.SRR15539829;43;45;0.581395348837209;18;25;0.0813953488372093;0.418604651162791
Control.SRR15539829;46;45;0.652173913043478;16;30;0.152173913043478;0.347826086956522
Control.SRR15539829;45;45;0.4;27;18;0.1;0.4
Control.SRR15539829;44;45;0.477272727272727;23;21;0.0227272727272727;0.477272727272727
Control.SRR15539829;41;45;0.48780487804878;21;20;0.0121951219512195;0.48780487804878
Control.SRR15539829;51;45;0.568627450980392;22;29;0.0686274509803921;0.431372549019608
Control.SRR15539829;40;45;0.5;20;20;0;0.5
Control.SRR15539829;47;45;0.425531914893617;27;20;0.074468085106383;0.425531914893617
Control.SRR15539829;42;45;0.476190476190476;22;20;0.0238095238095238;0.476190476190476
Control.SRR15539829;39;45;0.41025641025641;23;16;0.0897435897435898;0.41025641025641
Control.SRR15539829;41;45;0.609756097560976;16;25;0.109756097560976;0.390243902439024
Control.SRR15539829;45;45;0.466666666666667;24;21;0.0333333333333333;0.466666666666667
Control.SRR15539829;43;45;0.534883720930233;20;23;0.0348837209302325;0.465116279069767
Control.SRR15539829;41;45;0.48780487804878;21;20;0.0121951219512195;0.48780487804878
Control.SRR15539829;44;45;0.545454545454545;20;24;0.0454545454545454;0.454545454545455
Control.SRR15539829;41;45;0.536585365853659;19;22;0.0365853658536586;0.463414634146341
Control.SRR15539829;49;45;0.530612244897959;23;26;0.0306122448979592;0.469387755102041
Control.SRR15539829;40;45;0.475;21;19;0.025;0.475
Control.SRR15539829;42;45;0.476190476190476;22;20;0.0238095238095238;0.476190476190476
Control.SRR15539829;49;45;0.551020408163265;22;27;0.0510204081632653;0.448979591836735
Control.SRR15539829;44;45;0.431818181818182;25;19;0.0681818181818182;0.431818181818182
Control.SRR15539829;42;45;0.404761904761905;25;17;0.0952380952380952;0.404761904761905
Control.SRR15539829;46;45;0.5;23;23;0;0.5
Control.SRR15539829;41;45;0.463414634146341;22;19;0.0365853658536585;0.463414634146341
Control.SRR15539829;46;45;0.5;23;23;0;0.5
Control.SRR15539829;47;45;0.553191489361702;21;26;0.0531914893617021;0.446808510638298
Control.SRR15539829;44;45;0.704545454545455;13;31;0.204545454545455;0.295454545454545
Control.SRR15539829;43;45;0.372093023255814;27;16;0.127906976744186;0.372093023255814
Control.SRR15539829;44;45;0.431818181818182;25;19;0.0681818181818182;0.431818181818182
Control.SRR15539829;47;45;0.425531914893617;27;20;0.074468085106383;0.425531914893617
Control.SRR15539829;51;45;0.411764705882353;30;21;0.0882352941176471;0.411764705882353
Control.SRR15539829;49;45;0.510204081632653;24;25;0.0102040816326531;0.489795918367347
Control.SRR15539829;43;45;0.697674418604651;13;30;0.197674418604651;0.302325581395349
Control.SRR15539829;49;45;0.551020408163265;22;27;0.0510204081632653;0.448979591836735
Control.SRR15539829;45;45;0.444444444444444;25;20;0.0555555555555556;0.444444444444444
Control.SRR15539829;41;45;0.48780487804878;21;20;0.0121951219512195;0.48780487804878
Control.SRR15539829;44;45;0.477272727272727;23;21;0.0227272727272727;0.477272727272727
Control.SRR15539829;40;45;0.4;24;16;0.1;0.4
Control.SRR15539829;41;45;0.51219512195122;20;21;0.0121951219512195;0.48780487804878
Control.SRR15539829;39;45;0.487179487179487;20;19;0.0128205128205128;0.487179487179487
Control.SRR15539829;50;45;0.46;27;23;0.04;0.46
Control.SRR15539829;44;45;0.636363636363636;16;28;0.136363636363636;0.363636363636364
Control.SRR15539829;45;45;0.533333333333333;21;24;0.0333333333333333;0.466666666666667
Control.SRR15539829;42;45;0.5;21;21;0;0.5
Control.SRR15539829;39;45;0.435897435897436;22;17;0.0641025641025641;0.435897435897436
Control.SRR15539829;44;45;0.5;22;22;0;0.5
Control.SRR15539829;41;45;0.51219512195122;20;21;0.0121951219512195;0.48780487804878
Control.SRR15539829;42;45;0.452380952380952;23;19;0.0476190476190476;0.452380952380952
Control.SRR15539829;39;45;0.461538461538462;21;18;0.0384615384615384;0.461538461538462
Control.SRR15539829;51;45;0.450980392156863;28;23;0.0490196078431372;0.450980392156863
Control.SRR15539829;47;45;0.404255319148936;28;19;0.0957446808510639;0.404255319148936
Control.SRR15539829;39;45;0.512820512820513;19;20;0.0128205128205128;0.487179487179487
Control.SRR15539829;43;45;0.627906976744186;16;27;0.127906976744186;0.372093023255814
Control.SRR15539829;47;45;0.48936170212766;24;23;0.0106382978723404;0.48936170212766
Control.SRR15539829;45;45;0.488888888888889;23;22;0.0111111111111111;0.488888888888889
Control.SRR15539829;41;45;0.463414634146341;22;19;0.0365853658536585;0.463414634146341
Control.SRR15539829;45;45;0.6;18;27;0.1;0.4
Control.SRR15539829;39;45;0.692307692307692;12;27;0.192307692307692;0.307692307692308
Control.SRR15539829;42;45;0.5;21;21;0;0.5
Control.SRR15539829;39;45;0.512820512820513;19;20;0.0128205128205128;0.487179487179487
Control.SRR15539829;49;45;0.448979591836735;27;22;0.0510204081632653;0.448979591836735
Control.SRR15539829;45;45;0.422222222222222;26;19;0.0777777777777778;0.422222222222222
Control.SRR15539829;42;45;0.571428571428571;18;24;0.0714285714285714;0.428571428571429
Control.SRR15539829;40;45;0.525;19;21;0.025;0.475
Control.SRR15539829;44;45;0.454545454545455;24;20;0.0454545454545455;0.454545454545455
Control.SRR15539829;44;45;0.340909090909091;29;15;0.159090909090909;0.340909090909091
Control.SRR15539829;43;45;0.534883720930233;20;23;0.0348837209302325;0.465116279069767
Control.SRR15539829;51;45;0.450980392156863;28;23;0.0490196078431372;0.450980392156863
Control.SRR15539829;51;45;0.509803921568627;25;26;0.00980392156862742;0.490196078431373
Control.SRR15539829;48;45;0.520833333333333;23;25;0.0208333333333334;0.479166666666667
Control.SRR15539829;40;45;0.6;16;24;0.1;0.4
Control.SRR15539829;48;45;0.479166666666667;25;23;0.0208333333333333;0.479166666666667
Control.SRR15539829;44;45;0.545454545454545;20;24;0.0454545454545454;0.454545454545455
Control.SRR15539829;41;45;0.536585365853659;19;22;0.0365853658536586;0.463414634146341
Control.SRR15539829;42;45;0.404761904761905;25;17;0.0952380952380952;0.404761904761905
Control.SRR15539829;45;45;0.377777777777778;28;17;0.122222222222222;0.377777777777778
Control.SRR15539829;46;45;0.5;23;23;0;0.5
Control.SRR15539829;49;45;0.428571428571429;28;21;0.0714285714285715;0.428571428571429
Control.SRR15539829;39;45;0.641025641025641;14;25;0.141025641025641;0.358974358974359
Control.SRR15539829;39;45;0.41025641025641;23;16;0.0897435897435898;0.41025641025641
Control.SRR15539829;46;45;0.434782608695652;26;20;0.0652173913043478;0.434782608695652
Control.SRR15539829;48;45;0.479166666666667;25;23;0.0208333333333333;0.479166666666667
Control.SRR15539829;43;45;0.395348837209302;26;17;0.104651162790698;0.395348837209302
Control.SRR15539829;41;45;0.292682926829268;29;12;0.207317073170732;0.292682926829268
Control.SRR15539829;39;45;0.58974358974359;16;23;0.0897435897435898;0.41025641025641
Control.SRR15539829;50;45;0.5;25;25;0;0.5
Control.SRR15539829;47;45;0.574468085106383;20;27;0.074468085106383;0.425531914893617
Control.SRR15539829;45;45;0.466666666666667;24;21;0.0333333333333333;0.466666666666667
Control.SRR15539829;42;45;0.404761904761905;25;17;0.0952380952380952;0.404761904761905
Control.SRR15539829;41;45;0.390243902439024;25;16;0.109756097560976;0.390243902439024
Control.SRR15539829;41;45;0.51219512195122;20;21;0.0121951219512195;0.48780487804878
Control.SRR15539829;48;45;0.4375;27;21;0.0625;0.4375
Control.SRR15539829;48;45;0.583333333333333;20;28;0.0833333333333334;0.416666666666667
Control.SRR15539829;48;45;0.4375;27;21;0.0625;0.4375
Control.SRR15539829;51;45;0.529411764705882;24;27;0.0294117647058824;0.470588235294118
Control.SRR15539829;48;45;0.375;30;18;0.125;0.375
Control.SRR15539829;48;45;0.5625;21;27;0.0625;0.4375
Control.SRR15539829;41;45;0.51219512195122;20;21;0.0121951219512195;0.48780487804878
Control.SRR15539829;49;45;0.551020408163265;22;27;0.0510204081632653;0.448979591836735
Control.SRR15539829;51;45;0.450980392156863;28;23;0.0490196078431372;0.450980392156863
Control.SRR15539829;45;45;0.577777777777778;19;26;0.0777777777777777;0.422222222222222
Control.SRR15539829;41;45;0.536585365853659;19;22;0.0365853658536586;0.463414634146341
Control.SRR15539829;40;45;0.45;22;18;0.05;0.45
Control.SRR15539829;46;45;0.630434782608696;17;29;0.130434782608696;0.369565217391304
Control.SRR15539829;48;45;0.354166666666667;31;17;0.145833333333333;0.354166666666667
Control.SRR15539829;49;45;0.693877551020408;15;34;0.193877551020408;0.306122448979592
Control.SRR15539829;41;45;0.463414634146341;22;19;0.0365853658536585;0.463414634146341
Control.SRR15539829;46;45;0.543478260869565;21;25;0.0434782608695652;0.456521739130435
Control.SRR15539829;44;45;0.568181818181818;19;25;0.0681818181818182;0.431818181818182
Control.SRR15539829;51;45;0.431372549019608;29;22;0.0686274509803921;0.431372549019608
Control.SRR15539829;45;45;0.6;18;27;0.1;0.4
Control.SRR15539829;46;45;0.478260869565217;24;22;0.0217391304347826;0.478260869565217
Control.SRR15539829;42;45;0.428571428571429;24;18;0.0714285714285715;0.428571428571429
Control.SRR15539829;49;45;0.489795918367347;25;24;0.0102040816326531;0.489795918367347
Control.SRR15539829;46;45;0.456521739130435;25;21;0.0434782608695652;0.456521739130435
Control.SRR15539829;50;45;0.58;21;29;0.08;0.42
Control.SRR15539829;43;45;0.511627906976744;21;22;0.0116279069767442;0.488372093023256
Control.SRR15539829;39;45;0.487179487179487;20;19;0.0128205128205128;0.487179487179487
Control.SRR15539829;41;45;0.634146341463415;15;26;0.134146341463415;0.365853658536585
Control.SRR15539829;42;45;0.523809523809524;20;22;0.0238095238095238;0.476190476190476
Control.SRR15539829;47;45;0.51063829787234;23;24;0.0106382978723404;0.48936170212766
Control.SRR15539829;45;45;0.622222222222222;17;28;0.122222222222222;0.377777777777778
Control.SRR15539829;42;45;0.452380952380952;23;19;0.0476190476190476;0.452380952380952
Control.SRR15539829;47;45;0.404255319148936;28;19;0.0957446808510639;0.404255319148936
Control.SRR15539829;45;45;0.422222222222222;26;19;0.0777777777777778;0.422222222222222
Control.SRR15539829;46;45;0.456521739130435;25;21;0.0434782608695652;0.456521739130435
Control.SRR15539829;42;45;0.404761904761905;25;17;0.0952380952380952;0.404761904761905
Control.SRR15539829;42;45;0.476190476190476;22;20;0.0238095238095238;0.476190476190476
Control.SRR15539829;43;45;0.418604651162791;25;18;0.0813953488372093;0.418604651162791
Control.SRR15539829;50;45;0.52;24;26;0.02;0.48
Control.SRR15539829;39;45;0.641025641025641;14;25;0.141025641025641;0.358974358974359
Control.SRR15539829;43;45;0.488372093023256;22;21;0.0116279069767442;0.488372093023256
Control.SRR15539829;51;45;0.470588235294118;27;24;0.0294117647058824;0.470588235294118
Control.SRR15539829;46;45;0.41304347826087;27;19;0.0869565217391304;0.41304347826087
Control.SRR15539829;48;45;0.541666666666667;22;26;0.0416666666666666;0.458333333333333
Control.SRR15539829;50;45;0.52;24;26;0.02;0.48
Control.SRR15539829;43;45;0.674418604651163;14;29;0.174418604651163;0.325581395348837
Control.SRR15539829;51;45;0.588235294117647;21;30;0.0882352941176471;0.411764705882353
Control.SRR15539829;46;45;0.369565217391304;29;17;0.130434782608696;0.369565217391304
Control.SRR15539829;43;45;0.674418604651163;14;29;0.174418604651163;0.325581395348837
Control.SRR15539829;40;45;0.45;22;18;0.05;0.45
Control.SRR15539829;47;45;0.574468085106383;20;27;0.074468085106383;0.425531914893617
Control.SRR15539829;41;45;0.51219512195122;20;21;0.0121951219512195;0.48780487804878
Control.SRR15539829;44;45;0.477272727272727;23;21;0.0227272727272727;0.477272727272727
Control.SRR15539829;41;45;0.365853658536585;26;15;0.134146341463415;0.365853658536585
Control.SRR15539829;51;45;0.431372549019608;29;22;0.0686274509803921;0.431372549019608
Control.SRR15539829;49;45;0.36734693877551;31;18;0.13265306122449;0.36734693877551
Control.SRR15539829;43;45;0.581395348837209;18;25;0.0813953488372093;0.418604651162791
Control.SRR15539829;47;45;0.48936170212766;24;23;0.0106382978723404;0.48936170212766
Control.SRR15539829;50;45;0.66;17;33;0.16;0.34
Control.SRR15539829;45;45;0.444444444444444;25;20;0.0555555555555556;0.444444444444444
Control.SRR15539829;46;45;0.369565217391304;29;17;0.130434782608696;0.369565217391304
Control.SRR15539829;44;45;0.568181818181818;19;25;0.0681818181818182;0.431818181818182
Control.SRR15539829;50;45;0.36;32;18;0.14;0.36
Control.SRR15539829;47;45;0.51063829787234;23;24;0.0106382978723404;0.48936170212766
Control.SRR15539829;39;45;0.487179487179487;20;19;0.0128205128205128;0.487179487179487
Control.SRR15539829;39;45;0.58974358974359;16;23;0.0897435897435898;0.41025641025641
Control.SRR15539829;47;45;0.468085106382979;25;22;0.0319148936170213;0.468085106382979
Control.SRR15539829;42;45;0.5;21;21;0;0.5
Control.SRR15539829;44;45;0.386363636363636;27;17;0.113636363636364;0.386363636363636
Control.SRR15539829;50;45;0.42;29;21;0.08;0.42
Control.SRR15539829;50;45;0.54;23;27;0.04;0.46
Control.SRR15539829;45;45;0.6;18;27;0.1;0.4
Control.SRR15539829;50;45;0.56;22;28;0.0600000000000001;0.44
Control.SRR15539829;50;45;0.56;22;28;0.0600000000000001;0.44
Control.SRR15539829;47;45;0.531914893617021;22;25;0.0319148936170213;0.468085106382979
Control.SRR15539829;47;45;0.468085106382979;25;22;0.0319148936170213;0.468085106382979
Control.SRR15539829;47;45;0.531914893617021;22;25;0.0319148936170213;0.468085106382979
Control.SRR15539829;43;45;0.511627906976744;21;22;0.0116279069767442;0.488372093023256
Control.SRR15539829;49;45;0.530612244897959;23;26;0.0306122448979592;0.469387755102041
Control.SRR15539829;46;45;0.326086956521739;31;15;0.173913043478261;0.326086956521739
Control.SRR15539829;45;45;0.466666666666667;24;21;0.0333333333333333;0.466666666666667
Control.SRR15539829;44;45;0.454545454545455;24;20;0.0454545454545455;0.454545454545455
Control.SRR15539829;46;45;0.478260869565217;24;22;0.0217391304347826;0.478260869565217
Control.SRR15539829;48;45;0.5;24;24;0;0.5
Control.SRR15539829;40;45;0.55;18;22;0.05;0.45
Control.SRR15539829;51;45;0.470588235294118;27;24;0.0294117647058824;0.470588235294118
Control.SRR15539829;41;45;0.48780487804878;21;20;0.0121951219512195;0.48780487804878
Control.SRR15539829;44;45;0.454545454545455;24;20;0.0454545454545455;0.454545454545455
Control.SRR15539829;45;45;0.577777777777778;19;26;0.0777777777777777;0.422222222222222
Control.SRR15539829;43;45;0.674418604651163;14;29;0.174418604651163;0.325581395348837
Control.SRR15539829;43;45;0.465116279069767;23;20;0.0348837209302326;0.465116279069767
Control.SRR15539829;44;45;0.568181818181818;19;25;0.0681818181818182;0.431818181818182
Control.SRR15539829;42;45;0.619047619047619;16;26;0.119047619047619;0.380952380952381
Control.SRR15539829;51;45;0.509803921568627;25;26;0.00980392156862742;0.490196078431373
Control.SRR15539829;43;45;0.465116279069767;23;20;0.0348837209302326;0.465116279069767
Control.SRR15539829;45;45;0.533333333333333;21;24;0.0333333333333333;0.466666666666667
Control.SRR15539829;43;45;0.558139534883721;19;24;0.0581395348837209;0.441860465116279
Control.SRR15539829;42;45;0.452380952380952;23;19;0.0476190476190476;0.452380952380952
Control.SRR15539829;49;45;0.346938775510204;32;17;0.153061224489796;0.346938775510204
Control.SRR15539829;42;45;0.571428571428571;18;24;0.0714285714285714;0.428571428571429
Control.SRR15539829;41;45;0.48780487804878;21;20;0.0121951219512195;0.48780487804878
Control.SRR15539829;48;45;0.5;24;24;0;0.5
Control.SRR15539829;39;45;0.512820512820513;19;20;0.0128205128205128;0.487179487179487
Control.SRR15539829;44;45;0.590909090909091;18;26;0.0909090909090909;0.409090909090909
Control.SRR15539829;50;45;0.6;20;30;0.1;0.4
Control.SRR15539829;48;45;0.541666666666667;22;26;0.0416666666666666;0.458333333333333
Control.SRR15539829;44;45;0.568181818181818;19;25;0.0681818181818182;0.431818181818182
Control.SRR15539829;39;45;0.58974358974359;16;23;0.0897435897435898;0.41025641025641
Control.SRR15539829;47;45;0.531914893617021;22;25;0.0319148936170213;0.468085106382979
Control.SRR15539829;40;45;0.575;17;23;0.075;0.425
Control.SRR15539829;45;45;0.422222222222222;26;19;0.0777777777777778;0.422222222222222
Control.SRR15539829;44;45;0.590909090909091;18;26;0.0909090909090909;0.409090909090909
Control.SRR15539829;44;45;0.5;22;22;0;0.5
Control.SRR15539829;41;45;0.51219512195122;20;21;0.0121951219512195;0.48780487804878
Control.SRR15539829;45;45;0.511111111111111;22;23;0.0111111111111111;0.488888888888889
Control.SRR15539829;39;45;0.666666666666667;13;26;0.166666666666667;0.333333333333333
Control.SRR15539829;42;45;0.476190476190476;22;20;0.0238095238095238;0.476190476190476
Control.SRR15539829;44;45;0.568181818181818;19;25;0.0681818181818182;0.431818181818182
Control.SRR15539829;49;45;0.673469387755102;16;33;0.173469387755102;0.326530612244898
Control.SRR15539829;49;45;0.489795918367347;25;24;0.0102040816326531;0.489795918367347
Control.SRR15539829;41;45;0.268292682926829;30;11;0.231707317073171;0.268292682926829
Control.SRR15539829;47;45;0.51063829787234;23;24;0.0106382978723404;0.48936170212766
Control.SRR15539829;49;45;0.571428571428571;21;28;0.0714285714285714;0.428571428571429
Control.SRR15539829;48;45;0.5625;21;27;0.0625;0.4375
Control.SRR15539829;41;45;0.48780487804878;21;20;0.0121951219512195;0.48780487804878
Control.SRR15539829;48;45;0.5625;21;27;0.0625;0.4375
Control.SRR15539829;42;45;0.571428571428571;18;24;0.0714285714285714;0.428571428571429
Control.SRR15539829;44;45;0.636363636363636;16;28;0.136363636363636;0.363636363636364
Control.SRR15539829;42;45;0.404761904761905;25;17;0.0952380952380952;0.404761904761905
Control.SRR15539829;50;45;0.48;26;24;0.02;0.48
Control.SRR15539829;50;45;0.52;24;26;0.02;0.48
Control.SRR15539829;44;45;0.5;22;22;0;0.5
Control.SRR15539829;42;45;0.476190476190476;22;20;0.0238095238095238;0.476190476190476
Control.SRR15539829;45;45;0.355555555555556;29;16;0.144444444444444;0.355555555555556
Control.SRR15539829;40;45;0.425;23;17;0.075;0.425
Control.SRR15539829;39;45;0.358974358974359;25;14;0.141025641025641;0.358974358974359
Control.SRR15539829;51;45;0.411764705882353;30;21;0.0882352941176471;0.411764705882353
Control.SRR15539829;48;45;0.520833333333333;23;25;0.0208333333333334;0.479166666666667
Control.SRR15539829;39;45;0.487179487179487;20;19;0.0128205128205128;0.487179487179487
Control.SRR15539829;42;45;0.452380952380952;23;19;0.0476190476190476;0.452380952380952
Control.SRR15539829;39;45;0.384615384615385;24;15;0.115384615384615;0.384615384615385
Control.SRR15539829;39;45;0.384615384615385;24;15;0.115384615384615;0.384615384615385
Control.SRR15539829;42;45;0.547619047619048;19;23;0.0476190476190477;0.452380952380952
Control.SRR15539829;39;45;0.307692307692308;27;12;0.192307692307692;0.307692307692308
Control.SRR15539829;43;45;0.465116279069767;23;20;0.0348837209302326;0.465116279069767
Control.SRR15539829;50;45;0.38;31;19;0.12;0.38
Control.SRR15539829;42;45;0.476190476190476;22;20;0.0238095238095238;0.476190476190476
Control.SRR15539829;48;45;0.458333333333333;26;22;0.0416666666666667;0.458333333333333
Control.SRR15539829;45;45;0.577777777777778;19;26;0.0777777777777777;0.422222222222222
Control.SRR15539829;46;45;0.5;23;23;0;0.5
Control.SRR15539829;47;45;0.468085106382979;25;22;0.0319148936170213;0.468085106382979
Control.SRR15539829;49;45;0.530612244897959;23;26;0.0306122448979592;0.469387755102041
Control.SRR15539829;43;45;0.558139534883721;19;24;0.0581395348837209;0.441860465116279
Control.SRR15539829;47;45;0.574468085106383;20;27;0.074468085106383;0.425531914893617
Control.SRR15539829;48;45;0.583333333333333;20;28;0.0833333333333334;0.416666666666667
Control.SRR15539829;39;45;0.615384615384615;15;24;0.115384615384615;0.384615384615385
Control.SRR15539829;47;45;0.51063829787234;23;24;0.0106382978723404;0.48936170212766
Control.SRR15539829;45;45;0.488888888888889;23;22;0.0111111111111111;0.488888888888889
Control.SRR15539829;40;45;0.475;21;19;0.025;0.475
Control.SRR15539829;50;45;0.52;24;26;0.02;0.48
Control.SRR15539829;44;45;0.5;22;22;0;0.5
Control.SRR15539829;48;45;0.541666666666667;22;26;0.0416666666666666;0.458333333333333
Control.SRR15539829;41;45;0.634146341463415;15;26;0.134146341463415;0.365853658536585
Control.SRR15539829;45;45;0.533333333333333;21;24;0.0333333333333333;0.466666666666667
Control.SRR15539829;49;45;0.510204081632653;24;25;0.0102040816326531;0.489795918367347
Control.SRR15539829;51;45;0.607843137254902;20;31;0.107843137254902;0.392156862745098
Control.SRR15539829;43;45;0.418604651162791;25;18;0.0813953488372093;0.418604651162791
Control.SRR15539829;41;45;0.707317073170732;12;29;0.207317073170732;0.292682926829268
Control.SRR15539829;47;45;0.531914893617021;22;25;0.0319148936170213;0.468085106382979
Control.SRR15539829;41;45;0.48780487804878;21;20;0.0121951219512195;0.48780487804878
Control.SRR15539829;41;45;0.51219512195122;20;21;0.0121951219512195;0.48780487804878
Control.SRR15539829;40;45;0.5;20;20;0;0.5
Control.SRR15539829;40;45;0.55;18;22;0.05;0.45
Control.SRR15539829;48;45;0.520833333333333;23;25;0.0208333333333334;0.479166666666667
Control.SRR15539829;51;45;0.470588235294118;27;24;0.0294117647058824;0.470588235294118
Control.SRR15539829;43;45;0.465116279069767;23;20;0.0348837209302326;0.465116279069767
Control.SRR15539829;43;45;0.651162790697674;15;28;0.151162790697674;0.348837209302326
Control.SRR15539829;47;45;0.553191489361702;21;26;0.0531914893617021;0.446808510638298
Control.SRR15539829;46;45;0.478260869565217;24;22;0.0217391304347826;0.478260869565217
Control.SRR15539829;50;45;0.54;23;27;0.04;0.46
Control.SRR15539829;39;45;0.461538461538462;21;18;0.0384615384615384;0.461538461538462
Control.SRR15539829;39;45;0.435897435897436;22;17;0.0641025641025641;0.435897435897436
Control.SRR15539829;46;45;0.434782608695652;26;20;0.0652173913043478;0.434782608695652
Control.SRR15539829;39;45;0.358974358974359;25;14;0.141025641025641;0.358974358974359
Control.SRR15539829;43;45;0.534883720930233;20;23;0.0348837209302325;0.465116279069767
Control.SRR15539829;47;45;0.51063829787234;23;24;0.0106382978723404;0.48936170212766
Control.SRR15539829;49;45;0.448979591836735;27;22;0.0510204081632653;0.448979591836735
Control.SRR15539829;49;45;0.489795918367347;25;24;0.0102040816326531;0.489795918367347
Control.SRR15539829;46;45;0.521739130434783;22;24;0.0217391304347826;0.478260869565217
Control.SRR15539829;49;45;0.469387755102041;26;23;0.0306122448979592;0.469387755102041
Control.SRR15539829;42;45;0.595238095238095;17;25;0.0952380952380952;0.404761904761905
Control.SRR15539829;49;45;0.510204081632653;24;25;0.0102040816326531;0.489795918367347
Control.SRR15539829;44;45;0.363636363636364;28;16;0.136363636363636;0.363636363636364
Control.SRR15539829;39;45;0.512820512820513;19;20;0.0128205128205128;0.487179487179487
Control.SRR15539829;49;45;0.489795918367347;25;24;0.0102040816326531;0.489795918367347
Control.SRR15539829;48;45;0.541666666666667;22;26;0.0416666666666666;0.458333333333333
Control.SRR15539829;50;45;0.48;26;24;0.02;0.48
Control.SRR15539829;51;45;0.490196078431373;26;25;0.00980392156862747;0.490196078431373
Control.SRR15539829;45;45;0.577777777777778;19;26;0.0777777777777777;0.422222222222222
Control.SRR15539829;41;45;0.51219512195122;20;21;0.0121951219512195;0.48780487804878
Control.SRR15539829;43;45;0.627906976744186;16;27;0.127906976744186;0.372093023255814
Control.SRR15539829;39;45;0.461538461538462;21;18;0.0384615384615384;0.461538461538462
Control.SRR15539829;49;45;0.306122448979592;34;15;0.193877551020408;0.306122448979592
Control.SRR15539829;41;45;0.51219512195122;20;21;0.0121951219512195;0.48780487804878
Control.SRR15539829;44;45;0.5;22;22;0;0.5
Control.SRR15539829;48;45;0.604166666666667;19;29;0.104166666666667;0.395833333333333
Control.SRR15539829;48;45;0.583333333333333;20;28;0.0833333333333334;0.416666666666667
Control.SRR15539829;51;45;0.627450980392157;19;32;0.127450980392157;0.372549019607843
Control.SRR15539829;47;45;0.51063829787234;23;24;0.0106382978723404;0.48936170212766
Control.SRR15539829;49;45;0.36734693877551;31;18;0.13265306122449;0.36734693877551
Control.SRR15539829;46;45;0.543478260869565;21;25;0.0434782608695652;0.456521739130435
Control.SRR15539829;47;45;0.51063829787234;23;24;0.0106382978723404;0.48936170212766
Control.SRR15539829;48;45;0.3125;33;15;0.1875;0.3125
Control.SRR15539829;42;45;0.547619047619048;19;23;0.0476190476190477;0.452380952380952
Control.SRR15539829;50;45;0.46;27;23;0.04;0.46
Control.SRR15539829;49;45;0.571428571428571;21;28;0.0714285714285714;0.428571428571429
Control.SRR15539829;44;45;0.340909090909091;29;15;0.159090909090909;0.340909090909091
Control.SRR15539829;47;45;0.574468085106383;20;27;0.074468085106383;0.425531914893617
Control.SRR15539829;50;45;0.46;27;23;0.04;0.46
Control.SRR15539829;46;45;0.521739130434783;22;24;0.0217391304347826;0.478260869565217
Control.SRR15539829;43;45;0.488372093023256;22;21;0.0116279069767442;0.488372093023256
Control.SRR15539829;43;45;0.558139534883721;19;24;0.0581395348837209;0.441860465116279
Control.SRR15539829;50;45;0.44;28;22;0.06;0.44
Control.SRR15539829;47;45;0.531914893617021;22;25;0.0319148936170213;0.468085106382979
Control.SRR15539829;47;45;0.446808510638298;26;21;0.0531914893617021;0.446808510638298
Control.SRR15539829;50;45;0.5;25;25;0;0.5
Control.SRR15539829;50;45;0.6;20;30;0.1;0.4
Control.SRR15539829;47;45;0.51063829787234;23;24;0.0106382978723404;0.48936170212766
Control.SRR15539829;41;45;0.268292682926829;30;11;0.231707317073171;0.268292682926829
Control.SRR15539829;42;45;0.452380952380952;23;19;0.0476190476190476;0.452380952380952
Control.SRR15539829;47;45;0.48936170212766;24;23;0.0106382978723404;0.48936170212766
Control.SRR15539829;42;45;0.523809523809524;20;22;0.0238095238095238;0.476190476190476
Control.SRR15539829;46;45;0.565217391304348;20;26;0.0652173913043478;0.434782608695652
Control.SRR15539829;42;45;0.476190476190476;22;20;0.0238095238095238;0.476190476190476
Control.SRR15539829;41;45;0.585365853658537;17;24;0.0853658536585366;0.414634146341463
Control.SRR15539829;40;45;0.525;19;21;0.025;0.475
Control.SRR15539829;46;45;0.478260869565217;24;22;0.0217391304347826;0.478260869565217
Control.SRR15539829;48;45;0.458333333333333;26;22;0.0416666666666667;0.458333333333333
Control.SRR15539829;42;45;0.547619047619048;19;23;0.0476190476190477;0.452380952380952
Control.SRR15539829;50;45;0.54;23;27;0.04;0.46
Control.SRR15539829;49;45;0.387755102040816;30;19;0.112244897959184;0.387755102040816
Control.SRR15539829;47;45;0.382978723404255;29;18;0.117021276595745;0.382978723404255
Control.SRR15539829;46;45;0.521739130434783;22;24;0.0217391304347826;0.478260869565217
Control.SRR15539829;49;45;0.408163265306122;29;20;0.0918367346938775;0.408163265306122
Control.SRR15539829;45;45;0.488888888888889;23;22;0.0111111111111111;0.488888888888889
Control.SRR15539829;51;45;0.529411764705882;24;27;0.0294117647058824;0.470588235294118
Control.SRR15539829;41;45;0.634146341463415;15;26;0.134146341463415;0.365853658536585
Control.SRR15539829;40;45;0.55;18;22;0.05;0.45
Control.SRR15539829;40;45;0.675;13;27;0.175;0.325
Control.SRR15539829;43;45;0.534883720930233;20;23;0.0348837209302325;0.465116279069767
Control.SRR15539829;43;45;0.627906976744186;16;27;0.127906976744186;0.372093023255814
Control.SRR15539829;45;45;0.511111111111111;22;23;0.0111111111111111;0.488888888888889
Control.SRR15539829;43;45;0.325581395348837;29;14;0.174418604651163;0.325581395348837
Control.SRR15539829;45;45;0.533333333333333;21;24;0.0333333333333333;0.466666666666667
Control.SRR15539829;42;45;0.595238095238095;17;25;0.0952380952380952;0.404761904761905
Control.SRR15539829;40;45;0.5;20;20;0;0.5
Control.SRR15539829;45;45;0.333333333333333;30;15;0.166666666666667;0.333333333333333
Control.SRR15539829;51;45;0.568627450980392;22;29;0.0686274509803921;0.431372549019608
Control.SRR15539829;48;45;0.458333333333333;26;22;0.0416666666666667;0.458333333333333
Control.SRR15539829;47;45;0.574468085106383;20;27;0.074468085106383;0.425531914893617
Control.SRR15539829;47;45;0.48936170212766;24;23;0.0106382978723404;0.48936170212766
Control.SRR15539829;40;45;0.425;23;17;0.075;0.425
Control.SRR15539829;48;45;0.4375;27;21;0.0625;0.4375
Control.SRR15539829;43;45;0.395348837209302;26;17;0.104651162790698;0.395348837209302
Control.SRR15539829;39;45;0.487179487179487;20;19;0.0128205128205128;0.487179487179487
Control.SRR15539829;39;45;0.358974358974359;25;14;0.141025641025641;0.358974358974359
Control.SRR15539829;46;45;0.456521739130435;25;21;0.0434782608695652;0.456521739130435
Control.SRR15539829;42;45;0.428571428571429;24;18;0.0714285714285715;0.428571428571429
Control.SRR15539829;47;45;0.617021276595745;18;29;0.117021276595745;0.382978723404255
Control.SRR15539829;44;45;0.568181818181818;19;25;0.0681818181818182;0.431818181818182
Control.SRR15539829;50;45;0.54;23;27;0.04;0.46
Control.SRR15539829;48;45;0.541666666666667;22;26;0.0416666666666666;0.458333333333333
Control.SRR15539829;40;45;0.475;21;19;0.025;0.475
Control.SRR15539829;47;45;0.404255319148936;28;19;0.0957446808510639;0.404255319148936
Control.SRR15539829;50;45;0.46;27;23;0.04;0.46
Control.SRR15539829;44;45;0.5;22;22;0;0.5
Control.SRR15539829;42;45;0.523809523809524;20;22;0.0238095238095238;0.476190476190476
Control.SRR15539829;41;45;0.48780487804878;21;20;0.0121951219512195;0.48780487804878
Control.SRR15539829;49;45;0.510204081632653;24;25;0.0102040816326531;0.489795918367347
Control.SRR15539829;47;45;0.48936170212766;24;23;0.0106382978723404;0.48936170212766
Control.SRR15539829;41;45;0.414634146341463;24;17;0.0853658536585366;0.414634146341463
Control.SRR15539829;39;45;0.358974358974359;25;14;0.141025641025641;0.358974358974359
Control.SRR15539829;47;45;0.51063829787234;23;24;0.0106382978723404;0.48936170212766
Control.SRR15539829;47;45;0.51063829787234;23;24;0.0106382978723404;0.48936170212766
Control.SRR15539829;50;45;0.42;29;21;0.08;0.42
Control.SRR15539829;49;45;0.428571428571429;28;21;0.0714285714285715;0.428571428571429
Control.SRR15539829;49;45;0.530612244897959;23;26;0.0306122448979592;0.469387755102041
Control.SRR15539829;47;45;0.617021276595745;18;29;0.117021276595745;0.382978723404255
Control.SRR15539829;43;45;0.488372093023256;22;21;0.0116279069767442;0.488372093023256
Control.SRR15539829;48;45;0.583333333333333;20;28;0.0833333333333334;0.416666666666667
Control.SRR15539829;47;45;0.468085106382979;25;22;0.0319148936170213;0.468085106382979
Control.SRR15539829;40;45;0.45;22;18;0.05;0.45
Control.SRR15539829;41;45;0.560975609756098;18;23;0.0609756097560976;0.439024390243902
Control.SRR15539829;47;45;0.531914893617021;22;25;0.0319148936170213;0.468085106382979
Control.SRR15539829;49;45;0.571428571428571;21;28;0.0714285714285714;0.428571428571429
Control.SRR15539829;45;45;0.555555555555556;20;25;0.0555555555555556;0.444444444444444
Control.SRR15539829;50;45;0.54;23;27;0.04;0.46
Control.SRR15539829;48;45;0.375;30;18;0.125;0.375
Control.SRR15539829;44;45;0.386363636363636;27;17;0.113636363636364;0.386363636363636
Control.SRR15539829;44;45;0.522727272727273;21;23;0.0227272727272727;0.477272727272727
Control.SRR15539829;50;45;0.46;27;23;0.04;0.46
Control.SRR15539829;39;45;0.461538461538462;21;18;0.0384615384615384;0.461538461538462
Control.SRR15539829;45;45;0.422222222222222;26;19;0.0777777777777778;0.422222222222222
Control.SRR15539829;48;45;0.4375;27;21;0.0625;0.4375
Control.SRR15539829;43;45;0.465116279069767;23;20;0.0348837209302326;0.465116279069767
Control.SRR15539829;48;45;0.479166666666667;25;23;0.0208333333333333;0.479166666666667
Control.SRR15539829;50;45;0.54;23;27;0.04;0.46
Control.SRR15539829;51;45;0.588235294117647;21;30;0.0882352941176471;0.411764705882353
Control.SRR15539829;44;45;0.363636363636364;28;16;0.136363636363636;0.363636363636364
Control.SRR15539829;45;45;0.644444444444444;16;29;0.144444444444444;0.355555555555556
Control.SRR15539829;50;45;0.64;18;32;0.14;0.36
Control.SRR15539829;47;45;0.468085106382979;25;22;0.0319148936170213;0.468085106382979
Control.SRR15539829;50;45;0.34;33;17;0.16;0.34
Control.SRR15539829;44;45;0.477272727272727;23;21;0.0227272727272727;0.477272727272727
Control.SRR15539829;42;45;0.404761904761905;25;17;0.0952380952380952;0.404761904761905
Control.SRR15539829;45;45;0.622222222222222;17;28;0.122222222222222;0.377777777777778
Control.SRR15539829;47;45;0.531914893617021;22;25;0.0319148936170213;0.468085106382979
Control.SRR15539829;48;45;0.479166666666667;25;23;0.0208333333333333;0.479166666666667
Control.SRR15539829;49;45;0.489795918367347;25;24;0.0102040816326531;0.489795918367347
Control.SRR15539829;44;45;0.5;22;22;0;0.5
Control.SRR15539829;42;45;0.476190476190476;22;20;0.0238095238095238;0.476190476190476
Control.SRR15539829;49;45;0.591836734693878;20;29;0.0918367346938775;0.408163265306122
Control.SRR15539829;44;45;0.613636363636364;17;27;0.113636363636364;0.386363636363636
Control.SRR15539829;40;45;0.525;19;21;0.025;0.475
Control.SRR15539829;49;45;0.612244897959184;19;30;0.112244897959184;0.387755102040816
Control.SRR15539829;47;45;0.340425531914894;31;16;0.159574468085106;0.340425531914894
Control.SRR15539829;43;45;0.511627906976744;21;22;0.0116279069767442;0.488372093023256
Control.SRR15539829;47;45;0.446808510638298;26;21;0.0531914893617021;0.446808510638298
Control.SRR15539829;48;45;0.416666666666667;28;20;0.0833333333333333;0.416666666666667
Control.SRR15539829;51;45;0.411764705882353;30;21;0.0882352941176471;0.411764705882353
Control.SRR15539829;51;45;0.470588235294118;27;24;0.0294117647058824;0.470588235294118
Control.SRR15539829;50;45;0.64;18;32;0.14;0.36
Control.SRR15539829;51;45;0.627450980392157;19;32;0.127450980392157;0.372549019607843
Control.SRR15539829;39;45;0.538461538461538;18;21;0.0384615384615384;0.461538461538462
Control.SRR15539829;42;45;0.30952380952381;29;13;0.19047619047619;0.30952380952381
Control.SRR15539829;48;45;0.5;24;24;0;0.5
Control.SRR15539829;45;45;0.6;18;27;0.1;0.4
Control.SRR15539829;41;45;0.341463414634146;27;14;0.158536585365854;0.341463414634146
Control.SRR15539829;49;45;0.448979591836735;27;22;0.0510204081632653;0.448979591836735
Control.SRR15539829;50;45;0.46;27;23;0.04;0.46
Control.SRR15539829;41;45;0.390243902439024;25;16;0.109756097560976;0.390243902439024
Control.SRR15539829;43;45;0.534883720930233;20;23;0.0348837209302325;0.465116279069767
Control.SRR15539829;43;45;0.697674418604651;13;30;0.197674418604651;0.302325581395349
Control.SRR15539829;49;45;0.551020408163265;22;27;0.0510204081632653;0.448979591836735
Control.SRR15539829;48;45;0.520833333333333;23;25;0.0208333333333334;0.479166666666667
Control.SRR15539829;45;45;0.466666666666667;24;21;0.0333333333333333;0.466666666666667
Control.SRR15539829;50;45;0.44;28;22;0.06;0.44
Control.SRR15539829;40;45;0.425;23;17;0.075;0.425
Control.SRR15539829;50;45;0.46;27;23;0.04;0.46
Control.SRR15539829;40;45;0.475;21;19;0.025;0.475
Control.SRR15539829;39;45;0.58974358974359;16;23;0.0897435897435898;0.41025641025641
Control.SRR15539829;43;45;0.488372093023256;22;21;0.0116279069767442;0.488372093023256
Control.SRR15539829;43;45;0.511627906976744;21;22;0.0116279069767442;0.488372093023256
Control.SRR15539829;51;45;0.686274509803922;16;35;0.186274509803922;0.313725490196078
Control.SRR15539829;46;45;0.521739130434783;22;24;0.0217391304347826;0.478260869565217
Control.SRR15539829;43;45;0.488372093023256;22;21;0.0116279069767442;0.488372093023256
Control.SRR15539829;51;45;0.470588235294118;27;24;0.0294117647058824;0.470588235294118
Control.SRR15539829;47;45;0.404255319148936;28;19;0.0957446808510639;0.404255319148936
Control.SRR15539829;41;45;0.51219512195122;20;21;0.0121951219512195;0.48780487804878
Control.SRR15539829;47;45;0.382978723404255;29;18;0.117021276595745;0.382978723404255
Control.SRR15539829;51;45;0.352941176470588;33;18;0.147058823529412;0.352941176470588
Control.SRR15539829;48;45;0.291666666666667;34;14;0.208333333333333;0.291666666666667
Control.SRR15539829;45;45;0.555555555555556;20;25;0.0555555555555556;0.444444444444444
Control.SRR15539829;51;45;0.549019607843137;23;28;0.0490196078431373;0.450980392156863
Control.SRR15539829;48;45;0.458333333333333;26;22;0.0416666666666667;0.458333333333333
Control.SRR15539829;47;45;0.382978723404255;29;18;0.117021276595745;0.382978723404255
Control.SRR15539829;47;45;0.446808510638298;26;21;0.0531914893617021;0.446808510638298
Control.SRR15539829;44;45;0.568181818181818;19;25;0.0681818181818182;0.431818181818182
Control.SRR15539829;47;45;0.51063829787234;23;24;0.0106382978723404;0.48936170212766
Control.SRR15539829;49;45;0.63265306122449;18;31;0.13265306122449;0.36734693877551
Control.SRR15539829;46;45;0.521739130434783;22;24;0.0217391304347826;0.478260869565217
Control.SRR15539829;45;45;0.533333333333333;21;24;0.0333333333333333;0.466666666666667
Control.SRR15539829;41;45;0.658536585365854;14;27;0.158536585365854;0.341463414634146
Control.SRR15539829;50;45;0.54;23;27;0.04;0.46
Control.SRR15539829;50;45;0.54;23;27;0.04;0.46
Control.SRR15539829;47;45;0.48936170212766;24;23;0.0106382978723404;0.48936170212766
Control.SRR15539829;51;45;0.392156862745098;31;20;0.107843137254902;0.392156862745098
Control.SRR15539829;51;45;0.529411764705882;24;27;0.0294117647058824;0.470588235294118
Control.SRR15539829;42;45;0.476190476190476;22;20;0.0238095238095238;0.476190476190476
Control.SRR15539829;43;45;0.465116279069767;23;20;0.0348837209302326;0.465116279069767
Control.SRR15539829;42;45;0.452380952380952;23;19;0.0476190476190476;0.452380952380952
Control.SRR15539829;45;45;0.488888888888889;23;22;0.0111111111111111;0.488888888888889
Control.SRR15539829;43;45;0.465116279069767;23;20;0.0348837209302326;0.465116279069767
Control.SRR15539829;48;45;0.458333333333333;26;22;0.0416666666666667;0.458333333333333
Control.SRR15539829;42;45;0.476190476190476;22;20;0.0238095238095238;0.476190476190476
Control.SRR15539829;43;45;0.604651162790698;17;26;0.104651162790698;0.395348837209302
Control.SRR15539829;50;45;0.46;27;23;0.04;0.46
Control.SRR15539829;41;45;0.390243902439024;25;16;0.109756097560976;0.390243902439024
Control.SRR15539829;42;45;0.523809523809524;20;22;0.0238095238095238;0.476190476190476
Control.SRR15539829;45;45;0.622222222222222;17;28;0.122222222222222;0.377777777777778
Control.SRR15539829;49;45;0.469387755102041;26;23;0.0306122448979592;0.469387755102041
Control.SRR15539829;47;45;0.48936170212766;24;23;0.0106382978723404;0.48936170212766
Control.SRR15539829;51;45;0.588235294117647;21;30;0.0882352941176471;0.411764705882353
Control.SRR15539829;39;45;0.512820512820513;19;20;0.0128205128205128;0.487179487179487
Control.SRR15539829;49;45;0.36734693877551;31;18;0.13265306122449;0.36734693877551
Control.SRR15539829;44;45;0.477272727272727;23;21;0.0227272727272727;0.477272727272727
Control.SRR15539829;45;45;0.466666666666667;24;21;0.0333333333333333;0.466666666666667
Control.SRR15539829;39;45;0.41025641025641;23;16;0.0897435897435898;0.41025641025641
Control.SRR15539829;41;45;0.48780487804878;21;20;0.0121951219512195;0.48780487804878
Control.SRR15539829;48;45;0.395833333333333;29;19;0.104166666666667;0.395833333333333
Control.SRR15539829;48;45;0.416666666666667;28;20;0.0833333333333333;0.416666666666667
Control.SRR15539829;50;45;0.58;21;29;0.08;0.42
Control.SRR15539829;45;45;0.533333333333333;21;24;0.0333333333333333;0.466666666666667
Control.SRR15539829;51;45;0.568627450980392;22;29;0.0686274509803921;0.431372549019608
Control.SRR15539829;45;45;0.644444444444444;16;29;0.144444444444444;0.355555555555556
Control.SRR15539829;40;45;0.575;17;23;0.075;0.425
Control.SRR15539829;42;45;0.523809523809524;20;22;0.0238095238095238;0.476190476190476
Control.SRR15539829;45;45;0.4;27;18;0.1;0.4
Control.SRR15539829;45;45;0.466666666666667;24;21;0.0333333333333333;0.466666666666667
Control.SRR15539829;51;45;0.509803921568627;25;26;0.00980392156862742;0.490196078431373
Control.SRR15539829;51;45;0.431372549019608;29;22;0.0686274509803921;0.431372549019608
Control.SRR15539829;43;45;0.465116279069767;23;20;0.0348837209302326;0.465116279069767
Control.SRR15539829;51;45;0.549019607843137;23;28;0.0490196078431373;0.450980392156863
Control.SRR15539829;43;45;0.604651162790698;17;26;0.104651162790698;0.395348837209302
Control.SRR15539829;50;45;0.44;28;22;0.06;0.44
Control.SRR15539829;49;45;0.36734693877551;31;18;0.13265306122449;0.36734693877551
Control.SRR15539829;43;45;0.604651162790698;17;26;0.104651162790698;0.395348837209302
Control.SRR15539829;39;45;0.512820512820513;19;20;0.0128205128205128;0.487179487179487
Control.SRR15539829;48;45;0.458333333333333;26;22;0.0416666666666667;0.458333333333333
Control.SRR15539829;51;45;0.352941176470588;33;18;0.147058823529412;0.352941176470588
Control.SRR15539829;42;45;0.476190476190476;22;20;0.0238095238095238;0.476190476190476
Control.SRR15539829;51;45;0.490196078431373;26;25;0.00980392156862747;0.490196078431373
Control.SRR15539829;49;45;0.489795918367347;25;24;0.0102040816326531;0.489795918367347
Control.SRR15539829;42;45;0.523809523809524;20;22;0.0238095238095238;0.476190476190476
Control.SRR15539829;42;45;0.5;21;21;0;0.5
Control.SRR15539829;43;45;0.441860465116279;24;19;0.0581395348837209;0.441860465116279
Control.SRR15539829;45;45;0.422222222222222;26;19;0.0777777777777778;0.422222222222222
Control.SRR15539829;51;45;0.372549019607843;32;19;0.127450980392157;0.372549019607843
Control.SRR15539829;42;45;0.5;21;21;0;0.5
Control.SRR15539829;44;45;0.5;22;22;0;0.5
Control.SRR15539829;42;45;0.523809523809524;20;22;0.0238095238095238;0.476190476190476
Control.SRR15539829;43;45;0.651162790697674;15;28;0.151162790697674;0.348837209302326
Control.SRR15539829;51;45;0.509803921568627;25;26;0.00980392156862742;0.490196078431373
Control.SRR15539829;42;45;0.5;21;21;0;0.5
Control.SRR15539829;47;45;0.382978723404255;29;18;0.117021276595745;0.382978723404255
Control.SRR15539829;51;45;0.490196078431373;26;25;0.00980392156862747;0.490196078431373
Control.SRR15539829;46;45;0.673913043478261;15;31;0.173913043478261;0.326086956521739
Control.SRR15539829;47;45;0.51063829787234;23;24;0.0106382978723404;0.48936170212766
Control.SRR15539829;47;45;0.48936170212766;24;23;0.0106382978723404;0.48936170212766
Control.SRR15539829;51;45;0.549019607843137;23;28;0.0490196078431373;0.450980392156863
Control.SRR15539829;46;45;0.5;23;23;0;0.5
Control.SRR15539829;44;45;0.681818181818182;14;30;0.181818181818182;0.318181818181818
Control.SRR15539829;44;45;0.386363636363636;27;17;0.113636363636364;0.386363636363636
Control.SRR15539829;47;45;0.425531914893617;27;20;0.074468085106383;0.425531914893617
Control.SRR15539829;48;45;0.354166666666667;31;17;0.145833333333333;0.354166666666667
Control.SRR15539829;46;45;0.434782608695652;26;20;0.0652173913043478;0.434782608695652
Control.SRR15539829;42;45;0.523809523809524;20;22;0.0238095238095238;0.476190476190476
Control.SRR15539829;49;45;0.489795918367347;25;24;0.0102040816326531;0.489795918367347
Control.SRR15539829;45;45;0.688888888888889;14;31;0.188888888888889;0.311111111111111
Control.SRR15539829;42;45;0.452380952380952;23;19;0.0476190476190476;0.452380952380952
Control.SRR15539829;39;45;0.435897435897436;22;17;0.0641025641025641;0.435897435897436
Control.SRR15539829;45;45;0.577777777777778;19;26;0.0777777777777777;0.422222222222222
Control.SRR15539829;39;45;0.461538461538462;21;18;0.0384615384615384;0.461538461538462
Control.SRR15539829;45;45;0.6;18;27;0.1;0.4
Control.SRR15539829;46;45;0.521739130434783;22;24;0.0217391304347826;0.478260869565217
Control.SRR15539829;48;45;0.458333333333333;26;22;0.0416666666666667;0.458333333333333
Control.SRR15539829;48;45;0.479166666666667;25;23;0.0208333333333333;0.479166666666667
Control.SRR15539829;48;45;0.520833333333333;23;25;0.0208333333333334;0.479166666666667
Control.SRR15539829;40;45;0.525;19;21;0.025;0.475
Control.SRR15539829;47;45;0.468085106382979;25;22;0.0319148936170213;0.468085106382979
Control.SRR15539829;47;45;0.446808510638298;26;21;0.0531914893617021;0.446808510638298
Control.SRR15539829;47;45;0.468085106382979;25;22;0.0319148936170213;0.468085106382979
Control.SRR15539829;45;45;0.533333333333333;21;24;0.0333333333333333;0.466666666666667
Control.SRR15539829;45;45;0.622222222222222;17;28;0.122222222222222;0.377777777777778
Control.SRR15539829;49;45;0.571428571428571;21;28;0.0714285714285714;0.428571428571429
Control.SRR15539829;50;45;0.52;24;26;0.02;0.48
Control.SRR15539829;43;45;0.558139534883721;19;24;0.0581395348837209;0.441860465116279
Control.SRR15539829;49;45;0.612244897959184;19;30;0.112244897959184;0.387755102040816
Control.SRR15539829;44;45;0.681818181818182;14;30;0.181818181818182;0.318181818181818
Control.SRR15539829;48;45;0.604166666666667;19;29;0.104166666666667;0.395833333333333
Control.SRR15539829;51;45;0.470588235294118;27;24;0.0294117647058824;0.470588235294118
Control.SRR15539829;39;45;0.538461538461538;18;21;0.0384615384615384;0.461538461538462
Control.SRR15539829;41;45;0.48780487804878;21;20;0.0121951219512195;0.48780487804878
Control.SRR15539829;50;45;0.58;21;29;0.08;0.42
Control.SRR15539829;46;45;0.630434782608696;17;29;0.130434782608696;0.369565217391304
Control.SRR15539829;41;45;0.51219512195122;20;21;0.0121951219512195;0.48780487804878
Control.SRR15539829;39;45;0.358974358974359;25;14;0.141025641025641;0.358974358974359
Control.SRR15539829;50;45;0.48;26;24;0.02;0.48
Control.SRR15539829;51;45;0.470588235294118;27;24;0.0294117647058824;0.470588235294118
Control.SRR15539829;51;45;0.392156862745098;31;20;0.107843137254902;0.392156862745098
Control.SRR15539829;47;45;0.48936170212766;24;23;0.0106382978723404;0.48936170212766
Control.SRR15539829;44;45;0.477272727272727;23;21;0.0227272727272727;0.477272727272727
Control.SRR15539829;46;45;0.478260869565217;24;22;0.0217391304347826;0.478260869565217
Control.SRR15539829;46;45;0.565217391304348;20;26;0.0652173913043478;0.434782608695652
Control.SRR15539829;49;45;0.387755102040816;30;19;0.112244897959184;0.387755102040816
Control.SRR15539829;50;45;0.46;27;23;0.04;0.46
Control.SRR15539829;43;45;0.558139534883721;19;24;0.0581395348837209;0.441860465116279
Control.SRR15539829;48;45;0.5;24;24;0;0.5
Control.SRR15539829;42;45;0.380952380952381;26;16;0.119047619047619;0.380952380952381
Control.SRR15539829;42;45;0.428571428571429;24;18;0.0714285714285715;0.428571428571429
Control.SRR15539829;43;45;0.441860465116279;24;19;0.0581395348837209;0.441860465116279
Control.SRR15539829;43;45;0.441860465116279;24;19;0.0581395348837209;0.441860465116279
Control.SRR15539829;49;45;0.428571428571429;28;21;0.0714285714285715;0.428571428571429
Control.SRR15539829;49;45;0.571428571428571;21;28;0.0714285714285714;0.428571428571429
Control.SRR15539829;40;45;0.2;32;8;0.3;0.2
Control.SRR15539829;49;45;0.510204081632653;24;25;0.0102040816326531;0.489795918367347
Control.SRR15539829;50;45;0.6;20;30;0.1;0.4
Control.SRR15539829;50;45;0.44;28;22;0.06;0.44
Control.SRR15539829;43;45;0.488372093023256;22;21;0.0116279069767442;0.488372093023256
Control.SRR15539829;50;45;0.46;27;23;0.04;0.46
Control.SRR15539829;46;45;0.456521739130435;25;21;0.0434782608695652;0.456521739130435
Control.SRR15539829;49;45;0.428571428571429;28;21;0.0714285714285715;0.428571428571429
Control.SRR15539829;42;45;0.619047619047619;16;26;0.119047619047619;0.380952380952381
Control.SRR15539829;41;45;0.48780487804878;21;20;0.0121951219512195;0.48780487804878
Control.SRR15539829;51;45;0.607843137254902;20;31;0.107843137254902;0.392156862745098
Control.SRR15539829;47;45;0.617021276595745;18;29;0.117021276595745;0.382978723404255
Control.SRR15539829;46;45;0.543478260869565;21;25;0.0434782608695652;0.456521739130435
Control.SRR15539829;43;45;0.581395348837209;18;25;0.0813953488372093;0.418604651162791
Control.SRR15539829;43;45;0.418604651162791;25;18;0.0813953488372093;0.418604651162791
Control.SRR15539829;42;45;0.523809523809524;20;22;0.0238095238095238;0.476190476190476
Control.SRR15539829;42;45;0.30952380952381;29;13;0.19047619047619;0.30952380952381
Control.SRR15539829;51;45;0.490196078431373;26;25;0.00980392156862747;0.490196078431373
Control.SRR15539829;47;45;0.553191489361702;21;26;0.0531914893617021;0.446808510638298
Control.SRR15539829;41;45;0.365853658536585;26;15;0.134146341463415;0.365853658536585
Control.SRR15539829;49;45;0.551020408163265;22;27;0.0510204081632653;0.448979591836735
Control.SRR15539829;48;45;0.604166666666667;19;29;0.104166666666667;0.395833333333333
Control.SRR15539829;47;45;0.553191489361702;21;26;0.0531914893617021;0.446808510638298
Control.SRR15539829;39;45;0.615384615384615;15;24;0.115384615384615;0.384615384615385
Control.SRR15539829;46;45;0.543478260869565;21;25;0.0434782608695652;0.456521739130435
Control.SRR15539829;45;45;0.577777777777778;19;26;0.0777777777777777;0.422222222222222
Control.SRR15539829;45;45;0.444444444444444;25;20;0.0555555555555556;0.444444444444444
Control.SRR15539829;48;45;0.604166666666667;19;29;0.104166666666667;0.395833333333333
Control.SRR15539829;41;45;0.414634146341463;24;17;0.0853658536585366;0.414634146341463
Control.SRR15539829;51;45;0.529411764705882;24;27;0.0294117647058824;0.470588235294118
Control.SRR15539829;44;45;0.613636363636364;17;27;0.113636363636364;0.386363636363636
Control.SRR15539829;46;45;0.369565217391304;29;17;0.130434782608696;0.369565217391304
Control.SRR15539829;45;45;0.488888888888889;23;22;0.0111111111111111;0.488888888888889
Control.SRR15539829;42;45;0.476190476190476;22;20;0.0238095238095238;0.476190476190476
Control.SRR15539829;45;45;0.533333333333333;21;24;0.0333333333333333;0.466666666666667
Control.SRR15539829;45;45;0.4;27;18;0.1;0.4
Control.SRR15539829;39;45;0.58974358974359;16;23;0.0897435897435898;0.41025641025641
Control.SRR15539829;45;45;0.511111111111111;22;23;0.0111111111111111;0.488888888888889
Control.SRR15539829;46;45;0.478260869565217;24;22;0.0217391304347826;0.478260869565217
Control.SRR15539829;47;45;0.531914893617021;22;25;0.0319148936170213;0.468085106382979
Control.SRR15539829;46;45;0.543478260869565;21;25;0.0434782608695652;0.456521739130435
Control.SRR15539829;43;45;0.604651162790698;17;26;0.104651162790698;0.395348837209302
Control.SRR15539829;51;45;0.588235294117647;21;30;0.0882352941176471;0.411764705882353
Control.SRR15539829;50;45;0.54;23;27;0.04;0.46
Control.SRR15539829;51;45;0.450980392156863;28;23;0.0490196078431372;0.450980392156863
Control.SRR15539829;49;45;0.530612244897959;23;26;0.0306122448979592;0.469387755102041
Control.SRR15539829;40;45;0.575;17;23;0.075;0.425
Control.SRR15539829;39;45;0.487179487179487;20;19;0.0128205128205128;0.487179487179487
Control.SRR15539829;49;45;0.428571428571429;28;21;0.0714285714285715;0.428571428571429
Control.SRR15539829;50;45;0.4;30;20;0.1;0.4
Control.SRR15539829;47;45;0.595744680851064;19;28;0.0957446808510638;0.404255319148936
Control.SRR15539829;44;45;0.340909090909091;29;15;0.159090909090909;0.340909090909091
Control.SRR15539829;43;45;0.558139534883721;19;24;0.0581395348837209;0.441860465116279
Control.SRR15539829;45;45;0.466666666666667;24;21;0.0333333333333333;0.466666666666667
Control.SRR15539829;47;45;0.531914893617021;22;25;0.0319148936170213;0.468085106382979
Control.SRR15539829;44;45;0.477272727272727;23;21;0.0227272727272727;0.477272727272727
Control.SRR15539829;43;45;0.511627906976744;21;22;0.0116279069767442;0.488372093023256
Control.SRR15539829;48;45;0.458333333333333;26;22;0.0416666666666667;0.458333333333333
Control.SRR15539829;45;45;0.511111111111111;22;23;0.0111111111111111;0.488888888888889
Control.SRR15539829;51;45;0.431372549019608;29;22;0.0686274509803921;0.431372549019608
Control.SRR15539829;46;45;0.434782608695652;26;20;0.0652173913043478;0.434782608695652
Control.SRR15539829;49;45;0.408163265306122;29;20;0.0918367346938775;0.408163265306122
Control.SRR15539829;48;45;0.479166666666667;25;23;0.0208333333333333;0.479166666666667
Control.SRR15539829;51;45;0.588235294117647;21;30;0.0882352941176471;0.411764705882353
Control.SRR15539829;41;45;0.560975609756098;18;23;0.0609756097560976;0.439024390243902
Control.SRR15539829;51;45;0.490196078431373;26;25;0.00980392156862747;0.490196078431373
Control.SRR15539829;43;45;0.441860465116279;24;19;0.0581395348837209;0.441860465116279
Control.SRR15539829;43;45;0.511627906976744;21;22;0.0116279069767442;0.488372093023256
Control.SRR15539829;39;45;0.512820512820513;19;20;0.0128205128205128;0.487179487179487
Control.SRR15539829;48;45;0.5;24;24;0;0.5
Control.SRR15539829;51;45;0.509803921568627;25;26;0.00980392156862742;0.490196078431373
Control.SRR15539829;45;45;0.533333333333333;21;24;0.0333333333333333;0.466666666666667
Control.SRR15539829;45;45;0.488888888888889;23;22;0.0111111111111111;0.488888888888889
Control.SRR15539829;39;45;0.58974358974359;16;23;0.0897435897435898;0.41025641025641
Control.SRR15539829;44;45;0.409090909090909;26;18;0.0909090909090909;0.409090909090909
Control.SRR15539829;50;45;0.44;28;22;0.06;0.44
Control.SRR15539829;46;45;0.478260869565217;24;22;0.0217391304347826;0.478260869565217
Control.SRR15539829;49;45;0.510204081632653;24;25;0.0102040816326531;0.489795918367347
Control.SRR15539829;48;45;0.354166666666667;31;17;0.145833333333333;0.354166666666667
Control.SRR15539829;42;45;0.452380952380952;23;19;0.0476190476190476;0.452380952380952
Control.SRR15539829;51;45;0.431372549019608;29;22;0.0686274509803921;0.431372549019608
Control.SRR15539829;46;45;0.456521739130435;25;21;0.0434782608695652;0.456521739130435
Control.SRR15539829;42;45;0.5;21;21;0;0.5
Control.SRR15539829;50;45;0.6;20;30;0.1;0.4
Control.SRR15539829;41;45;0.48780487804878;21;20;0.0121951219512195;0.48780487804878
Control.SRR15539829;43;45;0.488372093023256;22;21;0.0116279069767442;0.488372093023256
Control.SRR15539829;47;45;0.446808510638298;26;21;0.0531914893617021;0.446808510638298
Control.SRR15539829;45;45;0.422222222222222;26;19;0.0777777777777778;0.422222222222222
Control.SRR15539829;51;45;0.450980392156863;28;23;0.0490196078431372;0.450980392156863
Control.SRR15539829;46;45;0.478260869565217;24;22;0.0217391304347826;0.478260869565217
Control.SRR15539829;51;45;0.431372549019608;29;22;0.0686274509803921;0.431372549019608
Control.SRR15539829;48;45;0.4375;27;21;0.0625;0.4375
Control.SRR15539829;49;45;0.571428571428571;21;28;0.0714285714285714;0.428571428571429
Control.SRR15539829;45;45;0.511111111111111;22;23;0.0111111111111111;0.488888888888889
Control.SRR15539829;40;45;0.55;18;22;0.05;0.45
Control.SRR15539829;46;45;0.565217391304348;20;26;0.0652173913043478;0.434782608695652
Control.SRR15539829;39;45;0.487179487179487;20;19;0.0128205128205128;0.487179487179487
Control.SRR15539829;48;45;0.5625;21;27;0.0625;0.4375
Control.SRR15539829;42;45;0.404761904761905;25;17;0.0952380952380952;0.404761904761905
Control.SRR15539829;46;45;0.521739130434783;22;24;0.0217391304347826;0.478260869565217
Control.SRR15539829;49;45;0.408163265306122;29;20;0.0918367346938775;0.408163265306122
Control.SRR15539829;40;45;0.65;14;26;0.15;0.35
Control.SRR15539829;45;45;0.311111111111111;31;14;0.188888888888889;0.311111111111111
Control.SRR15539829;49;45;0.612244897959184;19;30;0.112244897959184;0.387755102040816
Control.SRR15539829;41;45;0.48780487804878;21;20;0.0121951219512195;0.48780487804878
Control.SRR15539829;49;45;0.612244897959184;19;30;0.112244897959184;0.387755102040816
Control.SRR15539829;47;45;0.48936170212766;24;23;0.0106382978723404;0.48936170212766
Control.SRR15539829;43;45;0.488372093023256;22;21;0.0116279069767442;0.488372093023256
Control.SRR15539829;50;45;0.44;28;22;0.06;0.44
Control.SRR15539829;40;45;0.575;17;23;0.075;0.425
Control.SRR15539829;47;45;0.51063829787234;23;24;0.0106382978723404;0.48936170212766
Control.SRR15539829;39;45;0.58974358974359;16;23;0.0897435897435898;0.41025641025641
Control.SRR15539829;45;45;0.488888888888889;23;22;0.0111111111111111;0.488888888888889
Control.SRR15539829;46;45;0.5;23;23;0;0.5
Control.SRR15539829;45;45;0.422222222222222;26;19;0.0777777777777778;0.422222222222222
Control.SRR15539829;50;45;0.44;28;22;0.06;0.44
Control.SRR15539829;51;45;0.392156862745098;31;20;0.107843137254902;0.392156862745098
Control.SRR15539829;46;45;0.456521739130435;25;21;0.0434782608695652;0.456521739130435
Control.SRR15539829;46;45;0.478260869565217;24;22;0.0217391304347826;0.478260869565217
Control.SRR15539829;46;45;0.456521739130435;25;21;0.0434782608695652;0.456521739130435
Control.SRR15539829;46;45;0.478260869565217;24;22;0.0217391304347826;0.478260869565217
Control.SRR15539829;46;45;0.391304347826087;28;18;0.108695652173913;0.391304347826087
Control.SRR15539829;47;45;0.553191489361702;21;26;0.0531914893617021;0.446808510638298
Control.SRR15539829;45;45;0.466666666666667;24;21;0.0333333333333333;0.466666666666667
Control.SRR15539829;47;45;0.553191489361702;21;26;0.0531914893617021;0.446808510638298
Control.SRR15539829;48;45;0.458333333333333;26;22;0.0416666666666667;0.458333333333333
Control.SRR15539829;47;45;0.659574468085106;16;31;0.159574468085106;0.340425531914894
Control.SRR15539829;39;45;0.435897435897436;22;17;0.0641025641025641;0.435897435897436
Control.SRR15539829;44;45;0.522727272727273;21;23;0.0227272727272727;0.477272727272727
Control.SRR15539829;48;45;0.458333333333333;26;22;0.0416666666666667;0.458333333333333
Control.SRR15539829;50;45;0.6;20;30;0.1;0.4
Control.SRR15539829;46;45;0.434782608695652;26;20;0.0652173913043478;0.434782608695652
Control.SRR15539829;47;45;0.531914893617021;22;25;0.0319148936170213;0.468085106382979
Control.SRR15539829;46;45;0.478260869565217;24;22;0.0217391304347826;0.478260869565217
Control.SRR15539829;49;45;0.551020408163265;22;27;0.0510204081632653;0.448979591836735
Control.SRR15539829;45;45;0.466666666666667;24;21;0.0333333333333333;0.466666666666667
Control.SRR15539829;43;45;0.488372093023256;22;21;0.0116279069767442;0.488372093023256
Control.SRR15539829;51;45;0.529411764705882;24;27;0.0294117647058824;0.470588235294118
Control.SRR15539829;43;45;0.488372093023256;22;21;0.0116279069767442;0.488372093023256
Control.SRR15539829;45;45;0.533333333333333;21;24;0.0333333333333333;0.466666666666667
Control.SRR15539829;42;45;0.5;21;21;0;0.5
Control.SRR15539829;39;45;0.58974358974359;16;23;0.0897435897435898;0.41025641025641
Control.SRR15539829;42;45;0.404761904761905;25;17;0.0952380952380952;0.404761904761905
Control.SRR15539829;48;45;0.625;18;30;0.125;0.375
Control.SRR15539829;47;45;0.382978723404255;29;18;0.117021276595745;0.382978723404255
Control.SRR15539829;44;45;0.431818181818182;25;19;0.0681818181818182;0.431818181818182
Control.SRR15539829;45;45;0.466666666666667;24;21;0.0333333333333333;0.466666666666667
Control.SRR15539829;41;45;0.439024390243902;23;18;0.0609756097560976;0.439024390243902
Control.SRR15539829;43;45;0.534883720930233;20;23;0.0348837209302325;0.465116279069767
Control.SRR15539829;46;45;0.41304347826087;27;19;0.0869565217391304;0.41304347826087
Control.SRR15539829;49;45;0.591836734693878;20;29;0.0918367346938775;0.408163265306122
Control.SRR15539829;44;45;0.613636363636364;17;27;0.113636363636364;0.386363636363636
Control.SRR15539829;50;45;0.52;24;26;0.02;0.48
Control.SRR15539829;44;45;0.590909090909091;18;26;0.0909090909090909;0.409090909090909
Control.SRR15539829;47;45;0.531914893617021;22;25;0.0319148936170213;0.468085106382979
Control.SRR15539829;51;45;0.372549019607843;32;19;0.127450980392157;0.372549019607843
Control.SRR15539829;45;45;0.333333333333333;30;15;0.166666666666667;0.333333333333333
Control.SRR15539829;47;45;0.531914893617021;22;25;0.0319148936170213;0.468085106382979
Control.SRR15539829;51;45;0.490196078431373;26;25;0.00980392156862747;0.490196078431373
Control.SRR15539829;47;45;0.48936170212766;24;23;0.0106382978723404;0.48936170212766
Control.SRR15539829;46;45;0.5;23;23;0;0.5
Control.SRR15539829;46;45;0.630434782608696;17;29;0.130434782608696;0.369565217391304
Control.SRR15539829;48;45;0.541666666666667;22;26;0.0416666666666666;0.458333333333333
Control.SRR15539829;49;45;0.489795918367347;25;24;0.0102040816326531;0.489795918367347
Control.SRR15539829;42;45;0.357142857142857;27;15;0.142857142857143;0.357142857142857
Control.SRR15539829;43;45;0.534883720930233;20;23;0.0348837209302325;0.465116279069767
Control.SRR15539829;51;45;0.450980392156863;28;23;0.0490196078431372;0.450980392156863
Control.SRR15539829;43;45;0.511627906976744;21;22;0.0116279069767442;0.488372093023256
Control.SRR15539829;43;45;0.465116279069767;23;20;0.0348837209302326;0.465116279069767
Control.SRR15539829;48;45;0.395833333333333;29;19;0.104166666666667;0.395833333333333
Control.SRR15539829;46;45;0.478260869565217;24;22;0.0217391304347826;0.478260869565217
Control.SRR15539829;39;45;0.564102564102564;17;22;0.0641025641025641;0.435897435897436
Control.SRR15539829;43;45;0.418604651162791;25;18;0.0813953488372093;0.418604651162791
Control.SRR15539829;49;45;0.36734693877551;31;18;0.13265306122449;0.36734693877551
Control.SRR15539829;48;45;0.458333333333333;26;22;0.0416666666666667;0.458333333333333
Control.SRR15539829;46;45;0.608695652173913;18;28;0.108695652173913;0.391304347826087
Control.SRR15539829;42;45;0.619047619047619;16;26;0.119047619047619;0.380952380952381
Control.SRR15539829;41;45;0.439024390243902;23;18;0.0609756097560976;0.439024390243902
Control.SRR15539829;43;45;0.418604651162791;25;18;0.0813953488372093;0.418604651162791
Control.SRR15539829;50;45;0.4;30;20;0.1;0.4
Control.SRR15539829;39;45;0.487179487179487;20;19;0.0128205128205128;0.487179487179487
Control.SRR15539829;45;45;0.466666666666667;24;21;0.0333333333333333;0.466666666666667
Control.SRR15539829;50;45;0.52;24;26;0.02;0.48
Control.SRR15539829;49;45;0.346938775510204;32;17;0.153061224489796;0.346938775510204
Control.SRR15539829;42;45;0.547619047619048;19;23;0.0476190476190477;0.452380952380952
Control.SRR15539829;48;45;0.458333333333333;26;22;0.0416666666666667;0.458333333333333
Control.SRR15539829;45;45;0.466666666666667;24;21;0.0333333333333333;0.466666666666667
Control.SRR15539829;49;45;0.530612244897959;23;26;0.0306122448979592;0.469387755102041
Control.SRR15539829;49;45;0.387755102040816;30;19;0.112244897959184;0.387755102040816
Control.SRR15539829;47;45;0.382978723404255;29;18;0.117021276595745;0.382978723404255
Control.SRR15539829;46;45;0.5;23;23;0;0.5
Control.SRR15539829;41;45;0.48780487804878;21;20;0.0121951219512195;0.48780487804878
Control.SRR15539829;45;45;0.488888888888889;23;22;0.0111111111111111;0.488888888888889
Control.SRR15539829;44;45;0.5;22;22;0;0.5
Control.SRR15539829;50;45;0.56;22;28;0.0600000000000001;0.44
Control.SRR15539829;44;45;0.386363636363636;27;17;0.113636363636364;0.386363636363636
Control.SRR15539829;46;45;0.456521739130435;25;21;0.0434782608695652;0.456521739130435
Control.SRR15539829;47;45;0.361702127659574;30;17;0.138297872340426;0.361702127659574
Control.SRR15539829;51;45;0.313725490196078;35;16;0.186274509803922;0.313725490196078
Control.SRR15539829;46;45;0.369565217391304;29;17;0.130434782608696;0.369565217391304
Control.SRR15539829;44;45;0.477272727272727;23;21;0.0227272727272727;0.477272727272727
Control.SRR15539829;42;45;0.452380952380952;23;19;0.0476190476190476;0.452380952380952
Control.SRR15539829;44;45;0.454545454545455;24;20;0.0454545454545455;0.454545454545455
Control.SRR15539829;44;45;0.454545454545455;24;20;0.0454545454545455;0.454545454545455
Control.SRR15539829;41;45;0.439024390243902;23;18;0.0609756097560976;0.439024390243902
Control.SRR15539829;50;45;0.46;27;23;0.04;0.46
Control.SRR15539829;48;45;0.604166666666667;19;29;0.104166666666667;0.395833333333333
Control.SRR15539829;50;45;0.52;24;26;0.02;0.48
Control.SRR15539829;47;45;0.51063829787234;23;24;0.0106382978723404;0.48936170212766
Control.SRR15539829;48;45;0.541666666666667;22;26;0.0416666666666666;0.458333333333333
Control.SRR15539829;42;45;0.5;21;21;0;0.5
Control.SRR15539829;48;45;0.395833333333333;29;19;0.104166666666667;0.395833333333333
Control.SRR15539829;47;45;0.361702127659574;30;17;0.138297872340426;0.361702127659574
Control.SRR15539829;41;45;0.536585365853659;19;22;0.0365853658536586;0.463414634146341
Control.SRR15539829;51;45;0.411764705882353;30;21;0.0882352941176471;0.411764705882353
Control.SRR15539829;45;45;0.488888888888889;23;22;0.0111111111111111;0.488888888888889
Control.SRR15539829;50;45;0.54;23;27;0.04;0.46
Control.SRR15539829;46;45;0.41304347826087;27;19;0.0869565217391304;0.41304347826087
Control.SRR15539829;50;45;0.62;19;31;0.12;0.38
Control.SRR15539829;49;45;0.530612244897959;23;26;0.0306122448979592;0.469387755102041
Control.SRR15539829;39;45;0.461538461538462;21;18;0.0384615384615384;0.461538461538462
Control.SRR15539829;46;45;0.543478260869565;21;25;0.0434782608695652;0.456521739130435
Control.SRR15539829;43;45;0.488372093023256;22;21;0.0116279069767442;0.488372093023256
Control.SRR15539829;48;45;0.479166666666667;25;23;0.0208333333333333;0.479166666666667
Control.SRR15539829;49;45;0.530612244897959;23;26;0.0306122448979592;0.469387755102041
Control.SRR15539829;50;45;0.5;25;25;0;0.5
Control.SRR15539829;45;45;0.533333333333333;21;24;0.0333333333333333;0.466666666666667
Control.SRR15539829;44;45;0.568181818181818;19;25;0.0681818181818182;0.431818181818182
Control.SRR15539829;41;45;0.390243902439024;25;16;0.109756097560976;0.390243902439024
Control.SRR15539829;44;45;0.568181818181818;19;25;0.0681818181818182;0.431818181818182
Control.SRR15539829;43;45;0.674418604651163;14;29;0.174418604651163;0.325581395348837
Control.SRR15539829;44;45;0.545454545454545;20;24;0.0454545454545454;0.454545454545455
Control.SRR15539829;51;45;0.509803921568627;25;26;0.00980392156862742;0.490196078431373
Control.SRR15539829;45;45;0.444444444444444;25;20;0.0555555555555556;0.444444444444444
Control.SRR15539829;42;45;0.642857142857143;15;27;0.142857142857143;0.357142857142857
Control.SRR15539829;39;45;0.333333333333333;26;13;0.166666666666667;0.333333333333333
Control.SRR15539829;40;45;0.625;15;25;0.125;0.375
Control.SRR15539829;44;45;0.454545454545455;24;20;0.0454545454545455;0.454545454545455
Control.SRR15539829;44;45;0.522727272727273;21;23;0.0227272727272727;0.477272727272727
Control.SRR15539829;39;45;0.41025641025641;23;16;0.0897435897435898;0.41025641025641
Control.SRR15539829;50;45;0.4;30;20;0.1;0.4
Control.SRR15539829;47;45;0.51063829787234;23;24;0.0106382978723404;0.48936170212766
Control.SRR15539829;49;45;0.408163265306122;29;20;0.0918367346938775;0.408163265306122
Control.SRR15539829;39;45;0.512820512820513;19;20;0.0128205128205128;0.487179487179487
Control.SRR15539829;48;45;0.583333333333333;20;28;0.0833333333333334;0.416666666666667
Control.SRR15539829;43;45;0.441860465116279;24;19;0.0581395348837209;0.441860465116279
Control.SRR15539829;50;45;0.54;23;27;0.04;0.46
Control.SRR15539829;49;45;0.448979591836735;27;22;0.0510204081632653;0.448979591836735
Control.SRR15539829;43;45;0.372093023255814;27;16;0.127906976744186;0.372093023255814
Control.SRR15539829;50;45;0.56;22;28;0.0600000000000001;0.44
Control.SRR15539829;45;45;0.533333333333333;21;24;0.0333333333333333;0.466666666666667
Control.SRR15539829;44;45;0.5;22;22;0;0.5
Control.SRR15539829;40;45;0.475;21;19;0.025;0.475
Control.SRR15539829;39;45;0.41025641025641;23;16;0.0897435897435898;0.41025641025641
Control.SRR15539829;44;45;0.454545454545455;24;20;0.0454545454545455;0.454545454545455
Control.SRR15539829;46;45;0.565217391304348;20;26;0.0652173913043478;0.434782608695652
Control.SRR15539829;50;45;0.5;25;25;0;0.5
Control.SRR15539829;48;45;0.520833333333333;23;25;0.0208333333333334;0.479166666666667
Control.SRR15539829;42;45;0.547619047619048;19;23;0.0476190476190477;0.452380952380952
Control.SRR15539829;48;45;0.479166666666667;25;23;0.0208333333333333;0.479166666666667
Control.SRR15539829;43;45;0.465116279069767;23;20;0.0348837209302326;0.465116279069767
Control.SRR15539829;49;45;0.551020408163265;22;27;0.0510204081632653;0.448979591836735
Control.SRR15539829;49;45;0.612244897959184;19;30;0.112244897959184;0.387755102040816
Control.SRR15539829;40;45;0.55;18;22;0.05;0.45
Control.SRR15539829;44;45;0.431818181818182;25;19;0.0681818181818182;0.431818181818182
Control.SRR15539829;50;45;0.48;26;24;0.02;0.48
Control.SRR15539829;48;45;0.520833333333333;23;25;0.0208333333333334;0.479166666666667
Control.SRR15539829;39;45;0.358974358974359;25;14;0.141025641025641;0.358974358974359
Control.SRR15539829;43;45;0.488372093023256;22;21;0.0116279069767442;0.488372093023256
Control.SRR15539829;45;45;0.4;27;18;0.1;0.4
Control.SRR15539829;42;45;0.523809523809524;20;22;0.0238095238095238;0.476190476190476
Control.SRR15539829;41;45;0.463414634146341;22;19;0.0365853658536585;0.463414634146341
Control.SRR15539829;50;45;0.5;25;25;0;0.5
Control.SRR15539829;46;45;0.565217391304348;20;26;0.0652173913043478;0.434782608695652
Control.SRR15539829;40;45;0.575;17;23;0.075;0.425
Control.SRR15539829;45;45;0.577777777777778;19;26;0.0777777777777777;0.422222222222222
Control.SRR15539829;50;45;0.48;26;24;0.02;0.48
Control.SRR15539829;47;45;0.468085106382979;25;22;0.0319148936170213;0.468085106382979
Control.SRR15539829;44;45;0.227272727272727;34;10;0.272727272727273;0.227272727272727
Control.SRR15539829;44;45;0.590909090909091;18;26;0.0909090909090909;0.409090909090909
Control.SRR15539829;47;45;0.51063829787234;23;24;0.0106382978723404;0.48936170212766
Control.SRR15539829;44;45;0.568181818181818;19;25;0.0681818181818182;0.431818181818182
Control.SRR15539829;49;45;0.489795918367347;25;24;0.0102040816326531;0.489795918367347
Control.SRR15539829;49;45;0.489795918367347;25;24;0.0102040816326531;0.489795918367347
Control.SRR15539829;49;45;0.428571428571429;28;21;0.0714285714285715;0.428571428571429
Control.SRR15539829;41;45;0.463414634146341;22;19;0.0365853658536585;0.463414634146341
Control.SRR15539829;41;45;0.51219512195122;20;21;0.0121951219512195;0.48780487804878
Control.SRR15539829;44;45;0.522727272727273;21;23;0.0227272727272727;0.477272727272727
Control.SRR15539829;43;45;0.558139534883721;19;24;0.0581395348837209;0.441860465116279
Control.SRR15539829;40;45;0.55;18;22;0.05;0.45
Control.SRR15539829;44;45;0.5;22;22;0;0.5
Control.SRR15539829;40;45;0.4;24;16;0.1;0.4
Control.SRR15539829;44;45;0.477272727272727;23;21;0.0227272727272727;0.477272727272727
Control.SRR15539829;39;45;0.615384615384615;15;24;0.115384615384615;0.384615384615385
Control.SRR15539829;47;45;0.404255319148936;28;19;0.0957446808510639;0.404255319148936
Control.SRR15539829;47;45;0.404255319148936;28;19;0.0957446808510639;0.404255319148936
Control.SRR15539829;45;45;0.488888888888889;23;22;0.0111111111111111;0.488888888888889
Control.SRR15539829;41;45;0.51219512195122;20;21;0.0121951219512195;0.48780487804878
Control.SRR15539829;46;45;0.5;23;23;0;0.5
Control.SRR15539829;45;45;0.488888888888889;23;22;0.0111111111111111;0.488888888888889
Control.SRR15539829;47;45;0.553191489361702;21;26;0.0531914893617021;0.446808510638298
Control.SRR15539829;48;45;0.520833333333333;23;25;0.0208333333333334;0.479166666666667
Control.SRR15539829;48;45;0.604166666666667;19;29;0.104166666666667;0.395833333333333
Control.SRR15539829;40;45;0.425;23;17;0.075;0.425
Control.SRR15539829;40;45;0.55;18;22;0.05;0.45
Control.SRR15539829;39;45;0.435897435897436;22;17;0.0641025641025641;0.435897435897436
Control.SRR15539829;46;45;0.5;23;23;0;0.5
Control.SRR15539829;42;45;0.666666666666667;14;28;0.166666666666667;0.333333333333333
Control.SRR15539829;47;45;0.468085106382979;25;22;0.0319148936170213;0.468085106382979
Control.SRR15539829;48;45;0.520833333333333;23;25;0.0208333333333334;0.479166666666667
Control.SRR15539829;43;45;0.534883720930233;20;23;0.0348837209302325;0.465116279069767
Control.SRR15539829;49;45;0.489795918367347;25;24;0.0102040816326531;0.489795918367347
Control.SRR15539829;43;45;0.697674418604651;13;30;0.197674418604651;0.302325581395349
Control.SRR15539829;48;45;0.5;24;24;0;0.5
Control.SRR15539829;48;45;0.416666666666667;28;20;0.0833333333333333;0.416666666666667
Control.SRR15539829;47;45;0.48936170212766;24;23;0.0106382978723404;0.48936170212766
Control.SRR15539829;49;45;0.428571428571429;28;21;0.0714285714285715;0.428571428571429
Control.SRR15539829;42;45;0.547619047619048;19;23;0.0476190476190477;0.452380952380952
Control.SRR15539829;47;45;0.51063829787234;23;24;0.0106382978723404;0.48936170212766
Control.SRR15539829;48;45;0.541666666666667;22;26;0.0416666666666666;0.458333333333333
Control.SRR15539829;44;45;0.477272727272727;23;21;0.0227272727272727;0.477272727272727
Control.SRR15539829;39;45;0.384615384615385;24;15;0.115384615384615;0.384615384615385
Control.SRR15539829;43;45;0.418604651162791;25;18;0.0813953488372093;0.418604651162791
Control.SRR15539829;47;45;0.468085106382979;25;22;0.0319148936170213;0.468085106382979
Control.SRR15539829;48;45;0.520833333333333;23;25;0.0208333333333334;0.479166666666667
Control.SRR15539829;51;45;0.588235294117647;21;30;0.0882352941176471;0.411764705882353
Control.SRR15539829;42;45;0.5;21;21;0;0.5
Control.SRR15539829;42;45;0.404761904761905;25;17;0.0952380952380952;0.404761904761905
Control.SRR15539829;48;45;0.541666666666667;22;26;0.0416666666666666;0.458333333333333
Control.SRR15539829;44;45;0.431818181818182;25;19;0.0681818181818182;0.431818181818182
Control.SRR15539829;46;45;0.5;23;23;0;0.5
Control.SRR15539829;44;45;0.454545454545455;24;20;0.0454545454545455;0.454545454545455
Control.SRR15539829;41;45;0.585365853658537;17;24;0.0853658536585366;0.414634146341463
Control.SRR15539829;40;45;0.5;20;20;0;0.5
Control.SRR15539829;49;45;0.448979591836735;27;22;0.0510204081632653;0.448979591836735
Control.SRR15539829;41;45;0.634146341463415;15;26;0.134146341463415;0.365853658536585
Control.SRR15539829;40;45;0.525;19;21;0.025;0.475
Control.SRR15539829;41;45;0.51219512195122;20;21;0.0121951219512195;0.48780487804878
Control.SRR15539829;48;45;0.395833333333333;29;19;0.104166666666667;0.395833333333333
Control.SRR15539829;41;45;0.609756097560976;16;25;0.109756097560976;0.390243902439024
Control.SRR15539829;42;45;0.595238095238095;17;25;0.0952380952380952;0.404761904761905
Control.SRR15539829;39;45;0.435897435897436;22;17;0.0641025641025641;0.435897435897436
Control.SRR15539829;41;45;0.390243902439024;25;16;0.109756097560976;0.390243902439024
Control.SRR15539829;46;45;0.543478260869565;21;25;0.0434782608695652;0.456521739130435
Control.SRR15539829;49;45;0.469387755102041;26;23;0.0306122448979592;0.469387755102041
Control.SRR15539829;39;45;0.538461538461538;18;21;0.0384615384615384;0.461538461538462
Control.SRR15539829;49;45;0.346938775510204;32;17;0.153061224489796;0.346938775510204
Control.SRR15539829;48;45;0.479166666666667;25;23;0.0208333333333333;0.479166666666667
Control.SRR15539829;40;45;0.425;23;17;0.075;0.425
Control.SRR15539829;49;45;0.530612244897959;23;26;0.0306122448979592;0.469387755102041
Control.SRR15539829;50;45;0.48;26;24;0.02;0.48
Control.SRR15539829;41;45;0.390243902439024;25;16;0.109756097560976;0.390243902439024
Control.SRR15539829;51;45;0.431372549019608;29;22;0.0686274509803921;0.431372549019608
Control.SRR15539829;51;45;0.588235294117647;21;30;0.0882352941176471;0.411764705882353
Control.SRR15539829;44;45;0.5;22;22;0;0.5
Control.SRR15539829;49;45;0.551020408163265;22;27;0.0510204081632653;0.448979591836735
Control.SRR15539829;41;45;0.585365853658537;17;24;0.0853658536585366;0.414634146341463
Control.SRR15539829;39;45;0.461538461538462;21;18;0.0384615384615384;0.461538461538462
Control.SRR15539829;42;45;0.452380952380952;23;19;0.0476190476190476;0.452380952380952
Control.SRR15539829;42;45;0.404761904761905;25;17;0.0952380952380952;0.404761904761905
Control.SRR15539829;40;45;0.525;19;21;0.025;0.475
Control.SRR15539829;48;45;0.4375;27;21;0.0625;0.4375
Control.SRR15539829;42;45;0.523809523809524;20;22;0.0238095238095238;0.476190476190476
Control.SRR15539829;40;45;0.55;18;22;0.05;0.45
Control.SRR15539829;46;45;0.478260869565217;24;22;0.0217391304347826;0.478260869565217
Control.SRR15539829;39;45;0.58974358974359;16;23;0.0897435897435898;0.41025641025641
Control.SRR15539829;49;45;0.326530612244898;33;16;0.173469387755102;0.326530612244898
Control.SRR15539829;39;45;0.384615384615385;24;15;0.115384615384615;0.384615384615385
Control.SRR15539829;47;45;0.553191489361702;21;26;0.0531914893617021;0.446808510638298
Control.SRR15539829;46;45;0.478260869565217;24;22;0.0217391304347826;0.478260869565217
Control.SRR15539829;51;45;0.568627450980392;22;29;0.0686274509803921;0.431372549019608
Control.SRR15539829;42;45;0.642857142857143;15;27;0.142857142857143;0.357142857142857
Control.SRR15539829;43;45;0.558139534883721;19;24;0.0581395348837209;0.441860465116279
Control.SRR15539829;48;45;0.645833333333333;17;31;0.145833333333333;0.354166666666667
Control.SRR15539829;50;45;0.46;27;23;0.04;0.46
Control.SRR15539829;42;45;0.571428571428571;18;24;0.0714285714285714;0.428571428571429
Control.SRR15539829;46;45;0.456521739130435;25;21;0.0434782608695652;0.456521739130435
Control.SRR15539829;46;45;0.608695652173913;18;28;0.108695652173913;0.391304347826087
Control.SRR15539829;40;45;0.525;19;21;0.025;0.475
Control.SRR15539829;49;45;0.612244897959184;19;30;0.112244897959184;0.387755102040816
Control.SRR15539829;50;45;0.52;24;26;0.02;0.48
Control.SRR15539829;44;45;0.431818181818182;25;19;0.0681818181818182;0.431818181818182
Control.SRR15539829;40;45;0.375;25;15;0.125;0.375
Control.SRR15539829;44;45;0.545454545454545;20;24;0.0454545454545454;0.454545454545455
Control.SRR15539829;44;45;0.431818181818182;25;19;0.0681818181818182;0.431818181818182
Control.SRR15539829;47;45;0.48936170212766;24;23;0.0106382978723404;0.48936170212766
Control.SRR15539829;40;45;0.575;17;23;0.075;0.425
Control.SRR15539829;51;45;0.549019607843137;23;28;0.0490196078431373;0.450980392156863
Control.SRR15539829;49;45;0.551020408163265;22;27;0.0510204081632653;0.448979591836735
Control.SRR15539829;47;45;0.51063829787234;23;24;0.0106382978723404;0.48936170212766
Control.SRR15539829;49;45;0.571428571428571;21;28;0.0714285714285714;0.428571428571429
Control.SRR15539829;49;45;0.510204081632653;24;25;0.0102040816326531;0.489795918367347
Control.SRR15539829;45;45;0.444444444444444;25;20;0.0555555555555556;0.444444444444444
Control.SRR15539829;43;45;0.511627906976744;21;22;0.0116279069767442;0.488372093023256
Control.SRR15539829;45;45;0.488888888888889;23;22;0.0111111111111111;0.488888888888889
Control.SRR15539829;51;45;0.352941176470588;33;18;0.147058823529412;0.352941176470588
Control.SRR15539829;49;45;0.653061224489796;17;32;0.153061224489796;0.346938775510204
Control.SRR15539829;41;45;0.463414634146341;22;19;0.0365853658536585;0.463414634146341
Control.SRR15539829;51;45;0.509803921568627;25;26;0.00980392156862742;0.490196078431373
Control.SRR15539829;44;45;0.522727272727273;21;23;0.0227272727272727;0.477272727272727
Control.SRR15539829;45;45;0.6;18;27;0.1;0.4
Control.SRR15539829;46;45;0.434782608695652;26;20;0.0652173913043478;0.434782608695652
Control.SRR15539829;40;45;0.525;19;21;0.025;0.475
Control.SRR15539829;49;45;0.551020408163265;22;27;0.0510204081632653;0.448979591836735
Control.SRR15539829;43;45;0.604651162790698;17;26;0.104651162790698;0.395348837209302
Control.SRR15539829;39;45;0.487179487179487;20;19;0.0128205128205128;0.487179487179487
Control.SRR15539829;50;45;0.46;27;23;0.04;0.46
Control.SRR15539829;48;45;0.5625;21;27;0.0625;0.4375
Control.SRR15539829;46;45;0.565217391304348;20;26;0.0652173913043478;0.434782608695652
Control.SRR15539829;46;45;0.652173913043478;16;30;0.152173913043478;0.347826086956522
Control.SRR15539829;51;45;0.431372549019608;29;22;0.0686274509803921;0.431372549019608
Control.SRR15539829;46;45;0.5;23;23;0;0.5
Control.SRR15539829;41;45;0.51219512195122;20;21;0.0121951219512195;0.48780487804878
Control.SRR15539829;42;45;0.595238095238095;17;25;0.0952380952380952;0.404761904761905
Control.SRR15539829;41;45;0.51219512195122;20;21;0.0121951219512195;0.48780487804878
Control.SRR15539829;43;45;0.372093023255814;27;16;0.127906976744186;0.372093023255814
Control.SRR15539829;50;45;0.62;19;31;0.12;0.38
Control.SRR15539829;44;45;0.590909090909091;18;26;0.0909090909090909;0.409090909090909
Control.SRR15539829;47;45;0.468085106382979;25;22;0.0319148936170213;0.468085106382979
Control.SRR15539829;42;45;0.547619047619048;19;23;0.0476190476190477;0.452380952380952
Control.SRR15539829;46;45;0.434782608695652;26;20;0.0652173913043478;0.434782608695652
Control.SRR15539829;41;45;0.341463414634146;27;14;0.158536585365854;0.341463414634146
Control.SRR15539829;46;45;0.478260869565217;24;22;0.0217391304347826;0.478260869565217
Control.SRR15539829;46;45;0.369565217391304;29;17;0.130434782608696;0.369565217391304
Control.SRR15539829;51;45;0.549019607843137;23;28;0.0490196078431373;0.450980392156863
Control.SRR15539829;45;45;0.377777777777778;28;17;0.122222222222222;0.377777777777778
Control.SRR15539829;46;45;0.434782608695652;26;20;0.0652173913043478;0.434782608695652
Control.SRR15539829;47;45;0.425531914893617;27;20;0.074468085106383;0.425531914893617
Control.SRR15539829;45;45;0.622222222222222;17;28;0.122222222222222;0.377777777777778
Control.SRR15539829;46;45;0.391304347826087;28;18;0.108695652173913;0.391304347826087
Control.SRR15539829;50;45;0.3;35;15;0.2;0.3
Control.SRR15539829;50;45;0.6;20;30;0.1;0.4
Control.SRR15539829;41;45;0.48780487804878;21;20;0.0121951219512195;0.48780487804878
Control.SRR15539829;42;45;0.619047619047619;16;26;0.119047619047619;0.380952380952381
Control.SRR15539829;52;45;0.5;26;26;0;0.5
Control.SRR15539829;44;45;0.5;22;22;0;0.5
Control.SRR15539829;52;45;0.442307692307692;29;23;0.0576923076923077;0.442307692307692
Control.SRR15539829;47;45;0.595744680851064;19;28;0.0957446808510638;0.404255319148936
Control.SRR15539829;43;45;0.395348837209302;26;17;0.104651162790698;0.395348837209302
Control.SRR15539829;50;45;0.46;27;23;0.04;0.46
Control.SRR15539829;48;45;0.479166666666667;25;23;0.0208333333333333;0.479166666666667
Control.SRR15539829;51;45;0.470588235294118;27;24;0.0294117647058824;0.470588235294118
Control.SRR15539829;47;45;0.48936170212766;24;23;0.0106382978723404;0.48936170212766
Control.SRR15539829;41;45;0.48780487804878;21;20;0.0121951219512195;0.48780487804878
Control.SRR15539829;42;45;0.476190476190476;22;20;0.0238095238095238;0.476190476190476
Control.SRR15539829;50;45;0.5;25;25;0;0.5
Control.SRR15539829;47;45;0.48936170212766;24;23;0.0106382978723404;0.48936170212766
Control.SRR15539829;45;45;0.511111111111111;22;23;0.0111111111111111;0.488888888888889
Control.SRR15539829;48;45;0.375;30;18;0.125;0.375
Control.SRR15539829;49;45;0.510204081632653;24;25;0.0102040816326531;0.489795918367347
Control.SRR15539829;48;45;0.5;24;24;0;0.5
Control.SRR15539829;51;45;0.529411764705882;24;27;0.0294117647058824;0.470588235294118
Control.SRR15539829;43;45;0.534883720930233;20;23;0.0348837209302325;0.465116279069767
Control.SRR15539829;43;45;0.348837209302326;28;15;0.151162790697674;0.348837209302326
Control.SRR15539829;47;45;0.553191489361702;21;26;0.0531914893617021;0.446808510638298
Control.SRR15539829;42;45;0.428571428571429;24;18;0.0714285714285715;0.428571428571429
Control.SRR15539829;42;45;0.5;21;21;0;0.5
Control.SRR15539829;44;45;0.477272727272727;23;21;0.0227272727272727;0.477272727272727
Control.SRR15539829;50;45;0.54;23;27;0.04;0.46
Control.SRR15539829;44;45;0.477272727272727;23;21;0.0227272727272727;0.477272727272727
Control.SRR15539829;49;45;0.387755102040816;30;19;0.112244897959184;0.387755102040816
Control.SRR15539829;46;45;0.521739130434783;22;24;0.0217391304347826;0.478260869565217
Control.SRR15539829;47;45;0.425531914893617;27;20;0.074468085106383;0.425531914893617
Control.SRR15539829;42;45;0.595238095238095;17;25;0.0952380952380952;0.404761904761905
Control.SRR15539829;48;45;0.583333333333333;20;28;0.0833333333333334;0.416666666666667
Control.SRR15539829;51;45;0.568627450980392;22;29;0.0686274509803921;0.431372549019608
Control.SRR15539829;40;45;0.375;25;15;0.125;0.375
Control.SRR15539829;50;45;0.5;25;25;0;0.5
Control.SRR15539829;49;45;0.489795918367347;25;24;0.0102040816326531;0.489795918367347
Control.SRR15539829;45;45;0.466666666666667;24;21;0.0333333333333333;0.466666666666667
Control.SRR15539829;43;45;0.465116279069767;23;20;0.0348837209302326;0.465116279069767
Control.SRR15539829;42;45;0.404761904761905;25;17;0.0952380952380952;0.404761904761905
Control.SRR15539829;51;45;0.490196078431373;26;25;0.00980392156862747;0.490196078431373
Control.SRR15539829;49;45;0.489795918367347;25;24;0.0102040816326531;0.489795918367347
Control.SRR15539829;44;45;0.568181818181818;19;25;0.0681818181818182;0.431818181818182
Control.SRR15539829;52;45;0.5;26;26;0;0.5
Control.SRR15539829;46;45;0.58695652173913;19;27;0.0869565217391305;0.41304347826087
Control.SRR15539829;46;45;0.434782608695652;26;20;0.0652173913043478;0.434782608695652
Control.SRR15539829;44;45;0.477272727272727;23;21;0.0227272727272727;0.477272727272727
Control.SRR15539829;40;45;0.6;16;24;0.1;0.4
Control.SRR15539829;52;45;0.461538461538462;28;24;0.0384615384615384;0.461538461538462
Control.SRR15539829;45;45;0.577777777777778;19;26;0.0777777777777777;0.422222222222222
Control.SRR15539829;48;45;0.541666666666667;22;26;0.0416666666666666;0.458333333333333
Control.SRR15539829;44;45;0.454545454545455;24;20;0.0454545454545455;0.454545454545455
Control.SRR15539829;47;45;0.553191489361702;21;26;0.0531914893617021;0.446808510638298
Control.SRR15539829;43;45;0.511627906976744;21;22;0.0116279069767442;0.488372093023256
Control.SRR15539829;41;45;0.439024390243902;23;18;0.0609756097560976;0.439024390243902
Control.SRR15539829;40;45;0.35;26;14;0.15;0.35
Control.SRR15539829;43;45;0.558139534883721;19;24;0.0581395348837209;0.441860465116279
Control.SRR15539829;46;45;0.5;23;23;0;0.5
Control.SRR15539829;46;45;0.58695652173913;19;27;0.0869565217391305;0.41304347826087
Control.SRR15539829;48;45;0.541666666666667;22;26;0.0416666666666666;0.458333333333333
Control.SRR15539829;46;45;0.521739130434783;22;24;0.0217391304347826;0.478260869565217
Control.SRR15539829;50;45;0.52;24;26;0.02;0.48
Control.SRR15539829;49;45;0.469387755102041;26;23;0.0306122448979592;0.469387755102041
Control.SRR15539829;49;45;0.36734693877551;31;18;0.13265306122449;0.36734693877551
Control.SRR15539829;44;45;0.386363636363636;27;17;0.113636363636364;0.386363636363636
Control.SRR15539829;42;45;0.380952380952381;26;16;0.119047619047619;0.380952380952381
Control.SRR15539829;40;45;0.45;22;18;0.05;0.45
Control.SRR15539829;40;45;0.525;19;21;0.025;0.475
Control.SRR15539829;46;45;0.543478260869565;21;25;0.0434782608695652;0.456521739130435
Control.SRR15539829;47;45;0.51063829787234;23;24;0.0106382978723404;0.48936170212766
Control.SRR15539829;44;45;0.659090909090909;15;29;0.159090909090909;0.340909090909091
Control.SRR15539829;40;45;0.525;19;21;0.025;0.475
Control.SRR15539829;50;45;0.4;30;20;0.1;0.4
Control.SRR15539829;52;45;0.615384615384615;20;32;0.115384615384615;0.384615384615385
Control.SRR15539829;42;45;0.523809523809524;20;22;0.0238095238095238;0.476190476190476
Control.SRR15539829;47;45;0.404255319148936;28;19;0.0957446808510639;0.404255319148936
Control.SRR15539829;40;45;0.55;18;22;0.05;0.45
Control.SRR15539829;43;45;0.488372093023256;22;21;0.0116279069767442;0.488372093023256
Control.SRR15539829;49;45;0.469387755102041;26;23;0.0306122448979592;0.469387755102041
Control.SRR15539829;48;45;0.479166666666667;25;23;0.0208333333333333;0.479166666666667
Control.SRR15539829;48;45;0.5625;21;27;0.0625;0.4375
Control.SRR15539829;43;45;0.558139534883721;19;24;0.0581395348837209;0.441860465116279
Control.SRR15539829;47;45;0.51063829787234;23;24;0.0106382978723404;0.48936170212766
Control.SRR15539829;45;45;0.533333333333333;21;24;0.0333333333333333;0.466666666666667
Control.SRR15539829;45;45;0.622222222222222;17;28;0.122222222222222;0.377777777777778
Control.SRR15539829;49;45;0.530612244897959;23;26;0.0306122448979592;0.469387755102041
Control.SRR15539829;44;45;0.454545454545455;24;20;0.0454545454545455;0.454545454545455
Control.SRR15539829;44;45;0.431818181818182;25;19;0.0681818181818182;0.431818181818182
Control.SRR15539829;43;45;0.441860465116279;24;19;0.0581395348837209;0.441860465116279
Control.SRR15539829;49;45;0.510204081632653;24;25;0.0102040816326531;0.489795918367347
Control.SRR15539829;41;45;0.634146341463415;15;26;0.134146341463415;0.365853658536585
Control.SRR15539829;41;45;0.439024390243902;23;18;0.0609756097560976;0.439024390243902
Control.SRR15539829;43;45;0.511627906976744;21;22;0.0116279069767442;0.488372093023256
Control.SRR15539829;45;45;0.466666666666667;24;21;0.0333333333333333;0.466666666666667
Control.SRR15539829;42;45;0.404761904761905;25;17;0.0952380952380952;0.404761904761905
Control.SRR15539829;41;45;0.390243902439024;25;16;0.109756097560976;0.390243902439024
Control.SRR15539829;43;45;0.488372093023256;22;21;0.0116279069767442;0.488372093023256
Control.SRR15539829;47;45;0.553191489361702;21;26;0.0531914893617021;0.446808510638298
Control.SRR15539829;41;45;0.48780487804878;21;20;0.0121951219512195;0.48780487804878
Control.SRR15539829;45;45;0.488888888888889;23;22;0.0111111111111111;0.488888888888889
Control.SRR15539829;48;45;0.5625;21;27;0.0625;0.4375
Control.SRR15539829;52;45;0.538461538461538;24;28;0.0384615384615384;0.461538461538462
Control.SRR15539829;47;45;0.425531914893617;27;20;0.074468085106383;0.425531914893617
Control.SRR15539829;43;45;0.511627906976744;21;22;0.0116279069767442;0.488372093023256
Control.SRR15539829;51;45;0.607843137254902;20;31;0.107843137254902;0.392156862745098
Control.SRR15539829;40;45;0.325;27;13;0.175;0.325
Control.SRR15539829;41;45;0.48780487804878;21;20;0.0121951219512195;0.48780487804878
Control.SRR15539829;41;45;0.585365853658537;17;24;0.0853658536585366;0.414634146341463
Control.SRR15539829;47;45;0.48936170212766;24;23;0.0106382978723404;0.48936170212766
Control.SRR15539829;49;45;0.530612244897959;23;26;0.0306122448979592;0.469387755102041
Control.SRR15539829;43;45;0.511627906976744;21;22;0.0116279069767442;0.488372093023256
Control.SRR15539829;41;45;0.439024390243902;23;18;0.0609756097560976;0.439024390243902
Control.SRR15539829;46;45;0.391304347826087;28;18;0.108695652173913;0.391304347826087
Control.SRR15539829;48;45;0.541666666666667;22;26;0.0416666666666666;0.458333333333333
Control.SRR15539829;45;45;0.555555555555556;20;25;0.0555555555555556;0.444444444444444
Control.SRR15539829;40;45;0.525;19;21;0.025;0.475
Control.SRR15539829;45;45;0.511111111111111;22;23;0.0111111111111111;0.488888888888889
Control.SRR15539829;47;45;0.595744680851064;19;28;0.0957446808510638;0.404255319148936
Control.SRR15539829;43;45;0.418604651162791;25;18;0.0813953488372093;0.418604651162791
Control.SRR15539829;46;45;0.478260869565217;24;22;0.0217391304347826;0.478260869565217
Control.SRR15539829;41;45;0.48780487804878;21;20;0.0121951219512195;0.48780487804878
Control.SRR15539829;45;45;0.466666666666667;24;21;0.0333333333333333;0.466666666666667
Control.SRR15539829;40;45;0.425;23;17;0.075;0.425
Control.SRR15539829;50;45;0.46;27;23;0.04;0.46
Control.SRR15539829;42;45;0.333333333333333;28;14;0.166666666666667;0.333333333333333
Control.SRR15539829;51;45;0.607843137254902;20;31;0.107843137254902;0.392156862745098
Control.SRR15539829;41;45;0.48780487804878;21;20;0.0121951219512195;0.48780487804878
Control.SRR15539829;44;45;0.522727272727273;21;23;0.0227272727272727;0.477272727272727
Control.SRR15539829;50;45;0.42;29;21;0.08;0.42
Control.SRR15539829;48;45;0.4375;27;21;0.0625;0.4375
Control.SRR15539829;51;45;0.450980392156863;28;23;0.0490196078431372;0.450980392156863
Control.SRR15539829;47;45;0.51063829787234;23;24;0.0106382978723404;0.48936170212766
Control.SRR15539829;43;45;0.441860465116279;24;19;0.0581395348837209;0.441860465116279
Control.SRR15539829;52;45;0.5;26;26;0;0.5
Control.SRR15539829;42;45;0.571428571428571;18;24;0.0714285714285714;0.428571428571429
Control.SRR15539829;46;45;0.478260869565217;24;22;0.0217391304347826;0.478260869565217
Control.SRR15539829;44;45;0.5;22;22;0;0.5
Control.SRR15539829;49;45;0.469387755102041;26;23;0.0306122448979592;0.469387755102041
Control.SRR15539829;42;45;0.547619047619048;19;23;0.0476190476190477;0.452380952380952
Control.SRR15539829;48;45;0.5;24;24;0;0.5
Control.SRR15539829;42;45;0.5;21;21;0;0.5
Control.SRR15539829;45;45;0.4;27;18;0.1;0.4
Control.SRR15539829;42;45;0.547619047619048;19;23;0.0476190476190477;0.452380952380952
Control.SRR15539829;44;45;0.477272727272727;23;21;0.0227272727272727;0.477272727272727
Control.SRR15539829;47;45;0.468085106382979;25;22;0.0319148936170213;0.468085106382979
Control.SRR15539829;42;45;0.547619047619048;19;23;0.0476190476190477;0.452380952380952
Control.SRR15539829;43;45;0.465116279069767;23;20;0.0348837209302326;0.465116279069767
Control.SRR15539829;40;45;0.425;23;17;0.075;0.425
Control.SRR15539829;40;45;0.475;21;19;0.025;0.475
Control.SRR15539829;44;45;0.545454545454545;20;24;0.0454545454545454;0.454545454545455
Control.SRR15539829;51;45;0.470588235294118;27;24;0.0294117647058824;0.470588235294118
Control.SRR15539829;51;45;0.529411764705882;24;27;0.0294117647058824;0.470588235294118
Control.SRR15539829;40;45;0.6;16;24;0.1;0.4
Control.SRR15539829;40;45;0.6;16;24;0.1;0.4
Control.SRR15539829;40;45;0.475;21;19;0.025;0.475
Control.SRR15539829;41;45;0.365853658536585;26;15;0.134146341463415;0.365853658536585
Control.SRR15539829;47;45;0.48936170212766;24;23;0.0106382978723404;0.48936170212766
Control.SRR15539829;41;45;0.560975609756098;18;23;0.0609756097560976;0.439024390243902
Control.SRR15539829;41;45;0.463414634146341;22;19;0.0365853658536585;0.463414634146341
Control.SRR15539829;41;45;0.658536585365854;14;27;0.158536585365854;0.341463414634146
Control.SRR15539829;44;45;0.5;22;22;0;0.5
Control.SRR15539829;42;45;0.404761904761905;25;17;0.0952380952380952;0.404761904761905
Control.SRR15539829;45;45;0.533333333333333;21;24;0.0333333333333333;0.466666666666667
Control.SRR15539829;42;45;0.5;21;21;0;0.5
Control.SRR15539829;43;45;0.418604651162791;25;18;0.0813953488372093;0.418604651162791
Control.SRR15539829;40;45;0.525;19;21;0.025;0.475
Control.SRR15539829;44;45;0.454545454545455;24;20;0.0454545454545455;0.454545454545455
Control.SRR15539829;48;45;0.541666666666667;22;26;0.0416666666666666;0.458333333333333
Control.SRR15539829;44;45;0.522727272727273;21;23;0.0227272727272727;0.477272727272727
Control.SRR15539829;41;45;0.658536585365854;14;27;0.158536585365854;0.341463414634146
Control.SRR15539829;48;45;0.479166666666667;25;23;0.0208333333333333;0.479166666666667
Control.SRR15539829;48;45;0.520833333333333;23;25;0.0208333333333334;0.479166666666667
Control.SRR15539829;46;45;0.630434782608696;17;29;0.130434782608696;0.369565217391304
Control.SRR15539829;42;45;0.428571428571429;24;18;0.0714285714285715;0.428571428571429
Control.SRR15539829;50;45;0.5;25;25;0;0.5
Control.SRR15539829;52;45;0.5;26;26;0;0.5
Control.SRR15539829;42;45;0.547619047619048;19;23;0.0476190476190477;0.452380952380952
Control.SRR15539829;43;45;0.558139534883721;19;24;0.0581395348837209;0.441860465116279
Control.SRR15539829;44;45;0.5;22;22;0;0.5
Control.SRR15539829;42;45;0.404761904761905;25;17;0.0952380952380952;0.404761904761905
Control.SRR15539829;41;45;0.390243902439024;25;16;0.109756097560976;0.390243902439024
Control.SRR15539829;43;45;0.395348837209302;26;17;0.104651162790698;0.395348837209302
Control.SRR15539829;42;45;0.5;21;21;0;0.5
Control.SRR15539829;48;45;0.4375;27;21;0.0625;0.4375
Control.SRR15539829;40;45;0.475;21;19;0.025;0.475
Control.SRR15539829;47;45;0.553191489361702;21;26;0.0531914893617021;0.446808510638298
Control.SRR15539829;45;45;0.511111111111111;22;23;0.0111111111111111;0.488888888888889
Control.SRR15539829;47;45;0.51063829787234;23;24;0.0106382978723404;0.48936170212766
Control.SRR15539829;51;45;0.568627450980392;22;29;0.0686274509803921;0.431372549019608
Control.SRR15539829;41;45;0.707317073170732;12;29;0.207317073170732;0.292682926829268
Control.SRR15539829;51;45;0.490196078431373;26;25;0.00980392156862747;0.490196078431373
Control.SRR15539829;45;45;0.511111111111111;22;23;0.0111111111111111;0.488888888888889
Control.SRR15539829;42;45;0.547619047619048;19;23;0.0476190476190477;0.452380952380952
Control.SRR15539829;48;45;0.375;30;18;0.125;0.375
Control.SRR15539829;43;45;0.627906976744186;16;27;0.127906976744186;0.372093023255814
Control.SRR15539829;44;45;0.431818181818182;25;19;0.0681818181818182;0.431818181818182
Control.SRR15539829;40;45;0.6;16;24;0.1;0.4
Control.SRR15539829;43;45;0.441860465116279;24;19;0.0581395348837209;0.441860465116279
Control.SRR15539829;45;45;0.6;18;27;0.1;0.4
Control.SRR15539829;51;45;0.568627450980392;22;29;0.0686274509803921;0.431372549019608
Control.SRR15539829;41;45;0.51219512195122;20;21;0.0121951219512195;0.48780487804878
Control.SRR15539829;45;45;0.488888888888889;23;22;0.0111111111111111;0.488888888888889
Control.SRR15539829;47;45;0.446808510638298;26;21;0.0531914893617021;0.446808510638298
Control.SRR15539829;43;45;0.465116279069767;23;20;0.0348837209302326;0.465116279069767
Control.SRR15539829;45;45;0.444444444444444;25;20;0.0555555555555556;0.444444444444444
Control.SRR15539829;41;45;0.560975609756098;18;23;0.0609756097560976;0.439024390243902
Control.SRR15539829;40;45;0.525;19;21;0.025;0.475
Control.SRR15539829;43;45;0.441860465116279;24;19;0.0581395348837209;0.441860465116279
Control.SRR15539829;45;45;0.488888888888889;23;22;0.0111111111111111;0.488888888888889
Control.SRR15539829;42;45;0.547619047619048;19;23;0.0476190476190477;0.452380952380952
Control.SRR15539829;40;45;0.55;18;22;0.05;0.45
Control.SRR15539829;40;45;0.575;17;23;0.075;0.425
Control.SRR15539829;45;45;0.333333333333333;30;15;0.166666666666667;0.333333333333333
Control.SRR15539829;42;45;0.547619047619048;19;23;0.0476190476190477;0.452380952380952
Control.SRR15539829;46;45;0.456521739130435;25;21;0.0434782608695652;0.456521739130435
Control.SRR15539829;49;45;0.448979591836735;27;22;0.0510204081632653;0.448979591836735
Control.SRR15539829;43;45;0.465116279069767;23;20;0.0348837209302326;0.465116279069767
Control.SRR15539829;40;45;0.625;15;25;0.125;0.375
Control.SRR15539829;44;45;0.545454545454545;20;24;0.0454545454545454;0.454545454545455
Control.SRR15539829;49;45;0.530612244897959;23;26;0.0306122448979592;0.469387755102041
Control.SRR15539829;52;45;0.5;26;26;0;0.5
Control.SRR15539829;52;45;0.423076923076923;30;22;0.0769230769230769;0.423076923076923
Control.SRR15539829;51;45;0.549019607843137;23;28;0.0490196078431373;0.450980392156863
Control.SRR15539829;44;45;0.431818181818182;25;19;0.0681818181818182;0.431818181818182
Control.SRR15539829;45;45;0.466666666666667;24;21;0.0333333333333333;0.466666666666667
Control.SRR15539829;49;45;0.489795918367347;25;24;0.0102040816326531;0.489795918367347
Control.SRR15539829;44;45;0.477272727272727;23;21;0.0227272727272727;0.477272727272727
Control.SRR15539829;46;45;0.304347826086957;32;14;0.195652173913043;0.304347826086957
Control.SRR15539829;42;45;0.619047619047619;16;26;0.119047619047619;0.380952380952381
Control.SRR15539829;47;45;0.404255319148936;28;19;0.0957446808510639;0.404255319148936
Control.SRR15539829;47;45;0.553191489361702;21;26;0.0531914893617021;0.446808510638298
Control.SRR15539829;42;45;0.595238095238095;17;25;0.0952380952380952;0.404761904761905
Control.SRR15539829;52;45;0.480769230769231;27;25;0.0192307692307692;0.480769230769231
Control.SRR15539829;43;45;0.534883720930233;20;23;0.0348837209302325;0.465116279069767
Control.SRR15539829;44;45;0.454545454545455;24;20;0.0454545454545455;0.454545454545455
Control.SRR15539829;47;45;0.468085106382979;25;22;0.0319148936170213;0.468085106382979
Control.SRR15539829;45;45;0.488888888888889;23;22;0.0111111111111111;0.488888888888889
Control.SRR15539829;45;45;0.444444444444444;25;20;0.0555555555555556;0.444444444444444
Control.SRR15539829;45;45;0.622222222222222;17;28;0.122222222222222;0.377777777777778
Control.SRR15539829;40;45;0.525;19;21;0.025;0.475
Control.SRR15539829;50;45;0.42;29;21;0.08;0.42
Control.SRR15539829;43;45;0.604651162790698;17;26;0.104651162790698;0.395348837209302
Control.SRR15539829;42;45;0.5;21;21;0;0.5
Control.SRR15539829;44;45;0.386363636363636;27;17;0.113636363636364;0.386363636363636
Control.SRR15539829;40;45;0.475;21;19;0.025;0.475
Control.SRR15539829;43;45;0.534883720930233;20;23;0.0348837209302325;0.465116279069767
Control.SRR15539829;50;45;0.42;29;21;0.08;0.42
Control.SRR15539829;40;45;0.425;23;17;0.075;0.425
Control.SRR15539829;42;45;0.571428571428571;18;24;0.0714285714285714;0.428571428571429
Control.SRR15539829;51;45;0.411764705882353;30;21;0.0882352941176471;0.411764705882353
Control.SRR15539829;45;45;0.4;27;18;0.1;0.4
Control.SRR15539829;40;45;0.5;20;20;0;0.5
Control.SRR15539829;41;45;0.658536585365854;14;27;0.158536585365854;0.341463414634146
Control.SRR15539829;44;45;0.522727272727273;21;23;0.0227272727272727;0.477272727272727
Control.SRR15539829;40;45;0.575;17;23;0.075;0.425
Control.SRR15539829;43;45;0.465116279069767;23;20;0.0348837209302326;0.465116279069767
Control.SRR15539829;45;45;0.577777777777778;19;26;0.0777777777777777;0.422222222222222
Control.SRR15539829;44;45;0.522727272727273;21;23;0.0227272727272727;0.477272727272727
Control.SRR15539829;42;45;0.547619047619048;19;23;0.0476190476190477;0.452380952380952
Control.SRR15539829;49;45;0.510204081632653;24;25;0.0102040816326531;0.489795918367347
Control.SRR15539829;41;45;0.463414634146341;22;19;0.0365853658536585;0.463414634146341
Control.SRR15539829;42;45;0.404761904761905;25;17;0.0952380952380952;0.404761904761905
Control.SRR15539829;49;45;0.489795918367347;25;24;0.0102040816326531;0.489795918367347
Control.SRR15539829;51;45;0.470588235294118;27;24;0.0294117647058824;0.470588235294118
Control.SRR15539829;49;45;0.387755102040816;30;19;0.112244897959184;0.387755102040816
Control.SRR15539829;42;45;0.619047619047619;16;26;0.119047619047619;0.380952380952381
Control.SRR15539829;41;45;0.463414634146341;22;19;0.0365853658536585;0.463414634146341
Control.SRR15539829;43;45;0.488372093023256;22;21;0.0116279069767442;0.488372093023256
Control.SRR15539829;42;45;0.571428571428571;18;24;0.0714285714285714;0.428571428571429
Control.SRR15539829;49;45;0.693877551020408;15;34;0.193877551020408;0.306122448979592
Control.SRR15539829;44;45;0.386363636363636;27;17;0.113636363636364;0.386363636363636
Control.SRR15539829;45;45;0.533333333333333;21;24;0.0333333333333333;0.466666666666667
Control.SRR15539829;43;45;0.418604651162791;25;18;0.0813953488372093;0.418604651162791
Control.SRR15539829;41;45;0.658536585365854;14;27;0.158536585365854;0.341463414634146
Control.SRR15539829;42;45;0.476190476190476;22;20;0.0238095238095238;0.476190476190476
Control.SRR15539829;47;45;0.468085106382979;25;22;0.0319148936170213;0.468085106382979
Control.SRR15539829;52;45;0.461538461538462;28;24;0.0384615384615384;0.461538461538462
Control.SRR15539829;40;45;0.6;16;24;0.1;0.4
Control.SRR15539829;49;45;0.510204081632653;24;25;0.0102040816326531;0.489795918367347
Control.SRR15539829;46;45;0.521739130434783;22;24;0.0217391304347826;0.478260869565217
Control.SRR15539829;46;45;0.5;23;23;0;0.5
Control.SRR15539829;49;45;0.428571428571429;28;21;0.0714285714285715;0.428571428571429
Control.SRR15539829;45;45;0.444444444444444;25;20;0.0555555555555556;0.444444444444444
Control.SRR15539829;51;45;0.450980392156863;28;23;0.0490196078431372;0.450980392156863
Control.SRR15539829;43;45;0.604651162790698;17;26;0.104651162790698;0.395348837209302
Control.SRR15539829;50;45;0.44;28;22;0.06;0.44
Control.SRR15539829;51;45;0.509803921568627;25;26;0.00980392156862742;0.490196078431373
Control.SRR15539829;49;45;0.612244897959184;19;30;0.112244897959184;0.387755102040816
Control.SRR15539829;46;45;0.369565217391304;29;17;0.130434782608696;0.369565217391304
Control.SRR15539829;48;45;0.583333333333333;20;28;0.0833333333333334;0.416666666666667
Control.SRR15539829;44;45;0.5;22;22;0;0.5
Control.SRR15539829;43;45;0.418604651162791;25;18;0.0813953488372093;0.418604651162791
Control.SRR15539829;40;45;0.5;20;20;0;0.5
Control.SRR15539829;49;45;0.551020408163265;22;27;0.0510204081632653;0.448979591836735
Control.SRR15539829;44;45;0.5;22;22;0;0.5
Control.SRR15539829;52;45;0.480769230769231;27;25;0.0192307692307692;0.480769230769231
Control.SRR15539829;48;45;0.645833333333333;17;31;0.145833333333333;0.354166666666667
Control.SRR15539829;49;45;0.448979591836735;27;22;0.0510204081632653;0.448979591836735
Control.SRR15539829;51;45;0.529411764705882;24;27;0.0294117647058824;0.470588235294118
Control.SRR15539829;48;45;0.395833333333333;29;19;0.104166666666667;0.395833333333333
Control.SRR15539829;45;45;0.466666666666667;24;21;0.0333333333333333;0.466666666666667
Control.SRR15539829;40;45;0.375;25;15;0.125;0.375
Control.SRR15539829;41;45;0.51219512195122;20;21;0.0121951219512195;0.48780487804878
Control.SRR15539829;48;45;0.416666666666667;28;20;0.0833333333333333;0.416666666666667
Control.SRR15539829;45;45;0.555555555555556;20;25;0.0555555555555556;0.444444444444444
Control.SRR15539829;42;45;0.571428571428571;18;24;0.0714285714285714;0.428571428571429
Control.SRR15539829;48;45;0.583333333333333;20;28;0.0833333333333334;0.416666666666667
Control.SRR15539829;52;45;0.557692307692308;23;29;0.0576923076923077;0.442307692307692
Control.SRR15539829;46;45;0.282608695652174;33;13;0.217391304347826;0.282608695652174
Control.SRR15539829;41;45;0.341463414634146;27;14;0.158536585365854;0.341463414634146
Control.SRR15539829;44;45;0.25;33;11;0.25;0.25
Control.SRR15539829;47;45;0.297872340425532;33;14;0.202127659574468;0.297872340425532
Control.SRR15539829;47;45;0.553191489361702;21;26;0.0531914893617021;0.446808510638298
Control.SRR15539829;41;45;0.365853658536585;26;15;0.134146341463415;0.365853658536585
Control.SRR15539829;50;45;0.5;25;25;0;0.5
Control.SRR15539829;48;45;0.479166666666667;25;23;0.0208333333333333;0.479166666666667
Control.SRR15539829;45;45;0.488888888888889;23;22;0.0111111111111111;0.488888888888889
Control.SRR15539829;40;45;0.5;20;20;0;0.5
Control.SRR15539829;40;45;0.55;18;22;0.05;0.45
Control.SRR15539829;41;45;0.317073170731707;28;13;0.182926829268293;0.317073170731707
Control.SRR15539829;40;45;0.475;21;19;0.025;0.475
Control.SRR15539829;49;45;0.469387755102041;26;23;0.0306122448979592;0.469387755102041
Control.SRR15539829;41;45;0.463414634146341;22;19;0.0365853658536585;0.463414634146341
Control.SRR15539829;50;45;0.54;23;27;0.04;0.46
Control.SRR15539829;51;45;0.470588235294118;27;24;0.0294117647058824;0.470588235294118
Control.SRR15539829;48;45;0.479166666666667;25;23;0.0208333333333333;0.479166666666667
Control.SRR15539829;50;45;0.46;27;23;0.04;0.46
Control.SRR15539829;48;45;0.520833333333333;23;25;0.0208333333333334;0.479166666666667
Control.SRR15539829;48;45;0.458333333333333;26;22;0.0416666666666667;0.458333333333333
Control.SRR15539829;44;45;0.477272727272727;23;21;0.0227272727272727;0.477272727272727
Control.SRR15539829;42;45;0.571428571428571;18;24;0.0714285714285714;0.428571428571429
Control.SRR15539829;45;45;0.444444444444444;25;20;0.0555555555555556;0.444444444444444
Control.SRR15539829;48;45;0.4375;27;21;0.0625;0.4375
Control.SRR15539829;45;45;0.6;18;27;0.1;0.4
Control.SRR15539829;42;45;0.523809523809524;20;22;0.0238095238095238;0.476190476190476
Control.SRR15539829;52;45;0.442307692307692;29;23;0.0576923076923077;0.442307692307692
Control.SRR15539829;43;45;0.511627906976744;21;22;0.0116279069767442;0.488372093023256
Control.SRR15539829;48;45;0.395833333333333;29;19;0.104166666666667;0.395833333333333
Control.SRR15539829;50;45;0.5;25;25;0;0.5
Control.SRR15539829;52;45;0.423076923076923;30;22;0.0769230769230769;0.423076923076923
Control.SRR15539829;52;45;0.403846153846154;31;21;0.0961538461538461;0.403846153846154
Control.SRR15539829;43;45;0.372093023255814;27;16;0.127906976744186;0.372093023255814
Control.SRR15539829;40;45;0.5;20;20;0;0.5
Control.SRR15539829;42;45;0.571428571428571;18;24;0.0714285714285714;0.428571428571429
Control.SRR15539829;40;45;0.425;23;17;0.075;0.425
Control.SRR15539829;45;45;0.488888888888889;23;22;0.0111111111111111;0.488888888888889
Control.SRR15539829;52;45;0.480769230769231;27;25;0.0192307692307692;0.480769230769231
Control.SRR15539829;49;45;0.530612244897959;23;26;0.0306122448979592;0.469387755102041
Control.SRR15539829;48;45;0.375;30;18;0.125;0.375
Control.SRR15539829;42;45;0.452380952380952;23;19;0.0476190476190476;0.452380952380952
Control.SRR15539829;47;45;0.404255319148936;28;19;0.0957446808510639;0.404255319148936
Control.SRR15539829;43;45;0.534883720930233;20;23;0.0348837209302325;0.465116279069767
Control.SRR15539829;45;45;0.622222222222222;17;28;0.122222222222222;0.377777777777778
Control.SRR15539829;51;45;0.470588235294118;27;24;0.0294117647058824;0.470588235294118
Control.SRR15539829;44;45;0.454545454545455;24;20;0.0454545454545455;0.454545454545455
Control.SRR15539829;40;45;0.475;21;19;0.025;0.475
Control.SRR15539829;45;45;0.466666666666667;24;21;0.0333333333333333;0.466666666666667
Control.SRR15539829;40;45;0.5;20;20;0;0.5
Control.SRR15539829;44;45;0.431818181818182;25;19;0.0681818181818182;0.431818181818182
Control.SRR15539829;48;45;0.5;24;24;0;0.5
Control.SRR15539829;50;45;0.6;20;30;0.1;0.4
Control.SRR15539829;49;45;0.63265306122449;18;31;0.13265306122449;0.36734693877551
Control.SRR15539829;49;45;0.428571428571429;28;21;0.0714285714285715;0.428571428571429
Control.SRR15539829;47;45;0.468085106382979;25;22;0.0319148936170213;0.468085106382979
Control.SRR15539829;43;45;0.511627906976744;21;22;0.0116279069767442;0.488372093023256
Control.SRR15539829;44;45;0.522727272727273;21;23;0.0227272727272727;0.477272727272727
Control.SRR15539829;44;45;0.386363636363636;27;17;0.113636363636364;0.386363636363636
Control.SRR15539829;42;45;0.30952380952381;29;13;0.19047619047619;0.30952380952381
Control.SRR15539829;40;45;0.55;18;22;0.05;0.45
Control.SRR15539829;42;45;0.523809523809524;20;22;0.0238095238095238;0.476190476190476
Control.SRR15539829;50;45;0.48;26;24;0.02;0.48
Control.SRR15539829;44;45;0.454545454545455;24;20;0.0454545454545455;0.454545454545455
Control.SRR15539829;40;45;0.55;18;22;0.05;0.45
Control.SRR15539829;45;45;0.466666666666667;24;21;0.0333333333333333;0.466666666666667
Control.SRR15539829;47;45;0.340425531914894;31;16;0.159574468085106;0.340425531914894
Control.SRR15539829;41;45;0.51219512195122;20;21;0.0121951219512195;0.48780487804878
Control.SRR15539829;47;45;0.382978723404255;29;18;0.117021276595745;0.382978723404255
Control.SRR15539829;45;45;0.6;18;27;0.1;0.4
Control.SRR15539829;50;45;0.48;26;24;0.02;0.48
Control.SRR15539829;49;45;0.530612244897959;23;26;0.0306122448979592;0.469387755102041
Control.SRR15539829;46;45;0.478260869565217;24;22;0.0217391304347826;0.478260869565217
Control.SRR15539829;50;45;0.54;23;27;0.04;0.46
Control.SRR15539829;45;45;0.577777777777778;19;26;0.0777777777777777;0.422222222222222
Control.SRR15539829;42;45;0.476190476190476;22;20;0.0238095238095238;0.476190476190476
Control.SRR15539829;51;45;0.588235294117647;21;30;0.0882352941176471;0.411764705882353
Control.SRR15539829;42;45;0.619047619047619;16;26;0.119047619047619;0.380952380952381
Control.SRR15539829;42;45;0.523809523809524;20;22;0.0238095238095238;0.476190476190476
Control.SRR15539829;40;45;0.55;18;22;0.05;0.45
Control.SRR15539829;40;45;0.425;23;17;0.075;0.425
Control.SRR15539829;43;45;0.534883720930233;20;23;0.0348837209302325;0.465116279069767
Control.SRR15539829;52;45;0.615384615384615;20;32;0.115384615384615;0.384615384615385
Control.SRR15539829;51;45;0.470588235294118;27;24;0.0294117647058824;0.470588235294118
Control.SRR15539829;47;45;0.51063829787234;23;24;0.0106382978723404;0.48936170212766
Control.SRR15539829;46;45;0.521739130434783;22;24;0.0217391304347826;0.478260869565217
Control.SRR15539829;50;45;0.54;23;27;0.04;0.46
Control.SRR15539829;41;45;0.439024390243902;23;18;0.0609756097560976;0.439024390243902
Control.SRR15539829;49;45;0.551020408163265;22;27;0.0510204081632653;0.448979591836735
Control.SRR15539829;41;45;0.341463414634146;27;14;0.158536585365854;0.341463414634146
Control.SRR15539829;40;45;0.6;16;24;0.1;0.4
Control.SRR15539829;46;45;0.434782608695652;26;20;0.0652173913043478;0.434782608695652
Control.SRR15539829;49;45;0.408163265306122;29;20;0.0918367346938775;0.408163265306122
Control.SRR15539829;41;45;0.463414634146341;22;19;0.0365853658536585;0.463414634146341
Control.SRR15539829;41;45;0.585365853658537;17;24;0.0853658536585366;0.414634146341463
Control.SRR15539829;47;45;0.553191489361702;21;26;0.0531914893617021;0.446808510638298
Control.SRR15539829;43;45;0.441860465116279;24;19;0.0581395348837209;0.441860465116279
Control.SRR15539829;49;45;0.408163265306122;29;20;0.0918367346938775;0.408163265306122
Control.SRR15539829;48;45;0.541666666666667;22;26;0.0416666666666666;0.458333333333333
Control.SRR15539829;45;45;0.577777777777778;19;26;0.0777777777777777;0.422222222222222
Control.SRR15539829;49;45;0.571428571428571;21;28;0.0714285714285714;0.428571428571429
Control.SRR15539829;48;45;0.5;24;24;0;0.5
Control.SRR15539829;47;45;0.446808510638298;26;21;0.0531914893617021;0.446808510638298
Control.SRR15539829;43;45;0.558139534883721;19;24;0.0581395348837209;0.441860465116279
Control.SRR15539829;41;45;0.463414634146341;22;19;0.0365853658536585;0.463414634146341
Control.SRR15539829;49;45;0.469387755102041;26;23;0.0306122448979592;0.469387755102041
Control.SRR15539829;40;45;0.475;21;19;0.025;0.475
Control.SRR15539829;50;45;0.5;25;25;0;0.5
Control.SRR15539829;46;45;0.5;23;23;0;0.5
Control.SRR15539829;52;45;0.519230769230769;25;27;0.0192307692307693;0.480769230769231
Control.SRR15539829;42;45;0.476190476190476;22;20;0.0238095238095238;0.476190476190476
Control.SRR15539829;43;45;0.465116279069767;23;20;0.0348837209302326;0.465116279069767
Control.SRR15539829;50;45;0.54;23;27;0.04;0.46
Control.SRR15539829;42;45;0.452380952380952;23;19;0.0476190476190476;0.452380952380952
Control.SRR15539829;45;45;0.444444444444444;25;20;0.0555555555555556;0.444444444444444
Control.SRR15539829;52;45;0.461538461538462;28;24;0.0384615384615384;0.461538461538462
Control.SRR15539829;50;45;0.6;20;30;0.1;0.4
Control.SRR15539829;46;45;0.434782608695652;26;20;0.0652173913043478;0.434782608695652
Control.SRR15539829;50;45;0.52;24;26;0.02;0.48
Control.SRR15539829;41;45;0.414634146341463;24;17;0.0853658536585366;0.414634146341463
Control.SRR15539829;52;45;0.596153846153846;21;31;0.0961538461538461;0.403846153846154
Control.SRR15539829;52;45;0.423076923076923;30;22;0.0769230769230769;0.423076923076923
Control.SRR15539829;45;45;0.6;18;27;0.1;0.4
Control.SRR15539829;48;45;0.458333333333333;26;22;0.0416666666666667;0.458333333333333
Control.SRR15539829;50;45;0.44;28;22;0.06;0.44
Control.SRR15539829;51;45;0.568627450980392;22;29;0.0686274509803921;0.431372549019608
Control.SRR15539829;44;45;0.431818181818182;25;19;0.0681818181818182;0.431818181818182
Control.SRR15539829;47;45;0.574468085106383;20;27;0.074468085106383;0.425531914893617
Control.SRR15539829;46;45;0.391304347826087;28;18;0.108695652173913;0.391304347826087
Control.SRR15539829;51;45;0.411764705882353;30;21;0.0882352941176471;0.411764705882353
Control.SRR15539829;40;45;0.55;18;22;0.05;0.45
Control.SRR15539829;47;45;0.382978723404255;29;18;0.117021276595745;0.382978723404255
Control.SRR15539829;41;45;0.439024390243902;23;18;0.0609756097560976;0.439024390243902
Control.SRR15539829;43;45;0.581395348837209;18;25;0.0813953488372093;0.418604651162791
Control.SRR15539829;44;45;0.5;22;22;0;0.5
Control.SRR15539829;51;45;0.509803921568627;25;26;0.00980392156862742;0.490196078431373
Control.SRR15539829;41;45;0.536585365853659;19;22;0.0365853658536586;0.463414634146341
Control.SRR15539829;42;45;0.476190476190476;22;20;0.0238095238095238;0.476190476190476
Control.SRR15539829;47;45;0.382978723404255;29;18;0.117021276595745;0.382978723404255
Control.SRR15539829;49;45;0.469387755102041;26;23;0.0306122448979592;0.469387755102041
Control.SRR15539829;47;45;0.531914893617021;22;25;0.0319148936170213;0.468085106382979
Control.SRR15539829;42;45;0.547619047619048;19;23;0.0476190476190477;0.452380952380952
Control.SRR15539829;50;45;0.52;24;26;0.02;0.48
Control.SRR15539829;41;45;0.560975609756098;18;23;0.0609756097560976;0.439024390243902
Control.SRR15539829;51;45;0.529411764705882;24;27;0.0294117647058824;0.470588235294118
Control.SRR15539829;47;45;0.617021276595745;18;29;0.117021276595745;0.382978723404255
Control.SRR15539829;40;45;0.475;21;19;0.025;0.475
Control.SRR15539829;45;45;0.622222222222222;17;28;0.122222222222222;0.377777777777778
Control.SRR15539829;50;45;0.42;29;21;0.08;0.42
Control.SRR15539829;40;45;0.5;20;20;0;0.5
Control.SRR15539829;46;45;0.5;23;23;0;0.5
Control.SRR15539829;43;45;0.511627906976744;21;22;0.0116279069767442;0.488372093023256
Control.SRR15539829;51;45;0.431372549019608;29;22;0.0686274509803921;0.431372549019608
Control.SRR15539829;46;45;0.543478260869565;21;25;0.0434782608695652;0.456521739130435
Control.SRR15539829;44;45;0.431818181818182;25;19;0.0681818181818182;0.431818181818182
Control.SRR15539829;46;45;0.391304347826087;28;18;0.108695652173913;0.391304347826087
Control.SRR15539829;45;45;0.488888888888889;23;22;0.0111111111111111;0.488888888888889
Control.SRR15539829;51;45;0.549019607843137;23;28;0.0490196078431373;0.450980392156863
Control.SRR15539829;40;45;0.475;21;19;0.025;0.475
Control.SRR15539829;51;45;0.450980392156863;28;23;0.0490196078431372;0.450980392156863
Control.SRR15539829;45;45;0.422222222222222;26;19;0.0777777777777778;0.422222222222222
Control.SRR15539829;45;45;0.444444444444444;25;20;0.0555555555555556;0.444444444444444
Control.SRR15539829;46;45;0.5;23;23;0;0.5
Control.SRR15539829;49;45;0.510204081632653;24;25;0.0102040816326531;0.489795918367347
Control.SRR15539829;42;45;0.523809523809524;20;22;0.0238095238095238;0.476190476190476
Control.SRR15539829;51;45;0.431372549019608;29;22;0.0686274509803921;0.431372549019608
Control.SRR15539829;45;45;0.533333333333333;21;24;0.0333333333333333;0.466666666666667
Control.SRR15539829;50;45;0.56;22;28;0.0600000000000001;0.44
Control.SRR15539829;45;45;0.4;27;18;0.1;0.4
Control.SRR15539829;50;45;0.38;31;19;0.12;0.38
Control.SRR15539829;47;45;0.574468085106383;20;27;0.074468085106383;0.425531914893617
Control.SRR15539829;44;45;0.522727272727273;21;23;0.0227272727272727;0.477272727272727
Control.SRR15539829;50;45;0.52;24;26;0.02;0.48
Control.SRR15539829;52;45;0.557692307692308;23;29;0.0576923076923077;0.442307692307692
Control.SRR15539829;40;45;0.35;26;14;0.15;0.35
Control.SRR15539829;42;45;0.428571428571429;24;18;0.0714285714285715;0.428571428571429
Control.SRR15539829;46;45;0.456521739130435;25;21;0.0434782608695652;0.456521739130435
Control.SRR15539829;50;45;0.44;28;22;0.06;0.44
Control.SRR15539829;44;45;0.477272727272727;23;21;0.0227272727272727;0.477272727272727
Control.SRR15539829;44;45;0.477272727272727;23;21;0.0227272727272727;0.477272727272727
Control.SRR15539829;48;45;0.604166666666667;19;29;0.104166666666667;0.395833333333333
Control.SRR15539829;48;45;0.354166666666667;31;17;0.145833333333333;0.354166666666667
Control.SRR15539829;48;45;0.520833333333333;23;25;0.0208333333333334;0.479166666666667
Control.SRR15539829;48;45;0.479166666666667;25;23;0.0208333333333333;0.479166666666667
Control.SRR15539829;47;45;0.446808510638298;26;21;0.0531914893617021;0.446808510638298
Control.SRR15539829;51;45;0.450980392156863;28;23;0.0490196078431372;0.450980392156863
Control.SRR15539829;45;45;0.555555555555556;20;25;0.0555555555555556;0.444444444444444
Control.SRR15539829;52;45;0.596153846153846;21;31;0.0961538461538461;0.403846153846154
Control.SRR15539829;52;45;0.461538461538462;28;24;0.0384615384615384;0.461538461538462
Control.SRR15539829;44;45;0.477272727272727;23;21;0.0227272727272727;0.477272727272727
Control.SRR15539829;50;45;0.54;23;27;0.04;0.46
Control.SRR15539829;49;45;0.571428571428571;21;28;0.0714285714285714;0.428571428571429
Control.SRR15539829;42;45;0.476190476190476;22;20;0.0238095238095238;0.476190476190476
Control.SRR15539829;49;45;0.551020408163265;22;27;0.0510204081632653;0.448979591836735
Control.SRR15539829;41;45;0.463414634146341;22;19;0.0365853658536585;0.463414634146341
Control.SRR15539829;42;45;0.523809523809524;20;22;0.0238095238095238;0.476190476190476
Control.SRR15539829;50;45;0.5;25;25;0;0.5
Control.SRR15539829;47;45;0.595744680851064;19;28;0.0957446808510638;0.404255319148936
Control.SRR15539829;51;45;0.490196078431373;26;25;0.00980392156862747;0.490196078431373
Control.SRR15539829;51;45;0.411764705882353;30;21;0.0882352941176471;0.411764705882353
Control.SRR15539829;47;45;0.553191489361702;21;26;0.0531914893617021;0.446808510638298
Control.SRR15539829;43;45;0.441860465116279;24;19;0.0581395348837209;0.441860465116279
Control.SRR15539829;49;45;0.448979591836735;27;22;0.0510204081632653;0.448979591836735
Control.SRR15539829;52;45;0.538461538461538;24;28;0.0384615384615384;0.461538461538462
Control.SRR15539829;46;45;0.456521739130435;25;21;0.0434782608695652;0.456521739130435
Control.SRR15539829;43;45;0.534883720930233;20;23;0.0348837209302325;0.465116279069767
Control.SRR15539829;42;45;0.452380952380952;23;19;0.0476190476190476;0.452380952380952
Control.SRR15539829;48;45;0.458333333333333;26;22;0.0416666666666667;0.458333333333333
Control.SRR15539829;41;45;0.536585365853659;19;22;0.0365853658536586;0.463414634146341
Control.SRR15539829;41;45;0.414634146341463;24;17;0.0853658536585366;0.414634146341463
Control.SRR15539829;40;45;0.475;21;19;0.025;0.475
Control.SRR15539829;45;45;0.555555555555556;20;25;0.0555555555555556;0.444444444444444
Control.SRR15539829;52;45;0.461538461538462;28;24;0.0384615384615384;0.461538461538462
Control.SRR15539829;42;45;0.523809523809524;20;22;0.0238095238095238;0.476190476190476
Control.SRR15539829;45;45;0.466666666666667;24;21;0.0333333333333333;0.466666666666667
Control.SRR15539829;50;45;0.56;22;28;0.0600000000000001;0.44
Control.SRR15539829;43;45;0.348837209302326;28;15;0.151162790697674;0.348837209302326
Control.SRR15539829;49;45;0.530612244897959;23;26;0.0306122448979592;0.469387755102041
Control.SRR15539829;49;45;0.510204081632653;24;25;0.0102040816326531;0.489795918367347
Control.SRR15539829;42;45;0.5;21;21;0;0.5
Control.SRR15539829;44;45;0.5;22;22;0;0.5
Control.SRR15539829;45;45;0.488888888888889;23;22;0.0111111111111111;0.488888888888889
Control.SRR15539829;47;45;0.51063829787234;23;24;0.0106382978723404;0.48936170212766
Control.SRR15539829;46;45;0.543478260869565;21;25;0.0434782608695652;0.456521739130435
Control.SRR15539829;51;45;0.450980392156863;28;23;0.0490196078431372;0.450980392156863
Control.SRR15539829;40;45;0.425;23;17;0.075;0.425
Control.SRR15539829;46;45;0.434782608695652;26;20;0.0652173913043478;0.434782608695652
Control.SRR15539829;43;45;0.441860465116279;24;19;0.0581395348837209;0.441860465116279
Control.SRR15539829;52;45;0.480769230769231;27;25;0.0192307692307692;0.480769230769231
Control.SRR15539829;52;45;0.480769230769231;27;25;0.0192307692307692;0.480769230769231
Control.SRR15539829;50;45;0.58;21;29;0.08;0.42
Control.SRR15539829;51;45;0.411764705882353;30;21;0.0882352941176471;0.411764705882353
Control.SRR15539829;45;45;0.422222222222222;26;19;0.0777777777777778;0.422222222222222
Control.SRR15539829;45;45;0.622222222222222;17;28;0.122222222222222;0.377777777777778
Control.SRR15539829;45;45;0.533333333333333;21;24;0.0333333333333333;0.466666666666667
Control.SRR15539829;43;45;0.511627906976744;21;22;0.0116279069767442;0.488372093023256
Control.SRR15539829;51;45;0.450980392156863;28;23;0.0490196078431372;0.450980392156863
Control.SRR15539829;46;45;0.369565217391304;29;17;0.130434782608696;0.369565217391304
Control.SRR15539829;44;45;0.545454545454545;20;24;0.0454545454545454;0.454545454545455
Control.SRR15539829;40;45;0.575;17;23;0.075;0.425
Control.SRR15539829;47;45;0.48936170212766;24;23;0.0106382978723404;0.48936170212766
Control.SRR15539829;42;45;0.595238095238095;17;25;0.0952380952380952;0.404761904761905
Control.SRR15539829;41;45;0.439024390243902;23;18;0.0609756097560976;0.439024390243902
Control.SRR15539829;43;45;0.372093023255814;27;16;0.127906976744186;0.372093023255814
Control.SRR15539829;47;45;0.382978723404255;29;18;0.117021276595745;0.382978723404255
Control.SRR15539829;43;45;0.441860465116279;24;19;0.0581395348837209;0.441860465116279
Control.SRR15539829;43;45;0.441860465116279;24;19;0.0581395348837209;0.441860465116279
Control.SRR15539829;47;45;0.553191489361702;21;26;0.0531914893617021;0.446808510638298
Control.SRR15539829;45;45;0.533333333333333;21;24;0.0333333333333333;0.466666666666667
Control.SRR15539829;50;45;0.44;28;22;0.06;0.44
Control.SRR15539829;44;45;0.5;22;22;0;0.5
Control.SRR15539829;49;45;0.551020408163265;22;27;0.0510204081632653;0.448979591836735
Control.SRR15539829;45;45;0.444444444444444;25;20;0.0555555555555556;0.444444444444444
Control.SRR15539829;46;45;0.58695652173913;19;27;0.0869565217391305;0.41304347826087
Control.SRR15539829;50;45;0.56;22;28;0.0600000000000001;0.44
Control.SRR15539829;49;45;0.469387755102041;26;23;0.0306122448979592;0.469387755102041
Control.SRR15539829;51;45;0.450980392156863;28;23;0.0490196078431372;0.450980392156863
Control.SRR15539829;49;45;0.387755102040816;30;19;0.112244897959184;0.387755102040816
Control.SRR15539829;50;45;0.56;22;28;0.0600000000000001;0.44
Control.SRR15539829;50;45;0.52;24;26;0.02;0.48
Control.SRR15539829;46;45;0.41304347826087;27;19;0.0869565217391304;0.41304347826087
Control.SRR15539829;42;45;0.571428571428571;18;24;0.0714285714285714;0.428571428571429
Control.SRR15539829;42;45;0.523809523809524;20;22;0.0238095238095238;0.476190476190476
Control.SRR15539829;47;45;0.51063829787234;23;24;0.0106382978723404;0.48936170212766
Control.SRR15539829;44;45;0.477272727272727;23;21;0.0227272727272727;0.477272727272727
Control.SRR15539829;42;45;0.523809523809524;20;22;0.0238095238095238;0.476190476190476
Control.SRR15539829;46;45;0.304347826086957;32;14;0.195652173913043;0.304347826086957
Control.SRR15539829;45;45;0.488888888888889;23;22;0.0111111111111111;0.488888888888889
Control.SRR15539829;47;45;0.382978723404255;29;18;0.117021276595745;0.382978723404255
Control.SRR15539829;51;45;0.352941176470588;33;18;0.147058823529412;0.352941176470588
Control.SRR15539829;43;45;0.604651162790698;17;26;0.104651162790698;0.395348837209302
Control.SRR15539829;49;45;0.448979591836735;27;22;0.0510204081632653;0.448979591836735
Control.SRR15539829;45;45;0.488888888888889;23;22;0.0111111111111111;0.488888888888889
Control.SRR15539829;49;45;0.387755102040816;30;19;0.112244897959184;0.387755102040816
Control.SRR15539829;52;45;0.538461538461538;24;28;0.0384615384615384;0.461538461538462
Control.SRR15539829;43;45;0.465116279069767;23;20;0.0348837209302326;0.465116279069767
Control.SRR15539829;48;45;0.520833333333333;23;25;0.0208333333333334;0.479166666666667
Control.SRR15539829;45;45;0.466666666666667;24;21;0.0333333333333333;0.466666666666667
Control.SRR15539829;49;45;0.612244897959184;19;30;0.112244897959184;0.387755102040816
Control.SRR15539829;45;45;0.422222222222222;26;19;0.0777777777777778;0.422222222222222
Control.SRR15539829;41;45;0.609756097560976;16;25;0.109756097560976;0.390243902439024
Control.SRR15539829;40;45;0.45;22;18;0.05;0.45
Control.SRR15539829;45;45;0.466666666666667;24;21;0.0333333333333333;0.466666666666667
Control.SRR15539829;43;45;0.581395348837209;18;25;0.0813953488372093;0.418604651162791
Control.SRR15539829;47;45;0.531914893617021;22;25;0.0319148936170213;0.468085106382979
Control.SRR15539829;48;45;0.520833333333333;23;25;0.0208333333333334;0.479166666666667
Control.SRR15539829;41;45;0.48780487804878;21;20;0.0121951219512195;0.48780487804878
Control.SRR15539829;51;45;0.411764705882353;30;21;0.0882352941176471;0.411764705882353
Control.SRR15539829;48;45;0.458333333333333;26;22;0.0416666666666667;0.458333333333333
Control.SRR15539829;41;45;0.48780487804878;21;20;0.0121951219512195;0.48780487804878
Control.SRR15539829;44;45;0.454545454545455;24;20;0.0454545454545455;0.454545454545455
Control.SRR15539829;46;45;0.565217391304348;20;26;0.0652173913043478;0.434782608695652
Control.SRR15539829;47;45;0.468085106382979;25;22;0.0319148936170213;0.468085106382979
Control.SRR15539829;48;45;0.479166666666667;25;23;0.0208333333333333;0.479166666666667
Control.SRR15539829;44;45;0.5;22;22;0;0.5
Control.SRR15539829;49;45;0.489795918367347;25;24;0.0102040816326531;0.489795918367347
Control.SRR15539829;48;45;0.458333333333333;26;22;0.0416666666666667;0.458333333333333
Control.SRR15539829;40;45;0.5;20;20;0;0.5
Control.SRR15539829;45;45;0.466666666666667;24;21;0.0333333333333333;0.466666666666667
Control.SRR15539829;48;45;0.479166666666667;25;23;0.0208333333333333;0.479166666666667
Control.SRR15539829;46;45;0.478260869565217;24;22;0.0217391304347826;0.478260869565217
Control.SRR15539829;44;45;0.613636363636364;17;27;0.113636363636364;0.386363636363636
Control.SRR15539829;41;45;0.634146341463415;15;26;0.134146341463415;0.365853658536585
Control.SRR15539829;50;45;0.52;24;26;0.02;0.48
Control.SRR15539829;42;45;0.523809523809524;20;22;0.0238095238095238;0.476190476190476
Control.SRR15539829;42;45;0.428571428571429;24;18;0.0714285714285715;0.428571428571429
Control.SRR15539829;44;45;0.522727272727273;21;23;0.0227272727272727;0.477272727272727
Control.SRR15539829;41;45;0.536585365853659;19;22;0.0365853658536586;0.463414634146341
Control.SRR15539829;47;45;0.48936170212766;24;23;0.0106382978723404;0.48936170212766
Control.SRR15539829;46;45;0.456521739130435;25;21;0.0434782608695652;0.456521739130435
Control.SRR15539829;48;45;0.479166666666667;25;23;0.0208333333333333;0.479166666666667
Control.SRR15539829;41;45;0.48780487804878;21;20;0.0121951219512195;0.48780487804878
Control.SRR15539829;50;45;0.5;25;25;0;0.5
Control.SRR15539829;49;45;0.530612244897959;23;26;0.0306122448979592;0.469387755102041
Control.SRR15539829;42;45;0.5;21;21;0;0.5
Control.SRR15539829;49;45;0.448979591836735;27;22;0.0510204081632653;0.448979591836735
Control.SRR15539829;52;45;0.557692307692308;23;29;0.0576923076923077;0.442307692307692
Control.SRR15539829;42;45;0.476190476190476;22;20;0.0238095238095238;0.476190476190476
Control.SRR15539829;43;45;0.627906976744186;16;27;0.127906976744186;0.372093023255814
Control.SRR15539829;42;45;0.666666666666667;14;28;0.166666666666667;0.333333333333333
Control.SRR15539829;45;45;0.6;18;27;0.1;0.4
Control.SRR15539829;50;45;0.5;25;25;0;0.5
Control.SRR15539829;42;45;0.619047619047619;16;26;0.119047619047619;0.380952380952381
Control.SRR15539829;50;45;0.56;22;28;0.0600000000000001;0.44
Control.SRR15539829;41;45;0.658536585365854;14;27;0.158536585365854;0.341463414634146
Control.SRR15539829;45;45;0.444444444444444;25;20;0.0555555555555556;0.444444444444444
Control.SRR15539829;47;45;0.51063829787234;23;24;0.0106382978723404;0.48936170212766
Control.SRR15539829;49;45;0.387755102040816;30;19;0.112244897959184;0.387755102040816
Control.SRR15539829;45;45;0.488888888888889;23;22;0.0111111111111111;0.488888888888889
Control.SRR15539829;49;45;0.408163265306122;29;20;0.0918367346938775;0.408163265306122
Control.SRR15539829;42;45;0.547619047619048;19;23;0.0476190476190477;0.452380952380952
Control.SRR15539829;44;45;0.431818181818182;25;19;0.0681818181818182;0.431818181818182
Control.SRR15539829;46;45;0.5;23;23;0;0.5
Control.SRR15539829;46;45;0.478260869565217;24;22;0.0217391304347826;0.478260869565217
Control.SRR15539829;51;45;0.588235294117647;21;30;0.0882352941176471;0.411764705882353
Control.SRR15539829;43;45;0.465116279069767;23;20;0.0348837209302326;0.465116279069767
Control.SRR15539829;45;45;0.466666666666667;24;21;0.0333333333333333;0.466666666666667
Control.SRR15539829;44;45;0.477272727272727;23;21;0.0227272727272727;0.477272727272727
Control.SRR15539829;51;45;0.450980392156863;28;23;0.0490196078431372;0.450980392156863
Control.SRR15539829;47;45;0.531914893617021;22;25;0.0319148936170213;0.468085106382979
Control.SRR15539829;44;45;0.545454545454545;20;24;0.0454545454545454;0.454545454545455
Control.SRR15539829;44;45;0.340909090909091;29;15;0.159090909090909;0.340909090909091
Control.SRR15539829;49;45;0.489795918367347;25;24;0.0102040816326531;0.489795918367347
Control.SRR15539829;50;45;0.52;24;26;0.02;0.48
Control.SRR15539829;45;45;0.533333333333333;21;24;0.0333333333333333;0.466666666666667
Control.SRR15539829;50;45;0.4;30;20;0.1;0.4
Control.SRR15539829;51;45;0.431372549019608;29;22;0.0686274509803921;0.431372549019608
Control.SRR15539829;49;45;0.428571428571429;28;21;0.0714285714285715;0.428571428571429
Control.SRR15539829;47;45;0.446808510638298;26;21;0.0531914893617021;0.446808510638298
Control.SRR15539829;43;45;0.27906976744186;31;12;0.22093023255814;0.27906976744186
Control.SRR15539829;41;45;0.560975609756098;18;23;0.0609756097560976;0.439024390243902
Control.SRR15539829;41;45;0.51219512195122;20;21;0.0121951219512195;0.48780487804878
Control.SRR15539829;48;45;0.541666666666667;22;26;0.0416666666666666;0.458333333333333
Control.SRR15539829;46;45;0.434782608695652;26;20;0.0652173913043478;0.434782608695652
Control.SRR15539829;50;45;0.42;29;21;0.08;0.42
Control.SRR15539829;52;45;0.423076923076923;30;22;0.0769230769230769;0.423076923076923
Control.SRR15539829;52;45;0.346153846153846;34;18;0.153846153846154;0.346153846153846
Control.SRR15539829;49;45;0.63265306122449;18;31;0.13265306122449;0.36734693877551
Control.SRR15539829;52;45;0.480769230769231;27;25;0.0192307692307692;0.480769230769231
Control.SRR15539829;42;45;0.428571428571429;24;18;0.0714285714285715;0.428571428571429
Control.SRR15539829;51;45;0.607843137254902;20;31;0.107843137254902;0.392156862745098
Control.SRR15539829;51;45;0.490196078431373;26;25;0.00980392156862747;0.490196078431373
Control.SRR15539829;48;45;0.354166666666667;31;17;0.145833333333333;0.354166666666667
Control.SRR15539829;43;45;0.581395348837209;18;25;0.0813953488372093;0.418604651162791
Control.SRR15539829;50;45;0.46;27;23;0.04;0.46
Control.SRR15539829;49;45;0.346938775510204;32;17;0.153061224489796;0.346938775510204
Control.SRR15539829;51;45;0.627450980392157;19;32;0.127450980392157;0.372549019607843
Control.SRR15539829;48;45;0.541666666666667;22;26;0.0416666666666666;0.458333333333333
Control.SRR15539829;51;45;0.470588235294118;27;24;0.0294117647058824;0.470588235294118
Control.SRR15539829;48;45;0.520833333333333;23;25;0.0208333333333334;0.479166666666667
Control.SRR15539829;42;45;0.404761904761905;25;17;0.0952380952380952;0.404761904761905
Control.SRR15539829;51;45;0.686274509803922;16;35;0.186274509803922;0.313725490196078
Control.SRR15539829;44;45;0.5;22;22;0;0.5
Control.SRR15539829;52;45;0.403846153846154;31;21;0.0961538461538461;0.403846153846154
Control.SRR15539829;49;45;0.591836734693878;20;29;0.0918367346938775;0.408163265306122
Control.SRR15539829;52;45;0.326923076923077;35;17;0.173076923076923;0.326923076923077
Control.SRR15539829;48;45;0.541666666666667;22;26;0.0416666666666666;0.458333333333333
Control.SRR15539829;50;45;0.44;28;22;0.06;0.44
Control.SRR15539829;45;45;0.555555555555556;20;25;0.0555555555555556;0.444444444444444
Control.SRR15539829;45;45;0.533333333333333;21;24;0.0333333333333333;0.466666666666667
Control.SRR15539829;51;45;0.509803921568627;25;26;0.00980392156862742;0.490196078431373
Control.SRR15539829;47;45;0.531914893617021;22;25;0.0319148936170213;0.468085106382979
Control.SRR15539829;50;45;0.46;27;23;0.04;0.46
Control.SRR15539829;46;45;0.478260869565217;24;22;0.0217391304347826;0.478260869565217
Control.SRR15539829;44;45;0.477272727272727;23;21;0.0227272727272727;0.477272727272727
Control.SRR15539829;48;45;0.479166666666667;25;23;0.0208333333333333;0.479166666666667
Control.SRR15539829;45;45;0.422222222222222;26;19;0.0777777777777778;0.422222222222222
Control.SRR15539829;49;45;0.408163265306122;29;20;0.0918367346938775;0.408163265306122
Control.SRR15539829;45;45;0.4;27;18;0.1;0.4
Control.SRR15539829;47;45;0.404255319148936;28;19;0.0957446808510639;0.404255319148936
Control.SRR15539829;48;45;0.416666666666667;28;20;0.0833333333333333;0.416666666666667
Control.SRR15539829;44;45;0.568181818181818;19;25;0.0681818181818182;0.431818181818182
Control.SRR15539829;48;45;0.604166666666667;19;29;0.104166666666667;0.395833333333333
Control.SRR15539829;48;45;0.6875;15;33;0.1875;0.3125
Control.SRR15539829;45;45;0.488888888888889;23;22;0.0111111111111111;0.488888888888889
Control.SRR15539829;42;45;0.571428571428571;18;24;0.0714285714285714;0.428571428571429
Control.SRR15539829;41;45;0.414634146341463;24;17;0.0853658536585366;0.414634146341463
Control.SRR15539829;41;45;0.48780487804878;21;20;0.0121951219512195;0.48780487804878
Control.SRR15539829;50;45;0.58;21;29;0.08;0.42
Control.SRR15539829;50;45;0.48;26;24;0.02;0.48
Control.SRR15539829;41;45;0.48780487804878;21;20;0.0121951219512195;0.48780487804878
Control.SRR15539829;51;45;0.392156862745098;31;20;0.107843137254902;0.392156862745098
Control.SRR15539829;42;45;0.452380952380952;23;19;0.0476190476190476;0.452380952380952
Control.SRR15539829;41;45;0.390243902439024;25;16;0.109756097560976;0.390243902439024
Control.SRR15539829;48;45;0.541666666666667;22;26;0.0416666666666666;0.458333333333333
Control.SRR15539829;40;45;0.525;19;21;0.025;0.475
Control.SRR15539829;49;45;0.469387755102041;26;23;0.0306122448979592;0.469387755102041
Control.SRR15539829;49;45;0.428571428571429;28;21;0.0714285714285715;0.428571428571429
Control.SRR15539829;42;45;0.404761904761905;25;17;0.0952380952380952;0.404761904761905
Control.SRR15539829;47;45;0.404255319148936;28;19;0.0957446808510639;0.404255319148936
Control.SRR15539829;40;45;0.55;18;22;0.05;0.45
Control.SRR15539829;41;45;0.658536585365854;14;27;0.158536585365854;0.341463414634146
Control.SRR15539829;48;45;0.4375;27;21;0.0625;0.4375
Control.SRR15539829;41;45;0.536585365853659;19;22;0.0365853658536586;0.463414634146341
Control.SRR15539829;41;45;0.414634146341463;24;17;0.0853658536585366;0.414634146341463
Control.SRR15539829;43;45;0.348837209302326;28;15;0.151162790697674;0.348837209302326
Control.SRR15539829;51;45;0.470588235294118;27;24;0.0294117647058824;0.470588235294118
Control.SRR15539829;46;45;0.565217391304348;20;26;0.0652173913043478;0.434782608695652
Control.SRR15539829;45;45;0.422222222222222;26;19;0.0777777777777778;0.422222222222222
Control.SRR15539829;48;45;0.5625;21;27;0.0625;0.4375
Control.SRR15539829;47;45;0.425531914893617;27;20;0.074468085106383;0.425531914893617
Control.SRR15539829;48;45;0.520833333333333;23;25;0.0208333333333334;0.479166666666667
Control.SRR15539829;43;45;0.441860465116279;24;19;0.0581395348837209;0.441860465116279
Control.SRR15539829;48;45;0.458333333333333;26;22;0.0416666666666667;0.458333333333333
Control.SRR15539829;43;45;0.558139534883721;19;24;0.0581395348837209;0.441860465116279
Control.SRR15539829;41;45;0.463414634146341;22;19;0.0365853658536585;0.463414634146341
Control.SRR15539829;45;45;0.488888888888889;23;22;0.0111111111111111;0.488888888888889
Control.SRR15539829;46;45;0.565217391304348;20;26;0.0652173913043478;0.434782608695652
Control.SRR15539829;49;45;0.346938775510204;32;17;0.153061224489796;0.346938775510204
Control.SRR15539829;45;45;0.666666666666667;15;30;0.166666666666667;0.333333333333333
Control.SRR15539829;46;45;0.478260869565217;24;22;0.0217391304347826;0.478260869565217
Control.SRR15539829;41;45;0.585365853658537;17;24;0.0853658536585366;0.414634146341463
Control.SRR15539829;42;45;0.5;21;21;0;0.5
Control.SRR15539829;47;45;0.468085106382979;25;22;0.0319148936170213;0.468085106382979
Control.SRR15539829;47;45;0.48936170212766;24;23;0.0106382978723404;0.48936170212766
Control.SRR15539829;48;45;0.5;24;24;0;0.5
Control.SRR15539829;50;45;0.38;31;19;0.12;0.38
Control.SRR15539829;43;45;0.441860465116279;24;19;0.0581395348837209;0.441860465116279
Control.SRR15539829;47;45;0.553191489361702;21;26;0.0531914893617021;0.446808510638298
Control.SRR15539829;47;45;0.595744680851064;19;28;0.0957446808510638;0.404255319148936
Control.SRR15539829;46;45;0.478260869565217;24;22;0.0217391304347826;0.478260869565217
Control.SRR15539829;45;45;0.444444444444444;25;20;0.0555555555555556;0.444444444444444
Control.SRR15539829;48;45;0.645833333333333;17;31;0.145833333333333;0.354166666666667
Control.SRR15539829;47;45;0.595744680851064;19;28;0.0957446808510638;0.404255319148936
Control.SRR15539829;45;45;0.488888888888889;23;22;0.0111111111111111;0.488888888888889
Control.SRR15539829;46;45;0.391304347826087;28;18;0.108695652173913;0.391304347826087
Control.SRR15539829;43;45;0.511627906976744;21;22;0.0116279069767442;0.488372093023256
Control.SRR15539829;50;45;0.44;28;22;0.06;0.44
Control.SRR15539829;52;45;0.461538461538462;28;24;0.0384615384615384;0.461538461538462
Control.SRR15539829;51;45;0.490196078431373;26;25;0.00980392156862747;0.490196078431373
Control.SRR15539829;52;45;0.480769230769231;27;25;0.0192307692307692;0.480769230769231
Control.SRR15539829;52;45;0.5;26;26;0;0.5
Control.SRR15539829;40;45;0.425;23;17;0.075;0.425
Control.SRR15539829;47;45;0.48936170212766;24;23;0.0106382978723404;0.48936170212766
Control.SRR15539829;44;45;0.568181818181818;19;25;0.0681818181818182;0.431818181818182
Control.SRR15539829;50;45;0.52;24;26;0.02;0.48
Control.SRR15539829;46;45;0.478260869565217;24;22;0.0217391304347826;0.478260869565217
Control.SRR15539829;42;45;0.428571428571429;24;18;0.0714285714285715;0.428571428571429
Control.SRR15539829;48;45;0.479166666666667;25;23;0.0208333333333333;0.479166666666667
Control.SRR15539829;51;45;0.568627450980392;22;29;0.0686274509803921;0.431372549019608
Control.SRR15539829;45;45;0.577777777777778;19;26;0.0777777777777777;0.422222222222222
Control.SRR15539829;45;45;0.511111111111111;22;23;0.0111111111111111;0.488888888888889
Control.SRR15539829;48;45;0.458333333333333;26;22;0.0416666666666667;0.458333333333333
Control.SRR15539829;43;45;0.418604651162791;25;18;0.0813953488372093;0.418604651162791
Control.SRR15539829;49;45;0.551020408163265;22;27;0.0510204081632653;0.448979591836735
Control.SRR15539829;40;45;0.575;17;23;0.075;0.425
Control.SRR15539829;51;45;0.529411764705882;24;27;0.0294117647058824;0.470588235294118
Control.SRR15539829;43;45;0.441860465116279;24;19;0.0581395348837209;0.441860465116279
Control.SRR15539829;51;45;0.549019607843137;23;28;0.0490196078431373;0.450980392156863
Control.SRR15539829;50;45;0.46;27;23;0.04;0.46
Control.SRR15539829;48;45;0.583333333333333;20;28;0.0833333333333334;0.416666666666667
Control.SRR15539829;47;45;0.425531914893617;27;20;0.074468085106383;0.425531914893617
Control.SRR15539829;45;45;0.533333333333333;21;24;0.0333333333333333;0.466666666666667
Control.SRR15539829;43;45;0.395348837209302;26;17;0.104651162790698;0.395348837209302
Control.SRR15539829;52;45;0.596153846153846;21;31;0.0961538461538461;0.403846153846154
Control.SRR15539829;52;45;0.461538461538462;28;24;0.0384615384615384;0.461538461538462
Control.SRR15539829;50;45;0.5;25;25;0;0.5
Control.SRR15539829;44;45;0.545454545454545;20;24;0.0454545454545454;0.454545454545455
Control.SRR15539829;52;45;0.442307692307692;29;23;0.0576923076923077;0.442307692307692
Control.SRR15539829;49;45;0.387755102040816;30;19;0.112244897959184;0.387755102040816
Control.SRR15539829;48;45;0.604166666666667;19;29;0.104166666666667;0.395833333333333
Control.SRR15539829;40;45;0.55;18;22;0.05;0.45
Control.SRR15539829;45;45;0.444444444444444;25;20;0.0555555555555556;0.444444444444444
Control.SRR15539829;47;45;0.425531914893617;27;20;0.074468085106383;0.425531914893617
Control.SRR15539829;48;45;0.479166666666667;25;23;0.0208333333333333;0.479166666666667
Control.SRR15539829;48;45;0.5;24;24;0;0.5
Control.SRR15539829;43;45;0.441860465116279;24;19;0.0581395348837209;0.441860465116279
Control.SRR15539829;51;45;0.549019607843137;23;28;0.0490196078431373;0.450980392156863
Control.SRR15539829;50;45;0.42;29;21;0.08;0.42
Control.SRR15539829;51;45;0.627450980392157;19;32;0.127450980392157;0.372549019607843
Control.SRR15539829;47;45;0.468085106382979;25;22;0.0319148936170213;0.468085106382979
Control.SRR15539829;47;45;0.553191489361702;21;26;0.0531914893617021;0.446808510638298
Control.SRR15539829;43;45;0.534883720930233;20;23;0.0348837209302325;0.465116279069767
Control.SRR15539829;45;45;0.6;18;27;0.1;0.4
Control.SRR15539829;49;45;0.326530612244898;33;16;0.173469387755102;0.326530612244898
Control.SRR15539829;45;45;0.511111111111111;22;23;0.0111111111111111;0.488888888888889
Control.SRR15539829;46;45;0.41304347826087;27;19;0.0869565217391304;0.41304347826087
Control.SRR15539829;50;45;0.5;25;25;0;0.5
Control.SRR15539829;43;45;0.627906976744186;16;27;0.127906976744186;0.372093023255814
Control.SRR15539829;45;45;0.4;27;18;0.1;0.4
Control.SRR15539829;46;45;0.456521739130435;25;21;0.0434782608695652;0.456521739130435
Control.SRR15539829;46;45;0.5;23;23;0;0.5
Control.SRR15539829;51;45;0.588235294117647;21;30;0.0882352941176471;0.411764705882353
Control.SRR15539829;52;45;0.384615384615385;32;20;0.115384615384615;0.384615384615385
Control.SRR15539829;48;45;0.4375;27;21;0.0625;0.4375
Control.SRR15539829;42;45;0.5;21;21;0;0.5
Control.SRR15539829;44;45;0.409090909090909;26;18;0.0909090909090909;0.409090909090909
Control.SRR15539829;41;45;0.536585365853659;19;22;0.0365853658536586;0.463414634146341
Control.SRR15539829;46;45;0.434782608695652;26;20;0.0652173913043478;0.434782608695652
Control.SRR15539829;44;45;0.5;22;22;0;0.5
Control.SRR15539829;42;45;0.452380952380952;23;19;0.0476190476190476;0.452380952380952
Control.SRR15539829;43;45;0.418604651162791;25;18;0.0813953488372093;0.418604651162791
Control.SRR15539829;49;45;0.489795918367347;25;24;0.0102040816326531;0.489795918367347
Control.SRR15539829;46;45;0.5;23;23;0;0.5
Control.SRR15539829;49;45;0.510204081632653;24;25;0.0102040816326531;0.489795918367347
Control.SRR15539829;49;45;0.469387755102041;26;23;0.0306122448979592;0.469387755102041
Control.SRR15539829;46;45;0.326086956521739;31;15;0.173913043478261;0.326086956521739
Control.SRR15539829;42;45;0.5;21;21;0;0.5
Control.SRR15539829;47;45;0.48936170212766;24;23;0.0106382978723404;0.48936170212766
Control.SRR15539829;50;45;0.46;27;23;0.04;0.46
Control.SRR15539829;49;45;0.408163265306122;29;20;0.0918367346938775;0.408163265306122
Control.SRR15539829;46;45;0.58695652173913;19;27;0.0869565217391305;0.41304347826087
Control.SRR15539829;41;45;0.463414634146341;22;19;0.0365853658536585;0.463414634146341
Control.SRR15539829;51;45;0.431372549019608;29;22;0.0686274509803921;0.431372549019608
Control.SRR15539829;51;45;0.529411764705882;24;27;0.0294117647058824;0.470588235294118
Control.SRR15539829;45;45;0.488888888888889;23;22;0.0111111111111111;0.488888888888889
Control.SRR15539829;48;45;0.5625;21;27;0.0625;0.4375
Control.SRR15539829;43;45;0.441860465116279;24;19;0.0581395348837209;0.441860465116279
Control.SRR15539829;45;45;0.533333333333333;21;24;0.0333333333333333;0.466666666666667
Control.SRR15539829;42;45;0.523809523809524;20;22;0.0238095238095238;0.476190476190476
Control.SRR15539829;45;45;0.422222222222222;26;19;0.0777777777777778;0.422222222222222
Control.SRR15539829;46;45;0.456521739130435;25;21;0.0434782608695652;0.456521739130435
Control.SRR15539829;50;45;0.64;18;32;0.14;0.36
Control.SRR15539829;47;45;0.468085106382979;25;22;0.0319148936170213;0.468085106382979
Control.SRR15539829;48;45;0.520833333333333;23;25;0.0208333333333334;0.479166666666667
Control.SRR15539829;44;45;0.522727272727273;21;23;0.0227272727272727;0.477272727272727
Control.SRR15539829;49;45;0.489795918367347;25;24;0.0102040816326531;0.489795918367347
Control.SRR15539829;50;45;0.62;19;31;0.12;0.38
Control.SRR15539829;43;45;0.558139534883721;19;24;0.0581395348837209;0.441860465116279
Control.SRR15539829;42;45;0.595238095238095;17;25;0.0952380952380952;0.404761904761905
Control.SRR15539829;51;45;0.588235294117647;21;30;0.0882352941176471;0.411764705882353
Control.SRR15539829;49;45;0.510204081632653;24;25;0.0102040816326531;0.489795918367347
Control.SRR15539829;41;45;0.48780487804878;21;20;0.0121951219512195;0.48780487804878
Control.SRR15539829;47;45;0.340425531914894;31;16;0.159574468085106;0.340425531914894
Control.SRR15539829;45;45;0.422222222222222;26;19;0.0777777777777778;0.422222222222222
Control.SRR15539829;41;45;0.463414634146341;22;19;0.0365853658536585;0.463414634146341
Control.SRR15539829;45;45;0.488888888888889;23;22;0.0111111111111111;0.488888888888889
Control.SRR15539829;45;45;0.622222222222222;17;28;0.122222222222222;0.377777777777778
Control.SRR15539829;47;45;0.595744680851064;19;28;0.0957446808510638;0.404255319148936
Control.SRR15539829;52;45;0.5;26;26;0;0.5
Control.SRR15539829;49;45;0.551020408163265;22;27;0.0510204081632653;0.448979591836735
Control.SRR15539829;49;45;0.63265306122449;18;31;0.13265306122449;0.36734693877551
Control.SRR15539829;46;45;0.543478260869565;21;25;0.0434782608695652;0.456521739130435
Control.SRR15539829;45;45;0.444444444444444;25;20;0.0555555555555556;0.444444444444444
Control.SRR15539829;50;45;0.54;23;27;0.04;0.46
Control.SRR15539829;50;45;0.6;20;30;0.1;0.4
Control.SRR15539829;42;45;0.642857142857143;15;27;0.142857142857143;0.357142857142857
Control.SRR15539829;45;45;0.533333333333333;21;24;0.0333333333333333;0.466666666666667
Control.SRR15539829;48;45;0.458333333333333;26;22;0.0416666666666667;0.458333333333333
Control.SRR15539829;47;45;0.446808510638298;26;21;0.0531914893617021;0.446808510638298
Control.SRR15539829;46;45;0.456521739130435;25;21;0.0434782608695652;0.456521739130435
Control.SRR15539829;48;45;0.520833333333333;23;25;0.0208333333333334;0.479166666666667
Control.SRR15539829;40;45;0.475;21;19;0.025;0.475
Control.SRR15539829;41;45;0.48780487804878;21;20;0.0121951219512195;0.48780487804878
Control.SRR15539829;52;45;0.480769230769231;27;25;0.0192307692307692;0.480769230769231
Control.SRR15539829;52;45;0.519230769230769;25;27;0.0192307692307693;0.480769230769231
Control.SRR15539829;40;45;0.525;19;21;0.025;0.475
Control.SRR15539829;52;45;0.557692307692308;23;29;0.0576923076923077;0.442307692307692
Control.SRR15539829;40;45;0.55;18;22;0.05;0.45
Control.SRR15539829;44;45;0.568181818181818;19;25;0.0681818181818182;0.431818181818182
Control.SRR15539829;49;45;0.612244897959184;19;30;0.112244897959184;0.387755102040816
Control.SRR15539829;51;45;0.588235294117647;21;30;0.0882352941176471;0.411764705882353
Control.SRR15539829;50;45;0.54;23;27;0.04;0.46
Control.SRR15539829;42;45;0.380952380952381;26;16;0.119047619047619;0.380952380952381
Control.SRR15539829;48;45;0.541666666666667;22;26;0.0416666666666666;0.458333333333333
Control.SRR15539829;51;45;0.470588235294118;27;24;0.0294117647058824;0.470588235294118
Control.SRR15539829;40;45;0.5;20;20;0;0.5
Control.SRR15539829;46;45;0.652173913043478;16;30;0.152173913043478;0.347826086956522
Control.SRR15539829;44;45;0.636363636363636;16;28;0.136363636363636;0.363636363636364
Control.SRR15539829;51;45;0.588235294117647;21;30;0.0882352941176471;0.411764705882353
Control.SRR15539829;48;45;0.541666666666667;22;26;0.0416666666666666;0.458333333333333
Control.SRR15539829;40;45;0.6;16;24;0.1;0.4
Control.SRR15539829;41;45;0.292682926829268;29;12;0.207317073170732;0.292682926829268
Control.SRR15539829;41;45;0.463414634146341;22;19;0.0365853658536585;0.463414634146341
Control.SRR15539829;46;45;0.543478260869565;21;25;0.0434782608695652;0.456521739130435
Control.SRR15539829;52;45;0.423076923076923;30;22;0.0769230769230769;0.423076923076923
Control.SRR15539829;44;45;0.477272727272727;23;21;0.0227272727272727;0.477272727272727
Control.SRR15539829;41;45;0.609756097560976;16;25;0.109756097560976;0.390243902439024
Control.SRR15539829;50;45;0.62;19;31;0.12;0.38
Control.SRR15539829;41;45;0.51219512195122;20;21;0.0121951219512195;0.48780487804878
Control.SRR15539829;46;45;0.608695652173913;18;28;0.108695652173913;0.391304347826087
Control.SRR15539829;42;45;0.476190476190476;22;20;0.0238095238095238;0.476190476190476
Control.SRR15539829;49;45;0.591836734693878;20;29;0.0918367346938775;0.408163265306122
Control.SRR15539829;50;45;0.48;26;24;0.02;0.48
Control.SRR15539829;48;45;0.458333333333333;26;22;0.0416666666666667;0.458333333333333
Control.SRR15539829;43;45;0.441860465116279;24;19;0.0581395348837209;0.441860465116279
Control.SRR15539829;42;45;0.547619047619048;19;23;0.0476190476190477;0.452380952380952
Control.SRR15539829;41;45;0.536585365853659;19;22;0.0365853658536586;0.463414634146341
Control.SRR15539829;47;45;0.51063829787234;23;24;0.0106382978723404;0.48936170212766
Control.SRR15539829;41;45;0.463414634146341;22;19;0.0365853658536585;0.463414634146341
Control.SRR15539829;40;45;0.575;17;23;0.075;0.425
Control.SRR15539829;43;45;0.581395348837209;18;25;0.0813953488372093;0.418604651162791
Control.SRR15539829;46;45;0.543478260869565;21;25;0.0434782608695652;0.456521739130435
Control.SRR15539829;52;45;0.423076923076923;30;22;0.0769230769230769;0.423076923076923
Control.SRR15539829;44;45;0.522727272727273;21;23;0.0227272727272727;0.477272727272727
Control.SRR15539829;42;45;0.619047619047619;16;26;0.119047619047619;0.380952380952381
Control.SRR15539829;40;45;0.625;15;25;0.125;0.375
Control.SRR15539829;51;45;0.431372549019608;29;22;0.0686274509803921;0.431372549019608
Control.SRR15539829;45;45;0.466666666666667;24;21;0.0333333333333333;0.466666666666667
Control.SRR15539829;49;45;0.489795918367347;25;24;0.0102040816326531;0.489795918367347
Control.SRR15539829;50;45;0.62;19;31;0.12;0.38
Control.SRR15539829;41;45;0.560975609756098;18;23;0.0609756097560976;0.439024390243902
Control.SRR15539829;51;45;0.470588235294118;27;24;0.0294117647058824;0.470588235294118
Control.SRR15539829;49;45;0.571428571428571;21;28;0.0714285714285714;0.428571428571429
Control.SRR15539829;43;45;0.511627906976744;21;22;0.0116279069767442;0.488372093023256
Control.SRR15539829;48;45;0.5625;21;27;0.0625;0.4375
Control.SRR15539829;50;45;0.5;25;25;0;0.5
Control.SRR15539829;40;45;0.625;15;25;0.125;0.375
Control.SRR15539829;41;45;0.51219512195122;20;21;0.0121951219512195;0.48780487804878
Control.SRR15539829;44;45;0.477272727272727;23;21;0.0227272727272727;0.477272727272727
Control.SRR15539829;48;45;0.479166666666667;25;23;0.0208333333333333;0.479166666666667
Control.SRR15539829;42;45;0.523809523809524;20;22;0.0238095238095238;0.476190476190476
Control.SRR15539829;45;45;0.511111111111111;22;23;0.0111111111111111;0.488888888888889
Control.SRR15539829;49;45;0.571428571428571;21;28;0.0714285714285714;0.428571428571429
Control.SRR15539829;49;45;0.428571428571429;28;21;0.0714285714285715;0.428571428571429
Control.SRR15539829;47;45;0.531914893617021;22;25;0.0319148936170213;0.468085106382979
Control.SRR15539829;41;45;0.439024390243902;23;18;0.0609756097560976;0.439024390243902
Control.SRR15539829;40;45;0.4;24;16;0.1;0.4
Control.SRR15539829;46;45;0.41304347826087;27;19;0.0869565217391304;0.41304347826087
Control.SRR15539829;47;45;0.574468085106383;20;27;0.074468085106383;0.425531914893617
Control.SRR15539829;50;45;0.46;27;23;0.04;0.46
Control.SRR15539829;52;45;0.557692307692308;23;29;0.0576923076923077;0.442307692307692
Control.SRR15539829;47;45;0.340425531914894;31;16;0.159574468085106;0.340425531914894
Control.SRR15539829;46;45;0.543478260869565;21;25;0.0434782608695652;0.456521739130435
Control.SRR15539829;46;45;0.543478260869565;21;25;0.0434782608695652;0.456521739130435
Control.SRR15539829;43;45;0.627906976744186;16;27;0.127906976744186;0.372093023255814
Control.SRR15539829;43;45;0.418604651162791;25;18;0.0813953488372093;0.418604651162791
Control.SRR15539829;45;45;0.644444444444444;16;29;0.144444444444444;0.355555555555556
Control.SRR15539829;51;45;0.647058823529412;18;33;0.147058823529412;0.352941176470588
Control.SRR15539829;52;45;0.480769230769231;27;25;0.0192307692307692;0.480769230769231
Control.SRR15539829;48;45;0.458333333333333;26;22;0.0416666666666667;0.458333333333333
Control.SRR15539829;52;45;0.519230769230769;25;27;0.0192307692307693;0.480769230769231
Control.SRR15539829;46;45;0.456521739130435;25;21;0.0434782608695652;0.456521739130435
Control.SRR15539829;40;45;0.4;24;16;0.1;0.4
Control.SRR15539829;50;45;0.48;26;24;0.02;0.48
Control.SRR15539829;42;45;0.357142857142857;27;15;0.142857142857143;0.357142857142857
Control.SRR15539829;52;45;0.461538461538462;28;24;0.0384615384615384;0.461538461538462
Control.SRR15539829;40;45;0.5;20;20;0;0.5
Control.SRR15539829;44;45;0.5;22;22;0;0.5
Control.SRR15539829;48;45;0.5625;21;27;0.0625;0.4375
Control.SRR15539829;49;45;0.469387755102041;26;23;0.0306122448979592;0.469387755102041
Control.SRR15539829;49;45;0.530612244897959;23;26;0.0306122448979592;0.469387755102041
Control.SRR15539829;52;45;0.576923076923077;22;30;0.0769230769230769;0.423076923076923
Control.SRR15539829;50;45;0.62;19;31;0.12;0.38
Control.SRR15539829;45;45;0.555555555555556;20;25;0.0555555555555556;0.444444444444444
Control.SRR15539829;52;45;0.346153846153846;34;18;0.153846153846154;0.346153846153846
Control.SRR15539829;42;45;0.404761904761905;25;17;0.0952380952380952;0.404761904761905
Control.SRR15539829;48;45;0.5625;21;27;0.0625;0.4375
Control.SRR15539829;45;45;0.533333333333333;21;24;0.0333333333333333;0.466666666666667
Control.SRR15539829;48;45;0.5625;21;27;0.0625;0.4375
Control.SRR15539829;44;45;0.659090909090909;15;29;0.159090909090909;0.340909090909091
Control.SRR15539829;47;45;0.574468085106383;20;27;0.074468085106383;0.425531914893617
Control.SRR15539829;50;45;0.42;29;21;0.08;0.42
Control.SRR15539829;48;45;0.5;24;24;0;0.5
Control.SRR15539829;47;45;0.595744680851064;19;28;0.0957446808510638;0.404255319148936
Control.SRR15539829;45;45;0.555555555555556;20;25;0.0555555555555556;0.444444444444444
Control.SRR15539829;47;45;0.51063829787234;23;24;0.0106382978723404;0.48936170212766
Control.SRR15539829;46;45;0.478260869565217;24;22;0.0217391304347826;0.478260869565217
Control.SRR15539829;48;45;0.395833333333333;29;19;0.104166666666667;0.395833333333333
Control.SRR15539829;46;45;0.41304347826087;27;19;0.0869565217391304;0.41304347826087
Control.SRR15539829;44;45;0.431818181818182;25;19;0.0681818181818182;0.431818181818182
Control.SRR15539829;43;45;0.488372093023256;22;21;0.0116279069767442;0.488372093023256
Control.SRR15539829;49;45;0.591836734693878;20;29;0.0918367346938775;0.408163265306122
Control.SRR15539829;49;45;0.63265306122449;18;31;0.13265306122449;0.36734693877551
Control.SRR15539829;52;45;0.461538461538462;28;24;0.0384615384615384;0.461538461538462
Control.SRR15539829;50;45;0.4;30;20;0.1;0.4
Control.SRR15539829;46;45;0.456521739130435;25;21;0.0434782608695652;0.456521739130435
Control.SRR15539829;50;45;0.58;21;29;0.08;0.42
Control.SRR15539829;41;45;0.48780487804878;21;20;0.0121951219512195;0.48780487804878
Control.SRR15539829;40;45;0.55;18;22;0.05;0.45
Control.SRR15539829;46;45;0.5;23;23;0;0.5
Control.SRR15539829;41;45;0.682926829268293;13;28;0.182926829268293;0.317073170731707
Control.SRR15539829;44;45;0.454545454545455;24;20;0.0454545454545455;0.454545454545455
Control.SRR15539829;40;45;0.65;14;26;0.15;0.35
Control.SRR15539829;40;45;0.35;26;14;0.15;0.35
Control.SRR15539829;47;45;0.553191489361702;21;26;0.0531914893617021;0.446808510638298
Control.SRR15539829;46;45;0.391304347826087;28;18;0.108695652173913;0.391304347826087
Control.SRR15539829;44;45;0.545454545454545;20;24;0.0454545454545454;0.454545454545455
Control.SRR15539829;47;45;0.617021276595745;18;29;0.117021276595745;0.382978723404255
Control.SRR15539829;47;45;0.531914893617021;22;25;0.0319148936170213;0.468085106382979
Control.SRR15539829;50;45;0.4;30;20;0.1;0.4
Control.SRR15539829;46;45;0.369565217391304;29;17;0.130434782608696;0.369565217391304
Control.SRR15539829;44;45;0.477272727272727;23;21;0.0227272727272727;0.477272727272727
Control.SRR15539829;43;45;0.465116279069767;23;20;0.0348837209302326;0.465116279069767
Control.SRR15539829;45;45;0.555555555555556;20;25;0.0555555555555556;0.444444444444444
Control.SRR15539829;52;45;0.423076923076923;30;22;0.0769230769230769;0.423076923076923
Control.SRR15539829;49;45;0.551020408163265;22;27;0.0510204081632653;0.448979591836735
Control.SRR15539829;47;45;0.446808510638298;26;21;0.0531914893617021;0.446808510638298
Control.SRR15539829;43;45;0.534883720930233;20;23;0.0348837209302325;0.465116279069767
Control.SRR15539829;41;45;0.585365853658537;17;24;0.0853658536585366;0.414634146341463
Control.SRR15539829;43;45;0.441860465116279;24;19;0.0581395348837209;0.441860465116279
Control.SRR15539829;45;45;0.488888888888889;23;22;0.0111111111111111;0.488888888888889
Control.SRR15539829;43;45;0.418604651162791;25;18;0.0813953488372093;0.418604651162791
Control.SRR15539829;52;45;0.596153846153846;21;31;0.0961538461538461;0.403846153846154
Control.SRR15539829;42;45;0.523809523809524;20;22;0.0238095238095238;0.476190476190476
Control.SRR15539829;47;45;0.425531914893617;27;20;0.074468085106383;0.425531914893617
Control.SRR15539829;49;45;0.489795918367347;25;24;0.0102040816326531;0.489795918367347
Control.SRR15539829;49;45;0.551020408163265;22;27;0.0510204081632653;0.448979591836735
Control.SRR15539829;40;45;0.625;15;25;0.125;0.375
Control.SRR15539829;41;45;0.365853658536585;26;15;0.134146341463415;0.365853658536585
Control.SRR15539829;51;45;0.509803921568627;25;26;0.00980392156862742;0.490196078431373
Control.SRR15539829;42;45;0.547619047619048;19;23;0.0476190476190477;0.452380952380952
Control.SRR15539829;44;45;0.363636363636364;28;16;0.136363636363636;0.363636363636364
Control.SRR15539829;44;45;0.340909090909091;29;15;0.159090909090909;0.340909090909091
Control.SRR15539829;49;45;0.63265306122449;18;31;0.13265306122449;0.36734693877551
Control.SRR15539829;51;45;0.431372549019608;29;22;0.0686274509803921;0.431372549019608
Control.SRR15539829;42;45;0.547619047619048;19;23;0.0476190476190477;0.452380952380952
Control.SRR15539829;41;45;0.658536585365854;14;27;0.158536585365854;0.341463414634146
Control.SRR15539829;47;45;0.468085106382979;25;22;0.0319148936170213;0.468085106382979
Control.SRR15539829;41;45;0.585365853658537;17;24;0.0853658536585366;0.414634146341463
Control.SRR15539829;52;45;0.576923076923077;22;30;0.0769230769230769;0.423076923076923
Control.SRR15539829;48;45;0.479166666666667;25;23;0.0208333333333333;0.479166666666667
Control.SRR15539829;45;45;0.444444444444444;25;20;0.0555555555555556;0.444444444444444
Control.SRR15539829;42;45;0.523809523809524;20;22;0.0238095238095238;0.476190476190476
Control.SRR15539829;43;45;0.465116279069767;23;20;0.0348837209302326;0.465116279069767
Control.SRR15539829;47;45;0.382978723404255;29;18;0.117021276595745;0.382978723404255
Control.SRR15539829;48;45;0.479166666666667;25;23;0.0208333333333333;0.479166666666667
Control.SRR15539829;46;45;0.5;23;23;0;0.5
Control.SRR15539829;48;45;0.458333333333333;26;22;0.0416666666666667;0.458333333333333
Control.SRR15539829;47;45;0.51063829787234;23;24;0.0106382978723404;0.48936170212766
Control.SRR15539829;40;45;0.525;19;21;0.025;0.475
Control.SRR15539829;52;45;0.519230769230769;25;27;0.0192307692307693;0.480769230769231
Control.SRR15539829;51;45;0.470588235294118;27;24;0.0294117647058824;0.470588235294118
Control.SRR15539829;46;45;0.543478260869565;21;25;0.0434782608695652;0.456521739130435
Control.SRR15539829;52;45;0.442307692307692;29;23;0.0576923076923077;0.442307692307692
Control.SRR15539829;52;45;0.557692307692308;23;29;0.0576923076923077;0.442307692307692
Control.SRR15539829;42;45;0.380952380952381;26;16;0.119047619047619;0.380952380952381
Control.SRR15539829;48;45;0.479166666666667;25;23;0.0208333333333333;0.479166666666667
Control.SRR15539829;42;45;0.333333333333333;28;14;0.166666666666667;0.333333333333333
Control.SRR15539829;50;45;0.56;22;28;0.0600000000000001;0.44
Control.SRR15539829;42;45;0.666666666666667;14;28;0.166666666666667;0.333333333333333
Control.SRR15539829;46;45;0.630434782608696;17;29;0.130434782608696;0.369565217391304
Control.SRR15539829;47;45;0.48936170212766;24;23;0.0106382978723404;0.48936170212766
Control.SRR15539829;41;45;0.48780487804878;21;20;0.0121951219512195;0.48780487804878
Control.SRR15539829;44;45;0.522727272727273;21;23;0.0227272727272727;0.477272727272727
Control.SRR15539829;41;45;0.414634146341463;24;17;0.0853658536585366;0.414634146341463
Control.SRR15539829;45;45;0.444444444444444;25;20;0.0555555555555556;0.444444444444444
Control.SRR15539829;50;45;0.4;30;20;0.1;0.4
Control.SRR15539829;48;45;0.5625;21;27;0.0625;0.4375
Control.SRR15539829;47;45;0.531914893617021;22;25;0.0319148936170213;0.468085106382979
Control.SRR15539829;50;45;0.48;26;24;0.02;0.48
Control.SRR15539829;46;45;0.434782608695652;26;20;0.0652173913043478;0.434782608695652
Control.SRR15539829;42;45;0.5;21;21;0;0.5
Control.SRR15539829;40;45;0.45;22;18;0.05;0.45
Control.SRR15539829;46;45;0.456521739130435;25;21;0.0434782608695652;0.456521739130435
Control.SRR15539829;44;45;0.522727272727273;21;23;0.0227272727272727;0.477272727272727
Control.SRR15539829;40;45;0.525;19;21;0.025;0.475
Control.SRR15539829;46;45;0.478260869565217;24;22;0.0217391304347826;0.478260869565217
Control.SRR15539829;52;45;0.557692307692308;23;29;0.0576923076923077;0.442307692307692
Control.SRR15539829;51;45;0.549019607843137;23;28;0.0490196078431373;0.450980392156863
Control.SRR15539829;40;45;0.5;20;20;0;0.5
Control.SRR15539829;46;45;0.456521739130435;25;21;0.0434782608695652;0.456521739130435
Control.SRR15539829;48;45;0.395833333333333;29;19;0.104166666666667;0.395833333333333
Control.SRR15539829;45;45;0.466666666666667;24;21;0.0333333333333333;0.466666666666667
Control.SRR15539829;42;45;0.452380952380952;23;19;0.0476190476190476;0.452380952380952
Control.SRR15539829;48;45;0.5625;21;27;0.0625;0.4375
Control.SRR15539829;47;45;0.553191489361702;21;26;0.0531914893617021;0.446808510638298
Control.SRR15539829;45;45;0.511111111111111;22;23;0.0111111111111111;0.488888888888889
Control.SRR15539829;43;45;0.534883720930233;20;23;0.0348837209302325;0.465116279069767
Control.SRR15539829;48;45;0.541666666666667;22;26;0.0416666666666666;0.458333333333333
Control.SRR15539829;46;45;0.543478260869565;21;25;0.0434782608695652;0.456521739130435
Control.SRR15539829;40;45;0.575;17;23;0.075;0.425
Control.SRR15539829;47;45;0.617021276595745;18;29;0.117021276595745;0.382978723404255
Control.SRR15539829;45;45;0.577777777777778;19;26;0.0777777777777777;0.422222222222222
Control.SRR15539829;44;45;0.386363636363636;27;17;0.113636363636364;0.386363636363636
Control.SRR15539829;44;45;0.409090909090909;26;18;0.0909090909090909;0.409090909090909
Control.SRR15539829;50;45;0.46;27;23;0.04;0.46
Control.SRR15539829;44;45;0.477272727272727;23;21;0.0227272727272727;0.477272727272727
Control.SRR15539829;42;45;0.571428571428571;18;24;0.0714285714285714;0.428571428571429
Control.SRR15539829;52;45;0.5;26;26;0;0.5
Control.SRR15539829;48;45;0.520833333333333;23;25;0.0208333333333334;0.479166666666667
Control.SRR15539829;45;45;0.488888888888889;23;22;0.0111111111111111;0.488888888888889
Control.SRR15539829;50;45;0.56;22;28;0.0600000000000001;0.44
Control.SRR15539829;51;45;0.470588235294118;27;24;0.0294117647058824;0.470588235294118
Control.SRR15539829;42;45;0.380952380952381;26;16;0.119047619047619;0.380952380952381
Control.SRR15539829;42;45;0.476190476190476;22;20;0.0238095238095238;0.476190476190476
Control.SRR15539829;45;45;0.488888888888889;23;22;0.0111111111111111;0.488888888888889
Control.SRR15539829;45;45;0.533333333333333;21;24;0.0333333333333333;0.466666666666667
Control.SRR15539829;44;45;0.545454545454545;20;24;0.0454545454545454;0.454545454545455
Control.SRR15539829;41;45;0.48780487804878;21;20;0.0121951219512195;0.48780487804878
Control.SRR15539829;43;45;0.604651162790698;17;26;0.104651162790698;0.395348837209302
Control.SRR15539829;45;45;0.377777777777778;28;17;0.122222222222222;0.377777777777778
Control.SRR15539829;44;45;0.522727272727273;21;23;0.0227272727272727;0.477272727272727
Control.SRR15539829;49;45;0.551020408163265;22;27;0.0510204081632653;0.448979591836735
Control.SRR15539829;46;45;0.565217391304348;20;26;0.0652173913043478;0.434782608695652
Control.SRR15539829;42;45;0.523809523809524;20;22;0.0238095238095238;0.476190476190476
Control.SRR15539829;50;45;0.6;20;30;0.1;0.4
Control.SRR15539829;41;45;0.634146341463415;15;26;0.134146341463415;0.365853658536585
Control.SRR15539829;48;45;0.416666666666667;28;20;0.0833333333333333;0.416666666666667
Control.SRR15539829;49;45;0.653061224489796;17;32;0.153061224489796;0.346938775510204
Control.SRR15539829;47;45;0.51063829787234;23;24;0.0106382978723404;0.48936170212766
Control.SRR15539829;43;45;0.418604651162791;25;18;0.0813953488372093;0.418604651162791
Control.SRR15539829;43;45;0.558139534883721;19;24;0.0581395348837209;0.441860465116279
Control.SRR15539829;48;45;0.458333333333333;26;22;0.0416666666666667;0.458333333333333
Control.SRR15539829;49;45;0.571428571428571;21;28;0.0714285714285714;0.428571428571429
Control.SRR15539829;40;45;0.55;18;22;0.05;0.45
Control.SRR15539829;43;45;0.465116279069767;23;20;0.0348837209302326;0.465116279069767
Control.SRR15539829;50;45;0.44;28;22;0.06;0.44
Control.SRR15539829;42;45;0.5;21;21;0;0.5
Control.SRR15539829;48;45;0.458333333333333;26;22;0.0416666666666667;0.458333333333333
Control.SRR15539829;51;45;0.490196078431373;26;25;0.00980392156862747;0.490196078431373
Control.SRR15539829;41;45;0.536585365853659;19;22;0.0365853658536586;0.463414634146341
Control.SRR15539829;47;45;0.468085106382979;25;22;0.0319148936170213;0.468085106382979
Control.SRR15539829;43;45;0.488372093023256;22;21;0.0116279069767442;0.488372093023256
Control.SRR15539829;43;45;0.534883720930233;20;23;0.0348837209302325;0.465116279069767
Control.SRR15539829;42;45;0.571428571428571;18;24;0.0714285714285714;0.428571428571429
Control.SRR15539829;40;45;0.375;25;15;0.125;0.375
Control.SRR15539829;44;45;0.5;22;22;0;0.5
Control.SRR15539829;46;45;0.434782608695652;26;20;0.0652173913043478;0.434782608695652
Control.SRR15539829;45;45;0.4;27;18;0.1;0.4
Control.SRR15539829;41;45;0.463414634146341;22;19;0.0365853658536585;0.463414634146341
Control.SRR15539829;47;45;0.553191489361702;21;26;0.0531914893617021;0.446808510638298
Control.SRR15539829;43;45;0.534883720930233;20;23;0.0348837209302325;0.465116279069767
Control.SRR15539829;50;45;0.5;25;25;0;0.5
Control.SRR15539829;50;45;0.52;24;26;0.02;0.48
Control.SRR15539829;48;45;0.541666666666667;22;26;0.0416666666666666;0.458333333333333
Control.SRR15539829;41;45;0.585365853658537;17;24;0.0853658536585366;0.414634146341463
Control.SRR15539829;40;45;0.45;22;18;0.05;0.45
Control.SRR15539829;42;45;0.547619047619048;19;23;0.0476190476190477;0.452380952380952
Control.SRR15539829;46;45;0.391304347826087;28;18;0.108695652173913;0.391304347826087
Control.SRR15539829;46;45;0.543478260869565;21;25;0.0434782608695652;0.456521739130435
Control.SRR15539829;49;45;0.510204081632653;24;25;0.0102040816326531;0.489795918367347
Control.SRR15539829;51;45;0.431372549019608;29;22;0.0686274509803921;0.431372549019608
Control.SRR15539829;51;45;0.588235294117647;21;30;0.0882352941176471;0.411764705882353
Control.SRR15539829;48;45;0.4375;27;21;0.0625;0.4375
Control.SRR15539829;47;45;0.553191489361702;21;26;0.0531914893617021;0.446808510638298
Control.SRR15539829;40;45;0.475;21;19;0.025;0.475
Control.SRR15539829;40;45;0.625;15;25;0.125;0.375
Control.SRR15539829;40;45;0.45;22;18;0.05;0.45
Control.SRR15539829;40;45;0.425;23;17;0.075;0.425
Control.SRR15539829;42;45;0.523809523809524;20;22;0.0238095238095238;0.476190476190476
Control.SRR15539829;44;45;0.659090909090909;15;29;0.159090909090909;0.340909090909091
Control.SRR15539829;47;45;0.638297872340426;17;30;0.138297872340426;0.361702127659574
Control.SRR15539829;49;45;0.591836734693878;20;29;0.0918367346938775;0.408163265306122
Control.SRR15539829;44;45;0.545454545454545;20;24;0.0454545454545454;0.454545454545455
Control.SRR15539829;44;45;0.409090909090909;26;18;0.0909090909090909;0.409090909090909
Control.SRR15539829;52;45;0.538461538461538;24;28;0.0384615384615384;0.461538461538462
Control.SRR15539829;40;45;0.525;19;21;0.025;0.475
Control.SRR15539829;45;45;0.466666666666667;24;21;0.0333333333333333;0.466666666666667
Control.SRR15539829;40;45;0.525;19;21;0.025;0.475
Control.SRR15539829;44;45;0.5;22;22;0;0.5
Control.SRR15539829;41;45;0.536585365853659;19;22;0.0365853658536586;0.463414634146341
Control.SRR15539829;42;45;0.452380952380952;23;19;0.0476190476190476;0.452380952380952
Control.SRR15539829;47;45;0.531914893617021;22;25;0.0319148936170213;0.468085106382979
Control.SRR15539829;52;45;0.442307692307692;29;23;0.0576923076923077;0.442307692307692
Control.SRR15539829;47;45;0.425531914893617;27;20;0.074468085106383;0.425531914893617
Control.SRR15539829;42;45;0.595238095238095;17;25;0.0952380952380952;0.404761904761905
Control.SRR15539829;45;45;0.511111111111111;22;23;0.0111111111111111;0.488888888888889
Control.SRR15539829;41;45;0.439024390243902;23;18;0.0609756097560976;0.439024390243902
Control.SRR15539829;45;45;0.511111111111111;22;23;0.0111111111111111;0.488888888888889
Control.SRR15539829;42;45;0.595238095238095;17;25;0.0952380952380952;0.404761904761905
Control.SRR15539829;47;45;0.553191489361702;21;26;0.0531914893617021;0.446808510638298
Control.SRR15539829;52;45;0.423076923076923;30;22;0.0769230769230769;0.423076923076923
Control.SRR15539829;45;45;0.422222222222222;26;19;0.0777777777777778;0.422222222222222
Control.SRR15539829;48;45;0.395833333333333;29;19;0.104166666666667;0.395833333333333
Control.SRR15539829;47;45;0.51063829787234;23;24;0.0106382978723404;0.48936170212766
Control.SRR15539829;45;45;0.6;18;27;0.1;0.4
Control.SRR15539829;47;45;0.531914893617021;22;25;0.0319148936170213;0.468085106382979
Control.SRR15539829;47;45;0.425531914893617;27;20;0.074468085106383;0.425531914893617
Control.SRR15539829;50;45;0.4;30;20;0.1;0.4
Control.SRR15539829;48;45;0.520833333333333;23;25;0.0208333333333334;0.479166666666667
Control.SRR15539829;50;45;0.5;25;25;0;0.5
Control.SRR15539829;40;45;0.4;24;16;0.1;0.4
Control.SRR15539829;40;45;0.525;19;21;0.025;0.475
Control.SRR15539829;44;45;0.340909090909091;29;15;0.159090909090909;0.340909090909091
Control.SRR15539829;47;45;0.574468085106383;20;27;0.074468085106383;0.425531914893617
Control.SRR15539829;46;45;0.434782608695652;26;20;0.0652173913043478;0.434782608695652
Control.SRR15539829;47;45;0.468085106382979;25;22;0.0319148936170213;0.468085106382979
Control.SRR15539829;46;45;0.565217391304348;20;26;0.0652173913043478;0.434782608695652
Control.SRR15539829;46;45;0.434782608695652;26;20;0.0652173913043478;0.434782608695652
Control.SRR15539829;47;45;0.382978723404255;29;18;0.117021276595745;0.382978723404255
Control.SRR15539829;46;45;0.58695652173913;19;27;0.0869565217391305;0.41304347826087
Control.SRR15539829;45;45;0.511111111111111;22;23;0.0111111111111111;0.488888888888889
Control.SRR15539829;48;45;0.583333333333333;20;28;0.0833333333333334;0.416666666666667
Control.SRR15539829;41;45;0.463414634146341;22;19;0.0365853658536585;0.463414634146341
Control.SRR15539829;43;45;0.441860465116279;24;19;0.0581395348837209;0.441860465116279
Control.SRR15539829;49;45;0.326530612244898;33;16;0.173469387755102;0.326530612244898
Control.SRR15539829;49;45;0.551020408163265;22;27;0.0510204081632653;0.448979591836735
Control.SRR15539829;49;45;0.612244897959184;19;30;0.112244897959184;0.387755102040816
Control.SRR15539829;48;45;0.4375;27;21;0.0625;0.4375
Control.SRR15539829;42;45;0.476190476190476;22;20;0.0238095238095238;0.476190476190476
Control.SRR15539829;46;45;0.521739130434783;22;24;0.0217391304347826;0.478260869565217
Control.SRR15539829;52;45;0.423076923076923;30;22;0.0769230769230769;0.423076923076923
Control.SRR15539829;46;45;0.5;23;23;0;0.5
Control.SRR15539829;43;45;0.534883720930233;20;23;0.0348837209302325;0.465116279069767
Control.SRR15539829;45;45;0.311111111111111;31;14;0.188888888888889;0.311111111111111
Control.SRR15539829;50;45;0.44;28;22;0.06;0.44
Control.SRR15539829;40;45;0.55;18;22;0.05;0.45
Control.SRR15539829;50;45;0.54;23;27;0.04;0.46
Control.SRR15539829;51;45;0.549019607843137;23;28;0.0490196078431373;0.450980392156863
Control.SRR15539829;49;45;0.551020408163265;22;27;0.0510204081632653;0.448979591836735
Control.SRR15539829;42;45;0.380952380952381;26;16;0.119047619047619;0.380952380952381
Control.SRR15539829;40;45;0.525;19;21;0.025;0.475
Control.SRR15539829;41;45;0.560975609756098;18;23;0.0609756097560976;0.439024390243902
Control.SRR15539829;42;45;0.571428571428571;18;24;0.0714285714285714;0.428571428571429
Control.SRR15539829;46;45;0.478260869565217;24;22;0.0217391304347826;0.478260869565217
Control.SRR15539829;45;45;0.444444444444444;25;20;0.0555555555555556;0.444444444444444
Control.SRR15539829;47;45;0.48936170212766;24;23;0.0106382978723404;0.48936170212766
Control.SRR15539829;47;45;0.574468085106383;20;27;0.074468085106383;0.425531914893617
Control.SRR15539829;48;45;0.541666666666667;22;26;0.0416666666666666;0.458333333333333
Control.SRR15539829;47;45;0.553191489361702;21;26;0.0531914893617021;0.446808510638298
Control.SRR15539829;43;45;0.581395348837209;18;25;0.0813953488372093;0.418604651162791
Control.SRR15539829;47;45;0.574468085106383;20;27;0.074468085106383;0.425531914893617
Control.SRR15539829;47;45;0.425531914893617;27;20;0.074468085106383;0.425531914893617
Control.SRR15539829;43;45;0.558139534883721;19;24;0.0581395348837209;0.441860465116279
Control.SRR15539829;40;45;0.525;19;21;0.025;0.475
Control.SRR15539829;51;45;0.490196078431373;26;25;0.00980392156862747;0.490196078431373
Control.SRR15539829;43;45;0.488372093023256;22;21;0.0116279069767442;0.488372093023256
Control.SRR15539829;48;45;0.333333333333333;32;16;0.166666666666667;0.333333333333333
Control.SRR15539829;46;45;0.478260869565217;24;22;0.0217391304347826;0.478260869565217
Control.SRR15539829;43;45;0.534883720930233;20;23;0.0348837209302325;0.465116279069767
Control.SRR15539829;43;45;0.511627906976744;21;22;0.0116279069767442;0.488372093023256
Control.SRR15539829;47;45;0.382978723404255;29;18;0.117021276595745;0.382978723404255
Control.SRR15539829;44;45;0.431818181818182;25;19;0.0681818181818182;0.431818181818182
Control.SRR15539829;44;45;0.5;22;22;0;0.5
Control.SRR15539829;41;45;0.439024390243902;23;18;0.0609756097560976;0.439024390243902
Control.SRR15539829;50;45;0.4;30;20;0.1;0.4
Control.SRR15539829;51;45;0.529411764705882;24;27;0.0294117647058824;0.470588235294118
Control.SRR15539829;47;45;0.446808510638298;26;21;0.0531914893617021;0.446808510638298
Control.SRR15539829;45;45;0.488888888888889;23;22;0.0111111111111111;0.488888888888889
Control.SRR15539829;45;45;0.422222222222222;26;19;0.0777777777777778;0.422222222222222
Control.SRR15539829;49;45;0.530612244897959;23;26;0.0306122448979592;0.469387755102041
Control.SRR15539829;42;45;0.404761904761905;25;17;0.0952380952380952;0.404761904761905
Control.SRR15539829;43;45;0.581395348837209;18;25;0.0813953488372093;0.418604651162791
Control.SRR15539829;41;45;0.414634146341463;24;17;0.0853658536585366;0.414634146341463
Control.SRR15539829;42;45;0.428571428571429;24;18;0.0714285714285715;0.428571428571429
Control.SRR15539829;44;45;0.590909090909091;18;26;0.0909090909090909;0.409090909090909
Control.SRR15539829;41;45;0.51219512195122;20;21;0.0121951219512195;0.48780487804878
Control.SRR15539829;43;45;0.534883720930233;20;23;0.0348837209302325;0.465116279069767
Control.SRR15539829;44;45;0.409090909090909;26;18;0.0909090909090909;0.409090909090909
Control.SRR15539829;40;45;0.55;18;22;0.05;0.45
Control.SRR15539829;41;45;0.463414634146341;22;19;0.0365853658536585;0.463414634146341
Control.SRR15539829;44;45;0.545454545454545;20;24;0.0454545454545454;0.454545454545455
Control.SRR15539829;45;45;0.622222222222222;17;28;0.122222222222222;0.377777777777778
Control.SRR15539829;42;45;0.333333333333333;28;14;0.166666666666667;0.333333333333333
Control.SRR15539829;44;45;0.545454545454545;20;24;0.0454545454545454;0.454545454545455
Control.SRR15539829;47;45;0.446808510638298;26;21;0.0531914893617021;0.446808510638298
Control.SRR15539829;43;45;0.465116279069767;23;20;0.0348837209302326;0.465116279069767
Control.SRR15539829;49;45;0.387755102040816;30;19;0.112244897959184;0.387755102040816
Control.SRR15539829;45;45;0.533333333333333;21;24;0.0333333333333333;0.466666666666667
Control.SRR15539829;48;45;0.479166666666667;25;23;0.0208333333333333;0.479166666666667
Control.SRR15539829;46;45;0.478260869565217;24;22;0.0217391304347826;0.478260869565217
Control.SRR15539829;52;45;0.557692307692308;23;29;0.0576923076923077;0.442307692307692
Control.SRR15539829;51;45;0.450980392156863;28;23;0.0490196078431372;0.450980392156863
Control.SRR15539829;52;45;0.423076923076923;30;22;0.0769230769230769;0.423076923076923
Control.SRR15539829;51;45;0.490196078431373;26;25;0.00980392156862747;0.490196078431373
Control.SRR15539829;49;45;0.551020408163265;22;27;0.0510204081632653;0.448979591836735
Control.SRR15539829;46;45;0.652173913043478;16;30;0.152173913043478;0.347826086956522
Control.SRR15539829;45;45;0.555555555555556;20;25;0.0555555555555556;0.444444444444444
Control.SRR15539829;41;45;0.48780487804878;21;20;0.0121951219512195;0.48780487804878
Control.SRR15539829;42;45;0.476190476190476;22;20;0.0238095238095238;0.476190476190476
Control.SRR15539829;44;45;0.522727272727273;21;23;0.0227272727272727;0.477272727272727
Control.SRR15539829;41;45;0.48780487804878;21;20;0.0121951219512195;0.48780487804878
Control.SRR15539829;40;45;0.475;21;19;0.025;0.475
Control.SRR15539829;43;45;0.604651162790698;17;26;0.104651162790698;0.395348837209302
Control.SRR15539829;40;45;0.45;22;18;0.05;0.45
Control.SRR15539829;44;45;0.477272727272727;23;21;0.0227272727272727;0.477272727272727
Control.SRR15539829;46;45;0.58695652173913;19;27;0.0869565217391305;0.41304347826087
Control.SRR15539829;46;45;0.478260869565217;24;22;0.0217391304347826;0.478260869565217
Control.SRR15539829;46;45;0.58695652173913;19;27;0.0869565217391305;0.41304347826087
Control.SRR15539829;49;45;0.530612244897959;23;26;0.0306122448979592;0.469387755102041
Control.SRR15539829;51;45;0.549019607843137;23;28;0.0490196078431373;0.450980392156863
Control.SRR15539829;50;45;0.44;28;22;0.06;0.44
Control.SRR15539829;50;45;0.46;27;23;0.04;0.46
Control.SRR15539829;40;45;0.5;20;20;0;0.5
Control.SRR15539829;41;45;0.536585365853659;19;22;0.0365853658536586;0.463414634146341
Control.SRR15539829;45;45;0.555555555555556;20;25;0.0555555555555556;0.444444444444444
Control.SRR15539829;49;45;0.530612244897959;23;26;0.0306122448979592;0.469387755102041
Control.SRR15539829;42;45;0.476190476190476;22;20;0.0238095238095238;0.476190476190476
Control.SRR15539829;51;45;0.568627450980392;22;29;0.0686274509803921;0.431372549019608
Control.SRR15539829;48;45;0.5;24;24;0;0.5
Control.SRR15539829;45;45;0.555555555555556;20;25;0.0555555555555556;0.444444444444444
Control.SRR15539829;42;45;0.547619047619048;19;23;0.0476190476190477;0.452380952380952
Control.SRR15539829;41;45;0.439024390243902;23;18;0.0609756097560976;0.439024390243902
Control.SRR15539829;44;45;0.5;22;22;0;0.5
Control.SRR15539829;52;45;0.461538461538462;28;24;0.0384615384615384;0.461538461538462
Control.SRR15539829;41;45;0.390243902439024;25;16;0.109756097560976;0.390243902439024
Control.SRR15539829;47;45;0.574468085106383;20;27;0.074468085106383;0.425531914893617
Control.SRR15539829;51;45;0.313725490196078;35;16;0.186274509803922;0.313725490196078
Control.SRR15539829;42;45;0.452380952380952;23;19;0.0476190476190476;0.452380952380952
Control.SRR15539829;47;45;0.404255319148936;28;19;0.0957446808510639;0.404255319148936
Control.SRR15539829;41;45;0.609756097560976;16;25;0.109756097560976;0.390243902439024
Control.SRR15539829;48;45;0.5;24;24;0;0.5
Control.SRR15539829;43;45;0.441860465116279;24;19;0.0581395348837209;0.441860465116279
Control.SRR15539829;44;45;0.477272727272727;23;21;0.0227272727272727;0.477272727272727
Control.SRR15539829;49;45;0.428571428571429;28;21;0.0714285714285715;0.428571428571429
Control.SRR15539829;52;45;0.5;26;26;0;0.5
Control.SRR15539829;49;45;0.428571428571429;28;21;0.0714285714285715;0.428571428571429
Control.SRR15539829;46;45;0.478260869565217;24;22;0.0217391304347826;0.478260869565217
Control.SRR15539829;41;45;0.51219512195122;20;21;0.0121951219512195;0.48780487804878
Control.SRR15539829;44;45;0.681818181818182;14;30;0.181818181818182;0.318181818181818
Control.SRR15539829;45;45;0.6;18;27;0.1;0.4
Control.SRR15539829;48;45;0.479166666666667;25;23;0.0208333333333333;0.479166666666667
Control.SRR15539829;40;45;0.5;20;20;0;0.5
Control.SRR15539829;46;45;0.456521739130435;25;21;0.0434782608695652;0.456521739130435
Control.SRR15539829;52;45;0.403846153846154;31;21;0.0961538461538461;0.403846153846154
Control.SRR15539829;52;45;0.557692307692308;23;29;0.0576923076923077;0.442307692307692
Control.SRR15539829;48;45;0.416666666666667;28;20;0.0833333333333333;0.416666666666667
Control.SRR15539829;49;45;0.469387755102041;26;23;0.0306122448979592;0.469387755102041
Control.SRR15539829;47;45;0.468085106382979;25;22;0.0319148936170213;0.468085106382979
Control.SRR15539829;44;45;0.522727272727273;21;23;0.0227272727272727;0.477272727272727
Control.SRR15539829;51;45;0.529411764705882;24;27;0.0294117647058824;0.470588235294118
Control.SRR15539829;50;45;0.54;23;27;0.04;0.46
Control.SRR15539829;45;45;0.422222222222222;26;19;0.0777777777777778;0.422222222222222
Control.SRR15539829;46;45;0.565217391304348;20;26;0.0652173913043478;0.434782608695652
Control.SRR15539829;49;45;0.489795918367347;25;24;0.0102040816326531;0.489795918367347
Control.SRR15539829;49;45;0.387755102040816;30;19;0.112244897959184;0.387755102040816
Control.SRR15539829;51;45;0.509803921568627;25;26;0.00980392156862742;0.490196078431373
Control.SRR15539829;43;45;0.558139534883721;19;24;0.0581395348837209;0.441860465116279
Control.SRR15539829;42;45;0.452380952380952;23;19;0.0476190476190476;0.452380952380952
Control.SRR15539829;45;45;0.488888888888889;23;22;0.0111111111111111;0.488888888888889
Control.SRR15539829;43;45;0.418604651162791;25;18;0.0813953488372093;0.418604651162791
Control.SRR15539829;42;45;0.595238095238095;17;25;0.0952380952380952;0.404761904761905
Control.SRR15539829;50;45;0.52;24;26;0.02;0.48
Control.SRR15539829;44;45;0.522727272727273;21;23;0.0227272727272727;0.477272727272727
Control.SRR15539829;49;45;0.469387755102041;26;23;0.0306122448979592;0.469387755102041
Control.SRR15539829;47;45;0.425531914893617;27;20;0.074468085106383;0.425531914893617
Control.SRR15539829;45;45;0.644444444444444;16;29;0.144444444444444;0.355555555555556
Control.SRR15539829;42;45;0.547619047619048;19;23;0.0476190476190477;0.452380952380952
Control.SRR15539829;40;45;0.45;22;18;0.05;0.45
Control.SRR15539829;52;45;0.576923076923077;22;30;0.0769230769230769;0.423076923076923
Control.SRR15539829;49;45;0.346938775510204;32;17;0.153061224489796;0.346938775510204
Control.SRR15539829;49;45;0.387755102040816;30;19;0.112244897959184;0.387755102040816
Control.SRR15539829;46;45;0.434782608695652;26;20;0.0652173913043478;0.434782608695652
Control.SRR15539829;40;45;0.525;19;21;0.025;0.475
Control.SRR15539829;49;45;0.551020408163265;22;27;0.0510204081632653;0.448979591836735
Control.SRR15539829;47;45;0.531914893617021;22;25;0.0319148936170213;0.468085106382979
Control.SRR15539829;46;45;0.456521739130435;25;21;0.0434782608695652;0.456521739130435
Control.SRR15539829;41;45;0.585365853658537;17;24;0.0853658536585366;0.414634146341463
Control.SRR15539829;44;45;0.568181818181818;19;25;0.0681818181818182;0.431818181818182
Control.SRR15539829;42;45;0.571428571428571;18;24;0.0714285714285714;0.428571428571429
Control.SRR15539829;46;45;0.5;23;23;0;0.5
Control.SRR15539829;47;45;0.51063829787234;23;24;0.0106382978723404;0.48936170212766
Control.SRR15539829;43;45;0.511627906976744;21;22;0.0116279069767442;0.488372093023256
Control.SRR15539829;52;45;0.557692307692308;23;29;0.0576923076923077;0.442307692307692
Control.SRR15539829;52;45;0.480769230769231;27;25;0.0192307692307692;0.480769230769231
Control.SRR15539829;52;45;0.692307692307692;16;36;0.192307692307692;0.307692307692308
Control.SRR15539829;42;45;0.5;21;21;0;0.5
Control.SRR15539829;49;45;0.530612244897959;23;26;0.0306122448979592;0.469387755102041
Control.SRR15539829;51;45;0.568627450980392;22;29;0.0686274509803921;0.431372549019608
Control.SRR15539829;49;45;0.530612244897959;23;26;0.0306122448979592;0.469387755102041
Control.SRR15539829;46;45;0.41304347826087;27;19;0.0869565217391304;0.41304347826087
Control.SRR15539829;43;45;0.465116279069767;23;20;0.0348837209302326;0.465116279069767
Control.SRR15539829;46;45;0.5;23;23;0;0.5
Control.SRR15539829;49;45;0.653061224489796;17;32;0.153061224489796;0.346938775510204
Control.SRR15539829;47;45;0.531914893617021;22;25;0.0319148936170213;0.468085106382979
Control.SRR15539829;46;45;0.5;23;23;0;0.5
Control.SRR15539829;47;45;0.553191489361702;21;26;0.0531914893617021;0.446808510638298
Control.SRR15539829;42;45;0.428571428571429;24;18;0.0714285714285715;0.428571428571429
Control.SRR15539829;41;45;0.414634146341463;24;17;0.0853658536585366;0.414634146341463
Control.SRR15539829;40;45;0.475;21;19;0.025;0.475
Control.SRR15539829;50;45;0.46;27;23;0.04;0.46
Control.SRR15539829;41;45;0.439024390243902;23;18;0.0609756097560976;0.439024390243902
Control.SRR15539829;51;45;0.509803921568627;25;26;0.00980392156862742;0.490196078431373
Control.SRR15539829;48;45;0.479166666666667;25;23;0.0208333333333333;0.479166666666667
Control.SRR15539829;50;45;0.46;27;23;0.04;0.46
Control.SRR15539829;45;45;0.466666666666667;24;21;0.0333333333333333;0.466666666666667
Control.SRR15539829;51;45;0.490196078431373;26;25;0.00980392156862747;0.490196078431373
Control.SRR15539829;49;45;0.510204081632653;24;25;0.0102040816326531;0.489795918367347
Control.SRR15539829;50;45;0.46;27;23;0.04;0.46
Control.SRR15539829;41;45;0.439024390243902;23;18;0.0609756097560976;0.439024390243902
Control.SRR15539829;47;45;0.468085106382979;25;22;0.0319148936170213;0.468085106382979
Control.SRR15539829;51;45;0.588235294117647;21;30;0.0882352941176471;0.411764705882353
Control.SRR15539829;47;45;0.531914893617021;22;25;0.0319148936170213;0.468085106382979
Control.SRR15539829;43;45;0.581395348837209;18;25;0.0813953488372093;0.418604651162791
Control.SRR15539829;40;45;0.425;23;17;0.075;0.425
Control.SRR15539829;45;45;0.466666666666667;24;21;0.0333333333333333;0.466666666666667
Control.SRR15539829;43;45;0.488372093023256;22;21;0.0116279069767442;0.488372093023256
Control.SRR15539829;41;45;0.51219512195122;20;21;0.0121951219512195;0.48780487804878
Control.SRR15539829;44;45;0.590909090909091;18;26;0.0909090909090909;0.409090909090909
Control.SRR15539829;45;45;0.422222222222222;26;19;0.0777777777777778;0.422222222222222
Control.SRR15539829;45;45;0.4;27;18;0.1;0.4
Control.SRR15539829;47;45;0.51063829787234;23;24;0.0106382978723404;0.48936170212766
Control.SRR15539829;46;45;0.521739130434783;22;24;0.0217391304347826;0.478260869565217
Control.SRR15539829;40;45;0.6;16;24;0.1;0.4
Control.SRR15539829;52;45;0.519230769230769;25;27;0.0192307692307693;0.480769230769231
Control.SRR15539829;41;45;0.365853658536585;26;15;0.134146341463415;0.365853658536585
Control.SRR15539829;43;45;0.465116279069767;23;20;0.0348837209302326;0.465116279069767
Control.SRR15539829;51;45;0.372549019607843;32;19;0.127450980392157;0.372549019607843
Control.SRR15539829;40;45;0.375;25;15;0.125;0.375
Control.SRR15539829;47;45;0.595744680851064;19;28;0.0957446808510638;0.404255319148936
Control.SRR15539829;49;45;0.63265306122449;18;31;0.13265306122449;0.36734693877551
Control.SRR15539829;46;45;0.478260869565217;24;22;0.0217391304347826;0.478260869565217
Control.SRR15539829;40;45;0.525;19;21;0.025;0.475
Control.SRR15539829;45;45;0.511111111111111;22;23;0.0111111111111111;0.488888888888889
Control.SRR15539829;46;45;0.456521739130435;25;21;0.0434782608695652;0.456521739130435
Control.SRR15539829;43;45;0.511627906976744;21;22;0.0116279069767442;0.488372093023256
Control.SRR15539829;45;45;0.4;27;18;0.1;0.4
Control.SRR15539829;48;45;0.5625;21;27;0.0625;0.4375
Control.SRR15539829;42;45;0.523809523809524;20;22;0.0238095238095238;0.476190476190476
Control.SRR15539829;40;45;0.45;22;18;0.05;0.45
Control.SRR15539829;40;45;0.425;23;17;0.075;0.425
Control.SRR15539829;44;45;0.568181818181818;19;25;0.0681818181818182;0.431818181818182
Control.SRR15539829;48;45;0.541666666666667;22;26;0.0416666666666666;0.458333333333333
Control.SRR15539829;40;45;0.45;22;18;0.05;0.45
Control.SRR15539829;47;45;0.51063829787234;23;24;0.0106382978723404;0.48936170212766
Control.SRR15539829;41;45;0.560975609756098;18;23;0.0609756097560976;0.439024390243902
Control.SRR15539829;43;45;0.488372093023256;22;21;0.0116279069767442;0.488372093023256
Control.SRR15539829;43;45;0.418604651162791;25;18;0.0813953488372093;0.418604651162791
Control.SRR15539829;43;45;0.511627906976744;21;22;0.0116279069767442;0.488372093023256
Control.SRR15539829;41;45;0.463414634146341;22;19;0.0365853658536585;0.463414634146341
Control.SRR15539829;44;45;0.477272727272727;23;21;0.0227272727272727;0.477272727272727
Control.SRR15539829;46;45;0.456521739130435;25;21;0.0434782608695652;0.456521739130435
Control.SRR15539829;40;45;0.6;16;24;0.1;0.4
Control.SRR15539829;47;45;0.617021276595745;18;29;0.117021276595745;0.382978723404255
Control.SRR15539829;41;45;0.463414634146341;22;19;0.0365853658536585;0.463414634146341
Control.SRR15539829;42;45;0.452380952380952;23;19;0.0476190476190476;0.452380952380952
Control.SRR15539829;43;45;0.534883720930233;20;23;0.0348837209302325;0.465116279069767
Control.SRR15539829;44;45;0.568181818181818;19;25;0.0681818181818182;0.431818181818182
Control.SRR15539829;43;45;0.651162790697674;15;28;0.151162790697674;0.348837209302326
Control.SRR15539829;46;45;0.456521739130435;25;21;0.0434782608695652;0.456521739130435
Control.SRR15539829;40;45;0.55;18;22;0.05;0.45
Control.SRR15539829;47;45;0.340425531914894;31;16;0.159574468085106;0.340425531914894
Control.SRR15539829;51;45;0.431372549019608;29;22;0.0686274509803921;0.431372549019608
Control.SRR15539829;41;45;0.439024390243902;23;18;0.0609756097560976;0.439024390243902
Control.SRR15539829;43;45;0.627906976744186;16;27;0.127906976744186;0.372093023255814
Control.SRR15539829;48;45;0.604166666666667;19;29;0.104166666666667;0.395833333333333
Control.SRR15539829;51;45;0.490196078431373;26;25;0.00980392156862747;0.490196078431373
Control.SRR15539829;45;45;0.555555555555556;20;25;0.0555555555555556;0.444444444444444
Control.SRR15539829;50;45;0.54;23;27;0.04;0.46
Control.SRR15539829;50;45;0.4;30;20;0.1;0.4
Control.SRR15539829;47;45;0.468085106382979;25;22;0.0319148936170213;0.468085106382979
Control.SRR15539829;49;45;0.591836734693878;20;29;0.0918367346938775;0.408163265306122
Control.SRR15539829;48;45;0.520833333333333;23;25;0.0208333333333334;0.479166666666667
Control.SRR15539829;41;45;0.365853658536585;26;15;0.134146341463415;0.365853658536585
Control.SRR15539829;41;45;0.341463414634146;27;14;0.158536585365854;0.341463414634146
Control.SRR15539829;45;45;0.622222222222222;17;28;0.122222222222222;0.377777777777778
Control.SRR15539829;47;45;0.595744680851064;19;28;0.0957446808510638;0.404255319148936
Control.SRR15539829;42;45;0.476190476190476;22;20;0.0238095238095238;0.476190476190476
Control.SRR15539829;44;45;0.522727272727273;21;23;0.0227272727272727;0.477272727272727
Control.SRR15539829;51;45;0.509803921568627;25;26;0.00980392156862742;0.490196078431373
Control.SRR15539829;44;45;0.454545454545455;24;20;0.0454545454545455;0.454545454545455
Control.SRR15539829;40;45;0.475;21;19;0.025;0.475
Control.SRR15539829;43;45;0.348837209302326;28;15;0.151162790697674;0.348837209302326
Control.SRR15539829;40;45;0.375;25;15;0.125;0.375
Control.SRR15539829;45;45;0.533333333333333;21;24;0.0333333333333333;0.466666666666667
Control.SRR15539829;46;45;0.369565217391304;29;17;0.130434782608696;0.369565217391304
Control.SRR15539829;42;45;0.404761904761905;25;17;0.0952380952380952;0.404761904761905
Control.SRR15539829;40;45;0.475;21;19;0.025;0.475
Control.SRR15539829;43;45;0.674418604651163;14;29;0.174418604651163;0.325581395348837
Control.SRR15539829;40;45;0.55;18;22;0.05;0.45
Control.SRR15539829;43;45;0.511627906976744;21;22;0.0116279069767442;0.488372093023256
Control.SRR15539829;49;45;0.387755102040816;30;19;0.112244897959184;0.387755102040816
Control.SRR15539829;52;45;0.442307692307692;29;23;0.0576923076923077;0.442307692307692
Control.SRR15539829;49;45;0.530612244897959;23;26;0.0306122448979592;0.469387755102041
Control.SRR15539829;44;45;0.5;22;22;0;0.5
Control.SRR15539829;42;45;0.523809523809524;20;22;0.0238095238095238;0.476190476190476
Control.SRR15539829;45;45;0.488888888888889;23;22;0.0111111111111111;0.488888888888889
Control.SRR15539829;46;45;0.543478260869565;21;25;0.0434782608695652;0.456521739130435
Control.SRR15539829;46;45;0.41304347826087;27;19;0.0869565217391304;0.41304347826087
Control.SRR15539829;50;45;0.52;24;26;0.02;0.48
Control.SRR15539829;41;45;0.390243902439024;25;16;0.109756097560976;0.390243902439024
Control.SRR15539829;45;45;0.466666666666667;24;21;0.0333333333333333;0.466666666666667
Control.SRR15539829;41;45;0.414634146341463;24;17;0.0853658536585366;0.414634146341463
Control.SRR15539829;40;45;0.55;18;22;0.05;0.45
Control.SRR15539829;41;45;0.658536585365854;14;27;0.158536585365854;0.341463414634146
Control.SRR15539829;47;45;0.468085106382979;25;22;0.0319148936170213;0.468085106382979
Control.SRR15539829;48;45;0.416666666666667;28;20;0.0833333333333333;0.416666666666667
Control.SRR15539829;40;45;0.575;17;23;0.075;0.425
Control.SRR15539829;40;45;0.6;16;24;0.1;0.4
Control.SRR15539829;40;45;0.525;19;21;0.025;0.475
Control.SRR15539829;43;45;0.465116279069767;23;20;0.0348837209302326;0.465116279069767
Control.SRR15539829;48;45;0.520833333333333;23;25;0.0208333333333334;0.479166666666667
Control.SRR15539829;50;45;0.46;27;23;0.04;0.46
Control.SRR15539829;52;45;0.423076923076923;30;22;0.0769230769230769;0.423076923076923
Control.SRR15539829;41;45;0.51219512195122;20;21;0.0121951219512195;0.48780487804878
Control.SRR15539829;47;45;0.48936170212766;24;23;0.0106382978723404;0.48936170212766
Control.SRR15539829;47;45;0.425531914893617;27;20;0.074468085106383;0.425531914893617
Control.SRR15539829;45;45;0.6;18;27;0.1;0.4
Control.SRR15539829;47;45;0.51063829787234;23;24;0.0106382978723404;0.48936170212766
Control.SRR15539829;52;45;0.538461538461538;24;28;0.0384615384615384;0.461538461538462
Control.SRR15539829;46;45;0.456521739130435;25;21;0.0434782608695652;0.456521739130435
Control.SRR15539829;46;45;0.478260869565217;24;22;0.0217391304347826;0.478260869565217
Control.SRR15539829;50;45;0.6;20;30;0.1;0.4
Control.SRR15539829;44;45;0.5;22;22;0;0.5
Control.SRR15539829;45;45;0.666666666666667;15;30;0.166666666666667;0.333333333333333
Control.SRR15539829;50;45;0.68;16;34;0.18;0.32
Control.SRR15539829;50;45;0.54;23;27;0.04;0.46
Control.SRR15539829;52;45;0.384615384615385;32;20;0.115384615384615;0.384615384615385
Control.SRR15539829;47;45;0.446808510638298;26;21;0.0531914893617021;0.446808510638298
Control.SRR15539829;45;45;0.466666666666667;24;21;0.0333333333333333;0.466666666666667
Control.SRR15539829;45;45;0.422222222222222;26;19;0.0777777777777778;0.422222222222222
Control.SRR15539829;46;45;0.369565217391304;29;17;0.130434782608696;0.369565217391304
Control.SRR15539829;42;45;0.476190476190476;22;20;0.0238095238095238;0.476190476190476
Control.SRR15539829;41;45;0.560975609756098;18;23;0.0609756097560976;0.439024390243902
Control.SRR15539829;41;45;0.51219512195122;20;21;0.0121951219512195;0.48780487804878
Control.SRR15539829;44;45;0.477272727272727;23;21;0.0227272727272727;0.477272727272727
Control.SRR15539829;46;45;0.521739130434783;22;24;0.0217391304347826;0.478260869565217
Control.SRR15539829;48;45;0.5625;21;27;0.0625;0.4375
Control.SRR15539829;41;45;0.463414634146341;22;19;0.0365853658536585;0.463414634146341
Control.SRR15539829;41;45;0.317073170731707;28;13;0.182926829268293;0.317073170731707
Control.SRR15539829;48;45;0.583333333333333;20;28;0.0833333333333334;0.416666666666667
Control.SRR15539829;45;45;0.555555555555556;20;25;0.0555555555555556;0.444444444444444
Control.SRR15539829;47;45;0.468085106382979;25;22;0.0319148936170213;0.468085106382979
Control.SRR15539829;50;45;0.46;27;23;0.04;0.46
Control.SRR15539829;41;45;0.48780487804878;21;20;0.0121951219512195;0.48780487804878
Control.SRR15539829;47;45;0.595744680851064;19;28;0.0957446808510638;0.404255319148936
Control.SRR15539829;49;45;0.530612244897959;23;26;0.0306122448979592;0.469387755102041
Control.SRR15539829;47;45;0.425531914893617;27;20;0.074468085106383;0.425531914893617
Control.SRR15539829;44;45;0.363636363636364;28;16;0.136363636363636;0.363636363636364
Control.SRR15539829;43;45;0.465116279069767;23;20;0.0348837209302326;0.465116279069767
Control.SRR15539829;49;45;0.408163265306122;29;20;0.0918367346938775;0.408163265306122
Control.SRR15539829;47;45;0.531914893617021;22;25;0.0319148936170213;0.468085106382979
Control.SRR15539829;52;45;0.480769230769231;27;25;0.0192307692307692;0.480769230769231
Control.SRR15539829;51;45;0.431372549019608;29;22;0.0686274509803921;0.431372549019608
Control.SRR15539829;41;45;0.560975609756098;18;23;0.0609756097560976;0.439024390243902
Control.SRR15539829;41;45;0.536585365853659;19;22;0.0365853658536586;0.463414634146341
Control.SRR15539829;41;45;0.560975609756098;18;23;0.0609756097560976;0.439024390243902
Control.SRR15539829;40;45;0.575;17;23;0.075;0.425
Control.SRR15539829;43;45;0.488372093023256;22;21;0.0116279069767442;0.488372093023256
Control.SRR15539829;43;45;0.511627906976744;21;22;0.0116279069767442;0.488372093023256
Control.SRR15539829;49;45;0.551020408163265;22;27;0.0510204081632653;0.448979591836735
Control.SRR15539829;45;45;0.511111111111111;22;23;0.0111111111111111;0.488888888888889
Control.SRR15539829;40;45;0.5;20;20;0;0.5
Control.SRR15539829;47;45;0.48936170212766;24;23;0.0106382978723404;0.48936170212766
Control.SRR15539829;50;45;0.52;24;26;0.02;0.48
Control.SRR15539829;43;45;0.581395348837209;18;25;0.0813953488372093;0.418604651162791
Control.SRR15539829;45;45;0.511111111111111;22;23;0.0111111111111111;0.488888888888889
Control.SRR15539829;42;45;0.476190476190476;22;20;0.0238095238095238;0.476190476190476
Control.SRR15539829;52;45;0.442307692307692;29;23;0.0576923076923077;0.442307692307692
Control.SRR15539829;41;45;0.390243902439024;25;16;0.109756097560976;0.390243902439024
Control.SRR15539829;49;45;0.551020408163265;22;27;0.0510204081632653;0.448979591836735
Control.SRR15539829;50;45;0.52;24;26;0.02;0.48
Control.SRR15539829;40;45;0.45;22;18;0.05;0.45
Control.SRR15539829;52;45;0.461538461538462;28;24;0.0384615384615384;0.461538461538462
Control.SRR15539829;46;45;0.434782608695652;26;20;0.0652173913043478;0.434782608695652
Control.SRR15539829;42;45;0.452380952380952;23;19;0.0476190476190476;0.452380952380952
Control.SRR15539829;40;45;0.575;17;23;0.075;0.425
Control.SRR15539829;51;45;0.450980392156863;28;23;0.0490196078431372;0.450980392156863
Control.SRR15539829;41;45;0.414634146341463;24;17;0.0853658536585366;0.414634146341463
Control.SRR15539829;42;45;0.595238095238095;17;25;0.0952380952380952;0.404761904761905
Control.SRR15539829;41;45;0.609756097560976;16;25;0.109756097560976;0.390243902439024
Control.SRR15539829;50;45;0.44;28;22;0.06;0.44
Control.SRR15539829;43;45;0.558139534883721;19;24;0.0581395348837209;0.441860465116279
Control.SRR15539829;52;45;0.538461538461538;24;28;0.0384615384615384;0.461538461538462
Control.SRR15539829;44;45;0.522727272727273;21;23;0.0227272727272727;0.477272727272727
Control.SRR15539829;49;45;0.530612244897959;23;26;0.0306122448979592;0.469387755102041
Control.SRR15539829;51;45;0.529411764705882;24;27;0.0294117647058824;0.470588235294118
Control.SRR15539829;49;45;0.510204081632653;24;25;0.0102040816326531;0.489795918367347
Control.SRR15539829;49;45;0.530612244897959;23;26;0.0306122448979592;0.469387755102041
Control.SRR15539829;48;45;0.416666666666667;28;20;0.0833333333333333;0.416666666666667
Control.SRR15539829;46;45;0.478260869565217;24;22;0.0217391304347826;0.478260869565217
Control.SRR15539829;45;45;0.511111111111111;22;23;0.0111111111111111;0.488888888888889
Control.SRR15539829;48;45;0.5;24;24;0;0.5
Control.SRR15539829;41;45;0.536585365853659;19;22;0.0365853658536586;0.463414634146341
Control.SRR15539829;50;45;0.58;21;29;0.08;0.42
Control.SRR15539829;41;45;0.365853658536585;26;15;0.134146341463415;0.365853658536585
Control.SRR15539829;41;45;0.463414634146341;22;19;0.0365853658536585;0.463414634146341
Control.SRR15539829;44;45;0.590909090909091;18;26;0.0909090909090909;0.409090909090909
Control.SRR15539829;40;45;0.55;18;22;0.05;0.45
Control.SRR15539829;47;45;0.382978723404255;29;18;0.117021276595745;0.382978723404255
Control.SRR15539829;43;45;0.395348837209302;26;17;0.104651162790698;0.395348837209302
Control.SRR15539829;45;45;0.533333333333333;21;24;0.0333333333333333;0.466666666666667
Control.SRR15539829;40;45;0.4;24;16;0.1;0.4
Control.SRR15539829;44;45;0.522727272727273;21;23;0.0227272727272727;0.477272727272727
Control.SRR15539829;48;45;0.395833333333333;29;19;0.104166666666667;0.395833333333333
Control.SRR15539829;40;45;0.525;19;21;0.025;0.475
Control.SRR15539829;45;45;0.555555555555556;20;25;0.0555555555555556;0.444444444444444
Control.SRR15539829;48;45;0.5625;21;27;0.0625;0.4375
Control.SRR15539829;43;45;0.511627906976744;21;22;0.0116279069767442;0.488372093023256
Control.SRR15539829;43;45;0.441860465116279;24;19;0.0581395348837209;0.441860465116279
Control.SRR15539829;47;45;0.468085106382979;25;22;0.0319148936170213;0.468085106382979
Control.SRR15539829;46;45;0.456521739130435;25;21;0.0434782608695652;0.456521739130435
Control.SRR15539829;43;45;0.604651162790698;17;26;0.104651162790698;0.395348837209302
Control.SRR15539829;43;45;0.534883720930233;20;23;0.0348837209302325;0.465116279069767
Control.SRR15539829;44;45;0.522727272727273;21;23;0.0227272727272727;0.477272727272727
Control.SRR15539829;42;45;0.547619047619048;19;23;0.0476190476190477;0.452380952380952
Control.SRR15539829;44;45;0.477272727272727;23;21;0.0227272727272727;0.477272727272727
Control.SRR15539829;42;45;0.547619047619048;19;23;0.0476190476190477;0.452380952380952
Control.SRR15539829;43;45;0.674418604651163;14;29;0.174418604651163;0.325581395348837
Control.SRR15539829;39;45;0.58974358974359;16;23;0.0897435897435898;0.41025641025641
Control.SRR15539829;41;45;0.463414634146341;22;19;0.0365853658536585;0.463414634146341
Control.SRR15539829;47;45;0.51063829787234;23;24;0.0106382978723404;0.48936170212766
Control.SRR15539829;39;45;0.435897435897436;22;17;0.0641025641025641;0.435897435897436
Control.SRR15539829;45;45;0.511111111111111;22;23;0.0111111111111111;0.488888888888889
Control.SRR15539829;43;45;0.558139534883721;19;24;0.0581395348837209;0.441860465116279
Control.SRR15539829;39;45;0.461538461538462;21;18;0.0384615384615384;0.461538461538462
Control.SRR15539829;44;45;0.590909090909091;18;26;0.0909090909090909;0.409090909090909
Control.SRR15539829;39;45;0.538461538461538;18;21;0.0384615384615384;0.461538461538462
Control.SRR15539829;42;45;0.523809523809524;20;22;0.0238095238095238;0.476190476190476
Control.SRR15539829;43;45;0.511627906976744;21;22;0.0116279069767442;0.488372093023256
Control.SRR15539829;41;45;0.585365853658537;17;24;0.0853658536585366;0.414634146341463
Control.SRR15539829;39;45;0.435897435897436;22;17;0.0641025641025641;0.435897435897436
Control.SRR15539829;42;45;0.523809523809524;20;22;0.0238095238095238;0.476190476190476
Control.SRR15539829;49;45;0.571428571428571;21;28;0.0714285714285714;0.428571428571429
Control.SRR15539829;39;45;0.512820512820513;19;20;0.0128205128205128;0.487179487179487
Control.SRR15539829;49;45;0.489795918367347;25;24;0.0102040816326531;0.489795918367347
Control.SRR15539829;44;45;0.522727272727273;21;23;0.0227272727272727;0.477272727272727
Control.SRR15539829;49;45;0.571428571428571;21;28;0.0714285714285714;0.428571428571429
Control.SRR15539829;48;45;0.520833333333333;23;25;0.0208333333333334;0.479166666666667
Control.SRR15539829;41;45;0.439024390243902;23;18;0.0609756097560976;0.439024390243902
Control.SRR15539829;44;45;0.522727272727273;21;23;0.0227272727272727;0.477272727272727
Control.SRR15539829;51;45;0.392156862745098;31;20;0.107843137254902;0.392156862745098
Control.SRR15539829;46;45;0.347826086956522;30;16;0.152173913043478;0.347826086956522
Control.SRR15539829;44;45;0.522727272727273;21;23;0.0227272727272727;0.477272727272727
Control.SRR15539829;40;45;0.525;19;21;0.025;0.475
Control.SRR15539829;47;45;0.638297872340426;17;30;0.138297872340426;0.361702127659574
Control.SRR15539829;45;45;0.466666666666667;24;21;0.0333333333333333;0.466666666666667
Control.SRR15539829;41;45;0.390243902439024;25;16;0.109756097560976;0.390243902439024
Control.SRR15539829;46;45;0.521739130434783;22;24;0.0217391304347826;0.478260869565217
Control.SRR15539829;48;45;0.458333333333333;26;22;0.0416666666666667;0.458333333333333
Control.SRR15539829;44;45;0.636363636363636;16;28;0.136363636363636;0.363636363636364
Control.SRR15539829;45;45;0.488888888888889;23;22;0.0111111111111111;0.488888888888889
Control.SRR15539829;48;45;0.4375;27;21;0.0625;0.4375
Control.SRR15539829;44;45;0.454545454545455;24;20;0.0454545454545455;0.454545454545455
Control.SRR15539829;40;45;0.5;20;20;0;0.5
Control.SRR15539829;46;45;0.434782608695652;26;20;0.0652173913043478;0.434782608695652
Control.SRR15539829;42;45;0.595238095238095;17;25;0.0952380952380952;0.404761904761905
Control.SRR15539829;48;45;0.520833333333333;23;25;0.0208333333333334;0.479166666666667
Control.SRR15539829;42;45;0.380952380952381;26;16;0.119047619047619;0.380952380952381
Control.SRR15539829;43;45;0.581395348837209;18;25;0.0813953488372093;0.418604651162791
Control.SRR15539829;39;45;0.41025641025641;23;16;0.0897435897435898;0.41025641025641
Control.SRR15539829;42;45;0.452380952380952;23;19;0.0476190476190476;0.452380952380952
Control.SRR15539829;40;45;0.45;22;18;0.05;0.45
Control.SRR15539829;43;45;0.441860465116279;24;19;0.0581395348837209;0.441860465116279
Control.SRR15539829;49;45;0.408163265306122;29;20;0.0918367346938775;0.408163265306122
Control.SRR15539829;48;45;0.416666666666667;28;20;0.0833333333333333;0.416666666666667
Control.SRR15539829;50;45;0.66;17;33;0.16;0.34
Control.SRR15539829;44;45;0.522727272727273;21;23;0.0227272727272727;0.477272727272727
Control.SRR15539829;44;45;0.318181818181818;30;14;0.181818181818182;0.318181818181818
Control.SRR15539829;45;45;0.488888888888889;23;22;0.0111111111111111;0.488888888888889
Control.SRR15539829;41;45;0.585365853658537;17;24;0.0853658536585366;0.414634146341463
Control.SRR15539829;39;45;0.564102564102564;17;22;0.0641025641025641;0.435897435897436
Control.SRR15539829;44;45;0.5;22;22;0;0.5
Control.SRR15539829;50;45;0.46;27;23;0.04;0.46
Control.SRR15539829;39;45;0.461538461538462;21;18;0.0384615384615384;0.461538461538462
Control.SRR15539829;40;45;0.625;15;25;0.125;0.375
Control.SRR15539829;44;45;0.431818181818182;25;19;0.0681818181818182;0.431818181818182
Control.SRR15539829;40;45;0.55;18;22;0.05;0.45
Control.SRR15539829;43;45;0.418604651162791;25;18;0.0813953488372093;0.418604651162791
Control.SRR15539829;49;45;0.63265306122449;18;31;0.13265306122449;0.36734693877551
Control.SRR15539829;45;45;0.511111111111111;22;23;0.0111111111111111;0.488888888888889
Control.SRR15539829;40;45;0.575;17;23;0.075;0.425
Control.SRR15539829;50;45;0.38;31;19;0.12;0.38
Control.SRR15539829;40;45;0.525;19;21;0.025;0.475
Control.SRR15539829;43;45;0.441860465116279;24;19;0.0581395348837209;0.441860465116279
Control.SRR15539829;47;45;0.51063829787234;23;24;0.0106382978723404;0.48936170212766
Control.SRR15539829;46;45;0.543478260869565;21;25;0.0434782608695652;0.456521739130435
Control.SRR15539829;43;45;0.511627906976744;21;22;0.0116279069767442;0.488372093023256
Control.SRR15539829;42;45;0.452380952380952;23;19;0.0476190476190476;0.452380952380952
Control.SRR15539829;44;45;0.590909090909091;18;26;0.0909090909090909;0.409090909090909
Control.SRR15539829;50;45;0.58;21;29;0.08;0.42
Control.SRR15539829;41;45;0.463414634146341;22;19;0.0365853658536585;0.463414634146341
Control.SRR15539829;45;45;0.511111111111111;22;23;0.0111111111111111;0.488888888888889
Control.SRR15539829;49;45;0.591836734693878;20;29;0.0918367346938775;0.408163265306122
Control.SRR15539829;46;45;0.41304347826087;27;19;0.0869565217391304;0.41304347826087
Control.SRR15539829;40;45;0.475;21;19;0.025;0.475
Control.SRR15539829;43;45;0.511627906976744;21;22;0.0116279069767442;0.488372093023256
Control.SRR15539829;46;45;0.521739130434783;22;24;0.0217391304347826;0.478260869565217
Control.SRR15539829;42;45;0.523809523809524;20;22;0.0238095238095238;0.476190476190476
Control.SRR15539829;41;45;0.390243902439024;25;16;0.109756097560976;0.390243902439024
Control.SRR15539829;44;45;0.5;22;22;0;0.5
Control.SRR15539829;48;45;0.458333333333333;26;22;0.0416666666666667;0.458333333333333
Control.SRR15539829;51;45;0.529411764705882;24;27;0.0294117647058824;0.470588235294118
Control.SRR15539829;48;45;0.458333333333333;26;22;0.0416666666666667;0.458333333333333
Control.SRR15539829;41;45;0.463414634146341;22;19;0.0365853658536585;0.463414634146341
Control.SRR15539829;47;45;0.553191489361702;21;26;0.0531914893617021;0.446808510638298
Control.SRR15539829;47;45;0.531914893617021;22;25;0.0319148936170213;0.468085106382979
Control.SRR15539829;41;45;0.536585365853659;19;22;0.0365853658536586;0.463414634146341
Control.SRR15539829;43;45;0.534883720930233;20;23;0.0348837209302325;0.465116279069767
Control.SRR15539829;49;45;0.551020408163265;22;27;0.0510204081632653;0.448979591836735
Control.SRR15539829;47;45;0.404255319148936;28;19;0.0957446808510639;0.404255319148936
Control.SRR15539829;50;45;0.6;20;30;0.1;0.4
Control.SRR15539829;39;45;0.538461538461538;18;21;0.0384615384615384;0.461538461538462
Control.SRR15539829;42;45;0.642857142857143;15;27;0.142857142857143;0.357142857142857
Control.SRR15539829;39;45;0.538461538461538;18;21;0.0384615384615384;0.461538461538462
Control.SRR15539829;40;45;0.475;21;19;0.025;0.475
Control.SRR15539829;39;45;0.487179487179487;20;19;0.0128205128205128;0.487179487179487
Control.SRR15539829;44;45;0.477272727272727;23;21;0.0227272727272727;0.477272727272727
Control.SRR15539829;50;45;0.62;19;31;0.12;0.38
Control.SRR15539829;41;45;0.658536585365854;14;27;0.158536585365854;0.341463414634146
Control.SRR15539829;47;45;0.446808510638298;26;21;0.0531914893617021;0.446808510638298
Control.SRR15539829;47;45;0.51063829787234;23;24;0.0106382978723404;0.48936170212766
Control.SRR15539829;42;45;0.547619047619048;19;23;0.0476190476190477;0.452380952380952
Control.SRR15539829;49;45;0.469387755102041;26;23;0.0306122448979592;0.469387755102041
Control.SRR15539829;47;45;0.361702127659574;30;17;0.138297872340426;0.361702127659574
Control.SRR15539829;51;45;0.607843137254902;20;31;0.107843137254902;0.392156862745098
Control.SRR15539829;49;45;0.591836734693878;20;29;0.0918367346938775;0.408163265306122
Control.SRR15539829;50;45;0.52;24;26;0.02;0.48
Control.SRR15539829;49;45;0.469387755102041;26;23;0.0306122448979592;0.469387755102041
Control.SRR15539829;42;45;0.452380952380952;23;19;0.0476190476190476;0.452380952380952
Control.SRR15539829;39;45;0.435897435897436;22;17;0.0641025641025641;0.435897435897436
Control.SRR15539829;39;45;0.615384615384615;15;24;0.115384615384615;0.384615384615385
Control.SRR15539829;43;45;0.511627906976744;21;22;0.0116279069767442;0.488372093023256
Control.SRR15539829;42;45;0.5;21;21;0;0.5
Control.SRR15539829;44;45;0.590909090909091;18;26;0.0909090909090909;0.409090909090909
Control.SRR15539829;46;45;0.58695652173913;19;27;0.0869565217391305;0.41304347826087
Control.SRR15539829;48;45;0.520833333333333;23;25;0.0208333333333334;0.479166666666667
Control.SRR15539829;45;45;0.555555555555556;20;25;0.0555555555555556;0.444444444444444
Control.SRR15539829;43;45;0.488372093023256;22;21;0.0116279069767442;0.488372093023256
Control.SRR15539829;42;45;0.571428571428571;18;24;0.0714285714285714;0.428571428571429
Control.SRR15539829;47;45;0.595744680851064;19;28;0.0957446808510638;0.404255319148936
Control.SRR15539829;40;45;0.6;16;24;0.1;0.4
Control.SRR15539829;39;45;0.538461538461538;18;21;0.0384615384615384;0.461538461538462
Control.SRR15539829;43;45;0.488372093023256;22;21;0.0116279069767442;0.488372093023256
Control.SRR15539829;44;45;0.431818181818182;25;19;0.0681818181818182;0.431818181818182
Control.SRR15539829;42;45;0.428571428571429;24;18;0.0714285714285715;0.428571428571429
Control.SRR15539829;48;45;0.291666666666667;34;14;0.208333333333333;0.291666666666667
Control.SRR15539829;48;45;0.416666666666667;28;20;0.0833333333333333;0.416666666666667
Control.SRR15539829;45;45;0.555555555555556;20;25;0.0555555555555556;0.444444444444444
Control.SRR15539829;42;45;0.523809523809524;20;22;0.0238095238095238;0.476190476190476
Control.SRR15539829;45;45;0.555555555555556;20;25;0.0555555555555556;0.444444444444444
Control.SRR15539829;49;45;0.673469387755102;16;33;0.173469387755102;0.326530612244898
Control.SRR15539829;45;45;0.422222222222222;26;19;0.0777777777777778;0.422222222222222
Control.SRR15539829;39;45;0.538461538461538;18;21;0.0384615384615384;0.461538461538462
Control.SRR15539829;44;45;0.545454545454545;20;24;0.0454545454545454;0.454545454545455
Control.SRR15539829;45;45;0.488888888888889;23;22;0.0111111111111111;0.488888888888889
Control.SRR15539829;44;45;0.431818181818182;25;19;0.0681818181818182;0.431818181818182
Control.SRR15539829;42;45;0.642857142857143;15;27;0.142857142857143;0.357142857142857
Control.SRR15539829;43;45;0.441860465116279;24;19;0.0581395348837209;0.441860465116279
Control.SRR15539829;43;45;0.511627906976744;21;22;0.0116279069767442;0.488372093023256
Control.SRR15539829;43;45;0.488372093023256;22;21;0.0116279069767442;0.488372093023256
Control.SRR15539829;42;45;0.595238095238095;17;25;0.0952380952380952;0.404761904761905
Control.SRR15539829;40;45;0.525;19;21;0.025;0.475
Control.SRR15539829;41;45;0.24390243902439;31;10;0.25609756097561;0.24390243902439
Control.SRR15539829;42;45;0.666666666666667;14;28;0.166666666666667;0.333333333333333
Control.SRR15539829;40;45;0.475;21;19;0.025;0.475
Control.SRR15539829;39;45;0.564102564102564;17;22;0.0641025641025641;0.435897435897436
Control.SRR15539829;41;45;0.560975609756098;18;23;0.0609756097560976;0.439024390243902
Control.SRR15539829;47;45;0.468085106382979;25;22;0.0319148936170213;0.468085106382979
Control.SRR15539829;48;45;0.375;30;18;0.125;0.375
Control.SRR15539829;48;45;0.458333333333333;26;22;0.0416666666666667;0.458333333333333
Control.SRR15539829;49;45;0.63265306122449;18;31;0.13265306122449;0.36734693877551
Control.SRR15539829;44;45;0.522727272727273;21;23;0.0227272727272727;0.477272727272727
Control.SRR15539829;49;45;0.591836734693878;20;29;0.0918367346938775;0.408163265306122
Control.SRR15539829;45;45;0.488888888888889;23;22;0.0111111111111111;0.488888888888889
Control.SRR15539829;44;45;0.409090909090909;26;18;0.0909090909090909;0.409090909090909
Control.SRR15539829;40;45;0.425;23;17;0.075;0.425
Control.SRR15539829;39;45;0.564102564102564;17;22;0.0641025641025641;0.435897435897436
Control.SRR15539829;45;45;0.6;18;27;0.1;0.4
Control.SRR15539829;45;45;0.488888888888889;23;22;0.0111111111111111;0.488888888888889
Control.SRR15539829;45;45;0.577777777777778;19;26;0.0777777777777777;0.422222222222222
Control.SRR15539829;47;45;0.51063829787234;23;24;0.0106382978723404;0.48936170212766
Control.SRR15539829;40;45;0.425;23;17;0.075;0.425
Control.SRR15539829;44;45;0.477272727272727;23;21;0.0227272727272727;0.477272727272727
Control.SRR15539829;44;45;0.522727272727273;21;23;0.0227272727272727;0.477272727272727
Control.SRR15539829;40;45;0.575;17;23;0.075;0.425
Control.SRR15539829;39;45;0.487179487179487;20;19;0.0128205128205128;0.487179487179487
Control.SRR15539829;39;45;0.564102564102564;17;22;0.0641025641025641;0.435897435897436
Control.SRR15539829;41;45;0.634146341463415;15;26;0.134146341463415;0.365853658536585
Control.SRR15539829;51;45;0.509803921568627;25;26;0.00980392156862742;0.490196078431373
Control.SRR15539829;40;45;0.375;25;15;0.125;0.375
Control.SRR15539829;46;45;0.456521739130435;25;21;0.0434782608695652;0.456521739130435
Control.SRR15539829;46;45;0.608695652173913;18;28;0.108695652173913;0.391304347826087
Control.SRR15539829;43;45;0.488372093023256;22;21;0.0116279069767442;0.488372093023256
Control.SRR15539829;45;45;0.488888888888889;23;22;0.0111111111111111;0.488888888888889
Control.SRR15539829;51;45;0.509803921568627;25;26;0.00980392156862742;0.490196078431373
Control.SRR15539829;51;45;0.568627450980392;22;29;0.0686274509803921;0.431372549019608
Control.SRR15539829;45;45;0.555555555555556;20;25;0.0555555555555556;0.444444444444444
Control.SRR15539829;46;45;0.58695652173913;19;27;0.0869565217391305;0.41304347826087
Control.SRR15539829;42;45;0.452380952380952;23;19;0.0476190476190476;0.452380952380952
Control.SRR15539829;47;45;0.51063829787234;23;24;0.0106382978723404;0.48936170212766
Control.SRR15539829;46;45;0.456521739130435;25;21;0.0434782608695652;0.456521739130435
Control.SRR15539829;43;45;0.441860465116279;24;19;0.0581395348837209;0.441860465116279
Control.SRR15539829;41;45;0.536585365853659;19;22;0.0365853658536586;0.463414634146341
Control.SRR15539829;40;45;0.45;22;18;0.05;0.45
Control.SRR15539829;43;45;0.465116279069767;23;20;0.0348837209302326;0.465116279069767
Control.SRR15539829;43;45;0.372093023255814;27;16;0.127906976744186;0.372093023255814
Control.SRR15539829;46;45;0.5;23;23;0;0.5
Control.SRR15539829;42;45;0.452380952380952;23;19;0.0476190476190476;0.452380952380952
Control.SRR15539829;41;45;0.463414634146341;22;19;0.0365853658536585;0.463414634146341
Control.SRR15539829;39;45;0.564102564102564;17;22;0.0641025641025641;0.435897435897436
Control.SRR15539829;43;45;0.465116279069767;23;20;0.0348837209302326;0.465116279069767
Control.SRR15539829;43;45;0.558139534883721;19;24;0.0581395348837209;0.441860465116279
Control.SRR15539829;42;45;0.452380952380952;23;19;0.0476190476190476;0.452380952380952
Control.SRR15539829;48;45;0.604166666666667;19;29;0.104166666666667;0.395833333333333
Control.SRR15539829;49;45;0.530612244897959;23;26;0.0306122448979592;0.469387755102041
Control.SRR15539829;39;45;0.538461538461538;18;21;0.0384615384615384;0.461538461538462
Control.SRR15539829;40;45;0.45;22;18;0.05;0.45
Control.SRR15539829;46;45;0.521739130434783;22;24;0.0217391304347826;0.478260869565217
Control.SRR15539829;42;45;0.5;21;21;0;0.5
Control.SRR15539829;45;45;0.488888888888889;23;22;0.0111111111111111;0.488888888888889
Control.SRR15539829;46;45;0.521739130434783;22;24;0.0217391304347826;0.478260869565217
Control.SRR15539829;43;45;0.534883720930233;20;23;0.0348837209302325;0.465116279069767
Control.SRR15539829;40;45;0.5;20;20;0;0.5
Control.SRR15539829;41;45;0.463414634146341;22;19;0.0365853658536585;0.463414634146341
Control.SRR15539829;43;45;0.488372093023256;22;21;0.0116279069767442;0.488372093023256
Control.SRR15539829;39;45;0.384615384615385;24;15;0.115384615384615;0.384615384615385
Control.SRR15539829;51;45;0.450980392156863;28;23;0.0490196078431372;0.450980392156863
Control.SRR15539829;42;45;0.547619047619048;19;23;0.0476190476190477;0.452380952380952
Control.SRR15539829;44;45;0.386363636363636;27;17;0.113636363636364;0.386363636363636
Control.SRR15539829;43;45;0.511627906976744;21;22;0.0116279069767442;0.488372093023256
Control.SRR15539829;48;45;0.395833333333333;29;19;0.104166666666667;0.395833333333333
Control.SRR15539829;40;45;0.375;25;15;0.125;0.375
Control.SRR15539829;42;45;0.452380952380952;23;19;0.0476190476190476;0.452380952380952
Control.SRR15539829;50;45;0.56;22;28;0.0600000000000001;0.44
Control.SRR15539829;48;45;0.520833333333333;23;25;0.0208333333333334;0.479166666666667
Control.SRR15539829;44;45;0.386363636363636;27;17;0.113636363636364;0.386363636363636
Control.SRR15539829;41;45;0.365853658536585;26;15;0.134146341463415;0.365853658536585
Control.SRR15539829;44;45;0.5;22;22;0;0.5
Control.SRR15539829;42;45;0.476190476190476;22;20;0.0238095238095238;0.476190476190476
Control.SRR15539829;45;45;0.466666666666667;24;21;0.0333333333333333;0.466666666666667
Control.SRR15539829;39;45;0.512820512820513;19;20;0.0128205128205128;0.487179487179487
Control.SRR15539829;51;45;0.509803921568627;25;26;0.00980392156862742;0.490196078431373
Control.SRR15539829;46;45;0.434782608695652;26;20;0.0652173913043478;0.434782608695652
Control.SRR15539829;51;45;0.431372549019608;29;22;0.0686274509803921;0.431372549019608
Control.SRR15539829;44;45;0.477272727272727;23;21;0.0227272727272727;0.477272727272727
Control.SRR15539829;41;45;0.48780487804878;21;20;0.0121951219512195;0.48780487804878
Control.SRR15539829;48;45;0.541666666666667;22;26;0.0416666666666666;0.458333333333333
Control.SRR15539829;49;45;0.530612244897959;23;26;0.0306122448979592;0.469387755102041
Control.SRR15539829;46;45;0.434782608695652;26;20;0.0652173913043478;0.434782608695652
Control.SRR15539829;47;45;0.425531914893617;27;20;0.074468085106383;0.425531914893617
Control.SRR15539829;43;45;0.372093023255814;27;16;0.127906976744186;0.372093023255814
Control.SRR15539829;49;45;0.591836734693878;20;29;0.0918367346938775;0.408163265306122
Control.SRR15539829;41;45;0.731707317073171;11;30;0.231707317073171;0.268292682926829
Control.SRR15539829;46;45;0.543478260869565;21;25;0.0434782608695652;0.456521739130435
Control.SRR15539829;44;45;0.5;22;22;0;0.5
Control.SRR15539829;42;45;0.404761904761905;25;17;0.0952380952380952;0.404761904761905
Control.SRR15539829;43;45;0.534883720930233;20;23;0.0348837209302325;0.465116279069767
Control.SRR15539829;45;45;0.555555555555556;20;25;0.0555555555555556;0.444444444444444
Control.SRR15539829;50;45;0.48;26;24;0.02;0.48
Control.SRR15539829;49;45;0.448979591836735;27;22;0.0510204081632653;0.448979591836735
Control.SRR15539829;48;45;0.5625;21;27;0.0625;0.4375
Control.SRR15539829;45;45;0.533333333333333;21;24;0.0333333333333333;0.466666666666667
Control.SRR15539829;45;45;0.6;18;27;0.1;0.4
Control.SRR15539829;41;45;0.439024390243902;23;18;0.0609756097560976;0.439024390243902
Control.SRR15539829;40;45;0.475;21;19;0.025;0.475
Control.SRR15539829;47;45;0.382978723404255;29;18;0.117021276595745;0.382978723404255
Control.SRR15539829;50;45;0.48;26;24;0.02;0.48
Control.SRR15539829;50;45;0.58;21;29;0.08;0.42
Control.SRR15539829;51;45;0.529411764705882;24;27;0.0294117647058824;0.470588235294118
Control.SRR15539829;46;45;0.41304347826087;27;19;0.0869565217391304;0.41304347826087
Control.SRR15539829;39;45;0.358974358974359;25;14;0.141025641025641;0.358974358974359
Control.SRR15539829;44;45;0.454545454545455;24;20;0.0454545454545455;0.454545454545455
Control.SRR15539829;39;45;0.487179487179487;20;19;0.0128205128205128;0.487179487179487
Control.SRR15539829;45;45;0.511111111111111;22;23;0.0111111111111111;0.488888888888889
Control.SRR15539829;50;45;0.34;33;17;0.16;0.34
Control.SRR15539829;43;45;0.488372093023256;22;21;0.0116279069767442;0.488372093023256
Control.SRR15539829;41;45;0.48780487804878;21;20;0.0121951219512195;0.48780487804878
Control.SRR15539829;47;45;0.553191489361702;21;26;0.0531914893617021;0.446808510638298
Control.SRR15539829;45;45;0.422222222222222;26;19;0.0777777777777778;0.422222222222222
Control.SRR15539829;40;45;0.45;22;18;0.05;0.45
Control.SRR15539829;43;45;0.302325581395349;30;13;0.197674418604651;0.302325581395349
Control.SRR15539829;42;45;0.571428571428571;18;24;0.0714285714285714;0.428571428571429
Control.SRR15539829;43;45;0.558139534883721;19;24;0.0581395348837209;0.441860465116279
Control.SRR15539829;39;45;0.487179487179487;20;19;0.0128205128205128;0.487179487179487
Control.SRR15539829;45;45;0.511111111111111;22;23;0.0111111111111111;0.488888888888889
Control.SRR15539829;46;45;0.5;23;23;0;0.5
Control.SRR15539829;47;45;0.553191489361702;21;26;0.0531914893617021;0.446808510638298
Control.SRR15539829;39;45;0.564102564102564;17;22;0.0641025641025641;0.435897435897436
Control.SRR15539829;41;45;0.536585365853659;19;22;0.0365853658536586;0.463414634146341
Control.SRR15539829;41;45;0.536585365853659;19;22;0.0365853658536586;0.463414634146341
Control.SRR15539829;48;45;0.541666666666667;22;26;0.0416666666666666;0.458333333333333
Control.SRR15539829;50;45;0.48;26;24;0.02;0.48
Control.SRR15539829;40;45;0.475;21;19;0.025;0.475
Control.SRR15539829;46;45;0.565217391304348;20;26;0.0652173913043478;0.434782608695652
Control.SRR15539829;42;45;0.428571428571429;24;18;0.0714285714285715;0.428571428571429
Control.SRR15539829;47;45;0.595744680851064;19;28;0.0957446808510638;0.404255319148936
Control.SRR15539829;45;45;0.444444444444444;25;20;0.0555555555555556;0.444444444444444
Control.SRR15539829;41;45;0.390243902439024;25;16;0.109756097560976;0.390243902439024
Control.SRR15539829;45;45;0.4;27;18;0.1;0.4
Control.SRR15539829;47;45;0.404255319148936;28;19;0.0957446808510639;0.404255319148936
Control.SRR15539829;45;45;0.622222222222222;17;28;0.122222222222222;0.377777777777778
Control.SRR15539829;46;45;0.456521739130435;25;21;0.0434782608695652;0.456521739130435
Control.SRR15539829;41;45;0.609756097560976;16;25;0.109756097560976;0.390243902439024
Control.SRR15539829;49;45;0.306122448979592;34;15;0.193877551020408;0.306122448979592
Control.SRR15539829;50;45;0.58;21;29;0.08;0.42
Control.SRR15539829;46;45;0.478260869565217;24;22;0.0217391304347826;0.478260869565217
Control.SRR15539829;42;45;0.547619047619048;19;23;0.0476190476190477;0.452380952380952
Control.SRR15539829;48;45;0.5625;21;27;0.0625;0.4375
Control.SRR15539829;50;45;0.52;24;26;0.02;0.48
Control.SRR15539829;51;45;0.490196078431373;26;25;0.00980392156862747;0.490196078431373
Control.SRR15539829;43;45;0.627906976744186;16;27;0.127906976744186;0.372093023255814
Control.SRR15539829;44;45;0.568181818181818;19;25;0.0681818181818182;0.431818181818182
Control.SRR15539829;51;45;0.627450980392157;19;32;0.127450980392157;0.372549019607843
Control.SRR15539829;43;45;0.581395348837209;18;25;0.0813953488372093;0.418604651162791
Control.SRR15539829;40;45;0.6;16;24;0.1;0.4
Control.SRR15539829;42;45;0.333333333333333;28;14;0.166666666666667;0.333333333333333
Control.SRR15539829;44;45;0.545454545454545;20;24;0.0454545454545454;0.454545454545455
Control.SRR15539829;39;45;0.384615384615385;24;15;0.115384615384615;0.384615384615385
Control.SRR15539829;48;45;0.479166666666667;25;23;0.0208333333333333;0.479166666666667
Control.SRR15539829;43;45;0.627906976744186;16;27;0.127906976744186;0.372093023255814
Control.SRR15539829;44;45;0.522727272727273;21;23;0.0227272727272727;0.477272727272727
Control.SRR15539829;40;45;0.35;26;14;0.15;0.35
Control.SRR15539829;41;45;0.463414634146341;22;19;0.0365853658536585;0.463414634146341
Control.SRR15539829;41;45;0.51219512195122;20;21;0.0121951219512195;0.48780487804878
Control.SRR15539829;46;45;0.5;23;23;0;0.5
Control.SRR15539829;43;45;0.604651162790698;17;26;0.104651162790698;0.395348837209302
Control.SRR15539829;47;45;0.446808510638298;26;21;0.0531914893617021;0.446808510638298
Control.SRR15539829;39;45;0.435897435897436;22;17;0.0641025641025641;0.435897435897436
Control.SRR15539829;47;45;0.468085106382979;25;22;0.0319148936170213;0.468085106382979
Control.SRR15539829;50;45;0.52;24;26;0.02;0.48
Control.SRR15539829;48;45;0.5625;21;27;0.0625;0.4375
Control.SRR15539829;43;45;0.465116279069767;23;20;0.0348837209302326;0.465116279069767
Control.SRR15539829;45;45;0.555555555555556;20;25;0.0555555555555556;0.444444444444444
Control.SRR15539829;41;45;0.463414634146341;22;19;0.0365853658536585;0.463414634146341
Control.SRR15539829;46;45;0.478260869565217;24;22;0.0217391304347826;0.478260869565217
Control.SRR15539829;44;45;0.477272727272727;23;21;0.0227272727272727;0.477272727272727
Control.SRR15539829;43;45;0.488372093023256;22;21;0.0116279069767442;0.488372093023256
Control.SRR15539829;39;45;0.512820512820513;19;20;0.0128205128205128;0.487179487179487
Control.SRR15539829;39;45;0.487179487179487;20;19;0.0128205128205128;0.487179487179487
Control.SRR15539829;50;45;0.54;23;27;0.04;0.46
Control.SRR15539829;51;45;0.470588235294118;27;24;0.0294117647058824;0.470588235294118
Control.SRR15539829;42;45;0.571428571428571;18;24;0.0714285714285714;0.428571428571429
Control.SRR15539829;43;45;0.558139534883721;19;24;0.0581395348837209;0.441860465116279
Control.SRR15539829;44;45;0.613636363636364;17;27;0.113636363636364;0.386363636363636
Control.SRR15539829;44;45;0.431818181818182;25;19;0.0681818181818182;0.431818181818182
Control.SRR15539829;47;45;0.574468085106383;20;27;0.074468085106383;0.425531914893617
Control.SRR15539829;50;45;0.54;23;27;0.04;0.46
Control.SRR15539829;49;45;0.387755102040816;30;19;0.112244897959184;0.387755102040816
Control.SRR15539829;45;45;0.533333333333333;21;24;0.0333333333333333;0.466666666666667
Control.SRR15539829;47;45;0.638297872340426;17;30;0.138297872340426;0.361702127659574
Control.SRR15539829;49;45;0.530612244897959;23;26;0.0306122448979592;0.469387755102041
Control.SRR15539829;41;45;0.51219512195122;20;21;0.0121951219512195;0.48780487804878
Control.SRR15539829;50;45;0.5;25;25;0;0.5
Control.SRR15539829;48;45;0.520833333333333;23;25;0.0208333333333334;0.479166666666667
Control.SRR15539829;45;45;0.533333333333333;21;24;0.0333333333333333;0.466666666666667
Control.SRR15539829;45;45;0.466666666666667;24;21;0.0333333333333333;0.466666666666667
Control.SRR15539829;42;45;0.452380952380952;23;19;0.0476190476190476;0.452380952380952
Control.SRR15539829;50;45;0.54;23;27;0.04;0.46
Control.SRR15539829;42;45;0.476190476190476;22;20;0.0238095238095238;0.476190476190476
Control.SRR15539829;41;45;0.585365853658537;17;24;0.0853658536585366;0.414634146341463
Control.SRR15539829;43;45;0.441860465116279;24;19;0.0581395348837209;0.441860465116279
Control.SRR15539829;40;45;0.475;21;19;0.025;0.475
Control.SRR15539829;44;45;0.5;22;22;0;0.5
Control.SRR15539829;40;45;0.475;21;19;0.025;0.475
Control.SRR15539829;46;45;0.456521739130435;25;21;0.0434782608695652;0.456521739130435
Control.SRR15539829;46;45;0.543478260869565;21;25;0.0434782608695652;0.456521739130435
Control.SRR15539829;46;45;0.58695652173913;19;27;0.0869565217391305;0.41304347826087
Control.SRR15539829;40;45;0.5;20;20;0;0.5
Control.SRR15539829;44;45;0.681818181818182;14;30;0.181818181818182;0.318181818181818
Control.SRR15539829;48;45;0.479166666666667;25;23;0.0208333333333333;0.479166666666667
Control.SRR15539829;51;45;0.529411764705882;24;27;0.0294117647058824;0.470588235294118
Control.SRR15539829;42;45;0.523809523809524;20;22;0.0238095238095238;0.476190476190476
Control.SRR15539829;42;45;0.595238095238095;17;25;0.0952380952380952;0.404761904761905
Control.SRR15539829;40;45;0.55;18;22;0.05;0.45
Control.SRR15539829;39;45;0.615384615384615;15;24;0.115384615384615;0.384615384615385
Control.SRR15539829;41;45;0.48780487804878;21;20;0.0121951219512195;0.48780487804878
Control.SRR15539829;51;45;0.568627450980392;22;29;0.0686274509803921;0.431372549019608
Control.SRR15539829;50;45;0.5;25;25;0;0.5
Control.SRR15539829;44;45;0.568181818181818;19;25;0.0681818181818182;0.431818181818182
Control.SRR15539829;40;45;0.45;22;18;0.05;0.45
Control.SRR15539829;45;45;0.6;18;27;0.1;0.4
Control.SRR15539829;49;45;0.469387755102041;26;23;0.0306122448979592;0.469387755102041
Control.SRR15539829;45;45;0.555555555555556;20;25;0.0555555555555556;0.444444444444444
Control.SRR15539829;45;45;0.555555555555556;20;25;0.0555555555555556;0.444444444444444
Control.SRR15539829;46;45;0.478260869565217;24;22;0.0217391304347826;0.478260869565217
Control.SRR15539829;49;45;0.530612244897959;23;26;0.0306122448979592;0.469387755102041
Control.SRR15539829;50;45;0.48;26;24;0.02;0.48
Control.SRR15539829;50;45;0.54;23;27;0.04;0.46
Control.SRR15539829;44;45;0.545454545454545;20;24;0.0454545454545454;0.454545454545455
Control.SRR15539829;50;45;0.48;26;24;0.02;0.48
Control.SRR15539829;50;45;0.52;24;26;0.02;0.48
Control.SRR15539829;40;45;0.525;19;21;0.025;0.475
Control.SRR15539829;51;45;0.352941176470588;33;18;0.147058823529412;0.352941176470588
Control.SRR15539829;42;45;0.547619047619048;19;23;0.0476190476190477;0.452380952380952
Control.SRR15539829;45;45;0.577777777777778;19;26;0.0777777777777777;0.422222222222222
Control.SRR15539829;43;45;0.395348837209302;26;17;0.104651162790698;0.395348837209302
Control.SRR15539829;50;45;0.52;24;26;0.02;0.48
Control.SRR15539829;40;45;0.35;26;14;0.15;0.35
Control.SRR15539829;50;45;0.4;30;20;0.1;0.4
Control.SRR15539829;42;45;0.5;21;21;0;0.5
Control.SRR15539829;42;45;0.571428571428571;18;24;0.0714285714285714;0.428571428571429
Control.SRR15539829;40;45;0.5;20;20;0;0.5
Control.SRR15539829;48;45;0.625;18;30;0.125;0.375
Control.SRR15539829;50;45;0.5;25;25;0;0.5
Control.SRR15539829;48;45;0.5625;21;27;0.0625;0.4375
Control.SRR15539829;46;45;0.456521739130435;25;21;0.0434782608695652;0.456521739130435
Control.SRR15539829;46;45;0.565217391304348;20;26;0.0652173913043478;0.434782608695652
Control.SRR15539829;39;45;0.358974358974359;25;14;0.141025641025641;0.358974358974359
Control.SRR15539829;49;45;0.428571428571429;28;21;0.0714285714285715;0.428571428571429
Control.SRR15539829;49;45;0.469387755102041;26;23;0.0306122448979592;0.469387755102041
Control.SRR15539829;51;45;0.607843137254902;20;31;0.107843137254902;0.392156862745098
Control.SRR15539829;48;45;0.5625;21;27;0.0625;0.4375
Control.SRR15539829;46;45;0.434782608695652;26;20;0.0652173913043478;0.434782608695652
Control.SRR15539829;41;45;0.658536585365854;14;27;0.158536585365854;0.341463414634146
Control.SRR15539829;46;45;0.565217391304348;20;26;0.0652173913043478;0.434782608695652
Control.SRR15539829;46;45;0.565217391304348;20;26;0.0652173913043478;0.434782608695652
Control.SRR15539829;43;45;0.627906976744186;16;27;0.127906976744186;0.372093023255814
Control.SRR15539829;39;45;0.461538461538462;21;18;0.0384615384615384;0.461538461538462
Control.SRR15539829;42;45;0.404761904761905;25;17;0.0952380952380952;0.404761904761905
Control.SRR15539829;49;45;0.530612244897959;23;26;0.0306122448979592;0.469387755102041
Control.SRR15539829;48;45;0.520833333333333;23;25;0.0208333333333334;0.479166666666667
Control.SRR15539829;44;45;0.431818181818182;25;19;0.0681818181818182;0.431818181818182
Control.SRR15539829;51;45;0.549019607843137;23;28;0.0490196078431373;0.450980392156863
Control.SRR15539829;40;45;0.375;25;15;0.125;0.375
Control.SRR15539829;42;45;0.476190476190476;22;20;0.0238095238095238;0.476190476190476
Control.SRR15539829;43;45;0.511627906976744;21;22;0.0116279069767442;0.488372093023256
Control.SRR15539829;47;45;0.638297872340426;17;30;0.138297872340426;0.361702127659574
Control.SRR15539829;41;45;0.609756097560976;16;25;0.109756097560976;0.390243902439024
Control.SRR15539829;43;45;0.604651162790698;17;26;0.104651162790698;0.395348837209302
Control.SRR15539829;39;45;0.41025641025641;23;16;0.0897435897435898;0.41025641025641
Control.SRR15539829;42;45;0.404761904761905;25;17;0.0952380952380952;0.404761904761905
Control.SRR15539829;45;45;0.577777777777778;19;26;0.0777777777777777;0.422222222222222
Control.SRR15539829;43;45;0.441860465116279;24;19;0.0581395348837209;0.441860465116279
Control.SRR15539829;45;45;0.377777777777778;28;17;0.122222222222222;0.377777777777778
Control.SRR15539829;46;45;0.347826086956522;30;16;0.152173913043478;0.347826086956522
Control.SRR15539829;49;45;0.387755102040816;30;19;0.112244897959184;0.387755102040816
Control.SRR15539829;42;45;0.523809523809524;20;22;0.0238095238095238;0.476190476190476
Control.SRR15539829;46;45;0.5;23;23;0;0.5
Control.SRR15539829;51;45;0.509803921568627;25;26;0.00980392156862742;0.490196078431373
Control.SRR15539829;47;45;0.553191489361702;21;26;0.0531914893617021;0.446808510638298
Control.SRR15539829;51;45;0.549019607843137;23;28;0.0490196078431373;0.450980392156863
Control.SRR15539829;45;45;0.6;18;27;0.1;0.4
Control.SRR15539829;51;45;0.450980392156863;28;23;0.0490196078431372;0.450980392156863
Control.SRR15539829;50;45;0.44;28;22;0.06;0.44
Control.SRR15539829;49;45;0.530612244897959;23;26;0.0306122448979592;0.469387755102041
Control.SRR15539829;40;45;0.475;21;19;0.025;0.475
Control.SRR15539829;39;45;0.564102564102564;17;22;0.0641025641025641;0.435897435897436
Control.SRR15539829;47;45;0.702127659574468;14;33;0.202127659574468;0.297872340425532
Control.SRR15539829;47;45;0.48936170212766;24;23;0.0106382978723404;0.48936170212766
Control.SRR15539829;43;45;0.255813953488372;32;11;0.244186046511628;0.255813953488372
Control.SRR15539829;44;45;0.522727272727273;21;23;0.0227272727272727;0.477272727272727
Control.SRR15539829;41;45;0.463414634146341;22;19;0.0365853658536585;0.463414634146341
Control.SRR15539829;41;45;0.48780487804878;21;20;0.0121951219512195;0.48780487804878
Control.SRR15539829;42;45;0.595238095238095;17;25;0.0952380952380952;0.404761904761905
Control.SRR15539829;42;45;0.476190476190476;22;20;0.0238095238095238;0.476190476190476
Control.SRR15539829;45;45;0.466666666666667;24;21;0.0333333333333333;0.466666666666667
Control.SRR15539829;44;45;0.477272727272727;23;21;0.0227272727272727;0.477272727272727
Control.SRR15539829;46;45;0.652173913043478;16;30;0.152173913043478;0.347826086956522
Control.SRR15539829;39;45;0.615384615384615;15;24;0.115384615384615;0.384615384615385
Control.SRR15539829;47;45;0.531914893617021;22;25;0.0319148936170213;0.468085106382979
Control.SRR15539829;48;45;0.541666666666667;22;26;0.0416666666666666;0.458333333333333
Control.SRR15539829;41;45;0.439024390243902;23;18;0.0609756097560976;0.439024390243902
Control.SRR15539829;42;45;0.476190476190476;22;20;0.0238095238095238;0.476190476190476
Control.SRR15539829;44;45;0.545454545454545;20;24;0.0454545454545454;0.454545454545455
Control.SRR15539829;43;45;0.465116279069767;23;20;0.0348837209302326;0.465116279069767
Control.SRR15539829;44;45;0.590909090909091;18;26;0.0909090909090909;0.409090909090909
Control.SRR15539829;42;45;0.547619047619048;19;23;0.0476190476190477;0.452380952380952
Control.SRR15539829;42;45;0.571428571428571;18;24;0.0714285714285714;0.428571428571429
Control.SRR15539829;50;45;0.54;23;27;0.04;0.46
Control.SRR15539829;44;45;0.522727272727273;21;23;0.0227272727272727;0.477272727272727
Control.SRR15539829;49;45;0.591836734693878;20;29;0.0918367346938775;0.408163265306122
Control.SRR15539829;47;45;0.574468085106383;20;27;0.074468085106383;0.425531914893617
Control.SRR15539829;50;45;0.48;26;24;0.02;0.48
Control.SRR15539829;48;45;0.541666666666667;22;26;0.0416666666666666;0.458333333333333
Control.SRR15539829;40;45;0.475;21;19;0.025;0.475
Control.SRR15539829;40;45;0.625;15;25;0.125;0.375
Control.SRR15539829;41;45;0.341463414634146;27;14;0.158536585365854;0.341463414634146
Control.SRR15539829;39;45;0.564102564102564;17;22;0.0641025641025641;0.435897435897436
Control.SRR15539829;40;45;0.45;22;18;0.05;0.45
Control.SRR15539829;41;45;0.463414634146341;22;19;0.0365853658536585;0.463414634146341
Control.SRR15539829;41;45;0.51219512195122;20;21;0.0121951219512195;0.48780487804878
Control.SRR15539829;40;45;0.4;24;16;0.1;0.4
Control.SRR15539829;41;45;0.585365853658537;17;24;0.0853658536585366;0.414634146341463
Control.SRR15539829;48;45;0.4375;27;21;0.0625;0.4375
Control.SRR15539829;42;45;0.452380952380952;23;19;0.0476190476190476;0.452380952380952
Control.SRR15539829;47;45;0.48936170212766;24;23;0.0106382978723404;0.48936170212766
Control.SRR15539829;48;45;0.520833333333333;23;25;0.0208333333333334;0.479166666666667
Control.SRR15539829;46;45;0.521739130434783;22;24;0.0217391304347826;0.478260869565217
Control.SRR15539829;47;45;0.48936170212766;24;23;0.0106382978723404;0.48936170212766
Control.SRR15539829;45;45;0.466666666666667;24;21;0.0333333333333333;0.466666666666667
Control.SRR15539829;43;45;0.465116279069767;23;20;0.0348837209302326;0.465116279069767
Control.SRR15539829;44;45;0.704545454545455;13;31;0.204545454545455;0.295454545454545
Control.SRR15539829;44;45;0.431818181818182;25;19;0.0681818181818182;0.431818181818182
Control.SRR15539829;39;45;0.615384615384615;15;24;0.115384615384615;0.384615384615385
Control.SRR15539829;39;45;0.538461538461538;18;21;0.0384615384615384;0.461538461538462
Control.SRR15539829;51;45;0.607843137254902;20;31;0.107843137254902;0.392156862745098
Control.SRR15539829;41;45;0.48780487804878;21;20;0.0121951219512195;0.48780487804878
Control.SRR15539829;44;45;0.318181818181818;30;14;0.181818181818182;0.318181818181818
Control.SRR15539829;46;45;0.5;23;23;0;0.5
Control.SRR15539829;44;45;0.522727272727273;21;23;0.0227272727272727;0.477272727272727
Control.SRR15539829;45;45;0.488888888888889;23;22;0.0111111111111111;0.488888888888889
Control.SRR15539829;40;45;0.4;24;16;0.1;0.4
Control.SRR15539829;44;45;0.613636363636364;17;27;0.113636363636364;0.386363636363636
Control.SRR15539829;48;45;0.5;24;24;0;0.5
Control.SRR15539829;47;45;0.51063829787234;23;24;0.0106382978723404;0.48936170212766
Control.SRR15539829;45;45;0.511111111111111;22;23;0.0111111111111111;0.488888888888889
Control.SRR15539829;49;45;0.612244897959184;19;30;0.112244897959184;0.387755102040816
Control.SRR15539829;47;45;0.574468085106383;20;27;0.074468085106383;0.425531914893617
Control.SRR15539829;49;45;0.428571428571429;28;21;0.0714285714285715;0.428571428571429
Control.SRR15539829;39;45;0.435897435897436;22;17;0.0641025641025641;0.435897435897436
Control.SRR15539829;40;45;0.5;20;20;0;0.5
Control.SRR15539829;39;45;0.538461538461538;18;21;0.0384615384615384;0.461538461538462
Control.SRR15539829;40;45;0.475;21;19;0.025;0.475
Control.SRR15539829;42;45;0.5;21;21;0;0.5
Control.SRR15539829;51;45;0.568627450980392;22;29;0.0686274509803921;0.431372549019608
Control.SRR15539829;48;45;0.4375;27;21;0.0625;0.4375
Control.SRR15539829;40;45;0.575;17;23;0.075;0.425
Control.SRR15539829;44;45;0.522727272727273;21;23;0.0227272727272727;0.477272727272727
Control.SRR15539829;41;45;0.463414634146341;22;19;0.0365853658536585;0.463414634146341
Control.SRR15539829;39;45;0.615384615384615;15;24;0.115384615384615;0.384615384615385
Control.SRR15539829;41;45;0.414634146341463;24;17;0.0853658536585366;0.414634146341463
Control.SRR15539829;42;45;0.428571428571429;24;18;0.0714285714285715;0.428571428571429
Control.SRR15539829;39;45;0.641025641025641;14;25;0.141025641025641;0.358974358974359
Control.SRR15539829;44;45;0.409090909090909;26;18;0.0909090909090909;0.409090909090909
Control.SRR15539829;39;45;0.564102564102564;17;22;0.0641025641025641;0.435897435897436
Control.SRR15539829;44;45;0.5;22;22;0;0.5
Control.SRR15539829;45;45;0.555555555555556;20;25;0.0555555555555556;0.444444444444444
Control.SRR15539829;46;45;0.391304347826087;28;18;0.108695652173913;0.391304347826087
Control.SRR15539829;39;45;0.564102564102564;17;22;0.0641025641025641;0.435897435897436
Control.SRR15539829;39;45;0.461538461538462;21;18;0.0384615384615384;0.461538461538462
Control.SRR15539829;46;45;0.326086956521739;31;15;0.173913043478261;0.326086956521739
Control.SRR15539829;43;45;0.395348837209302;26;17;0.104651162790698;0.395348837209302
Control.SRR15539829;47;45;0.319148936170213;32;15;0.180851063829787;0.319148936170213
Control.SRR15539829;41;45;0.536585365853659;19;22;0.0365853658536586;0.463414634146341
Control.SRR15539829;50;45;0.58;21;29;0.08;0.42
Control.SRR15539829;45;45;0.555555555555556;20;25;0.0555555555555556;0.444444444444444
Control.SRR15539829;45;45;0.511111111111111;22;23;0.0111111111111111;0.488888888888889
Control.SRR15539829;44;45;0.5;22;22;0;0.5
Control.SRR15539829;40;45;0.525;19;21;0.025;0.475
Control.SRR15539829;46;45;0.434782608695652;26;20;0.0652173913043478;0.434782608695652
Control.SRR15539829;50;45;0.58;21;29;0.08;0.42
Control.SRR15539829;42;45;0.476190476190476;22;20;0.0238095238095238;0.476190476190476
Control.SRR15539829;43;45;0.395348837209302;26;17;0.104651162790698;0.395348837209302
Control.SRR15539829;47;45;0.446808510638298;26;21;0.0531914893617021;0.446808510638298
Control.SRR15539829;42;45;0.547619047619048;19;23;0.0476190476190477;0.452380952380952
Control.SRR15539829;41;45;0.51219512195122;20;21;0.0121951219512195;0.48780487804878
Control.SRR15539829;41;45;0.390243902439024;25;16;0.109756097560976;0.390243902439024
Control.SRR15539829;42;45;0.619047619047619;16;26;0.119047619047619;0.380952380952381
Control.SRR15539829;47;45;0.382978723404255;29;18;0.117021276595745;0.382978723404255
Control.SRR15539829;40;45;0.55;18;22;0.05;0.45
Control.SRR15539829;40;45;0.525;19;21;0.025;0.475
Control.SRR15539829;48;45;0.333333333333333;32;16;0.166666666666667;0.333333333333333
Control.SRR15539829;42;45;0.523809523809524;20;22;0.0238095238095238;0.476190476190476
Control.SRR15539829;39;45;0.512820512820513;19;20;0.0128205128205128;0.487179487179487
Control.SRR15539829;48;45;0.479166666666667;25;23;0.0208333333333333;0.479166666666667
Control.SRR15539829;49;45;0.571428571428571;21;28;0.0714285714285714;0.428571428571429
Control.SRR15539829;46;45;0.434782608695652;26;20;0.0652173913043478;0.434782608695652
Control.SRR15539829;40;45;0.4;24;16;0.1;0.4
Control.SRR15539829;44;45;0.340909090909091;29;15;0.159090909090909;0.340909090909091
Control.SRR15539829;47;45;0.595744680851064;19;28;0.0957446808510638;0.404255319148936
Control.SRR15539829;45;45;0.488888888888889;23;22;0.0111111111111111;0.488888888888889
Control.SRR15539829;49;45;0.306122448979592;34;15;0.193877551020408;0.306122448979592
Control.SRR15539829;45;45;0.511111111111111;22;23;0.0111111111111111;0.488888888888889
Control.SRR15539829;46;45;0.543478260869565;21;25;0.0434782608695652;0.456521739130435
Control.SRR15539829;40;45;0.4;24;16;0.1;0.4
Control.SRR15539829;40;45;0.525;19;21;0.025;0.475
Control.SRR15539829;47;45;0.531914893617021;22;25;0.0319148936170213;0.468085106382979
Control.SRR15539829;41;45;0.365853658536585;26;15;0.134146341463415;0.365853658536585
Control.SRR15539829;39;45;0.615384615384615;15;24;0.115384615384615;0.384615384615385
Control.SRR15539829;51;45;0.568627450980392;22;29;0.0686274509803921;0.431372549019608
Control.SRR15539829;40;45;0.45;22;18;0.05;0.45
Control.SRR15539829;44;45;0.545454545454545;20;24;0.0454545454545454;0.454545454545455
Control.SRR15539829;43;45;0.418604651162791;25;18;0.0813953488372093;0.418604651162791
Control.SRR15539829;43;45;0.488372093023256;22;21;0.0116279069767442;0.488372093023256
Control.SRR15539829;41;45;0.536585365853659;19;22;0.0365853658536586;0.463414634146341
Control.SRR15539829;46;45;0.434782608695652;26;20;0.0652173913043478;0.434782608695652
Control.SRR15539829;43;45;0.581395348837209;18;25;0.0813953488372093;0.418604651162791
Control.SRR15539829;44;45;0.477272727272727;23;21;0.0227272727272727;0.477272727272727
Control.SRR15539829;40;45;0.45;22;18;0.05;0.45
Control.SRR15539829;42;45;0.547619047619048;19;23;0.0476190476190477;0.452380952380952
Control.SRR15539829;44;45;0.386363636363636;27;17;0.113636363636364;0.386363636363636
Control.SRR15539829;39;45;0.564102564102564;17;22;0.0641025641025641;0.435897435897436
Control.SRR15539829;46;45;0.608695652173913;18;28;0.108695652173913;0.391304347826087
Control.SRR15539829;49;45;0.571428571428571;21;28;0.0714285714285714;0.428571428571429
Control.SRR15539829;48;45;0.5625;21;27;0.0625;0.4375
Control.SRR15539829;43;45;0.558139534883721;19;24;0.0581395348837209;0.441860465116279
Control.SRR15539829;46;45;0.608695652173913;18;28;0.108695652173913;0.391304347826087
Control.SRR15539829;40;45;0.525;19;21;0.025;0.475
Control.SRR15539829;45;45;0.622222222222222;17;28;0.122222222222222;0.377777777777778
Control.SRR15539829;46;45;0.565217391304348;20;26;0.0652173913043478;0.434782608695652
Control.SRR15539829;44;45;0.5;22;22;0;0.5
Control.SRR15539829;50;45;0.54;23;27;0.04;0.46
Control.SRR15539829;44;45;0.522727272727273;21;23;0.0227272727272727;0.477272727272727
Control.SRR15539829;43;45;0.558139534883721;19;24;0.0581395348837209;0.441860465116279
Control.SRR15539829;50;45;0.46;27;23;0.04;0.46
Control.SRR15539829;44;45;0.5;22;22;0;0.5
Control.SRR15539829;46;45;0.608695652173913;18;28;0.108695652173913;0.391304347826087
Control.SRR15539829;49;45;0.571428571428571;21;28;0.0714285714285714;0.428571428571429
Control.SRR15539829;50;45;0.54;23;27;0.04;0.46
Control.SRR15539829;45;45;0.622222222222222;17;28;0.122222222222222;0.377777777777778
Control.SRR15539829;44;45;0.477272727272727;23;21;0.0227272727272727;0.477272727272727
Control.SRR15539829;43;45;0.465116279069767;23;20;0.0348837209302326;0.465116279069767
Control.SRR15539829;48;45;0.395833333333333;29;19;0.104166666666667;0.395833333333333
Control.SRR15539829;49;45;0.428571428571429;28;21;0.0714285714285715;0.428571428571429
Control.SRR15539829;50;45;0.6;20;30;0.1;0.4
Control.SRR15539829;50;45;0.44;28;22;0.06;0.44
Control.SRR15539829;39;45;0.487179487179487;20;19;0.0128205128205128;0.487179487179487
Control.SRR15539829;40;45;0.425;23;17;0.075;0.425
Control.SRR15539829;43;45;0.395348837209302;26;17;0.104651162790698;0.395348837209302
Control.SRR15539829;46;45;0.521739130434783;22;24;0.0217391304347826;0.478260869565217
Control.SRR15539829;45;45;0.555555555555556;20;25;0.0555555555555556;0.444444444444444
Control.SRR15539829;47;45;0.425531914893617;27;20;0.074468085106383;0.425531914893617
Control.SRR15539829;42;45;0.523809523809524;20;22;0.0238095238095238;0.476190476190476
Control.SRR15539829;39;45;0.538461538461538;18;21;0.0384615384615384;0.461538461538462
Control.SRR15539829;43;45;0.534883720930233;20;23;0.0348837209302325;0.465116279069767
Control.SRR15539829;43;45;0.511627906976744;21;22;0.0116279069767442;0.488372093023256
Control.SRR15539829;43;45;0.465116279069767;23;20;0.0348837209302326;0.465116279069767
Control.SRR15539829;44;45;0.568181818181818;19;25;0.0681818181818182;0.431818181818182
Control.SRR15539829;45;45;0.511111111111111;22;23;0.0111111111111111;0.488888888888889
Control.SRR15539829;50;45;0.32;34;16;0.18;0.32
Control.SRR15539829;44;45;0.5;22;22;0;0.5
Control.SRR15539829;47;45;0.425531914893617;27;20;0.074468085106383;0.425531914893617
Control.SRR15539829;44;45;0.522727272727273;21;23;0.0227272727272727;0.477272727272727
Control.SRR15539829;50;45;0.5;25;25;0;0.5
Control.SRR15539829;51;45;0.509803921568627;25;26;0.00980392156862742;0.490196078431373
Control.SRR15539829;47;45;0.531914893617021;22;25;0.0319148936170213;0.468085106382979
Control.SRR15539829;48;45;0.5625;21;27;0.0625;0.4375
Control.SRR15539829;49;45;0.489795918367347;25;24;0.0102040816326531;0.489795918367347
Control.SRR15539829;48;45;0.4375;27;21;0.0625;0.4375
Control.SRR15539829;46;45;0.695652173913043;14;32;0.195652173913043;0.304347826086957
Control.SRR15539829;47;45;0.574468085106383;20;27;0.074468085106383;0.425531914893617
Control.SRR15539829;49;45;0.428571428571429;28;21;0.0714285714285715;0.428571428571429
Control.SRR15539829;48;45;0.5;24;24;0;0.5
Control.SRR15539829;51;45;0.372549019607843;32;19;0.127450980392157;0.372549019607843
Control.SRR15539829;45;45;0.555555555555556;20;25;0.0555555555555556;0.444444444444444
Control.SRR15539829;48;45;0.541666666666667;22;26;0.0416666666666666;0.458333333333333
Control.SRR15539829;41;45;0.317073170731707;28;13;0.182926829268293;0.317073170731707
Control.SRR15539829;44;45;0.409090909090909;26;18;0.0909090909090909;0.409090909090909
Control.SRR15539829;41;45;0.634146341463415;15;26;0.134146341463415;0.365853658536585
Control.SRR15539829;48;45;0.5;24;24;0;0.5
Control.SRR15539829;41;45;0.439024390243902;23;18;0.0609756097560976;0.439024390243902
Control.SRR15539829;45;45;0.622222222222222;17;28;0.122222222222222;0.377777777777778
Control.SRR15539829;44;45;0.431818181818182;25;19;0.0681818181818182;0.431818181818182
Control.SRR15539829;46;45;0.521739130434783;22;24;0.0217391304347826;0.478260869565217
Control.SRR15539829;47;45;0.48936170212766;24;23;0.0106382978723404;0.48936170212766
Control.SRR15539829;47;45;0.404255319148936;28;19;0.0957446808510639;0.404255319148936
Control.SRR15539829;46;45;0.608695652173913;18;28;0.108695652173913;0.391304347826087
Control.SRR15539829;45;45;0.511111111111111;22;23;0.0111111111111111;0.488888888888889
Control.SRR15539829;40;45;0.5;20;20;0;0.5
Control.SRR15539829;44;45;0.386363636363636;27;17;0.113636363636364;0.386363636363636
Control.SRR15539829;42;45;0.642857142857143;15;27;0.142857142857143;0.357142857142857
Control.SRR15539829;43;45;0.534883720930233;20;23;0.0348837209302325;0.465116279069767
Control.SRR15539829;41;45;0.414634146341463;24;17;0.0853658536585366;0.414634146341463
Control.SRR15539829;47;45;0.382978723404255;29;18;0.117021276595745;0.382978723404255
Control.SRR15539829;42;45;0.5;21;21;0;0.5
Control.SRR15539829;41;45;0.585365853658537;17;24;0.0853658536585366;0.414634146341463
Control.SRR15539829;46;45;0.5;23;23;0;0.5
Control.SRR15539829;46;45;0.5;23;23;0;0.5
Control.SRR15539829;47;45;0.638297872340426;17;30;0.138297872340426;0.361702127659574
Control.SRR15539829;48;45;0.479166666666667;25;23;0.0208333333333333;0.479166666666667
Control.SRR15539829;49;45;0.469387755102041;26;23;0.0306122448979592;0.469387755102041
Control.SRR15539829;45;45;0.488888888888889;23;22;0.0111111111111111;0.488888888888889
Control.SRR15539829;47;45;0.51063829787234;23;24;0.0106382978723404;0.48936170212766
Control.SRR15539829;50;45;0.42;29;21;0.08;0.42
Control.SRR15539829;42;45;0.476190476190476;22;20;0.0238095238095238;0.476190476190476
Control.SRR15539829;42;45;0.404761904761905;25;17;0.0952380952380952;0.404761904761905
Control.SRR15539829;45;45;0.488888888888889;23;22;0.0111111111111111;0.488888888888889
Control.SRR15539829;46;45;0.478260869565217;24;22;0.0217391304347826;0.478260869565217
Control.SRR15539829;45;45;0.4;27;18;0.1;0.4
Control.SRR15539829;40;45;0.525;19;21;0.025;0.475
Control.SRR15539829;45;45;0.488888888888889;23;22;0.0111111111111111;0.488888888888889
Control.SRR15539829;44;45;0.477272727272727;23;21;0.0227272727272727;0.477272727272727
Control.SRR15539829;40;45;0.55;18;22;0.05;0.45
Control.SRR15539829;41;45;0.536585365853659;19;22;0.0365853658536586;0.463414634146341
Control.SRR15539829;43;45;0.488372093023256;22;21;0.0116279069767442;0.488372093023256
Control.SRR15539829;41;45;0.536585365853659;19;22;0.0365853658536586;0.463414634146341
Control.SRR15539829;46;45;0.521739130434783;22;24;0.0217391304347826;0.478260869565217
Control.SRR15539829;47;45;0.574468085106383;20;27;0.074468085106383;0.425531914893617
Control.SRR15539829;42;45;0.5;21;21;0;0.5
Control.SRR15539829;43;45;0.465116279069767;23;20;0.0348837209302326;0.465116279069767
Control.SRR15539829;44;45;0.568181818181818;19;25;0.0681818181818182;0.431818181818182
Control.SRR15539829;39;45;0.487179487179487;20;19;0.0128205128205128;0.487179487179487
Control.SRR15539829;45;45;0.355555555555556;29;16;0.144444444444444;0.355555555555556
Control.SRR15539829;43;45;0.558139534883721;19;24;0.0581395348837209;0.441860465116279
Control.SRR15539829;50;45;0.56;22;28;0.0600000000000001;0.44
Control.SRR15539829;42;45;0.571428571428571;18;24;0.0714285714285714;0.428571428571429
Control.SRR15539829;48;45;0.520833333333333;23;25;0.0208333333333334;0.479166666666667
Control.SRR15539829;47;45;0.574468085106383;20;27;0.074468085106383;0.425531914893617
Control.SRR15539829;47;45;0.382978723404255;29;18;0.117021276595745;0.382978723404255
Control.SRR15539829;44;45;0.545454545454545;20;24;0.0454545454545454;0.454545454545455
Control.SRR15539829;43;45;0.604651162790698;17;26;0.104651162790698;0.395348837209302
Control.SRR15539829;51;45;0.411764705882353;30;21;0.0882352941176471;0.411764705882353
Control.SRR15539829;42;45;0.404761904761905;25;17;0.0952380952380952;0.404761904761905
Control.SRR15539829;41;45;0.51219512195122;20;21;0.0121951219512195;0.48780487804878
Control.SRR15539829;42;45;0.452380952380952;23;19;0.0476190476190476;0.452380952380952
Control.SRR15539829;45;45;0.6;18;27;0.1;0.4
Control.SRR15539829;43;45;0.511627906976744;21;22;0.0116279069767442;0.488372093023256
Control.SRR15539829;48;45;0.583333333333333;20;28;0.0833333333333334;0.416666666666667
Control.SRR15539829;47;45;0.574468085106383;20;27;0.074468085106383;0.425531914893617
Control.SRR15539829;49;45;0.63265306122449;18;31;0.13265306122449;0.36734693877551
Control.SRR15539829;47;45;0.553191489361702;21;26;0.0531914893617021;0.446808510638298
Control.SRR15539829;43;45;0.488372093023256;22;21;0.0116279069767442;0.488372093023256
Control.SRR15539829;40;45;0.5;20;20;0;0.5
Control.SRR15539829;41;45;0.51219512195122;20;21;0.0121951219512195;0.48780487804878
Control.SRR15539829;42;45;0.476190476190476;22;20;0.0238095238095238;0.476190476190476
Control.SRR15539829;48;45;0.5;24;24;0;0.5
Control.SRR15539829;44;45;0.568181818181818;19;25;0.0681818181818182;0.431818181818182
Control.SRR15539829;50;45;0.46;27;23;0.04;0.46
Control.SRR15539829;47;45;0.425531914893617;27;20;0.074468085106383;0.425531914893617
Control.SRR15539829;51;45;0.470588235294118;27;24;0.0294117647058824;0.470588235294118
Control.SRR15539829;48;45;0.5625;21;27;0.0625;0.4375
Control.SRR15539829;48;45;0.520833333333333;23;25;0.0208333333333334;0.479166666666667
Control.SRR15539829;46;45;0.41304347826087;27;19;0.0869565217391304;0.41304347826087
Control.SRR15539829;49;45;0.408163265306122;29;20;0.0918367346938775;0.408163265306122
Control.SRR15539829;40;45;0.475;21;19;0.025;0.475
Control.SRR15539829;42;45;0.5;21;21;0;0.5
Control.SRR15539829;50;45;0.6;20;30;0.1;0.4
Control.SRR15539829;44;45;0.5;22;22;0;0.5
Control.SRR15539829;45;45;0.466666666666667;24;21;0.0333333333333333;0.466666666666667
Control.SRR15539829;44;45;0.386363636363636;27;17;0.113636363636364;0.386363636363636
Control.SRR15539829;42;45;0.428571428571429;24;18;0.0714285714285715;0.428571428571429
Control.SRR15539829;44;45;0.340909090909091;29;15;0.159090909090909;0.340909090909091
Control.SRR15539829;47;45;0.531914893617021;22;25;0.0319148936170213;0.468085106382979
Control.SRR15539829;48;45;0.25;36;12;0.25;0.25
Control.SRR15539829;44;45;0.590909090909091;18;26;0.0909090909090909;0.409090909090909
Control.SRR15539829;40;45;0.55;18;22;0.05;0.45
Control.SRR15539829;45;45;0.422222222222222;26;19;0.0777777777777778;0.422222222222222
Control.SRR15539829;51;45;0.470588235294118;27;24;0.0294117647058824;0.470588235294118
Control.SRR15539829;49;45;0.530612244897959;23;26;0.0306122448979592;0.469387755102041
Control.SRR15539829;41;45;0.463414634146341;22;19;0.0365853658536585;0.463414634146341
Control.SRR15539829;41;45;0.48780487804878;21;20;0.0121951219512195;0.48780487804878
Control.SRR15539829;44;45;0.431818181818182;25;19;0.0681818181818182;0.431818181818182
Control.SRR15539829;39;45;0.538461538461538;18;21;0.0384615384615384;0.461538461538462
Control.SRR15539829;42;45;0.5;21;21;0;0.5
Control.SRR15539829;45;45;0.488888888888889;23;22;0.0111111111111111;0.488888888888889
Control.SRR15539829;50;45;0.52;24;26;0.02;0.48
Control.SRR15539829;44;45;0.340909090909091;29;15;0.159090909090909;0.340909090909091
Control.SRR15539829;47;45;0.446808510638298;26;21;0.0531914893617021;0.446808510638298
Control.SRR15539829;47;45;0.468085106382979;25;22;0.0319148936170213;0.468085106382979
Control.SRR15539829;42;45;0.547619047619048;19;23;0.0476190476190477;0.452380952380952
Control.SRR15539829;43;45;0.604651162790698;17;26;0.104651162790698;0.395348837209302
Control.SRR15539829;50;45;0.54;23;27;0.04;0.46
Control.SRR15539829;42;45;0.5;21;21;0;0.5
Control.SRR15539829;44;45;0.454545454545455;24;20;0.0454545454545455;0.454545454545455
Control.SRR15539829;42;45;0.547619047619048;19;23;0.0476190476190477;0.452380952380952
Control.SRR15539829;46;45;0.434782608695652;26;20;0.0652173913043478;0.434782608695652
Control.SRR15539829;47;45;0.468085106382979;25;22;0.0319148936170213;0.468085106382979
Control.SRR15539829;51;45;0.549019607843137;23;28;0.0490196078431373;0.450980392156863
Control.SRR15539829;44;45;0.590909090909091;18;26;0.0909090909090909;0.409090909090909
Control.SRR15539829;44;45;0.477272727272727;23;21;0.0227272727272727;0.477272727272727
Control.SRR15539829;41;45;0.48780487804878;21;20;0.0121951219512195;0.48780487804878
Control.SRR15539829;41;45;0.585365853658537;17;24;0.0853658536585366;0.414634146341463
Control.SRR15539829;42;45;0.452380952380952;23;19;0.0476190476190476;0.452380952380952
Control.SRR15539829;45;45;0.444444444444444;25;20;0.0555555555555556;0.444444444444444
Control.SRR15539829;46;45;0.521739130434783;22;24;0.0217391304347826;0.478260869565217
Control.SRR15539829;47;45;0.446808510638298;26;21;0.0531914893617021;0.446808510638298
Control.SRR15539829;48;45;0.333333333333333;32;16;0.166666666666667;0.333333333333333
Control.SRR15539829;42;45;0.595238095238095;17;25;0.0952380952380952;0.404761904761905
Control.SRR15539829;50;45;0.6;20;30;0.1;0.4
Control.SRR15539829;47;45;0.531914893617021;22;25;0.0319148936170213;0.468085106382979
Control.SRR15539829;49;45;0.346938775510204;32;17;0.153061224489796;0.346938775510204
Control.SRR15539829;47;45;0.51063829787234;23;24;0.0106382978723404;0.48936170212766
Control.SRR15539829;48;45;0.458333333333333;26;22;0.0416666666666667;0.458333333333333
Control.SRR15539829;41;45;0.585365853658537;17;24;0.0853658536585366;0.414634146341463
Control.SRR15539829;47;45;0.446808510638298;26;21;0.0531914893617021;0.446808510638298
Control.SRR15539829;42;45;0.571428571428571;18;24;0.0714285714285714;0.428571428571429
Control.SRR15539829;47;45;0.468085106382979;25;22;0.0319148936170213;0.468085106382979
Control.SRR15539829;49;45;0.653061224489796;17;32;0.153061224489796;0.346938775510204
Control.SRR15539829;46;45;0.456521739130435;25;21;0.0434782608695652;0.456521739130435
Control.SRR15539829;49;45;0.469387755102041;26;23;0.0306122448979592;0.469387755102041
Control.SRR15539829;47;45;0.51063829787234;23;24;0.0106382978723404;0.48936170212766
Control.SRR15539829;46;45;0.565217391304348;20;26;0.0652173913043478;0.434782608695652
Control.SRR15539829;46;45;0.369565217391304;29;17;0.130434782608696;0.369565217391304
Control.SRR15539829;42;45;0.404761904761905;25;17;0.0952380952380952;0.404761904761905
Control.SRR15539829;47;45;0.446808510638298;26;21;0.0531914893617021;0.446808510638298
Control.SRR15539829;51;45;0.450980392156863;28;23;0.0490196078431372;0.450980392156863
Control.SRR15539829;47;45;0.553191489361702;21;26;0.0531914893617021;0.446808510638298
Control.SRR15539829;47;45;0.531914893617021;22;25;0.0319148936170213;0.468085106382979
Control.SRR15539829;40;45;0.425;23;17;0.075;0.425
Control.SRR15539829;42;45;0.547619047619048;19;23;0.0476190476190477;0.452380952380952
Control.SRR15539829;50;45;0.52;24;26;0.02;0.48
Control.SRR15539829;43;45;0.488372093023256;22;21;0.0116279069767442;0.488372093023256
Control.SRR15539829;39;45;0.564102564102564;17;22;0.0641025641025641;0.435897435897436
Control.SRR15539829;40;45;0.525;19;21;0.025;0.475
Control.SRR15539829;41;45;0.390243902439024;25;16;0.109756097560976;0.390243902439024
Control.SRR15539829;43;45;0.581395348837209;18;25;0.0813953488372093;0.418604651162791
Control.SRR15539829;42;45;0.452380952380952;23;19;0.0476190476190476;0.452380952380952
Control.SRR15539829;40;45;0.475;21;19;0.025;0.475
Control.SRR15539829;39;45;0.564102564102564;17;22;0.0641025641025641;0.435897435897436
Control.SRR15539829;46;45;0.5;23;23;0;0.5
Control.SRR15539829;47;45;0.51063829787234;23;24;0.0106382978723404;0.48936170212766
Control.SRR15539829;47;45;0.531914893617021;22;25;0.0319148936170213;0.468085106382979
Control.SRR15539829;47;45;0.553191489361702;21;26;0.0531914893617021;0.446808510638298
Control.SRR15539829;47;45;0.361702127659574;30;17;0.138297872340426;0.361702127659574
Control.SRR15539829;47;45;0.51063829787234;23;24;0.0106382978723404;0.48936170212766
Control.SRR15539829;43;45;0.488372093023256;22;21;0.0116279069767442;0.488372093023256
Control.SRR15539829;44;45;0.590909090909091;18;26;0.0909090909090909;0.409090909090909
Control.SRR15539829;47;45;0.553191489361702;21;26;0.0531914893617021;0.446808510638298
Control.SRR15539829;45;45;0.488888888888889;23;22;0.0111111111111111;0.488888888888889
Control.SRR15539829;46;45;0.58695652173913;19;27;0.0869565217391305;0.41304347826087
Control.SRR15539829;46;45;0.5;23;23;0;0.5
Control.SRR15539829;51;45;0.529411764705882;24;27;0.0294117647058824;0.470588235294118
Control.SRR15539829;45;45;0.533333333333333;21;24;0.0333333333333333;0.466666666666667
Control.SRR15539829;42;45;0.452380952380952;23;19;0.0476190476190476;0.452380952380952
Control.SRR15539829;47;45;0.446808510638298;26;21;0.0531914893617021;0.446808510638298
Control.SRR15539829;51;45;0.450980392156863;28;23;0.0490196078431372;0.450980392156863
Control.SRR15539829;42;45;0.523809523809524;20;22;0.0238095238095238;0.476190476190476
Control.SRR15539829;43;45;0.604651162790698;17;26;0.104651162790698;0.395348837209302
Control.SRR15539829;51;45;0.470588235294118;27;24;0.0294117647058824;0.470588235294118
Control.SRR15539829;42;45;0.547619047619048;19;23;0.0476190476190477;0.452380952380952
Control.SRR15539829;41;45;0.292682926829268;29;12;0.207317073170732;0.292682926829268
Control.SRR15539829;46;45;0.5;23;23;0;0.5
Control.SRR15539829;49;45;0.26530612244898;36;13;0.23469387755102;0.26530612244898
Control.SRR15539829;49;45;0.428571428571429;28;21;0.0714285714285715;0.428571428571429
Control.SRR15539829;41;45;0.51219512195122;20;21;0.0121951219512195;0.48780487804878
Control.SRR15539829;48;45;0.4375;27;21;0.0625;0.4375
Control.SRR15539829;43;45;0.511627906976744;21;22;0.0116279069767442;0.488372093023256
Control.SRR15539829;49;45;0.428571428571429;28;21;0.0714285714285715;0.428571428571429
Control.SRR15539829;41;45;0.658536585365854;14;27;0.158536585365854;0.341463414634146
Control.SRR15539829;51;45;0.705882352941177;15;36;0.205882352941177;0.294117647058824
Control.SRR15539829;48;45;0.520833333333333;23;25;0.0208333333333334;0.479166666666667
Control.SRR15539829;40;45;0.575;17;23;0.075;0.425
Control.SRR15539829;45;45;0.511111111111111;22;23;0.0111111111111111;0.488888888888889
Control.SRR15539829;42;45;0.5;21;21;0;0.5
Control.SRR15539829;44;45;0.409090909090909;26;18;0.0909090909090909;0.409090909090909
Control.SRR15539829;39;45;0.384615384615385;24;15;0.115384615384615;0.384615384615385
Control.SRR15539829;50;45;0.46;27;23;0.04;0.46
Control.SRR15539829;43;45;0.441860465116279;24;19;0.0581395348837209;0.441860465116279
Control.SRR15539829;48;45;0.4375;27;21;0.0625;0.4375
Control.SRR15539829;50;45;0.56;22;28;0.0600000000000001;0.44
Control.SRR15539829;39;45;0.538461538461538;18;21;0.0384615384615384;0.461538461538462
Control.SRR15539829;51;45;0.529411764705882;24;27;0.0294117647058824;0.470588235294118
Control.SRR15539829;48;45;0.416666666666667;28;20;0.0833333333333333;0.416666666666667
Control.SRR15539829;49;45;0.387755102040816;30;19;0.112244897959184;0.387755102040816
Control.SRR15539829;46;45;0.565217391304348;20;26;0.0652173913043478;0.434782608695652
Control.SRR15539829;43;45;0.465116279069767;23;20;0.0348837209302326;0.465116279069767
Control.SRR15539829;47;45;0.51063829787234;23;24;0.0106382978723404;0.48936170212766
Control.SRR15539829;47;45;0.468085106382979;25;22;0.0319148936170213;0.468085106382979
Control.SRR15539829;43;45;0.558139534883721;19;24;0.0581395348837209;0.441860465116279
Control.SRR15539829;43;45;0.558139534883721;19;24;0.0581395348837209;0.441860465116279
Control.SRR15539829;46;45;0.478260869565217;24;22;0.0217391304347826;0.478260869565217
Control.SRR15539829;44;45;0.613636363636364;17;27;0.113636363636364;0.386363636363636
Control.SRR15539829;51;45;0.549019607843137;23;28;0.0490196078431373;0.450980392156863
Control.SRR15539829;48;45;0.5625;21;27;0.0625;0.4375
Control.SRR15539829;40;45;0.5;20;20;0;0.5
Control.SRR15539829;41;45;0.463414634146341;22;19;0.0365853658536585;0.463414634146341
Control.SRR15539829;47;45;0.468085106382979;25;22;0.0319148936170213;0.468085106382979
Control.SRR15539829;47;45;0.48936170212766;24;23;0.0106382978723404;0.48936170212766
Control.SRR15539829;47;45;0.574468085106383;20;27;0.074468085106383;0.425531914893617
Control.SRR15539829;51;45;0.490196078431373;26;25;0.00980392156862747;0.490196078431373
Control.SRR15539829;44;45;0.477272727272727;23;21;0.0227272727272727;0.477272727272727
Control.SRR15539829;49;45;0.551020408163265;22;27;0.0510204081632653;0.448979591836735
Control.SRR15539829;47;45;0.468085106382979;25;22;0.0319148936170213;0.468085106382979
Control.SRR15539829;50;45;0.48;26;24;0.02;0.48
Control.SRR15539829;43;45;0.395348837209302;26;17;0.104651162790698;0.395348837209302
Control.SRR15539829;47;45;0.404255319148936;28;19;0.0957446808510639;0.404255319148936
Control.SRR15539829;45;45;0.533333333333333;21;24;0.0333333333333333;0.466666666666667
Control.SRR15539829;45;45;0.555555555555556;20;25;0.0555555555555556;0.444444444444444
Control.SRR15539829;39;45;0.435897435897436;22;17;0.0641025641025641;0.435897435897436
Control.SRR15539829;47;45;0.48936170212766;24;23;0.0106382978723404;0.48936170212766
Control.SRR15539829;49;45;0.408163265306122;29;20;0.0918367346938775;0.408163265306122
Control.SRR15539829;44;45;0.477272727272727;23;21;0.0227272727272727;0.477272727272727
Control.SRR15539829;46;45;0.565217391304348;20;26;0.0652173913043478;0.434782608695652
Control.SRR15539829;51;45;0.549019607843137;23;28;0.0490196078431373;0.450980392156863
Control.SRR15539829;47;45;0.531914893617021;22;25;0.0319148936170213;0.468085106382979
Control.SRR15539829;40;45;0.475;21;19;0.025;0.475
Control.SRR15539829;47;45;0.595744680851064;19;28;0.0957446808510638;0.404255319148936
Control.SRR15539829;42;45;0.261904761904762;31;11;0.238095238095238;0.261904761904762
Control.SRR15539829;49;45;0.653061224489796;17;32;0.153061224489796;0.346938775510204
Control.SRR15539829;41;45;0.439024390243902;23;18;0.0609756097560976;0.439024390243902
Control.SRR15539829;47;45;0.446808510638298;26;21;0.0531914893617021;0.446808510638298
Control.SRR15539829;39;45;0.487179487179487;20;19;0.0128205128205128;0.487179487179487
Control.SRR15539829;42;45;0.571428571428571;18;24;0.0714285714285714;0.428571428571429
Control.SRR15539829;43;45;0.534883720930233;20;23;0.0348837209302325;0.465116279069767
Control.SRR15539829;40;45;0.4;24;16;0.1;0.4
Control.SRR15539829;47;45;0.638297872340426;17;30;0.138297872340426;0.361702127659574
Control.SRR15539829;48;45;0.354166666666667;31;17;0.145833333333333;0.354166666666667
Control.SRR15539829;47;45;0.659574468085106;16;31;0.159574468085106;0.340425531914894
Control.SRR15539829;45;45;0.4;27;18;0.1;0.4
Control.SRR15539829;48;45;0.604166666666667;19;29;0.104166666666667;0.395833333333333
Control.SRR15539829;44;45;0.454545454545455;24;20;0.0454545454545455;0.454545454545455
Control.SRR15539829;43;45;0.558139534883721;19;24;0.0581395348837209;0.441860465116279
Control.SRR15539829;41;45;0.536585365853659;19;22;0.0365853658536586;0.463414634146341
Control.SRR15539829;41;45;0.439024390243902;23;18;0.0609756097560976;0.439024390243902
Control.SRR15539829;41;45;0.585365853658537;17;24;0.0853658536585366;0.414634146341463
Control.SRR15539829;39;45;0.487179487179487;20;19;0.0128205128205128;0.487179487179487
Control.SRR15539829;49;45;0.571428571428571;21;28;0.0714285714285714;0.428571428571429
Control.SRR15539829;43;45;0.581395348837209;18;25;0.0813953488372093;0.418604651162791
Control.SRR15539829;43;45;0.488372093023256;22;21;0.0116279069767442;0.488372093023256
Control.SRR15539829;42;45;0.380952380952381;26;16;0.119047619047619;0.380952380952381
Control.SRR15539829;46;45;0.478260869565217;24;22;0.0217391304347826;0.478260869565217
Control.SRR15539829;47;45;0.48936170212766;24;23;0.0106382978723404;0.48936170212766
Control.SRR15539829;41;45;0.560975609756098;18;23;0.0609756097560976;0.439024390243902
Control.SRR15539829;47;45;0.48936170212766;24;23;0.0106382978723404;0.48936170212766
Control.SRR15539829;42;45;0.5;21;21;0;0.5
Control.SRR15539829;49;45;0.469387755102041;26;23;0.0306122448979592;0.469387755102041
Control.SRR15539829;43;45;0.395348837209302;26;17;0.104651162790698;0.395348837209302
Control.SRR15539829;48;45;0.4375;27;21;0.0625;0.4375
Control.SRR15539829;44;45;0.5;22;22;0;0.5
Control.SRR15539829;48;45;0.395833333333333;29;19;0.104166666666667;0.395833333333333
Control.SRR15539829;46;45;0.543478260869565;21;25;0.0434782608695652;0.456521739130435
Control.SRR15539829;43;45;0.441860465116279;24;19;0.0581395348837209;0.441860465116279
Control.SRR15539829;45;45;0.355555555555556;29;16;0.144444444444444;0.355555555555556
Control.SRR15539829;42;45;0.571428571428571;18;24;0.0714285714285714;0.428571428571429
Control.SRR15539829;46;45;0.478260869565217;24;22;0.0217391304347826;0.478260869565217
Control.SRR15539829;49;45;0.408163265306122;29;20;0.0918367346938775;0.408163265306122
Control.SRR15539829;49;45;0.387755102040816;30;19;0.112244897959184;0.387755102040816
Control.SRR15539829;44;45;0.590909090909091;18;26;0.0909090909090909;0.409090909090909
Control.SRR15539829;41;45;0.560975609756098;18;23;0.0609756097560976;0.439024390243902
Control.SRR15539829;41;45;0.609756097560976;16;25;0.109756097560976;0.390243902439024
Control.SRR15539829;47;45;0.617021276595745;18;29;0.117021276595745;0.382978723404255
Control.SRR15539829;49;45;0.469387755102041;26;23;0.0306122448979592;0.469387755102041
Control.SRR15539829;46;45;0.478260869565217;24;22;0.0217391304347826;0.478260869565217
Control.SRR15539829;44;45;0.5;22;22;0;0.5
Control.SRR15539829;47;45;0.48936170212766;24;23;0.0106382978723404;0.48936170212766
Control.SRR15539829;42;45;0.547619047619048;19;23;0.0476190476190477;0.452380952380952
Control.SRR15539829;46;45;0.391304347826087;28;18;0.108695652173913;0.391304347826087
Control.SRR15539829;45;45;0.377777777777778;28;17;0.122222222222222;0.377777777777778
Control.SRR15539829;46;45;0.5;23;23;0;0.5
Control.SRR15539829;47;45;0.446808510638298;26;21;0.0531914893617021;0.446808510638298
Control.SRR15539829;42;45;0.404761904761905;25;17;0.0952380952380952;0.404761904761905
Control.SRR15539829;50;45;0.34;33;17;0.16;0.34
Control.SRR15539829;43;45;0.511627906976744;21;22;0.0116279069767442;0.488372093023256
Control.SRR15539829;45;45;0.488888888888889;23;22;0.0111111111111111;0.488888888888889
Control.SRR15539829;43;45;0.511627906976744;21;22;0.0116279069767442;0.488372093023256
Control.SRR15539829;39;45;0.307692307692308;27;12;0.192307692307692;0.307692307692308
Control.SRR15539829;45;45;0.622222222222222;17;28;0.122222222222222;0.377777777777778
Control.SRR15539829;39;45;0.435897435897436;22;17;0.0641025641025641;0.435897435897436
Control.SRR15539829;39;45;0.58974358974359;16;23;0.0897435897435898;0.41025641025641
Control.SRR15539829;49;45;0.387755102040816;30;19;0.112244897959184;0.387755102040816
Control.SRR15539829;41;45;0.463414634146341;22;19;0.0365853658536585;0.463414634146341
Control.SRR15539829;42;45;0.357142857142857;27;15;0.142857142857143;0.357142857142857
Control.SRR15539829;44;45;0.522727272727273;21;23;0.0227272727272727;0.477272727272727
Control.SRR15539829;48;45;0.416666666666667;28;20;0.0833333333333333;0.416666666666667
Control.SRR15539829;49;45;0.469387755102041;26;23;0.0306122448979592;0.469387755102041
Control.SRR15539829;47;45;0.404255319148936;28;19;0.0957446808510639;0.404255319148936
Control.SRR15539829;44;45;0.431818181818182;25;19;0.0681818181818182;0.431818181818182
Control.SRR15539829;47;45;0.404255319148936;28;19;0.0957446808510639;0.404255319148936
Control.SRR15539829;48;45;0.541666666666667;22;26;0.0416666666666666;0.458333333333333
Control.SRR15539829;42;45;0.428571428571429;24;18;0.0714285714285715;0.428571428571429
Control.SRR15539829;39;45;0.41025641025641;23;16;0.0897435897435898;0.41025641025641
Control.SRR15539829;51;45;0.470588235294118;27;24;0.0294117647058824;0.470588235294118
Control.SRR15539829;51;45;0.470588235294118;27;24;0.0294117647058824;0.470588235294118
Control.SRR15539829;40;45;0.6;16;24;0.1;0.4
Control.SRR15539829;44;45;0.568181818181818;19;25;0.0681818181818182;0.431818181818182
Control.SRR15539829;47;45;0.51063829787234;23;24;0.0106382978723404;0.48936170212766
Control.SRR15539829;49;45;0.530612244897959;23;26;0.0306122448979592;0.469387755102041
Control.SRR15539829;47;45;0.48936170212766;24;23;0.0106382978723404;0.48936170212766
Control.SRR15539829;44;45;0.5;22;22;0;0.5
Control.SRR15539829;50;45;0.56;22;28;0.0600000000000001;0.44
Control.SRR15539829;49;45;0.510204081632653;24;25;0.0102040816326531;0.489795918367347
Control.SRR15539829;49;45;0.489795918367347;25;24;0.0102040816326531;0.489795918367347
Control.SRR15539829;49;45;0.469387755102041;26;23;0.0306122448979592;0.469387755102041
Control.SRR15539829;45;45;0.533333333333333;21;24;0.0333333333333333;0.466666666666667
Control.SRR15539829;42;45;0.666666666666667;14;28;0.166666666666667;0.333333333333333
Control.SRR15539829;39;45;0.435897435897436;22;17;0.0641025641025641;0.435897435897436
Control.SRR15539829;49;45;0.530612244897959;23;26;0.0306122448979592;0.469387755102041
Control.SRR15539829;44;45;0.386363636363636;27;17;0.113636363636364;0.386363636363636
Control.SRR15539829;44;45;0.477272727272727;23;21;0.0227272727272727;0.477272727272727
Control.SRR15539829;47;45;0.446808510638298;26;21;0.0531914893617021;0.446808510638298
Control.SRR15539829;51;45;0.490196078431373;26;25;0.00980392156862747;0.490196078431373
Control.SRR15539829;47;45;0.48936170212766;24;23;0.0106382978723404;0.48936170212766
Control.SRR15539829;44;45;0.5;22;22;0;0.5
Control.SRR15539829;42;45;0.5;21;21;0;0.5
Control.SRR15539829;46;45;0.456521739130435;25;21;0.0434782608695652;0.456521739130435
Control.SRR15539829;46;45;0.41304347826087;27;19;0.0869565217391304;0.41304347826087
Control.SRR15539829;44;45;0.522727272727273;21;23;0.0227272727272727;0.477272727272727
Control.SRR15539829;42;45;0.452380952380952;23;19;0.0476190476190476;0.452380952380952
Control.SRR15539829;46;45;0.521739130434783;22;24;0.0217391304347826;0.478260869565217
Control.SRR15539829;43;45;0.534883720930233;20;23;0.0348837209302325;0.465116279069767
Control.SRR15539829;40;45;0.5;20;20;0;0.5
Control.SRR15539829;46;45;0.456521739130435;25;21;0.0434782608695652;0.456521739130435
Control.SRR15539829;43;45;0.558139534883721;19;24;0.0581395348837209;0.441860465116279
Control.SRR15539829;45;45;0.533333333333333;21;24;0.0333333333333333;0.466666666666667
Control.SRR15539829;51;45;0.529411764705882;24;27;0.0294117647058824;0.470588235294118
Control.SRR15539829;50;45;0.48;26;24;0.02;0.48
Control.SRR15539829;42;45;0.5;21;21;0;0.5
Control.SRR15539829;43;45;0.534883720930233;20;23;0.0348837209302325;0.465116279069767
Control.SRR15539829;45;45;0.488888888888889;23;22;0.0111111111111111;0.488888888888889
Control.SRR15539829;51;45;0.588235294117647;21;30;0.0882352941176471;0.411764705882353
Control.SRR15539829;47;45;0.48936170212766;24;23;0.0106382978723404;0.48936170212766
Control.SRR15539829;48;45;0.625;18;30;0.125;0.375
Control.SRR15539829;50;45;0.52;24;26;0.02;0.48
Control.SRR15539829;40;45;0.475;21;19;0.025;0.475
Control.SRR15539829;48;45;0.479166666666667;25;23;0.0208333333333333;0.479166666666667
Control.SRR15539829;39;45;0.435897435897436;22;17;0.0641025641025641;0.435897435897436
Control.SRR15539829;44;45;0.363636363636364;28;16;0.136363636363636;0.363636363636364
Control.SRR15539829;44;45;0.522727272727273;21;23;0.0227272727272727;0.477272727272727
Control.SRR15539829;50;45;0.46;27;23;0.04;0.46
Control.SRR15539829;45;45;0.6;18;27;0.1;0.4
Control.SRR15539829;40;45;0.625;15;25;0.125;0.375
Control.SRR15539829;48;45;0.520833333333333;23;25;0.0208333333333334;0.479166666666667
Control.SRR15539829;39;45;0.384615384615385;24;15;0.115384615384615;0.384615384615385
Control.SRR15539829;43;45;0.534883720930233;20;23;0.0348837209302325;0.465116279069767
Control.SRR15539829;42;45;0.523809523809524;20;22;0.0238095238095238;0.476190476190476
Control.SRR15539829;50;45;0.56;22;28;0.0600000000000001;0.44
Control.SRR15539829;44;45;0.659090909090909;15;29;0.159090909090909;0.340909090909091
Control.SRR15539829;50;45;0.56;22;28;0.0600000000000001;0.44
Control.SRR15539829;50;45;0.6;20;30;0.1;0.4
Control.SRR15539829;49;45;0.469387755102041;26;23;0.0306122448979592;0.469387755102041
Control.SRR15539829;46;45;0.456521739130435;25;21;0.0434782608695652;0.456521739130435
Control.SRR15539829;50;45;0.56;22;28;0.0600000000000001;0.44
Control.SRR15539829;51;45;0.588235294117647;21;30;0.0882352941176471;0.411764705882353
Control.SRR15539829;50;45;0.48;26;24;0.02;0.48
Control.SRR15539829;48;45;0.4375;27;21;0.0625;0.4375
Control.SRR15539829;47;45;0.51063829787234;23;24;0.0106382978723404;0.48936170212766
Control.SRR15539829;47;45;0.51063829787234;23;24;0.0106382978723404;0.48936170212766
Control.SRR15539829;44;45;0.431818181818182;25;19;0.0681818181818182;0.431818181818182
Control.SRR15539829;43;45;0.558139534883721;19;24;0.0581395348837209;0.441860465116279
Control.SRR15539829;47;45;0.531914893617021;22;25;0.0319148936170213;0.468085106382979
Control.SRR15539829;50;45;0.48;26;24;0.02;0.48
Control.SRR15539829;46;45;0.478260869565217;24;22;0.0217391304347826;0.478260869565217
Control.SRR15539829;44;45;0.454545454545455;24;20;0.0454545454545455;0.454545454545455
Control.SRR15539829;46;45;0.543478260869565;21;25;0.0434782608695652;0.456521739130435
Control.SRR15539829;47;45;0.531914893617021;22;25;0.0319148936170213;0.468085106382979
Control.SRR15539829;40;45;0.6;16;24;0.1;0.4
Control.SRR15539829;40;45;0.65;14;26;0.15;0.35
Control.SRR15539829;48;45;0.416666666666667;28;20;0.0833333333333333;0.416666666666667
Control.SRR15539829;48;45;0.5;24;24;0;0.5
Control.SRR15539829;47;45;0.468085106382979;25;22;0.0319148936170213;0.468085106382979
Control.SRR15539829;44;45;0.545454545454545;20;24;0.0454545454545454;0.454545454545455
Control.SRR15539829;40;45;0.525;19;21;0.025;0.475
Control.SRR15539829;47;45;0.574468085106383;20;27;0.074468085106383;0.425531914893617
Control.SRR15539829;39;45;0.435897435897436;22;17;0.0641025641025641;0.435897435897436
Control.SRR15539829;48;45;0.625;18;30;0.125;0.375
Control.SRR15539829;50;45;0.5;25;25;0;0.5
Control.SRR15539829;49;45;0.551020408163265;22;27;0.0510204081632653;0.448979591836735
Control.SRR15539829;50;45;0.52;24;26;0.02;0.48
Control.SRR15539829;49;45;0.408163265306122;29;20;0.0918367346938775;0.408163265306122
Control.SRR15539829;50;45;0.56;22;28;0.0600000000000001;0.44
Control.SRR15539829;47;45;0.553191489361702;21;26;0.0531914893617021;0.446808510638298
Control.SRR15539829;48;45;0.458333333333333;26;22;0.0416666666666667;0.458333333333333
Control.SRR15539829;39;45;0.487179487179487;20;19;0.0128205128205128;0.487179487179487
Control.SRR15539829;41;45;0.48780487804878;21;20;0.0121951219512195;0.48780487804878
Control.SRR15539829;40;45;0.525;19;21;0.025;0.475
Control.SRR15539829;40;45;0.475;21;19;0.025;0.475
Control.SRR15539829;47;45;0.446808510638298;26;21;0.0531914893617021;0.446808510638298
Control.SRR15539829;49;45;0.591836734693878;20;29;0.0918367346938775;0.408163265306122
Control.SRR15539829;51;45;0.607843137254902;20;31;0.107843137254902;0.392156862745098
Control.SRR15539829;51;45;0.549019607843137;23;28;0.0490196078431373;0.450980392156863
Control.SRR15539829;46;45;0.521739130434783;22;24;0.0217391304347826;0.478260869565217
Control.SRR15539829;40;45;0.575;17;23;0.075;0.425
Control.SRR15539829;50;45;0.54;23;27;0.04;0.46
Control.SRR15539829;43;45;0.511627906976744;21;22;0.0116279069767442;0.488372093023256
Control.SRR15539829;42;45;0.547619047619048;19;23;0.0476190476190477;0.452380952380952
Control.SRR15539829;43;45;0.465116279069767;23;20;0.0348837209302326;0.465116279069767
Control.SRR15539829;43;45;0.488372093023256;22;21;0.0116279069767442;0.488372093023256
Control.SRR15539829;51;45;0.333333333333333;34;17;0.166666666666667;0.333333333333333
Control.SRR15539829;48;45;0.416666666666667;28;20;0.0833333333333333;0.416666666666667
Control.SRR15539829;40;45;0.425;23;17;0.075;0.425
Control.SRR15539829;51;45;0.509803921568627;25;26;0.00980392156862742;0.490196078431373
Control.SRR15539829;46;45;0.521739130434783;22;24;0.0217391304347826;0.478260869565217
Control.SRR15539829;46;45;0.565217391304348;20;26;0.0652173913043478;0.434782608695652
Control.SRR15539829;47;45;0.531914893617021;22;25;0.0319148936170213;0.468085106382979
Control.SRR15539829;47;45;0.51063829787234;23;24;0.0106382978723404;0.48936170212766
Control.SRR15539829;42;45;0.523809523809524;20;22;0.0238095238095238;0.476190476190476
Control.SRR15539829;44;45;0.454545454545455;24;20;0.0454545454545455;0.454545454545455
Control.SRR15539829;44;45;0.5;22;22;0;0.5
Control.SRR15539829;43;45;0.418604651162791;25;18;0.0813953488372093;0.418604651162791
Control.SRR15539829;48;45;0.541666666666667;22;26;0.0416666666666666;0.458333333333333
Control.SRR15539829;50;45;0.6;20;30;0.1;0.4
Control.SRR15539829;45;45;0.466666666666667;24;21;0.0333333333333333;0.466666666666667
Control.SRR15539829;42;45;0.380952380952381;26;16;0.119047619047619;0.380952380952381
Control.SRR15539829;49;45;0.489795918367347;25;24;0.0102040816326531;0.489795918367347
Control.SRR15539829;46;45;0.543478260869565;21;25;0.0434782608695652;0.456521739130435
Control.SRR15539829;51;45;0.509803921568627;25;26;0.00980392156862742;0.490196078431373
Control.SRR15539829;47;45;0.51063829787234;23;24;0.0106382978723404;0.48936170212766
Control.SRR15539829;48;45;0.395833333333333;29;19;0.104166666666667;0.395833333333333
Control.SRR15539829;48;45;0.395833333333333;29;19;0.104166666666667;0.395833333333333
Control.SRR15539829;49;45;0.510204081632653;24;25;0.0102040816326531;0.489795918367347
Control.SRR15539829;47;45;0.531914893617021;22;25;0.0319148936170213;0.468085106382979
Control.SRR15539829;49;45;0.510204081632653;24;25;0.0102040816326531;0.489795918367347
Control.SRR15539829;40;45;0.5;20;20;0;0.5
Control.SRR15539829;42;45;0.5;21;21;0;0.5
Control.SRR15539829;47;45;0.446808510638298;26;21;0.0531914893617021;0.446808510638298
Control.SRR15539829;49;45;0.428571428571429;28;21;0.0714285714285715;0.428571428571429
Control.SRR15539829;50;45;0.58;21;29;0.08;0.42
Control.SRR15539829;46;45;0.456521739130435;25;21;0.0434782608695652;0.456521739130435
Control.SRR15539829;47;45;0.382978723404255;29;18;0.117021276595745;0.382978723404255
Control.SRR15539829;46;45;0.521739130434783;22;24;0.0217391304347826;0.478260869565217
Control.SRR15539829;44;45;0.545454545454545;20;24;0.0454545454545454;0.454545454545455
Control.SRR15539829;48;45;0.458333333333333;26;22;0.0416666666666667;0.458333333333333
Control.SRR15539829;44;45;0.545454545454545;20;24;0.0454545454545454;0.454545454545455
Control.SRR15539829;42;45;0.5;21;21;0;0.5
Control.SRR15539829;42;45;0.595238095238095;17;25;0.0952380952380952;0.404761904761905
Control.SRR15539829;51;45;0.568627450980392;22;29;0.0686274509803921;0.431372549019608
Control.SRR15539829;48;45;0.541666666666667;22;26;0.0416666666666666;0.458333333333333
Control.SRR15539829;51;45;0.607843137254902;20;31;0.107843137254902;0.392156862745098
Control.SRR15539829;49;45;0.551020408163265;22;27;0.0510204081632653;0.448979591836735
Control.SRR15539829;46;45;0.326086956521739;31;15;0.173913043478261;0.326086956521739
Control.SRR15539829;51;45;0.568627450980392;22;29;0.0686274509803921;0.431372549019608
Control.SRR15539829;48;45;0.458333333333333;26;22;0.0416666666666667;0.458333333333333
Control.SRR15539829;45;45;0.555555555555556;20;25;0.0555555555555556;0.444444444444444
Control.SRR15539829;51;45;0.529411764705882;24;27;0.0294117647058824;0.470588235294118
Control.SRR15539829;50;45;0.58;21;29;0.08;0.42
Control.SRR15539829;39;45;0.538461538461538;18;21;0.0384615384615384;0.461538461538462
Control.SRR15539829;48;45;0.479166666666667;25;23;0.0208333333333333;0.479166666666667
Control.SRR15539829;42;45;0.523809523809524;20;22;0.0238095238095238;0.476190476190476
Control.SRR15539829;44;45;0.545454545454545;20;24;0.0454545454545454;0.454545454545455
Control.SRR15539829;47;45;0.446808510638298;26;21;0.0531914893617021;0.446808510638298
Control.SRR15539829;49;45;0.469387755102041;26;23;0.0306122448979592;0.469387755102041
Control.SRR15539829;50;45;0.62;19;31;0.12;0.38
Control.SRR15539829;39;45;0.564102564102564;17;22;0.0641025641025641;0.435897435897436
Control.SRR15539829;51;45;0.529411764705882;24;27;0.0294117647058824;0.470588235294118
Control.SRR15539829;46;45;0.41304347826087;27;19;0.0869565217391304;0.41304347826087
Control.SRR15539829;50;45;0.6;20;30;0.1;0.4
Control.SRR15539829;44;45;0.613636363636364;17;27;0.113636363636364;0.386363636363636
Control.SRR15539829;47;45;0.361702127659574;30;17;0.138297872340426;0.361702127659574
Control.SRR15539829;48;45;0.416666666666667;28;20;0.0833333333333333;0.416666666666667
Control.SRR15539829;48;45;0.5;24;24;0;0.5
Control.SRR15539829;45;45;0.533333333333333;21;24;0.0333333333333333;0.466666666666667
Control.SRR15539829;43;45;0.465116279069767;23;20;0.0348837209302326;0.465116279069767
Control.SRR15539829;45;45;0.511111111111111;22;23;0.0111111111111111;0.488888888888889
Control.SRR15539829;40;45;0.55;18;22;0.05;0.45
Control.SRR15539829;41;45;0.609756097560976;16;25;0.109756097560976;0.390243902439024
Control.SRR15539829;41;45;0.51219512195122;20;21;0.0121951219512195;0.48780487804878
Control.SRR15539829;49;45;0.448979591836735;27;22;0.0510204081632653;0.448979591836735
Control.SRR15539829;40;45;0.425;23;17;0.075;0.425
Control.SRR15539829;51;45;0.509803921568627;25;26;0.00980392156862742;0.490196078431373
Control.SRR15539829;48;45;0.520833333333333;23;25;0.0208333333333334;0.479166666666667
Control.SRR15539829;49;45;0.489795918367347;25;24;0.0102040816326531;0.489795918367347
Control.SRR15539829;45;45;0.377777777777778;28;17;0.122222222222222;0.377777777777778
Control.SRR15539829;49;45;0.489795918367347;25;24;0.0102040816326531;0.489795918367347
Control.SRR15539829;48;45;0.645833333333333;17;31;0.145833333333333;0.354166666666667
Control.SRR15539829;48;45;0.5;24;24;0;0.5
Control.SRR15539829;48;45;0.458333333333333;26;22;0.0416666666666667;0.458333333333333
Control.SRR15539829;49;45;0.469387755102041;26;23;0.0306122448979592;0.469387755102041
Control.SRR15539829;44;45;0.568181818181818;19;25;0.0681818181818182;0.431818181818182
Control.SRR15539829;41;45;0.536585365853659;19;22;0.0365853658536586;0.463414634146341
Control.SRR15539829;43;45;0.488372093023256;22;21;0.0116279069767442;0.488372093023256
Control.SRR15539829;47;45;0.638297872340426;17;30;0.138297872340426;0.361702127659574
Control.SRR15539829;47;45;0.617021276595745;18;29;0.117021276595745;0.382978723404255
Control.SRR15539829;48;45;0.5;24;24;0;0.5
Control.SRR15539829;48;45;0.604166666666667;19;29;0.104166666666667;0.395833333333333
Control.SRR15539829;51;45;0.549019607843137;23;28;0.0490196078431373;0.450980392156863
Control.SRR15539829;43;45;0.488372093023256;22;21;0.0116279069767442;0.488372093023256
Control.SRR15539829;46;45;0.543478260869565;21;25;0.0434782608695652;0.456521739130435
Control.SRR15539829;43;45;0.488372093023256;22;21;0.0116279069767442;0.488372093023256
Control.SRR15539829;48;45;0.625;18;30;0.125;0.375
Control.SRR15539829;49;45;0.448979591836735;27;22;0.0510204081632653;0.448979591836735
Control.SRR15539829;48;45;0.416666666666667;28;20;0.0833333333333333;0.416666666666667
Control.SRR15539829;47;45;0.553191489361702;21;26;0.0531914893617021;0.446808510638298
Control.SRR15539829;39;45;0.512820512820513;19;20;0.0128205128205128;0.487179487179487
Control.SRR15539829;48;45;0.458333333333333;26;22;0.0416666666666667;0.458333333333333
Control.SRR15539829;45;45;0.488888888888889;23;22;0.0111111111111111;0.488888888888889
Control.SRR15539829;47;45;0.425531914893617;27;20;0.074468085106383;0.425531914893617
Control.SRR15539829;50;45;0.58;21;29;0.08;0.42
Control.SRR15539829;50;45;0.52;24;26;0.02;0.48
Control.SRR15539829;45;45;0.488888888888889;23;22;0.0111111111111111;0.488888888888889
Control.SRR15539829;46;45;0.543478260869565;21;25;0.0434782608695652;0.456521739130435
Control.SRR15539829;50;45;0.48;26;24;0.02;0.48
Control.SRR15539829;47;45;0.531914893617021;22;25;0.0319148936170213;0.468085106382979
Control.SRR15539829;49;45;0.489795918367347;25;24;0.0102040816326531;0.489795918367347
Control.SRR15539829;50;45;0.52;24;26;0.02;0.48
Control.SRR15539829;49;45;0.510204081632653;24;25;0.0102040816326531;0.489795918367347
Control.SRR15539829;50;45;0.48;26;24;0.02;0.48
Control.SRR15539829;45;45;0.488888888888889;23;22;0.0111111111111111;0.488888888888889
Control.SRR15539829;50;45;0.48;26;24;0.02;0.48
Control.SRR15539829;51;45;0.627450980392157;19;32;0.127450980392157;0.372549019607843
Control.SRR15539829;45;45;0.533333333333333;21;24;0.0333333333333333;0.466666666666667
Control.SRR15539829;45;45;0.511111111111111;22;23;0.0111111111111111;0.488888888888889
Control.SRR15539829;49;45;0.428571428571429;28;21;0.0714285714285715;0.428571428571429
Control.SRR15539829;51;45;0.509803921568627;25;26;0.00980392156862742;0.490196078431373
Control.SRR15539829;50;45;0.48;26;24;0.02;0.48
Control.SRR15539829;49;45;0.571428571428571;21;28;0.0714285714285714;0.428571428571429
Control.SRR15539829;49;45;0.551020408163265;22;27;0.0510204081632653;0.448979591836735
Control.SRR15539829;45;45;0.511111111111111;22;23;0.0111111111111111;0.488888888888889
Control.SRR15539829;45;45;0.333333333333333;30;15;0.166666666666667;0.333333333333333
Control.SRR15539829;45;45;0.444444444444444;25;20;0.0555555555555556;0.444444444444444
Control.SRR15539829;40;45;0.55;18;22;0.05;0.45
Control.SRR15539829;43;45;0.465116279069767;23;20;0.0348837209302326;0.465116279069767
Control.SRR15539829;49;45;0.428571428571429;28;21;0.0714285714285715;0.428571428571429
Control.SRR15539829;44;45;0.522727272727273;21;23;0.0227272727272727;0.477272727272727
Control.SRR15539829;42;45;0.404761904761905;25;17;0.0952380952380952;0.404761904761905
Control.SRR15539829;42;45;0.523809523809524;20;22;0.0238095238095238;0.476190476190476
Control.SRR15539829;46;45;0.717391304347826;13;33;0.217391304347826;0.282608695652174
Control.SRR15539829;51;45;0.509803921568627;25;26;0.00980392156862742;0.490196078431373
Control.SRR15539829;41;45;0.48780487804878;21;20;0.0121951219512195;0.48780487804878
Control.SRR15539829;44;45;0.522727272727273;21;23;0.0227272727272727;0.477272727272727
Control.SRR15539829;44;45;0.636363636363636;16;28;0.136363636363636;0.363636363636364
Control.SRR15539829;51;45;0.509803921568627;25;26;0.00980392156862742;0.490196078431373
Control.SRR15539829;45;45;0.666666666666667;15;30;0.166666666666667;0.333333333333333
Control.SRR15539829;46;45;0.543478260869565;21;25;0.0434782608695652;0.456521739130435
Control.SRR15539829;50;45;0.4;30;20;0.1;0.4
Control.SRR15539829;50;45;0.54;23;27;0.04;0.46
Control.SRR15539829;41;45;0.560975609756098;18;23;0.0609756097560976;0.439024390243902
Control.SRR15539829;41;45;0.439024390243902;23;18;0.0609756097560976;0.439024390243902
Control.SRR15539829;49;45;0.571428571428571;21;28;0.0714285714285714;0.428571428571429
Control.SRR15539829;48;45;0.520833333333333;23;25;0.0208333333333334;0.479166666666667
Control.SRR15539829;49;45;0.530612244897959;23;26;0.0306122448979592;0.469387755102041
Control.SRR15539829;51;45;0.568627450980392;22;29;0.0686274509803921;0.431372549019608
Control.SRR15539829;47;45;0.595744680851064;19;28;0.0957446808510638;0.404255319148936
Control.SRR15539829;49;45;0.489795918367347;25;24;0.0102040816326531;0.489795918367347
Control.SRR15539829;45;45;0.444444444444444;25;20;0.0555555555555556;0.444444444444444
Control.SRR15539829;44;45;0.590909090909091;18;26;0.0909090909090909;0.409090909090909
Control.SRR15539829;44;45;0.545454545454545;20;24;0.0454545454545454;0.454545454545455
Control.SRR15539829;39;45;0.512820512820513;19;20;0.0128205128205128;0.487179487179487
Control.SRR15539829;43;45;0.465116279069767;23;20;0.0348837209302326;0.465116279069767
Control.SRR15539829;48;45;0.479166666666667;25;23;0.0208333333333333;0.479166666666667
Control.SRR15539829;46;45;0.456521739130435;25;21;0.0434782608695652;0.456521739130435
Control.SRR15539829;48;45;0.479166666666667;25;23;0.0208333333333333;0.479166666666667
Control.SRR15539829;40;45;0.45;22;18;0.05;0.45
Control.SRR15539829;44;45;0.454545454545455;24;20;0.0454545454545455;0.454545454545455
Control.SRR15539829;51;45;0.431372549019608;29;22;0.0686274509803921;0.431372549019608
Control.SRR15539829;46;45;0.521739130434783;22;24;0.0217391304347826;0.478260869565217
Control.SRR15539829;43;45;0.581395348837209;18;25;0.0813953488372093;0.418604651162791
Control.SRR15539829;45;45;0.577777777777778;19;26;0.0777777777777777;0.422222222222222
Control.SRR15539829;44;45;0.5;22;22;0;0.5
Control.SRR15539829;45;45;0.422222222222222;26;19;0.0777777777777778;0.422222222222222
Control.SRR15539829;47;45;0.425531914893617;27;20;0.074468085106383;0.425531914893617
Control.SRR15539829;44;45;0.431818181818182;25;19;0.0681818181818182;0.431818181818182
Control.SRR15539829;48;45;0.5;24;24;0;0.5
Control.SRR15539829;42;45;0.428571428571429;24;18;0.0714285714285715;0.428571428571429
Control.SRR15539829;51;45;0.529411764705882;24;27;0.0294117647058824;0.470588235294118
Control.SRR15539829;41;45;0.439024390243902;23;18;0.0609756097560976;0.439024390243902
Control.SRR15539829;45;45;0.555555555555556;20;25;0.0555555555555556;0.444444444444444
Control.SRR15539829;44;45;0.522727272727273;21;23;0.0227272727272727;0.477272727272727
Control.SRR15539829;47;45;0.446808510638298;26;21;0.0531914893617021;0.446808510638298
Control.SRR15539829;47;45;0.404255319148936;28;19;0.0957446808510639;0.404255319148936
Control.SRR15539829;48;45;0.541666666666667;22;26;0.0416666666666666;0.458333333333333
Control.SRR15539829;51;45;0.470588235294118;27;24;0.0294117647058824;0.470588235294118
Control.SRR15539829;49;45;0.469387755102041;26;23;0.0306122448979592;0.469387755102041
Control.SRR15539829;48;45;0.479166666666667;25;23;0.0208333333333333;0.479166666666667
Control.SRR15539829;45;45;0.488888888888889;23;22;0.0111111111111111;0.488888888888889
Control.SRR15539829;50;45;0.46;27;23;0.04;0.46
Control.SRR15539829;50;45;0.64;18;32;0.14;0.36
Control.SRR15539829;50;45;0.48;26;24;0.02;0.48
Control.SRR15539829;42;45;0.523809523809524;20;22;0.0238095238095238;0.476190476190476
Control.SRR15539829;47;45;0.574468085106383;20;27;0.074468085106383;0.425531914893617
Control.SRR15539829;42;45;0.595238095238095;17;25;0.0952380952380952;0.404761904761905
Control.SRR15539829;42;45;0.571428571428571;18;24;0.0714285714285714;0.428571428571429
Control.SRR15539829;48;45;0.5625;21;27;0.0625;0.4375
Control.SRR15539829;51;45;0.568627450980392;22;29;0.0686274509803921;0.431372549019608
Control.SRR15539829;51;45;0.529411764705882;24;27;0.0294117647058824;0.470588235294118
Control.SRR15539829;40;45;0.55;18;22;0.05;0.45
Control.SRR15539829;49;45;0.653061224489796;17;32;0.153061224489796;0.346938775510204
Control.SRR15539829;46;45;0.391304347826087;28;18;0.108695652173913;0.391304347826087
Control.SRR15539829;46;45;0.391304347826087;28;18;0.108695652173913;0.391304347826087
Control.SRR15539829;45;45;0.6;18;27;0.1;0.4
Control.SRR15539829;49;45;0.408163265306122;29;20;0.0918367346938775;0.408163265306122
Control.SRR15539829;47;45;0.382978723404255;29;18;0.117021276595745;0.382978723404255
Control.SRR15539829;42;45;0.547619047619048;19;23;0.0476190476190477;0.452380952380952
Control.SRR15539829;50;45;0.5;25;25;0;0.5
Control.SRR15539829;48;45;0.395833333333333;29;19;0.104166666666667;0.395833333333333
Control.SRR15539829;44;45;0.5;22;22;0;0.5
Control.SRR15539829;41;45;0.390243902439024;25;16;0.109756097560976;0.390243902439024
Control.SRR15539829;42;45;0.404761904761905;25;17;0.0952380952380952;0.404761904761905
Control.SRR15539829;46;45;0.456521739130435;25;21;0.0434782608695652;0.456521739130435
Control.SRR15539829;45;45;0.555555555555556;20;25;0.0555555555555556;0.444444444444444
Control.SRR15539829;47;45;0.553191489361702;21;26;0.0531914893617021;0.446808510638298
Control.SRR15539829;49;45;0.408163265306122;29;20;0.0918367346938775;0.408163265306122
Control.SRR15539829;51;45;0.490196078431373;26;25;0.00980392156862747;0.490196078431373
Control.SRR15539829;51;45;0.607843137254902;20;31;0.107843137254902;0.392156862745098
Control.SRR15539829;44;45;0.5;22;22;0;0.5
Control.SRR15539829;42;45;0.595238095238095;17;25;0.0952380952380952;0.404761904761905
Control.SRR15539829;47;45;0.48936170212766;24;23;0.0106382978723404;0.48936170212766
Control.SRR15539829;44;45;0.590909090909091;18;26;0.0909090909090909;0.409090909090909
Control.SRR15539829;46;45;0.630434782608696;17;29;0.130434782608696;0.369565217391304
Control.SRR15539829;40;45;0.625;15;25;0.125;0.375
Control.SRR15539829;51;45;0.411764705882353;30;21;0.0882352941176471;0.411764705882353
Control.SRR15539829;40;45;0.5;20;20;0;0.5
Control.SRR15539829;43;45;0.465116279069767;23;20;0.0348837209302326;0.465116279069767
Control.SRR15539829;50;45;0.48;26;24;0.02;0.48
Control.SRR15539829;48;45;0.541666666666667;22;26;0.0416666666666666;0.458333333333333
Control.SRR15539829;45;45;0.488888888888889;23;22;0.0111111111111111;0.488888888888889
Control.SRR15539829;40;45;0.5;20;20;0;0.5
Control.SRR15539829;42;45;0.476190476190476;22;20;0.0238095238095238;0.476190476190476
Control.SRR15539829;48;45;0.541666666666667;22;26;0.0416666666666666;0.458333333333333
Control.SRR15539829;48;45;0.4375;27;21;0.0625;0.4375
Control.SRR15539829;43;45;0.372093023255814;27;16;0.127906976744186;0.372093023255814
Control.SRR15539829;49;45;0.551020408163265;22;27;0.0510204081632653;0.448979591836735
Control.SRR15539829;45;45;0.355555555555556;29;16;0.144444444444444;0.355555555555556
Control.SRR15539829;46;45;0.434782608695652;26;20;0.0652173913043478;0.434782608695652
Control.SRR15539829;46;45;0.543478260869565;21;25;0.0434782608695652;0.456521739130435
Control.SRR15539829;48;45;0.5625;21;27;0.0625;0.4375
Control.SRR15539829;41;45;0.390243902439024;25;16;0.109756097560976;0.390243902439024
Control.SRR15539829;48;45;0.583333333333333;20;28;0.0833333333333334;0.416666666666667
Control.SRR15539829;40;45;0.55;18;22;0.05;0.45
Control.SRR15539829;46;45;0.608695652173913;18;28;0.108695652173913;0.391304347826087
Control.SRR15539829;40;45;0.5;20;20;0;0.5
Control.SRR15539829;43;45;0.534883720930233;20;23;0.0348837209302325;0.465116279069767
Control.SRR15539829;41;45;0.414634146341463;24;17;0.0853658536585366;0.414634146341463
Control.SRR15539829;40;45;0.55;18;22;0.05;0.45
Control.SRR15539829;51;45;0.529411764705882;24;27;0.0294117647058824;0.470588235294118
Control.SRR15539829;44;45;0.363636363636364;28;16;0.136363636363636;0.363636363636364
Control.SRR15539829;46;45;0.58695652173913;19;27;0.0869565217391305;0.41304347826087
Control.SRR15539829;41;45;0.463414634146341;22;19;0.0365853658536585;0.463414634146341
Control.SRR15539829;42;45;0.476190476190476;22;20;0.0238095238095238;0.476190476190476
Control.SRR15539829;43;45;0.627906976744186;16;27;0.127906976744186;0.372093023255814
Control.SRR15539829;39;45;0.641025641025641;14;25;0.141025641025641;0.358974358974359
Control.SRR15539829;40;45;0.425;23;17;0.075;0.425
Control.SRR15539829;46;45;0.456521739130435;25;21;0.0434782608695652;0.456521739130435
Control.SRR15539829;44;45;0.545454545454545;20;24;0.0454545454545454;0.454545454545455
Control.SRR15539829;48;45;0.583333333333333;20;28;0.0833333333333334;0.416666666666667
Control.SRR15539829;46;45;0.5;23;23;0;0.5
Control.SRR15539829;48;45;0.5625;21;27;0.0625;0.4375
Control.SRR15539829;49;45;0.36734693877551;31;18;0.13265306122449;0.36734693877551
Control.SRR15539829;49;45;0.510204081632653;24;25;0.0102040816326531;0.489795918367347
Control.SRR15539829;51;45;0.529411764705882;24;27;0.0294117647058824;0.470588235294118
Control.SRR15539829;41;45;0.414634146341463;24;17;0.0853658536585366;0.414634146341463
Control.SRR15539829;39;45;0.538461538461538;18;21;0.0384615384615384;0.461538461538462
Control.SRR15539829;48;45;0.520833333333333;23;25;0.0208333333333334;0.479166666666667
Control.SRR15539829;46;45;0.5;23;23;0;0.5
Control.SRR15539829;42;45;0.761904761904762;10;32;0.261904761904762;0.238095238095238
Control.SRR15539829;46;45;0.630434782608696;17;29;0.130434782608696;0.369565217391304
Control.SRR15539829;49;45;0.306122448979592;34;15;0.193877551020408;0.306122448979592
Control.SRR15539829;51;45;0.392156862745098;31;20;0.107843137254902;0.392156862745098
Control.SRR15539829;47;45;0.340425531914894;31;16;0.159574468085106;0.340425531914894
Control.SRR15539829;50;45;0.54;23;27;0.04;0.46
Control.SRR15539829;44;45;0.477272727272727;23;21;0.0227272727272727;0.477272727272727
Control.SRR15539829;50;45;0.44;28;22;0.06;0.44
Control.SRR15539829;41;45;0.414634146341463;24;17;0.0853658536585366;0.414634146341463
Control.SRR15539829;46;45;0.478260869565217;24;22;0.0217391304347826;0.478260869565217
Control.SRR15539829;51;45;0.509803921568627;25;26;0.00980392156862742;0.490196078431373
Control.SRR15539829;44;45;0.545454545454545;20;24;0.0454545454545454;0.454545454545455
Control.SRR15539829;39;45;0.538461538461538;18;21;0.0384615384615384;0.461538461538462
Control.SRR15539829;45;45;0.422222222222222;26;19;0.0777777777777778;0.422222222222222
Control.SRR15539829;49;45;0.551020408163265;22;27;0.0510204081632653;0.448979591836735
Control.SRR15539829;42;45;0.523809523809524;20;22;0.0238095238095238;0.476190476190476
Control.SRR15539829;44;45;0.590909090909091;18;26;0.0909090909090909;0.409090909090909
Control.SRR15539829;44;45;0.5;22;22;0;0.5
Control.SRR15539829;46;45;0.521739130434783;22;24;0.0217391304347826;0.478260869565217
Control.SRR15539829;47;45;0.702127659574468;14;33;0.202127659574468;0.297872340425532
Control.SRR15539829;46;45;0.521739130434783;22;24;0.0217391304347826;0.478260869565217
Control.SRR15539829;39;45;0.564102564102564;17;22;0.0641025641025641;0.435897435897436
Control.SRR15539829;46;45;0.543478260869565;21;25;0.0434782608695652;0.456521739130435
Control.SRR15539829;50;45;0.48;26;24;0.02;0.48
Control.SRR15539829;41;45;0.634146341463415;15;26;0.134146341463415;0.365853658536585
Control.SRR15539829;47;45;0.553191489361702;21;26;0.0531914893617021;0.446808510638298
Control.SRR15539829;47;45;0.531914893617021;22;25;0.0319148936170213;0.468085106382979
Control.SRR15539829;39;45;0.487179487179487;20;19;0.0128205128205128;0.487179487179487
Control.SRR15539829;45;45;0.555555555555556;20;25;0.0555555555555556;0.444444444444444
Control.SRR15539829;49;45;0.489795918367347;25;24;0.0102040816326531;0.489795918367347
Control.SRR15539829;48;45;0.479166666666667;25;23;0.0208333333333333;0.479166666666667
Control.SRR15539829;44;45;0.477272727272727;23;21;0.0227272727272727;0.477272727272727
Control.SRR15539829;47;45;0.617021276595745;18;29;0.117021276595745;0.382978723404255
Control.SRR15539829;41;45;0.341463414634146;27;14;0.158536585365854;0.341463414634146
Control.SRR15539829;41;45;0.51219512195122;20;21;0.0121951219512195;0.48780487804878
Control.SRR15539829;40;45;0.475;21;19;0.025;0.475
Control.SRR15539829;42;45;0.5;21;21;0;0.5
Control.SRR15539829;43;45;0.488372093023256;22;21;0.0116279069767442;0.488372093023256
Control.SRR15539829;48;45;0.5625;21;27;0.0625;0.4375
Control.SRR15539829;40;45;0.5;20;20;0;0.5
Control.SRR15539829;45;45;0.488888888888889;23;22;0.0111111111111111;0.488888888888889
Control.SRR15539829;47;45;0.48936170212766;24;23;0.0106382978723404;0.48936170212766
Control.SRR15539829;39;45;0.384615384615385;24;15;0.115384615384615;0.384615384615385
Control.SRR15539829;41;45;0.634146341463415;15;26;0.134146341463415;0.365853658536585
Control.SRR15539829;41;45;0.51219512195122;20;21;0.0121951219512195;0.48780487804878
Control.SRR15539829;45;45;0.511111111111111;22;23;0.0111111111111111;0.488888888888889
Control.SRR15539829;45;45;0.444444444444444;25;20;0.0555555555555556;0.444444444444444
Control.SRR15539829;47;45;0.404255319148936;28;19;0.0957446808510639;0.404255319148936
Control.SRR15539829;46;45;0.543478260869565;21;25;0.0434782608695652;0.456521739130435
Control.SRR15539829;43;45;0.511627906976744;21;22;0.0116279069767442;0.488372093023256
Control.SRR15539829;50;45;0.58;21;29;0.08;0.42
Control.SRR15539829;50;45;0.64;18;32;0.14;0.36
Control.SRR15539829;50;45;0.54;23;27;0.04;0.46
Control.SRR15539829;49;45;0.346938775510204;32;17;0.153061224489796;0.346938775510204
Control.SRR15539829;45;45;0.333333333333333;30;15;0.166666666666667;0.333333333333333
Control.SRR15539829;43;45;0.651162790697674;15;28;0.151162790697674;0.348837209302326
Control.SRR15539829;41;45;0.51219512195122;20;21;0.0121951219512195;0.48780487804878
Control.SRR15539829;48;45;0.4375;27;21;0.0625;0.4375
Control.SRR15539829;42;45;0.547619047619048;19;23;0.0476190476190477;0.452380952380952
Control.SRR15539829;39;45;0.512820512820513;19;20;0.0128205128205128;0.487179487179487
Control.SRR15539829;47;45;0.382978723404255;29;18;0.117021276595745;0.382978723404255
Control.SRR15539829;42;45;0.5;21;21;0;0.5
Control.SRR15539829;45;45;0.488888888888889;23;22;0.0111111111111111;0.488888888888889
Control.SRR15539829;45;45;0.422222222222222;26;19;0.0777777777777778;0.422222222222222
Control.SRR15539829;48;45;0.583333333333333;20;28;0.0833333333333334;0.416666666666667
Control.SRR15539829;48;45;0.541666666666667;22;26;0.0416666666666666;0.458333333333333
Control.SRR15539829;51;45;0.549019607843137;23;28;0.0490196078431373;0.450980392156863
Control.SRR15539829;49;45;0.428571428571429;28;21;0.0714285714285715;0.428571428571429
Control.SRR15539829;50;45;0.48;26;24;0.02;0.48
Control.SRR15539829;47;45;0.574468085106383;20;27;0.074468085106383;0.425531914893617
Control.SRR15539829;41;45;0.48780487804878;21;20;0.0121951219512195;0.48780487804878
Control.SRR15539829;42;45;0.5;21;21;0;0.5
Control.SRR15539829;47;45;0.446808510638298;26;21;0.0531914893617021;0.446808510638298
Control.SRR15539829;45;45;0.533333333333333;21;24;0.0333333333333333;0.466666666666667
Control.SRR15539829;43;45;0.488372093023256;22;21;0.0116279069767442;0.488372093023256
Control.SRR15539829;46;45;0.369565217391304;29;17;0.130434782608696;0.369565217391304
Control.SRR15539829;45;45;0.488888888888889;23;22;0.0111111111111111;0.488888888888889
Control.SRR15539829;40;45;0.3;28;12;0.2;0.3
Control.SRR15539829;43;45;0.441860465116279;24;19;0.0581395348837209;0.441860465116279
Control.SRR15539829;40;45;0.575;17;23;0.075;0.425
Control.SRR15539829;42;45;0.5;21;21;0;0.5
Control.SRR15539829;42;45;0.452380952380952;23;19;0.0476190476190476;0.452380952380952
Control.SRR15539829;42;45;0.476190476190476;22;20;0.0238095238095238;0.476190476190476
Control.SRR15539829;51;45;0.509803921568627;25;26;0.00980392156862742;0.490196078431373
Control.SRR15539829;46;45;0.521739130434783;22;24;0.0217391304347826;0.478260869565217
Control.SRR15539829;49;45;0.428571428571429;28;21;0.0714285714285715;0.428571428571429
Control.SRR15539829;39;45;0.641025641025641;14;25;0.141025641025641;0.358974358974359
Control.SRR15539829;39;45;0.461538461538462;21;18;0.0384615384615384;0.461538461538462
Control.SRR15539829;45;45;0.577777777777778;19;26;0.0777777777777777;0.422222222222222
Control.SRR15539829;45;45;0.511111111111111;22;23;0.0111111111111111;0.488888888888889
Control.SRR15539829;50;45;0.56;22;28;0.0600000000000001;0.44
Control.SRR15539829;51;45;0.549019607843137;23;28;0.0490196078431373;0.450980392156863
Control.SRR15539829;44;45;0.454545454545455;24;20;0.0454545454545455;0.454545454545455
Control.SRR15539829;48;45;0.520833333333333;23;25;0.0208333333333334;0.479166666666667
Control.SRR15539829;45;45;0.311111111111111;31;14;0.188888888888889;0.311111111111111
Control.SRR15539829;47;45;0.51063829787234;23;24;0.0106382978723404;0.48936170212766
Control.SRR15539829;49;45;0.469387755102041;26;23;0.0306122448979592;0.469387755102041
Control.SRR15539829;45;45;0.533333333333333;21;24;0.0333333333333333;0.466666666666667
Control.SRR15539829;44;45;0.409090909090909;26;18;0.0909090909090909;0.409090909090909
Control.SRR15539829;49;45;0.387755102040816;30;19;0.112244897959184;0.387755102040816
Control.SRR15539829;43;45;0.465116279069767;23;20;0.0348837209302326;0.465116279069767
Control.SRR15539829;45;45;0.555555555555556;20;25;0.0555555555555556;0.444444444444444
Control.SRR15539829;50;45;0.64;18;32;0.14;0.36
Control.SRR15539829;48;45;0.5;24;24;0;0.5
Control.SRR15539829;39;45;0.58974358974359;16;23;0.0897435897435898;0.41025641025641
Control.SRR15539829;41;45;0.609756097560976;16;25;0.109756097560976;0.390243902439024
Control.SRR15539829;48;45;0.583333333333333;20;28;0.0833333333333334;0.416666666666667
Control.SRR15539829;49;45;0.428571428571429;28;21;0.0714285714285715;0.428571428571429
Control.SRR15539829;40;45;0.5;20;20;0;0.5
Control.SRR15539829;50;45;0.54;23;27;0.04;0.46
Control.SRR15539829;42;45;0.523809523809524;20;22;0.0238095238095238;0.476190476190476
Control.SRR15539829;46;45;0.58695652173913;19;27;0.0869565217391305;0.41304347826087
Control.SRR15539829;46;45;0.347826086956522;30;16;0.152173913043478;0.347826086956522
Control.SRR15539829;43;45;0.581395348837209;18;25;0.0813953488372093;0.418604651162791
Control.SRR15539829;51;45;0.666666666666667;17;34;0.166666666666667;0.333333333333333
Control.SRR15539829;47;45;0.531914893617021;22;25;0.0319148936170213;0.468085106382979
Control.SRR15539829;50;45;0.48;26;24;0.02;0.48
Control.SRR15539829;46;45;0.521739130434783;22;24;0.0217391304347826;0.478260869565217
Control.SRR15539829;44;45;0.5;22;22;0;0.5
Control.SRR15539829;44;45;0.590909090909091;18;26;0.0909090909090909;0.409090909090909
Control.SRR15539829;48;45;0.604166666666667;19;29;0.104166666666667;0.395833333333333
Control.SRR15539829;42;45;0.5;21;21;0;0.5
Control.SRR15539829;44;45;0.545454545454545;20;24;0.0454545454545454;0.454545454545455
Control.SRR15539829;50;45;0.56;22;28;0.0600000000000001;0.44
Control.SRR15539829;45;45;0.466666666666667;24;21;0.0333333333333333;0.466666666666667
Control.SRR15539829;50;45;0.38;31;19;0.12;0.38
Control.SRR15539829;46;45;0.58695652173913;19;27;0.0869565217391305;0.41304347826087
Control.SRR15539829;41;45;0.439024390243902;23;18;0.0609756097560976;0.439024390243902
Control.SRR15539829;45;45;0.444444444444444;25;20;0.0555555555555556;0.444444444444444
Control.SRR15539829;45;45;0.577777777777778;19;26;0.0777777777777777;0.422222222222222
Control.SRR15539829;47;45;0.51063829787234;23;24;0.0106382978723404;0.48936170212766
Control.SRR15539829;47;45;0.404255319148936;28;19;0.0957446808510639;0.404255319148936
Control.SRR15539829;44;45;0.431818181818182;25;19;0.0681818181818182;0.431818181818182
Control.SRR15539829;49;45;0.551020408163265;22;27;0.0510204081632653;0.448979591836735
Control.SRR15539829;47;45;0.553191489361702;21;26;0.0531914893617021;0.446808510638298
Control.SRR15539829;50;45;0.48;26;24;0.02;0.48
Control.SRR15539829;46;45;0.521739130434783;22;24;0.0217391304347826;0.478260869565217
Control.SRR15539829;51;45;0.431372549019608;29;22;0.0686274509803921;0.431372549019608
Control.SRR15539829;47;45;0.340425531914894;31;16;0.159574468085106;0.340425531914894
Control.SRR15539829;45;45;0.466666666666667;24;21;0.0333333333333333;0.466666666666667
Control.SRR15539829;51;45;0.490196078431373;26;25;0.00980392156862747;0.490196078431373
Control.SRR15539829;48;45;0.4375;27;21;0.0625;0.4375
Control.SRR15539829;44;45;0.545454545454545;20;24;0.0454545454545454;0.454545454545455
Control.SRR15539829;44;45;0.613636363636364;17;27;0.113636363636364;0.386363636363636
Control.SRR15539829;42;45;0.619047619047619;16;26;0.119047619047619;0.380952380952381
Control.SRR15539829;49;45;0.489795918367347;25;24;0.0102040816326531;0.489795918367347
Control.SRR15539829;43;45;0.441860465116279;24;19;0.0581395348837209;0.441860465116279
Control.SRR15539829;40;45;0.5;20;20;0;0.5
Control.SRR15539829;49;45;0.551020408163265;22;27;0.0510204081632653;0.448979591836735
Control.SRR15539829;47;45;0.404255319148936;28;19;0.0957446808510639;0.404255319148936
Control.SRR15539829;44;45;0.454545454545455;24;20;0.0454545454545455;0.454545454545455
Control.SRR15539829;50;45;0.6;20;30;0.1;0.4
Control.SRR15539829;51;45;0.490196078431373;26;25;0.00980392156862747;0.490196078431373
Control.SRR15539829;45;45;0.533333333333333;21;24;0.0333333333333333;0.466666666666667
Control.SRR15539829;45;45;0.644444444444444;16;29;0.144444444444444;0.355555555555556
Control.SRR15539829;42;45;0.571428571428571;18;24;0.0714285714285714;0.428571428571429
Control.SRR15539829;39;45;0.435897435897436;22;17;0.0641025641025641;0.435897435897436
Control.SRR15539829;39;45;0.564102564102564;17;22;0.0641025641025641;0.435897435897436
Control.SRR15539829;46;45;0.695652173913043;14;32;0.195652173913043;0.304347826086957
Control.SRR15539829;43;45;0.604651162790698;17;26;0.104651162790698;0.395348837209302
Control.SRR15539829;45;45;0.511111111111111;22;23;0.0111111111111111;0.488888888888889
Control.SRR15539829;47;45;0.48936170212766;24;23;0.0106382978723404;0.48936170212766
Control.SRR15539829;46;45;0.434782608695652;26;20;0.0652173913043478;0.434782608695652
Control.SRR15539829;51;45;0.450980392156863;28;23;0.0490196078431372;0.450980392156863
Control.SRR15539829;39;45;0.615384615384615;15;24;0.115384615384615;0.384615384615385
Control.SRR15539829;39;45;0.538461538461538;18;21;0.0384615384615384;0.461538461538462
Control.SRR15539829;46;45;0.456521739130435;25;21;0.0434782608695652;0.456521739130435
Control.SRR15539829;51;45;0.607843137254902;20;31;0.107843137254902;0.392156862745098
Control.SRR15539829;42;45;0.476190476190476;22;20;0.0238095238095238;0.476190476190476
Control.SRR15539829;48;45;0.458333333333333;26;22;0.0416666666666667;0.458333333333333
Control.SRR15539829;49;45;0.530612244897959;23;26;0.0306122448979592;0.469387755102041
Control.SRR15539829;44;45;0.5;22;22;0;0.5
Control.SRR15539829;42;45;0.619047619047619;16;26;0.119047619047619;0.380952380952381
Control.SRR15539829;42;45;0.428571428571429;24;18;0.0714285714285715;0.428571428571429
Control.SRR15539829;45;45;0.666666666666667;15;30;0.166666666666667;0.333333333333333
Control.SRR15539829;42;45;0.428571428571429;24;18;0.0714285714285715;0.428571428571429
Control.SRR15539829;47;45;0.574468085106383;20;27;0.074468085106383;0.425531914893617
Control.SRR15539829;46;45;0.326086956521739;31;15;0.173913043478261;0.326086956521739
Control.SRR15539829;50;45;0.42;29;21;0.08;0.42
Control.SRR15539829;48;45;0.458333333333333;26;22;0.0416666666666667;0.458333333333333
Control.SRR15539829;44;45;0.431818181818182;25;19;0.0681818181818182;0.431818181818182
Control.SRR15539829;49;45;0.469387755102041;26;23;0.0306122448979592;0.469387755102041
Control.SRR15539829;45;45;0.488888888888889;23;22;0.0111111111111111;0.488888888888889
Control.SRR15539829;49;45;0.551020408163265;22;27;0.0510204081632653;0.448979591836735
Control.SRR15539829;40;45;0.45;22;18;0.05;0.45
Control.SRR15539829;45;45;0.311111111111111;31;14;0.188888888888889;0.311111111111111
Control.SRR15539829;50;45;0.48;26;24;0.02;0.48
Control.SRR15539829;50;45;0.52;24;26;0.02;0.48
Control.SRR15539829;42;45;0.5;21;21;0;0.5
Control.SRR15539829;48;45;0.4375;27;21;0.0625;0.4375
Control.SRR15539829;46;45;0.5;23;23;0;0.5
Control.SRR15539829;43;45;0.534883720930233;20;23;0.0348837209302325;0.465116279069767
Control.SRR15539829;40;45;0.45;22;18;0.05;0.45
Control.SRR15539829;46;45;0.565217391304348;20;26;0.0652173913043478;0.434782608695652
Control.SRR15539829;46;45;0.434782608695652;26;20;0.0652173913043478;0.434782608695652
Control.SRR15539829;41;45;0.634146341463415;15;26;0.134146341463415;0.365853658536585
Control.SRR15539829;51;45;0.431372549019608;29;22;0.0686274509803921;0.431372549019608
Control.SRR15539829;44;45;0.477272727272727;23;21;0.0227272727272727;0.477272727272727
Control.SRR15539829;44;45;0.431818181818182;25;19;0.0681818181818182;0.431818181818182
Control.SRR15539829;48;45;0.479166666666667;25;23;0.0208333333333333;0.479166666666667
Control.SRR15539829;46;45;0.543478260869565;21;25;0.0434782608695652;0.456521739130435
Control.SRR15539829;51;45;0.470588235294118;27;24;0.0294117647058824;0.470588235294118
Control.SRR15539829;42;45;0.666666666666667;14;28;0.166666666666667;0.333333333333333
Control.SRR15539829;49;45;0.510204081632653;24;25;0.0102040816326531;0.489795918367347
Control.SRR15539829;51;45;0.588235294117647;21;30;0.0882352941176471;0.411764705882353
Control.SRR15539829;39;45;0.512820512820513;19;20;0.0128205128205128;0.487179487179487
Control.SRR15539829;43;45;0.674418604651163;14;29;0.174418604651163;0.325581395348837
Control.SRR15539829;42;45;0.476190476190476;22;20;0.0238095238095238;0.476190476190476
Control.SRR15539829;46;45;0.434782608695652;26;20;0.0652173913043478;0.434782608695652
Control.SRR15539829;41;45;0.463414634146341;22;19;0.0365853658536585;0.463414634146341
Control.SRR15539829;46;45;0.41304347826087;27;19;0.0869565217391304;0.41304347826087
Control.SRR15539829;50;45;0.48;26;24;0.02;0.48
Control.SRR15539829;44;45;0.545454545454545;20;24;0.0454545454545454;0.454545454545455
Control.SRR15539829;44;45;0.522727272727273;21;23;0.0227272727272727;0.477272727272727
Control.SRR15539829;39;45;0.641025641025641;14;25;0.141025641025641;0.358974358974359
Control.SRR15539829;42;45;0.523809523809524;20;22;0.0238095238095238;0.476190476190476
Control.SRR15539829;50;45;0.54;23;27;0.04;0.46
Control.SRR15539829;45;45;0.4;27;18;0.1;0.4
Control.SRR15539829;51;45;0.509803921568627;25;26;0.00980392156862742;0.490196078431373
Control.SRR15539829;51;45;0.509803921568627;25;26;0.00980392156862742;0.490196078431373
Control.SRR15539829;46;45;0.543478260869565;21;25;0.0434782608695652;0.456521739130435
Control.SRR15539829;50;45;0.54;23;27;0.04;0.46
Control.SRR15539829;42;45;0.547619047619048;19;23;0.0476190476190477;0.452380952380952
Control.SRR15539829;45;45;0.355555555555556;29;16;0.144444444444444;0.355555555555556
Control.SRR15539829;42;45;0.428571428571429;24;18;0.0714285714285715;0.428571428571429
Control.SRR15539829;46;45;0.521739130434783;22;24;0.0217391304347826;0.478260869565217
Control.SRR15539829;44;45;0.454545454545455;24;20;0.0454545454545455;0.454545454545455
Control.SRR15539829;47;45;0.446808510638298;26;21;0.0531914893617021;0.446808510638298
Control.SRR15539829;42;45;0.571428571428571;18;24;0.0714285714285714;0.428571428571429
Control.SRR15539829;43;45;0.441860465116279;24;19;0.0581395348837209;0.441860465116279
Control.SRR15539829;46;45;0.521739130434783;22;24;0.0217391304347826;0.478260869565217
Control.SRR15539829;48;45;0.541666666666667;22;26;0.0416666666666666;0.458333333333333
Control.SRR15539829;40;45;0.45;22;18;0.05;0.45
Control.SRR15539829;41;45;0.48780487804878;21;20;0.0121951219512195;0.48780487804878
Control.SRR15539829;51;45;0.431372549019608;29;22;0.0686274509803921;0.431372549019608
Control.SRR15539829;48;45;0.479166666666667;25;23;0.0208333333333333;0.479166666666667
Control.SRR15539829;40;45;0.375;25;15;0.125;0.375
Control.SRR15539829;50;45;0.56;22;28;0.0600000000000001;0.44
Control.SRR15539829;47;45;0.468085106382979;25;22;0.0319148936170213;0.468085106382979
Control.SRR15539829;40;45;0.675;13;27;0.175;0.325
Control.SRR15539829;49;45;0.448979591836735;27;22;0.0510204081632653;0.448979591836735
Control.SRR15539829;49;45;0.489795918367347;25;24;0.0102040816326531;0.489795918367347
Control.SRR15539829;49;45;0.36734693877551;31;18;0.13265306122449;0.36734693877551
Control.SRR15539829;40;45;0.525;19;21;0.025;0.475
Control.SRR15539829;51;45;0.490196078431373;26;25;0.00980392156862747;0.490196078431373
Control.SRR15539829;40;45;0.425;23;17;0.075;0.425
Control.SRR15539829;51;45;0.509803921568627;25;26;0.00980392156862742;0.490196078431373
Control.SRR15539829;50;45;0.64;18;32;0.14;0.36
Control.SRR15539829;49;45;0.612244897959184;19;30;0.112244897959184;0.387755102040816
Control.SRR15539829;45;45;0.533333333333333;21;24;0.0333333333333333;0.466666666666667
Control.SRR15539829;51;45;0.431372549019608;29;22;0.0686274509803921;0.431372549019608
Control.SRR15539829;48;45;0.583333333333333;20;28;0.0833333333333334;0.416666666666667
Control.SRR15539829;41;45;0.536585365853659;19;22;0.0365853658536586;0.463414634146341
Control.SRR15539829;50;45;0.36;32;18;0.14;0.36
Control.SRR15539829;46;45;0.543478260869565;21;25;0.0434782608695652;0.456521739130435
Control.SRR15539829;50;45;0.44;28;22;0.06;0.44
Control.SRR15539829;44;45;0.363636363636364;28;16;0.136363636363636;0.363636363636364
Control.SRR15539829;40;45;0.575;17;23;0.075;0.425
Control.SRR15539829;49;45;0.510204081632653;24;25;0.0102040816326531;0.489795918367347
Control.SRR15539829;39;45;0.58974358974359;16;23;0.0897435897435898;0.41025641025641
Control.SRR15539829;48;45;0.625;18;30;0.125;0.375
Control.SRR15539829;42;45;0.404761904761905;25;17;0.0952380952380952;0.404761904761905
Control.SRR15539829;47;45;0.680851063829787;15;32;0.180851063829787;0.319148936170213
Control.SRR15539829;40;45;0.575;17;23;0.075;0.425
Control.SRR15539829;43;45;0.604651162790698;17;26;0.104651162790698;0.395348837209302
Control.SRR15539829;44;45;0.454545454545455;24;20;0.0454545454545455;0.454545454545455
Control.SRR15539829;41;45;0.585365853658537;17;24;0.0853658536585366;0.414634146341463
Control.SRR15539829;50;45;0.46;27;23;0.04;0.46
Control.SRR15539829;46;45;0.565217391304348;20;26;0.0652173913043478;0.434782608695652
Control.SRR15539829;42;45;0.595238095238095;17;25;0.0952380952380952;0.404761904761905
Control.SRR15539829;46;45;0.41304347826087;27;19;0.0869565217391304;0.41304347826087
Control.SRR15539829;41;45;0.48780487804878;21;20;0.0121951219512195;0.48780487804878
Control.SRR15539829;40;45;0.575;17;23;0.075;0.425
Control.SRR15539829;51;45;0.411764705882353;30;21;0.0882352941176471;0.411764705882353
Control.SRR15539829;42;45;0.547619047619048;19;23;0.0476190476190477;0.452380952380952
Control.SRR15539829;40;45;0.4;24;16;0.1;0.4
Control.SRR15539829;51;45;0.607843137254902;20;31;0.107843137254902;0.392156862745098
Control.SRR15539829;49;45;0.510204081632653;24;25;0.0102040816326531;0.489795918367347
Control.SRR15539829;51;45;0.549019607843137;23;28;0.0490196078431373;0.450980392156863
Control.SRR15539829;42;45;0.571428571428571;18;24;0.0714285714285714;0.428571428571429
Control.SRR15539829;44;45;0.5;22;22;0;0.5
Control.SRR15539829;39;45;0.461538461538462;21;18;0.0384615384615384;0.461538461538462
Control.SRR15539829;51;45;0.450980392156863;28;23;0.0490196078431372;0.450980392156863
Control.SRR15539829;50;45;0.52;24;26;0.02;0.48
Control.SRR15539829;49;45;0.489795918367347;25;24;0.0102040816326531;0.489795918367347
Control.SRR15539829;51;45;0.450980392156863;28;23;0.0490196078431372;0.450980392156863
Control.SRR15539829;44;45;0.613636363636364;17;27;0.113636363636364;0.386363636363636
Control.SRR15539829;50;45;0.48;26;24;0.02;0.48
Control.SRR15539829;49;45;0.510204081632653;24;25;0.0102040816326531;0.489795918367347
Control.SRR15539829;42;45;0.547619047619048;19;23;0.0476190476190477;0.452380952380952
Control.SRR15539829;41;45;0.560975609756098;18;23;0.0609756097560976;0.439024390243902
Control.SRR15539829;48;45;0.5;24;24;0;0.5
Control.SRR15539829;50;45;0.56;22;28;0.0600000000000001;0.44
Control.SRR15539829;45;45;0.355555555555556;29;16;0.144444444444444;0.355555555555556
Control.SRR15539829;40;45;0.575;17;23;0.075;0.425
Control.SRR15539829;46;45;0.5;23;23;0;0.5
Control.SRR15539829;44;45;0.340909090909091;29;15;0.159090909090909;0.340909090909091
Control.SRR15539829;42;45;0.428571428571429;24;18;0.0714285714285715;0.428571428571429
Control.SRR15539829;44;45;0.477272727272727;23;21;0.0227272727272727;0.477272727272727
Control.SRR15539829;45;45;0.444444444444444;25;20;0.0555555555555556;0.444444444444444
Control.SRR15539829;39;45;0.538461538461538;18;21;0.0384615384615384;0.461538461538462
Control.SRR15539829;48;45;0.604166666666667;19;29;0.104166666666667;0.395833333333333
Control.SRR15539829;42;45;0.476190476190476;22;20;0.0238095238095238;0.476190476190476
Control.SRR15539829;48;45;0.4375;27;21;0.0625;0.4375
Control.SRR15539829;40;45;0.6;16;24;0.1;0.4
Control.SRR15539829;42;45;0.547619047619048;19;23;0.0476190476190477;0.452380952380952
Control.SRR15539829;42;45;0.595238095238095;17;25;0.0952380952380952;0.404761904761905
Control.SRR15539829;51;45;0.588235294117647;21;30;0.0882352941176471;0.411764705882353
Control.SRR15539829;43;45;0.604651162790698;17;26;0.104651162790698;0.395348837209302
Control.SRR15539829;51;45;0.490196078431373;26;25;0.00980392156862747;0.490196078431373
Control.SRR15539829;45;45;0.488888888888889;23;22;0.0111111111111111;0.488888888888889
Control.SRR15539829;43;45;0.558139534883721;19;24;0.0581395348837209;0.441860465116279
Control.SRR15539829;42;45;0.547619047619048;19;23;0.0476190476190477;0.452380952380952
Control.SRR15539829;41;45;0.560975609756098;18;23;0.0609756097560976;0.439024390243902
Control.SRR15539829;46;45;0.326086956521739;31;15;0.173913043478261;0.326086956521739
Control.SRR15539829;41;45;0.51219512195122;20;21;0.0121951219512195;0.48780487804878
Control.SRR15539829;48;45;0.4375;27;21;0.0625;0.4375
Control.SRR15539829;46;45;0.543478260869565;21;25;0.0434782608695652;0.456521739130435
Control.SRR15539829;40;45;0.6;16;24;0.1;0.4
Control.SRR15539829;50;45;0.56;22;28;0.0600000000000001;0.44
Control.SRR15539829;46;45;0.565217391304348;20;26;0.0652173913043478;0.434782608695652
Control.SRR15539829;45;45;0.466666666666667;24;21;0.0333333333333333;0.466666666666667
Control.SRR15539829;43;45;0.488372093023256;22;21;0.0116279069767442;0.488372093023256
Control.SRR15539829;45;45;0.622222222222222;17;28;0.122222222222222;0.377777777777778
Control.SRR15539829;47;45;0.531914893617021;22;25;0.0319148936170213;0.468085106382979
Control.SRR15539829;51;45;0.529411764705882;24;27;0.0294117647058824;0.470588235294118
Control.SRR15539829;43;45;0.465116279069767;23;20;0.0348837209302326;0.465116279069767
Control.SRR15539829;42;45;0.523809523809524;20;22;0.0238095238095238;0.476190476190476
Control.SRR15539829;45;45;0.488888888888889;23;22;0.0111111111111111;0.488888888888889
Control.SRR15539829;45;45;0.533333333333333;21;24;0.0333333333333333;0.466666666666667
Control.SRR15539829;40;45;0.55;18;22;0.05;0.45
Control.SRR15539829;46;45;0.630434782608696;17;29;0.130434782608696;0.369565217391304
Control.SRR15539829;39;45;0.487179487179487;20;19;0.0128205128205128;0.487179487179487
Control.SRR15539829;39;45;0.487179487179487;20;19;0.0128205128205128;0.487179487179487
Control.SRR15539829;44;45;0.477272727272727;23;21;0.0227272727272727;0.477272727272727
Control.SRR15539829;49;45;0.551020408163265;22;27;0.0510204081632653;0.448979591836735
Control.SRR15539829;42;45;0.404761904761905;25;17;0.0952380952380952;0.404761904761905
Control.SRR15539829;42;45;0.5;21;21;0;0.5
Control.SRR15539829;45;45;0.422222222222222;26;19;0.0777777777777778;0.422222222222222
Control.SRR15539829;43;45;0.372093023255814;27;16;0.127906976744186;0.372093023255814
Control.SRR15539829;42;45;0.428571428571429;24;18;0.0714285714285715;0.428571428571429
Control.SRR15539829;46;45;0.434782608695652;26;20;0.0652173913043478;0.434782608695652
Control.SRR15539829;48;45;0.395833333333333;29;19;0.104166666666667;0.395833333333333
Control.SRR15539829;41;45;0.51219512195122;20;21;0.0121951219512195;0.48780487804878
Control.SRR15539829;45;45;0.4;27;18;0.1;0.4
Control.SRR15539829;40;45;0.525;19;21;0.025;0.475
Control.SRR15539829;39;45;0.435897435897436;22;17;0.0641025641025641;0.435897435897436
Control.SRR15539829;39;45;0.58974358974359;16;23;0.0897435897435898;0.41025641025641
Control.SRR15539829;39;45;0.512820512820513;19;20;0.0128205128205128;0.487179487179487
Control.SRR15539829;40;45;0.525;19;21;0.025;0.475
Control.SRR15539829;39;45;0.461538461538462;21;18;0.0384615384615384;0.461538461538462
Control.SRR15539829;42;45;0.30952380952381;29;13;0.19047619047619;0.30952380952381
Control.SRR15539829;47;45;0.425531914893617;27;20;0.074468085106383;0.425531914893617
Control.SRR15539829;49;45;0.448979591836735;27;22;0.0510204081632653;0.448979591836735
Control.SRR15539829;44;45;0.431818181818182;25;19;0.0681818181818182;0.431818181818182
Control.SRR15539829;50;45;0.44;28;22;0.06;0.44
Control.SRR15539829;51;45;0.470588235294118;27;24;0.0294117647058824;0.470588235294118
Control.SRR15539829;49;45;0.591836734693878;20;29;0.0918367346938775;0.408163265306122
Control.SRR15539829;47;45;0.48936170212766;24;23;0.0106382978723404;0.48936170212766
Control.SRR15539829;50;45;0.48;26;24;0.02;0.48
Control.SRR15539829;48;45;0.458333333333333;26;22;0.0416666666666667;0.458333333333333
Control.SRR15539829;51;45;0.450980392156863;28;23;0.0490196078431372;0.450980392156863
Control.SRR15539829;45;45;0.555555555555556;20;25;0.0555555555555556;0.444444444444444
Control.SRR15539829;43;45;0.488372093023256;22;21;0.0116279069767442;0.488372093023256
Control.SRR15539829;46;45;0.347826086956522;30;16;0.152173913043478;0.347826086956522
Control.SRR15539829;47;45;0.404255319148936;28;19;0.0957446808510639;0.404255319148936
Control.SRR15539829;49;45;0.612244897959184;19;30;0.112244897959184;0.387755102040816
Control.SRR15539829;43;45;0.465116279069767;23;20;0.0348837209302326;0.465116279069767
Control.SRR15539829;44;45;0.522727272727273;21;23;0.0227272727272727;0.477272727272727
Control.SRR15539829;50;45;0.46;27;23;0.04;0.46
Control.SRR15539829;42;45;0.476190476190476;22;20;0.0238095238095238;0.476190476190476
Control.SRR15539829;46;45;0.58695652173913;19;27;0.0869565217391305;0.41304347826087
Control.SRR15539829;46;45;0.565217391304348;20;26;0.0652173913043478;0.434782608695652
Control.SRR15539829;40;45;0.475;21;19;0.025;0.475
Control.SRR15539829;46;45;0.521739130434783;22;24;0.0217391304347826;0.478260869565217
Control.SRR15539829;48;45;0.4375;27;21;0.0625;0.4375
Control.SRR15539829;44;45;0.477272727272727;23;21;0.0227272727272727;0.477272727272727
Control.SRR15539829;45;45;0.511111111111111;22;23;0.0111111111111111;0.488888888888889
Control.SRR15539829;43;45;0.581395348837209;18;25;0.0813953488372093;0.418604651162791
Control.SRR15539829;44;45;0.522727272727273;21;23;0.0227272727272727;0.477272727272727
Control.SRR15539829;45;45;0.422222222222222;26;19;0.0777777777777778;0.422222222222222
Control.SRR15539829;47;45;0.425531914893617;27;20;0.074468085106383;0.425531914893617
Control.SRR15539829;42;45;0.357142857142857;27;15;0.142857142857143;0.357142857142857
Control.SRR15539829;46;45;0.478260869565217;24;22;0.0217391304347826;0.478260869565217
Control.SRR15539829;44;45;0.545454545454545;20;24;0.0454545454545454;0.454545454545455
Control.SRR15539829;44;45;0.386363636363636;27;17;0.113636363636364;0.386363636363636
Control.SRR15539829;41;45;0.414634146341463;24;17;0.0853658536585366;0.414634146341463
Control.SRR15539829;47;45;0.404255319148936;28;19;0.0957446808510639;0.404255319148936
Control.SRR15539829;42;45;0.476190476190476;22;20;0.0238095238095238;0.476190476190476
Control.SRR15539829;44;45;0.454545454545455;24;20;0.0454545454545455;0.454545454545455
Control.SRR15539829;40;45;0.45;22;18;0.05;0.45
Control.SRR15539829;48;45;0.458333333333333;26;22;0.0416666666666667;0.458333333333333
Control.SRR15539829;49;45;0.530612244897959;23;26;0.0306122448979592;0.469387755102041
Control.SRR15539829;47;45;0.48936170212766;24;23;0.0106382978723404;0.48936170212766
Control.SRR15539829;39;45;0.435897435897436;22;17;0.0641025641025641;0.435897435897436
Control.SRR15539829;41;45;0.463414634146341;22;19;0.0365853658536585;0.463414634146341
Control.SRR15539829;43;45;0.558139534883721;19;24;0.0581395348837209;0.441860465116279
Control.SRR15539829;44;45;0.477272727272727;23;21;0.0227272727272727;0.477272727272727
Control.SRR15539829;45;45;0.622222222222222;17;28;0.122222222222222;0.377777777777778
Control.SRR15539829;51;45;0.549019607843137;23;28;0.0490196078431373;0.450980392156863
Control.SRR15539829;45;45;0.511111111111111;22;23;0.0111111111111111;0.488888888888889
Control.SRR15539829;40;45;0.275;29;11;0.225;0.275
Control.SRR15539829;41;45;0.51219512195122;20;21;0.0121951219512195;0.48780487804878
Control.SRR15539829;39;45;0.435897435897436;22;17;0.0641025641025641;0.435897435897436
Control.SRR15539829;50;45;0.62;19;31;0.12;0.38
Control.SRR15539829;39;45;0.461538461538462;21;18;0.0384615384615384;0.461538461538462
Control.SRR15539829;45;45;0.555555555555556;20;25;0.0555555555555556;0.444444444444444
Control.SRR15539829;47;45;0.553191489361702;21;26;0.0531914893617021;0.446808510638298
Control.SRR15539829;43;45;0.511627906976744;21;22;0.0116279069767442;0.488372093023256
Control.SRR15539829;50;45;0.48;26;24;0.02;0.48
Control.SRR15539829;47;45;0.574468085106383;20;27;0.074468085106383;0.425531914893617
Control.SRR15539829;42;45;0.5;21;21;0;0.5
Control.SRR15539829;43;45;0.348837209302326;28;15;0.151162790697674;0.348837209302326
Control.SRR15539829;43;45;0.465116279069767;23;20;0.0348837209302326;0.465116279069767
Control.SRR15539829;41;45;0.48780487804878;21;20;0.0121951219512195;0.48780487804878
Control.SRR15539829;43;45;0.534883720930233;20;23;0.0348837209302325;0.465116279069767
Control.SRR15539829;40;45;0.6;16;24;0.1;0.4
Control.SRR15539829;39;45;0.641025641025641;14;25;0.141025641025641;0.358974358974359
Control.SRR15539829;42;45;0.642857142857143;15;27;0.142857142857143;0.357142857142857
Control.SRR15539829;46;45;0.5;23;23;0;0.5
Control.SRR15539829;42;45;0.333333333333333;28;14;0.166666666666667;0.333333333333333
Control.SRR15539829;40;45;0.5;20;20;0;0.5
Control.SRR15539829;45;45;0.6;18;27;0.1;0.4
Control.SRR15539829;39;45;0.282051282051282;28;11;0.217948717948718;0.282051282051282
Control.SRR15539829;40;45;0.575;17;23;0.075;0.425
Control.SRR15539829;41;45;0.536585365853659;19;22;0.0365853658536586;0.463414634146341
Control.SRR15539829;41;45;0.51219512195122;20;21;0.0121951219512195;0.48780487804878
Control.SRR15539829;49;45;0.469387755102041;26;23;0.0306122448979592;0.469387755102041
Control.SRR15539829;40;45;0.575;17;23;0.075;0.425
Control.SRR15539829;44;45;0.522727272727273;21;23;0.0227272727272727;0.477272727272727
Control.SRR15539829;47;45;0.531914893617021;22;25;0.0319148936170213;0.468085106382979
Control.SRR15539829;42;45;0.476190476190476;22;20;0.0238095238095238;0.476190476190476
Control.SRR15539829;51;45;0.509803921568627;25;26;0.00980392156862742;0.490196078431373
Control.SRR15539829;44;45;0.613636363636364;17;27;0.113636363636364;0.386363636363636
Control.SRR15539829;45;45;0.511111111111111;22;23;0.0111111111111111;0.488888888888889
Control.SRR15539829;44;45;0.568181818181818;19;25;0.0681818181818182;0.431818181818182
Control.SRR15539829;46;45;0.5;23;23;0;0.5
Control.SRR15539829;46;45;0.565217391304348;20;26;0.0652173913043478;0.434782608695652
Control.SRR15539829;42;45;0.5;21;21;0;0.5
Control.SRR15539829;39;45;0.564102564102564;17;22;0.0641025641025641;0.435897435897436
Control.SRR15539829;39;45;0.615384615384615;15;24;0.115384615384615;0.384615384615385
Control.SRR15539829;45;45;0.444444444444444;25;20;0.0555555555555556;0.444444444444444
Control.SRR15539829;39;45;0.487179487179487;20;19;0.0128205128205128;0.487179487179487
Control.SRR15539829;42;45;0.476190476190476;22;20;0.0238095238095238;0.476190476190476
Control.SRR15539829;40;45;0.5;20;20;0;0.5
Control.SRR15539829;40;45;0.575;17;23;0.075;0.425
Control.SRR15539829;45;45;0.577777777777778;19;26;0.0777777777777777;0.422222222222222
Control.SRR15539829;41;45;0.48780487804878;21;20;0.0121951219512195;0.48780487804878
Control.SRR15539829;47;45;0.404255319148936;28;19;0.0957446808510639;0.404255319148936
Control.SRR15539829;43;45;0.418604651162791;25;18;0.0813953488372093;0.418604651162791
Control.SRR15539829;44;45;0.477272727272727;23;21;0.0227272727272727;0.477272727272727
Control.SRR15539829;45;45;0.444444444444444;25;20;0.0555555555555556;0.444444444444444
Control.SRR15539829;40;45;0.5;20;20;0;0.5
Control.SRR15539829;41;45;0.536585365853659;19;22;0.0365853658536586;0.463414634146341
Control.SRR15539829;46;45;0.434782608695652;26;20;0.0652173913043478;0.434782608695652
Control.SRR15539829;50;45;0.58;21;29;0.08;0.42
Control.SRR15539829;39;45;0.435897435897436;22;17;0.0641025641025641;0.435897435897436
Control.SRR15539829;49;45;0.551020408163265;22;27;0.0510204081632653;0.448979591836735
Control.SRR15539829;49;45;0.510204081632653;24;25;0.0102040816326531;0.489795918367347
Control.SRR15539829;47;45;0.48936170212766;24;23;0.0106382978723404;0.48936170212766
Control.SRR15539829;43;45;0.651162790697674;15;28;0.151162790697674;0.348837209302326
Control.SRR15539829;50;45;0.44;28;22;0.06;0.44
Control.SRR15539829;47;45;0.404255319148936;28;19;0.0957446808510639;0.404255319148936
Control.SRR15539829;49;45;0.469387755102041;26;23;0.0306122448979592;0.469387755102041
Control.SRR15539829;46;45;0.521739130434783;22;24;0.0217391304347826;0.478260869565217
Control.SRR15539829;51;45;0.529411764705882;24;27;0.0294117647058824;0.470588235294118
Control.SRR15539829;45;45;0.466666666666667;24;21;0.0333333333333333;0.466666666666667
Control.SRR15539829;41;45;0.414634146341463;24;17;0.0853658536585366;0.414634146341463
Control.SRR15539829;39;45;0.641025641025641;14;25;0.141025641025641;0.358974358974359
Control.SRR15539829;42;45;0.595238095238095;17;25;0.0952380952380952;0.404761904761905
Control.SRR15539829;42;45;0.595238095238095;17;25;0.0952380952380952;0.404761904761905
Control.SRR15539829;45;45;0.4;27;18;0.1;0.4
Control.SRR15539829;50;45;0.6;20;30;0.1;0.4
Control.SRR15539829;47;45;0.553191489361702;21;26;0.0531914893617021;0.446808510638298
Control.SRR15539829;46;45;0.456521739130435;25;21;0.0434782608695652;0.456521739130435
Control.SRR15539829;43;45;0.441860465116279;24;19;0.0581395348837209;0.441860465116279
Control.SRR15539829;47;45;0.48936170212766;24;23;0.0106382978723404;0.48936170212766
Control.SRR15539829;44;45;0.477272727272727;23;21;0.0227272727272727;0.477272727272727
Control.SRR15539829;40;45;0.5;20;20;0;0.5
Control.SRR15539829;47;45;0.51063829787234;23;24;0.0106382978723404;0.48936170212766
Control.SRR15539829;43;45;0.465116279069767;23;20;0.0348837209302326;0.465116279069767
Control.SRR15539829;43;45;0.488372093023256;22;21;0.0116279069767442;0.488372093023256
Control.SRR15539829;44;45;0.613636363636364;17;27;0.113636363636364;0.386363636363636
Control.SRR15539829;45;45;0.488888888888889;23;22;0.0111111111111111;0.488888888888889
Control.SRR15539829;42;45;0.523809523809524;20;22;0.0238095238095238;0.476190476190476
Control.SRR15539829;43;45;0.534883720930233;20;23;0.0348837209302325;0.465116279069767
Control.SRR15539829;40;45;0.375;25;15;0.125;0.375
Control.SRR15539829;45;45;0.555555555555556;20;25;0.0555555555555556;0.444444444444444
Control.SRR15539829;44;45;0.431818181818182;25;19;0.0681818181818182;0.431818181818182
Control.SRR15539829;47;45;0.425531914893617;27;20;0.074468085106383;0.425531914893617
Control.SRR15539829;44;45;0.431818181818182;25;19;0.0681818181818182;0.431818181818182
Control.SRR15539829;40;45;0.375;25;15;0.125;0.375
Control.SRR15539829;46;45;0.478260869565217;24;22;0.0217391304347826;0.478260869565217
Control.SRR15539829;41;45;0.463414634146341;22;19;0.0365853658536585;0.463414634146341
Control.SRR15539829;48;45;0.5625;21;27;0.0625;0.4375
Control.SRR15539829;48;45;0.5;24;24;0;0.5
Control.SRR15539829;40;45;0.525;19;21;0.025;0.475
Control.SRR15539829;42;45;0.666666666666667;14;28;0.166666666666667;0.333333333333333
Control.SRR15539829;47;45;0.51063829787234;23;24;0.0106382978723404;0.48936170212766
Control.SRR15539829;48;45;0.625;18;30;0.125;0.375
Control.SRR15539829;42;45;0.523809523809524;20;22;0.0238095238095238;0.476190476190476
Control.SRR15539829;46;45;0.58695652173913;19;27;0.0869565217391305;0.41304347826087
Control.SRR15539829;43;45;0.465116279069767;23;20;0.0348837209302326;0.465116279069767
Control.SRR15539829;51;45;0.392156862745098;31;20;0.107843137254902;0.392156862745098
Control.SRR15539829;47;45;0.531914893617021;22;25;0.0319148936170213;0.468085106382979
Control.SRR15539829;47;45;0.574468085106383;20;27;0.074468085106383;0.425531914893617
Control.SRR15539829;45;45;0.533333333333333;21;24;0.0333333333333333;0.466666666666667
Control.SRR15539829;48;45;0.604166666666667;19;29;0.104166666666667;0.395833333333333
Control.SRR15539829;50;45;0.34;33;17;0.16;0.34
Control.SRR15539829;41;45;0.585365853658537;17;24;0.0853658536585366;0.414634146341463
Control.SRR15539829;51;45;0.470588235294118;27;24;0.0294117647058824;0.470588235294118
Control.SRR15539829;44;45;0.431818181818182;25;19;0.0681818181818182;0.431818181818182
Control.SRR15539829;45;45;0.511111111111111;22;23;0.0111111111111111;0.488888888888889
Control.SRR15539829;41;45;0.609756097560976;16;25;0.109756097560976;0.390243902439024
Control.SRR15539829;51;45;0.431372549019608;29;22;0.0686274509803921;0.431372549019608
Control.SRR15539829;43;45;0.627906976744186;16;27;0.127906976744186;0.372093023255814
Control.SRR15539829;41;45;0.51219512195122;20;21;0.0121951219512195;0.48780487804878
Control.SRR15539829;46;45;0.478260869565217;24;22;0.0217391304347826;0.478260869565217
Control.SRR15539829;45;45;0.4;27;18;0.1;0.4
Control.SRR15539829;44;45;0.522727272727273;21;23;0.0227272727272727;0.477272727272727
Control.SRR15539829;46;45;0.41304347826087;27;19;0.0869565217391304;0.41304347826087
Control.SRR15539829;44;45;0.5;22;22;0;0.5
Control.SRR15539829;49;45;0.612244897959184;19;30;0.112244897959184;0.387755102040816
Control.SRR15539829;45;45;0.533333333333333;21;24;0.0333333333333333;0.466666666666667
Control.SRR15539829;41;45;0.463414634146341;22;19;0.0365853658536585;0.463414634146341
Control.SRR15539829;50;45;0.48;26;24;0.02;0.48
Control.SRR15539829;44;45;0.5;22;22;0;0.5
Control.SRR15539829;43;45;0.720930232558139;12;31;0.220930232558139;0.27906976744186
Control.SRR15539829;41;45;0.414634146341463;24;17;0.0853658536585366;0.414634146341463
Control.SRR15539829;49;45;0.571428571428571;21;28;0.0714285714285714;0.428571428571429
Control.SRR15539829;48;45;0.541666666666667;22;26;0.0416666666666666;0.458333333333333
Control.SRR15539829;45;45;0.555555555555556;20;25;0.0555555555555556;0.444444444444444
Control.SRR15539829;45;45;0.533333333333333;21;24;0.0333333333333333;0.466666666666667
Control.SRR15539829;46;45;0.5;23;23;0;0.5
Control.SRR15539829;41;45;0.390243902439024;25;16;0.109756097560976;0.390243902439024
Control.SRR15539829;42;45;0.476190476190476;22;20;0.0238095238095238;0.476190476190476
Control.SRR15539829;51;45;0.450980392156863;28;23;0.0490196078431372;0.450980392156863
Control.SRR15539829;51;45;0.450980392156863;28;23;0.0490196078431372;0.450980392156863
Control.SRR15539829;48;45;0.458333333333333;26;22;0.0416666666666667;0.458333333333333
Control.SRR15539829;43;45;0.488372093023256;22;21;0.0116279069767442;0.488372093023256
Control.SRR15539829;51;45;0.568627450980392;22;29;0.0686274509803921;0.431372549019608
Control.SRR15539829;40;45;0.45;22;18;0.05;0.45
Control.SRR15539829;47;45;0.425531914893617;27;20;0.074468085106383;0.425531914893617
Control.SRR15539829;46;45;0.565217391304348;20;26;0.0652173913043478;0.434782608695652
Control.SRR15539829;44;45;0.431818181818182;25;19;0.0681818181818182;0.431818181818182
Control.SRR15539829;44;45;0.431818181818182;25;19;0.0681818181818182;0.431818181818182
Control.SRR15539829;50;45;0.64;18;32;0.14;0.36
Control.SRR15539829;43;45;0.465116279069767;23;20;0.0348837209302326;0.465116279069767
Control.SRR15539829;40;45;0.625;15;25;0.125;0.375
Control.SRR15539829;40;45;0.5;20;20;0;0.5
Control.SRR15539829;45;45;0.6;18;27;0.1;0.4
Control.SRR15539829;46;45;0.521739130434783;22;24;0.0217391304347826;0.478260869565217
Control.SRR15539829;43;45;0.488372093023256;22;21;0.0116279069767442;0.488372093023256
Control.SRR15539829;46;45;0.456521739130435;25;21;0.0434782608695652;0.456521739130435
Control.SRR15539829;46;45;0.391304347826087;28;18;0.108695652173913;0.391304347826087
Control.SRR15539829;44;45;0.568181818181818;19;25;0.0681818181818182;0.431818181818182
Control.SRR15539829;49;45;0.469387755102041;26;23;0.0306122448979592;0.469387755102041
Control.SRR15539829;42;45;0.5;21;21;0;0.5
Control.SRR15539829;45;45;0.422222222222222;26;19;0.0777777777777778;0.422222222222222
Control.SRR15539829;46;45;0.41304347826087;27;19;0.0869565217391304;0.41304347826087
Control.SRR15539829;40;45;0.425;23;17;0.075;0.425
Control.SRR15539829;40;45;0.45;22;18;0.05;0.45
Control.SRR15539829;43;45;0.465116279069767;23;20;0.0348837209302326;0.465116279069767
Control.SRR15539829;41;45;0.51219512195122;20;21;0.0121951219512195;0.48780487804878
Control.SRR15539829;40;45;0.525;19;21;0.025;0.475
Control.SRR15539829;41;45;0.536585365853659;19;22;0.0365853658536586;0.463414634146341
Control.SRR15539829;50;45;0.44;28;22;0.06;0.44
Control.SRR15539829;42;45;0.523809523809524;20;22;0.0238095238095238;0.476190476190476
Control.SRR15539829;39;45;0.461538461538462;21;18;0.0384615384615384;0.461538461538462
Control.SRR15539829;44;45;0.568181818181818;19;25;0.0681818181818182;0.431818181818182
Control.SRR15539829;48;45;0.520833333333333;23;25;0.0208333333333334;0.479166666666667
Control.SRR15539829;44;45;0.522727272727273;21;23;0.0227272727272727;0.477272727272727
Control.SRR15539829;49;45;0.530612244897959;23;26;0.0306122448979592;0.469387755102041
Control.SRR15539829;44;45;0.590909090909091;18;26;0.0909090909090909;0.409090909090909
Control.SRR15539829;45;45;0.488888888888889;23;22;0.0111111111111111;0.488888888888889
Control.SRR15539829;46;45;0.543478260869565;21;25;0.0434782608695652;0.456521739130435
Control.SRR15539829;47;45;0.531914893617021;22;25;0.0319148936170213;0.468085106382979
Control.SRR15539829;41;45;0.560975609756098;18;23;0.0609756097560976;0.439024390243902
Control.SRR15539829;48;45;0.5625;21;27;0.0625;0.4375
Control.SRR15539829;44;45;0.568181818181818;19;25;0.0681818181818182;0.431818181818182
Control.SRR15539829;39;45;0.538461538461538;18;21;0.0384615384615384;0.461538461538462
Control.SRR15539829;48;45;0.416666666666667;28;20;0.0833333333333333;0.416666666666667
Control.SRR15539829;41;45;0.536585365853659;19;22;0.0365853658536586;0.463414634146341
Control.SRR15539829;43;45;0.534883720930233;20;23;0.0348837209302325;0.465116279069767
Control.SRR15539829;51;45;0.549019607843137;23;28;0.0490196078431373;0.450980392156863
Control.SRR15539829;45;45;0.488888888888889;23;22;0.0111111111111111;0.488888888888889
Control.SRR15539829;43;45;0.697674418604651;13;30;0.197674418604651;0.302325581395349
Control.SRR15539829;46;45;0.5;23;23;0;0.5
Control.SRR15539829;50;45;0.38;31;19;0.12;0.38
Control.SRR15539829;50;45;0.42;29;21;0.08;0.42
Control.SRR15539829;49;45;0.591836734693878;20;29;0.0918367346938775;0.408163265306122
Control.SRR15539829;42;45;0.571428571428571;18;24;0.0714285714285714;0.428571428571429
Control.SRR15539829;48;45;0.666666666666667;16;32;0.166666666666667;0.333333333333333
Control.SRR15539829;48;45;0.5;24;24;0;0.5
Control.SRR15539829;45;45;0.511111111111111;22;23;0.0111111111111111;0.488888888888889
Control.SRR15539829;51;45;0.509803921568627;25;26;0.00980392156862742;0.490196078431373
Control.SRR15539829;41;45;0.585365853658537;17;24;0.0853658536585366;0.414634146341463
Control.SRR15539829;43;45;0.465116279069767;23;20;0.0348837209302326;0.465116279069767
Control.SRR15539829;48;45;0.583333333333333;20;28;0.0833333333333334;0.416666666666667
Control.SRR15539829;40;45;0.475;21;19;0.025;0.475
Control.SRR15539829;47;45;0.48936170212766;24;23;0.0106382978723404;0.48936170212766
Control.SRR15539829;41;45;0.536585365853659;19;22;0.0365853658536586;0.463414634146341
Control.SRR15539829;39;45;0.461538461538462;21;18;0.0384615384615384;0.461538461538462
Control.SRR15539829;39;45;0.512820512820513;19;20;0.0128205128205128;0.487179487179487
Control.SRR15539829;49;45;0.673469387755102;16;33;0.173469387755102;0.326530612244898
Control.SRR15539829;48;45;0.520833333333333;23;25;0.0208333333333334;0.479166666666667
Control.SRR15539829;44;45;0.5;22;22;0;0.5
Control.SRR15539829;43;45;0.465116279069767;23;20;0.0348837209302326;0.465116279069767
Control.SRR15539829;41;45;0.341463414634146;27;14;0.158536585365854;0.341463414634146
Control.SRR15539829;43;45;0.534883720930233;20;23;0.0348837209302325;0.465116279069767
Control.SRR15539829;45;45;0.533333333333333;21;24;0.0333333333333333;0.466666666666667
Control.SRR15539829;44;45;0.568181818181818;19;25;0.0681818181818182;0.431818181818182
Control.SRR15539829;46;45;0.543478260869565;21;25;0.0434782608695652;0.456521739130435
Control.SRR15539829;40;45;0.425;23;17;0.075;0.425
Control.SRR15539829;46;45;0.543478260869565;21;25;0.0434782608695652;0.456521739130435
Control.SRR15539829;48;45;0.625;18;30;0.125;0.375
Control.SRR15539829;42;45;0.666666666666667;14;28;0.166666666666667;0.333333333333333
Control.SRR15539829;43;45;0.558139534883721;19;24;0.0581395348837209;0.441860465116279
Control.SRR15539829;51;45;0.372549019607843;32;19;0.127450980392157;0.372549019607843
Control.SRR15539829;41;45;0.560975609756098;18;23;0.0609756097560976;0.439024390243902
Control.SRR15539829;50;45;0.5;25;25;0;0.5
Control.SRR15539829;49;45;0.530612244897959;23;26;0.0306122448979592;0.469387755102041
Control.SRR15539829;47;45;0.574468085106383;20;27;0.074468085106383;0.425531914893617
Control.SRR15539829;50;45;0.5;25;25;0;0.5
Control.SRR15539829;44;45;0.522727272727273;21;23;0.0227272727272727;0.477272727272727
Control.SRR15539829;39;45;0.58974358974359;16;23;0.0897435897435898;0.41025641025641
Control.SRR15539829;41;45;0.609756097560976;16;25;0.109756097560976;0.390243902439024
Control.SRR15539829;46;45;0.673913043478261;15;31;0.173913043478261;0.326086956521739
Control.SRR15539829;50;45;0.54;23;27;0.04;0.46
Control.SRR15539829;46;45;0.543478260869565;21;25;0.0434782608695652;0.456521739130435
Control.SRR15539829;46;45;0.456521739130435;25;21;0.0434782608695652;0.456521739130435
Control.SRR15539829;42;45;0.452380952380952;23;19;0.0476190476190476;0.452380952380952
Control.SRR15539829;41;45;0.51219512195122;20;21;0.0121951219512195;0.48780487804878
Control.SRR15539829;49;45;0.387755102040816;30;19;0.112244897959184;0.387755102040816
Control.SRR15539829;51;45;0.411764705882353;30;21;0.0882352941176471;0.411764705882353
Control.SRR15539829;43;45;0.441860465116279;24;19;0.0581395348837209;0.441860465116279
Control.SRR15539829;48;45;0.645833333333333;17;31;0.145833333333333;0.354166666666667
Control.SRR15539829;42;45;0.428571428571429;24;18;0.0714285714285715;0.428571428571429
Control.SRR15539829;48;45;0.458333333333333;26;22;0.0416666666666667;0.458333333333333
Control.SRR15539829;49;45;0.387755102040816;30;19;0.112244897959184;0.387755102040816
Control.SRR15539829;51;45;0.568627450980392;22;29;0.0686274509803921;0.431372549019608
Control.SRR15539829;45;45;0.511111111111111;22;23;0.0111111111111111;0.488888888888889
Control.SRR15539829;45;45;0.511111111111111;22;23;0.0111111111111111;0.488888888888889
Control.SRR15539829;39;45;0.487179487179487;20;19;0.0128205128205128;0.487179487179487
Control.SRR15539829;45;45;0.488888888888889;23;22;0.0111111111111111;0.488888888888889
Control.SRR15539829;42;45;0.476190476190476;22;20;0.0238095238095238;0.476190476190476
Control.SRR15539829;39;45;0.512820512820513;19;20;0.0128205128205128;0.487179487179487
Control.SRR15539829;51;45;0.411764705882353;30;21;0.0882352941176471;0.411764705882353
Control.SRR15539829;49;45;0.346938775510204;32;17;0.153061224489796;0.346938775510204
Control.SRR15539829;44;45;0.545454545454545;20;24;0.0454545454545454;0.454545454545455
Control.SRR15539829;39;45;0.692307692307692;12;27;0.192307692307692;0.307692307692308
Control.SRR15539829;48;45;0.375;30;18;0.125;0.375
Control.SRR15539829;45;45;0.622222222222222;17;28;0.122222222222222;0.377777777777778
Control.SRR15539829;50;45;0.44;28;22;0.06;0.44
Control.SRR15539829;39;45;0.538461538461538;18;21;0.0384615384615384;0.461538461538462
Control.SRR15539829;44;45;0.522727272727273;21;23;0.0227272727272727;0.477272727272727
Control.SRR15539829;39;45;0.641025641025641;14;25;0.141025641025641;0.358974358974359
Control.SRR15539829;41;45;0.585365853658537;17;24;0.0853658536585366;0.414634146341463
Control.SRR15539829;45;45;0.511111111111111;22;23;0.0111111111111111;0.488888888888889
Control.SRR15539829;51;45;0.490196078431373;26;25;0.00980392156862747;0.490196078431373
Control.SRR15539829;41;45;0.48780487804878;21;20;0.0121951219512195;0.48780487804878
Control.SRR15539829;42;45;0.571428571428571;18;24;0.0714285714285714;0.428571428571429
Control.SRR15539829;39;45;0.384615384615385;24;15;0.115384615384615;0.384615384615385
Control.SRR15539829;40;45;0.575;17;23;0.075;0.425
Control.SRR15539829;44;45;0.522727272727273;21;23;0.0227272727272727;0.477272727272727
Control.SRR15539829;40;45;0.35;26;14;0.15;0.35
Control.SRR15539829;42;45;0.380952380952381;26;16;0.119047619047619;0.380952380952381
Control.SRR15539829;46;45;0.456521739130435;25;21;0.0434782608695652;0.456521739130435
Control.SRR15539829;39;45;0.641025641025641;14;25;0.141025641025641;0.358974358974359
Control.SRR15539829;49;45;0.489795918367347;25;24;0.0102040816326531;0.489795918367347
Control.SRR15539829;50;45;0.48;26;24;0.02;0.48
Control.SRR15539829;41;45;0.51219512195122;20;21;0.0121951219512195;0.48780487804878
Control.SRR15539829;45;45;0.488888888888889;23;22;0.0111111111111111;0.488888888888889
Control.SRR15539829;50;45;0.56;22;28;0.0600000000000001;0.44
Control.SRR15539829;49;45;0.489795918367347;25;24;0.0102040816326531;0.489795918367347
Control.SRR15539829;41;45;0.48780487804878;21;20;0.0121951219512195;0.48780487804878
Control.SRR15539829;48;45;0.4375;27;21;0.0625;0.4375
Control.SRR15539829;46;45;0.5;23;23;0;0.5
Control.SRR15539829;47;45;0.446808510638298;26;21;0.0531914893617021;0.446808510638298
Control.SRR15539829;47;45;0.48936170212766;24;23;0.0106382978723404;0.48936170212766
Control.SRR15539829;51;45;0.411764705882353;30;21;0.0882352941176471;0.411764705882353
Control.SRR15539829;45;45;0.444444444444444;25;20;0.0555555555555556;0.444444444444444
Control.SRR15539829;43;45;0.511627906976744;21;22;0.0116279069767442;0.488372093023256
Control.SRR15539829;44;45;0.5;22;22;0;0.5
Control.SRR15539829;44;45;0.522727272727273;21;23;0.0227272727272727;0.477272727272727
Control.SRR15539829;48;45;0.416666666666667;28;20;0.0833333333333333;0.416666666666667
Control.SRR15539829;48;45;0.4375;27;21;0.0625;0.4375
Control.SRR15539829;45;45;0.533333333333333;21;24;0.0333333333333333;0.466666666666667
Control.SRR15539829;44;45;0.409090909090909;26;18;0.0909090909090909;0.409090909090909
Control.SRR15539829;45;45;0.466666666666667;24;21;0.0333333333333333;0.466666666666667
Control.SRR15539829;45;45;0.6;18;27;0.1;0.4
Control.SRR15539829;50;45;0.42;29;21;0.08;0.42
Control.SRR15539829;49;45;0.428571428571429;28;21;0.0714285714285715;0.428571428571429
Control.SRR15539829;44;45;0.568181818181818;19;25;0.0681818181818182;0.431818181818182
Control.SRR15539829;45;45;0.466666666666667;24;21;0.0333333333333333;0.466666666666667
Control.SRR15539829;50;45;0.34;33;17;0.16;0.34
Control.SRR15539829;45;45;0.466666666666667;24;21;0.0333333333333333;0.466666666666667
Control.SRR15539829;47;45;0.48936170212766;24;23;0.0106382978723404;0.48936170212766
Control.SRR15539829;45;45;0.577777777777778;19;26;0.0777777777777777;0.422222222222222
Control.SRR15539829;44;45;0.409090909090909;26;18;0.0909090909090909;0.409090909090909
Control.SRR15539829;44;45;0.431818181818182;25;19;0.0681818181818182;0.431818181818182
Control.SRR15539829;45;45;0.688888888888889;14;31;0.188888888888889;0.311111111111111
Control.SRR15539829;44;45;0.590909090909091;18;26;0.0909090909090909;0.409090909090909
Control.SRR15539829;43;45;0.581395348837209;18;25;0.0813953488372093;0.418604651162791
Control.SRR15539829;48;45;0.5625;21;27;0.0625;0.4375
Control.SRR15539829;50;45;0.48;26;24;0.02;0.48
Control.SRR15539829;39;45;0.487179487179487;20;19;0.0128205128205128;0.487179487179487
Control.SRR15539829;42;45;0.5;21;21;0;0.5
Control.SRR15539829;41;45;0.536585365853659;19;22;0.0365853658536586;0.463414634146341
Control.SRR15539829;42;45;0.619047619047619;16;26;0.119047619047619;0.380952380952381
Control.SRR15539829;43;45;0.627906976744186;16;27;0.127906976744186;0.372093023255814
Control.SRR15539829;43;45;0.581395348837209;18;25;0.0813953488372093;0.418604651162791
Control.SRR15539829;51;45;0.294117647058824;36;15;0.205882352941176;0.294117647058824
Control.SRR15539829;39;45;0.487179487179487;20;19;0.0128205128205128;0.487179487179487
Control.SRR15539829;46;45;0.521739130434783;22;24;0.0217391304347826;0.478260869565217
Control.SRR15539829;45;45;0.466666666666667;24;21;0.0333333333333333;0.466666666666667
Control.SRR15539829;50;45;0.48;26;24;0.02;0.48
Control.SRR15539829;41;45;0.48780487804878;21;20;0.0121951219512195;0.48780487804878
Control.SRR15539829;46;45;0.478260869565217;24;22;0.0217391304347826;0.478260869565217
Control.SRR15539829;40;45;0.5;20;20;0;0.5
Control.SRR15539829;41;45;0.560975609756098;18;23;0.0609756097560976;0.439024390243902
Control.SRR15539829;43;45;0.511627906976744;21;22;0.0116279069767442;0.488372093023256
Control.SRR15539829;44;45;0.431818181818182;25;19;0.0681818181818182;0.431818181818182
Control.SRR15539829;40;45;0.45;22;18;0.05;0.45
Control.SRR15539829;47;45;0.48936170212766;24;23;0.0106382978723404;0.48936170212766
Control.SRR15539829;47;45;0.48936170212766;24;23;0.0106382978723404;0.48936170212766
Control.SRR15539829;45;45;0.444444444444444;25;20;0.0555555555555556;0.444444444444444
Control.SRR15539829;46;45;0.630434782608696;17;29;0.130434782608696;0.369565217391304
Control.SRR15539829;40;45;0.5;20;20;0;0.5
Control.SRR15539829;39;45;0.564102564102564;17;22;0.0641025641025641;0.435897435897436
Control.SRR15539829;47;45;0.48936170212766;24;23;0.0106382978723404;0.48936170212766
Control.SRR15539829;41;45;0.51219512195122;20;21;0.0121951219512195;0.48780487804878
Control.SRR15539829;46;45;0.456521739130435;25;21;0.0434782608695652;0.456521739130435
Control.SRR15539829;41;45;0.51219512195122;20;21;0.0121951219512195;0.48780487804878
Control.SRR15539829;49;45;0.530612244897959;23;26;0.0306122448979592;0.469387755102041
Control.SRR15539829;39;45;0.564102564102564;17;22;0.0641025641025641;0.435897435897436
Control.SRR15539829;39;45;0.435897435897436;22;17;0.0641025641025641;0.435897435897436
Control.SRR15539829;50;45;0.54;23;27;0.04;0.46
Control.SRR15539829;40;45;0.35;26;14;0.15;0.35
Control.SRR15539829;44;45;0.5;22;22;0;0.5
Control.SRR15539829;43;45;0.534883720930233;20;23;0.0348837209302325;0.465116279069767
Control.SRR15539829;40;45;0.6;16;24;0.1;0.4
Control.SRR15539829;42;45;0.428571428571429;24;18;0.0714285714285715;0.428571428571429
Control.SRR15539829;46;45;0.608695652173913;18;28;0.108695652173913;0.391304347826087
Control.SRR15539829;46;45;0.478260869565217;24;22;0.0217391304347826;0.478260869565217
Control.SRR15539829;45;45;0.444444444444444;25;20;0.0555555555555556;0.444444444444444
Control.SRR15539829;40;45;0.375;25;15;0.125;0.375
Control.SRR15539829;44;45;0.613636363636364;17;27;0.113636363636364;0.386363636363636
Control.SRR15539829;49;45;0.551020408163265;22;27;0.0510204081632653;0.448979591836735
Control.SRR15539829;46;45;0.478260869565217;24;22;0.0217391304347826;0.478260869565217
Control.SRR15539829;39;45;0.41025641025641;23;16;0.0897435897435898;0.41025641025641
Control.SRR15539829;43;45;0.465116279069767;23;20;0.0348837209302326;0.465116279069767
Control.SRR15539829;40;45;0.55;18;22;0.05;0.45
Control.SRR15539829;41;45;0.463414634146341;22;19;0.0365853658536585;0.463414634146341
Control.SRR15539829;46;45;0.478260869565217;24;22;0.0217391304347826;0.478260869565217
Control.SRR15539829;47;45;0.51063829787234;23;24;0.0106382978723404;0.48936170212766
Control.SRR15539829;47;45;0.468085106382979;25;22;0.0319148936170213;0.468085106382979
Control.SRR15539829;40;45;0.525;19;21;0.025;0.475
Control.SRR15539829;50;45;0.54;23;27;0.04;0.46
Control.SRR15539829;49;45;0.510204081632653;24;25;0.0102040816326531;0.489795918367347
Control.SRR15539829;47;45;0.468085106382979;25;22;0.0319148936170213;0.468085106382979
Control.SRR15539829;48;45;0.479166666666667;25;23;0.0208333333333333;0.479166666666667
Control.SRR15539829;39;45;0.461538461538462;21;18;0.0384615384615384;0.461538461538462
Control.SRR15539829;47;45;0.51063829787234;23;24;0.0106382978723404;0.48936170212766
Control.SRR15539829;45;45;0.511111111111111;22;23;0.0111111111111111;0.488888888888889
Control.SRR15539829;43;45;0.441860465116279;24;19;0.0581395348837209;0.441860465116279
Control.SRR15539829;44;45;0.522727272727273;21;23;0.0227272727272727;0.477272727272727
Control.SRR15539829;50;45;0.66;17;33;0.16;0.34
Control.SRR15539829;46;45;0.41304347826087;27;19;0.0869565217391304;0.41304347826087
Control.SRR15539829;51;45;0.450980392156863;28;23;0.0490196078431372;0.450980392156863
Control.SRR15539829;39;45;0.615384615384615;15;24;0.115384615384615;0.384615384615385
Control.SRR15539829;44;45;0.5;22;22;0;0.5
Control.SRR15539829;48;45;0.520833333333333;23;25;0.0208333333333334;0.479166666666667
Control.SRR15539829;46;45;0.630434782608696;17;29;0.130434782608696;0.369565217391304
Control.SRR15539829;51;45;0.509803921568627;25;26;0.00980392156862742;0.490196078431373
Control.SRR15539829;42;45;0.547619047619048;19;23;0.0476190476190477;0.452380952380952
Control.SRR15539829;51;45;0.490196078431373;26;25;0.00980392156862747;0.490196078431373
Control.SRR15539829;48;45;0.375;30;18;0.125;0.375
Control.SRR15539829;46;45;0.630434782608696;17;29;0.130434782608696;0.369565217391304
Control.SRR15539829;41;45;0.463414634146341;22;19;0.0365853658536585;0.463414634146341
Control.SRR15539829;48;45;0.541666666666667;22;26;0.0416666666666666;0.458333333333333
Control.SRR15539829;48;45;0.479166666666667;25;23;0.0208333333333333;0.479166666666667
Control.SRR15539829;50;45;0.54;23;27;0.04;0.46
Control.SRR15539829;44;45;0.454545454545455;24;20;0.0454545454545455;0.454545454545455
Control.SRR15539829;47;45;0.51063829787234;23;24;0.0106382978723404;0.48936170212766
Control.SRR15539829;42;45;0.452380952380952;23;19;0.0476190476190476;0.452380952380952
Control.SRR15539829;48;45;0.520833333333333;23;25;0.0208333333333334;0.479166666666667
Control.SRR15539829;46;45;0.478260869565217;24;22;0.0217391304347826;0.478260869565217
Control.SRR15539829;48;45;0.4375;27;21;0.0625;0.4375
Control.SRR15539829;51;45;0.411764705882353;30;21;0.0882352941176471;0.411764705882353
Control.SRR15539829;51;45;0.568627450980392;22;29;0.0686274509803921;0.431372549019608
Control.SRR15539829;39;45;0.512820512820513;19;20;0.0128205128205128;0.487179487179487
Control.SRR15539829;47;45;0.531914893617021;22;25;0.0319148936170213;0.468085106382979
Control.SRR15539829;43;45;0.395348837209302;26;17;0.104651162790698;0.395348837209302
Control.SRR15539829;47;45;0.404255319148936;28;19;0.0957446808510639;0.404255319148936
Control.SRR15539829;48;45;0.395833333333333;29;19;0.104166666666667;0.395833333333333
Control.SRR15539829;47;45;0.574468085106383;20;27;0.074468085106383;0.425531914893617
Control.SRR15539829;49;45;0.428571428571429;28;21;0.0714285714285715;0.428571428571429
Control.SRR15539829;43;45;0.465116279069767;23;20;0.0348837209302326;0.465116279069767
Control.SRR15539829;39;45;0.538461538461538;18;21;0.0384615384615384;0.461538461538462
Control.SRR15539829;44;45;0.5;22;22;0;0.5
Control.SRR15539829;50;45;0.5;25;25;0;0.5
Control.SRR15539829;49;45;0.489795918367347;25;24;0.0102040816326531;0.489795918367347
Control.SRR15539829;39;45;0.615384615384615;15;24;0.115384615384615;0.384615384615385
Control.SRR15539829;41;45;0.560975609756098;18;23;0.0609756097560976;0.439024390243902
Control.SRR15539829;44;45;0.5;22;22;0;0.5
Control.SRR15539829;46;45;0.543478260869565;21;25;0.0434782608695652;0.456521739130435
Control.SRR15539829;42;45;0.595238095238095;17;25;0.0952380952380952;0.404761904761905
Control.SRR15539829;49;45;0.510204081632653;24;25;0.0102040816326531;0.489795918367347
Control.SRR15539829;49;45;0.469387755102041;26;23;0.0306122448979592;0.469387755102041
Control.SRR15539829;42;45;0.547619047619048;19;23;0.0476190476190477;0.452380952380952
Control.SRR15539829;44;45;0.636363636363636;16;28;0.136363636363636;0.363636363636364
Control.SRR15539829;44;45;0.522727272727273;21;23;0.0227272727272727;0.477272727272727
Control.SRR15539829;41;45;0.536585365853659;19;22;0.0365853658536586;0.463414634146341
Control.SRR15539829;47;45;0.531914893617021;22;25;0.0319148936170213;0.468085106382979
Control.SRR15539829;50;45;0.46;27;23;0.04;0.46
Control.SRR15539829;49;45;0.36734693877551;31;18;0.13265306122449;0.36734693877551
Control.SRR15539829;47;45;0.446808510638298;26;21;0.0531914893617021;0.446808510638298
Control.SRR15539829;44;45;0.636363636363636;16;28;0.136363636363636;0.363636363636364
Control.SRR15539829;44;45;0.431818181818182;25;19;0.0681818181818182;0.431818181818182
Control.SRR15539829;42;45;0.523809523809524;20;22;0.0238095238095238;0.476190476190476
Control.SRR15539829;47;45;0.553191489361702;21;26;0.0531914893617021;0.446808510638298
Control.SRR15539829;45;45;0.577777777777778;19;26;0.0777777777777777;0.422222222222222
Control.SRR15539829;45;45;0.666666666666667;15;30;0.166666666666667;0.333333333333333
Control.SRR15539829;46;45;0.521739130434783;22;24;0.0217391304347826;0.478260869565217
Control.SRR15539829;48;45;0.583333333333333;20;28;0.0833333333333334;0.416666666666667
Control.SRR15539829;48;45;0.395833333333333;29;19;0.104166666666667;0.395833333333333
Control.SRR15539829;45;45;0.622222222222222;17;28;0.122222222222222;0.377777777777778
Control.SRR15539829;46;45;0.434782608695652;26;20;0.0652173913043478;0.434782608695652
Control.SRR15539829;49;45;0.469387755102041;26;23;0.0306122448979592;0.469387755102041
Control.SRR15539829;49;45;0.489795918367347;25;24;0.0102040816326531;0.489795918367347
Control.SRR15539829;44;45;0.5;22;22;0;0.5
Control.SRR15539829;42;45;0.523809523809524;20;22;0.0238095238095238;0.476190476190476
Control.SRR15539829;39;45;0.358974358974359;25;14;0.141025641025641;0.358974358974359
Control.SRR15539829;45;45;0.466666666666667;24;21;0.0333333333333333;0.466666666666667
Control.SRR15539829;46;45;0.521739130434783;22;24;0.0217391304347826;0.478260869565217
Control.SRR15539829;48;45;0.395833333333333;29;19;0.104166666666667;0.395833333333333
Control.SRR15539829;42;45;0.452380952380952;23;19;0.0476190476190476;0.452380952380952
Control.SRR15539829;45;45;0.577777777777778;19;26;0.0777777777777777;0.422222222222222
Control.SRR15539829;40;45;0.35;26;14;0.15;0.35
Control.SRR15539829;44;45;0.5;22;22;0;0.5
Control.SRR15539829;51;45;0.568627450980392;22;29;0.0686274509803921;0.431372549019608
Control.SRR15539829;51;45;0.411764705882353;30;21;0.0882352941176471;0.411764705882353
Control.SRR15539829;44;45;0.363636363636364;28;16;0.136363636363636;0.363636363636364
Control.SRR15539829;51;45;0.392156862745098;31;20;0.107843137254902;0.392156862745098
Control.SRR15539829;46;45;0.456521739130435;25;21;0.0434782608695652;0.456521739130435
Control.SRR15539829;42;45;0.595238095238095;17;25;0.0952380952380952;0.404761904761905
Control.SRR15539829;43;45;0.488372093023256;22;21;0.0116279069767442;0.488372093023256
Control.SRR15539829;39;45;0.487179487179487;20;19;0.0128205128205128;0.487179487179487
Control.SRR15539829;40;45;0.5;20;20;0;0.5
Control.SRR15539829;43;45;0.488372093023256;22;21;0.0116279069767442;0.488372093023256
Control.SRR15539829;42;45;0.476190476190476;22;20;0.0238095238095238;0.476190476190476
Control.SRR15539829;42;45;0.333333333333333;28;14;0.166666666666667;0.333333333333333
Control.SRR15539829;48;45;0.395833333333333;29;19;0.104166666666667;0.395833333333333
Control.SRR15539829;43;45;0.441860465116279;24;19;0.0581395348837209;0.441860465116279
Control.SRR15539829;43;45;0.581395348837209;18;25;0.0813953488372093;0.418604651162791
Control.SRR15539829;46;45;0.58695652173913;19;27;0.0869565217391305;0.41304347826087
Control.SRR15539829;41;45;0.51219512195122;20;21;0.0121951219512195;0.48780487804878
Control.SRR15539829;49;45;0.510204081632653;24;25;0.0102040816326531;0.489795918367347
Control.SRR15539829;44;45;0.477272727272727;23;21;0.0227272727272727;0.477272727272727
Control.SRR15539829;49;45;0.469387755102041;26;23;0.0306122448979592;0.469387755102041
Control.SRR15539829;48;45;0.5625;21;27;0.0625;0.4375
Control.SRR15539829;45;45;0.555555555555556;20;25;0.0555555555555556;0.444444444444444
Control.SRR15539829;44;45;0.568181818181818;19;25;0.0681818181818182;0.431818181818182
Control.SRR15539829;41;45;0.51219512195122;20;21;0.0121951219512195;0.48780487804878
Control.SRR15539829;43;45;0.465116279069767;23;20;0.0348837209302326;0.465116279069767
Control.SRR15539829;49;45;0.36734693877551;31;18;0.13265306122449;0.36734693877551
Control.SRR15539829;43;45;0.558139534883721;19;24;0.0581395348837209;0.441860465116279
Control.SRR15539829;44;45;0.318181818181818;30;14;0.181818181818182;0.318181818181818
Control.SRR15539829;41;45;0.439024390243902;23;18;0.0609756097560976;0.439024390243902
Control.SRR15539829;42;45;0.523809523809524;20;22;0.0238095238095238;0.476190476190476
Control.SRR15539829;48;45;0.5;24;24;0;0.5
Control.SRR15539829;47;45;0.48936170212766;24;23;0.0106382978723404;0.48936170212766
Control.SRR15539829;45;45;0.444444444444444;25;20;0.0555555555555556;0.444444444444444
Control.SRR15539829;44;45;0.454545454545455;24;20;0.0454545454545455;0.454545454545455
Control.SRR15539829;40;45;0.625;15;25;0.125;0.375
Control.SRR15539829;42;45;0.476190476190476;22;20;0.0238095238095238;0.476190476190476
Control.SRR15539829;49;45;0.387755102040816;30;19;0.112244897959184;0.387755102040816
Control.SRR15539829;42;45;0.595238095238095;17;25;0.0952380952380952;0.404761904761905
Control.SRR15539829;45;45;0.511111111111111;22;23;0.0111111111111111;0.488888888888889
Control.SRR15539829;40;45;0.525;19;21;0.025;0.475
Control.SRR15539829;42;45;0.404761904761905;25;17;0.0952380952380952;0.404761904761905
Control.SRR15539829;42;45;0.428571428571429;24;18;0.0714285714285715;0.428571428571429
Control.SRR15539829;47;45;0.51063829787234;23;24;0.0106382978723404;0.48936170212766
Control.SRR15539829;45;45;0.444444444444444;25;20;0.0555555555555556;0.444444444444444
Control.SRR15539829;42;45;0.5;21;21;0;0.5
Control.SRR15539829;43;45;0.651162790697674;15;28;0.151162790697674;0.348837209302326
Control.SRR15539829;46;45;0.5;23;23;0;0.5
Control.SRR15539829;41;45;0.585365853658537;17;24;0.0853658536585366;0.414634146341463
Control.SRR15539829;40;45;0.475;21;19;0.025;0.475
Control.SRR15539829;41;45;0.51219512195122;20;21;0.0121951219512195;0.48780487804878
Control.SRR15539829;45;45;0.4;27;18;0.1;0.4
Control.SRR15539829;48;45;0.5;24;24;0;0.5
Control.SRR15539829;44;45;0.477272727272727;23;21;0.0227272727272727;0.477272727272727
Control.SRR15539829;42;45;0.571428571428571;18;24;0.0714285714285714;0.428571428571429
Control.SRR15539829;39;45;0.384615384615385;24;15;0.115384615384615;0.384615384615385
Control.SRR15539829;48;45;0.458333333333333;26;22;0.0416666666666667;0.458333333333333
Control.SRR15539829;47;45;0.595744680851064;19;28;0.0957446808510638;0.404255319148936
Control.SRR15539829;47;45;0.531914893617021;22;25;0.0319148936170213;0.468085106382979
Control.SRR15539829;49;45;0.489795918367347;25;24;0.0102040816326531;0.489795918367347
Control.SRR15539829;48;45;0.541666666666667;22;26;0.0416666666666666;0.458333333333333
Control.SRR15539829;51;45;0.450980392156863;28;23;0.0490196078431372;0.450980392156863
Control.SRR15539829;48;45;0.541666666666667;22;26;0.0416666666666666;0.458333333333333
Control.SRR15539829;50;45;0.52;24;26;0.02;0.48
Control.SRR15539829;47;45;0.638297872340426;17;30;0.138297872340426;0.361702127659574
Control.SRR15539829;44;45;0.272727272727273;32;12;0.227272727272727;0.272727272727273
Control.SRR15539829;42;45;0.595238095238095;17;25;0.0952380952380952;0.404761904761905
Control.SRR15539829;44;45;0.5;22;22;0;0.5
Control.SRR15539829;40;45;0.4;24;16;0.1;0.4
Control.SRR15539829;42;45;0.523809523809524;20;22;0.0238095238095238;0.476190476190476
Control.SRR15539829;41;45;0.585365853658537;17;24;0.0853658536585366;0.414634146341463
Control.SRR15539829;50;45;0.6;20;30;0.1;0.4
Control.SRR15539829;42;45;0.452380952380952;23;19;0.0476190476190476;0.452380952380952
Control.SRR15539829;41;45;0.463414634146341;22;19;0.0365853658536585;0.463414634146341
Control.SRR15539829;44;45;0.477272727272727;23;21;0.0227272727272727;0.477272727272727
Control.SRR15539829;45;45;0.466666666666667;24;21;0.0333333333333333;0.466666666666667
Control.SRR15539829;45;45;0.488888888888889;23;22;0.0111111111111111;0.488888888888889
Control.SRR15539829;50;45;0.38;31;19;0.12;0.38
Control.SRR15539829;39;45;0.358974358974359;25;14;0.141025641025641;0.358974358974359
Control.SRR15539829;50;45;0.5;25;25;0;0.5
Control.SRR15539829;44;45;0.409090909090909;26;18;0.0909090909090909;0.409090909090909
Control.SRR15539829;45;45;0.533333333333333;21;24;0.0333333333333333;0.466666666666667
Control.SRR15539829;49;45;0.571428571428571;21;28;0.0714285714285714;0.428571428571429
Control.SRR15539829;44;45;0.431818181818182;25;19;0.0681818181818182;0.431818181818182
Control.SRR15539829;45;45;0.533333333333333;21;24;0.0333333333333333;0.466666666666667
Control.SRR15539829;42;45;0.5;21;21;0;0.5
Control.SRR15539829;40;45;0.475;21;19;0.025;0.475
Control.SRR15539829;51;45;0.588235294117647;21;30;0.0882352941176471;0.411764705882353
Control.SRR15539829;42;45;0.428571428571429;24;18;0.0714285714285715;0.428571428571429
Control.SRR15539829;44;45;0.522727272727273;21;23;0.0227272727272727;0.477272727272727
Control.SRR15539829;47;45;0.404255319148936;28;19;0.0957446808510639;0.404255319148936
Control.SRR15539829;47;45;0.404255319148936;28;19;0.0957446808510639;0.404255319148936
Control.SRR15539829;43;45;0.511627906976744;21;22;0.0116279069767442;0.488372093023256
Control.SRR15539829;47;45;0.48936170212766;24;23;0.0106382978723404;0.48936170212766
Control.SRR15539829;39;45;0.58974358974359;16;23;0.0897435897435898;0.41025641025641
Control.SRR15539829;46;45;0.521739130434783;22;24;0.0217391304347826;0.478260869565217
Control.SRR15539829;45;45;0.466666666666667;24;21;0.0333333333333333;0.466666666666667
Control.SRR15539829;45;45;0.488888888888889;23;22;0.0111111111111111;0.488888888888889
Control.SRR15539829;43;45;0.395348837209302;26;17;0.104651162790698;0.395348837209302
Control.SRR15539829;40;45;0.55;18;22;0.05;0.45
Control.SRR15539829;45;45;0.688888888888889;14;31;0.188888888888889;0.311111111111111
Control.SRR15539829;40;45;0.55;18;22;0.05;0.45
Control.SRR15539829;42;45;0.571428571428571;18;24;0.0714285714285714;0.428571428571429
Control.SRR15539829;48;45;0.479166666666667;25;23;0.0208333333333333;0.479166666666667
Control.SRR15539829;42;45;0.452380952380952;23;19;0.0476190476190476;0.452380952380952
Control.SRR15539829;43;45;0.558139534883721;19;24;0.0581395348837209;0.441860465116279
Control.SRR15539829;45;45;0.355555555555556;29;16;0.144444444444444;0.355555555555556
Control.SRR15539829;40;45;0.475;21;19;0.025;0.475
Control.SRR15539829;45;45;0.488888888888889;23;22;0.0111111111111111;0.488888888888889
Control.SRR15539829;44;45;0.454545454545455;24;20;0.0454545454545455;0.454545454545455
Control.SRR15539829;42;45;0.571428571428571;18;24;0.0714285714285714;0.428571428571429
Control.SRR15539829;41;45;0.560975609756098;18;23;0.0609756097560976;0.439024390243902
Control.SRR15539829;44;45;0.477272727272727;23;21;0.0227272727272727;0.477272727272727
Control.SRR15539829;50;45;0.62;19;31;0.12;0.38
Control.SRR15539829;46;45;0.434782608695652;26;20;0.0652173913043478;0.434782608695652
Control.SRR15539829;43;45;0.441860465116279;24;19;0.0581395348837209;0.441860465116279
Control.SRR15539829;46;45;0.41304347826087;27;19;0.0869565217391304;0.41304347826087
Control.SRR15539829;41;45;0.390243902439024;25;16;0.109756097560976;0.390243902439024
Control.SRR15539829;44;45;0.454545454545455;24;20;0.0454545454545455;0.454545454545455
Control.SRR15539829;44;45;0.5;22;22;0;0.5
Control.SRR15539829;48;45;0.5;24;24;0;0.5
Control.SRR15539829;50;45;0.58;21;29;0.08;0.42
Control.SRR15539829;44;45;0.590909090909091;18;26;0.0909090909090909;0.409090909090909
Control.SRR15539829;42;45;0.452380952380952;23;19;0.0476190476190476;0.452380952380952
Control.SRR15539829;39;45;0.538461538461538;18;21;0.0384615384615384;0.461538461538462
Control.SRR15539829;41;45;0.48780487804878;21;20;0.0121951219512195;0.48780487804878
Control.SRR15539829;46;45;0.456521739130435;25;21;0.0434782608695652;0.456521739130435
Control.SRR15539829;48;45;0.520833333333333;23;25;0.0208333333333334;0.479166666666667
Control.SRR15539829;46;45;0.478260869565217;24;22;0.0217391304347826;0.478260869565217
Control.SRR15539829;48;45;0.6875;15;33;0.1875;0.3125
Control.SRR15539829;47;45;0.51063829787234;23;24;0.0106382978723404;0.48936170212766
Control.SRR15539829;49;45;0.510204081632653;24;25;0.0102040816326531;0.489795918367347
Control.SRR15539829;44;45;0.590909090909091;18;26;0.0909090909090909;0.409090909090909
Control.SRR15539829;48;45;0.520833333333333;23;25;0.0208333333333334;0.479166666666667
Control.SRR15539829;43;45;0.651162790697674;15;28;0.151162790697674;0.348837209302326
Control.SRR15539829;46;45;0.521739130434783;22;24;0.0217391304347826;0.478260869565217
Control.SRR15539829;46;45;0.58695652173913;19;27;0.0869565217391305;0.41304347826087
Control.SRR15539829;39;45;0.538461538461538;18;21;0.0384615384615384;0.461538461538462
Control.SRR15539829;47;45;0.468085106382979;25;22;0.0319148936170213;0.468085106382979
Control.SRR15539829;46;45;0.5;23;23;0;0.5
Control.SRR15539829;45;45;0.6;18;27;0.1;0.4
Control.SRR15539829;41;45;0.51219512195122;20;21;0.0121951219512195;0.48780487804878
Control.SRR15539829;43;45;0.395348837209302;26;17;0.104651162790698;0.395348837209302
Control.SRR15539829;44;45;0.409090909090909;26;18;0.0909090909090909;0.409090909090909
Control.SRR15539829;43;45;0.488372093023256;22;21;0.0116279069767442;0.488372093023256
Control.SRR15539829;45;45;0.488888888888889;23;22;0.0111111111111111;0.488888888888889
Control.SRR15539829;46;45;0.369565217391304;29;17;0.130434782608696;0.369565217391304
Control.SRR15539829;39;45;0.435897435897436;22;17;0.0641025641025641;0.435897435897436
Control.SRR15539829;48;45;0.5625;21;27;0.0625;0.4375
Control.SRR15539829;43;45;0.558139534883721;19;24;0.0581395348837209;0.441860465116279
Control.SRR15539829;42;45;0.547619047619048;19;23;0.0476190476190477;0.452380952380952
Control.SRR15539829;41;45;0.48780487804878;21;20;0.0121951219512195;0.48780487804878
Control.SRR15539829;41;45;0.48780487804878;21;20;0.0121951219512195;0.48780487804878
Control.SRR15539829;49;45;0.448979591836735;27;22;0.0510204081632653;0.448979591836735
Control.SRR15539829;43;45;0.604651162790698;17;26;0.104651162790698;0.395348837209302
Control.SRR15539829;45;45;0.355555555555556;29;16;0.144444444444444;0.355555555555556
Control.SRR15539829;49;45;0.469387755102041;26;23;0.0306122448979592;0.469387755102041
Control.SRR15539829;51;45;0.568627450980392;22;29;0.0686274509803921;0.431372549019608
Control.SRR15539829;39;45;0.538461538461538;18;21;0.0384615384615384;0.461538461538462
Control.SRR15539829;44;45;0.636363636363636;16;28;0.136363636363636;0.363636363636364
Control.SRR15539829;47;45;0.468085106382979;25;22;0.0319148936170213;0.468085106382979
Control.SRR15539829;49;45;0.551020408163265;22;27;0.0510204081632653;0.448979591836735
Control.SRR15539829;50;45;0.48;26;24;0.02;0.48
Control.SRR15539829;40;45;0.475;21;19;0.025;0.475
Control.SRR15539829;39;45;0.461538461538462;21;18;0.0384615384615384;0.461538461538462
Control.SRR15539829;45;45;0.6;18;27;0.1;0.4
Control.SRR15539829;42;45;0.619047619047619;16;26;0.119047619047619;0.380952380952381
Control.SRR15539829;39;45;0.564102564102564;17;22;0.0641025641025641;0.435897435897436
Control.SRR15539829;43;45;0.441860465116279;24;19;0.0581395348837209;0.441860465116279
Control.SRR15539829;41;45;0.560975609756098;18;23;0.0609756097560976;0.439024390243902
Control.SRR15539829;50;45;0.38;31;19;0.12;0.38
Control.SRR15539829;50;45;0.42;29;21;0.08;0.42
Control.SRR15539829;44;45;0.477272727272727;23;21;0.0227272727272727;0.477272727272727
Control.SRR15539829;48;45;0.479166666666667;25;23;0.0208333333333333;0.479166666666667
Control.SRR15539829;39;45;0.512820512820513;19;20;0.0128205128205128;0.487179487179487
Control.SRR15539829;45;45;0.6;18;27;0.1;0.4
Control.SRR15539829;49;45;0.530612244897959;23;26;0.0306122448979592;0.469387755102041
Control.SRR15539829;48;45;0.458333333333333;26;22;0.0416666666666667;0.458333333333333
Control.SRR15539829;48;45;0.625;18;30;0.125;0.375
Control.SRR15539829;41;45;0.682926829268293;13;28;0.182926829268293;0.317073170731707
Control.SRR15539829;43;45;0.418604651162791;25;18;0.0813953488372093;0.418604651162791
Control.SRR15539829;50;45;0.58;21;29;0.08;0.42
Control.SRR15539829;39;45;0.461538461538462;21;18;0.0384615384615384;0.461538461538462
Control.SRR15539829;44;45;0.431818181818182;25;19;0.0681818181818182;0.431818181818182
Control.SRR15539829;40;45;0.425;23;17;0.075;0.425
Control.SRR15539829;41;45;0.536585365853659;19;22;0.0365853658536586;0.463414634146341
Control.SRR15539829;51;45;0.509803921568627;25;26;0.00980392156862742;0.490196078431373
Control.SRR15539829;51;45;0.529411764705882;24;27;0.0294117647058824;0.470588235294118
Control.SRR15539829;45;45;0.4;27;18;0.1;0.4
Control.SRR15539829;42;45;0.476190476190476;22;20;0.0238095238095238;0.476190476190476
Control.SRR15539829;40;45;0.7;12;28;0.2;0.3
Control.SRR15539829;51;45;0.588235294117647;21;30;0.0882352941176471;0.411764705882353
Control.SRR15539829;42;45;0.5;21;21;0;0.5
Control.SRR15539829;46;45;0.478260869565217;24;22;0.0217391304347826;0.478260869565217
Control.SRR15539829;40;45;0.425;23;17;0.075;0.425
Control.SRR15539829;41;45;0.414634146341463;24;17;0.0853658536585366;0.414634146341463
Control.SRR15539829;47;45;0.638297872340426;17;30;0.138297872340426;0.361702127659574
Control.SRR15539829;40;45;0.65;14;26;0.15;0.35
Control.SRR15539829;50;45;0.32;34;16;0.18;0.32
Control.SRR15539829;43;45;0.418604651162791;25;18;0.0813953488372093;0.418604651162791
Control.SRR15539829;47;45;0.404255319148936;28;19;0.0957446808510639;0.404255319148936
Control.SRR15539829;42;45;0.428571428571429;24;18;0.0714285714285715;0.428571428571429
Control.SRR15539829;41;45;0.48780487804878;21;20;0.0121951219512195;0.48780487804878
Control.SRR15539829;45;45;0.555555555555556;20;25;0.0555555555555556;0.444444444444444
Control.SRR15539829;50;45;0.44;28;22;0.06;0.44
Control.SRR15539829;44;45;0.318181818181818;30;14;0.181818181818182;0.318181818181818
Control.SRR15539829;44;45;0.5;22;22;0;0.5
Control.SRR15539829;41;45;0.560975609756098;18;23;0.0609756097560976;0.439024390243902
Control.SRR15539829;39;45;0.461538461538462;21;18;0.0384615384615384;0.461538461538462
Control.SRR15539829;50;45;0.56;22;28;0.0600000000000001;0.44
Control.SRR15539829;43;45;0.558139534883721;19;24;0.0581395348837209;0.441860465116279
Control.SRR15539829;40;45;0.5;20;20;0;0.5
Control.SRR15539829;49;45;0.408163265306122;29;20;0.0918367346938775;0.408163265306122
Control.SRR15539829;42;45;0.428571428571429;24;18;0.0714285714285715;0.428571428571429
Control.SRR15539829;46;45;0.521739130434783;22;24;0.0217391304347826;0.478260869565217
Control.SRR15539829;44;45;0.477272727272727;23;21;0.0227272727272727;0.477272727272727
Control.SRR15539829;44;45;0.477272727272727;23;21;0.0227272727272727;0.477272727272727
Control.SRR15539829;48;45;0.520833333333333;23;25;0.0208333333333334;0.479166666666667
Control.SRR15539829;51;45;0.607843137254902;20;31;0.107843137254902;0.392156862745098
Control.SRR15539829;47;45;0.51063829787234;23;24;0.0106382978723404;0.48936170212766
Control.SRR15539829;42;45;0.476190476190476;22;20;0.0238095238095238;0.476190476190476
Control.SRR15539829;45;45;0.444444444444444;25;20;0.0555555555555556;0.444444444444444
Control.SRR15539829;43;45;0.465116279069767;23;20;0.0348837209302326;0.465116279069767
Control.SRR15539829;41;45;0.463414634146341;22;19;0.0365853658536585;0.463414634146341
Control.SRR15539829;41;45;0.439024390243902;23;18;0.0609756097560976;0.439024390243902
Control.SRR15539829;42;45;0.642857142857143;15;27;0.142857142857143;0.357142857142857
Control.SRR15539829;39;45;0.358974358974359;25;14;0.141025641025641;0.358974358974359
Control.SRR15539829;48;45;0.458333333333333;26;22;0.0416666666666667;0.458333333333333
Control.SRR15539829;44;45;0.431818181818182;25;19;0.0681818181818182;0.431818181818182
Control.SRR15539829;46;45;0.5;23;23;0;0.5
Control.SRR15539829;49;45;0.428571428571429;28;21;0.0714285714285715;0.428571428571429
Control.SRR15539829;50;45;0.52;24;26;0.02;0.48
Control.SRR15539829;48;45;0.479166666666667;25;23;0.0208333333333333;0.479166666666667
Control.SRR15539829;44;45;0.522727272727273;21;23;0.0227272727272727;0.477272727272727
Control.SRR15539829;43;45;0.418604651162791;25;18;0.0813953488372093;0.418604651162791
Control.SRR15539829;47;45;0.404255319148936;28;19;0.0957446808510639;0.404255319148936
Control.SRR15539829;49;45;0.408163265306122;29;20;0.0918367346938775;0.408163265306122
Control.SRR15539829;48;45;0.520833333333333;23;25;0.0208333333333334;0.479166666666667
Control.SRR15539829;47;45;0.51063829787234;23;24;0.0106382978723404;0.48936170212766
Control.SRR15539829;39;45;0.641025641025641;14;25;0.141025641025641;0.358974358974359
Control.SRR15539829;39;45;0.641025641025641;14;25;0.141025641025641;0.358974358974359
Control.SRR15539829;43;45;0.441860465116279;24;19;0.0581395348837209;0.441860465116279
Control.SRR15539829;50;45;0.38;31;19;0.12;0.38
Control.SRR15539829;45;45;0.466666666666667;24;21;0.0333333333333333;0.466666666666667
Control.SRR15539829;50;45;0.44;28;22;0.06;0.44
Control.SRR15539829;41;45;0.560975609756098;18;23;0.0609756097560976;0.439024390243902
Control.SRR15539829;51;45;0.549019607843137;23;28;0.0490196078431373;0.450980392156863
Control.SRR15539829;40;45;0.45;22;18;0.05;0.45
Control.SRR15539829;50;45;0.52;24;26;0.02;0.48
Control.SRR15539829;48;45;0.354166666666667;31;17;0.145833333333333;0.354166666666667
Control.SRR15539829;47;45;0.48936170212766;24;23;0.0106382978723404;0.48936170212766
Control.SRR15539829;50;45;0.44;28;22;0.06;0.44
Control.SRR15539829;43;45;0.465116279069767;23;20;0.0348837209302326;0.465116279069767
Control.SRR15539829;45;45;0.444444444444444;25;20;0.0555555555555556;0.444444444444444
Control.SRR15539829;43;45;0.534883720930233;20;23;0.0348837209302325;0.465116279069767
Control.SRR15539829;44;45;0.568181818181818;19;25;0.0681818181818182;0.431818181818182
Control.SRR15539829;42;45;0.5;21;21;0;0.5
Control.SRR15539829;48;45;0.458333333333333;26;22;0.0416666666666667;0.458333333333333
Control.SRR15539829;43;45;0.465116279069767;23;20;0.0348837209302326;0.465116279069767
Control.SRR15539829;45;45;0.511111111111111;22;23;0.0111111111111111;0.488888888888889
Control.SRR15539829;47;45;0.446808510638298;26;21;0.0531914893617021;0.446808510638298
Control.SRR15539829;39;45;0.487179487179487;20;19;0.0128205128205128;0.487179487179487
Control.SRR15539829;48;45;0.479166666666667;25;23;0.0208333333333333;0.479166666666667
Control.SRR15539829;39;45;0.435897435897436;22;17;0.0641025641025641;0.435897435897436
Control.SRR15539829;46;45;0.434782608695652;26;20;0.0652173913043478;0.434782608695652
Control.SRR15539829;47;45;0.531914893617021;22;25;0.0319148936170213;0.468085106382979
Control.SRR15539829;45;45;0.6;18;27;0.1;0.4
Control.SRR15539829;48;45;0.5;24;24;0;0.5
Control.SRR15539829;49;45;0.408163265306122;29;20;0.0918367346938775;0.408163265306122
Control.SRR15539829;44;45;0.431818181818182;25;19;0.0681818181818182;0.431818181818182
Control.SRR15539829;42;45;0.452380952380952;23;19;0.0476190476190476;0.452380952380952
Control.SRR15539829;41;45;0.536585365853659;19;22;0.0365853658536586;0.463414634146341
Control.SRR15539829;42;45;0.452380952380952;23;19;0.0476190476190476;0.452380952380952
Control.SRR15539829;44;45;0.545454545454545;20;24;0.0454545454545454;0.454545454545455
Control.SRR15539829;47;45;0.531914893617021;22;25;0.0319148936170213;0.468085106382979
Control.SRR15539829;40;45;0.525;19;21;0.025;0.475
Control.SRR15539829;49;45;0.571428571428571;21;28;0.0714285714285714;0.428571428571429
Control.SRR15539829;40;45;0.55;18;22;0.05;0.45
Control.SRR15539829;45;45;0.666666666666667;15;30;0.166666666666667;0.333333333333333
Control.SRR15539829;50;45;0.48;26;24;0.02;0.48
Control.SRR15539829;41;45;0.463414634146341;22;19;0.0365853658536585;0.463414634146341
Control.SRR15539829;50;45;0.62;19;31;0.12;0.38
Control.SRR15539829;39;45;0.461538461538462;21;18;0.0384615384615384;0.461538461538462
Control.SRR15539829;42;45;0.595238095238095;17;25;0.0952380952380952;0.404761904761905
Control.SRR15539829;51;45;0.470588235294118;27;24;0.0294117647058824;0.470588235294118
Control.SRR15539829;49;45;0.428571428571429;28;21;0.0714285714285715;0.428571428571429
Control.SRR15539829;39;45;0.512820512820513;19;20;0.0128205128205128;0.487179487179487
Control.SRR15539829;43;45;0.534883720930233;20;23;0.0348837209302325;0.465116279069767
Control.SRR15539829;46;45;0.5;23;23;0;0.5
Control.SRR15539829;44;45;0.409090909090909;26;18;0.0909090909090909;0.409090909090909
Control.SRR15539829;43;45;0.581395348837209;18;25;0.0813953488372093;0.418604651162791
Control.SRR15539829;45;45;0.488888888888889;23;22;0.0111111111111111;0.488888888888889
Control.SRR15539829;39;45;0.615384615384615;15;24;0.115384615384615;0.384615384615385
Control.SRR15539829;46;45;0.478260869565217;24;22;0.0217391304347826;0.478260869565217
Control.SRR15539829;45;45;0.511111111111111;22;23;0.0111111111111111;0.488888888888889
Control.SRR15539829;40;45;0.425;23;17;0.075;0.425
Control.SRR15539829;40;45;0.525;19;21;0.025;0.475
Control.SRR15539829;46;45;0.478260869565217;24;22;0.0217391304347826;0.478260869565217
Control.SRR15539829;42;45;0.452380952380952;23;19;0.0476190476190476;0.452380952380952
Control.SRR15539829;47;45;0.382978723404255;29;18;0.117021276595745;0.382978723404255
Control.SRR15539829;43;45;0.488372093023256;22;21;0.0116279069767442;0.488372093023256
Control.SRR15539829;44;45;0.477272727272727;23;21;0.0227272727272727;0.477272727272727
Control.SRR15539829;41;45;0.560975609756098;18;23;0.0609756097560976;0.439024390243902
Control.SRR15539829;43;45;0.581395348837209;18;25;0.0813953488372093;0.418604651162791
Control.SRR15539829;45;45;0.511111111111111;22;23;0.0111111111111111;0.488888888888889
Control.SRR15539829;43;45;0.441860465116279;24;19;0.0581395348837209;0.441860465116279
Control.SRR15539829;40;45;0.475;21;19;0.025;0.475
Control.SRR15539829;43;45;0.395348837209302;26;17;0.104651162790698;0.395348837209302
Control.SRR15539829;42;45;0.476190476190476;22;20;0.0238095238095238;0.476190476190476
Control.SRR15539829;40;45;0.525;19;21;0.025;0.475
Control.SRR15539829;48;45;0.541666666666667;22;26;0.0416666666666666;0.458333333333333
Control.SRR15539829;41;45;0.560975609756098;18;23;0.0609756097560976;0.439024390243902
Control.SRR15539829;39;45;0.538461538461538;18;21;0.0384615384615384;0.461538461538462
Control.SRR15539829;43;45;0.581395348837209;18;25;0.0813953488372093;0.418604651162791
Control.SRR15539829;43;45;0.441860465116279;24;19;0.0581395348837209;0.441860465116279
Control.SRR15539829;51;45;0.568627450980392;22;29;0.0686274509803921;0.431372549019608
Control.SRR15539829;43;45;0.465116279069767;23;20;0.0348837209302326;0.465116279069767
Control.SRR15539829;40;45;0.4;24;16;0.1;0.4
Control.SRR15539829;47;45;0.48936170212766;24;23;0.0106382978723404;0.48936170212766
Control.SRR15539829;42;45;0.547619047619048;19;23;0.0476190476190477;0.452380952380952
Control.SRR15539829;41;45;0.48780487804878;21;20;0.0121951219512195;0.48780487804878
Control.SRR15539829;48;45;0.479166666666667;25;23;0.0208333333333333;0.479166666666667
Control.SRR15539829;40;45;0.55;18;22;0.05;0.45
Control.SRR15539829;42;45;0.547619047619048;19;23;0.0476190476190477;0.452380952380952
Control.SRR15539829;44;45;0.545454545454545;20;24;0.0454545454545454;0.454545454545455
Control.SRR15539829;51;45;0.549019607843137;23;28;0.0490196078431373;0.450980392156863
Control.SRR15539829;43;45;0.627906976744186;16;27;0.127906976744186;0.372093023255814
Control.SRR15539829;42;45;0.476190476190476;22;20;0.0238095238095238;0.476190476190476
Control.SRR15539829;41;45;0.463414634146341;22;19;0.0365853658536585;0.463414634146341
Control.SRR15539829;45;45;0.4;27;18;0.1;0.4
Control.SRR15539829;47;45;0.553191489361702;21;26;0.0531914893617021;0.446808510638298
Control.SRR15539829;40;45;0.475;21;19;0.025;0.475
Control.SRR15539829;40;45;0.425;23;17;0.075;0.425
Control.SRR15539829;40;45;0.5;20;20;0;0.5
Control.SRR15539829;51;45;0.470588235294118;27;24;0.0294117647058824;0.470588235294118
Control.SRR15539829;45;45;0.444444444444444;25;20;0.0555555555555556;0.444444444444444
Control.SRR15539829;44;45;0.454545454545455;24;20;0.0454545454545455;0.454545454545455
Control.SRR15539829;39;45;0.435897435897436;22;17;0.0641025641025641;0.435897435897436
Control.SRR15539829;45;45;0.644444444444444;16;29;0.144444444444444;0.355555555555556
Control.SRR15539829;47;45;0.574468085106383;20;27;0.074468085106383;0.425531914893617
Control.SRR15539829;40;45;0.6;16;24;0.1;0.4
Control.SRR15539829;44;45;0.636363636363636;16;28;0.136363636363636;0.363636363636364
Control.SRR15539829;42;45;0.428571428571429;24;18;0.0714285714285715;0.428571428571429
Control.SRR15539829;48;45;0.520833333333333;23;25;0.0208333333333334;0.479166666666667
Control.SRR15539829;43;45;0.488372093023256;22;21;0.0116279069767442;0.488372093023256
Control.SRR15539829;40;45;0.5;20;20;0;0.5
Control.SRR15539829;42;45;0.476190476190476;22;20;0.0238095238095238;0.476190476190476
Control.SRR15539829;46;45;0.5;23;23;0;0.5
Control.SRR15539829;39;45;0.41025641025641;23;16;0.0897435897435898;0.41025641025641
Control.SRR15539829;42;45;0.547619047619048;19;23;0.0476190476190477;0.452380952380952
Control.SRR15539829;39;45;0.538461538461538;18;21;0.0384615384615384;0.461538461538462
Control.SRR15539829;44;45;0.454545454545455;24;20;0.0454545454545455;0.454545454545455
Control.SRR15539829;50;45;0.44;28;22;0.06;0.44
Control.SRR15539829;47;45;0.404255319148936;28;19;0.0957446808510639;0.404255319148936
Control.SRR15539829;39;45;0.487179487179487;20;19;0.0128205128205128;0.487179487179487
Control.SRR15539829;42;45;0.380952380952381;26;16;0.119047619047619;0.380952380952381
Control.SRR15539829;40;45;0.575;17;23;0.075;0.425
Control.SRR15539829;41;45;0.463414634146341;22;19;0.0365853658536585;0.463414634146341
Control.SRR15539829;40;45;0.475;21;19;0.025;0.475
Control.SRR15539829;47;45;0.531914893617021;22;25;0.0319148936170213;0.468085106382979
Control.SRR15539829;40;45;0.6;16;24;0.1;0.4
Control.SRR15539829;50;45;0.4;30;20;0.1;0.4
Control.SRR15539829;45;45;0.377777777777778;28;17;0.122222222222222;0.377777777777778
Control.SRR15539829;47;45;0.382978723404255;29;18;0.117021276595745;0.382978723404255
Control.SRR15539829;46;45;0.521739130434783;22;24;0.0217391304347826;0.478260869565217
Control.SRR15539829;49;45;0.673469387755102;16;33;0.173469387755102;0.326530612244898
Control.SRR15539829;45;45;0.444444444444444;25;20;0.0555555555555556;0.444444444444444
Control.SRR15539829;49;45;0.408163265306122;29;20;0.0918367346938775;0.408163265306122
Control.SRR15539829;43;45;0.604651162790698;17;26;0.104651162790698;0.395348837209302
Control.SRR15539829;49;45;0.510204081632653;24;25;0.0102040816326531;0.489795918367347
Control.SRR15539829;47;45;0.446808510638298;26;21;0.0531914893617021;0.446808510638298
Control.SRR15539829;50;45;0.48;26;24;0.02;0.48
Control.SRR15539829;41;45;0.609756097560976;16;25;0.109756097560976;0.390243902439024
Control.SRR15539829;42;45;0.476190476190476;22;20;0.0238095238095238;0.476190476190476
Control.SRR15539829;43;45;0.465116279069767;23;20;0.0348837209302326;0.465116279069767
Control.SRR15539829;47;45;0.574468085106383;20;27;0.074468085106383;0.425531914893617
Control.SRR15539829;48;45;0.541666666666667;22;26;0.0416666666666666;0.458333333333333
Control.SRR15539829;41;45;0.48780487804878;21;20;0.0121951219512195;0.48780487804878
Control.SRR15539829;45;45;0.4;27;18;0.1;0.4
Control.SRR15539829;40;45;0.45;22;18;0.05;0.45
Control.SRR15539829;39;45;0.461538461538462;21;18;0.0384615384615384;0.461538461538462
Control.SRR15539829;41;45;0.48780487804878;21;20;0.0121951219512195;0.48780487804878
Control.SRR15539829;39;45;0.512820512820513;19;20;0.0128205128205128;0.487179487179487
Control.SRR15539829;43;45;0.534883720930233;20;23;0.0348837209302325;0.465116279069767
Control.SRR15539829;49;45;0.551020408163265;22;27;0.0510204081632653;0.448979591836735
Control.SRR15539829;43;45;0.488372093023256;22;21;0.0116279069767442;0.488372093023256
Control.SRR15539829;45;45;0.422222222222222;26;19;0.0777777777777778;0.422222222222222
Control.SRR15539829;42;45;0.523809523809524;20;22;0.0238095238095238;0.476190476190476
Control.SRR15539829;41;45;0.51219512195122;20;21;0.0121951219512195;0.48780487804878
Control.SRR15539829;43;45;0.674418604651163;14;29;0.174418604651163;0.325581395348837
Control.SRR15539829;46;45;0.456521739130435;25;21;0.0434782608695652;0.456521739130435
Control.SRR15539829;44;45;0.477272727272727;23;21;0.0227272727272727;0.477272727272727
Control.SRR15539829;41;45;0.51219512195122;20;21;0.0121951219512195;0.48780487804878
Control.SRR15539829;41;45;0.463414634146341;22;19;0.0365853658536585;0.463414634146341
Control.SRR15539829;45;45;0.533333333333333;21;24;0.0333333333333333;0.466666666666667
Control.SRR15539829;44;45;0.545454545454545;20;24;0.0454545454545454;0.454545454545455
Control.SRR15539829;51;45;0.568627450980392;22;29;0.0686274509803921;0.431372549019608
Control.SRR15539829;41;45;0.48780487804878;21;20;0.0121951219512195;0.48780487804878
Control.SRR15539829;47;45;0.382978723404255;29;18;0.117021276595745;0.382978723404255
Control.SRR15539829;48;45;0.4375;27;21;0.0625;0.4375
Control.SRR15539829;48;45;0.5625;21;27;0.0625;0.4375
Control.SRR15539829;40;45;0.55;18;22;0.05;0.45
Control.SRR15539829;39;45;0.512820512820513;19;20;0.0128205128205128;0.487179487179487
Control.SRR15539829;44;45;0.522727272727273;21;23;0.0227272727272727;0.477272727272727
Control.SRR15539829;39;45;0.384615384615385;24;15;0.115384615384615;0.384615384615385
Control.SRR15539829;48;45;0.4375;27;21;0.0625;0.4375
Control.SRR15539829;48;45;0.5625;21;27;0.0625;0.4375
Control.SRR15539829;44;45;0.568181818181818;19;25;0.0681818181818182;0.431818181818182
Control.SRR15539829;43;45;0.255813953488372;32;11;0.244186046511628;0.255813953488372
Control.SRR15539829;42;45;0.595238095238095;17;25;0.0952380952380952;0.404761904761905
Control.SRR15539829;40;45;0.425;23;17;0.075;0.425
Control.SRR15539829;46;45;0.434782608695652;26;20;0.0652173913043478;0.434782608695652
Control.SRR15539829;40;45;0.475;21;19;0.025;0.475
Control.SRR15539829;40;45;0.425;23;17;0.075;0.425
Control.SRR15539829;40;45;0.675;13;27;0.175;0.325
Control.SRR15539829;39;45;0.538461538461538;18;21;0.0384615384615384;0.461538461538462
Control.SRR15539829;43;45;0.465116279069767;23;20;0.0348837209302326;0.465116279069767
Control.SRR15539829;42;45;0.571428571428571;18;24;0.0714285714285714;0.428571428571429
Control.SRR15539829;45;45;0.622222222222222;17;28;0.122222222222222;0.377777777777778
Control.SRR15539829;48;45;0.520833333333333;23;25;0.0208333333333334;0.479166666666667
Control.SRR15539829;45;45;0.422222222222222;26;19;0.0777777777777778;0.422222222222222
Control.SRR15539829;48;45;0.375;30;18;0.125;0.375
Control.SRR15539829;48;45;0.5;24;24;0;0.5
Control.SRR15539829;41;45;0.48780487804878;21;20;0.0121951219512195;0.48780487804878
Control.SRR15539829;49;45;0.591836734693878;20;29;0.0918367346938775;0.408163265306122
Control.SRR15539829;47;45;0.48936170212766;24;23;0.0106382978723404;0.48936170212766
Control.SRR15539829;43;45;0.488372093023256;22;21;0.0116279069767442;0.488372093023256
Control.SRR15539829;46;45;0.456521739130435;25;21;0.0434782608695652;0.456521739130435
Control.SRR15539829;44;45;0.409090909090909;26;18;0.0909090909090909;0.409090909090909
Control.SRR15539829;41;45;0.414634146341463;24;17;0.0853658536585366;0.414634146341463
Control.SRR15539829;47;45;0.51063829787234;23;24;0.0106382978723404;0.48936170212766
Control.SRR15539829;47;45;0.468085106382979;25;22;0.0319148936170213;0.468085106382979
Control.SRR15539829;42;45;0.619047619047619;16;26;0.119047619047619;0.380952380952381
Control.SRR15539829;47;45;0.404255319148936;28;19;0.0957446808510639;0.404255319148936
Control.SRR15539829;51;45;0.372549019607843;32;19;0.127450980392157;0.372549019607843
Control.SRR15539829;49;45;0.693877551020408;15;34;0.193877551020408;0.306122448979592
Control.SRR15539829;44;45;0.318181818181818;30;14;0.181818181818182;0.318181818181818
Control.SRR15539829;40;45;0.5;20;20;0;0.5
Control.SRR15539829;48;45;0.375;30;18;0.125;0.375
Control.SRR15539829;39;45;0.538461538461538;18;21;0.0384615384615384;0.461538461538462
Control.SRR15539829;47;45;0.425531914893617;27;20;0.074468085106383;0.425531914893617
Control.SRR15539829;48;45;0.5;24;24;0;0.5
Control.SRR15539829;39;45;0.41025641025641;23;16;0.0897435897435898;0.41025641025641
Control.SRR15539829;42;45;0.547619047619048;19;23;0.0476190476190477;0.452380952380952
Control.SRR15539829;46;45;0.565217391304348;20;26;0.0652173913043478;0.434782608695652
Control.SRR15539829;46;45;0.521739130434783;22;24;0.0217391304347826;0.478260869565217
Control.SRR15539829;45;45;0.488888888888889;23;22;0.0111111111111111;0.488888888888889
Control.SRR15539829;44;45;0.477272727272727;23;21;0.0227272727272727;0.477272727272727
Control.SRR15539829;41;45;0.585365853658537;17;24;0.0853658536585366;0.414634146341463
Control.SRR15539829;40;45;0.55;18;22;0.05;0.45
Control.SRR15539829;45;45;0.422222222222222;26;19;0.0777777777777778;0.422222222222222
Control.SRR15539829;46;45;0.391304347826087;28;18;0.108695652173913;0.391304347826087
Control.SRR15539829;45;45;0.711111111111111;13;32;0.211111111111111;0.288888888888889
Control.SRR15539829;49;45;0.510204081632653;24;25;0.0102040816326531;0.489795918367347
Control.SRR15539829;49;45;0.489795918367347;25;24;0.0102040816326531;0.489795918367347
Control.SRR15539829;40;45;0.375;25;15;0.125;0.375
Control.SRR15539829;50;45;0.5;25;25;0;0.5
Control.SRR15539829;46;45;0.41304347826087;27;19;0.0869565217391304;0.41304347826087
Control.SRR15539829;47;45;0.340425531914894;31;16;0.159574468085106;0.340425531914894
Control.SRR15539829;43;45;0.395348837209302;26;17;0.104651162790698;0.395348837209302
Control.SRR15539829;42;45;0.380952380952381;26;16;0.119047619047619;0.380952380952381
Control.SRR15539829;40;45;0.525;19;21;0.025;0.475
Control.SRR15539829;40;45;0.4;24;16;0.1;0.4
Control.SRR15539829;45;45;0.377777777777778;28;17;0.122222222222222;0.377777777777778
Control.SRR15539829;41;45;0.585365853658537;17;24;0.0853658536585366;0.414634146341463
Control.SRR15539829;43;45;0.418604651162791;25;18;0.0813953488372093;0.418604651162791
Control.SRR15539829;45;45;0.4;27;18;0.1;0.4
Control.SRR15539829;40;45;0.6;16;24;0.1;0.4
Control.SRR15539829;45;45;0.511111111111111;22;23;0.0111111111111111;0.488888888888889
Control.SRR15539829;47;45;0.382978723404255;29;18;0.117021276595745;0.382978723404255
Control.SRR15539829;50;45;0.42;29;21;0.08;0.42
Control.SRR15539829;45;45;0.533333333333333;21;24;0.0333333333333333;0.466666666666667
Control.SRR15539829;47;45;0.468085106382979;25;22;0.0319148936170213;0.468085106382979
Control.SRR15539829;51;45;0.529411764705882;24;27;0.0294117647058824;0.470588235294118
Control.SRR15539829;46;45;0.5;23;23;0;0.5
Control.SRR15539829;49;45;0.428571428571429;28;21;0.0714285714285715;0.428571428571429
Control.SRR15539829;44;45;0.454545454545455;24;20;0.0454545454545455;0.454545454545455
Control.SRR15539829;49;45;0.551020408163265;22;27;0.0510204081632653;0.448979591836735
Control.SRR15539829;47;45;0.553191489361702;21;26;0.0531914893617021;0.446808510638298
Control.SRR15539829;43;45;0.558139534883721;19;24;0.0581395348837209;0.441860465116279
Control.SRR15539829;40;45;0.675;13;27;0.175;0.325
Control.SRR15539829;45;45;0.422222222222222;26;19;0.0777777777777778;0.422222222222222
Control.SRR15539829;48;45;0.541666666666667;22;26;0.0416666666666666;0.458333333333333
Control.SRR15539829;49;45;0.63265306122449;18;31;0.13265306122449;0.36734693877551
Control.SRR15539829;44;45;0.431818181818182;25;19;0.0681818181818182;0.431818181818182
Control.SRR15539829;43;45;0.418604651162791;25;18;0.0813953488372093;0.418604651162791
Control.SRR15539829;48;45;0.583333333333333;20;28;0.0833333333333334;0.416666666666667
Control.SRR15539829;51;45;0.568627450980392;22;29;0.0686274509803921;0.431372549019608
Control.SRR15539829;49;45;0.469387755102041;26;23;0.0306122448979592;0.469387755102041
Control.SRR15539829;42;45;0.5;21;21;0;0.5
Control.SRR15539829;47;45;0.48936170212766;24;23;0.0106382978723404;0.48936170212766
Control.SRR15539829;48;45;0.458333333333333;26;22;0.0416666666666667;0.458333333333333
Control.SRR15539829;50;45;0.64;18;32;0.14;0.36
Control.SRR15539829;41;45;0.463414634146341;22;19;0.0365853658536585;0.463414634146341
Control.SRR15539829;45;45;0.555555555555556;20;25;0.0555555555555556;0.444444444444444
