Sample;coverage;median_coverage;ALTF;RDR;RDA;Complexity;MAF
Control.SRR15539824;40;40;0.45;22;18;0.05;0.45
Control.SRR15539824;44;40;0.590909090909091;18;26;0.0909090909090909;0.409090909090909
Control.SRR15539824;44;40;0.477272727272727;23;21;0.0227272727272727;0.477272727272727
Control.SRR15539824;43;40;0.348837209302326;28;15;0.151162790697674;0.348837209302326
Control.SRR15539824;44;40;0.477272727272727;23;21;0.0227272727272727;0.477272727272727
Control.SRR15539824;39;40;0.538461538461538;18;21;0.0384615384615384;0.461538461538462
Control.SRR15539824;44;40;0.568181818181818;19;25;0.0681818181818182;0.431818181818182
Control.SRR15539824;39;40;0.538461538461538;18;21;0.0384615384615384;0.461538461538462
Control.SRR15539824;42;40;0.523809523809524;20;22;0.0238095238095238;0.476190476190476
Control.SRR15539824;35;40;0.628571428571429;13;22;0.128571428571429;0.371428571428571
Control.SRR15539824;39;40;0.435897435897436;22;17;0.0641025641025641;0.435897435897436
Control.SRR15539824;40;40;0.675;13;27;0.175;0.325
Control.SRR15539824;44;40;0.454545454545455;24;20;0.0454545454545455;0.454545454545455
Control.SRR15539824;41;40;0.585365853658537;17;24;0.0853658536585366;0.414634146341463
Control.SRR15539824;43;40;0.604651162790698;17;26;0.104651162790698;0.395348837209302
Control.SRR15539824;36;40;0.666666666666667;12;24;0.166666666666667;0.333333333333333
Control.SRR15539824;41;40;0.536585365853659;19;22;0.0365853658536586;0.463414634146341
Control.SRR15539824;36;40;0.472222222222222;19;17;0.0277777777777778;0.472222222222222
Control.SRR15539824;41;40;0.48780487804878;21;20;0.0121951219512195;0.48780487804878
Control.SRR15539824;43;40;0.488372093023256;22;21;0.0116279069767442;0.488372093023256
Control.SRR15539824;39;40;0.512820512820513;19;20;0.0128205128205128;0.487179487179487
Control.SRR15539824;41;40;0.536585365853659;19;22;0.0365853658536586;0.463414634146341
Control.SRR15539824;37;40;0.459459459459459;20;17;0.0405405405405405;0.459459459459459
Control.SRR15539824;38;40;0.421052631578947;22;16;0.0789473684210527;0.421052631578947
Control.SRR15539824;45;40;0.533333333333333;21;24;0.0333333333333333;0.466666666666667
Control.SRR15539824;35;40;0.514285714285714;17;18;0.0142857142857142;0.485714285714286
Control.SRR15539824;45;40;0.466666666666667;24;21;0.0333333333333333;0.466666666666667
Control.SRR15539824;44;40;0.590909090909091;18;26;0.0909090909090909;0.409090909090909
Control.SRR15539824;42;40;0.595238095238095;17;25;0.0952380952380952;0.404761904761905
Control.SRR15539824;44;40;0.636363636363636;16;28;0.136363636363636;0.363636363636364
Control.SRR15539824;41;40;0.365853658536585;26;15;0.134146341463415;0.365853658536585
Control.SRR15539824;41;40;0.48780487804878;21;20;0.0121951219512195;0.48780487804878
Control.SRR15539824;35;40;0.485714285714286;18;17;0.0142857142857143;0.485714285714286
Control.SRR15539824;39;40;0.538461538461538;18;21;0.0384615384615384;0.461538461538462
Control.SRR15539824;41;40;0.439024390243902;23;18;0.0609756097560976;0.439024390243902
Control.SRR15539824;45;40;0.422222222222222;26;19;0.0777777777777778;0.422222222222222
Control.SRR15539824;41;40;0.585365853658537;17;24;0.0853658536585366;0.414634146341463
Control.SRR15539824;43;40;0.558139534883721;19;24;0.0581395348837209;0.441860465116279
Control.SRR15539824;36;40;0.5;18;18;0;0.5
Control.SRR15539824;43;40;0.534883720930233;20;23;0.0348837209302325;0.465116279069767
Control.SRR15539824;38;40;0.421052631578947;22;16;0.0789473684210527;0.421052631578947
Control.SRR15539824;43;40;0.465116279069767;23;20;0.0348837209302326;0.465116279069767
Control.SRR15539824;36;40;0.611111111111111;14;22;0.111111111111111;0.388888888888889
Control.SRR15539824;42;40;0.666666666666667;14;28;0.166666666666667;0.333333333333333
Control.SRR15539824;41;40;0.585365853658537;17;24;0.0853658536585366;0.414634146341463
Control.SRR15539824;43;40;0.488372093023256;22;21;0.0116279069767442;0.488372093023256
Control.SRR15539824;39;40;0.538461538461538;18;21;0.0384615384615384;0.461538461538462
Control.SRR15539824;42;40;0.452380952380952;23;19;0.0476190476190476;0.452380952380952
Control.SRR15539824;42;40;0.476190476190476;22;20;0.0238095238095238;0.476190476190476
Control.SRR15539824;35;40;0.657142857142857;12;23;0.157142857142857;0.342857142857143
Control.SRR15539824;37;40;0.567567567567568;16;21;0.0675675675675675;0.432432432432432
Control.SRR15539824;42;40;0.547619047619048;19;23;0.0476190476190477;0.452380952380952
Control.SRR15539824;45;40;0.466666666666667;24;21;0.0333333333333333;0.466666666666667
Control.SRR15539824;36;40;0.361111111111111;23;13;0.138888888888889;0.361111111111111
Control.SRR15539824;39;40;0.538461538461538;18;21;0.0384615384615384;0.461538461538462
Control.SRR15539824;35;40;0.6;14;21;0.1;0.4
Control.SRR15539824;42;40;0.428571428571429;24;18;0.0714285714285715;0.428571428571429
Control.SRR15539824;40;40;0.475;21;19;0.025;0.475
Control.SRR15539824;44;40;0.613636363636364;17;27;0.113636363636364;0.386363636363636
Control.SRR15539824;41;40;0.463414634146341;22;19;0.0365853658536585;0.463414634146341
Control.SRR15539824;42;40;0.547619047619048;19;23;0.0476190476190477;0.452380952380952
Control.SRR15539824;40;40;0.675;13;27;0.175;0.325
Control.SRR15539824;42;40;0.452380952380952;23;19;0.0476190476190476;0.452380952380952
Control.SRR15539824;41;40;0.560975609756098;18;23;0.0609756097560976;0.439024390243902
Control.SRR15539824;37;40;0.459459459459459;20;17;0.0405405405405405;0.459459459459459
Control.SRR15539824;40;40;0.55;18;22;0.05;0.45
Control.SRR15539824;45;40;0.533333333333333;21;24;0.0333333333333333;0.466666666666667
Control.SRR15539824;44;40;0.454545454545455;24;20;0.0454545454545455;0.454545454545455
Control.SRR15539824;41;40;0.48780487804878;21;20;0.0121951219512195;0.48780487804878
Control.SRR15539824;42;40;0.5;21;21;0;0.5
Control.SRR15539824;38;40;0.578947368421053;16;22;0.0789473684210527;0.421052631578947
Control.SRR15539824;40;40;0.625;15;25;0.125;0.375
Control.SRR15539824;37;40;0.486486486486487;19;18;0.0135135135135135;0.486486486486487
Control.SRR15539824;44;40;0.454545454545455;24;20;0.0454545454545455;0.454545454545455
Control.SRR15539824;38;40;0.421052631578947;22;16;0.0789473684210527;0.421052631578947
Control.SRR15539824;37;40;0.486486486486487;19;18;0.0135135135135135;0.486486486486487
Control.SRR15539824;40;40;0.4;24;16;0.1;0.4
Control.SRR15539824;41;40;0.585365853658537;17;24;0.0853658536585366;0.414634146341463
Control.SRR15539824;45;40;0.466666666666667;24;21;0.0333333333333333;0.466666666666667
Control.SRR15539824;43;40;0.511627906976744;21;22;0.0116279069767442;0.488372093023256
Control.SRR15539824;40;40;0.55;18;22;0.05;0.45
Control.SRR15539824;44;40;0.545454545454545;20;24;0.0454545454545454;0.454545454545455
Control.SRR15539824;42;40;0.476190476190476;22;20;0.0238095238095238;0.476190476190476
Control.SRR15539824;39;40;0.512820512820513;19;20;0.0128205128205128;0.487179487179487
Control.SRR15539824;44;40;0.590909090909091;18;26;0.0909090909090909;0.409090909090909
Control.SRR15539824;42;40;0.523809523809524;20;22;0.0238095238095238;0.476190476190476
Control.SRR15539824;41;40;0.414634146341463;24;17;0.0853658536585366;0.414634146341463
Control.SRR15539824;39;40;0.307692307692308;27;12;0.192307692307692;0.307692307692308
Control.SRR15539824;39;40;0.461538461538462;21;18;0.0384615384615384;0.461538461538462
Control.SRR15539824;42;40;0.523809523809524;20;22;0.0238095238095238;0.476190476190476
Control.SRR15539824;35;40;0.657142857142857;12;23;0.157142857142857;0.342857142857143
Control.SRR15539824;40;40;0.45;22;18;0.05;0.45
Control.SRR15539824;41;40;0.634146341463415;15;26;0.134146341463415;0.365853658536585
Control.SRR15539824;45;40;0.444444444444444;25;20;0.0555555555555556;0.444444444444444
Control.SRR15539824;44;40;0.522727272727273;21;23;0.0227272727272727;0.477272727272727
Control.SRR15539824;38;40;0.394736842105263;23;15;0.105263157894737;0.394736842105263
Control.SRR15539824;41;40;0.560975609756098;18;23;0.0609756097560976;0.439024390243902
Control.SRR15539824;35;40;0.628571428571429;13;22;0.128571428571429;0.371428571428571
Control.SRR15539824;35;40;0.4;21;14;0.1;0.4
Control.SRR15539824;36;40;0.472222222222222;19;17;0.0277777777777778;0.472222222222222
Control.SRR15539824;39;40;0.538461538461538;18;21;0.0384615384615384;0.461538461538462
Control.SRR15539824;37;40;0.648648648648649;13;24;0.148648648648649;0.351351351351351
Control.SRR15539824;36;40;0.5;18;18;0;0.5
Control.SRR15539824;35;40;0.657142857142857;12;23;0.157142857142857;0.342857142857143
Control.SRR15539824;36;40;0.555555555555556;16;20;0.0555555555555556;0.444444444444444
Control.SRR15539824;40;40;0.5;20;20;0;0.5
Control.SRR15539824;43;40;0.488372093023256;22;21;0.0116279069767442;0.488372093023256
Control.SRR15539824;40;40;0.425;23;17;0.075;0.425
Control.SRR15539824;41;40;0.48780487804878;21;20;0.0121951219512195;0.48780487804878
Control.SRR15539824;40;40;0.575;17;23;0.075;0.425
Control.SRR15539824;36;40;0.5;18;18;0;0.5
Control.SRR15539824;38;40;0.263157894736842;28;10;0.236842105263158;0.263157894736842
Control.SRR15539824;42;40;0.428571428571429;24;18;0.0714285714285715;0.428571428571429
Control.SRR15539824;42;40;0.476190476190476;22;20;0.0238095238095238;0.476190476190476
Control.SRR15539824;44;40;0.5;22;22;0;0.5
Control.SRR15539824;41;40;0.51219512195122;20;21;0.0121951219512195;0.48780487804878
Control.SRR15539824;44;40;0.545454545454545;20;24;0.0454545454545454;0.454545454545455
Control.SRR15539824;37;40;0.513513513513513;18;19;0.0135135135135135;0.486486486486487
Control.SRR15539824;40;40;0.55;18;22;0.05;0.45
Control.SRR15539824;35;40;0.457142857142857;19;16;0.0428571428571429;0.457142857142857
Control.SRR15539824;39;40;0.538461538461538;18;21;0.0384615384615384;0.461538461538462
Control.SRR15539824;41;40;0.658536585365854;14;27;0.158536585365854;0.341463414634146
Control.SRR15539824;36;40;0.472222222222222;19;17;0.0277777777777778;0.472222222222222
Control.SRR15539824;35;40;0.514285714285714;17;18;0.0142857142857142;0.485714285714286
Control.SRR15539824;36;40;0.388888888888889;22;14;0.111111111111111;0.388888888888889
Control.SRR15539824;40;40;0.7;12;28;0.2;0.3
Control.SRR15539824;41;40;0.634146341463415;15;26;0.134146341463415;0.365853658536585
Control.SRR15539824;37;40;0.459459459459459;20;17;0.0405405405405405;0.459459459459459
Control.SRR15539824;39;40;0.461538461538462;21;18;0.0384615384615384;0.461538461538462
Control.SRR15539824;42;40;0.5;21;21;0;0.5
Control.SRR15539824;36;40;0.388888888888889;22;14;0.111111111111111;0.388888888888889
Control.SRR15539824;43;40;0.558139534883721;19;24;0.0581395348837209;0.441860465116279
Control.SRR15539824;35;40;0.428571428571429;20;15;0.0714285714285715;0.428571428571429
Control.SRR15539824;39;40;0.564102564102564;17;22;0.0641025641025641;0.435897435897436
Control.SRR15539824;38;40;0.526315789473684;18;20;0.0263157894736842;0.473684210526316
Control.SRR15539824;38;40;0.578947368421053;16;22;0.0789473684210527;0.421052631578947
Control.SRR15539824;36;40;0.5;18;18;0;0.5
Control.SRR15539824;38;40;0.473684210526316;20;18;0.0263157894736842;0.473684210526316
Control.SRR15539824;38;40;0.605263157894737;15;23;0.105263157894737;0.394736842105263
Control.SRR15539824;38;40;0.631578947368421;14;24;0.131578947368421;0.368421052631579
Control.SRR15539824;38;40;0.5;19;19;0;0.5
Control.SRR15539824;40;40;0.45;22;18;0.05;0.45
Control.SRR15539824;43;40;0.511627906976744;21;22;0.0116279069767442;0.488372093023256
Control.SRR15539824;37;40;0.459459459459459;20;17;0.0405405405405405;0.459459459459459
Control.SRR15539824;37;40;0.432432432432432;21;16;0.0675675675675675;0.432432432432432
Control.SRR15539824;37;40;0.486486486486487;19;18;0.0135135135135135;0.486486486486487
Control.SRR15539824;40;40;0.375;25;15;0.125;0.375
Control.SRR15539824;39;40;0.512820512820513;19;20;0.0128205128205128;0.487179487179487
Control.SRR15539824;38;40;0.526315789473684;18;20;0.0263157894736842;0.473684210526316
Control.SRR15539824;35;40;0.4;21;14;0.1;0.4
Control.SRR15539824;42;40;0.595238095238095;17;25;0.0952380952380952;0.404761904761905
Control.SRR15539824;43;40;0.441860465116279;24;19;0.0581395348837209;0.441860465116279
Control.SRR15539824;44;40;0.522727272727273;21;23;0.0227272727272727;0.477272727272727
Control.SRR15539824;38;40;0.631578947368421;14;24;0.131578947368421;0.368421052631579
Control.SRR15539824;38;40;0.368421052631579;24;14;0.131578947368421;0.368421052631579
Control.SRR15539824;41;40;0.536585365853659;19;22;0.0365853658536586;0.463414634146341
Control.SRR15539824;41;40;0.536585365853659;19;22;0.0365853658536586;0.463414634146341
Control.SRR15539824;35;40;0.657142857142857;12;23;0.157142857142857;0.342857142857143
Control.SRR15539824;38;40;0.578947368421053;16;22;0.0789473684210527;0.421052631578947
Control.SRR15539824;36;40;0.416666666666667;21;15;0.0833333333333333;0.416666666666667
Control.SRR15539824;37;40;0.540540540540541;17;20;0.0405405405405406;0.459459459459459
Control.SRR15539824;38;40;0.578947368421053;16;22;0.0789473684210527;0.421052631578947
Control.SRR15539824;37;40;0.621621621621622;14;23;0.121621621621622;0.378378378378378
Control.SRR15539824;40;40;0.525;19;21;0.025;0.475
Control.SRR15539824;43;40;0.558139534883721;19;24;0.0581395348837209;0.441860465116279
Control.SRR15539824;43;40;0.511627906976744;21;22;0.0116279069767442;0.488372093023256
Control.SRR15539824;40;40;0.45;22;18;0.05;0.45
Control.SRR15539824;41;40;0.414634146341463;24;17;0.0853658536585366;0.414634146341463
Control.SRR15539824;45;40;0.622222222222222;17;28;0.122222222222222;0.377777777777778
Control.SRR15539824;36;40;0.555555555555556;16;20;0.0555555555555556;0.444444444444444
Control.SRR15539824;44;40;0.454545454545455;24;20;0.0454545454545455;0.454545454545455
Control.SRR15539824;36;40;0.361111111111111;23;13;0.138888888888889;0.361111111111111
Control.SRR15539824;42;40;0.595238095238095;17;25;0.0952380952380952;0.404761904761905
Control.SRR15539824;37;40;0.513513513513513;18;19;0.0135135135135135;0.486486486486487
Control.SRR15539824;38;40;0.526315789473684;18;20;0.0263157894736842;0.473684210526316
Control.SRR15539824;44;40;0.568181818181818;19;25;0.0681818181818182;0.431818181818182
Control.SRR15539824;38;40;0.631578947368421;14;24;0.131578947368421;0.368421052631579
Control.SRR15539824;43;40;0.534883720930233;20;23;0.0348837209302325;0.465116279069767
Control.SRR15539824;35;40;0.542857142857143;16;19;0.0428571428571428;0.457142857142857
Control.SRR15539824;44;40;0.613636363636364;17;27;0.113636363636364;0.386363636363636
Control.SRR15539824;40;40;0.45;22;18;0.05;0.45
Control.SRR15539824;35;40;0.514285714285714;17;18;0.0142857142857142;0.485714285714286
Control.SRR15539824;43;40;0.465116279069767;23;20;0.0348837209302326;0.465116279069767
Control.SRR15539824;37;40;0.675675675675676;12;25;0.175675675675676;0.324324324324324
Control.SRR15539824;42;40;0.476190476190476;22;20;0.0238095238095238;0.476190476190476
Control.SRR15539824;40;40;0.425;23;17;0.075;0.425
Control.SRR15539824;40;40;0.425;23;17;0.075;0.425
Control.SRR15539824;39;40;0.41025641025641;23;16;0.0897435897435898;0.41025641025641
Control.SRR15539824;42;40;0.476190476190476;22;20;0.0238095238095238;0.476190476190476
Control.SRR15539824;44;40;0.522727272727273;21;23;0.0227272727272727;0.477272727272727
Control.SRR15539824;42;40;0.523809523809524;20;22;0.0238095238095238;0.476190476190476
Control.SRR15539824;41;40;0.439024390243902;23;18;0.0609756097560976;0.439024390243902
Control.SRR15539824;44;40;0.386363636363636;27;17;0.113636363636364;0.386363636363636
Control.SRR15539824;44;40;0.431818181818182;25;19;0.0681818181818182;0.431818181818182
Control.SRR15539824;37;40;0.621621621621622;14;23;0.121621621621622;0.378378378378378
Control.SRR15539824;39;40;0.41025641025641;23;16;0.0897435897435898;0.41025641025641
Control.SRR15539824;36;40;0.555555555555556;16;20;0.0555555555555556;0.444444444444444
Control.SRR15539824;44;40;0.409090909090909;26;18;0.0909090909090909;0.409090909090909
Control.SRR15539824;41;40;0.536585365853659;19;22;0.0365853658536586;0.463414634146341
Control.SRR15539824;44;40;0.431818181818182;25;19;0.0681818181818182;0.431818181818182
Control.SRR15539824;41;40;0.439024390243902;23;18;0.0609756097560976;0.439024390243902
Control.SRR15539824;38;40;0.421052631578947;22;16;0.0789473684210527;0.421052631578947
Control.SRR15539824;41;40;0.48780487804878;21;20;0.0121951219512195;0.48780487804878
Control.SRR15539824;37;40;0.486486486486487;19;18;0.0135135135135135;0.486486486486487
Control.SRR15539824;41;40;0.536585365853659;19;22;0.0365853658536586;0.463414634146341
Control.SRR15539824;40;40;0.45;22;18;0.05;0.45
Control.SRR15539824;39;40;0.58974358974359;16;23;0.0897435897435898;0.41025641025641
Control.SRR15539824;37;40;0.405405405405405;22;15;0.0945945945945946;0.405405405405405
Control.SRR15539824;44;40;0.613636363636364;17;27;0.113636363636364;0.386363636363636
Control.SRR15539824;36;40;0.583333333333333;15;21;0.0833333333333334;0.416666666666667
Control.SRR15539824;35;40;0.457142857142857;19;16;0.0428571428571429;0.457142857142857
Control.SRR15539824;41;40;0.439024390243902;23;18;0.0609756097560976;0.439024390243902
Control.SRR15539824;44;40;0.477272727272727;23;21;0.0227272727272727;0.477272727272727
Control.SRR15539824;37;40;0.540540540540541;17;20;0.0405405405405406;0.459459459459459
Control.SRR15539824;40;40;0.425;23;17;0.075;0.425
Control.SRR15539824;40;40;0.55;18;22;0.05;0.45
Control.SRR15539824;38;40;0.631578947368421;14;24;0.131578947368421;0.368421052631579
Control.SRR15539824;40;40;0.375;25;15;0.125;0.375
Control.SRR15539824;45;40;0.422222222222222;26;19;0.0777777777777778;0.422222222222222
Control.SRR15539824;40;40;0.35;26;14;0.15;0.35
Control.SRR15539824;42;40;0.404761904761905;25;17;0.0952380952380952;0.404761904761905
Control.SRR15539824;45;40;0.511111111111111;22;23;0.0111111111111111;0.488888888888889
Control.SRR15539824;42;40;0.547619047619048;19;23;0.0476190476190477;0.452380952380952
Control.SRR15539824;35;40;0.6;14;21;0.1;0.4
Control.SRR15539824;35;40;0.4;21;14;0.1;0.4
Control.SRR15539824;36;40;0.611111111111111;14;22;0.111111111111111;0.388888888888889
Control.SRR15539824;37;40;0.540540540540541;17;20;0.0405405405405406;0.459459459459459
Control.SRR15539824;39;40;0.512820512820513;19;20;0.0128205128205128;0.487179487179487
Control.SRR15539824;44;40;0.477272727272727;23;21;0.0227272727272727;0.477272727272727
Control.SRR15539824;40;40;0.45;22;18;0.05;0.45
Control.SRR15539824;35;40;0.485714285714286;18;17;0.0142857142857143;0.485714285714286
Control.SRR15539824;42;40;0.452380952380952;23;19;0.0476190476190476;0.452380952380952
Control.SRR15539824;36;40;0.472222222222222;19;17;0.0277777777777778;0.472222222222222
Control.SRR15539824;45;40;0.622222222222222;17;28;0.122222222222222;0.377777777777778
Control.SRR15539824;44;40;0.568181818181818;19;25;0.0681818181818182;0.431818181818182
Control.SRR15539824;42;40;0.571428571428571;18;24;0.0714285714285714;0.428571428571429
Control.SRR15539824;35;40;0.542857142857143;16;19;0.0428571428571428;0.457142857142857
Control.SRR15539824;37;40;0.486486486486487;19;18;0.0135135135135135;0.486486486486487
Control.SRR15539824;40;40;0.65;14;26;0.15;0.35
Control.SRR15539824;39;40;0.538461538461538;18;21;0.0384615384615384;0.461538461538462
Control.SRR15539824;36;40;0.444444444444444;20;16;0.0555555555555556;0.444444444444444
Control.SRR15539824;40;40;0.375;25;15;0.125;0.375
Control.SRR15539824;36;40;0.416666666666667;21;15;0.0833333333333333;0.416666666666667
Control.SRR15539824;40;40;0.55;18;22;0.05;0.45
Control.SRR15539824;41;40;0.536585365853659;19;22;0.0365853658536586;0.463414634146341
Control.SRR15539824;39;40;0.487179487179487;20;19;0.0128205128205128;0.487179487179487
Control.SRR15539824;44;40;0.431818181818182;25;19;0.0681818181818182;0.431818181818182
Control.SRR15539824;39;40;0.692307692307692;12;27;0.192307692307692;0.307692307692308
Control.SRR15539824;40;40;0.5;20;20;0;0.5
Control.SRR15539824;42;40;0.5;21;21;0;0.5
Control.SRR15539824;43;40;0.488372093023256;22;21;0.0116279069767442;0.488372093023256
Control.SRR15539824;45;40;0.488888888888889;23;22;0.0111111111111111;0.488888888888889
Control.SRR15539824;44;40;0.590909090909091;18;26;0.0909090909090909;0.409090909090909
Control.SRR15539824;40;40;0.475;21;19;0.025;0.475
Control.SRR15539824;44;40;0.568181818181818;19;25;0.0681818181818182;0.431818181818182
Control.SRR15539824;41;40;0.560975609756098;18;23;0.0609756097560976;0.439024390243902
Control.SRR15539824;42;40;0.571428571428571;18;24;0.0714285714285714;0.428571428571429
Control.SRR15539824;45;40;0.422222222222222;26;19;0.0777777777777778;0.422222222222222
Control.SRR15539824;44;40;0.5;22;22;0;0.5
Control.SRR15539824;40;40;0.425;23;17;0.075;0.425
Control.SRR15539824;37;40;0.378378378378378;23;14;0.121621621621622;0.378378378378378
Control.SRR15539824;35;40;0.457142857142857;19;16;0.0428571428571429;0.457142857142857
Control.SRR15539824;35;40;0.485714285714286;18;17;0.0142857142857143;0.485714285714286
Control.SRR15539824;40;40;0.425;23;17;0.075;0.425
Control.SRR15539824;44;40;0.477272727272727;23;21;0.0227272727272727;0.477272727272727
Control.SRR15539824;38;40;0.578947368421053;16;22;0.0789473684210527;0.421052631578947
Control.SRR15539824;39;40;0.333333333333333;26;13;0.166666666666667;0.333333333333333
Control.SRR15539824;41;40;0.439024390243902;23;18;0.0609756097560976;0.439024390243902
Control.SRR15539824;40;40;0.6;16;24;0.1;0.4
Control.SRR15539824;41;40;0.536585365853659;19;22;0.0365853658536586;0.463414634146341
Control.SRR15539824;43;40;0.511627906976744;21;22;0.0116279069767442;0.488372093023256
Control.SRR15539824;43;40;0.558139534883721;19;24;0.0581395348837209;0.441860465116279
Control.SRR15539824;41;40;0.634146341463415;15;26;0.134146341463415;0.365853658536585
Control.SRR15539824;40;40;0.45;22;18;0.05;0.45
Control.SRR15539824;42;40;0.666666666666667;14;28;0.166666666666667;0.333333333333333
Control.SRR15539824;37;40;0.486486486486487;19;18;0.0135135135135135;0.486486486486487
Control.SRR15539824;41;40;0.51219512195122;20;21;0.0121951219512195;0.48780487804878
Control.SRR15539824;44;40;0.5;22;22;0;0.5
Control.SRR15539824;45;40;0.488888888888889;23;22;0.0111111111111111;0.488888888888889
Control.SRR15539824;40;40;0.45;22;18;0.05;0.45
Control.SRR15539824;41;40;0.341463414634146;27;14;0.158536585365854;0.341463414634146
Control.SRR15539824;36;40;0.444444444444444;20;16;0.0555555555555556;0.444444444444444
Control.SRR15539824;36;40;0.472222222222222;19;17;0.0277777777777778;0.472222222222222
Control.SRR15539824;38;40;0.447368421052632;21;17;0.0526315789473684;0.447368421052632
Control.SRR15539824;42;40;0.595238095238095;17;25;0.0952380952380952;0.404761904761905
Control.SRR15539824;40;40;0.45;22;18;0.05;0.45
Control.SRR15539824;44;40;0.568181818181818;19;25;0.0681818181818182;0.431818181818182
Control.SRR15539824;37;40;0.432432432432432;21;16;0.0675675675675675;0.432432432432432
Control.SRR15539824;42;40;0.547619047619048;19;23;0.0476190476190477;0.452380952380952
Control.SRR15539824;41;40;0.48780487804878;21;20;0.0121951219512195;0.48780487804878
Control.SRR15539824;39;40;0.615384615384615;15;24;0.115384615384615;0.384615384615385
Control.SRR15539824;41;40;0.414634146341463;24;17;0.0853658536585366;0.414634146341463
Control.SRR15539824;45;40;0.466666666666667;24;21;0.0333333333333333;0.466666666666667
Control.SRR15539824;40;40;0.45;22;18;0.05;0.45
Control.SRR15539824;39;40;0.512820512820513;19;20;0.0128205128205128;0.487179487179487
Control.SRR15539824;41;40;0.439024390243902;23;18;0.0609756097560976;0.439024390243902
Control.SRR15539824;37;40;0.540540540540541;17;20;0.0405405405405406;0.459459459459459
Control.SRR15539824;38;40;0.552631578947368;17;21;0.0526315789473685;0.447368421052632
Control.SRR15539824;39;40;0.41025641025641;23;16;0.0897435897435898;0.41025641025641
Control.SRR15539824;42;40;0.5;21;21;0;0.5
Control.SRR15539824;40;40;0.45;22;18;0.05;0.45
Control.SRR15539824;36;40;0.555555555555556;16;20;0.0555555555555556;0.444444444444444
Control.SRR15539824;35;40;0.285714285714286;25;10;0.214285714285714;0.285714285714286
Control.SRR15539824;45;40;0.533333333333333;21;24;0.0333333333333333;0.466666666666667
Control.SRR15539824;40;40;0.45;22;18;0.05;0.45
Control.SRR15539824;38;40;0.473684210526316;20;18;0.0263157894736842;0.473684210526316
Control.SRR15539824;41;40;0.609756097560976;16;25;0.109756097560976;0.390243902439024
Control.SRR15539824;45;40;0.666666666666667;15;30;0.166666666666667;0.333333333333333
Control.SRR15539824;41;40;0.51219512195122;20;21;0.0121951219512195;0.48780487804878
Control.SRR15539824;36;40;0.5;18;18;0;0.5
Control.SRR15539824;45;40;0.422222222222222;26;19;0.0777777777777778;0.422222222222222
Control.SRR15539824;38;40;0.578947368421053;16;22;0.0789473684210527;0.421052631578947
Control.SRR15539824;35;40;0.342857142857143;23;12;0.157142857142857;0.342857142857143
Control.SRR15539824;41;40;0.341463414634146;27;14;0.158536585365854;0.341463414634146
Control.SRR15539824;44;40;0.477272727272727;23;21;0.0227272727272727;0.477272727272727
Control.SRR15539824;38;40;0.394736842105263;23;15;0.105263157894737;0.394736842105263
Control.SRR15539824;44;40;0.431818181818182;25;19;0.0681818181818182;0.431818181818182
Control.SRR15539824;38;40;0.394736842105263;23;15;0.105263157894737;0.394736842105263
Control.SRR15539824;36;40;0.5;18;18;0;0.5
Control.SRR15539824;37;40;0.567567567567568;16;21;0.0675675675675675;0.432432432432432
Control.SRR15539824;36;40;0.583333333333333;15;21;0.0833333333333334;0.416666666666667
Control.SRR15539824;45;40;0.511111111111111;22;23;0.0111111111111111;0.488888888888889
Control.SRR15539824;40;40;0.6;16;24;0.1;0.4
Control.SRR15539824;43;40;0.511627906976744;21;22;0.0116279069767442;0.488372093023256
Control.SRR15539824;35;40;0.514285714285714;17;18;0.0142857142857142;0.485714285714286
Control.SRR15539824;45;40;0.4;27;18;0.1;0.4
Control.SRR15539824;37;40;0.513513513513513;18;19;0.0135135135135135;0.486486486486487
Control.SRR15539824;43;40;0.372093023255814;27;16;0.127906976744186;0.372093023255814
Control.SRR15539824;42;40;0.476190476190476;22;20;0.0238095238095238;0.476190476190476
Control.SRR15539824;39;40;0.564102564102564;17;22;0.0641025641025641;0.435897435897436
Control.SRR15539824;39;40;0.461538461538462;21;18;0.0384615384615384;0.461538461538462
Control.SRR15539824;37;40;0.351351351351351;24;13;0.148648648648649;0.351351351351351
Control.SRR15539824;40;40;0.55;18;22;0.05;0.45
Control.SRR15539824;37;40;0.486486486486487;19;18;0.0135135135135135;0.486486486486487
Control.SRR15539824;39;40;0.487179487179487;20;19;0.0128205128205128;0.487179487179487
Control.SRR15539824;42;40;0.476190476190476;22;20;0.0238095238095238;0.476190476190476
Control.SRR15539824;37;40;0.405405405405405;22;15;0.0945945945945946;0.405405405405405
Control.SRR15539824;36;40;0.444444444444444;20;16;0.0555555555555556;0.444444444444444
Control.SRR15539824;43;40;0.441860465116279;24;19;0.0581395348837209;0.441860465116279
Control.SRR15539824;41;40;0.536585365853659;19;22;0.0365853658536586;0.463414634146341
Control.SRR15539824;40;40;0.425;23;17;0.075;0.425
Control.SRR15539824;40;40;0.675;13;27;0.175;0.325
Control.SRR15539824;37;40;0.486486486486487;19;18;0.0135135135135135;0.486486486486487
Control.SRR15539824;43;40;0.558139534883721;19;24;0.0581395348837209;0.441860465116279
Control.SRR15539824;42;40;0.476190476190476;22;20;0.0238095238095238;0.476190476190476
Control.SRR15539824;38;40;0.447368421052632;21;17;0.0526315789473684;0.447368421052632
Control.SRR15539824;35;40;0.485714285714286;18;17;0.0142857142857143;0.485714285714286
Control.SRR15539824;41;40;0.439024390243902;23;18;0.0609756097560976;0.439024390243902
Control.SRR15539824;43;40;0.465116279069767;23;20;0.0348837209302326;0.465116279069767
Control.SRR15539824;44;40;0.522727272727273;21;23;0.0227272727272727;0.477272727272727
Control.SRR15539824;36;40;0.444444444444444;20;16;0.0555555555555556;0.444444444444444
Control.SRR15539824;42;40;0.5;21;21;0;0.5
Control.SRR15539824;40;40;0.475;21;19;0.025;0.475
Control.SRR15539824;45;40;0.533333333333333;21;24;0.0333333333333333;0.466666666666667
Control.SRR15539824;40;40;0.525;19;21;0.025;0.475
Control.SRR15539824;43;40;0.627906976744186;16;27;0.127906976744186;0.372093023255814
Control.SRR15539824;41;40;0.609756097560976;16;25;0.109756097560976;0.390243902439024
Control.SRR15539824;43;40;0.418604651162791;25;18;0.0813953488372093;0.418604651162791
Control.SRR15539824;41;40;0.390243902439024;25;16;0.109756097560976;0.390243902439024
Control.SRR15539824;38;40;0.526315789473684;18;20;0.0263157894736842;0.473684210526316
Control.SRR15539824;40;40;0.525;19;21;0.025;0.475
Control.SRR15539824;41;40;0.365853658536585;26;15;0.134146341463415;0.365853658536585
Control.SRR15539824;44;40;0.522727272727273;21;23;0.0227272727272727;0.477272727272727
Control.SRR15539824;36;40;0.472222222222222;19;17;0.0277777777777778;0.472222222222222
Control.SRR15539824;37;40;0.432432432432432;21;16;0.0675675675675675;0.432432432432432
Control.SRR15539824;39;40;0.487179487179487;20;19;0.0128205128205128;0.487179487179487
Control.SRR15539824;41;40;0.463414634146341;22;19;0.0365853658536585;0.463414634146341
Control.SRR15539824;41;40;0.414634146341463;24;17;0.0853658536585366;0.414634146341463
Control.SRR15539824;38;40;0.5;19;19;0;0.5
Control.SRR15539824;35;40;0.4;21;14;0.1;0.4
Control.SRR15539824;36;40;0.277777777777778;26;10;0.222222222222222;0.277777777777778
Control.SRR15539824;40;40;0.575;17;23;0.075;0.425
Control.SRR15539824;39;40;0.512820512820513;19;20;0.0128205128205128;0.487179487179487
Control.SRR15539824;40;40;0.375;25;15;0.125;0.375
Control.SRR15539824;42;40;0.571428571428571;18;24;0.0714285714285714;0.428571428571429
Control.SRR15539824;38;40;0.473684210526316;20;18;0.0263157894736842;0.473684210526316
Control.SRR15539824;35;40;0.485714285714286;18;17;0.0142857142857143;0.485714285714286
Control.SRR15539824;35;40;0.571428571428571;15;20;0.0714285714285714;0.428571428571429
Control.SRR15539824;46;40;0.521739130434783;22;24;0.0217391304347826;0.478260869565217
Control.SRR15539824;35;40;0.342857142857143;23;12;0.157142857142857;0.342857142857143
Control.SRR15539824;45;40;0.266666666666667;33;12;0.233333333333333;0.266666666666667
Control.SRR15539824;43;40;0.395348837209302;26;17;0.104651162790698;0.395348837209302
Control.SRR15539824;37;40;0.648648648648649;13;24;0.148648648648649;0.351351351351351
Control.SRR15539824;38;40;0.526315789473684;18;20;0.0263157894736842;0.473684210526316
Control.SRR15539824;36;40;0.527777777777778;17;19;0.0277777777777778;0.472222222222222
Control.SRR15539824;40;40;0.45;22;18;0.05;0.45
Control.SRR15539824;38;40;0.473684210526316;20;18;0.0263157894736842;0.473684210526316
Control.SRR15539824;44;40;0.477272727272727;23;21;0.0227272727272727;0.477272727272727
Control.SRR15539824;47;40;0.51063829787234;23;24;0.0106382978723404;0.48936170212766
Control.SRR15539824;42;40;0.476190476190476;22;20;0.0238095238095238;0.476190476190476
Control.SRR15539824;36;40;0.361111111111111;23;13;0.138888888888889;0.361111111111111
Control.SRR15539824;41;40;0.463414634146341;22;19;0.0365853658536585;0.463414634146341
Control.SRR15539824;41;40;0.414634146341463;24;17;0.0853658536585366;0.414634146341463
Control.SRR15539824;42;40;0.404761904761905;25;17;0.0952380952380952;0.404761904761905
Control.SRR15539824;35;40;0.485714285714286;18;17;0.0142857142857143;0.485714285714286
Control.SRR15539824;37;40;0.486486486486487;19;18;0.0135135135135135;0.486486486486487
Control.SRR15539824;46;40;0.543478260869565;21;25;0.0434782608695652;0.456521739130435
Control.SRR15539824;36;40;0.5;18;18;0;0.5
Control.SRR15539824;44;40;0.568181818181818;19;25;0.0681818181818182;0.431818181818182
Control.SRR15539824;43;40;0.488372093023256;22;21;0.0116279069767442;0.488372093023256
Control.SRR15539824;37;40;0.459459459459459;20;17;0.0405405405405405;0.459459459459459
Control.SRR15539824;46;40;0.543478260869565;21;25;0.0434782608695652;0.456521739130435
Control.SRR15539824;40;40;0.4;24;16;0.1;0.4
Control.SRR15539824;47;40;0.361702127659574;30;17;0.138297872340426;0.361702127659574
Control.SRR15539824;42;40;0.5;21;21;0;0.5
Control.SRR15539824;44;40;0.545454545454545;20;24;0.0454545454545454;0.454545454545455
Control.SRR15539824;39;40;0.487179487179487;20;19;0.0128205128205128;0.487179487179487
Control.SRR15539824;41;40;0.48780487804878;21;20;0.0121951219512195;0.48780487804878
Control.SRR15539824;36;40;0.527777777777778;17;19;0.0277777777777778;0.472222222222222
Control.SRR15539824;46;40;0.41304347826087;27;19;0.0869565217391304;0.41304347826087
Control.SRR15539824;36;40;0.416666666666667;21;15;0.0833333333333333;0.416666666666667
Control.SRR15539824;42;40;0.5;21;21;0;0.5
Control.SRR15539824;43;40;0.465116279069767;23;20;0.0348837209302326;0.465116279069767
Control.SRR15539824;36;40;0.5;18;18;0;0.5
Control.SRR15539824;45;40;0.488888888888889;23;22;0.0111111111111111;0.488888888888889
Control.SRR15539824;38;40;0.578947368421053;16;22;0.0789473684210527;0.421052631578947
Control.SRR15539824;35;40;0.571428571428571;15;20;0.0714285714285714;0.428571428571429
Control.SRR15539824;44;40;0.636363636363636;16;28;0.136363636363636;0.363636363636364
Control.SRR15539824;36;40;0.277777777777778;26;10;0.222222222222222;0.277777777777778
Control.SRR15539824;35;40;0.6;14;21;0.1;0.4
Control.SRR15539824;35;40;0.657142857142857;12;23;0.157142857142857;0.342857142857143
Control.SRR15539824;37;40;0.378378378378378;23;14;0.121621621621622;0.378378378378378
Control.SRR15539824;42;40;0.571428571428571;18;24;0.0714285714285714;0.428571428571429
Control.SRR15539824;45;40;0.555555555555556;20;25;0.0555555555555556;0.444444444444444
Control.SRR15539824;36;40;0.5;18;18;0;0.5
Control.SRR15539824;36;40;0.527777777777778;17;19;0.0277777777777778;0.472222222222222
Control.SRR15539824;38;40;0.526315789473684;18;20;0.0263157894736842;0.473684210526316
Control.SRR15539824;45;40;0.333333333333333;30;15;0.166666666666667;0.333333333333333
Control.SRR15539824;35;40;0.485714285714286;18;17;0.0142857142857143;0.485714285714286
Control.SRR15539824;39;40;0.461538461538462;21;18;0.0384615384615384;0.461538461538462
Control.SRR15539824;38;40;0.5;19;19;0;0.5
Control.SRR15539824;41;40;0.536585365853659;19;22;0.0365853658536586;0.463414634146341
Control.SRR15539824;42;40;0.452380952380952;23;19;0.0476190476190476;0.452380952380952
Control.SRR15539824;43;40;0.418604651162791;25;18;0.0813953488372093;0.418604651162791
Control.SRR15539824;47;40;0.361702127659574;30;17;0.138297872340426;0.361702127659574
Control.SRR15539824;41;40;0.439024390243902;23;18;0.0609756097560976;0.439024390243902
Control.SRR15539824;38;40;0.421052631578947;22;16;0.0789473684210527;0.421052631578947
Control.SRR15539824;43;40;0.651162790697674;15;28;0.151162790697674;0.348837209302326
Control.SRR15539824;41;40;0.439024390243902;23;18;0.0609756097560976;0.439024390243902
Control.SRR15539824;39;40;0.58974358974359;16;23;0.0897435897435898;0.41025641025641
Control.SRR15539824;38;40;0.657894736842105;13;25;0.157894736842105;0.342105263157895
Control.SRR15539824;37;40;0.513513513513513;18;19;0.0135135135135135;0.486486486486487
Control.SRR15539824;47;40;0.48936170212766;24;23;0.0106382978723404;0.48936170212766
Control.SRR15539824;37;40;0.513513513513513;18;19;0.0135135135135135;0.486486486486487
Control.SRR15539824;42;40;0.547619047619048;19;23;0.0476190476190477;0.452380952380952
Control.SRR15539824;39;40;0.512820512820513;19;20;0.0128205128205128;0.487179487179487
Control.SRR15539824;35;40;0.514285714285714;17;18;0.0142857142857142;0.485714285714286
Control.SRR15539824;35;40;0.571428571428571;15;20;0.0714285714285714;0.428571428571429
Control.SRR15539824;43;40;0.395348837209302;26;17;0.104651162790698;0.395348837209302
Control.SRR15539824;38;40;0.526315789473684;18;20;0.0263157894736842;0.473684210526316
Control.SRR15539824;46;40;0.478260869565217;24;22;0.0217391304347826;0.478260869565217
Control.SRR15539824;44;40;0.318181818181818;30;14;0.181818181818182;0.318181818181818
Control.SRR15539824;36;40;0.638888888888889;13;23;0.138888888888889;0.361111111111111
Control.SRR15539824;39;40;0.435897435897436;22;17;0.0641025641025641;0.435897435897436
Control.SRR15539824;38;40;0.552631578947368;17;21;0.0526315789473685;0.447368421052632
Control.SRR15539824;36;40;0.611111111111111;14;22;0.111111111111111;0.388888888888889
Control.SRR15539824;43;40;0.604651162790698;17;26;0.104651162790698;0.395348837209302
Control.SRR15539824;35;40;0.514285714285714;17;18;0.0142857142857142;0.485714285714286
Control.SRR15539824;44;40;0.522727272727273;21;23;0.0227272727272727;0.477272727272727
Control.SRR15539824;46;40;0.456521739130435;25;21;0.0434782608695652;0.456521739130435
Control.SRR15539824;43;40;0.488372093023256;22;21;0.0116279069767442;0.488372093023256
Control.SRR15539824;45;40;0.555555555555556;20;25;0.0555555555555556;0.444444444444444
Control.SRR15539824;37;40;0.486486486486487;19;18;0.0135135135135135;0.486486486486487
Control.SRR15539824;36;40;0.583333333333333;15;21;0.0833333333333334;0.416666666666667
Control.SRR15539824;46;40;0.5;23;23;0;0.5
Control.SRR15539824;41;40;0.51219512195122;20;21;0.0121951219512195;0.48780487804878
Control.SRR15539824;40;40;0.55;18;22;0.05;0.45
Control.SRR15539824;39;40;0.564102564102564;17;22;0.0641025641025641;0.435897435897436
Control.SRR15539824;45;40;0.466666666666667;24;21;0.0333333333333333;0.466666666666667
Control.SRR15539824;39;40;0.564102564102564;17;22;0.0641025641025641;0.435897435897436
Control.SRR15539824;41;40;0.560975609756098;18;23;0.0609756097560976;0.439024390243902
Control.SRR15539824;45;40;0.444444444444444;25;20;0.0555555555555556;0.444444444444444
Control.SRR15539824;47;40;0.51063829787234;23;24;0.0106382978723404;0.48936170212766
Control.SRR15539824;40;40;0.45;22;18;0.05;0.45
Control.SRR15539824;47;40;0.468085106382979;25;22;0.0319148936170213;0.468085106382979
Control.SRR15539824;44;40;0.522727272727273;21;23;0.0227272727272727;0.477272727272727
Control.SRR15539824;46;40;0.543478260869565;21;25;0.0434782608695652;0.456521739130435
Control.SRR15539824;47;40;0.404255319148936;28;19;0.0957446808510639;0.404255319148936
Control.SRR15539824;42;40;0.428571428571429;24;18;0.0714285714285715;0.428571428571429
Control.SRR15539824;37;40;0.513513513513513;18;19;0.0135135135135135;0.486486486486487
Control.SRR15539824;41;40;0.585365853658537;17;24;0.0853658536585366;0.414634146341463
Control.SRR15539824;36;40;0.555555555555556;16;20;0.0555555555555556;0.444444444444444
Control.SRR15539824;40;40;0.5;20;20;0;0.5
Control.SRR15539824;43;40;0.511627906976744;21;22;0.0116279069767442;0.488372093023256
Control.SRR15539824;46;40;0.456521739130435;25;21;0.0434782608695652;0.456521739130435
Control.SRR15539824;44;40;0.681818181818182;14;30;0.181818181818182;0.318181818181818
Control.SRR15539824;41;40;0.585365853658537;17;24;0.0853658536585366;0.414634146341463
Control.SRR15539824;40;40;0.625;15;25;0.125;0.375
Control.SRR15539824;38;40;0.473684210526316;20;18;0.0263157894736842;0.473684210526316
Control.SRR15539824;42;40;0.5;21;21;0;0.5
Control.SRR15539824;43;40;0.534883720930233;20;23;0.0348837209302325;0.465116279069767
Control.SRR15539824;42;40;0.5;21;21;0;0.5
Control.SRR15539824;35;40;0.371428571428571;22;13;0.128571428571429;0.371428571428571
Control.SRR15539824;40;40;0.55;18;22;0.05;0.45
Control.SRR15539824;38;40;0.447368421052632;21;17;0.0526315789473684;0.447368421052632
Control.SRR15539824;46;40;0.521739130434783;22;24;0.0217391304347826;0.478260869565217
Control.SRR15539824;35;40;0.457142857142857;19;16;0.0428571428571429;0.457142857142857
Control.SRR15539824;44;40;0.5;22;22;0;0.5
Control.SRR15539824;35;40;0.428571428571429;20;15;0.0714285714285715;0.428571428571429
Control.SRR15539824;43;40;0.511627906976744;21;22;0.0116279069767442;0.488372093023256
Control.SRR15539824;46;40;0.347826086956522;30;16;0.152173913043478;0.347826086956522
Control.SRR15539824;42;40;0.476190476190476;22;20;0.0238095238095238;0.476190476190476
Control.SRR15539824;47;40;0.617021276595745;18;29;0.117021276595745;0.382978723404255
Control.SRR15539824;47;40;0.638297872340426;17;30;0.138297872340426;0.361702127659574
Control.SRR15539824;42;40;0.523809523809524;20;22;0.0238095238095238;0.476190476190476
Control.SRR15539824;43;40;0.372093023255814;27;16;0.127906976744186;0.372093023255814
Control.SRR15539824;44;40;0.454545454545455;24;20;0.0454545454545455;0.454545454545455
Control.SRR15539824;39;40;0.538461538461538;18;21;0.0384615384615384;0.461538461538462
Control.SRR15539824;41;40;0.439024390243902;23;18;0.0609756097560976;0.439024390243902
Control.SRR15539824;38;40;0.447368421052632;21;17;0.0526315789473684;0.447368421052632
Control.SRR15539824;44;40;0.545454545454545;20;24;0.0454545454545454;0.454545454545455
Control.SRR15539824;39;40;0.487179487179487;20;19;0.0128205128205128;0.487179487179487
Control.SRR15539824;45;40;0.488888888888889;23;22;0.0111111111111111;0.488888888888889
Control.SRR15539824;41;40;0.463414634146341;22;19;0.0365853658536585;0.463414634146341
Control.SRR15539824;45;40;0.4;27;18;0.1;0.4
Control.SRR15539824;43;40;0.372093023255814;27;16;0.127906976744186;0.372093023255814
Control.SRR15539824;45;40;0.466666666666667;24;21;0.0333333333333333;0.466666666666667
Control.SRR15539824;43;40;0.511627906976744;21;22;0.0116279069767442;0.488372093023256
Control.SRR15539824;36;40;0.527777777777778;17;19;0.0277777777777778;0.472222222222222
Control.SRR15539824;39;40;0.41025641025641;23;16;0.0897435897435898;0.41025641025641
Control.SRR15539824;41;40;0.390243902439024;25;16;0.109756097560976;0.390243902439024
Control.SRR15539824;43;40;0.418604651162791;25;18;0.0813953488372093;0.418604651162791
Control.SRR15539824;39;40;0.564102564102564;17;22;0.0641025641025641;0.435897435897436
Control.SRR15539824;46;40;0.565217391304348;20;26;0.0652173913043478;0.434782608695652
Control.SRR15539824;44;40;0.477272727272727;23;21;0.0227272727272727;0.477272727272727
Control.SRR15539824;40;40;0.55;18;22;0.05;0.45
Control.SRR15539824;40;40;0.45;22;18;0.05;0.45
Control.SRR15539824;43;40;0.558139534883721;19;24;0.0581395348837209;0.441860465116279
Control.SRR15539824;37;40;0.459459459459459;20;17;0.0405405405405405;0.459459459459459
Control.SRR15539824;43;40;0.418604651162791;25;18;0.0813953488372093;0.418604651162791
Control.SRR15539824;47;40;0.446808510638298;26;21;0.0531914893617021;0.446808510638298
Control.SRR15539824;38;40;0.473684210526316;20;18;0.0263157894736842;0.473684210526316
Control.SRR15539824;40;40;0.45;22;18;0.05;0.45
Control.SRR15539824;38;40;0.605263157894737;15;23;0.105263157894737;0.394736842105263
Control.SRR15539824;45;40;0.533333333333333;21;24;0.0333333333333333;0.466666666666667
Control.SRR15539824;37;40;0.540540540540541;17;20;0.0405405405405406;0.459459459459459
Control.SRR15539824;39;40;0.461538461538462;21;18;0.0384615384615384;0.461538461538462
Control.SRR15539824;47;40;0.425531914893617;27;20;0.074468085106383;0.425531914893617
Control.SRR15539824;41;40;0.634146341463415;15;26;0.134146341463415;0.365853658536585
Control.SRR15539824;39;40;0.58974358974359;16;23;0.0897435897435898;0.41025641025641
Control.SRR15539824;36;40;0.555555555555556;16;20;0.0555555555555556;0.444444444444444
Control.SRR15539824;46;40;0.478260869565217;24;22;0.0217391304347826;0.478260869565217
Control.SRR15539824;41;40;0.439024390243902;23;18;0.0609756097560976;0.439024390243902
Control.SRR15539824;38;40;0.736842105263158;10;28;0.236842105263158;0.263157894736842
Control.SRR15539824;37;40;0.648648648648649;13;24;0.148648648648649;0.351351351351351
Control.SRR15539824;47;40;0.595744680851064;19;28;0.0957446808510638;0.404255319148936
Control.SRR15539824;38;40;0.578947368421053;16;22;0.0789473684210527;0.421052631578947
Control.SRR15539824;37;40;0.540540540540541;17;20;0.0405405405405406;0.459459459459459
Control.SRR15539824;42;40;0.5;21;21;0;0.5
Control.SRR15539824;41;40;0.439024390243902;23;18;0.0609756097560976;0.439024390243902
Control.SRR15539824;35;40;0.514285714285714;17;18;0.0142857142857142;0.485714285714286
Control.SRR15539824;44;40;0.613636363636364;17;27;0.113636363636364;0.386363636363636
Control.SRR15539824;43;40;0.465116279069767;23;20;0.0348837209302326;0.465116279069767
Control.SRR15539824;47;40;0.48936170212766;24;23;0.0106382978723404;0.48936170212766
Control.SRR15539824;45;40;0.622222222222222;17;28;0.122222222222222;0.377777777777778
Control.SRR15539824;37;40;0.324324324324324;25;12;0.175675675675676;0.324324324324324
Control.SRR15539824;35;40;0.485714285714286;18;17;0.0142857142857143;0.485714285714286
Control.SRR15539824;45;40;0.644444444444444;16;29;0.144444444444444;0.355555555555556
Control.SRR15539824;36;40;0.472222222222222;19;17;0.0277777777777778;0.472222222222222
Control.SRR15539824;41;40;0.51219512195122;20;21;0.0121951219512195;0.48780487804878
Control.SRR15539824;39;40;0.58974358974359;16;23;0.0897435897435898;0.41025641025641
Control.SRR15539824;38;40;0.526315789473684;18;20;0.0263157894736842;0.473684210526316
Control.SRR15539824;36;40;0.416666666666667;21;15;0.0833333333333333;0.416666666666667
Control.SRR15539824;38;40;0.605263157894737;15;23;0.105263157894737;0.394736842105263
Control.SRR15539824;43;40;0.302325581395349;30;13;0.197674418604651;0.302325581395349
Control.SRR15539824;40;40;0.525;19;21;0.025;0.475
Control.SRR15539824;38;40;0.526315789473684;18;20;0.0263157894736842;0.473684210526316
Control.SRR15539824;37;40;0.675675675675676;12;25;0.175675675675676;0.324324324324324
Control.SRR15539824;44;40;0.340909090909091;29;15;0.159090909090909;0.340909090909091
Control.SRR15539824;41;40;0.634146341463415;15;26;0.134146341463415;0.365853658536585
Control.SRR15539824;37;40;0.405405405405405;22;15;0.0945945945945946;0.405405405405405
Control.SRR15539824;42;40;0.452380952380952;23;19;0.0476190476190476;0.452380952380952
Control.SRR15539824;46;40;0.434782608695652;26;20;0.0652173913043478;0.434782608695652
Control.SRR15539824;44;40;0.522727272727273;21;23;0.0227272727272727;0.477272727272727
Control.SRR15539824;41;40;0.536585365853659;19;22;0.0365853658536586;0.463414634146341
Control.SRR15539824;35;40;0.485714285714286;18;17;0.0142857142857143;0.485714285714286
Control.SRR15539824;37;40;0.486486486486487;19;18;0.0135135135135135;0.486486486486487
Control.SRR15539824;42;40;0.619047619047619;16;26;0.119047619047619;0.380952380952381
Control.SRR15539824;44;40;0.613636363636364;17;27;0.113636363636364;0.386363636363636
Control.SRR15539824;35;40;0.571428571428571;15;20;0.0714285714285714;0.428571428571429
Control.SRR15539824;35;40;0.542857142857143;16;19;0.0428571428571428;0.457142857142857
Control.SRR15539824;36;40;0.444444444444444;20;16;0.0555555555555556;0.444444444444444
Control.SRR15539824;35;40;0.485714285714286;18;17;0.0142857142857143;0.485714285714286
Control.SRR15539824;43;40;0.348837209302326;28;15;0.151162790697674;0.348837209302326
Control.SRR15539824;36;40;0.555555555555556;16;20;0.0555555555555556;0.444444444444444
Control.SRR15539824;38;40;0.578947368421053;16;22;0.0789473684210527;0.421052631578947
Control.SRR15539824;39;40;0.538461538461538;18;21;0.0384615384615384;0.461538461538462
Control.SRR15539824;43;40;0.581395348837209;18;25;0.0813953488372093;0.418604651162791
Control.SRR15539824;40;40;0.35;26;14;0.15;0.35
Control.SRR15539824;39;40;0.615384615384615;15;24;0.115384615384615;0.384615384615385
Control.SRR15539824;35;40;0.485714285714286;18;17;0.0142857142857143;0.485714285714286
Control.SRR15539824;37;40;0.459459459459459;20;17;0.0405405405405405;0.459459459459459
Control.SRR15539824;47;40;0.51063829787234;23;24;0.0106382978723404;0.48936170212766
Control.SRR15539824;36;40;0.527777777777778;17;19;0.0277777777777778;0.472222222222222
Control.SRR15539824;37;40;0.324324324324324;25;12;0.175675675675676;0.324324324324324
Control.SRR15539824;43;40;0.511627906976744;21;22;0.0116279069767442;0.488372093023256
Control.SRR15539824;46;40;0.58695652173913;19;27;0.0869565217391305;0.41304347826087
Control.SRR15539824;40;40;0.525;19;21;0.025;0.475
Control.SRR15539824;39;40;0.615384615384615;15;24;0.115384615384615;0.384615384615385
Control.SRR15539824;43;40;0.511627906976744;21;22;0.0116279069767442;0.488372093023256
Control.SRR15539824;35;40;0.542857142857143;16;19;0.0428571428571428;0.457142857142857
Control.SRR15539824;40;40;0.55;18;22;0.05;0.45
Control.SRR15539824;46;40;0.478260869565217;24;22;0.0217391304347826;0.478260869565217
Control.SRR15539824;42;40;0.523809523809524;20;22;0.0238095238095238;0.476190476190476
Control.SRR15539824;37;40;0.432432432432432;21;16;0.0675675675675675;0.432432432432432
Control.SRR15539824;37;40;0.540540540540541;17;20;0.0405405405405406;0.459459459459459
Control.SRR15539824;39;40;0.666666666666667;13;26;0.166666666666667;0.333333333333333
Control.SRR15539824;46;40;0.456521739130435;25;21;0.0434782608695652;0.456521739130435
Control.SRR15539824;43;40;0.465116279069767;23;20;0.0348837209302326;0.465116279069767
Control.SRR15539824;43;40;0.488372093023256;22;21;0.0116279069767442;0.488372093023256
Control.SRR15539824;46;40;0.565217391304348;20;26;0.0652173913043478;0.434782608695652
Control.SRR15539824;46;40;0.456521739130435;25;21;0.0434782608695652;0.456521739130435
Control.SRR15539824;40;40;0.55;18;22;0.05;0.45
Control.SRR15539824;43;40;0.348837209302326;28;15;0.151162790697674;0.348837209302326
Control.SRR15539824;44;40;0.477272727272727;23;21;0.0227272727272727;0.477272727272727
Control.SRR15539824;40;40;0.525;19;21;0.025;0.475
Control.SRR15539824;40;40;0.625;15;25;0.125;0.375
Control.SRR15539824;44;40;0.545454545454545;20;24;0.0454545454545454;0.454545454545455
Control.SRR15539824;43;40;0.558139534883721;19;24;0.0581395348837209;0.441860465116279
Control.SRR15539824;43;40;0.651162790697674;15;28;0.151162790697674;0.348837209302326
Control.SRR15539824;42;40;0.523809523809524;20;22;0.0238095238095238;0.476190476190476
Control.SRR15539824;43;40;0.558139534883721;19;24;0.0581395348837209;0.441860465116279
Control.SRR15539824;38;40;0.605263157894737;15;23;0.105263157894737;0.394736842105263
Control.SRR15539824;43;40;0.581395348837209;18;25;0.0813953488372093;0.418604651162791
Control.SRR15539824;40;40;0.6;16;24;0.1;0.4
Control.SRR15539824;44;40;0.568181818181818;19;25;0.0681818181818182;0.431818181818182
Control.SRR15539824;43;40;0.511627906976744;21;22;0.0116279069767442;0.488372093023256
Control.SRR15539824;37;40;0.405405405405405;22;15;0.0945945945945946;0.405405405405405
Control.SRR15539824;38;40;0.526315789473684;18;20;0.0263157894736842;0.473684210526316
Control.SRR15539824;40;40;0.35;26;14;0.15;0.35
Control.SRR15539824;42;40;0.476190476190476;22;20;0.0238095238095238;0.476190476190476
Control.SRR15539824;47;40;0.468085106382979;25;22;0.0319148936170213;0.468085106382979
Control.SRR15539824;37;40;0.540540540540541;17;20;0.0405405405405406;0.459459459459459
Control.SRR15539824;41;40;0.463414634146341;22;19;0.0365853658536585;0.463414634146341
Control.SRR15539824;45;40;0.466666666666667;24;21;0.0333333333333333;0.466666666666667
Control.SRR15539824;35;40;0.542857142857143;16;19;0.0428571428571428;0.457142857142857
Control.SRR15539824;42;40;0.547619047619048;19;23;0.0476190476190477;0.452380952380952
Control.SRR15539824;43;40;0.465116279069767;23;20;0.0348837209302326;0.465116279069767
Control.SRR15539824;41;40;0.536585365853659;19;22;0.0365853658536586;0.463414634146341
Control.SRR15539824;41;40;0.536585365853659;19;22;0.0365853658536586;0.463414634146341
Control.SRR15539824;35;40;0.428571428571429;20;15;0.0714285714285715;0.428571428571429
Control.SRR15539824;41;40;0.536585365853659;19;22;0.0365853658536586;0.463414634146341
Control.SRR15539824;35;40;0.571428571428571;15;20;0.0714285714285714;0.428571428571429
Control.SRR15539824;44;40;0.431818181818182;25;19;0.0681818181818182;0.431818181818182
Control.SRR15539824;39;40;0.435897435897436;22;17;0.0641025641025641;0.435897435897436
Control.SRR15539824;41;40;0.634146341463415;15;26;0.134146341463415;0.365853658536585
Control.SRR15539824;43;40;0.604651162790698;17;26;0.104651162790698;0.395348837209302
Control.SRR15539824;43;40;0.511627906976744;21;22;0.0116279069767442;0.488372093023256
Control.SRR15539824;44;40;0.590909090909091;18;26;0.0909090909090909;0.409090909090909
Control.SRR15539824;39;40;0.487179487179487;20;19;0.0128205128205128;0.487179487179487
Control.SRR15539824;36;40;0.666666666666667;12;24;0.166666666666667;0.333333333333333
Control.SRR15539824;41;40;0.51219512195122;20;21;0.0121951219512195;0.48780487804878
Control.SRR15539824;35;40;0.485714285714286;18;17;0.0142857142857143;0.485714285714286
Control.SRR15539824;38;40;0.578947368421053;16;22;0.0789473684210527;0.421052631578947
Control.SRR15539824;37;40;0.405405405405405;22;15;0.0945945945945946;0.405405405405405
Control.SRR15539824;44;40;0.318181818181818;30;14;0.181818181818182;0.318181818181818
Control.SRR15539824;45;40;0.488888888888889;23;22;0.0111111111111111;0.488888888888889
Control.SRR15539824;43;40;0.511627906976744;21;22;0.0116279069767442;0.488372093023256
Control.SRR15539824;39;40;0.512820512820513;19;20;0.0128205128205128;0.487179487179487
Control.SRR15539824;39;40;0.538461538461538;18;21;0.0384615384615384;0.461538461538462
Control.SRR15539824;44;40;0.454545454545455;24;20;0.0454545454545455;0.454545454545455
Control.SRR15539824;36;40;0.555555555555556;16;20;0.0555555555555556;0.444444444444444
Control.SRR15539824;38;40;0.421052631578947;22;16;0.0789473684210527;0.421052631578947
Control.SRR15539824;46;40;0.391304347826087;28;18;0.108695652173913;0.391304347826087
Control.SRR15539824;43;40;0.511627906976744;21;22;0.0116279069767442;0.488372093023256
Control.SRR15539824;42;40;0.523809523809524;20;22;0.0238095238095238;0.476190476190476
Control.SRR15539824;36;40;0.527777777777778;17;19;0.0277777777777778;0.472222222222222
Control.SRR15539824;45;40;0.6;18;27;0.1;0.4
Control.SRR15539824;43;40;0.441860465116279;24;19;0.0581395348837209;0.441860465116279
Control.SRR15539824;36;40;0.555555555555556;16;20;0.0555555555555556;0.444444444444444
Control.SRR15539824;46;40;0.434782608695652;26;20;0.0652173913043478;0.434782608695652
Control.SRR15539824;46;40;0.5;23;23;0;0.5
Control.SRR15539824;47;40;0.531914893617021;22;25;0.0319148936170213;0.468085106382979
Control.SRR15539824;37;40;0.513513513513513;18;19;0.0135135135135135;0.486486486486487
Control.SRR15539824;44;40;0.590909090909091;18;26;0.0909090909090909;0.409090909090909
Control.SRR15539824;36;40;0.5;18;18;0;0.5
Control.SRR15539824;42;40;0.571428571428571;18;24;0.0714285714285714;0.428571428571429
Control.SRR15539824;44;40;0.568181818181818;19;25;0.0681818181818182;0.431818181818182
Control.SRR15539824;41;40;0.609756097560976;16;25;0.109756097560976;0.390243902439024
Control.SRR15539824;39;40;0.641025641025641;14;25;0.141025641025641;0.358974358974359
Control.SRR15539824;41;40;0.365853658536585;26;15;0.134146341463415;0.365853658536585
Control.SRR15539824;47;40;0.468085106382979;25;22;0.0319148936170213;0.468085106382979
Control.SRR15539824;35;40;0.628571428571429;13;22;0.128571428571429;0.371428571428571
Control.SRR15539824;40;40;0.55;18;22;0.05;0.45
Control.SRR15539824;44;40;0.545454545454545;20;24;0.0454545454545454;0.454545454545455
Control.SRR15539824;38;40;0.552631578947368;17;21;0.0526315789473685;0.447368421052632
Control.SRR15539824;37;40;0.405405405405405;22;15;0.0945945945945946;0.405405405405405
Control.SRR15539824;38;40;0.421052631578947;22;16;0.0789473684210527;0.421052631578947
Control.SRR15539824;37;40;0.432432432432432;21;16;0.0675675675675675;0.432432432432432
Control.SRR15539824;38;40;0.394736842105263;23;15;0.105263157894737;0.394736842105263
Control.SRR15539824;43;40;0.441860465116279;24;19;0.0581395348837209;0.441860465116279
Control.SRR15539824;44;40;0.477272727272727;23;21;0.0227272727272727;0.477272727272727
Control.SRR15539824;38;40;0.578947368421053;16;22;0.0789473684210527;0.421052631578947
Control.SRR15539824;41;40;0.51219512195122;20;21;0.0121951219512195;0.48780487804878
Control.SRR15539824;36;40;0.472222222222222;19;17;0.0277777777777778;0.472222222222222
Control.SRR15539824;36;40;0.361111111111111;23;13;0.138888888888889;0.361111111111111
Control.SRR15539824;36;40;0.333333333333333;24;12;0.166666666666667;0.333333333333333
Control.SRR15539824;38;40;0.421052631578947;22;16;0.0789473684210527;0.421052631578947
Control.SRR15539824;45;40;0.511111111111111;22;23;0.0111111111111111;0.488888888888889
Control.SRR15539824;46;40;0.456521739130435;25;21;0.0434782608695652;0.456521739130435
Control.SRR15539824;37;40;0.459459459459459;20;17;0.0405405405405405;0.459459459459459
Control.SRR15539824;41;40;0.609756097560976;16;25;0.109756097560976;0.390243902439024
Control.SRR15539824;39;40;0.461538461538462;21;18;0.0384615384615384;0.461538461538462
Control.SRR15539824;40;40;0.525;19;21;0.025;0.475
Control.SRR15539824;37;40;0.351351351351351;24;13;0.148648648648649;0.351351351351351
Control.SRR15539824;40;40;0.475;21;19;0.025;0.475
Control.SRR15539824;47;40;0.48936170212766;24;23;0.0106382978723404;0.48936170212766
Control.SRR15539824;44;40;0.477272727272727;23;21;0.0227272727272727;0.477272727272727
Control.SRR15539824;45;40;0.466666666666667;24;21;0.0333333333333333;0.466666666666667
Control.SRR15539824;46;40;0.478260869565217;24;22;0.0217391304347826;0.478260869565217
Control.SRR15539824;46;40;0.456521739130435;25;21;0.0434782608695652;0.456521739130435
Control.SRR15539824;45;40;0.533333333333333;21;24;0.0333333333333333;0.466666666666667
Control.SRR15539824;36;40;0.527777777777778;17;19;0.0277777777777778;0.472222222222222
Control.SRR15539824;36;40;0.416666666666667;21;15;0.0833333333333333;0.416666666666667
Control.SRR15539824;43;40;0.348837209302326;28;15;0.151162790697674;0.348837209302326
Control.SRR15539824;47;40;0.51063829787234;23;24;0.0106382978723404;0.48936170212766
Control.SRR15539824;44;40;0.545454545454545;20;24;0.0454545454545454;0.454545454545455
Control.SRR15539824;45;40;0.533333333333333;21;24;0.0333333333333333;0.466666666666667
Control.SRR15539824;44;40;0.431818181818182;25;19;0.0681818181818182;0.431818181818182
Control.SRR15539824;41;40;0.658536585365854;14;27;0.158536585365854;0.341463414634146
Control.SRR15539824;38;40;0.631578947368421;14;24;0.131578947368421;0.368421052631579
Control.SRR15539824;37;40;0.567567567567568;16;21;0.0675675675675675;0.432432432432432
Control.SRR15539824;42;40;0.428571428571429;24;18;0.0714285714285715;0.428571428571429
Control.SRR15539824;45;40;0.6;18;27;0.1;0.4
Control.SRR15539824;37;40;0.486486486486487;19;18;0.0135135135135135;0.486486486486487
Control.SRR15539824;45;40;0.4;27;18;0.1;0.4
Control.SRR15539824;39;40;0.512820512820513;19;20;0.0128205128205128;0.487179487179487
Control.SRR15539824;44;40;0.545454545454545;20;24;0.0454545454545454;0.454545454545455
Control.SRR15539824;39;40;0.58974358974359;16;23;0.0897435897435898;0.41025641025641
Control.SRR15539824;35;40;0.428571428571429;20;15;0.0714285714285715;0.428571428571429
Control.SRR15539824;47;40;0.48936170212766;24;23;0.0106382978723404;0.48936170212766
Control.SRR15539824;37;40;0.567567567567568;16;21;0.0675675675675675;0.432432432432432
Control.SRR15539824;37;40;0.594594594594595;15;22;0.0945945945945946;0.405405405405405
Control.SRR15539824;41;40;0.463414634146341;22;19;0.0365853658536585;0.463414634146341
Control.SRR15539824;44;40;0.545454545454545;20;24;0.0454545454545454;0.454545454545455
Control.SRR15539824;43;40;0.465116279069767;23;20;0.0348837209302326;0.465116279069767
Control.SRR15539824;37;40;0.594594594594595;15;22;0.0945945945945946;0.405405405405405
Control.SRR15539824;41;40;0.585365853658537;17;24;0.0853658536585366;0.414634146341463
Control.SRR15539824;36;40;0.5;18;18;0;0.5
Control.SRR15539824;40;40;0.55;18;22;0.05;0.45
Control.SRR15539824;45;40;0.488888888888889;23;22;0.0111111111111111;0.488888888888889
Control.SRR15539824;41;40;0.48780487804878;21;20;0.0121951219512195;0.48780487804878
Control.SRR15539824;43;40;0.511627906976744;21;22;0.0116279069767442;0.488372093023256
Control.SRR15539824;44;40;0.545454545454545;20;24;0.0454545454545454;0.454545454545455
Control.SRR15539824;47;40;0.404255319148936;28;19;0.0957446808510639;0.404255319148936
Control.SRR15539824;42;40;0.452380952380952;23;19;0.0476190476190476;0.452380952380952
Control.SRR15539824;41;40;0.439024390243902;23;18;0.0609756097560976;0.439024390243902
Control.SRR15539824;37;40;0.567567567567568;16;21;0.0675675675675675;0.432432432432432
Control.SRR15539824;39;40;0.512820512820513;19;20;0.0128205128205128;0.487179487179487
Control.SRR15539824;42;40;0.619047619047619;16;26;0.119047619047619;0.380952380952381
Control.SRR15539824;40;40;0.6;16;24;0.1;0.4
Control.SRR15539824;35;40;0.485714285714286;18;17;0.0142857142857143;0.485714285714286
Control.SRR15539824;44;40;0.636363636363636;16;28;0.136363636363636;0.363636363636364
Control.SRR15539824;35;40;0.428571428571429;20;15;0.0714285714285715;0.428571428571429
Control.SRR15539824;35;40;0.457142857142857;19;16;0.0428571428571429;0.457142857142857
Control.SRR15539824;44;40;0.5;22;22;0;0.5
Control.SRR15539824;40;40;0.35;26;14;0.15;0.35
Control.SRR15539824;43;40;0.581395348837209;18;25;0.0813953488372093;0.418604651162791
Control.SRR15539824;41;40;0.463414634146341;22;19;0.0365853658536585;0.463414634146341
Control.SRR15539824;37;40;0.432432432432432;21;16;0.0675675675675675;0.432432432432432
Control.SRR15539824;39;40;0.487179487179487;20;19;0.0128205128205128;0.487179487179487
Control.SRR15539824;41;40;0.463414634146341;22;19;0.0365853658536585;0.463414634146341
Control.SRR15539824;38;40;0.421052631578947;22;16;0.0789473684210527;0.421052631578947
Control.SRR15539824;40;40;0.55;18;22;0.05;0.45
Control.SRR15539824;40;40;0.575;17;23;0.075;0.425
Control.SRR15539824;36;40;0.333333333333333;24;12;0.166666666666667;0.333333333333333
Control.SRR15539824;37;40;0.486486486486487;19;18;0.0135135135135135;0.486486486486487
Control.SRR15539824;39;40;0.512820512820513;19;20;0.0128205128205128;0.487179487179487
Control.SRR15539824;41;40;0.560975609756098;18;23;0.0609756097560976;0.439024390243902
Control.SRR15539824;41;40;0.463414634146341;22;19;0.0365853658536585;0.463414634146341
Control.SRR15539824;35;40;0.6;14;21;0.1;0.4
Control.SRR15539824;36;40;0.472222222222222;19;17;0.0277777777777778;0.472222222222222
Control.SRR15539824;44;40;0.727272727272727;12;32;0.227272727272727;0.272727272727273
Control.SRR15539824;43;40;0.465116279069767;23;20;0.0348837209302326;0.465116279069767
Control.SRR15539824;40;40;0.475;21;19;0.025;0.475
Control.SRR15539824;39;40;0.615384615384615;15;24;0.115384615384615;0.384615384615385
Control.SRR15539824;36;40;0.5;18;18;0;0.5
Control.SRR15539824;45;40;0.511111111111111;22;23;0.0111111111111111;0.488888888888889
Control.SRR15539824;40;40;0.3;28;12;0.2;0.3
Control.SRR15539824;40;40;0.55;18;22;0.05;0.45
Control.SRR15539824;44;40;0.5;22;22;0;0.5
Control.SRR15539824;42;40;0.404761904761905;25;17;0.0952380952380952;0.404761904761905
Control.SRR15539824;43;40;0.558139534883721;19;24;0.0581395348837209;0.441860465116279
Control.SRR15539824;43;40;0.465116279069767;23;20;0.0348837209302326;0.465116279069767
Control.SRR15539824;43;40;0.604651162790698;17;26;0.104651162790698;0.395348837209302
Control.SRR15539824;38;40;0.342105263157895;25;13;0.157894736842105;0.342105263157895
Control.SRR15539824;42;40;0.357142857142857;27;15;0.142857142857143;0.357142857142857
Control.SRR15539824;36;40;0.527777777777778;17;19;0.0277777777777778;0.472222222222222
Control.SRR15539824;37;40;0.594594594594595;15;22;0.0945945945945946;0.405405405405405
Control.SRR15539824;35;40;0.485714285714286;18;17;0.0142857142857143;0.485714285714286
Control.SRR15539824;36;40;0.472222222222222;19;17;0.0277777777777778;0.472222222222222
Control.SRR15539824;36;40;0.555555555555556;16;20;0.0555555555555556;0.444444444444444
Control.SRR15539824;35;40;0.4;21;14;0.1;0.4
Control.SRR15539824;42;40;0.476190476190476;22;20;0.0238095238095238;0.476190476190476
Control.SRR15539824;37;40;0.432432432432432;21;16;0.0675675675675675;0.432432432432432
Control.SRR15539824;36;40;0.416666666666667;21;15;0.0833333333333333;0.416666666666667
Control.SRR15539824;37;40;0.486486486486487;19;18;0.0135135135135135;0.486486486486487
Control.SRR15539824;39;40;0.538461538461538;18;21;0.0384615384615384;0.461538461538462
Control.SRR15539824;40;40;0.375;25;15;0.125;0.375
Control.SRR15539824;41;40;0.439024390243902;23;18;0.0609756097560976;0.439024390243902
Control.SRR15539824;37;40;0.675675675675676;12;25;0.175675675675676;0.324324324324324
Control.SRR15539824;39;40;0.435897435897436;22;17;0.0641025641025641;0.435897435897436
Control.SRR15539824;38;40;0.578947368421053;16;22;0.0789473684210527;0.421052631578947
Control.SRR15539824;43;40;0.441860465116279;24;19;0.0581395348837209;0.441860465116279
Control.SRR15539824;41;40;0.341463414634146;27;14;0.158536585365854;0.341463414634146
Control.SRR15539824;43;40;0.488372093023256;22;21;0.0116279069767442;0.488372093023256
Control.SRR15539824;35;40;0.428571428571429;20;15;0.0714285714285715;0.428571428571429
Control.SRR15539824;37;40;0.594594594594595;15;22;0.0945945945945946;0.405405405405405
Control.SRR15539824;38;40;0.421052631578947;22;16;0.0789473684210527;0.421052631578947
Control.SRR15539824;38;40;0.342105263157895;25;13;0.157894736842105;0.342105263157895
Control.SRR15539824;45;40;0.4;27;18;0.1;0.4
Control.SRR15539824;44;40;0.568181818181818;19;25;0.0681818181818182;0.431818181818182
Control.SRR15539824;45;40;0.577777777777778;19;26;0.0777777777777777;0.422222222222222
Control.SRR15539824;36;40;0.5;18;18;0;0.5
Control.SRR15539824;36;40;0.5;18;18;0;0.5
Control.SRR15539824;38;40;0.473684210526316;20;18;0.0263157894736842;0.473684210526316
Control.SRR15539824;41;40;0.463414634146341;22;19;0.0365853658536585;0.463414634146341
Control.SRR15539824;38;40;0.552631578947368;17;21;0.0526315789473685;0.447368421052632
Control.SRR15539824;43;40;0.325581395348837;29;14;0.174418604651163;0.325581395348837
Control.SRR15539824;36;40;0.277777777777778;26;10;0.222222222222222;0.277777777777778
Control.SRR15539824;43;40;0.534883720930233;20;23;0.0348837209302325;0.465116279069767
Control.SRR15539824;38;40;0.605263157894737;15;23;0.105263157894737;0.394736842105263
Control.SRR15539824;38;40;0.368421052631579;24;14;0.131578947368421;0.368421052631579
Control.SRR15539824;37;40;0.540540540540541;17;20;0.0405405405405406;0.459459459459459
Control.SRR15539824;37;40;0.513513513513513;18;19;0.0135135135135135;0.486486486486487
Control.SRR15539824;43;40;0.372093023255814;27;16;0.127906976744186;0.372093023255814
Control.SRR15539824;38;40;0.605263157894737;15;23;0.105263157894737;0.394736842105263
Control.SRR15539824;43;40;0.441860465116279;24;19;0.0581395348837209;0.441860465116279
Control.SRR15539824;42;40;0.428571428571429;24;18;0.0714285714285715;0.428571428571429
Control.SRR15539824;39;40;0.538461538461538;18;21;0.0384615384615384;0.461538461538462
Control.SRR15539824;44;40;0.590909090909091;18;26;0.0909090909090909;0.409090909090909
Control.SRR15539824;45;40;0.488888888888889;23;22;0.0111111111111111;0.488888888888889
Control.SRR15539824;40;40;0.4;24;16;0.1;0.4
Control.SRR15539824;41;40;0.536585365853659;19;22;0.0365853658536586;0.463414634146341
Control.SRR15539824;42;40;0.476190476190476;22;20;0.0238095238095238;0.476190476190476
Control.SRR15539824;44;40;0.522727272727273;21;23;0.0227272727272727;0.477272727272727
Control.SRR15539824;41;40;0.51219512195122;20;21;0.0121951219512195;0.48780487804878
Control.SRR15539824;43;40;0.558139534883721;19;24;0.0581395348837209;0.441860465116279
Control.SRR15539824;40;40;0.575;17;23;0.075;0.425
Control.SRR15539824;40;40;0.6;16;24;0.1;0.4
Control.SRR15539824;39;40;0.435897435897436;22;17;0.0641025641025641;0.435897435897436
Control.SRR15539824;35;40;0.457142857142857;19;16;0.0428571428571429;0.457142857142857
Control.SRR15539824;38;40;0.631578947368421;14;24;0.131578947368421;0.368421052631579
Control.SRR15539824;35;40;0.457142857142857;19;16;0.0428571428571429;0.457142857142857
Control.SRR15539824;43;40;0.651162790697674;15;28;0.151162790697674;0.348837209302326
Control.SRR15539824;40;40;0.55;18;22;0.05;0.45
Control.SRR15539824;45;40;0.511111111111111;22;23;0.0111111111111111;0.488888888888889
Control.SRR15539824;44;40;0.477272727272727;23;21;0.0227272727272727;0.477272727272727
Control.SRR15539824;35;40;0.428571428571429;20;15;0.0714285714285715;0.428571428571429
Control.SRR15539824;39;40;0.384615384615385;24;15;0.115384615384615;0.384615384615385
Control.SRR15539824;39;40;0.564102564102564;17;22;0.0641025641025641;0.435897435897436
Control.SRR15539824;45;40;0.511111111111111;22;23;0.0111111111111111;0.488888888888889
Control.SRR15539824;42;40;0.404761904761905;25;17;0.0952380952380952;0.404761904761905
Control.SRR15539824;44;40;0.454545454545455;24;20;0.0454545454545455;0.454545454545455
Control.SRR15539824;45;40;0.4;27;18;0.1;0.4
Control.SRR15539824;43;40;0.465116279069767;23;20;0.0348837209302326;0.465116279069767
Control.SRR15539824;42;40;0.452380952380952;23;19;0.0476190476190476;0.452380952380952
Control.SRR15539824;44;40;0.545454545454545;20;24;0.0454545454545454;0.454545454545455
Control.SRR15539824;45;40;0.466666666666667;24;21;0.0333333333333333;0.466666666666667
Control.SRR15539824;38;40;0.368421052631579;24;14;0.131578947368421;0.368421052631579
Control.SRR15539824;38;40;0.421052631578947;22;16;0.0789473684210527;0.421052631578947
Control.SRR15539824;36;40;0.555555555555556;16;20;0.0555555555555556;0.444444444444444
Control.SRR15539824;35;40;0.542857142857143;16;19;0.0428571428571428;0.457142857142857
Control.SRR15539824;37;40;0.324324324324324;25;12;0.175675675675676;0.324324324324324
Control.SRR15539824;37;40;0.432432432432432;21;16;0.0675675675675675;0.432432432432432
Control.SRR15539824;35;40;0.457142857142857;19;16;0.0428571428571429;0.457142857142857
Control.SRR15539824;38;40;0.526315789473684;18;20;0.0263157894736842;0.473684210526316
Control.SRR15539824;41;40;0.560975609756098;18;23;0.0609756097560976;0.439024390243902
Control.SRR15539824;40;40;0.525;19;21;0.025;0.475
Control.SRR15539824;43;40;0.558139534883721;19;24;0.0581395348837209;0.441860465116279
Control.SRR15539824;40;40;0.5;20;20;0;0.5
Control.SRR15539824;41;40;0.439024390243902;23;18;0.0609756097560976;0.439024390243902
Control.SRR15539824;41;40;0.48780487804878;21;20;0.0121951219512195;0.48780487804878
Control.SRR15539824;42;40;0.642857142857143;15;27;0.142857142857143;0.357142857142857
Control.SRR15539824;40;40;0.425;23;17;0.075;0.425
Control.SRR15539824;41;40;0.48780487804878;21;20;0.0121951219512195;0.48780487804878
Control.SRR15539824;39;40;0.666666666666667;13;26;0.166666666666667;0.333333333333333
Control.SRR15539824;36;40;0.5;18;18;0;0.5
Control.SRR15539824;39;40;0.538461538461538;18;21;0.0384615384615384;0.461538461538462
Control.SRR15539824;39;40;0.615384615384615;15;24;0.115384615384615;0.384615384615385
Control.SRR15539824;43;40;0.581395348837209;18;25;0.0813953488372093;0.418604651162791
Control.SRR15539824;40;40;0.5;20;20;0;0.5
Control.SRR15539824;42;40;0.571428571428571;18;24;0.0714285714285714;0.428571428571429
Control.SRR15539824;43;40;0.651162790697674;15;28;0.151162790697674;0.348837209302326
Control.SRR15539824;36;40;0.527777777777778;17;19;0.0277777777777778;0.472222222222222
Control.SRR15539824;36;40;0.472222222222222;19;17;0.0277777777777778;0.472222222222222
Control.SRR15539824;39;40;0.307692307692308;27;12;0.192307692307692;0.307692307692308
Control.SRR15539824;35;40;0.342857142857143;23;12;0.157142857142857;0.342857142857143
Control.SRR15539824;35;40;0.542857142857143;16;19;0.0428571428571428;0.457142857142857
Control.SRR15539824;45;40;0.511111111111111;22;23;0.0111111111111111;0.488888888888889
Control.SRR15539824;41;40;0.51219512195122;20;21;0.0121951219512195;0.48780487804878
Control.SRR15539824;42;40;0.547619047619048;19;23;0.0476190476190477;0.452380952380952
Control.SRR15539824;42;40;0.476190476190476;22;20;0.0238095238095238;0.476190476190476
Control.SRR15539824;45;40;0.422222222222222;26;19;0.0777777777777778;0.422222222222222
Control.SRR15539824;44;40;0.522727272727273;21;23;0.0227272727272727;0.477272727272727
Control.SRR15539824;42;40;0.452380952380952;23;19;0.0476190476190476;0.452380952380952
Control.SRR15539824;40;40;0.5;20;20;0;0.5
Control.SRR15539824;39;40;0.435897435897436;22;17;0.0641025641025641;0.435897435897436
Control.SRR15539824;37;40;0.540540540540541;17;20;0.0405405405405406;0.459459459459459
Control.SRR15539824;44;40;0.590909090909091;18;26;0.0909090909090909;0.409090909090909
Control.SRR15539824;36;40;0.666666666666667;12;24;0.166666666666667;0.333333333333333
Control.SRR15539824;36;40;0.583333333333333;15;21;0.0833333333333334;0.416666666666667
Control.SRR15539824;41;40;0.585365853658537;17;24;0.0853658536585366;0.414634146341463
Control.SRR15539824;41;40;0.634146341463415;15;26;0.134146341463415;0.365853658536585
Control.SRR15539824;42;40;0.547619047619048;19;23;0.0476190476190477;0.452380952380952
Control.SRR15539824;42;40;0.595238095238095;17;25;0.0952380952380952;0.404761904761905
Control.SRR15539824;39;40;0.358974358974359;25;14;0.141025641025641;0.358974358974359
Control.SRR15539824;38;40;0.526315789473684;18;20;0.0263157894736842;0.473684210526316
Control.SRR15539824;40;40;0.575;17;23;0.075;0.425
Control.SRR15539824;44;40;0.454545454545455;24;20;0.0454545454545455;0.454545454545455
Control.SRR15539824;45;40;0.422222222222222;26;19;0.0777777777777778;0.422222222222222
Control.SRR15539824;35;40;0.6;14;21;0.1;0.4
Control.SRR15539824;35;40;0.571428571428571;15;20;0.0714285714285714;0.428571428571429
Control.SRR15539824;36;40;0.388888888888889;22;14;0.111111111111111;0.388888888888889
Control.SRR15539824;41;40;0.463414634146341;22;19;0.0365853658536585;0.463414634146341
Control.SRR15539824;41;40;0.390243902439024;25;16;0.109756097560976;0.390243902439024
Control.SRR15539824;42;40;0.571428571428571;18;24;0.0714285714285714;0.428571428571429
Control.SRR15539824;40;40;0.45;22;18;0.05;0.45
Control.SRR15539824;39;40;0.487179487179487;20;19;0.0128205128205128;0.487179487179487
Control.SRR15539824;45;40;0.622222222222222;17;28;0.122222222222222;0.377777777777778
Control.SRR15539824;36;40;0.444444444444444;20;16;0.0555555555555556;0.444444444444444
Control.SRR15539824;40;40;0.525;19;21;0.025;0.475
Control.SRR15539824;42;40;0.404761904761905;25;17;0.0952380952380952;0.404761904761905
Control.SRR15539824;40;40;0.575;17;23;0.075;0.425
Control.SRR15539824;43;40;0.558139534883721;19;24;0.0581395348837209;0.441860465116279
Control.SRR15539824;40;40;0.575;17;23;0.075;0.425
Control.SRR15539824;42;40;0.428571428571429;24;18;0.0714285714285715;0.428571428571429
Control.SRR15539824;43;40;0.534883720930233;20;23;0.0348837209302325;0.465116279069767
Control.SRR15539824;44;40;0.454545454545455;24;20;0.0454545454545455;0.454545454545455
Control.SRR15539824;42;40;0.404761904761905;25;17;0.0952380952380952;0.404761904761905
Control.SRR15539824;37;40;0.567567567567568;16;21;0.0675675675675675;0.432432432432432
Control.SRR15539824;35;40;0.371428571428571;22;13;0.128571428571429;0.371428571428571
Control.SRR15539824;35;40;0.457142857142857;19;16;0.0428571428571429;0.457142857142857
Control.SRR15539824;39;40;0.435897435897436;22;17;0.0641025641025641;0.435897435897436
Control.SRR15539824;44;40;0.545454545454545;20;24;0.0454545454545454;0.454545454545455
Control.SRR15539824;37;40;0.621621621621622;14;23;0.121621621621622;0.378378378378378
Control.SRR15539824;45;40;0.622222222222222;17;28;0.122222222222222;0.377777777777778
Control.SRR15539824;44;40;0.590909090909091;18;26;0.0909090909090909;0.409090909090909
Control.SRR15539824;42;40;0.428571428571429;24;18;0.0714285714285715;0.428571428571429
Control.SRR15539824;43;40;0.511627906976744;21;22;0.0116279069767442;0.488372093023256
Control.SRR15539824;42;40;0.547619047619048;19;23;0.0476190476190477;0.452380952380952
Control.SRR15539824;41;40;0.390243902439024;25;16;0.109756097560976;0.390243902439024
Control.SRR15539824;42;40;0.428571428571429;24;18;0.0714285714285715;0.428571428571429
Control.SRR15539824;39;40;0.461538461538462;21;18;0.0384615384615384;0.461538461538462
Control.SRR15539824;38;40;0.447368421052632;21;17;0.0526315789473684;0.447368421052632
Control.SRR15539824;37;40;0.567567567567568;16;21;0.0675675675675675;0.432432432432432
Control.SRR15539824;35;40;0.4;21;14;0.1;0.4
Control.SRR15539824;43;40;0.488372093023256;22;21;0.0116279069767442;0.488372093023256
Control.SRR15539824;35;40;0.542857142857143;16;19;0.0428571428571428;0.457142857142857
Control.SRR15539824;39;40;0.692307692307692;12;27;0.192307692307692;0.307692307692308
Control.SRR15539824;42;40;0.547619047619048;19;23;0.0476190476190477;0.452380952380952
Control.SRR15539824;41;40;0.365853658536585;26;15;0.134146341463415;0.365853658536585
Control.SRR15539824;44;40;0.431818181818182;25;19;0.0681818181818182;0.431818181818182
Control.SRR15539824;44;40;0.5;22;22;0;0.5
Control.SRR15539824;38;40;0.394736842105263;23;15;0.105263157894737;0.394736842105263
Control.SRR15539824;36;40;0.444444444444444;20;16;0.0555555555555556;0.444444444444444
Control.SRR15539824;45;40;0.511111111111111;22;23;0.0111111111111111;0.488888888888889
Control.SRR15539824;40;40;0.6;16;24;0.1;0.4
Control.SRR15539824;38;40;0.552631578947368;17;21;0.0526315789473685;0.447368421052632
Control.SRR15539824;44;40;0.5;22;22;0;0.5
Control.SRR15539824;38;40;0.578947368421053;16;22;0.0789473684210527;0.421052631578947
Control.SRR15539824;36;40;0.611111111111111;14;22;0.111111111111111;0.388888888888889
Control.SRR15539824;44;40;0.409090909090909;26;18;0.0909090909090909;0.409090909090909
Control.SRR15539824;45;40;0.488888888888889;23;22;0.0111111111111111;0.488888888888889
Control.SRR15539824;45;40;0.466666666666667;24;21;0.0333333333333333;0.466666666666667
Control.SRR15539824;35;40;0.457142857142857;19;16;0.0428571428571429;0.457142857142857
Control.SRR15539824;39;40;0.41025641025641;23;16;0.0897435897435898;0.41025641025641
Control.SRR15539824;35;40;0.514285714285714;17;18;0.0142857142857142;0.485714285714286
Control.SRR15539824;44;40;0.454545454545455;24;20;0.0454545454545455;0.454545454545455
Control.SRR15539824;45;40;0.444444444444444;25;20;0.0555555555555556;0.444444444444444
Control.SRR15539824;39;40;0.461538461538462;21;18;0.0384615384615384;0.461538461538462
Control.SRR15539824;41;40;0.51219512195122;20;21;0.0121951219512195;0.48780487804878
Control.SRR15539824;41;40;0.48780487804878;21;20;0.0121951219512195;0.48780487804878
Control.SRR15539824;42;40;0.476190476190476;22;20;0.0238095238095238;0.476190476190476
Control.SRR15539824;44;40;0.477272727272727;23;21;0.0227272727272727;0.477272727272727
Control.SRR15539824;41;40;0.536585365853659;19;22;0.0365853658536586;0.463414634146341
Control.SRR15539824;37;40;0.513513513513513;18;19;0.0135135135135135;0.486486486486487
Control.SRR15539824;36;40;0.333333333333333;24;12;0.166666666666667;0.333333333333333
Control.SRR15539824;42;40;0.571428571428571;18;24;0.0714285714285714;0.428571428571429
Control.SRR15539824;40;40;0.375;25;15;0.125;0.375
Control.SRR15539824;45;40;0.511111111111111;22;23;0.0111111111111111;0.488888888888889
Control.SRR15539824;40;40;0.425;23;17;0.075;0.425
Control.SRR15539824;40;40;0.625;15;25;0.125;0.375
Control.SRR15539824;36;40;0.527777777777778;17;19;0.0277777777777778;0.472222222222222
Control.SRR15539824;43;40;0.441860465116279;24;19;0.0581395348837209;0.441860465116279
Control.SRR15539824;44;40;0.5;22;22;0;0.5
Control.SRR15539824;41;40;0.51219512195122;20;21;0.0121951219512195;0.48780487804878
Control.SRR15539824;39;40;0.641025641025641;14;25;0.141025641025641;0.358974358974359
Control.SRR15539824;41;40;0.560975609756098;18;23;0.0609756097560976;0.439024390243902
Control.SRR15539824;44;40;0.659090909090909;15;29;0.159090909090909;0.340909090909091
Control.SRR15539824;43;40;0.581395348837209;18;25;0.0813953488372093;0.418604651162791
Control.SRR15539824;36;40;0.472222222222222;19;17;0.0277777777777778;0.472222222222222
Control.SRR15539824;36;40;0.472222222222222;19;17;0.0277777777777778;0.472222222222222
Control.SRR15539824;41;40;0.51219512195122;20;21;0.0121951219512195;0.48780487804878
Control.SRR15539824;41;40;0.48780487804878;21;20;0.0121951219512195;0.48780487804878
Control.SRR15539824;38;40;0.368421052631579;24;14;0.131578947368421;0.368421052631579
Control.SRR15539824;38;40;0.526315789473684;18;20;0.0263157894736842;0.473684210526316
Control.SRR15539824;38;40;0.605263157894737;15;23;0.105263157894737;0.394736842105263
Control.SRR15539824;43;40;0.581395348837209;18;25;0.0813953488372093;0.418604651162791
Control.SRR15539824;44;40;0.5;22;22;0;0.5
Control.SRR15539824;44;40;0.409090909090909;26;18;0.0909090909090909;0.409090909090909
Control.SRR15539824;42;40;0.5;21;21;0;0.5
Control.SRR15539824;41;40;0.463414634146341;22;19;0.0365853658536585;0.463414634146341
Control.SRR15539824;43;40;0.465116279069767;23;20;0.0348837209302326;0.465116279069767
Control.SRR15539824;43;40;0.604651162790698;17;26;0.104651162790698;0.395348837209302
Control.SRR15539824;42;40;0.428571428571429;24;18;0.0714285714285715;0.428571428571429
Control.SRR15539824;40;40;0.45;22;18;0.05;0.45
Control.SRR15539824;43;40;0.395348837209302;26;17;0.104651162790698;0.395348837209302
Control.SRR15539824;39;40;0.538461538461538;18;21;0.0384615384615384;0.461538461538462
Control.SRR15539824;41;40;0.365853658536585;26;15;0.134146341463415;0.365853658536585
Control.SRR15539824;35;40;0.457142857142857;19;16;0.0428571428571429;0.457142857142857
Control.SRR15539824;41;40;0.439024390243902;23;18;0.0609756097560976;0.439024390243902
Control.SRR15539824;45;40;0.688888888888889;14;31;0.188888888888889;0.311111111111111
Control.SRR15539824;43;40;0.534883720930233;20;23;0.0348837209302325;0.465116279069767
Control.SRR15539824;42;40;0.452380952380952;23;19;0.0476190476190476;0.452380952380952
Control.SRR15539824;36;40;0.555555555555556;16;20;0.0555555555555556;0.444444444444444
Control.SRR15539824;38;40;0.394736842105263;23;15;0.105263157894737;0.394736842105263
Control.SRR15539824;45;40;0.377777777777778;28;17;0.122222222222222;0.377777777777778
Control.SRR15539824;37;40;0.540540540540541;17;20;0.0405405405405406;0.459459459459459
Control.SRR15539824;37;40;0.432432432432432;21;16;0.0675675675675675;0.432432432432432
Control.SRR15539824;42;40;0.571428571428571;18;24;0.0714285714285714;0.428571428571429
Control.SRR15539824;37;40;0.324324324324324;25;12;0.175675675675676;0.324324324324324
Control.SRR15539824;36;40;0.5;18;18;0;0.5
Control.SRR15539824;36;40;0.444444444444444;20;16;0.0555555555555556;0.444444444444444
Control.SRR15539824;43;40;0.674418604651163;14;29;0.174418604651163;0.325581395348837
Control.SRR15539824;42;40;0.619047619047619;16;26;0.119047619047619;0.380952380952381
Control.SRR15539824;39;40;0.487179487179487;20;19;0.0128205128205128;0.487179487179487
Control.SRR15539824;42;40;0.619047619047619;16;26;0.119047619047619;0.380952380952381
Control.SRR15539824;45;40;0.577777777777778;19;26;0.0777777777777777;0.422222222222222
Control.SRR15539824;45;40;0.511111111111111;22;23;0.0111111111111111;0.488888888888889
Control.SRR15539824;38;40;0.473684210526316;20;18;0.0263157894736842;0.473684210526316
Control.SRR15539824;36;40;0.638888888888889;13;23;0.138888888888889;0.361111111111111
Control.SRR15539824;39;40;0.58974358974359;16;23;0.0897435897435898;0.41025641025641
Control.SRR15539824;40;40;0.425;23;17;0.075;0.425
Control.SRR15539824;43;40;0.488372093023256;22;21;0.0116279069767442;0.488372093023256
Control.SRR15539824;40;40;0.475;21;19;0.025;0.475
Control.SRR15539824;36;40;0.611111111111111;14;22;0.111111111111111;0.388888888888889
Control.SRR15539824;41;40;0.439024390243902;23;18;0.0609756097560976;0.439024390243902
Control.SRR15539824;41;40;0.585365853658537;17;24;0.0853658536585366;0.414634146341463
Control.SRR15539824;45;40;0.511111111111111;22;23;0.0111111111111111;0.488888888888889
Control.SRR15539824;35;40;0.485714285714286;18;17;0.0142857142857143;0.485714285714286
Control.SRR15539824;37;40;0.486486486486487;19;18;0.0135135135135135;0.486486486486487
Control.SRR15539824;39;40;0.435897435897436;22;17;0.0641025641025641;0.435897435897436
Control.SRR15539824;43;40;0.418604651162791;25;18;0.0813953488372093;0.418604651162791
Control.SRR15539824;35;40;0.6;14;21;0.1;0.4
Control.SRR15539824;39;40;0.641025641025641;14;25;0.141025641025641;0.358974358974359
Control.SRR15539824;41;40;0.48780487804878;21;20;0.0121951219512195;0.48780487804878
Control.SRR15539824;42;40;0.571428571428571;18;24;0.0714285714285714;0.428571428571429
Control.SRR15539824;39;40;0.58974358974359;16;23;0.0897435897435898;0.41025641025641
Control.SRR15539824;37;40;0.648648648648649;13;24;0.148648648648649;0.351351351351351
Control.SRR15539824;43;40;0.604651162790698;17;26;0.104651162790698;0.395348837209302
Control.SRR15539824;41;40;0.51219512195122;20;21;0.0121951219512195;0.48780487804878
Control.SRR15539824;45;40;0.6;18;27;0.1;0.4
Control.SRR15539824;36;40;0.527777777777778;17;19;0.0277777777777778;0.472222222222222
Control.SRR15539824;40;40;0.675;13;27;0.175;0.325
Control.SRR15539824;42;40;0.452380952380952;23;19;0.0476190476190476;0.452380952380952
Control.SRR15539824;44;40;0.545454545454545;20;24;0.0454545454545454;0.454545454545455
Control.SRR15539824;43;40;0.488372093023256;22;21;0.0116279069767442;0.488372093023256
Control.SRR15539824;36;40;0.388888888888889;22;14;0.111111111111111;0.388888888888889
Control.SRR15539824;38;40;0.447368421052632;21;17;0.0526315789473684;0.447368421052632
Control.SRR15539824;42;40;0.5;21;21;0;0.5
Control.SRR15539824;36;40;0.611111111111111;14;22;0.111111111111111;0.388888888888889
Control.SRR15539824;39;40;0.615384615384615;15;24;0.115384615384615;0.384615384615385
Control.SRR15539824;40;40;0.525;19;21;0.025;0.475
Control.SRR15539824;43;40;0.372093023255814;27;16;0.127906976744186;0.372093023255814
Control.SRR15539824;40;40;0.5;20;20;0;0.5
Control.SRR15539824;42;40;0.571428571428571;18;24;0.0714285714285714;0.428571428571429
Control.SRR15539824;44;40;0.522727272727273;21;23;0.0227272727272727;0.477272727272727
Control.SRR15539824;35;40;0.514285714285714;17;18;0.0142857142857142;0.485714285714286
Control.SRR15539824;39;40;0.512820512820513;19;20;0.0128205128205128;0.487179487179487
Control.SRR15539824;45;40;0.466666666666667;24;21;0.0333333333333333;0.466666666666667
Control.SRR15539824;45;40;0.4;27;18;0.1;0.4
Control.SRR15539824;38;40;0.5;19;19;0;0.5
Control.SRR15539824;36;40;0.5;18;18;0;0.5
Control.SRR15539824;41;40;0.536585365853659;19;22;0.0365853658536586;0.463414634146341
Control.SRR15539824;45;40;0.444444444444444;25;20;0.0555555555555556;0.444444444444444
Control.SRR15539824;40;40;0.575;17;23;0.075;0.425
Control.SRR15539824;37;40;0.513513513513513;18;19;0.0135135135135135;0.486486486486487
Control.SRR15539824;43;40;0.418604651162791;25;18;0.0813953488372093;0.418604651162791
Control.SRR15539824;38;40;0.447368421052632;21;17;0.0526315789473684;0.447368421052632
Control.SRR15539824;39;40;0.41025641025641;23;16;0.0897435897435898;0.41025641025641
Control.SRR15539824;40;40;0.55;18;22;0.05;0.45
Control.SRR15539824;45;40;0.444444444444444;25;20;0.0555555555555556;0.444444444444444
Control.SRR15539824;39;40;0.41025641025641;23;16;0.0897435897435898;0.41025641025641
Control.SRR15539824;42;40;0.523809523809524;20;22;0.0238095238095238;0.476190476190476
Control.SRR15539824;35;40;0.485714285714286;18;17;0.0142857142857143;0.485714285714286
Control.SRR15539824;39;40;0.512820512820513;19;20;0.0128205128205128;0.487179487179487
Control.SRR15539824;44;40;0.431818181818182;25;19;0.0681818181818182;0.431818181818182
Control.SRR15539824;45;40;0.511111111111111;22;23;0.0111111111111111;0.488888888888889
Control.SRR15539824;45;40;0.533333333333333;21;24;0.0333333333333333;0.466666666666667
Control.SRR15539824;44;40;0.5;22;22;0;0.5
Control.SRR15539824;40;40;0.425;23;17;0.075;0.425
Control.SRR15539824;44;40;0.522727272727273;21;23;0.0227272727272727;0.477272727272727
Control.SRR15539824;36;40;0.444444444444444;20;16;0.0555555555555556;0.444444444444444
Control.SRR15539824;41;40;0.463414634146341;22;19;0.0365853658536585;0.463414634146341
Control.SRR15539824;35;40;0.485714285714286;18;17;0.0142857142857143;0.485714285714286
Control.SRR15539824;41;40;0.414634146341463;24;17;0.0853658536585366;0.414634146341463
Control.SRR15539824;45;40;0.511111111111111;22;23;0.0111111111111111;0.488888888888889
Control.SRR15539824;45;40;0.555555555555556;20;25;0.0555555555555556;0.444444444444444
Control.SRR15539824;41;40;0.707317073170732;12;29;0.207317073170732;0.292682926829268
Control.SRR15539824;36;40;0.611111111111111;14;22;0.111111111111111;0.388888888888889
Control.SRR15539824;38;40;0.526315789473684;18;20;0.0263157894736842;0.473684210526316
Control.SRR15539824;38;40;0.473684210526316;20;18;0.0263157894736842;0.473684210526316
Control.SRR15539824;38;40;0.578947368421053;16;22;0.0789473684210527;0.421052631578947
Control.SRR15539824;35;40;0.542857142857143;16;19;0.0428571428571428;0.457142857142857
Control.SRR15539824;42;40;0.595238095238095;17;25;0.0952380952380952;0.404761904761905
Control.SRR15539824;40;40;0.425;23;17;0.075;0.425
Control.SRR15539824;37;40;0.513513513513513;18;19;0.0135135135135135;0.486486486486487
Control.SRR15539824;43;40;0.511627906976744;21;22;0.0116279069767442;0.488372093023256
Control.SRR15539824;41;40;0.439024390243902;23;18;0.0609756097560976;0.439024390243902
Control.SRR15539824;41;40;0.48780487804878;21;20;0.0121951219512195;0.48780487804878
Control.SRR15539824;43;40;0.488372093023256;22;21;0.0116279069767442;0.488372093023256
Control.SRR15539824;39;40;0.692307692307692;12;27;0.192307692307692;0.307692307692308
Control.SRR15539824;37;40;0.459459459459459;20;17;0.0405405405405405;0.459459459459459
Control.SRR15539824;38;40;0.421052631578947;22;16;0.0789473684210527;0.421052631578947
Control.SRR15539824;44;40;0.431818181818182;25;19;0.0681818181818182;0.431818181818182
Control.SRR15539824;40;40;0.5;20;20;0;0.5
Control.SRR15539824;37;40;0.540540540540541;17;20;0.0405405405405406;0.459459459459459
Control.SRR15539824;37;40;0.459459459459459;20;17;0.0405405405405405;0.459459459459459
Control.SRR15539824;36;40;0.611111111111111;14;22;0.111111111111111;0.388888888888889
Control.SRR15539824;39;40;0.487179487179487;20;19;0.0128205128205128;0.487179487179487
Control.SRR15539824;38;40;0.552631578947368;17;21;0.0526315789473685;0.447368421052632
Control.SRR15539824;40;40;0.575;17;23;0.075;0.425
Control.SRR15539824;35;40;0.457142857142857;19;16;0.0428571428571429;0.457142857142857
Control.SRR15539824;41;40;0.536585365853659;19;22;0.0365853658536586;0.463414634146341
Control.SRR15539824;41;40;0.414634146341463;24;17;0.0853658536585366;0.414634146341463
Control.SRR15539824;39;40;0.538461538461538;18;21;0.0384615384615384;0.461538461538462
Control.SRR15539824;39;40;0.435897435897436;22;17;0.0641025641025641;0.435897435897436
Control.SRR15539824;42;40;0.595238095238095;17;25;0.0952380952380952;0.404761904761905
Control.SRR15539824;44;40;0.363636363636364;28;16;0.136363636363636;0.363636363636364
Control.SRR15539824;42;40;0.452380952380952;23;19;0.0476190476190476;0.452380952380952
Control.SRR15539824;44;40;0.522727272727273;21;23;0.0227272727272727;0.477272727272727
Control.SRR15539824;36;40;0.472222222222222;19;17;0.0277777777777778;0.472222222222222
Control.SRR15539824;45;40;0.422222222222222;26;19;0.0777777777777778;0.422222222222222
Control.SRR15539824;40;40;0.475;21;19;0.025;0.475
Control.SRR15539824;38;40;0.526315789473684;18;20;0.0263157894736842;0.473684210526316
Control.SRR15539824;41;40;0.48780487804878;21;20;0.0121951219512195;0.48780487804878
Control.SRR15539824;37;40;0.486486486486487;19;18;0.0135135135135135;0.486486486486487
Control.SRR15539824;43;40;0.465116279069767;23;20;0.0348837209302326;0.465116279069767
Control.SRR15539824;36;40;0.472222222222222;19;17;0.0277777777777778;0.472222222222222
Control.SRR15539824;35;40;0.485714285714286;18;17;0.0142857142857143;0.485714285714286
Control.SRR15539824;36;40;0.527777777777778;17;19;0.0277777777777778;0.472222222222222
Control.SRR15539824;45;40;0.577777777777778;19;26;0.0777777777777777;0.422222222222222
Control.SRR15539824;43;40;0.325581395348837;29;14;0.174418604651163;0.325581395348837
Control.SRR15539824;43;40;0.604651162790698;17;26;0.104651162790698;0.395348837209302
Control.SRR15539824;39;40;0.512820512820513;19;20;0.0128205128205128;0.487179487179487
Control.SRR15539824;45;40;0.533333333333333;21;24;0.0333333333333333;0.466666666666667
Control.SRR15539824;38;40;0.526315789473684;18;20;0.0263157894736842;0.473684210526316
Control.SRR15539824;44;40;0.477272727272727;23;21;0.0227272727272727;0.477272727272727
Control.SRR15539824;38;40;0.552631578947368;17;21;0.0526315789473685;0.447368421052632
Control.SRR15539824;38;40;0.473684210526316;20;18;0.0263157894736842;0.473684210526316
Control.SRR15539824;45;40;0.466666666666667;24;21;0.0333333333333333;0.466666666666667
Control.SRR15539824;38;40;0.368421052631579;24;14;0.131578947368421;0.368421052631579
Control.SRR15539824;35;40;0.742857142857143;9;26;0.242857142857143;0.257142857142857
Control.SRR15539824;36;40;0.694444444444444;11;25;0.194444444444444;0.305555555555556
Control.SRR15539824;36;40;0.416666666666667;21;15;0.0833333333333333;0.416666666666667
Control.SRR15539824;45;40;0.488888888888889;23;22;0.0111111111111111;0.488888888888889
Control.SRR15539824;37;40;0.459459459459459;20;17;0.0405405405405405;0.459459459459459
Control.SRR15539824;35;40;0.457142857142857;19;16;0.0428571428571429;0.457142857142857
Control.SRR15539824;41;40;0.51219512195122;20;21;0.0121951219512195;0.48780487804878
Control.SRR15539824;42;40;0.5;21;21;0;0.5
Control.SRR15539824;38;40;0.789473684210526;8;30;0.289473684210526;0.210526315789474
Control.SRR15539824;40;40;0.65;14;26;0.15;0.35
Control.SRR15539824;35;40;0.457142857142857;19;16;0.0428571428571429;0.457142857142857
Control.SRR15539824;37;40;0.567567567567568;16;21;0.0675675675675675;0.432432432432432
Control.SRR15539824;40;40;0.35;26;14;0.15;0.35
Control.SRR15539824;42;40;0.5;21;21;0;0.5
Control.SRR15539824;38;40;0.447368421052632;21;17;0.0526315789473684;0.447368421052632
Control.SRR15539824;44;40;0.454545454545455;24;20;0.0454545454545455;0.454545454545455
Control.SRR15539824;41;40;0.560975609756098;18;23;0.0609756097560976;0.439024390243902
Control.SRR15539824;43;40;0.418604651162791;25;18;0.0813953488372093;0.418604651162791
Control.SRR15539824;37;40;0.378378378378378;23;14;0.121621621621622;0.378378378378378
Control.SRR15539824;39;40;0.461538461538462;21;18;0.0384615384615384;0.461538461538462
Control.SRR15539824;44;40;0.431818181818182;25;19;0.0681818181818182;0.431818181818182
Control.SRR15539824;36;40;0.444444444444444;20;16;0.0555555555555556;0.444444444444444
Control.SRR15539824;36;40;0.472222222222222;19;17;0.0277777777777778;0.472222222222222
Control.SRR15539824;36;40;0.638888888888889;13;23;0.138888888888889;0.361111111111111
Control.SRR15539824;38;40;0.605263157894737;15;23;0.105263157894737;0.394736842105263
Control.SRR15539824;35;40;0.628571428571429;13;22;0.128571428571429;0.371428571428571
Control.SRR15539824;37;40;0.540540540540541;17;20;0.0405405405405406;0.459459459459459
Control.SRR15539824;35;40;0.685714285714286;11;24;0.185714285714286;0.314285714285714
Control.SRR15539824;40;40;0.375;25;15;0.125;0.375
Control.SRR15539824;36;40;0.583333333333333;15;21;0.0833333333333334;0.416666666666667
Control.SRR15539824;36;40;0.555555555555556;16;20;0.0555555555555556;0.444444444444444
Control.SRR15539824;40;40;0.575;17;23;0.075;0.425
Control.SRR15539824;41;40;0.463414634146341;22;19;0.0365853658536585;0.463414634146341
Control.SRR15539824;43;40;0.488372093023256;22;21;0.0116279069767442;0.488372093023256
Control.SRR15539824;38;40;0.421052631578947;22;16;0.0789473684210527;0.421052631578947
Control.SRR15539824;38;40;0.5;19;19;0;0.5
Control.SRR15539824;36;40;0.638888888888889;13;23;0.138888888888889;0.361111111111111
Control.SRR15539824;40;40;0.5;20;20;0;0.5
Control.SRR15539824;35;40;0.428571428571429;20;15;0.0714285714285715;0.428571428571429
Control.SRR15539824;44;40;0.5;22;22;0;0.5
Control.SRR15539824;36;40;0.527777777777778;17;19;0.0277777777777778;0.472222222222222
Control.SRR15539824;35;40;0.685714285714286;11;24;0.185714285714286;0.314285714285714
Control.SRR15539824;41;40;0.48780487804878;21;20;0.0121951219512195;0.48780487804878
Control.SRR15539824;40;40;0.55;18;22;0.05;0.45
Control.SRR15539824;42;40;0.452380952380952;23;19;0.0476190476190476;0.452380952380952
Control.SRR15539824;37;40;0.648648648648649;13;24;0.148648648648649;0.351351351351351
Control.SRR15539824;42;40;0.547619047619048;19;23;0.0476190476190477;0.452380952380952
Control.SRR15539824;38;40;0.394736842105263;23;15;0.105263157894737;0.394736842105263
Control.SRR15539824;39;40;0.487179487179487;20;19;0.0128205128205128;0.487179487179487
Control.SRR15539824;40;40;0.55;18;22;0.05;0.45
Control.SRR15539824;45;40;0.466666666666667;24;21;0.0333333333333333;0.466666666666667
Control.SRR15539824;41;40;0.560975609756098;18;23;0.0609756097560976;0.439024390243902
Control.SRR15539824;42;40;0.666666666666667;14;28;0.166666666666667;0.333333333333333
Control.SRR15539824;40;40;0.425;23;17;0.075;0.425
Control.SRR15539824;38;40;0.473684210526316;20;18;0.0263157894736842;0.473684210526316
Control.SRR15539824;43;40;0.488372093023256;22;21;0.0116279069767442;0.488372093023256
Control.SRR15539824;44;40;0.613636363636364;17;27;0.113636363636364;0.386363636363636
Control.SRR15539824;41;40;0.390243902439024;25;16;0.109756097560976;0.390243902439024
Control.SRR15539824;41;40;0.585365853658537;17;24;0.0853658536585366;0.414634146341463
Control.SRR15539824;40;40;0.575;17;23;0.075;0.425
Control.SRR15539824;43;40;0.465116279069767;23;20;0.0348837209302326;0.465116279069767
Control.SRR15539824;38;40;0.578947368421053;16;22;0.0789473684210527;0.421052631578947
Control.SRR15539824;37;40;0.459459459459459;20;17;0.0405405405405405;0.459459459459459
Control.SRR15539824;42;40;0.523809523809524;20;22;0.0238095238095238;0.476190476190476
Control.SRR15539824;40;40;0.55;18;22;0.05;0.45
Control.SRR15539824;42;40;0.476190476190476;22;20;0.0238095238095238;0.476190476190476
Control.SRR15539824;35;40;0.6;14;21;0.1;0.4
Control.SRR15539824;44;40;0.545454545454545;20;24;0.0454545454545454;0.454545454545455
Control.SRR15539824;37;40;0.459459459459459;20;17;0.0405405405405405;0.459459459459459
Control.SRR15539824;37;40;0.324324324324324;25;12;0.175675675675676;0.324324324324324
Control.SRR15539824;43;40;0.534883720930233;20;23;0.0348837209302325;0.465116279069767
Control.SRR15539824;43;40;0.372093023255814;27;16;0.127906976744186;0.372093023255814
Control.SRR15539824;37;40;0.459459459459459;20;17;0.0405405405405405;0.459459459459459
Control.SRR15539824;42;40;0.476190476190476;22;20;0.0238095238095238;0.476190476190476
Control.SRR15539824;38;40;0.552631578947368;17;21;0.0526315789473685;0.447368421052632
Control.SRR15539824;38;40;0.342105263157895;25;13;0.157894736842105;0.342105263157895
Control.SRR15539824;42;40;0.595238095238095;17;25;0.0952380952380952;0.404761904761905
Control.SRR15539824;42;40;0.523809523809524;20;22;0.0238095238095238;0.476190476190476
Control.SRR15539824;39;40;0.384615384615385;24;15;0.115384615384615;0.384615384615385
Control.SRR15539824;39;40;0.512820512820513;19;20;0.0128205128205128;0.487179487179487
Control.SRR15539824;45;40;0.511111111111111;22;23;0.0111111111111111;0.488888888888889
Control.SRR15539824;40;40;0.425;23;17;0.075;0.425
Control.SRR15539824;43;40;0.534883720930233;20;23;0.0348837209302325;0.465116279069767
Control.SRR15539824;43;40;0.534883720930233;20;23;0.0348837209302325;0.465116279069767
Control.SRR15539824;36;40;0.555555555555556;16;20;0.0555555555555556;0.444444444444444
Control.SRR15539824;37;40;0.486486486486487;19;18;0.0135135135135135;0.486486486486487
Control.SRR15539824;35;40;0.485714285714286;18;17;0.0142857142857143;0.485714285714286
Control.SRR15539824;41;40;0.682926829268293;13;28;0.182926829268293;0.317073170731707
Control.SRR15539824;43;40;0.465116279069767;23;20;0.0348837209302326;0.465116279069767
Control.SRR15539824;41;40;0.658536585365854;14;27;0.158536585365854;0.341463414634146
Control.SRR15539824;40;40;0.425;23;17;0.075;0.425
Control.SRR15539824;35;40;0.428571428571429;20;15;0.0714285714285715;0.428571428571429
Control.SRR15539824;42;40;0.476190476190476;22;20;0.0238095238095238;0.476190476190476
Control.SRR15539824;42;40;0.452380952380952;23;19;0.0476190476190476;0.452380952380952
Control.SRR15539824;41;40;0.536585365853659;19;22;0.0365853658536586;0.463414634146341
Control.SRR15539824;38;40;0.578947368421053;16;22;0.0789473684210527;0.421052631578947
Control.SRR15539824;42;40;0.595238095238095;17;25;0.0952380952380952;0.404761904761905
Control.SRR15539824;41;40;0.585365853658537;17;24;0.0853658536585366;0.414634146341463
Control.SRR15539824;37;40;0.405405405405405;22;15;0.0945945945945946;0.405405405405405
Control.SRR15539824;40;40;0.525;19;21;0.025;0.475
Control.SRR15539824;41;40;0.51219512195122;20;21;0.0121951219512195;0.48780487804878
Control.SRR15539824;35;40;0.314285714285714;24;11;0.185714285714286;0.314285714285714
Control.SRR15539824;39;40;0.58974358974359;16;23;0.0897435897435898;0.41025641025641
Control.SRR15539824;36;40;0.555555555555556;16;20;0.0555555555555556;0.444444444444444
Control.SRR15539824;40;40;0.475;21;19;0.025;0.475
Control.SRR15539824;37;40;0.486486486486487;19;18;0.0135135135135135;0.486486486486487
Control.SRR15539824;36;40;0.527777777777778;17;19;0.0277777777777778;0.472222222222222
Control.SRR15539824;44;40;0.5;22;22;0;0.5
Control.SRR15539824;43;40;0.465116279069767;23;20;0.0348837209302326;0.465116279069767
Control.SRR15539824;42;40;0.5;21;21;0;0.5
Control.SRR15539824;37;40;0.378378378378378;23;14;0.121621621621622;0.378378378378378
Control.SRR15539824;43;40;0.511627906976744;21;22;0.0116279069767442;0.488372093023256
Control.SRR15539824;36;40;0.5;18;18;0;0.5
Control.SRR15539824;35;40;0.514285714285714;17;18;0.0142857142857142;0.485714285714286
Control.SRR15539824;35;40;0.685714285714286;11;24;0.185714285714286;0.314285714285714
Control.SRR15539824;44;40;0.477272727272727;23;21;0.0227272727272727;0.477272727272727
Control.SRR15539824;35;40;0.514285714285714;17;18;0.0142857142857142;0.485714285714286
Control.SRR15539824;38;40;0.578947368421053;16;22;0.0789473684210527;0.421052631578947
Control.SRR15539824;44;40;0.522727272727273;21;23;0.0227272727272727;0.477272727272727
Control.SRR15539824;38;40;0.368421052631579;24;14;0.131578947368421;0.368421052631579
Control.SRR15539824;36;40;0.555555555555556;16;20;0.0555555555555556;0.444444444444444
Control.SRR15539824;41;40;0.609756097560976;16;25;0.109756097560976;0.390243902439024
Control.SRR15539824;45;40;0.511111111111111;22;23;0.0111111111111111;0.488888888888889
Control.SRR15539824;38;40;0.736842105263158;10;28;0.236842105263158;0.263157894736842
Control.SRR15539824;40;40;0.425;23;17;0.075;0.425
Control.SRR15539824;40;40;0.5;20;20;0;0.5
Control.SRR15539824;44;40;0.545454545454545;20;24;0.0454545454545454;0.454545454545455
Control.SRR15539824;43;40;0.418604651162791;25;18;0.0813953488372093;0.418604651162791
Control.SRR15539824;45;40;0.533333333333333;21;24;0.0333333333333333;0.466666666666667
Control.SRR15539824;35;40;0.485714285714286;18;17;0.0142857142857143;0.485714285714286
Control.SRR15539824;38;40;0.578947368421053;16;22;0.0789473684210527;0.421052631578947
Control.SRR15539824;44;40;0.545454545454545;20;24;0.0454545454545454;0.454545454545455
Control.SRR15539824;35;40;0.428571428571429;20;15;0.0714285714285715;0.428571428571429
Control.SRR15539824;43;40;0.418604651162791;25;18;0.0813953488372093;0.418604651162791
Control.SRR15539824;36;40;0.5;18;18;0;0.5
Control.SRR15539824;44;40;0.522727272727273;21;23;0.0227272727272727;0.477272727272727
Control.SRR15539824;43;40;0.465116279069767;23;20;0.0348837209302326;0.465116279069767
Control.SRR15539824;44;40;0.454545454545455;24;20;0.0454545454545455;0.454545454545455
Control.SRR15539824;40;40;0.625;15;25;0.125;0.375
Control.SRR15539824;40;40;0.5;20;20;0;0.5
Control.SRR15539824;35;40;0.542857142857143;16;19;0.0428571428571428;0.457142857142857
Control.SRR15539824;38;40;0.605263157894737;15;23;0.105263157894737;0.394736842105263
Control.SRR15539824;42;40;0.428571428571429;24;18;0.0714285714285715;0.428571428571429
Control.SRR15539824;34;40;0.558823529411765;15;19;0.0588235294117647;0.441176470588235
Control.SRR15539824;41;40;0.390243902439024;25;16;0.109756097560976;0.390243902439024
Control.SRR15539824;43;40;0.511627906976744;21;22;0.0116279069767442;0.488372093023256
Control.SRR15539824;35;40;0.571428571428571;15;20;0.0714285714285714;0.428571428571429
Control.SRR15539824;38;40;0.5;19;19;0;0.5
Control.SRR15539824;35;40;0.457142857142857;19;16;0.0428571428571429;0.457142857142857
Control.SRR15539824;38;40;0.526315789473684;18;20;0.0263157894736842;0.473684210526316
Control.SRR15539824;43;40;0.558139534883721;19;24;0.0581395348837209;0.441860465116279
Control.SRR15539824;35;40;0.485714285714286;18;17;0.0142857142857143;0.485714285714286
Control.SRR15539824;34;40;0.617647058823529;13;21;0.117647058823529;0.382352941176471
Control.SRR15539824;34;40;0.470588235294118;18;16;0.0294117647058824;0.470588235294118
Control.SRR15539824;35;40;0.571428571428571;15;20;0.0714285714285714;0.428571428571429
Control.SRR15539824;38;40;0.447368421052632;21;17;0.0526315789473684;0.447368421052632
Control.SRR15539824;39;40;0.615384615384615;15;24;0.115384615384615;0.384615384615385
Control.SRR15539824;44;40;0.409090909090909;26;18;0.0909090909090909;0.409090909090909
Control.SRR15539824;38;40;0.473684210526316;20;18;0.0263157894736842;0.473684210526316
Control.SRR15539824;38;40;0.526315789473684;18;20;0.0263157894736842;0.473684210526316
Control.SRR15539824;37;40;0.432432432432432;21;16;0.0675675675675675;0.432432432432432
Control.SRR15539824;42;40;0.5;21;21;0;0.5
Control.SRR15539824;42;40;0.476190476190476;22;20;0.0238095238095238;0.476190476190476
Control.SRR15539824;42;40;0.333333333333333;28;14;0.166666666666667;0.333333333333333
Control.SRR15539824;39;40;0.538461538461538;18;21;0.0384615384615384;0.461538461538462
Control.SRR15539824;34;40;0.411764705882353;20;14;0.0882352941176471;0.411764705882353
Control.SRR15539824;34;40;0.529411764705882;16;18;0.0294117647058824;0.470588235294118
Control.SRR15539824;42;40;0.476190476190476;22;20;0.0238095238095238;0.476190476190476
Control.SRR15539824;36;40;0.527777777777778;17;19;0.0277777777777778;0.472222222222222
Control.SRR15539824;44;40;0.454545454545455;24;20;0.0454545454545455;0.454545454545455
Control.SRR15539824;39;40;0.564102564102564;17;22;0.0641025641025641;0.435897435897436
Control.SRR15539824;40;40;0.575;17;23;0.075;0.425
Control.SRR15539824;36;40;0.472222222222222;19;17;0.0277777777777778;0.472222222222222
Control.SRR15539824;38;40;0.684210526315789;12;26;0.184210526315789;0.315789473684211
Control.SRR15539824;43;40;0.604651162790698;17;26;0.104651162790698;0.395348837209302
Control.SRR15539824;42;40;0.476190476190476;22;20;0.0238095238095238;0.476190476190476
Control.SRR15539824;40;40;0.625;15;25;0.125;0.375
Control.SRR15539824;40;40;0.525;19;21;0.025;0.475
Control.SRR15539824;37;40;0.594594594594595;15;22;0.0945945945945946;0.405405405405405
Control.SRR15539824;38;40;0.368421052631579;24;14;0.131578947368421;0.368421052631579
Control.SRR15539824;40;40;0.375;25;15;0.125;0.375
Control.SRR15539824;40;40;0.575;17;23;0.075;0.425
Control.SRR15539824;40;40;0.675;13;27;0.175;0.325
Control.SRR15539824;41;40;0.463414634146341;22;19;0.0365853658536585;0.463414634146341
Control.SRR15539824;38;40;0.368421052631579;24;14;0.131578947368421;0.368421052631579
Control.SRR15539824;34;40;0.352941176470588;22;12;0.147058823529412;0.352941176470588
Control.SRR15539824;40;40;0.6;16;24;0.1;0.4
Control.SRR15539824;44;40;0.363636363636364;28;16;0.136363636363636;0.363636363636364
Control.SRR15539824;43;40;0.558139534883721;19;24;0.0581395348837209;0.441860465116279
Control.SRR15539824;39;40;0.41025641025641;23;16;0.0897435897435898;0.41025641025641
Control.SRR15539824;37;40;0.486486486486487;19;18;0.0135135135135135;0.486486486486487
Control.SRR15539824;38;40;0.578947368421053;16;22;0.0789473684210527;0.421052631578947
Control.SRR15539824;34;40;0.558823529411765;15;19;0.0588235294117647;0.441176470588235
Control.SRR15539824;42;40;0.428571428571429;24;18;0.0714285714285715;0.428571428571429
Control.SRR15539824;39;40;0.41025641025641;23;16;0.0897435897435898;0.41025641025641
Control.SRR15539824;36;40;0.5;18;18;0;0.5
Control.SRR15539824;43;40;0.488372093023256;22;21;0.0116279069767442;0.488372093023256
Control.SRR15539824;41;40;0.365853658536585;26;15;0.134146341463415;0.365853658536585
Control.SRR15539824;34;40;0.411764705882353;20;14;0.0882352941176471;0.411764705882353
Control.SRR15539824;38;40;0.5;19;19;0;0.5
Control.SRR15539824;42;40;0.428571428571429;24;18;0.0714285714285715;0.428571428571429
Control.SRR15539824;38;40;0.631578947368421;14;24;0.131578947368421;0.368421052631579
Control.SRR15539824;34;40;0.529411764705882;16;18;0.0294117647058824;0.470588235294118
Control.SRR15539824;43;40;0.534883720930233;20;23;0.0348837209302325;0.465116279069767
Control.SRR15539824;37;40;0.486486486486487;19;18;0.0135135135135135;0.486486486486487
Control.SRR15539824;35;40;0.457142857142857;19;16;0.0428571428571429;0.457142857142857
Control.SRR15539824;38;40;0.526315789473684;18;20;0.0263157894736842;0.473684210526316
Control.SRR15539824;41;40;0.439024390243902;23;18;0.0609756097560976;0.439024390243902
Control.SRR15539824;36;40;0.444444444444444;20;16;0.0555555555555556;0.444444444444444
Control.SRR15539824;40;40;0.4;24;16;0.1;0.4
Control.SRR15539824;39;40;0.512820512820513;19;20;0.0128205128205128;0.487179487179487
Control.SRR15539824;43;40;0.627906976744186;16;27;0.127906976744186;0.372093023255814
Control.SRR15539824;35;40;0.485714285714286;18;17;0.0142857142857143;0.485714285714286
Control.SRR15539824;42;40;0.428571428571429;24;18;0.0714285714285715;0.428571428571429
Control.SRR15539824;38;40;0.578947368421053;16;22;0.0789473684210527;0.421052631578947
Control.SRR15539824;39;40;0.512820512820513;19;20;0.0128205128205128;0.487179487179487
Control.SRR15539824;37;40;0.513513513513513;18;19;0.0135135135135135;0.486486486486487
Control.SRR15539824;36;40;0.472222222222222;19;17;0.0277777777777778;0.472222222222222
Control.SRR15539824;40;40;0.5;20;20;0;0.5
Control.SRR15539824;40;40;0.575;17;23;0.075;0.425
Control.SRR15539824;44;40;0.568181818181818;19;25;0.0681818181818182;0.431818181818182
Control.SRR15539824;39;40;0.384615384615385;24;15;0.115384615384615;0.384615384615385
Control.SRR15539824;40;40;0.475;21;19;0.025;0.475
Control.SRR15539824;44;40;0.454545454545455;24;20;0.0454545454545455;0.454545454545455
Control.SRR15539824;34;40;0.352941176470588;22;12;0.147058823529412;0.352941176470588
Control.SRR15539824;34;40;0.470588235294118;18;16;0.0294117647058824;0.470588235294118
Control.SRR15539824;42;40;0.428571428571429;24;18;0.0714285714285715;0.428571428571429
Control.SRR15539824;44;40;0.477272727272727;23;21;0.0227272727272727;0.477272727272727
Control.SRR15539824;38;40;0.5;19;19;0;0.5
Control.SRR15539824;41;40;0.560975609756098;18;23;0.0609756097560976;0.439024390243902
Control.SRR15539824;36;40;0.416666666666667;21;15;0.0833333333333333;0.416666666666667
Control.SRR15539824;34;40;0.558823529411765;15;19;0.0588235294117647;0.441176470588235
Control.SRR15539824;42;40;0.547619047619048;19;23;0.0476190476190477;0.452380952380952
Control.SRR15539824;38;40;0.526315789473684;18;20;0.0263157894736842;0.473684210526316
Control.SRR15539824;38;40;0.5;19;19;0;0.5
Control.SRR15539824;35;40;0.542857142857143;16;19;0.0428571428571428;0.457142857142857
Control.SRR15539824;34;40;0.5;17;17;0;0.5
Control.SRR15539824;34;40;0.470588235294118;18;16;0.0294117647058824;0.470588235294118
Control.SRR15539824;43;40;0.534883720930233;20;23;0.0348837209302325;0.465116279069767
Control.SRR15539824;41;40;0.682926829268293;13;28;0.182926829268293;0.317073170731707
Control.SRR15539824;38;40;0.421052631578947;22;16;0.0789473684210527;0.421052631578947
Control.SRR15539824;44;40;0.568181818181818;19;25;0.0681818181818182;0.431818181818182
Control.SRR15539824;42;40;0.523809523809524;20;22;0.0238095238095238;0.476190476190476
Control.SRR15539824;40;40;0.55;18;22;0.05;0.45
Control.SRR15539824;38;40;0.447368421052632;21;17;0.0526315789473684;0.447368421052632
Control.SRR15539824;38;40;0.526315789473684;18;20;0.0263157894736842;0.473684210526316
Control.SRR15539824;35;40;0.542857142857143;16;19;0.0428571428571428;0.457142857142857
Control.SRR15539824;39;40;0.435897435897436;22;17;0.0641025641025641;0.435897435897436
Control.SRR15539824;42;40;0.523809523809524;20;22;0.0238095238095238;0.476190476190476
Control.SRR15539824;40;40;0.4;24;16;0.1;0.4
Control.SRR15539824;41;40;0.463414634146341;22;19;0.0365853658536585;0.463414634146341
Control.SRR15539824;39;40;0.538461538461538;18;21;0.0384615384615384;0.461538461538462
Control.SRR15539824;43;40;0.558139534883721;19;24;0.0581395348837209;0.441860465116279
Control.SRR15539824;41;40;0.439024390243902;23;18;0.0609756097560976;0.439024390243902
Control.SRR15539824;39;40;0.512820512820513;19;20;0.0128205128205128;0.487179487179487
Control.SRR15539824;38;40;0.631578947368421;14;24;0.131578947368421;0.368421052631579
Control.SRR15539824;41;40;0.414634146341463;24;17;0.0853658536585366;0.414634146341463
Control.SRR15539824;43;40;0.558139534883721;19;24;0.0581395348837209;0.441860465116279
Control.SRR15539824;44;40;0.5;22;22;0;0.5
Control.SRR15539824;42;40;0.571428571428571;18;24;0.0714285714285714;0.428571428571429
Control.SRR15539824;34;40;0.5;17;17;0;0.5
Control.SRR15539824;38;40;0.552631578947368;17;21;0.0526315789473685;0.447368421052632
Control.SRR15539824;35;40;0.428571428571429;20;15;0.0714285714285715;0.428571428571429
Control.SRR15539824;38;40;0.578947368421053;16;22;0.0789473684210527;0.421052631578947
Control.SRR15539824;34;40;0.617647058823529;13;21;0.117647058823529;0.382352941176471
Control.SRR15539824;34;40;0.441176470588235;19;15;0.0588235294117647;0.441176470588235
Control.SRR15539824;44;40;0.590909090909091;18;26;0.0909090909090909;0.409090909090909
Control.SRR15539824;36;40;0.444444444444444;20;16;0.0555555555555556;0.444444444444444
Control.SRR15539824;40;40;0.45;22;18;0.05;0.45
Control.SRR15539824;43;40;0.534883720930233;20;23;0.0348837209302325;0.465116279069767
Control.SRR15539824;37;40;0.567567567567568;16;21;0.0675675675675675;0.432432432432432
Control.SRR15539824;37;40;0.621621621621622;14;23;0.121621621621622;0.378378378378378
Control.SRR15539824;42;40;0.547619047619048;19;23;0.0476190476190477;0.452380952380952
Control.SRR15539824;39;40;0.538461538461538;18;21;0.0384615384615384;0.461538461538462
Control.SRR15539824;41;40;0.463414634146341;22;19;0.0365853658536585;0.463414634146341
Control.SRR15539824;44;40;0.545454545454545;20;24;0.0454545454545454;0.454545454545455
Control.SRR15539824;38;40;0.526315789473684;18;20;0.0263157894736842;0.473684210526316
Control.SRR15539824;42;40;0.5;21;21;0;0.5
Control.SRR15539824;40;40;0.5;20;20;0;0.5
Control.SRR15539824;34;40;0.588235294117647;14;20;0.0882352941176471;0.411764705882353
Control.SRR15539824;44;40;0.522727272727273;21;23;0.0227272727272727;0.477272727272727
Control.SRR15539824;42;40;0.523809523809524;20;22;0.0238095238095238;0.476190476190476
Control.SRR15539824;43;40;0.581395348837209;18;25;0.0813953488372093;0.418604651162791
Control.SRR15539824;43;40;0.348837209302326;28;15;0.151162790697674;0.348837209302326
Control.SRR15539824;44;40;0.590909090909091;18;26;0.0909090909090909;0.409090909090909
Control.SRR15539824;44;40;0.522727272727273;21;23;0.0227272727272727;0.477272727272727
Control.SRR15539824;40;40;0.55;18;22;0.05;0.45
Control.SRR15539824;36;40;0.472222222222222;19;17;0.0277777777777778;0.472222222222222
Control.SRR15539824;35;40;0.4;21;14;0.1;0.4
Control.SRR15539824;41;40;0.560975609756098;18;23;0.0609756097560976;0.439024390243902
Control.SRR15539824;35;40;0.542857142857143;16;19;0.0428571428571428;0.457142857142857
Control.SRR15539824;41;40;0.414634146341463;24;17;0.0853658536585366;0.414634146341463
Control.SRR15539824;37;40;0.594594594594595;15;22;0.0945945945945946;0.405405405405405
Control.SRR15539824;44;40;0.636363636363636;16;28;0.136363636363636;0.363636363636364
Control.SRR15539824;34;40;0.5;17;17;0;0.5
Control.SRR15539824;34;40;0.529411764705882;16;18;0.0294117647058824;0.470588235294118
Control.SRR15539824;42;40;0.666666666666667;14;28;0.166666666666667;0.333333333333333
Control.SRR15539824;42;40;0.380952380952381;26;16;0.119047619047619;0.380952380952381
Control.SRR15539824;41;40;0.536585365853659;19;22;0.0365853658536586;0.463414634146341
Control.SRR15539824;41;40;0.585365853658537;17;24;0.0853658536585366;0.414634146341463
Control.SRR15539824;38;40;0.526315789473684;18;20;0.0263157894736842;0.473684210526316
Control.SRR15539824;44;40;0.5;22;22;0;0.5
Control.SRR15539824;41;40;0.51219512195122;20;21;0.0121951219512195;0.48780487804878
Control.SRR15539824;38;40;0.394736842105263;23;15;0.105263157894737;0.394736842105263
Control.SRR15539824;37;40;0.594594594594595;15;22;0.0945945945945946;0.405405405405405
Control.SRR15539824;38;40;0.394736842105263;23;15;0.105263157894737;0.394736842105263
Control.SRR15539824;40;40;0.425;23;17;0.075;0.425
Control.SRR15539824;39;40;0.512820512820513;19;20;0.0128205128205128;0.487179487179487
Control.SRR15539824;44;40;0.477272727272727;23;21;0.0227272727272727;0.477272727272727
Control.SRR15539824;40;40;0.45;22;18;0.05;0.45
Control.SRR15539824;36;40;0.583333333333333;15;21;0.0833333333333334;0.416666666666667
Control.SRR15539824;39;40;0.487179487179487;20;19;0.0128205128205128;0.487179487179487
Control.SRR15539824;40;40;0.525;19;21;0.025;0.475
Control.SRR15539824;36;40;0.527777777777778;17;19;0.0277777777777778;0.472222222222222
Control.SRR15539824;43;40;0.395348837209302;26;17;0.104651162790698;0.395348837209302
Control.SRR15539824;42;40;0.452380952380952;23;19;0.0476190476190476;0.452380952380952
Control.SRR15539824;44;40;0.477272727272727;23;21;0.0227272727272727;0.477272727272727
Control.SRR15539824;44;40;0.545454545454545;20;24;0.0454545454545454;0.454545454545455
Control.SRR15539824;38;40;0.657894736842105;13;25;0.157894736842105;0.342105263157895
Control.SRR15539824;34;40;0.529411764705882;16;18;0.0294117647058824;0.470588235294118
Control.SRR15539824;41;40;0.585365853658537;17;24;0.0853658536585366;0.414634146341463
Control.SRR15539824;37;40;0.378378378378378;23;14;0.121621621621622;0.378378378378378
Control.SRR15539824;35;40;0.542857142857143;16;19;0.0428571428571428;0.457142857142857
Control.SRR15539824;41;40;0.609756097560976;16;25;0.109756097560976;0.390243902439024
Control.SRR15539824;41;40;0.463414634146341;22;19;0.0365853658536585;0.463414634146341
Control.SRR15539824;38;40;0.421052631578947;22;16;0.0789473684210527;0.421052631578947
Control.SRR15539824;41;40;0.634146341463415;15;26;0.134146341463415;0.365853658536585
Control.SRR15539824;40;40;0.5;20;20;0;0.5
Control.SRR15539824;39;40;0.461538461538462;21;18;0.0384615384615384;0.461538461538462
Control.SRR15539824;44;40;0.454545454545455;24;20;0.0454545454545455;0.454545454545455
Control.SRR15539824;42;40;0.571428571428571;18;24;0.0714285714285714;0.428571428571429
Control.SRR15539824;43;40;0.511627906976744;21;22;0.0116279069767442;0.488372093023256
Control.SRR15539824;35;40;0.4;21;14;0.1;0.4
Control.SRR15539824;39;40;0.615384615384615;15;24;0.115384615384615;0.384615384615385
Control.SRR15539824;41;40;0.634146341463415;15;26;0.134146341463415;0.365853658536585
Control.SRR15539824;37;40;0.27027027027027;27;10;0.22972972972973;0.27027027027027
Control.SRR15539824;44;40;0.409090909090909;26;18;0.0909090909090909;0.409090909090909
Control.SRR15539824;39;40;0.461538461538462;21;18;0.0384615384615384;0.461538461538462
Control.SRR15539824;41;40;0.463414634146341;22;19;0.0365853658536585;0.463414634146341
Control.SRR15539824;40;40;0.475;21;19;0.025;0.475
Control.SRR15539824;37;40;0.540540540540541;17;20;0.0405405405405406;0.459459459459459
Control.SRR15539824;43;40;0.465116279069767;23;20;0.0348837209302326;0.465116279069767
Control.SRR15539824;44;40;0.386363636363636;27;17;0.113636363636364;0.386363636363636
Control.SRR15539824;35;40;0.371428571428571;22;13;0.128571428571429;0.371428571428571
Control.SRR15539824;41;40;0.48780487804878;21;20;0.0121951219512195;0.48780487804878
Control.SRR15539824;35;40;0.571428571428571;15;20;0.0714285714285714;0.428571428571429
Control.SRR15539824;43;40;0.627906976744186;16;27;0.127906976744186;0.372093023255814
Control.SRR15539824;35;40;0.571428571428571;15;20;0.0714285714285714;0.428571428571429
Control.SRR15539824;43;40;0.558139534883721;19;24;0.0581395348837209;0.441860465116279
Control.SRR15539824;44;40;0.522727272727273;21;23;0.0227272727272727;0.477272727272727
Control.SRR15539824;39;40;0.384615384615385;24;15;0.115384615384615;0.384615384615385
Control.SRR15539824;44;40;0.522727272727273;21;23;0.0227272727272727;0.477272727272727
Control.SRR15539824;36;40;0.527777777777778;17;19;0.0277777777777778;0.472222222222222
Control.SRR15539824;43;40;0.511627906976744;21;22;0.0116279069767442;0.488372093023256
Control.SRR15539824;43;40;0.534883720930233;20;23;0.0348837209302325;0.465116279069767
Control.SRR15539824;41;40;0.51219512195122;20;21;0.0121951219512195;0.48780487804878
Control.SRR15539824;43;40;0.488372093023256;22;21;0.0116279069767442;0.488372093023256
Control.SRR15539824;39;40;0.41025641025641;23;16;0.0897435897435898;0.41025641025641
Control.SRR15539824;35;40;0.685714285714286;11;24;0.185714285714286;0.314285714285714
Control.SRR15539824;37;40;0.513513513513513;18;19;0.0135135135135135;0.486486486486487
Control.SRR15539824;37;40;0.432432432432432;21;16;0.0675675675675675;0.432432432432432
Control.SRR15539824;41;40;0.341463414634146;27;14;0.158536585365854;0.341463414634146
Control.SRR15539824;36;40;0.527777777777778;17;19;0.0277777777777778;0.472222222222222
Control.SRR15539824;42;40;0.547619047619048;19;23;0.0476190476190477;0.452380952380952
Control.SRR15539824;37;40;0.513513513513513;18;19;0.0135135135135135;0.486486486486487
Control.SRR15539824;44;40;0.545454545454545;20;24;0.0454545454545454;0.454545454545455
Control.SRR15539824;42;40;0.476190476190476;22;20;0.0238095238095238;0.476190476190476
Control.SRR15539824;42;40;0.452380952380952;23;19;0.0476190476190476;0.452380952380952
Control.SRR15539824;43;40;0.488372093023256;22;21;0.0116279069767442;0.488372093023256
Control.SRR15539824;36;40;0.666666666666667;12;24;0.166666666666667;0.333333333333333
Control.SRR15539824;39;40;0.435897435897436;22;17;0.0641025641025641;0.435897435897436
Control.SRR15539824;41;40;0.609756097560976;16;25;0.109756097560976;0.390243902439024
Control.SRR15539824;36;40;0.416666666666667;21;15;0.0833333333333333;0.416666666666667
Control.SRR15539824;34;40;0.558823529411765;15;19;0.0588235294117647;0.441176470588235
Control.SRR15539824;41;40;0.48780487804878;21;20;0.0121951219512195;0.48780487804878
Control.SRR15539824;36;40;0.5;18;18;0;0.5
Control.SRR15539824;37;40;0.378378378378378;23;14;0.121621621621622;0.378378378378378
Control.SRR15539824;41;40;0.439024390243902;23;18;0.0609756097560976;0.439024390243902
Control.SRR15539824;37;40;0.486486486486487;19;18;0.0135135135135135;0.486486486486487
Control.SRR15539824;36;40;0.333333333333333;24;12;0.166666666666667;0.333333333333333
Control.SRR15539824;38;40;0.578947368421053;16;22;0.0789473684210527;0.421052631578947
Control.SRR15539824;35;40;0.485714285714286;18;17;0.0142857142857143;0.485714285714286
Control.SRR15539824;37;40;0.513513513513513;18;19;0.0135135135135135;0.486486486486487
Control.SRR15539824;38;40;0.421052631578947;22;16;0.0789473684210527;0.421052631578947
Control.SRR15539824;44;40;0.613636363636364;17;27;0.113636363636364;0.386363636363636
Control.SRR15539824;34;40;0.441176470588235;19;15;0.0588235294117647;0.441176470588235
Control.SRR15539824;36;40;0.527777777777778;17;19;0.0277777777777778;0.472222222222222
Control.SRR15539824;34;40;0.382352941176471;21;13;0.117647058823529;0.382352941176471
Control.SRR15539824;40;40;0.5;20;20;0;0.5
Control.SRR15539824;43;40;0.441860465116279;24;19;0.0581395348837209;0.441860465116279
Control.SRR15539824;40;40;0.5;20;20;0;0.5
Control.SRR15539824;42;40;0.547619047619048;19;23;0.0476190476190477;0.452380952380952
Control.SRR15539824;34;40;0.382352941176471;21;13;0.117647058823529;0.382352941176471
Control.SRR15539824;43;40;0.372093023255814;27;16;0.127906976744186;0.372093023255814
Control.SRR15539824;43;40;0.465116279069767;23;20;0.0348837209302326;0.465116279069767
Control.SRR15539824;43;40;0.534883720930233;20;23;0.0348837209302325;0.465116279069767
Control.SRR15539824;41;40;0.609756097560976;16;25;0.109756097560976;0.390243902439024
Control.SRR15539824;40;40;0.6;16;24;0.1;0.4
Control.SRR15539824;36;40;0.444444444444444;20;16;0.0555555555555556;0.444444444444444
Control.SRR15539824;41;40;0.48780487804878;21;20;0.0121951219512195;0.48780487804878
Control.SRR15539824;39;40;0.615384615384615;15;24;0.115384615384615;0.384615384615385
Control.SRR15539824;44;40;0.568181818181818;19;25;0.0681818181818182;0.431818181818182
Control.SRR15539824;34;40;0.470588235294118;18;16;0.0294117647058824;0.470588235294118
Control.SRR15539824;41;40;0.51219512195122;20;21;0.0121951219512195;0.48780487804878
Control.SRR15539824;38;40;0.5;19;19;0;0.5
Control.SRR15539824;40;40;0.5;20;20;0;0.5
Control.SRR15539824;38;40;0.578947368421053;16;22;0.0789473684210527;0.421052631578947
Control.SRR15539824;39;40;0.487179487179487;20;19;0.0128205128205128;0.487179487179487
Control.SRR15539824;38;40;0.473684210526316;20;18;0.0263157894736842;0.473684210526316
Control.SRR15539824;34;40;0.588235294117647;14;20;0.0882352941176471;0.411764705882353
Control.SRR15539824;36;40;0.388888888888889;22;14;0.111111111111111;0.388888888888889
Control.SRR15539824;37;40;0.513513513513513;18;19;0.0135135135135135;0.486486486486487
Control.SRR15539824;40;40;0.525;19;21;0.025;0.475
Control.SRR15539824;42;40;0.523809523809524;20;22;0.0238095238095238;0.476190476190476
Control.SRR15539824;34;40;0.470588235294118;18;16;0.0294117647058824;0.470588235294118
Control.SRR15539824;42;40;0.595238095238095;17;25;0.0952380952380952;0.404761904761905
Control.SRR15539824;35;40;0.485714285714286;18;17;0.0142857142857143;0.485714285714286
Control.SRR15539824;38;40;0.578947368421053;16;22;0.0789473684210527;0.421052631578947
Control.SRR15539824;37;40;0.621621621621622;14;23;0.121621621621622;0.378378378378378
Control.SRR15539824;41;40;0.365853658536585;26;15;0.134146341463415;0.365853658536585
Control.SRR15539824;36;40;0.527777777777778;17;19;0.0277777777777778;0.472222222222222
Control.SRR15539824;39;40;0.358974358974359;25;14;0.141025641025641;0.358974358974359
Control.SRR15539824;37;40;0.540540540540541;17;20;0.0405405405405406;0.459459459459459
Control.SRR15539824;41;40;0.585365853658537;17;24;0.0853658536585366;0.414634146341463
Control.SRR15539824;37;40;0.459459459459459;20;17;0.0405405405405405;0.459459459459459
Control.SRR15539824;41;40;0.585365853658537;17;24;0.0853658536585366;0.414634146341463
Control.SRR15539824;34;40;0.470588235294118;18;16;0.0294117647058824;0.470588235294118
Control.SRR15539824;34;40;0.441176470588235;19;15;0.0588235294117647;0.441176470588235
Control.SRR15539824;41;40;0.463414634146341;22;19;0.0365853658536585;0.463414634146341
Control.SRR15539824;41;40;0.560975609756098;18;23;0.0609756097560976;0.439024390243902
Control.SRR15539824;42;40;0.523809523809524;20;22;0.0238095238095238;0.476190476190476
Control.SRR15539824;35;40;0.6;14;21;0.1;0.4
Control.SRR15539824;35;40;0.571428571428571;15;20;0.0714285714285714;0.428571428571429
Control.SRR15539824;35;40;0.457142857142857;19;16;0.0428571428571429;0.457142857142857
Control.SRR15539824;34;40;0.558823529411765;15;19;0.0588235294117647;0.441176470588235
Control.SRR15539824;35;40;0.428571428571429;20;15;0.0714285714285715;0.428571428571429
Control.SRR15539824;36;40;0.444444444444444;20;16;0.0555555555555556;0.444444444444444
Control.SRR15539824;43;40;0.488372093023256;22;21;0.0116279069767442;0.488372093023256
Control.SRR15539824;38;40;0.5;19;19;0;0.5
Control.SRR15539824;34;40;0.5;17;17;0;0.5
Control.SRR15539824;35;40;0.485714285714286;18;17;0.0142857142857143;0.485714285714286
Control.SRR15539824;43;40;0.581395348837209;18;25;0.0813953488372093;0.418604651162791
Control.SRR15539824;36;40;0.416666666666667;21;15;0.0833333333333333;0.416666666666667
Control.SRR15539824;39;40;0.538461538461538;18;21;0.0384615384615384;0.461538461538462
Control.SRR15539824;36;40;0.361111111111111;23;13;0.138888888888889;0.361111111111111
Control.SRR15539824;34;40;0.558823529411765;15;19;0.0588235294117647;0.441176470588235
Control.SRR15539824;41;40;0.560975609756098;18;23;0.0609756097560976;0.439024390243902
Control.SRR15539824;39;40;0.564102564102564;17;22;0.0641025641025641;0.435897435897436
Control.SRR15539824;37;40;0.540540540540541;17;20;0.0405405405405406;0.459459459459459
Control.SRR15539824;36;40;0.583333333333333;15;21;0.0833333333333334;0.416666666666667
Control.SRR15539824;39;40;0.564102564102564;17;22;0.0641025641025641;0.435897435897436
Control.SRR15539824;36;40;0.611111111111111;14;22;0.111111111111111;0.388888888888889
Control.SRR15539824;38;40;0.5;19;19;0;0.5
Control.SRR15539824;39;40;0.538461538461538;18;21;0.0384615384615384;0.461538461538462
Control.SRR15539824;34;40;0.588235294117647;14;20;0.0882352941176471;0.411764705882353
Control.SRR15539824;43;40;0.558139534883721;19;24;0.0581395348837209;0.441860465116279
Control.SRR15539824;34;40;0.617647058823529;13;21;0.117647058823529;0.382352941176471
Control.SRR15539824;35;40;0.542857142857143;16;19;0.0428571428571428;0.457142857142857
Control.SRR15539824;40;40;0.65;14;26;0.15;0.35
Control.SRR15539824;37;40;0.459459459459459;20;17;0.0405405405405405;0.459459459459459
Control.SRR15539824;38;40;0.342105263157895;25;13;0.157894736842105;0.342105263157895
Control.SRR15539824;38;40;0.552631578947368;17;21;0.0526315789473685;0.447368421052632
Control.SRR15539824;36;40;0.472222222222222;19;17;0.0277777777777778;0.472222222222222
Control.SRR15539824;44;40;0.590909090909091;18;26;0.0909090909090909;0.409090909090909
Control.SRR15539824;41;40;0.439024390243902;23;18;0.0609756097560976;0.439024390243902
Control.SRR15539824;34;40;0.558823529411765;15;19;0.0588235294117647;0.441176470588235
Control.SRR15539824;39;40;0.58974358974359;16;23;0.0897435897435898;0.41025641025641
Control.SRR15539824;39;40;0.564102564102564;17;22;0.0641025641025641;0.435897435897436
Control.SRR15539824;40;40;0.55;18;22;0.05;0.45
Control.SRR15539824;42;40;0.523809523809524;20;22;0.0238095238095238;0.476190476190476
Control.SRR15539824;38;40;0.5;19;19;0;0.5
Control.SRR15539824;39;40;0.58974358974359;16;23;0.0897435897435898;0.41025641025641
Control.SRR15539824;43;40;0.604651162790698;17;26;0.104651162790698;0.395348837209302
Control.SRR15539824;37;40;0.567567567567568;16;21;0.0675675675675675;0.432432432432432
Control.SRR15539824;35;40;0.4;21;14;0.1;0.4
Control.SRR15539824;36;40;0.472222222222222;19;17;0.0277777777777778;0.472222222222222
Control.SRR15539824;36;40;0.361111111111111;23;13;0.138888888888889;0.361111111111111
Control.SRR15539824;38;40;0.447368421052632;21;17;0.0526315789473684;0.447368421052632
Control.SRR15539824;36;40;0.361111111111111;23;13;0.138888888888889;0.361111111111111
Control.SRR15539824;35;40;0.485714285714286;18;17;0.0142857142857143;0.485714285714286
Control.SRR15539824;38;40;0.447368421052632;21;17;0.0526315789473684;0.447368421052632
Control.SRR15539824;38;40;0.394736842105263;23;15;0.105263157894737;0.394736842105263
Control.SRR15539824;41;40;0.536585365853659;19;22;0.0365853658536586;0.463414634146341
Control.SRR15539824;39;40;0.538461538461538;18;21;0.0384615384615384;0.461538461538462
Control.SRR15539824;41;40;0.317073170731707;28;13;0.182926829268293;0.317073170731707
Control.SRR15539824;38;40;0.421052631578947;22;16;0.0789473684210527;0.421052631578947
Control.SRR15539824;40;40;0.35;26;14;0.15;0.35
Control.SRR15539824;44;40;0.477272727272727;23;21;0.0227272727272727;0.477272727272727
Control.SRR15539824;38;40;0.526315789473684;18;20;0.0263157894736842;0.473684210526316
Control.SRR15539824;37;40;0.567567567567568;16;21;0.0675675675675675;0.432432432432432
Control.SRR15539824;39;40;0.41025641025641;23;16;0.0897435897435898;0.41025641025641
Control.SRR15539824;41;40;0.560975609756098;18;23;0.0609756097560976;0.439024390243902
Control.SRR15539824;36;40;0.555555555555556;16;20;0.0555555555555556;0.444444444444444
Control.SRR15539824;41;40;0.414634146341463;24;17;0.0853658536585366;0.414634146341463
Control.SRR15539824;33;40;0.545454545454545;15;18;0.0454545454545454;0.454545454545455
Control.SRR15539824;38;40;0.605263157894737;15;23;0.105263157894737;0.394736842105263
Control.SRR15539824;39;40;0.564102564102564;17;22;0.0641025641025641;0.435897435897436
Control.SRR15539824;39;40;0.512820512820513;19;20;0.0128205128205128;0.487179487179487
Control.SRR15539824;38;40;0.526315789473684;18;20;0.0263157894736842;0.473684210526316
Control.SRR15539824;42;40;0.404761904761905;25;17;0.0952380952380952;0.404761904761905
Control.SRR15539824;34;40;0.5;17;17;0;0.5
Control.SRR15539824;42;40;0.523809523809524;20;22;0.0238095238095238;0.476190476190476
Control.SRR15539824;40;40;0.575;17;23;0.075;0.425
Control.SRR15539824;39;40;0.564102564102564;17;22;0.0641025641025641;0.435897435897436
Control.SRR15539824;40;40;0.475;21;19;0.025;0.475
Control.SRR15539824;38;40;0.421052631578947;22;16;0.0789473684210527;0.421052631578947
Control.SRR15539824;40;40;0.475;21;19;0.025;0.475
Control.SRR15539824;36;40;0.555555555555556;16;20;0.0555555555555556;0.444444444444444
Control.SRR15539824;39;40;0.615384615384615;15;24;0.115384615384615;0.384615384615385
Control.SRR15539824;36;40;0.555555555555556;16;20;0.0555555555555556;0.444444444444444
Control.SRR15539824;39;40;0.538461538461538;18;21;0.0384615384615384;0.461538461538462
Control.SRR15539824;39;40;0.564102564102564;17;22;0.0641025641025641;0.435897435897436
Control.SRR15539824;41;40;0.48780487804878;21;20;0.0121951219512195;0.48780487804878
Control.SRR15539824;39;40;0.461538461538462;21;18;0.0384615384615384;0.461538461538462
Control.SRR15539824;36;40;0.555555555555556;16;20;0.0555555555555556;0.444444444444444
Control.SRR15539824;36;40;0.416666666666667;21;15;0.0833333333333333;0.416666666666667
Control.SRR15539824;37;40;0.486486486486487;19;18;0.0135135135135135;0.486486486486487
Control.SRR15539824;39;40;0.615384615384615;15;24;0.115384615384615;0.384615384615385
Control.SRR15539824;42;40;0.380952380952381;26;16;0.119047619047619;0.380952380952381
Control.SRR15539824;33;40;0.454545454545455;18;15;0.0454545454545455;0.454545454545455
Control.SRR15539824;40;40;0.525;19;21;0.025;0.475
Control.SRR15539824;40;40;0.4;24;16;0.1;0.4
Control.SRR15539824;34;40;0.558823529411765;15;19;0.0588235294117647;0.441176470588235
Control.SRR15539824;39;40;0.487179487179487;20;19;0.0128205128205128;0.487179487179487
Control.SRR15539824;39;40;0.461538461538462;21;18;0.0384615384615384;0.461538461538462
Control.SRR15539824;41;40;0.609756097560976;16;25;0.109756097560976;0.390243902439024
Control.SRR15539824;37;40;0.432432432432432;21;16;0.0675675675675675;0.432432432432432
Control.SRR15539824;36;40;0.416666666666667;21;15;0.0833333333333333;0.416666666666667
Control.SRR15539824;32;40;0.5;16;16;0;0.5
Control.SRR15539824;37;40;0.486486486486487;19;18;0.0135135135135135;0.486486486486487
Control.SRR15539824;37;40;0.324324324324324;25;12;0.175675675675676;0.324324324324324
Control.SRR15539824;39;40;0.487179487179487;20;19;0.0128205128205128;0.487179487179487
Control.SRR15539824;32;40;0.375;20;12;0.125;0.375
Control.SRR15539824;41;40;0.439024390243902;23;18;0.0609756097560976;0.439024390243902
Control.SRR15539824;40;40;0.425;23;17;0.075;0.425
Control.SRR15539824;39;40;0.41025641025641;23;16;0.0897435897435898;0.41025641025641
Control.SRR15539824;36;40;0.5;18;18;0;0.5
Control.SRR15539824;40;40;0.6;16;24;0.1;0.4
Control.SRR15539824;39;40;0.333333333333333;26;13;0.166666666666667;0.333333333333333
Control.SRR15539824;34;40;0.323529411764706;23;11;0.176470588235294;0.323529411764706
Control.SRR15539824;35;40;0.542857142857143;16;19;0.0428571428571428;0.457142857142857
Control.SRR15539824;35;40;0.514285714285714;17;18;0.0142857142857142;0.485714285714286
Control.SRR15539824;37;40;0.513513513513513;18;19;0.0135135135135135;0.486486486486487
Control.SRR15539824;42;40;0.452380952380952;23;19;0.0476190476190476;0.452380952380952
Control.SRR15539824;42;40;0.5;21;21;0;0.5
Control.SRR15539824;41;40;0.48780487804878;21;20;0.0121951219512195;0.48780487804878
Control.SRR15539824;40;40;0.525;19;21;0.025;0.475
Control.SRR15539824;35;40;0.542857142857143;16;19;0.0428571428571428;0.457142857142857
Control.SRR15539824;32;40;0.59375;13;19;0.09375;0.40625
Control.SRR15539824;33;40;0.393939393939394;20;13;0.106060606060606;0.393939393939394
Control.SRR15539824;38;40;0.526315789473684;18;20;0.0263157894736842;0.473684210526316
Control.SRR15539824;34;40;0.529411764705882;16;18;0.0294117647058824;0.470588235294118
Control.SRR15539824;37;40;0.513513513513513;18;19;0.0135135135135135;0.486486486486487
Control.SRR15539824;34;40;0.617647058823529;13;21;0.117647058823529;0.382352941176471
Control.SRR15539824;37;40;0.567567567567568;16;21;0.0675675675675675;0.432432432432432
Control.SRR15539824;40;40;0.575;17;23;0.075;0.425
Control.SRR15539824;40;40;0.375;25;15;0.125;0.375
Control.SRR15539824;36;40;0.527777777777778;17;19;0.0277777777777778;0.472222222222222
Control.SRR15539824;39;40;0.564102564102564;17;22;0.0641025641025641;0.435897435897436
Control.SRR15539824;37;40;0.567567567567568;16;21;0.0675675675675675;0.432432432432432
Control.SRR15539824;40;40;0.5;20;20;0;0.5
Control.SRR15539824;40;40;0.3;28;12;0.2;0.3
Control.SRR15539824;34;40;0.470588235294118;18;16;0.0294117647058824;0.470588235294118
Control.SRR15539824;32;40;0.5625;14;18;0.0625;0.4375
Control.SRR15539824;39;40;0.512820512820513;19;20;0.0128205128205128;0.487179487179487
Control.SRR15539824;33;40;0.575757575757576;14;19;0.0757575757575758;0.424242424242424
Control.SRR15539824;32;40;0.59375;13;19;0.09375;0.40625
Control.SRR15539824;39;40;0.512820512820513;19;20;0.0128205128205128;0.487179487179487
Control.SRR15539824;37;40;0.351351351351351;24;13;0.148648648648649;0.351351351351351
Control.SRR15539824;42;40;0.547619047619048;19;23;0.0476190476190477;0.452380952380952
Control.SRR15539824;33;40;0.272727272727273;24;9;0.227272727272727;0.272727272727273
Control.SRR15539824;34;40;0.411764705882353;20;14;0.0882352941176471;0.411764705882353
Control.SRR15539824;38;40;0.631578947368421;14;24;0.131578947368421;0.368421052631579
Control.SRR15539824;32;40;0.46875;17;15;0.03125;0.46875
Control.SRR15539824;37;40;0.540540540540541;17;20;0.0405405405405406;0.459459459459459
Control.SRR15539824;37;40;0.459459459459459;20;17;0.0405405405405405;0.459459459459459
Control.SRR15539824;42;40;0.5;21;21;0;0.5
Control.SRR15539824;39;40;0.512820512820513;19;20;0.0128205128205128;0.487179487179487
Control.SRR15539824;36;40;0.555555555555556;16;20;0.0555555555555556;0.444444444444444
Control.SRR15539824;36;40;0.583333333333333;15;21;0.0833333333333334;0.416666666666667
Control.SRR15539824;42;40;0.404761904761905;25;17;0.0952380952380952;0.404761904761905
Control.SRR15539824;40;40;0.35;26;14;0.15;0.35
Control.SRR15539824;34;40;0.441176470588235;19;15;0.0588235294117647;0.441176470588235
Control.SRR15539824;37;40;0.405405405405405;22;15;0.0945945945945946;0.405405405405405
Control.SRR15539824;32;40;0.625;12;20;0.125;0.375
Control.SRR15539824;38;40;0.5;19;19;0;0.5
Control.SRR15539824;40;40;0.45;22;18;0.05;0.45
Control.SRR15539824;36;40;0.722222222222222;10;26;0.222222222222222;0.277777777777778
Control.SRR15539824;34;40;0.5;17;17;0;0.5
Control.SRR15539824;36;40;0.5;18;18;0;0.5
Control.SRR15539824;32;40;0.46875;17;15;0.03125;0.46875
Control.SRR15539824;35;40;0.542857142857143;16;19;0.0428571428571428;0.457142857142857
Control.SRR15539824;38;40;0.5;19;19;0;0.5
Control.SRR15539824;34;40;0.529411764705882;16;18;0.0294117647058824;0.470588235294118
Control.SRR15539824;35;40;0.4;21;14;0.1;0.4
Control.SRR15539824;33;40;0.696969696969697;10;23;0.196969696969697;0.303030303030303
Control.SRR15539824;32;40;0.4375;18;14;0.0625;0.4375
Control.SRR15539824;37;40;0.540540540540541;17;20;0.0405405405405406;0.459459459459459
Control.SRR15539824;37;40;0.540540540540541;17;20;0.0405405405405406;0.459459459459459
Control.SRR15539824;41;40;0.463414634146341;22;19;0.0365853658536585;0.463414634146341
Control.SRR15539824;34;40;0.382352941176471;21;13;0.117647058823529;0.382352941176471
Control.SRR15539824;33;40;0.515151515151515;16;17;0.0151515151515151;0.484848484848485
Control.SRR15539824;32;40;0.65625;11;21;0.15625;0.34375
Control.SRR15539824;37;40;0.513513513513513;18;19;0.0135135135135135;0.486486486486487
Control.SRR15539824;39;40;0.358974358974359;25;14;0.141025641025641;0.358974358974359
Control.SRR15539824;39;40;0.435897435897436;22;17;0.0641025641025641;0.435897435897436
Control.SRR15539824;36;40;0.694444444444444;11;25;0.194444444444444;0.305555555555556
Control.SRR15539824;35;40;0.514285714285714;17;18;0.0142857142857142;0.485714285714286
Control.SRR15539824;37;40;0.594594594594595;15;22;0.0945945945945946;0.405405405405405
Control.SRR15539824;35;40;0.4;21;14;0.1;0.4
Control.SRR15539824;37;40;0.459459459459459;20;17;0.0405405405405405;0.459459459459459
Control.SRR15539824;32;40;0.4375;18;14;0.0625;0.4375
Control.SRR15539824;36;40;0.444444444444444;20;16;0.0555555555555556;0.444444444444444
Control.SRR15539824;40;40;0.475;21;19;0.025;0.475
Control.SRR15539824;40;40;0.625;15;25;0.125;0.375
Control.SRR15539824;37;40;0.432432432432432;21;16;0.0675675675675675;0.432432432432432
Control.SRR15539824;34;40;0.470588235294118;18;16;0.0294117647058824;0.470588235294118
Control.SRR15539824;41;40;0.439024390243902;23;18;0.0609756097560976;0.439024390243902
Control.SRR15539824;39;40;0.641025641025641;14;25;0.141025641025641;0.358974358974359
Control.SRR15539824;40;40;0.525;19;21;0.025;0.475
Control.SRR15539824;38;40;0.526315789473684;18;20;0.0263157894736842;0.473684210526316
Control.SRR15539824;34;40;0.529411764705882;16;18;0.0294117647058824;0.470588235294118
Control.SRR15539824;42;40;0.404761904761905;25;17;0.0952380952380952;0.404761904761905
Control.SRR15539824;34;40;0.558823529411765;15;19;0.0588235294117647;0.441176470588235
Control.SRR15539824;37;40;0.567567567567568;16;21;0.0675675675675675;0.432432432432432
Control.SRR15539824;42;40;0.452380952380952;23;19;0.0476190476190476;0.452380952380952
Control.SRR15539824;39;40;0.435897435897436;22;17;0.0641025641025641;0.435897435897436
Control.SRR15539824;40;40;0.425;23;17;0.075;0.425
Control.SRR15539824;37;40;0.432432432432432;21;16;0.0675675675675675;0.432432432432432
Control.SRR15539824;35;40;0.485714285714286;18;17;0.0142857142857143;0.485714285714286
Control.SRR15539824;41;40;0.390243902439024;25;16;0.109756097560976;0.390243902439024
Control.SRR15539824;38;40;0.473684210526316;20;18;0.0263157894736842;0.473684210526316
Control.SRR15539824;41;40;0.536585365853659;19;22;0.0365853658536586;0.463414634146341
Control.SRR15539824;42;40;0.476190476190476;22;20;0.0238095238095238;0.476190476190476
Control.SRR15539824;34;40;0.411764705882353;20;14;0.0882352941176471;0.411764705882353
Control.SRR15539824;37;40;0.486486486486487;19;18;0.0135135135135135;0.486486486486487
Control.SRR15539824;33;40;0.424242424242424;19;14;0.0757575757575757;0.424242424242424
Control.SRR15539824;37;40;0.432432432432432;21;16;0.0675675675675675;0.432432432432432
Control.SRR15539824;39;40;0.512820512820513;19;20;0.0128205128205128;0.487179487179487
Control.SRR15539824;38;40;0.394736842105263;23;15;0.105263157894737;0.394736842105263
Control.SRR15539824;38;40;0.447368421052632;21;17;0.0526315789473684;0.447368421052632
Control.SRR15539824;42;40;0.619047619047619;16;26;0.119047619047619;0.380952380952381
Control.SRR15539824;37;40;0.486486486486487;19;18;0.0135135135135135;0.486486486486487
Control.SRR15539824;33;40;0.484848484848485;17;16;0.0151515151515151;0.484848484848485
Control.SRR15539824;41;40;0.365853658536585;26;15;0.134146341463415;0.365853658536585
Control.SRR15539824;41;40;0.414634146341463;24;17;0.0853658536585366;0.414634146341463
Control.SRR15539824;41;40;0.292682926829268;29;12;0.207317073170732;0.292682926829268
Control.SRR15539824;42;40;0.380952380952381;26;16;0.119047619047619;0.380952380952381
Control.SRR15539824;36;40;0.444444444444444;20;16;0.0555555555555556;0.444444444444444
Control.SRR15539824;42;40;0.476190476190476;22;20;0.0238095238095238;0.476190476190476
Control.SRR15539824;41;40;0.414634146341463;24;17;0.0853658536585366;0.414634146341463
Control.SRR15539824;34;40;0.588235294117647;14;20;0.0882352941176471;0.411764705882353
Control.SRR15539824;34;40;0.558823529411765;15;19;0.0588235294117647;0.441176470588235
Control.SRR15539824;33;40;0.484848484848485;17;16;0.0151515151515151;0.484848484848485
Control.SRR15539824;40;40;0.5;20;20;0;0.5
Control.SRR15539824;36;40;0.555555555555556;16;20;0.0555555555555556;0.444444444444444
Control.SRR15539824;36;40;0.583333333333333;15;21;0.0833333333333334;0.416666666666667
Control.SRR15539824;37;40;0.459459459459459;20;17;0.0405405405405405;0.459459459459459
Control.SRR15539824;39;40;0.461538461538462;21;18;0.0384615384615384;0.461538461538462
Control.SRR15539824;39;40;0.538461538461538;18;21;0.0384615384615384;0.461538461538462
Control.SRR15539824;34;40;0.617647058823529;13;21;0.117647058823529;0.382352941176471
Control.SRR15539824;32;40;0.53125;15;17;0.03125;0.46875
Control.SRR15539824;39;40;0.538461538461538;18;21;0.0384615384615384;0.461538461538462
Control.SRR15539824;40;40;0.575;17;23;0.075;0.425
Control.SRR15539824;36;40;0.5;18;18;0;0.5
Control.SRR15539824;37;40;0.594594594594595;15;22;0.0945945945945946;0.405405405405405
Control.SRR15539824;40;40;0.675;13;27;0.175;0.325
Control.SRR15539824;35;40;0.4;21;14;0.1;0.4
Control.SRR15539824;38;40;0.447368421052632;21;17;0.0526315789473684;0.447368421052632
Control.SRR15539824;40;40;0.5;20;20;0;0.5
Control.SRR15539824;32;40;0.5625;14;18;0.0625;0.4375
Control.SRR15539824;35;40;0.6;14;21;0.1;0.4
Control.SRR15539824;33;40;0.393939393939394;20;13;0.106060606060606;0.393939393939394
Control.SRR15539824;40;40;0.375;25;15;0.125;0.375
Control.SRR15539824;38;40;0.605263157894737;15;23;0.105263157894737;0.394736842105263
Control.SRR15539824;39;40;0.487179487179487;20;19;0.0128205128205128;0.487179487179487
Control.SRR15539824;40;40;0.575;17;23;0.075;0.425
Control.SRR15539824;35;40;0.457142857142857;19;16;0.0428571428571429;0.457142857142857
Control.SRR15539824;37;40;0.513513513513513;18;19;0.0135135135135135;0.486486486486487
Control.SRR15539824;35;40;0.514285714285714;17;18;0.0142857142857142;0.485714285714286
Control.SRR15539824;40;40;0.55;18;22;0.05;0.45
Control.SRR15539824;41;40;0.414634146341463;24;17;0.0853658536585366;0.414634146341463
Control.SRR15539824;39;40;0.307692307692308;27;12;0.192307692307692;0.307692307692308
Control.SRR15539824;37;40;0.432432432432432;21;16;0.0675675675675675;0.432432432432432
Control.SRR15539824;34;40;0.5;17;17;0;0.5
Control.SRR15539824;32;40;0.3125;22;10;0.1875;0.3125
Control.SRR15539824;33;40;0.454545454545455;18;15;0.0454545454545455;0.454545454545455
Control.SRR15539824;33;40;0.575757575757576;14;19;0.0757575757575758;0.424242424242424
Control.SRR15539824;35;40;0.628571428571429;13;22;0.128571428571429;0.371428571428571
Control.SRR15539824;41;40;0.48780487804878;21;20;0.0121951219512195;0.48780487804878
Control.SRR15539824;39;40;0.282051282051282;28;11;0.217948717948718;0.282051282051282
Control.SRR15539824;35;40;0.6;14;21;0.1;0.4
Control.SRR15539824;41;40;0.536585365853659;19;22;0.0365853658536586;0.463414634146341
Control.SRR15539824;39;40;0.358974358974359;25;14;0.141025641025641;0.358974358974359
Control.SRR15539824;41;40;0.439024390243902;23;18;0.0609756097560976;0.439024390243902
Control.SRR15539824;34;40;0.470588235294118;18;16;0.0294117647058824;0.470588235294118
Control.SRR15539824;36;40;0.472222222222222;19;17;0.0277777777777778;0.472222222222222
Control.SRR15539824;34;40;0.470588235294118;18;16;0.0294117647058824;0.470588235294118
Control.SRR15539824;42;40;0.428571428571429;24;18;0.0714285714285715;0.428571428571429
Control.SRR15539824;40;40;0.525;19;21;0.025;0.475
Control.SRR15539824;40;40;0.525;19;21;0.025;0.475
Control.SRR15539824;34;40;0.529411764705882;16;18;0.0294117647058824;0.470588235294118
Control.SRR15539824;41;40;0.658536585365854;14;27;0.158536585365854;0.341463414634146
Control.SRR15539824;35;40;0.371428571428571;22;13;0.128571428571429;0.371428571428571
Control.SRR15539824;35;40;0.428571428571429;20;15;0.0714285714285715;0.428571428571429
Control.SRR15539824;33;40;0.727272727272727;9;24;0.227272727272727;0.272727272727273
Control.SRR15539824;33;40;0.424242424242424;19;14;0.0757575757575757;0.424242424242424
Control.SRR15539824;40;40;0.45;22;18;0.05;0.45
Control.SRR15539824;37;40;0.486486486486487;19;18;0.0135135135135135;0.486486486486487
Control.SRR15539824;41;40;0.48780487804878;21;20;0.0121951219512195;0.48780487804878
Control.SRR15539824;41;40;0.341463414634146;27;14;0.158536585365854;0.341463414634146
Control.SRR15539824;41;40;0.536585365853659;19;22;0.0365853658536586;0.463414634146341
Control.SRR15539824;37;40;0.540540540540541;17;20;0.0405405405405406;0.459459459459459
Control.SRR15539824;35;40;0.457142857142857;19;16;0.0428571428571429;0.457142857142857
Control.SRR15539824;35;40;0.6;14;21;0.1;0.4
Control.SRR15539824;34;40;0.441176470588235;19;15;0.0588235294117647;0.441176470588235
Control.SRR15539824;34;40;0.617647058823529;13;21;0.117647058823529;0.382352941176471
Control.SRR15539824;37;40;0.432432432432432;21;16;0.0675675675675675;0.432432432432432
Control.SRR15539824;35;40;0.571428571428571;15;20;0.0714285714285714;0.428571428571429
Control.SRR15539824;39;40;0.435897435897436;22;17;0.0641025641025641;0.435897435897436
Control.SRR15539824;39;40;0.564102564102564;17;22;0.0641025641025641;0.435897435897436
Control.SRR15539824;39;40;0.461538461538462;21;18;0.0384615384615384;0.461538461538462
Control.SRR15539824;36;40;0.444444444444444;20;16;0.0555555555555556;0.444444444444444
Control.SRR15539824;34;40;0.470588235294118;18;16;0.0294117647058824;0.470588235294118
Control.SRR15539824;37;40;0.432432432432432;21;16;0.0675675675675675;0.432432432432432
Control.SRR15539824;40;40;0.55;18;22;0.05;0.45
Control.SRR15539824;34;40;0.647058823529412;12;22;0.147058823529412;0.352941176470588
Control.SRR15539824;38;40;0.5;19;19;0;0.5
Control.SRR15539824;34;40;0.647058823529412;12;22;0.147058823529412;0.352941176470588
Control.SRR15539824;39;40;0.58974358974359;16;23;0.0897435897435898;0.41025641025641
Control.SRR15539824;34;40;0.352941176470588;22;12;0.147058823529412;0.352941176470588
Control.SRR15539824;38;40;0.605263157894737;15;23;0.105263157894737;0.394736842105263
Control.SRR15539824;34;40;0.588235294117647;14;20;0.0882352941176471;0.411764705882353
Control.SRR15539824;41;40;0.439024390243902;23;18;0.0609756097560976;0.439024390243902
Control.SRR15539824;39;40;0.41025641025641;23;16;0.0897435897435898;0.41025641025641
Control.SRR15539824;36;40;0.527777777777778;17;19;0.0277777777777778;0.472222222222222
Control.SRR15539824;36;40;0.388888888888889;22;14;0.111111111111111;0.388888888888889
Control.SRR15539824;42;40;0.547619047619048;19;23;0.0476190476190477;0.452380952380952
Control.SRR15539824;34;40;0.470588235294118;18;16;0.0294117647058824;0.470588235294118
Control.SRR15539824;35;40;0.6;14;21;0.1;0.4
Control.SRR15539824;33;40;0.393939393939394;20;13;0.106060606060606;0.393939393939394
Control.SRR15539824;33;40;0.575757575757576;14;19;0.0757575757575758;0.424242424242424
Control.SRR15539824;42;40;0.5;21;21;0;0.5
Control.SRR15539824;34;40;0.558823529411765;15;19;0.0588235294117647;0.441176470588235
Control.SRR15539824;39;40;0.435897435897436;22;17;0.0641025641025641;0.435897435897436
Control.SRR15539824;39;40;0.461538461538462;21;18;0.0384615384615384;0.461538461538462
Control.SRR15539824;39;40;0.461538461538462;21;18;0.0384615384615384;0.461538461538462
Control.SRR15539824;41;40;0.439024390243902;23;18;0.0609756097560976;0.439024390243902
Control.SRR15539824;40;40;0.55;18;22;0.05;0.45
Control.SRR15539824;34;40;0.5;17;17;0;0.5
Control.SRR15539824;36;40;0.5;18;18;0;0.5
Control.SRR15539824;34;40;0.529411764705882;16;18;0.0294117647058824;0.470588235294118
Control.SRR15539824;37;40;0.567567567567568;16;21;0.0675675675675675;0.432432432432432
Control.SRR15539824;38;40;0.5;19;19;0;0.5
Control.SRR15539824;32;40;0.53125;15;17;0.03125;0.46875
Control.SRR15539824;37;40;0.702702702702703;11;26;0.202702702702703;0.297297297297297
Control.SRR15539824;40;40;0.475;21;19;0.025;0.475
Control.SRR15539824;35;40;0.514285714285714;17;18;0.0142857142857142;0.485714285714286
Control.SRR15539824;37;40;0.405405405405405;22;15;0.0945945945945946;0.405405405405405
Control.SRR15539824;38;40;0.447368421052632;21;17;0.0526315789473684;0.447368421052632
Control.SRR15539824;34;40;0.5;17;17;0;0.5
Control.SRR15539824;36;40;0.555555555555556;16;20;0.0555555555555556;0.444444444444444
Control.SRR15539824;36;40;0.555555555555556;16;20;0.0555555555555556;0.444444444444444
Control.SRR15539824;36;40;0.5;18;18;0;0.5
Control.SRR15539824;37;40;0.405405405405405;22;15;0.0945945945945946;0.405405405405405
Control.SRR15539824;34;40;0.264705882352941;25;9;0.235294117647059;0.264705882352941
Control.SRR15539824;39;40;0.384615384615385;24;15;0.115384615384615;0.384615384615385
Control.SRR15539824;42;40;0.738095238095238;11;31;0.238095238095238;0.261904761904762
Control.SRR15539824;37;40;0.567567567567568;16;21;0.0675675675675675;0.432432432432432
Control.SRR15539824;36;40;0.611111111111111;14;22;0.111111111111111;0.388888888888889
Control.SRR15539824;40;40;0.4;24;16;0.1;0.4
Control.SRR15539824;35;40;0.514285714285714;17;18;0.0142857142857142;0.485714285714286
Control.SRR15539824;36;40;0.472222222222222;19;17;0.0277777777777778;0.472222222222222
Control.SRR15539824;37;40;0.567567567567568;16;21;0.0675675675675675;0.432432432432432
Control.SRR15539824;34;40;0.441176470588235;19;15;0.0588235294117647;0.441176470588235
Control.SRR15539824;35;40;0.371428571428571;22;13;0.128571428571429;0.371428571428571
Control.SRR15539824;36;40;0.583333333333333;15;21;0.0833333333333334;0.416666666666667
Control.SRR15539824;42;40;0.428571428571429;24;18;0.0714285714285715;0.428571428571429
Control.SRR15539824;41;40;0.780487804878049;9;32;0.280487804878049;0.219512195121951
Control.SRR15539824;40;40;0.525;19;21;0.025;0.475
Control.SRR15539824;36;40;0.388888888888889;22;14;0.111111111111111;0.388888888888889
Control.SRR15539824;37;40;0.621621621621622;14;23;0.121621621621622;0.378378378378378
Control.SRR15539824;39;40;0.487179487179487;20;19;0.0128205128205128;0.487179487179487
Control.SRR15539824;35;40;0.6;14;21;0.1;0.4
Control.SRR15539824;33;40;0.515151515151515;16;17;0.0151515151515151;0.484848484848485
Control.SRR15539824;40;40;0.45;22;18;0.05;0.45
Control.SRR15539824;36;40;0.583333333333333;15;21;0.0833333333333334;0.416666666666667
Control.SRR15539824;36;40;0.666666666666667;12;24;0.166666666666667;0.333333333333333
Control.SRR15539824;34;40;0.5;17;17;0;0.5
Control.SRR15539824;32;40;0.5;16;16;0;0.5
Control.SRR15539824;36;40;0.527777777777778;17;19;0.0277777777777778;0.472222222222222
Control.SRR15539824;38;40;0.578947368421053;16;22;0.0789473684210527;0.421052631578947
Control.SRR15539824;41;40;0.51219512195122;20;21;0.0121951219512195;0.48780487804878
Control.SRR15539824;40;40;0.5;20;20;0;0.5
Control.SRR15539824;35;40;0.571428571428571;15;20;0.0714285714285714;0.428571428571429
Control.SRR15539824;35;40;0.542857142857143;16;19;0.0428571428571428;0.457142857142857
Control.SRR15539824;38;40;0.289473684210526;27;11;0.210526315789474;0.289473684210526
Control.SRR15539824;33;40;0.575757575757576;14;19;0.0757575757575758;0.424242424242424
Control.SRR15539824;41;40;0.51219512195122;20;21;0.0121951219512195;0.48780487804878
Control.SRR15539824;37;40;0.567567567567568;16;21;0.0675675675675675;0.432432432432432
Control.SRR15539824;42;40;0.642857142857143;15;27;0.142857142857143;0.357142857142857
Control.SRR15539824;39;40;0.58974358974359;16;23;0.0897435897435898;0.41025641025641
Control.SRR15539824;41;40;0.560975609756098;18;23;0.0609756097560976;0.439024390243902
Control.SRR15539824;37;40;0.513513513513513;18;19;0.0135135135135135;0.486486486486487
Control.SRR15539824;33;40;0.515151515151515;16;17;0.0151515151515151;0.484848484848485
Control.SRR15539824;33;40;0.727272727272727;9;24;0.227272727272727;0.272727272727273
Control.SRR15539824;39;40;0.461538461538462;21;18;0.0384615384615384;0.461538461538462
Control.SRR15539824;37;40;0.621621621621622;14;23;0.121621621621622;0.378378378378378
Control.SRR15539824;39;40;0.358974358974359;25;14;0.141025641025641;0.358974358974359
Control.SRR15539824;37;40;0.594594594594595;15;22;0.0945945945945946;0.405405405405405
Control.SRR15539824;42;40;0.547619047619048;19;23;0.0476190476190477;0.452380952380952
Control.SRR15539824;42;40;0.404761904761905;25;17;0.0952380952380952;0.404761904761905
Control.SRR15539824;34;40;0.529411764705882;16;18;0.0294117647058824;0.470588235294118
Control.SRR15539824;41;40;0.439024390243902;23;18;0.0609756097560976;0.439024390243902
Control.SRR15539824;35;40;0.657142857142857;12;23;0.157142857142857;0.342857142857143
Control.SRR15539824;39;40;0.487179487179487;20;19;0.0128205128205128;0.487179487179487
Control.SRR15539824;38;40;0.552631578947368;17;21;0.0526315789473685;0.447368421052632
Control.SRR15539824;42;40;0.595238095238095;17;25;0.0952380952380952;0.404761904761905
Control.SRR15539824;38;40;0.473684210526316;20;18;0.0263157894736842;0.473684210526316
Control.SRR15539824;42;40;0.452380952380952;23;19;0.0476190476190476;0.452380952380952
Control.SRR15539824;38;40;0.526315789473684;18;20;0.0263157894736842;0.473684210526316
Control.SRR15539824;37;40;0.567567567567568;16;21;0.0675675675675675;0.432432432432432
Control.SRR15539824;42;40;0.404761904761905;25;17;0.0952380952380952;0.404761904761905
Control.SRR15539824;40;40;0.6;16;24;0.1;0.4
Control.SRR15539824;39;40;0.538461538461538;18;21;0.0384615384615384;0.461538461538462
Control.SRR15539824;40;40;0.425;23;17;0.075;0.425
Control.SRR15539824;36;40;0.444444444444444;20;16;0.0555555555555556;0.444444444444444
Control.SRR15539824;35;40;0.628571428571429;13;22;0.128571428571429;0.371428571428571
Control.SRR15539824;34;40;0.411764705882353;20;14;0.0882352941176471;0.411764705882353
Control.SRR15539824;42;40;0.428571428571429;24;18;0.0714285714285715;0.428571428571429
Control.SRR15539824;39;40;0.487179487179487;20;19;0.0128205128205128;0.487179487179487
Control.SRR15539824;38;40;0.526315789473684;18;20;0.0263157894736842;0.473684210526316
Control.SRR15539824;33;40;0.454545454545455;18;15;0.0454545454545455;0.454545454545455
Control.SRR15539824;37;40;0.513513513513513;18;19;0.0135135135135135;0.486486486486487
Control.SRR15539824;32;40;0.53125;15;17;0.03125;0.46875
Control.SRR15539824;38;40;0.605263157894737;15;23;0.105263157894737;0.394736842105263
Control.SRR15539824;39;40;0.512820512820513;19;20;0.0128205128205128;0.487179487179487
Control.SRR15539824;42;40;0.619047619047619;16;26;0.119047619047619;0.380952380952381
Control.SRR15539824;40;40;0.475;21;19;0.025;0.475
Control.SRR15539824;33;40;0.363636363636364;21;12;0.136363636363636;0.363636363636364
Control.SRR15539824;34;40;0.411764705882353;20;14;0.0882352941176471;0.411764705882353
Control.SRR15539824;41;40;0.609756097560976;16;25;0.109756097560976;0.390243902439024
Control.SRR15539824;35;40;0.628571428571429;13;22;0.128571428571429;0.371428571428571
Control.SRR15539824;38;40;0.421052631578947;22;16;0.0789473684210527;0.421052631578947
Control.SRR15539824;39;40;0.564102564102564;17;22;0.0641025641025641;0.435897435897436
Control.SRR15539824;41;40;0.585365853658537;17;24;0.0853658536585366;0.414634146341463
Control.SRR15539824;33;40;0.484848484848485;17;16;0.0151515151515151;0.484848484848485
Control.SRR15539824;34;40;0.5;17;17;0;0.5
Control.SRR15539824;36;40;0.5;18;18;0;0.5
Control.SRR15539824;36;40;0.444444444444444;20;16;0.0555555555555556;0.444444444444444
Control.SRR15539824;36;40;0.416666666666667;21;15;0.0833333333333333;0.416666666666667
Control.SRR15539824;42;40;0.428571428571429;24;18;0.0714285714285715;0.428571428571429
Control.SRR15539824;36;40;0.472222222222222;19;17;0.0277777777777778;0.472222222222222
Control.SRR15539824;32;40;0.375;20;12;0.125;0.375
Control.SRR15539824;36;40;0.388888888888889;22;14;0.111111111111111;0.388888888888889
Control.SRR15539824;33;40;0.545454545454545;15;18;0.0454545454545454;0.454545454545455
Control.SRR15539824;41;40;0.707317073170732;12;29;0.207317073170732;0.292682926829268
Control.SRR15539824;38;40;0.605263157894737;15;23;0.105263157894737;0.394736842105263
Control.SRR15539824;40;40;0.425;23;17;0.075;0.425
Control.SRR15539824;39;40;0.58974358974359;16;23;0.0897435897435898;0.41025641025641
Control.SRR15539824;41;40;0.439024390243902;23;18;0.0609756097560976;0.439024390243902
Control.SRR15539824;39;40;0.461538461538462;21;18;0.0384615384615384;0.461538461538462
Control.SRR15539824;39;40;0.307692307692308;27;12;0.192307692307692;0.307692307692308
Control.SRR15539824;40;40;0.375;25;15;0.125;0.375
Control.SRR15539824;35;40;0.542857142857143;16;19;0.0428571428571428;0.457142857142857
Control.SRR15539824;33;40;0.424242424242424;19;14;0.0757575757575757;0.424242424242424
Control.SRR15539824;37;40;0.594594594594595;15;22;0.0945945945945946;0.405405405405405
Control.SRR15539824;32;40;0.65625;11;21;0.15625;0.34375
Control.SRR15539824;36;40;0.527777777777778;17;19;0.0277777777777778;0.472222222222222
Control.SRR15539824;36;40;0.416666666666667;21;15;0.0833333333333333;0.416666666666667
Control.SRR15539824;32;40;0.5;16;16;0;0.5
Control.SRR15539824;40;40;0.525;19;21;0.025;0.475
Control.SRR15539824;42;40;0.452380952380952;23;19;0.0476190476190476;0.452380952380952
Control.SRR15539824;42;40;0.404761904761905;25;17;0.0952380952380952;0.404761904761905
Control.SRR15539824;35;40;0.542857142857143;16;19;0.0428571428571428;0.457142857142857
Control.SRR15539824;36;40;0.527777777777778;17;19;0.0277777777777778;0.472222222222222
Control.SRR15539824;39;40;0.641025641025641;14;25;0.141025641025641;0.358974358974359
Control.SRR15539824;42;40;0.595238095238095;17;25;0.0952380952380952;0.404761904761905
Control.SRR15539824;42;40;0.619047619047619;16;26;0.119047619047619;0.380952380952381
Control.SRR15539824;41;40;0.609756097560976;16;25;0.109756097560976;0.390243902439024
Control.SRR15539824;40;40;0.475;21;19;0.025;0.475
Control.SRR15539824;40;40;0.5;20;20;0;0.5
Control.SRR15539824;40;40;0.425;23;17;0.075;0.425
Control.SRR15539824;42;40;0.547619047619048;19;23;0.0476190476190477;0.452380952380952
Control.SRR15539824;41;40;0.341463414634146;27;14;0.158536585365854;0.341463414634146
Control.SRR15539824;35;40;0.514285714285714;17;18;0.0142857142857142;0.485714285714286
Control.SRR15539824;37;40;0.513513513513513;18;19;0.0135135135135135;0.486486486486487
Control.SRR15539824;35;40;0.428571428571429;20;15;0.0714285714285715;0.428571428571429
Control.SRR15539824;36;40;0.611111111111111;14;22;0.111111111111111;0.388888888888889
Control.SRR15539824;36;40;0.555555555555556;16;20;0.0555555555555556;0.444444444444444
Control.SRR15539824;42;40;0.5;21;21;0;0.5
Control.SRR15539824;35;40;0.571428571428571;15;20;0.0714285714285714;0.428571428571429
Control.SRR15539824;41;40;0.560975609756098;18;23;0.0609756097560976;0.439024390243902
Control.SRR15539824;34;40;0.588235294117647;14;20;0.0882352941176471;0.411764705882353
Control.SRR15539824;38;40;0.473684210526316;20;18;0.0263157894736842;0.473684210526316
Control.SRR15539824;39;40;0.512820512820513;19;20;0.0128205128205128;0.487179487179487
Control.SRR15539824;34;40;0.441176470588235;19;15;0.0588235294117647;0.441176470588235
Control.SRR15539824;32;40;0.53125;15;17;0.03125;0.46875
Control.SRR15539824;34;40;0.5;17;17;0;0.5
Control.SRR15539824;39;40;0.435897435897436;22;17;0.0641025641025641;0.435897435897436
Control.SRR15539824;41;40;0.341463414634146;27;14;0.158536585365854;0.341463414634146
Control.SRR15539824;40;40;0.5;20;20;0;0.5
Control.SRR15539824;32;40;0.5625;14;18;0.0625;0.4375
Control.SRR15539824;40;40;0.45;22;18;0.05;0.45
Control.SRR15539824;42;40;0.619047619047619;16;26;0.119047619047619;0.380952380952381
Control.SRR15539824;36;40;0.527777777777778;17;19;0.0277777777777778;0.472222222222222
Control.SRR15539824;34;40;0.588235294117647;14;20;0.0882352941176471;0.411764705882353
Control.SRR15539824;42;40;0.571428571428571;18;24;0.0714285714285714;0.428571428571429
Control.SRR15539824;38;40;0.605263157894737;15;23;0.105263157894737;0.394736842105263
Control.SRR15539824;41;40;0.48780487804878;21;20;0.0121951219512195;0.48780487804878
Control.SRR15539824;35;40;0.514285714285714;17;18;0.0142857142857142;0.485714285714286
Control.SRR15539824;38;40;0.5;19;19;0;0.5
Control.SRR15539824;33;40;0.545454545454545;15;18;0.0454545454545454;0.454545454545455
Control.SRR15539824;42;40;0.476190476190476;22;20;0.0238095238095238;0.476190476190476
Control.SRR15539824;34;40;0.382352941176471;21;13;0.117647058823529;0.382352941176471
Control.SRR15539824;33;40;0.545454545454545;15;18;0.0454545454545454;0.454545454545455
Control.SRR15539824;42;40;0.380952380952381;26;16;0.119047619047619;0.380952380952381
Control.SRR15539824;40;40;0.4;24;16;0.1;0.4
Control.SRR15539824;41;40;0.560975609756098;18;23;0.0609756097560976;0.439024390243902
Control.SRR15539824;32;40;0.5625;14;18;0.0625;0.4375
Control.SRR15539824;37;40;0.432432432432432;21;16;0.0675675675675675;0.432432432432432
Control.SRR15539824;36;40;0.555555555555556;16;20;0.0555555555555556;0.444444444444444
Control.SRR15539824;41;40;0.48780487804878;21;20;0.0121951219512195;0.48780487804878
Control.SRR15539824;42;40;0.523809523809524;20;22;0.0238095238095238;0.476190476190476
Control.SRR15539824;41;40;0.439024390243902;23;18;0.0609756097560976;0.439024390243902
Control.SRR15539824;39;40;0.564102564102564;17;22;0.0641025641025641;0.435897435897436
Control.SRR15539824;38;40;0.605263157894737;15;23;0.105263157894737;0.394736842105263
Control.SRR15539824;41;40;0.463414634146341;22;19;0.0365853658536585;0.463414634146341
Control.SRR15539824;40;40;0.475;21;19;0.025;0.475
Control.SRR15539824;37;40;0.486486486486487;19;18;0.0135135135135135;0.486486486486487
Control.SRR15539824;33;40;0.606060606060606;13;20;0.106060606060606;0.393939393939394
Control.SRR15539824;33;40;0.484848484848485;17;16;0.0151515151515151;0.484848484848485
Control.SRR15539824;37;40;0.405405405405405;22;15;0.0945945945945946;0.405405405405405
Control.SRR15539824;32;40;0.5;16;16;0;0.5
Control.SRR15539824;42;40;0.547619047619048;19;23;0.0476190476190477;0.452380952380952
Control.SRR15539824;37;40;0.486486486486487;19;18;0.0135135135135135;0.486486486486487
Control.SRR15539824;41;40;0.634146341463415;15;26;0.134146341463415;0.365853658536585
Control.SRR15539824;34;40;0.411764705882353;20;14;0.0882352941176471;0.411764705882353
Control.SRR15539824;34;40;0.441176470588235;19;15;0.0588235294117647;0.441176470588235
Control.SRR15539824;32;40;0.5;16;16;0;0.5
Control.SRR15539824;38;40;0.447368421052632;21;17;0.0526315789473684;0.447368421052632
Control.SRR15539824;38;40;0.447368421052632;21;17;0.0526315789473684;0.447368421052632
Control.SRR15539824;40;40;0.5;20;20;0;0.5
Control.SRR15539824;39;40;0.58974358974359;16;23;0.0897435897435898;0.41025641025641
Control.SRR15539824;39;40;0.435897435897436;22;17;0.0641025641025641;0.435897435897436
Control.SRR15539824;41;40;0.51219512195122;20;21;0.0121951219512195;0.48780487804878
Control.SRR15539824;36;40;0.527777777777778;17;19;0.0277777777777778;0.472222222222222
Control.SRR15539824;34;40;0.529411764705882;16;18;0.0294117647058824;0.470588235294118
Control.SRR15539824;42;40;0.357142857142857;27;15;0.142857142857143;0.357142857142857
Control.SRR15539824;35;40;0.485714285714286;18;17;0.0142857142857143;0.485714285714286
Control.SRR15539824;37;40;0.513513513513513;18;19;0.0135135135135135;0.486486486486487
Control.SRR15539824;41;40;0.414634146341463;24;17;0.0853658536585366;0.414634146341463
Control.SRR15539824;37;40;0.540540540540541;17;20;0.0405405405405406;0.459459459459459
Control.SRR15539824;33;40;0.484848484848485;17;16;0.0151515151515151;0.484848484848485
Control.SRR15539824;38;40;0.526315789473684;18;20;0.0263157894736842;0.473684210526316
Control.SRR15539824;39;40;0.512820512820513;19;20;0.0128205128205128;0.487179487179487
Control.SRR15539824;42;40;0.5;21;21;0;0.5
Control.SRR15539824;41;40;0.609756097560976;16;25;0.109756097560976;0.390243902439024
Control.SRR15539824;40;40;0.475;21;19;0.025;0.475
Control.SRR15539824;35;40;0.514285714285714;17;18;0.0142857142857142;0.485714285714286
Control.SRR15539824;33;40;0.454545454545455;18;15;0.0454545454545455;0.454545454545455
Control.SRR15539824;32;40;0.34375;21;11;0.15625;0.34375
Control.SRR15539824;35;40;0.571428571428571;15;20;0.0714285714285714;0.428571428571429
Control.SRR15539824;47;40;0.659574468085106;16;31;0.159574468085106;0.340425531914894
Control.SRR15539824;41;40;0.585365853658537;17;24;0.0853658536585366;0.414634146341463
Control.SRR15539824;37;40;0.540540540540541;17;20;0.0405405405405406;0.459459459459459
Control.SRR15539824;40;40;0.45;22;18;0.05;0.45
Control.SRR15539824;47;40;0.468085106382979;25;22;0.0319148936170213;0.468085106382979
Control.SRR15539824;36;40;0.472222222222222;19;17;0.0277777777777778;0.472222222222222
Control.SRR15539824;35;40;0.542857142857143;16;19;0.0428571428571428;0.457142857142857
Control.SRR15539824;43;40;0.372093023255814;27;16;0.127906976744186;0.372093023255814
Control.SRR15539824;42;40;0.5;21;21;0;0.5
Control.SRR15539824;47;40;0.446808510638298;26;21;0.0531914893617021;0.446808510638298
Control.SRR15539824;41;40;0.439024390243902;23;18;0.0609756097560976;0.439024390243902
Control.SRR15539824;39;40;0.512820512820513;19;20;0.0128205128205128;0.487179487179487
Control.SRR15539824;47;40;0.425531914893617;27;20;0.074468085106383;0.425531914893617
Control.SRR15539824;41;40;0.658536585365854;14;27;0.158536585365854;0.341463414634146
Control.SRR15539824;36;40;0.472222222222222;19;17;0.0277777777777778;0.472222222222222
Control.SRR15539824;35;40;0.6;14;21;0.1;0.4
Control.SRR15539824;40;40;0.65;14;26;0.15;0.35
Control.SRR15539824;42;40;0.404761904761905;25;17;0.0952380952380952;0.404761904761905
Control.SRR15539824;43;40;0.604651162790698;17;26;0.104651162790698;0.395348837209302
Control.SRR15539824;43;40;0.441860465116279;24;19;0.0581395348837209;0.441860465116279
Control.SRR15539824;40;40;0.55;18;22;0.05;0.45
Control.SRR15539824;38;40;0.526315789473684;18;20;0.0263157894736842;0.473684210526316
Control.SRR15539824;40;40;0.575;17;23;0.075;0.425
Control.SRR15539824;38;40;0.578947368421053;16;22;0.0789473684210527;0.421052631578947
Control.SRR15539824;37;40;0.567567567567568;16;21;0.0675675675675675;0.432432432432432
Control.SRR15539824;39;40;0.58974358974359;16;23;0.0897435897435898;0.41025641025641
Control.SRR15539824;37;40;0.378378378378378;23;14;0.121621621621622;0.378378378378378
Control.SRR15539824;43;40;0.534883720930233;20;23;0.0348837209302325;0.465116279069767
Control.SRR15539824;39;40;0.435897435897436;22;17;0.0641025641025641;0.435897435897436
Control.SRR15539824;41;40;0.609756097560976;16;25;0.109756097560976;0.390243902439024
Control.SRR15539824;39;40;0.564102564102564;17;22;0.0641025641025641;0.435897435897436
Control.SRR15539824;45;40;0.311111111111111;31;14;0.188888888888889;0.311111111111111
Control.SRR15539824;39;40;0.487179487179487;20;19;0.0128205128205128;0.487179487179487
Control.SRR15539824;47;40;0.51063829787234;23;24;0.0106382978723404;0.48936170212766
Control.SRR15539824;36;40;0.583333333333333;15;21;0.0833333333333334;0.416666666666667
Control.SRR15539824;46;40;0.304347826086957;32;14;0.195652173913043;0.304347826086957
Control.SRR15539824;38;40;0.342105263157895;25;13;0.157894736842105;0.342105263157895
Control.SRR15539824;43;40;0.534883720930233;20;23;0.0348837209302325;0.465116279069767
Control.SRR15539824;37;40;0.486486486486487;19;18;0.0135135135135135;0.486486486486487
Control.SRR15539824;37;40;0.378378378378378;23;14;0.121621621621622;0.378378378378378
Control.SRR15539824;46;40;0.5;23;23;0;0.5
Control.SRR15539824;39;40;0.333333333333333;26;13;0.166666666666667;0.333333333333333
Control.SRR15539824;42;40;0.428571428571429;24;18;0.0714285714285715;0.428571428571429
Control.SRR15539824;39;40;0.615384615384615;15;24;0.115384615384615;0.384615384615385
Control.SRR15539824;38;40;0.526315789473684;18;20;0.0263157894736842;0.473684210526316
Control.SRR15539824;39;40;0.615384615384615;15;24;0.115384615384615;0.384615384615385
Control.SRR15539824;39;40;0.538461538461538;18;21;0.0384615384615384;0.461538461538462
Control.SRR15539824;38;40;0.473684210526316;20;18;0.0263157894736842;0.473684210526316
Control.SRR15539824;42;40;0.5;21;21;0;0.5
Control.SRR15539824;38;40;0.578947368421053;16;22;0.0789473684210527;0.421052631578947
Control.SRR15539824;37;40;0.540540540540541;17;20;0.0405405405405406;0.459459459459459
Control.SRR15539824;35;40;0.428571428571429;20;15;0.0714285714285715;0.428571428571429
Control.SRR15539824;39;40;0.512820512820513;19;20;0.0128205128205128;0.487179487179487
Control.SRR15539824;37;40;0.486486486486487;19;18;0.0135135135135135;0.486486486486487
Control.SRR15539824;45;40;0.6;18;27;0.1;0.4
Control.SRR15539824;36;40;0.333333333333333;24;12;0.166666666666667;0.333333333333333
Control.SRR15539824;36;40;0.638888888888889;13;23;0.138888888888889;0.361111111111111
Control.SRR15539824;36;40;0.388888888888889;22;14;0.111111111111111;0.388888888888889
Control.SRR15539824;39;40;0.58974358974359;16;23;0.0897435897435898;0.41025641025641
Control.SRR15539824;40;40;0.45;22;18;0.05;0.45
Control.SRR15539824;35;40;0.485714285714286;18;17;0.0142857142857143;0.485714285714286
Control.SRR15539824;40;40;0.525;19;21;0.025;0.475
Control.SRR15539824;39;40;0.538461538461538;18;21;0.0384615384615384;0.461538461538462
Control.SRR15539824;45;40;0.577777777777778;19;26;0.0777777777777777;0.422222222222222
Control.SRR15539824;40;40;0.6;16;24;0.1;0.4
Control.SRR15539824;45;40;0.4;27;18;0.1;0.4
Control.SRR15539824;44;40;0.522727272727273;21;23;0.0227272727272727;0.477272727272727
Control.SRR15539824;35;40;0.342857142857143;23;12;0.157142857142857;0.342857142857143
Control.SRR15539824;40;40;0.55;18;22;0.05;0.45
Control.SRR15539824;37;40;0.405405405405405;22;15;0.0945945945945946;0.405405405405405
Control.SRR15539824;35;40;0.428571428571429;20;15;0.0714285714285715;0.428571428571429
Control.SRR15539824;47;40;0.446808510638298;26;21;0.0531914893617021;0.446808510638298
Control.SRR15539824;38;40;0.368421052631579;24;14;0.131578947368421;0.368421052631579
Control.SRR15539824;37;40;0.432432432432432;21;16;0.0675675675675675;0.432432432432432
Control.SRR15539824;39;40;0.564102564102564;17;22;0.0641025641025641;0.435897435897436
Control.SRR15539824;41;40;0.439024390243902;23;18;0.0609756097560976;0.439024390243902
Control.SRR15539824;44;40;0.522727272727273;21;23;0.0227272727272727;0.477272727272727
Control.SRR15539824;36;40;0.305555555555556;25;11;0.194444444444444;0.305555555555556
Control.SRR15539824;38;40;0.684210526315789;12;26;0.184210526315789;0.315789473684211
Control.SRR15539824;41;40;0.414634146341463;24;17;0.0853658536585366;0.414634146341463
Control.SRR15539824;45;40;0.6;18;27;0.1;0.4
Control.SRR15539824;43;40;0.325581395348837;29;14;0.174418604651163;0.325581395348837
Control.SRR15539824;39;40;0.538461538461538;18;21;0.0384615384615384;0.461538461538462
Control.SRR15539824;44;40;0.386363636363636;27;17;0.113636363636364;0.386363636363636
Control.SRR15539824;44;40;0.454545454545455;24;20;0.0454545454545455;0.454545454545455
Control.SRR15539824;43;40;0.511627906976744;21;22;0.0116279069767442;0.488372093023256
Control.SRR15539824;43;40;0.627906976744186;16;27;0.127906976744186;0.372093023255814
Control.SRR15539824;43;40;0.604651162790698;17;26;0.104651162790698;0.395348837209302
Control.SRR15539824;43;40;0.581395348837209;18;25;0.0813953488372093;0.418604651162791
Control.SRR15539824;39;40;0.461538461538462;21;18;0.0384615384615384;0.461538461538462
Control.SRR15539824;41;40;0.48780487804878;21;20;0.0121951219512195;0.48780487804878
Control.SRR15539824;40;40;0.55;18;22;0.05;0.45
Control.SRR15539824;37;40;0.405405405405405;22;15;0.0945945945945946;0.405405405405405
Control.SRR15539824;39;40;0.564102564102564;17;22;0.0641025641025641;0.435897435897436
Control.SRR15539824;36;40;0.472222222222222;19;17;0.0277777777777778;0.472222222222222
Control.SRR15539824;40;40;0.4;24;16;0.1;0.4
Control.SRR15539824;37;40;0.459459459459459;20;17;0.0405405405405405;0.459459459459459
Control.SRR15539824;42;40;0.5;21;21;0;0.5
Control.SRR15539824;39;40;0.487179487179487;20;19;0.0128205128205128;0.487179487179487
Control.SRR15539824;35;40;0.371428571428571;22;13;0.128571428571429;0.371428571428571
Control.SRR15539824;37;40;0.405405405405405;22;15;0.0945945945945946;0.405405405405405
Control.SRR15539824;46;40;0.565217391304348;20;26;0.0652173913043478;0.434782608695652
Control.SRR15539824;42;40;0.476190476190476;22;20;0.0238095238095238;0.476190476190476
Control.SRR15539824;41;40;0.609756097560976;16;25;0.109756097560976;0.390243902439024
Control.SRR15539824;35;40;0.514285714285714;17;18;0.0142857142857142;0.485714285714286
Control.SRR15539824;35;40;0.542857142857143;16;19;0.0428571428571428;0.457142857142857
Control.SRR15539824;45;40;0.577777777777778;19;26;0.0777777777777777;0.422222222222222
Control.SRR15539824;38;40;0.421052631578947;22;16;0.0789473684210527;0.421052631578947
Control.SRR15539824;37;40;0.648648648648649;13;24;0.148648648648649;0.351351351351351
Control.SRR15539824;37;40;0.621621621621622;14;23;0.121621621621622;0.378378378378378
Control.SRR15539824;41;40;0.365853658536585;26;15;0.134146341463415;0.365853658536585
Control.SRR15539824;42;40;0.642857142857143;15;27;0.142857142857143;0.357142857142857
Control.SRR15539824;37;40;0.432432432432432;21;16;0.0675675675675675;0.432432432432432
Control.SRR15539824;39;40;0.512820512820513;19;20;0.0128205128205128;0.487179487179487
Control.SRR15539824;39;40;0.358974358974359;25;14;0.141025641025641;0.358974358974359
Control.SRR15539824;42;40;0.523809523809524;20;22;0.0238095238095238;0.476190476190476
Control.SRR15539824;43;40;0.558139534883721;19;24;0.0581395348837209;0.441860465116279
Control.SRR15539824;37;40;0.486486486486487;19;18;0.0135135135135135;0.486486486486487
Control.SRR15539824;42;40;0.547619047619048;19;23;0.0476190476190477;0.452380952380952
Control.SRR15539824;42;40;0.380952380952381;26;16;0.119047619047619;0.380952380952381
Control.SRR15539824;38;40;0.368421052631579;24;14;0.131578947368421;0.368421052631579
Control.SRR15539824;43;40;0.441860465116279;24;19;0.0581395348837209;0.441860465116279
Control.SRR15539824;42;40;0.595238095238095;17;25;0.0952380952380952;0.404761904761905
Control.SRR15539824;40;40;0.425;23;17;0.075;0.425
Control.SRR15539824;38;40;0.473684210526316;20;18;0.0263157894736842;0.473684210526316
Control.SRR15539824;47;40;0.531914893617021;22;25;0.0319148936170213;0.468085106382979
Control.SRR15539824;41;40;0.585365853658537;17;24;0.0853658536585366;0.414634146341463
Control.SRR15539824;35;40;0.428571428571429;20;15;0.0714285714285715;0.428571428571429
Control.SRR15539824;37;40;0.513513513513513;18;19;0.0135135135135135;0.486486486486487
Control.SRR15539824;43;40;0.465116279069767;23;20;0.0348837209302326;0.465116279069767
Control.SRR15539824;45;40;0.577777777777778;19;26;0.0777777777777777;0.422222222222222
Control.SRR15539824;41;40;0.634146341463415;15;26;0.134146341463415;0.365853658536585
Control.SRR15539824;41;40;0.439024390243902;23;18;0.0609756097560976;0.439024390243902
Control.SRR15539824;44;40;0.545454545454545;20;24;0.0454545454545454;0.454545454545455
Control.SRR15539824;35;40;0.6;14;21;0.1;0.4
Control.SRR15539824;35;40;0.485714285714286;18;17;0.0142857142857143;0.485714285714286
Control.SRR15539824;41;40;0.536585365853659;19;22;0.0365853658536586;0.463414634146341
Control.SRR15539824;44;40;0.431818181818182;25;19;0.0681818181818182;0.431818181818182
Control.SRR15539824;35;40;0.6;14;21;0.1;0.4
Control.SRR15539824;43;40;0.418604651162791;25;18;0.0813953488372093;0.418604651162791
Control.SRR15539824;43;40;0.372093023255814;27;16;0.127906976744186;0.372093023255814
Control.SRR15539824;37;40;0.513513513513513;18;19;0.0135135135135135;0.486486486486487
Control.SRR15539824;39;40;0.435897435897436;22;17;0.0641025641025641;0.435897435897436
Control.SRR15539824;44;40;0.409090909090909;26;18;0.0909090909090909;0.409090909090909
Control.SRR15539824;43;40;0.511627906976744;21;22;0.0116279069767442;0.488372093023256
Control.SRR15539824;43;40;0.604651162790698;17;26;0.104651162790698;0.395348837209302
Control.SRR15539824;39;40;0.58974358974359;16;23;0.0897435897435898;0.41025641025641
Control.SRR15539824;46;40;0.5;23;23;0;0.5
Control.SRR15539824;37;40;0.621621621621622;14;23;0.121621621621622;0.378378378378378
Control.SRR15539824;46;40;0.652173913043478;16;30;0.152173913043478;0.347826086956522
Control.SRR15539824;44;40;0.431818181818182;25;19;0.0681818181818182;0.431818181818182
Control.SRR15539824;44;40;0.590909090909091;18;26;0.0909090909090909;0.409090909090909
Control.SRR15539824;38;40;0.578947368421053;16;22;0.0789473684210527;0.421052631578947
Control.SRR15539824;37;40;0.459459459459459;20;17;0.0405405405405405;0.459459459459459
Control.SRR15539824;47;40;0.51063829787234;23;24;0.0106382978723404;0.48936170212766
Control.SRR15539824;35;40;0.514285714285714;17;18;0.0142857142857142;0.485714285714286
Control.SRR15539824;45;40;0.622222222222222;17;28;0.122222222222222;0.377777777777778
Control.SRR15539824;43;40;0.441860465116279;24;19;0.0581395348837209;0.441860465116279
Control.SRR15539824;35;40;0.428571428571429;20;15;0.0714285714285715;0.428571428571429
Control.SRR15539824;43;40;0.441860465116279;24;19;0.0581395348837209;0.441860465116279
Control.SRR15539824;36;40;0.527777777777778;17;19;0.0277777777777778;0.472222222222222
Control.SRR15539824;35;40;0.485714285714286;18;17;0.0142857142857143;0.485714285714286
Control.SRR15539824;37;40;0.432432432432432;21;16;0.0675675675675675;0.432432432432432
Control.SRR15539824;46;40;0.565217391304348;20;26;0.0652173913043478;0.434782608695652
Control.SRR15539824;45;40;0.466666666666667;24;21;0.0333333333333333;0.466666666666667
Control.SRR15539824;38;40;0.421052631578947;22;16;0.0789473684210527;0.421052631578947
Control.SRR15539824;45;40;0.622222222222222;17;28;0.122222222222222;0.377777777777778
Control.SRR15539824;45;40;0.511111111111111;22;23;0.0111111111111111;0.488888888888889
Control.SRR15539824;36;40;0.305555555555556;25;11;0.194444444444444;0.305555555555556
Control.SRR15539824;40;40;0.425;23;17;0.075;0.425
Control.SRR15539824;37;40;0.459459459459459;20;17;0.0405405405405405;0.459459459459459
Control.SRR15539824;46;40;0.521739130434783;22;24;0.0217391304347826;0.478260869565217
Control.SRR15539824;47;40;0.425531914893617;27;20;0.074468085106383;0.425531914893617
Control.SRR15539824;35;40;0.457142857142857;19;16;0.0428571428571429;0.457142857142857
Control.SRR15539824;36;40;0.472222222222222;19;17;0.0277777777777778;0.472222222222222
Control.SRR15539824;40;40;0.5;20;20;0;0.5
Control.SRR15539824;40;40;0.5;20;20;0;0.5
Control.SRR15539824;38;40;0.605263157894737;15;23;0.105263157894737;0.394736842105263
Control.SRR15539824;38;40;0.421052631578947;22;16;0.0789473684210527;0.421052631578947
Control.SRR15539824;42;40;0.476190476190476;22;20;0.0238095238095238;0.476190476190476
Control.SRR15539824;44;40;0.522727272727273;21;23;0.0227272727272727;0.477272727272727
Control.SRR15539824;44;40;0.545454545454545;20;24;0.0454545454545454;0.454545454545455
Control.SRR15539824;40;40;0.5;20;20;0;0.5
Control.SRR15539824;42;40;0.476190476190476;22;20;0.0238095238095238;0.476190476190476
Control.SRR15539824;36;40;0.583333333333333;15;21;0.0833333333333334;0.416666666666667
Control.SRR15539824;37;40;0.540540540540541;17;20;0.0405405405405406;0.459459459459459
Control.SRR15539824;38;40;0.447368421052632;21;17;0.0526315789473684;0.447368421052632
Control.SRR15539824;35;40;0.4;21;14;0.1;0.4
Control.SRR15539824;39;40;0.641025641025641;14;25;0.141025641025641;0.358974358974359
Control.SRR15539824;42;40;0.428571428571429;24;18;0.0714285714285715;0.428571428571429
Control.SRR15539824;35;40;0.457142857142857;19;16;0.0428571428571429;0.457142857142857
Control.SRR15539824;35;40;0.4;21;14;0.1;0.4
Control.SRR15539824;37;40;0.405405405405405;22;15;0.0945945945945946;0.405405405405405
Control.SRR15539824;45;40;0.555555555555556;20;25;0.0555555555555556;0.444444444444444
Control.SRR15539824;47;40;0.617021276595745;18;29;0.117021276595745;0.382978723404255
Control.SRR15539824;46;40;0.391304347826087;28;18;0.108695652173913;0.391304347826087
Control.SRR15539824;42;40;0.619047619047619;16;26;0.119047619047619;0.380952380952381
Control.SRR15539824;39;40;0.358974358974359;25;14;0.141025641025641;0.358974358974359
Control.SRR15539824;43;40;0.465116279069767;23;20;0.0348837209302326;0.465116279069767
Control.SRR15539824;37;40;0.405405405405405;22;15;0.0945945945945946;0.405405405405405
Control.SRR15539824;44;40;0.454545454545455;24;20;0.0454545454545455;0.454545454545455
Control.SRR15539824;44;40;0.704545454545455;13;31;0.204545454545455;0.295454545454545
Control.SRR15539824;37;40;0.621621621621622;14;23;0.121621621621622;0.378378378378378
Control.SRR15539824;36;40;0.333333333333333;24;12;0.166666666666667;0.333333333333333
Control.SRR15539824;41;40;0.536585365853659;19;22;0.0365853658536586;0.463414634146341
Control.SRR15539824;36;40;0.416666666666667;21;15;0.0833333333333333;0.416666666666667
Control.SRR15539824;43;40;0.558139534883721;19;24;0.0581395348837209;0.441860465116279
Control.SRR15539824;40;40;0.375;25;15;0.125;0.375
Control.SRR15539824;40;40;0.475;21;19;0.025;0.475
Control.SRR15539824;39;40;0.538461538461538;18;21;0.0384615384615384;0.461538461538462
Control.SRR15539824;39;40;0.538461538461538;18;21;0.0384615384615384;0.461538461538462
Control.SRR15539824;41;40;0.463414634146341;22;19;0.0365853658536585;0.463414634146341
Control.SRR15539824;47;40;0.468085106382979;25;22;0.0319148936170213;0.468085106382979
Control.SRR15539824;36;40;0.361111111111111;23;13;0.138888888888889;0.361111111111111
Control.SRR15539824;46;40;0.326086956521739;31;15;0.173913043478261;0.326086956521739
Control.SRR15539824;38;40;0.394736842105263;23;15;0.105263157894737;0.394736842105263
Control.SRR15539824;40;40;0.5;20;20;0;0.5
Control.SRR15539824;44;40;0.545454545454545;20;24;0.0454545454545454;0.454545454545455
Control.SRR15539824;41;40;0.51219512195122;20;21;0.0121951219512195;0.48780487804878
Control.SRR15539824;39;40;0.435897435897436;22;17;0.0641025641025641;0.435897435897436
Control.SRR15539824;40;40;0.5;20;20;0;0.5
Control.SRR15539824;45;40;0.511111111111111;22;23;0.0111111111111111;0.488888888888889
Control.SRR15539824;43;40;0.581395348837209;18;25;0.0813953488372093;0.418604651162791
Control.SRR15539824;46;40;0.543478260869565;21;25;0.0434782608695652;0.456521739130435
Control.SRR15539824;37;40;0.594594594594595;15;22;0.0945945945945946;0.405405405405405
Control.SRR15539824;39;40;0.435897435897436;22;17;0.0641025641025641;0.435897435897436
Control.SRR15539824;40;40;0.425;23;17;0.075;0.425
Control.SRR15539824;46;40;0.456521739130435;25;21;0.0434782608695652;0.456521739130435
Control.SRR15539824;46;40;0.478260869565217;24;22;0.0217391304347826;0.478260869565217
Control.SRR15539824;44;40;0.636363636363636;16;28;0.136363636363636;0.363636363636364
Control.SRR15539824;46;40;0.543478260869565;21;25;0.0434782608695652;0.456521739130435
Control.SRR15539824;43;40;0.627906976744186;16;27;0.127906976744186;0.372093023255814
Control.SRR15539824;37;40;0.351351351351351;24;13;0.148648648648649;0.351351351351351
Control.SRR15539824;38;40;0.578947368421053;16;22;0.0789473684210527;0.421052631578947
Control.SRR15539824;47;40;0.446808510638298;26;21;0.0531914893617021;0.446808510638298
Control.SRR15539824;44;40;0.636363636363636;16;28;0.136363636363636;0.363636363636364
Control.SRR15539824;41;40;0.536585365853659;19;22;0.0365853658536586;0.463414634146341
Control.SRR15539824;37;40;0.648648648648649;13;24;0.148648648648649;0.351351351351351
Control.SRR15539824;45;40;0.511111111111111;22;23;0.0111111111111111;0.488888888888889
Control.SRR15539824;39;40;0.487179487179487;20;19;0.0128205128205128;0.487179487179487
Control.SRR15539824;41;40;0.536585365853659;19;22;0.0365853658536586;0.463414634146341
Control.SRR15539824;43;40;0.395348837209302;26;17;0.104651162790698;0.395348837209302
Control.SRR15539824;47;40;0.48936170212766;24;23;0.0106382978723404;0.48936170212766
Control.SRR15539824;39;40;0.538461538461538;18;21;0.0384615384615384;0.461538461538462
Control.SRR15539824;41;40;0.536585365853659;19;22;0.0365853658536586;0.463414634146341
Control.SRR15539824;45;40;0.644444444444444;16;29;0.144444444444444;0.355555555555556
Control.SRR15539824;41;40;0.463414634146341;22;19;0.0365853658536585;0.463414634146341
Control.SRR15539824;43;40;0.488372093023256;22;21;0.0116279069767442;0.488372093023256
Control.SRR15539824;46;40;0.478260869565217;24;22;0.0217391304347826;0.478260869565217
Control.SRR15539824;46;40;0.565217391304348;20;26;0.0652173913043478;0.434782608695652
Control.SRR15539824;35;40;0.371428571428571;22;13;0.128571428571429;0.371428571428571
Control.SRR15539824;40;40;0.525;19;21;0.025;0.475
Control.SRR15539824;43;40;0.604651162790698;17;26;0.104651162790698;0.395348837209302
Control.SRR15539824;36;40;0.5;18;18;0;0.5
Control.SRR15539824;36;40;0.444444444444444;20;16;0.0555555555555556;0.444444444444444
Control.SRR15539824;44;40;0.454545454545455;24;20;0.0454545454545455;0.454545454545455
Control.SRR15539824;46;40;0.630434782608696;17;29;0.130434782608696;0.369565217391304
Control.SRR15539824;42;40;0.452380952380952;23;19;0.0476190476190476;0.452380952380952
Control.SRR15539824;43;40;0.581395348837209;18;25;0.0813953488372093;0.418604651162791
Control.SRR15539824;45;40;0.422222222222222;26;19;0.0777777777777778;0.422222222222222
Control.SRR15539824;47;40;0.425531914893617;27;20;0.074468085106383;0.425531914893617
Control.SRR15539824;41;40;0.390243902439024;25;16;0.109756097560976;0.390243902439024
Control.SRR15539824;39;40;0.538461538461538;18;21;0.0384615384615384;0.461538461538462
Control.SRR15539824;46;40;0.5;23;23;0;0.5
Control.SRR15539824;36;40;0.388888888888889;22;14;0.111111111111111;0.388888888888889
Control.SRR15539824;38;40;0.578947368421053;16;22;0.0789473684210527;0.421052631578947
Control.SRR15539824;44;40;0.568181818181818;19;25;0.0681818181818182;0.431818181818182
Control.SRR15539824;40;40;0.6;16;24;0.1;0.4
Control.SRR15539824;42;40;0.357142857142857;27;15;0.142857142857143;0.357142857142857
Control.SRR15539824;43;40;0.418604651162791;25;18;0.0813953488372093;0.418604651162791
Control.SRR15539824;35;40;0.428571428571429;20;15;0.0714285714285715;0.428571428571429
Control.SRR15539824;40;40;0.6;16;24;0.1;0.4
Control.SRR15539824;46;40;0.608695652173913;18;28;0.108695652173913;0.391304347826087
Control.SRR15539824;36;40;0.5;18;18;0;0.5
Control.SRR15539824;43;40;0.488372093023256;22;21;0.0116279069767442;0.488372093023256
Control.SRR15539824;41;40;0.536585365853659;19;22;0.0365853658536586;0.463414634146341
Control.SRR15539824;37;40;0.486486486486487;19;18;0.0135135135135135;0.486486486486487
Control.SRR15539824;40;40;0.5;20;20;0;0.5
Control.SRR15539824;36;40;0.611111111111111;14;22;0.111111111111111;0.388888888888889
Control.SRR15539824;43;40;0.488372093023256;22;21;0.0116279069767442;0.488372093023256
Control.SRR15539824;45;40;0.511111111111111;22;23;0.0111111111111111;0.488888888888889
Control.SRR15539824;44;40;0.5;22;22;0;0.5
Control.SRR15539824;45;40;0.466666666666667;24;21;0.0333333333333333;0.466666666666667
Control.SRR15539824;40;40;0.575;17;23;0.075;0.425
Control.SRR15539824;35;40;0.542857142857143;16;19;0.0428571428571428;0.457142857142857
Control.SRR15539824;35;40;0.542857142857143;16;19;0.0428571428571428;0.457142857142857
Control.SRR15539824;41;40;0.463414634146341;22;19;0.0365853658536585;0.463414634146341
Control.SRR15539824;39;40;0.487179487179487;20;19;0.0128205128205128;0.487179487179487
Control.SRR15539824;46;40;0.565217391304348;20;26;0.0652173913043478;0.434782608695652
Control.SRR15539824;45;40;0.488888888888889;23;22;0.0111111111111111;0.488888888888889
Control.SRR15539824;40;40;0.5;20;20;0;0.5
Control.SRR15539824;41;40;0.634146341463415;15;26;0.134146341463415;0.365853658536585
Control.SRR15539824;40;40;0.525;19;21;0.025;0.475
Control.SRR15539824;40;40;0.475;21;19;0.025;0.475
Control.SRR15539824;42;40;0.571428571428571;18;24;0.0714285714285714;0.428571428571429
Control.SRR15539824;37;40;0.459459459459459;20;17;0.0405405405405405;0.459459459459459
Control.SRR15539824;37;40;0.513513513513513;18;19;0.0135135135135135;0.486486486486487
Control.SRR15539824;36;40;0.527777777777778;17;19;0.0277777777777778;0.472222222222222
Control.SRR15539824;44;40;0.477272727272727;23;21;0.0227272727272727;0.477272727272727
Control.SRR15539824;40;40;0.4;24;16;0.1;0.4
Control.SRR15539824;47;40;0.553191489361702;21;26;0.0531914893617021;0.446808510638298
Control.SRR15539824;46;40;0.41304347826087;27;19;0.0869565217391304;0.41304347826087
Control.SRR15539824;47;40;0.48936170212766;24;23;0.0106382978723404;0.48936170212766
Control.SRR15539824;45;40;0.555555555555556;20;25;0.0555555555555556;0.444444444444444
Control.SRR15539824;44;40;0.613636363636364;17;27;0.113636363636364;0.386363636363636
Control.SRR15539824;35;40;0.371428571428571;22;13;0.128571428571429;0.371428571428571
Control.SRR15539824;43;40;0.488372093023256;22;21;0.0116279069767442;0.488372093023256
Control.SRR15539824;39;40;0.358974358974359;25;14;0.141025641025641;0.358974358974359
Control.SRR15539824;44;40;0.477272727272727;23;21;0.0227272727272727;0.477272727272727
Control.SRR15539824;42;40;0.380952380952381;26;16;0.119047619047619;0.380952380952381
Control.SRR15539824;40;40;0.475;21;19;0.025;0.475
Control.SRR15539824;38;40;0.473684210526316;20;18;0.0263157894736842;0.473684210526316
Control.SRR15539824;46;40;0.434782608695652;26;20;0.0652173913043478;0.434782608695652
Control.SRR15539824;38;40;0.394736842105263;23;15;0.105263157894737;0.394736842105263
Control.SRR15539824;40;40;0.375;25;15;0.125;0.375
Control.SRR15539824;40;40;0.4;24;16;0.1;0.4
Control.SRR15539824;36;40;0.472222222222222;19;17;0.0277777777777778;0.472222222222222
Control.SRR15539824;35;40;0.571428571428571;15;20;0.0714285714285714;0.428571428571429
Control.SRR15539824;40;40;0.475;21;19;0.025;0.475
Control.SRR15539824;39;40;0.538461538461538;18;21;0.0384615384615384;0.461538461538462
Control.SRR15539824;40;40;0.55;18;22;0.05;0.45
Control.SRR15539824;39;40;0.538461538461538;18;21;0.0384615384615384;0.461538461538462
Control.SRR15539824;38;40;0.368421052631579;24;14;0.131578947368421;0.368421052631579
Control.SRR15539824;46;40;0.5;23;23;0;0.5
Control.SRR15539824;39;40;0.461538461538462;21;18;0.0384615384615384;0.461538461538462
Control.SRR15539824;44;40;0.409090909090909;26;18;0.0909090909090909;0.409090909090909
Control.SRR15539824;41;40;0.560975609756098;18;23;0.0609756097560976;0.439024390243902
Control.SRR15539824;42;40;0.523809523809524;20;22;0.0238095238095238;0.476190476190476
Control.SRR15539824;41;40;0.560975609756098;18;23;0.0609756097560976;0.439024390243902
Control.SRR15539824;37;40;0.594594594594595;15;22;0.0945945945945946;0.405405405405405
Control.SRR15539824;35;40;0.428571428571429;20;15;0.0714285714285715;0.428571428571429
Control.SRR15539824;37;40;0.432432432432432;21;16;0.0675675675675675;0.432432432432432
Control.SRR15539824;44;40;0.568181818181818;19;25;0.0681818181818182;0.431818181818182
Control.SRR15539824;38;40;0.5;19;19;0;0.5
Control.SRR15539824;41;40;0.317073170731707;28;13;0.182926829268293;0.317073170731707
Control.SRR15539824;36;40;0.527777777777778;17;19;0.0277777777777778;0.472222222222222
Control.SRR15539824;37;40;0.459459459459459;20;17;0.0405405405405405;0.459459459459459
Control.SRR15539824;35;40;0.742857142857143;9;26;0.242857142857143;0.257142857142857
Control.SRR15539824;44;40;0.590909090909091;18;26;0.0909090909090909;0.409090909090909
Control.SRR15539824;41;40;0.585365853658537;17;24;0.0853658536585366;0.414634146341463
Control.SRR15539824;36;40;0.444444444444444;20;16;0.0555555555555556;0.444444444444444
Control.SRR15539824;41;40;0.536585365853659;19;22;0.0365853658536586;0.463414634146341
Control.SRR15539824;46;40;0.5;23;23;0;0.5
Control.SRR15539824;43;40;0.465116279069767;23;20;0.0348837209302326;0.465116279069767
Control.SRR15539824;39;40;0.487179487179487;20;19;0.0128205128205128;0.487179487179487
Control.SRR15539824;35;40;0.457142857142857;19;16;0.0428571428571429;0.457142857142857
Control.SRR15539824;40;40;0.45;22;18;0.05;0.45
Control.SRR15539824;42;40;0.452380952380952;23;19;0.0476190476190476;0.452380952380952
Control.SRR15539824;47;40;0.425531914893617;27;20;0.074468085106383;0.425531914893617
Control.SRR15539824;42;40;0.571428571428571;18;24;0.0714285714285714;0.428571428571429
Control.SRR15539824;37;40;0.540540540540541;17;20;0.0405405405405406;0.459459459459459
Control.SRR15539824;45;40;0.533333333333333;21;24;0.0333333333333333;0.466666666666667
Control.SRR15539824;42;40;0.571428571428571;18;24;0.0714285714285714;0.428571428571429
Control.SRR15539824;47;40;0.48936170212766;24;23;0.0106382978723404;0.48936170212766
Control.SRR15539824;46;40;0.391304347826087;28;18;0.108695652173913;0.391304347826087
Control.SRR15539824;45;40;0.488888888888889;23;22;0.0111111111111111;0.488888888888889
Control.SRR15539824;38;40;0.5;19;19;0;0.5
Control.SRR15539824;36;40;0.583333333333333;15;21;0.0833333333333334;0.416666666666667
Control.SRR15539824;35;40;0.428571428571429;20;15;0.0714285714285715;0.428571428571429
Control.SRR15539824;38;40;0.552631578947368;17;21;0.0526315789473685;0.447368421052632
Control.SRR15539824;37;40;0.432432432432432;21;16;0.0675675675675675;0.432432432432432
Control.SRR15539824;41;40;0.463414634146341;22;19;0.0365853658536585;0.463414634146341
Control.SRR15539824;41;40;0.463414634146341;22;19;0.0365853658536585;0.463414634146341
Control.SRR15539824;47;40;0.553191489361702;21;26;0.0531914893617021;0.446808510638298
Control.SRR15539824;45;40;0.511111111111111;22;23;0.0111111111111111;0.488888888888889
Control.SRR15539824;41;40;0.51219512195122;20;21;0.0121951219512195;0.48780487804878
Control.SRR15539824;36;40;0.638888888888889;13;23;0.138888888888889;0.361111111111111
Control.SRR15539824;38;40;0.447368421052632;21;17;0.0526315789473684;0.447368421052632
Control.SRR15539824;45;40;0.355555555555556;29;16;0.144444444444444;0.355555555555556
Control.SRR15539824;41;40;0.463414634146341;22;19;0.0365853658536585;0.463414634146341
Control.SRR15539824;40;40;0.525;19;21;0.025;0.475
Control.SRR15539824;36;40;0.416666666666667;21;15;0.0833333333333333;0.416666666666667
Control.SRR15539824;36;40;0.583333333333333;15;21;0.0833333333333334;0.416666666666667
Control.SRR15539824;37;40;0.486486486486487;19;18;0.0135135135135135;0.486486486486487
Control.SRR15539824;37;40;0.378378378378378;23;14;0.121621621621622;0.378378378378378
Control.SRR15539824;43;40;0.441860465116279;24;19;0.0581395348837209;0.441860465116279
Control.SRR15539824;46;40;0.478260869565217;24;22;0.0217391304347826;0.478260869565217
Control.SRR15539824;44;40;0.454545454545455;24;20;0.0454545454545455;0.454545454545455
Control.SRR15539824;44;40;0.477272727272727;23;21;0.0227272727272727;0.477272727272727
Control.SRR15539824;44;40;0.568181818181818;19;25;0.0681818181818182;0.431818181818182
Control.SRR15539824;35;40;0.514285714285714;17;18;0.0142857142857142;0.485714285714286
Control.SRR15539824;43;40;0.488372093023256;22;21;0.0116279069767442;0.488372093023256
Control.SRR15539824;43;40;0.348837209302326;28;15;0.151162790697674;0.348837209302326
Control.SRR15539824;37;40;0.351351351351351;24;13;0.148648648648649;0.351351351351351
Control.SRR15539824;35;40;0.657142857142857;12;23;0.157142857142857;0.342857142857143
Control.SRR15539824;36;40;0.5;18;18;0;0.5
Control.SRR15539824;45;40;0.511111111111111;22;23;0.0111111111111111;0.488888888888889
Control.SRR15539824;45;40;0.533333333333333;21;24;0.0333333333333333;0.466666666666667
Control.SRR15539824;46;40;0.456521739130435;25;21;0.0434782608695652;0.456521739130435
Control.SRR15539824;45;40;0.644444444444444;16;29;0.144444444444444;0.355555555555556
Control.SRR15539824;36;40;0.5;18;18;0;0.5
Control.SRR15539824;46;40;0.608695652173913;18;28;0.108695652173913;0.391304347826087
Control.SRR15539824;45;40;0.533333333333333;21;24;0.0333333333333333;0.466666666666667
Control.SRR15539824;35;40;0.371428571428571;22;13;0.128571428571429;0.371428571428571
Control.SRR15539824;40;40;0.7;12;28;0.2;0.3
Control.SRR15539824;43;40;0.488372093023256;22;21;0.0116279069767442;0.488372093023256
Control.SRR15539824;40;40;0.425;23;17;0.075;0.425
Control.SRR15539824;40;40;0.5;20;20;0;0.5
Control.SRR15539824;37;40;0.594594594594595;15;22;0.0945945945945946;0.405405405405405
Control.SRR15539824;40;40;0.525;19;21;0.025;0.475
Control.SRR15539824;43;40;0.372093023255814;27;16;0.127906976744186;0.372093023255814
Control.SRR15539824;42;40;0.476190476190476;22;20;0.0238095238095238;0.476190476190476
Control.SRR15539824;41;40;0.560975609756098;18;23;0.0609756097560976;0.439024390243902
Control.SRR15539824;39;40;0.512820512820513;19;20;0.0128205128205128;0.487179487179487
Control.SRR15539824;39;40;0.538461538461538;18;21;0.0384615384615384;0.461538461538462
Control.SRR15539824;42;40;0.428571428571429;24;18;0.0714285714285715;0.428571428571429
Control.SRR15539824;47;40;0.531914893617021;22;25;0.0319148936170213;0.468085106382979
Control.SRR15539824;47;40;0.468085106382979;25;22;0.0319148936170213;0.468085106382979
Control.SRR15539824;39;40;0.512820512820513;19;20;0.0128205128205128;0.487179487179487
Control.SRR15539824;42;40;0.523809523809524;20;22;0.0238095238095238;0.476190476190476
Control.SRR15539824;36;40;0.361111111111111;23;13;0.138888888888889;0.361111111111111
Control.SRR15539824;41;40;0.536585365853659;19;22;0.0365853658536586;0.463414634146341
Control.SRR15539824;43;40;0.395348837209302;26;17;0.104651162790698;0.395348837209302
Control.SRR15539824;40;40;0.525;19;21;0.025;0.475
Control.SRR15539824;45;40;0.488888888888889;23;22;0.0111111111111111;0.488888888888889
Control.SRR15539824;47;40;0.51063829787234;23;24;0.0106382978723404;0.48936170212766
Control.SRR15539824;42;40;0.452380952380952;23;19;0.0476190476190476;0.452380952380952
Control.SRR15539824;35;40;0.428571428571429;20;15;0.0714285714285715;0.428571428571429
Control.SRR15539824;38;40;0.447368421052632;21;17;0.0526315789473684;0.447368421052632
Control.SRR15539824;42;40;0.428571428571429;24;18;0.0714285714285715;0.428571428571429
Control.SRR15539824;45;40;0.6;18;27;0.1;0.4
Control.SRR15539824;37;40;0.594594594594595;15;22;0.0945945945945946;0.405405405405405
Control.SRR15539824;38;40;0.473684210526316;20;18;0.0263157894736842;0.473684210526316
Control.SRR15539824;45;40;0.422222222222222;26;19;0.0777777777777778;0.422222222222222
Control.SRR15539824;37;40;0.486486486486487;19;18;0.0135135135135135;0.486486486486487
Control.SRR15539824;42;40;0.571428571428571;18;24;0.0714285714285714;0.428571428571429
Control.SRR15539824;44;40;0.5;22;22;0;0.5
Control.SRR15539824;43;40;0.558139534883721;19;24;0.0581395348837209;0.441860465116279
Control.SRR15539824;41;40;0.560975609756098;18;23;0.0609756097560976;0.439024390243902
Control.SRR15539824;43;40;0.534883720930233;20;23;0.0348837209302325;0.465116279069767
Control.SRR15539824;41;40;0.439024390243902;23;18;0.0609756097560976;0.439024390243902
Control.SRR15539824;38;40;0.552631578947368;17;21;0.0526315789473685;0.447368421052632
Control.SRR15539824;43;40;0.558139534883721;19;24;0.0581395348837209;0.441860465116279
Control.SRR15539824;37;40;0.486486486486487;19;18;0.0135135135135135;0.486486486486487
Control.SRR15539824;42;40;0.452380952380952;23;19;0.0476190476190476;0.452380952380952
Control.SRR15539824;40;40;0.425;23;17;0.075;0.425
Control.SRR15539824;37;40;0.486486486486487;19;18;0.0135135135135135;0.486486486486487
Control.SRR15539824;38;40;0.473684210526316;20;18;0.0263157894736842;0.473684210526316
Control.SRR15539824;42;40;0.5;21;21;0;0.5
Control.SRR15539824;36;40;0.472222222222222;19;17;0.0277777777777778;0.472222222222222
Control.SRR15539824;41;40;0.707317073170732;12;29;0.207317073170732;0.292682926829268
Control.SRR15539824;39;40;0.538461538461538;18;21;0.0384615384615384;0.461538461538462
Control.SRR15539824;45;40;0.333333333333333;30;15;0.166666666666667;0.333333333333333
Control.SRR15539824;35;40;0.571428571428571;15;20;0.0714285714285714;0.428571428571429
Control.SRR15539824;41;40;0.414634146341463;24;17;0.0853658536585366;0.414634146341463
Control.SRR15539824;46;40;0.521739130434783;22;24;0.0217391304347826;0.478260869565217
Control.SRR15539824;42;40;0.452380952380952;23;19;0.0476190476190476;0.452380952380952
Control.SRR15539824;40;40;0.625;15;25;0.125;0.375
Control.SRR15539824;45;40;0.511111111111111;22;23;0.0111111111111111;0.488888888888889
Control.SRR15539824;36;40;0.5;18;18;0;0.5
Control.SRR15539824;36;40;0.444444444444444;20;16;0.0555555555555556;0.444444444444444
Control.SRR15539824;39;40;0.435897435897436;22;17;0.0641025641025641;0.435897435897436
Control.SRR15539824;47;40;0.446808510638298;26;21;0.0531914893617021;0.446808510638298
Control.SRR15539824;38;40;0.631578947368421;14;24;0.131578947368421;0.368421052631579
Control.SRR15539824;38;40;0.552631578947368;17;21;0.0526315789473685;0.447368421052632
Control.SRR15539824;44;40;0.590909090909091;18;26;0.0909090909090909;0.409090909090909
Control.SRR15539824;45;40;0.466666666666667;24;21;0.0333333333333333;0.466666666666667
Control.SRR15539824;42;40;0.452380952380952;23;19;0.0476190476190476;0.452380952380952
Control.SRR15539824;42;40;0.547619047619048;19;23;0.0476190476190477;0.452380952380952
Control.SRR15539824;45;40;0.422222222222222;26;19;0.0777777777777778;0.422222222222222
Control.SRR15539824;44;40;0.454545454545455;24;20;0.0454545454545455;0.454545454545455
Control.SRR15539824;41;40;0.365853658536585;26;15;0.134146341463415;0.365853658536585
Control.SRR15539824;47;40;0.553191489361702;21;26;0.0531914893617021;0.446808510638298
Control.SRR15539824;36;40;0.361111111111111;23;13;0.138888888888889;0.361111111111111
Control.SRR15539824;36;40;0.611111111111111;14;22;0.111111111111111;0.388888888888889
Control.SRR15539824;47;40;0.553191489361702;21;26;0.0531914893617021;0.446808510638298
Control.SRR15539824;40;40;0.5;20;20;0;0.5
Control.SRR15539824;46;40;0.5;23;23;0;0.5
Control.SRR15539824;46;40;0.456521739130435;25;21;0.0434782608695652;0.456521739130435
Control.SRR15539824;42;40;0.523809523809524;20;22;0.0238095238095238;0.476190476190476
Control.SRR15539824;42;40;0.619047619047619;16;26;0.119047619047619;0.380952380952381
Control.SRR15539824;41;40;0.585365853658537;17;24;0.0853658536585366;0.414634146341463
Control.SRR15539824;45;40;0.422222222222222;26;19;0.0777777777777778;0.422222222222222
Control.SRR15539824;36;40;0.5;18;18;0;0.5
Control.SRR15539824;43;40;0.465116279069767;23;20;0.0348837209302326;0.465116279069767
Control.SRR15539824;40;40;0.425;23;17;0.075;0.425
Control.SRR15539824;40;40;0.5;20;20;0;0.5
Control.SRR15539824;41;40;0.341463414634146;27;14;0.158536585365854;0.341463414634146
Control.SRR15539824;41;40;0.365853658536585;26;15;0.134146341463415;0.365853658536585
Control.SRR15539824;38;40;0.631578947368421;14;24;0.131578947368421;0.368421052631579
Control.SRR15539824;41;40;0.48780487804878;21;20;0.0121951219512195;0.48780487804878
Control.SRR15539824;37;40;0.486486486486487;19;18;0.0135135135135135;0.486486486486487
Control.SRR15539824;44;40;0.568181818181818;19;25;0.0681818181818182;0.431818181818182
Control.SRR15539824;38;40;0.394736842105263;23;15;0.105263157894737;0.394736842105263
Control.SRR15539824;39;40;0.358974358974359;25;14;0.141025641025641;0.358974358974359
Control.SRR15539824;36;40;0.5;18;18;0;0.5
Control.SRR15539824;45;40;0.577777777777778;19;26;0.0777777777777777;0.422222222222222
Control.SRR15539824;39;40;0.435897435897436;22;17;0.0641025641025641;0.435897435897436
Control.SRR15539824;39;40;0.435897435897436;22;17;0.0641025641025641;0.435897435897436
Control.SRR15539824;42;40;0.476190476190476;22;20;0.0238095238095238;0.476190476190476
Control.SRR15539824;47;40;0.48936170212766;24;23;0.0106382978723404;0.48936170212766
Control.SRR15539824;47;40;0.595744680851064;19;28;0.0957446808510638;0.404255319148936
Control.SRR15539824;43;40;0.534883720930233;20;23;0.0348837209302325;0.465116279069767
Control.SRR15539824;37;40;0.594594594594595;15;22;0.0945945945945946;0.405405405405405
Control.SRR15539824;35;40;0.4;21;14;0.1;0.4
Control.SRR15539824;36;40;0.388888888888889;22;14;0.111111111111111;0.388888888888889
Control.SRR15539824;39;40;0.564102564102564;17;22;0.0641025641025641;0.435897435897436
Control.SRR15539824;45;40;0.555555555555556;20;25;0.0555555555555556;0.444444444444444
Control.SRR15539824;35;40;0.542857142857143;16;19;0.0428571428571428;0.457142857142857
Control.SRR15539824;42;40;0.571428571428571;18;24;0.0714285714285714;0.428571428571429
Control.SRR15539824;39;40;0.435897435897436;22;17;0.0641025641025641;0.435897435897436
Control.SRR15539824;38;40;0.552631578947368;17;21;0.0526315789473685;0.447368421052632
Control.SRR15539824;43;40;0.534883720930233;20;23;0.0348837209302325;0.465116279069767
Control.SRR15539824;46;40;0.543478260869565;21;25;0.0434782608695652;0.456521739130435
Control.SRR15539824;42;40;0.571428571428571;18;24;0.0714285714285714;0.428571428571429
Control.SRR15539824;41;40;0.414634146341463;24;17;0.0853658536585366;0.414634146341463
Control.SRR15539824;45;40;0.555555555555556;20;25;0.0555555555555556;0.444444444444444
Control.SRR15539824;41;40;0.365853658536585;26;15;0.134146341463415;0.365853658536585
Control.SRR15539824;36;40;0.444444444444444;20;16;0.0555555555555556;0.444444444444444
Control.SRR15539824;47;40;0.51063829787234;23;24;0.0106382978723404;0.48936170212766
Control.SRR15539824;37;40;0.459459459459459;20;17;0.0405405405405405;0.459459459459459
Control.SRR15539824;43;40;0.511627906976744;21;22;0.0116279069767442;0.488372093023256
Control.SRR15539824;45;40;0.511111111111111;22;23;0.0111111111111111;0.488888888888889
Control.SRR15539824;37;40;0.486486486486487;19;18;0.0135135135135135;0.486486486486487
Control.SRR15539824;43;40;0.558139534883721;19;24;0.0581395348837209;0.441860465116279
Control.SRR15539824;41;40;0.609756097560976;16;25;0.109756097560976;0.390243902439024
Control.SRR15539824;36;40;0.611111111111111;14;22;0.111111111111111;0.388888888888889
Control.SRR15539824;37;40;0.432432432432432;21;16;0.0675675675675675;0.432432432432432
Control.SRR15539824;42;40;0.619047619047619;16;26;0.119047619047619;0.380952380952381
Control.SRR15539824;37;40;0.567567567567568;16;21;0.0675675675675675;0.432432432432432
Control.SRR15539824;42;40;0.571428571428571;18;24;0.0714285714285714;0.428571428571429
Control.SRR15539824;43;40;0.488372093023256;22;21;0.0116279069767442;0.488372093023256
Control.SRR15539824;35;40;0.485714285714286;18;17;0.0142857142857143;0.485714285714286
Control.SRR15539824;43;40;0.465116279069767;23;20;0.0348837209302326;0.465116279069767
Control.SRR15539824;47;40;0.574468085106383;20;27;0.074468085106383;0.425531914893617
Control.SRR15539824;41;40;0.463414634146341;22;19;0.0365853658536585;0.463414634146341
Control.SRR15539824;42;40;0.571428571428571;18;24;0.0714285714285714;0.428571428571429
Control.SRR15539824;40;40;0.625;15;25;0.125;0.375
Control.SRR15539824;46;40;0.521739130434783;22;24;0.0217391304347826;0.478260869565217
Control.SRR15539824;41;40;0.414634146341463;24;17;0.0853658536585366;0.414634146341463
Control.SRR15539824;37;40;0.486486486486487;19;18;0.0135135135135135;0.486486486486487
Control.SRR15539824;40;40;0.45;22;18;0.05;0.45
Control.SRR15539824;37;40;0.432432432432432;21;16;0.0675675675675675;0.432432432432432
Control.SRR15539824;44;40;0.522727272727273;21;23;0.0227272727272727;0.477272727272727
Control.SRR15539824;46;40;0.456521739130435;25;21;0.0434782608695652;0.456521739130435
Control.SRR15539824;41;40;0.439024390243902;23;18;0.0609756097560976;0.439024390243902
Control.SRR15539824;40;40;0.55;18;22;0.05;0.45
Control.SRR15539824;42;40;0.547619047619048;19;23;0.0476190476190477;0.452380952380952
Control.SRR15539824;47;40;0.553191489361702;21;26;0.0531914893617021;0.446808510638298
Control.SRR15539824;40;40;0.4;24;16;0.1;0.4
Control.SRR15539824;42;40;0.5;21;21;0;0.5
Control.SRR15539824;39;40;0.487179487179487;20;19;0.0128205128205128;0.487179487179487
Control.SRR15539824;36;40;0.388888888888889;22;14;0.111111111111111;0.388888888888889
Control.SRR15539824;41;40;0.536585365853659;19;22;0.0365853658536586;0.463414634146341
Control.SRR15539824;40;40;0.625;15;25;0.125;0.375
Control.SRR15539824;41;40;0.51219512195122;20;21;0.0121951219512195;0.48780487804878
Control.SRR15539824;44;40;0.454545454545455;24;20;0.0454545454545455;0.454545454545455
Control.SRR15539824;36;40;0.527777777777778;17;19;0.0277777777777778;0.472222222222222
Control.SRR15539824;46;40;0.5;23;23;0;0.5
Control.SRR15539824;46;40;0.521739130434783;22;24;0.0217391304347826;0.478260869565217
Control.SRR15539824;37;40;0.621621621621622;14;23;0.121621621621622;0.378378378378378
Control.SRR15539824;41;40;0.536585365853659;19;22;0.0365853658536586;0.463414634146341
Control.SRR15539824;37;40;0.486486486486487;19;18;0.0135135135135135;0.486486486486487
Control.SRR15539824;36;40;0.472222222222222;19;17;0.0277777777777778;0.472222222222222
Control.SRR15539824;43;40;0.511627906976744;21;22;0.0116279069767442;0.488372093023256
Control.SRR15539824;47;40;0.48936170212766;24;23;0.0106382978723404;0.48936170212766
Control.SRR15539824;46;40;0.673913043478261;15;31;0.173913043478261;0.326086956521739
Control.SRR15539824;42;40;0.571428571428571;18;24;0.0714285714285714;0.428571428571429
Control.SRR15539824;35;40;0.485714285714286;18;17;0.0142857142857143;0.485714285714286
Control.SRR15539824;37;40;0.513513513513513;18;19;0.0135135135135135;0.486486486486487
Control.SRR15539824;47;40;0.595744680851064;19;28;0.0957446808510638;0.404255319148936
Control.SRR15539824;43;40;0.534883720930233;20;23;0.0348837209302325;0.465116279069767
Control.SRR15539824;43;40;0.488372093023256;22;21;0.0116279069767442;0.488372093023256
Control.SRR15539824;45;40;0.555555555555556;20;25;0.0555555555555556;0.444444444444444
Control.SRR15539824;40;40;0.475;21;19;0.025;0.475
Control.SRR15539824;46;40;0.521739130434783;22;24;0.0217391304347826;0.478260869565217
Control.SRR15539824;42;40;0.523809523809524;20;22;0.0238095238095238;0.476190476190476
Control.SRR15539824;37;40;0.567567567567568;16;21;0.0675675675675675;0.432432432432432
Control.SRR15539824;47;40;0.468085106382979;25;22;0.0319148936170213;0.468085106382979
Control.SRR15539824;42;40;0.404761904761905;25;17;0.0952380952380952;0.404761904761905
Control.SRR15539824;46;40;0.565217391304348;20;26;0.0652173913043478;0.434782608695652
Control.SRR15539824;41;40;0.536585365853659;19;22;0.0365853658536586;0.463414634146341
Control.SRR15539824;42;40;0.404761904761905;25;17;0.0952380952380952;0.404761904761905
Control.SRR15539824;42;40;0.452380952380952;23;19;0.0476190476190476;0.452380952380952
Control.SRR15539824;41;40;0.634146341463415;15;26;0.134146341463415;0.365853658536585
Control.SRR15539824;38;40;0.5;19;19;0;0.5
Control.SRR15539824;38;40;0.473684210526316;20;18;0.0263157894736842;0.473684210526316
Control.SRR15539824;38;40;0.368421052631579;24;14;0.131578947368421;0.368421052631579
Control.SRR15539824;43;40;0.581395348837209;18;25;0.0813953488372093;0.418604651162791
Control.SRR15539824;44;40;0.522727272727273;21;23;0.0227272727272727;0.477272727272727
Control.SRR15539824;39;40;0.538461538461538;18;21;0.0384615384615384;0.461538461538462
Control.SRR15539824;46;40;0.565217391304348;20;26;0.0652173913043478;0.434782608695652
Control.SRR15539824;42;40;0.5;21;21;0;0.5
Control.SRR15539824;38;40;0.526315789473684;18;20;0.0263157894736842;0.473684210526316
Control.SRR15539824;36;40;0.694444444444444;11;25;0.194444444444444;0.305555555555556
Control.SRR15539824;40;40;0.425;23;17;0.075;0.425
Control.SRR15539824;37;40;0.432432432432432;21;16;0.0675675675675675;0.432432432432432
Control.SRR15539824;41;40;0.585365853658537;17;24;0.0853658536585366;0.414634146341463
Control.SRR15539824;36;40;0.555555555555556;16;20;0.0555555555555556;0.444444444444444
Control.SRR15539824;44;40;0.522727272727273;21;23;0.0227272727272727;0.477272727272727
Control.SRR15539824;45;40;0.466666666666667;24;21;0.0333333333333333;0.466666666666667
Control.SRR15539824;40;40;0.55;18;22;0.05;0.45
Control.SRR15539824;38;40;0.368421052631579;24;14;0.131578947368421;0.368421052631579
Control.SRR15539824;40;40;0.475;21;19;0.025;0.475
Control.SRR15539824;36;40;0.555555555555556;16;20;0.0555555555555556;0.444444444444444
Control.SRR15539824;37;40;0.594594594594595;15;22;0.0945945945945946;0.405405405405405
Control.SRR15539824;40;40;0.475;21;19;0.025;0.475
Control.SRR15539824;43;40;0.395348837209302;26;17;0.104651162790698;0.395348837209302
Control.SRR15539824;43;40;0.604651162790698;17;26;0.104651162790698;0.395348837209302
Control.SRR15539824;44;40;0.522727272727273;21;23;0.0227272727272727;0.477272727272727
Control.SRR15539824;45;40;0.466666666666667;24;21;0.0333333333333333;0.466666666666667
Control.SRR15539824;42;40;0.523809523809524;20;22;0.0238095238095238;0.476190476190476
Control.SRR15539824;47;40;0.446808510638298;26;21;0.0531914893617021;0.446808510638298
Control.SRR15539824;35;40;0.542857142857143;16;19;0.0428571428571428;0.457142857142857
Control.SRR15539824;45;40;0.666666666666667;15;30;0.166666666666667;0.333333333333333
Control.SRR15539824;37;40;0.459459459459459;20;17;0.0405405405405405;0.459459459459459
Control.SRR15539824;43;40;0.534883720930233;20;23;0.0348837209302325;0.465116279069767
Control.SRR15539824;42;40;0.380952380952381;26;16;0.119047619047619;0.380952380952381
Control.SRR15539824;38;40;0.421052631578947;22;16;0.0789473684210527;0.421052631578947
Control.SRR15539824;36;40;0.416666666666667;21;15;0.0833333333333333;0.416666666666667
Control.SRR15539824;43;40;0.511627906976744;21;22;0.0116279069767442;0.488372093023256
Control.SRR15539824;36;40;0.555555555555556;16;20;0.0555555555555556;0.444444444444444
Control.SRR15539824;41;40;0.536585365853659;19;22;0.0365853658536586;0.463414634146341
Control.SRR15539824;44;40;0.568181818181818;19;25;0.0681818181818182;0.431818181818182
Control.SRR15539824;40;40;0.475;21;19;0.025;0.475
Control.SRR15539824;37;40;0.486486486486487;19;18;0.0135135135135135;0.486486486486487
Control.SRR15539824;35;40;0.514285714285714;17;18;0.0142857142857142;0.485714285714286
Control.SRR15539824;37;40;0.459459459459459;20;17;0.0405405405405405;0.459459459459459
Control.SRR15539824;45;40;0.511111111111111;22;23;0.0111111111111111;0.488888888888889
Control.SRR15539824;39;40;0.487179487179487;20;19;0.0128205128205128;0.487179487179487
Control.SRR15539824;37;40;0.621621621621622;14;23;0.121621621621622;0.378378378378378
Control.SRR15539824;44;40;0.477272727272727;23;21;0.0227272727272727;0.477272727272727
Control.SRR15539824;37;40;0.702702702702703;11;26;0.202702702702703;0.297297297297297
Control.SRR15539824;42;40;0.547619047619048;19;23;0.0476190476190477;0.452380952380952
Control.SRR15539824;44;40;0.5;22;22;0;0.5
Control.SRR15539824;44;40;0.477272727272727;23;21;0.0227272727272727;0.477272727272727
Control.SRR15539824;47;40;0.404255319148936;28;19;0.0957446808510639;0.404255319148936
Control.SRR15539824;44;40;0.522727272727273;21;23;0.0227272727272727;0.477272727272727
Control.SRR15539824;45;40;0.577777777777778;19;26;0.0777777777777777;0.422222222222222
Control.SRR15539824;43;40;0.465116279069767;23;20;0.0348837209302326;0.465116279069767
Control.SRR15539824;40;40;0.475;21;19;0.025;0.475
Control.SRR15539824;47;40;0.531914893617021;22;25;0.0319148936170213;0.468085106382979
Control.SRR15539824;39;40;0.512820512820513;19;20;0.0128205128205128;0.487179487179487
Control.SRR15539824;40;40;0.55;18;22;0.05;0.45
Control.SRR15539824;37;40;0.297297297297297;26;11;0.202702702702703;0.297297297297297
Control.SRR15539824;41;40;0.414634146341463;24;17;0.0853658536585366;0.414634146341463
Control.SRR15539824;42;40;0.428571428571429;24;18;0.0714285714285715;0.428571428571429
Control.SRR15539824;47;40;0.468085106382979;25;22;0.0319148936170213;0.468085106382979
Control.SRR15539824;47;40;0.553191489361702;21;26;0.0531914893617021;0.446808510638298
Control.SRR15539824;45;40;0.577777777777778;19;26;0.0777777777777777;0.422222222222222
Control.SRR15539824;42;40;0.428571428571429;24;18;0.0714285714285715;0.428571428571429
Control.SRR15539824;40;40;0.475;21;19;0.025;0.475
Control.SRR15539824;45;40;0.6;18;27;0.1;0.4
Control.SRR15539824;36;40;0.444444444444444;20;16;0.0555555555555556;0.444444444444444
Control.SRR15539824;43;40;0.418604651162791;25;18;0.0813953488372093;0.418604651162791
Control.SRR15539824;46;40;0.565217391304348;20;26;0.0652173913043478;0.434782608695652
Control.SRR15539824;39;40;0.435897435897436;22;17;0.0641025641025641;0.435897435897436
Control.SRR15539824;45;40;0.466666666666667;24;21;0.0333333333333333;0.466666666666667
Control.SRR15539824;42;40;0.547619047619048;19;23;0.0476190476190477;0.452380952380952
Control.SRR15539824;38;40;0.473684210526316;20;18;0.0263157894736842;0.473684210526316
Control.SRR15539824;39;40;0.692307692307692;12;27;0.192307692307692;0.307692307692308
Control.SRR15539824;37;40;0.567567567567568;16;21;0.0675675675675675;0.432432432432432
Control.SRR15539824;43;40;0.581395348837209;18;25;0.0813953488372093;0.418604651162791
Control.SRR15539824;36;40;0.555555555555556;16;20;0.0555555555555556;0.444444444444444
Control.SRR15539824;43;40;0.511627906976744;21;22;0.0116279069767442;0.488372093023256
Control.SRR15539824;44;40;0.386363636363636;27;17;0.113636363636364;0.386363636363636
Control.SRR15539824;40;40;0.6;16;24;0.1;0.4
Control.SRR15539824;39;40;0.358974358974359;25;14;0.141025641025641;0.358974358974359
Control.SRR15539824;45;40;0.466666666666667;24;21;0.0333333333333333;0.466666666666667
Control.SRR15539824;45;40;0.533333333333333;21;24;0.0333333333333333;0.466666666666667
Control.SRR15539824;39;40;0.358974358974359;25;14;0.141025641025641;0.358974358974359
Control.SRR15539824;39;40;0.358974358974359;25;14;0.141025641025641;0.358974358974359
Control.SRR15539824;42;40;0.452380952380952;23;19;0.0476190476190476;0.452380952380952
Control.SRR15539824;47;40;0.48936170212766;24;23;0.0106382978723404;0.48936170212766
Control.SRR15539824;37;40;0.486486486486487;19;18;0.0135135135135135;0.486486486486487
Control.SRR15539824;43;40;0.558139534883721;19;24;0.0581395348837209;0.441860465116279
Control.SRR15539824;38;40;0.473684210526316;20;18;0.0263157894736842;0.473684210526316
Control.SRR15539824;36;40;0.5;18;18;0;0.5
Control.SRR15539824;45;40;0.555555555555556;20;25;0.0555555555555556;0.444444444444444
Control.SRR15539824;39;40;0.435897435897436;22;17;0.0641025641025641;0.435897435897436
Control.SRR15539824;46;40;0.5;23;23;0;0.5
Control.SRR15539824;42;40;0.619047619047619;16;26;0.119047619047619;0.380952380952381
Control.SRR15539824;46;40;0.456521739130435;25;21;0.0434782608695652;0.456521739130435
Control.SRR15539824;35;40;0.571428571428571;15;20;0.0714285714285714;0.428571428571429
Control.SRR15539824;35;40;0.457142857142857;19;16;0.0428571428571429;0.457142857142857
Control.SRR15539824;46;40;0.521739130434783;22;24;0.0217391304347826;0.478260869565217
Control.SRR15539824;39;40;0.538461538461538;18;21;0.0384615384615384;0.461538461538462
Control.SRR15539824;45;40;0.311111111111111;31;14;0.188888888888889;0.311111111111111
Control.SRR15539824;41;40;0.390243902439024;25;16;0.109756097560976;0.390243902439024
Control.SRR15539824;38;40;0.447368421052632;21;17;0.0526315789473684;0.447368421052632
Control.SRR15539824;40;40;0.475;21;19;0.025;0.475
Control.SRR15539824;41;40;0.48780487804878;21;20;0.0121951219512195;0.48780487804878
Control.SRR15539824;36;40;0.361111111111111;23;13;0.138888888888889;0.361111111111111
Control.SRR15539824;44;40;0.477272727272727;23;21;0.0227272727272727;0.477272727272727
Control.SRR15539824;46;40;0.478260869565217;24;22;0.0217391304347826;0.478260869565217
Control.SRR15539824;36;40;0.611111111111111;14;22;0.111111111111111;0.388888888888889
Control.SRR15539824;38;40;0.447368421052632;21;17;0.0526315789473684;0.447368421052632
Control.SRR15539824;36;40;0.444444444444444;20;16;0.0555555555555556;0.444444444444444
Control.SRR15539824;46;40;0.456521739130435;25;21;0.0434782608695652;0.456521739130435
Control.SRR15539824;42;40;0.547619047619048;19;23;0.0476190476190477;0.452380952380952
Control.SRR15539824;47;40;0.51063829787234;23;24;0.0106382978723404;0.48936170212766
Control.SRR15539824;44;40;0.590909090909091;18;26;0.0909090909090909;0.409090909090909
Control.SRR15539824;41;40;0.463414634146341;22;19;0.0365853658536585;0.463414634146341
Control.SRR15539824;38;40;0.447368421052632;21;17;0.0526315789473684;0.447368421052632
Control.SRR15539824;42;40;0.452380952380952;23;19;0.0476190476190476;0.452380952380952
Control.SRR15539824;36;40;0.5;18;18;0;0.5
Control.SRR15539824;47;40;0.48936170212766;24;23;0.0106382978723404;0.48936170212766
Control.SRR15539824;36;40;0.388888888888889;22;14;0.111111111111111;0.388888888888889
Control.SRR15539824;36;40;0.555555555555556;16;20;0.0555555555555556;0.444444444444444
Control.SRR15539824;40;40;0.6;16;24;0.1;0.4
Control.SRR15539824;38;40;0.552631578947368;17;21;0.0526315789473685;0.447368421052632
Control.SRR15539824;36;40;0.611111111111111;14;22;0.111111111111111;0.388888888888889
Control.SRR15539824;37;40;0.405405405405405;22;15;0.0945945945945946;0.405405405405405
Control.SRR15539824;40;40;0.425;23;17;0.075;0.425
Control.SRR15539824;45;40;0.555555555555556;20;25;0.0555555555555556;0.444444444444444
Control.SRR15539824;45;40;0.511111111111111;22;23;0.0111111111111111;0.488888888888889
Control.SRR15539824;40;40;0.45;22;18;0.05;0.45
Control.SRR15539824;39;40;0.435897435897436;22;17;0.0641025641025641;0.435897435897436
Control.SRR15539824;37;40;0.459459459459459;20;17;0.0405405405405405;0.459459459459459
Control.SRR15539824;39;40;0.41025641025641;23;16;0.0897435897435898;0.41025641025641
Control.SRR15539824;47;40;0.595744680851064;19;28;0.0957446808510638;0.404255319148936
Control.SRR15539824;39;40;0.512820512820513;19;20;0.0128205128205128;0.487179487179487
Control.SRR15539824;35;40;0.371428571428571;22;13;0.128571428571429;0.371428571428571
Control.SRR15539824;47;40;0.468085106382979;25;22;0.0319148936170213;0.468085106382979
Control.SRR15539824;44;40;0.5;22;22;0;0.5
Control.SRR15539824;35;40;0.542857142857143;16;19;0.0428571428571428;0.457142857142857
Control.SRR15539824;38;40;0.447368421052632;21;17;0.0526315789473684;0.447368421052632
Control.SRR15539824;46;40;0.478260869565217;24;22;0.0217391304347826;0.478260869565217
Control.SRR15539824;44;40;0.590909090909091;18;26;0.0909090909090909;0.409090909090909
Control.SRR15539824;43;40;0.488372093023256;22;21;0.0116279069767442;0.488372093023256
Control.SRR15539824;47;40;0.553191489361702;21;26;0.0531914893617021;0.446808510638298
Control.SRR15539824;36;40;0.527777777777778;17;19;0.0277777777777778;0.472222222222222
Control.SRR15539824;38;40;0.447368421052632;21;17;0.0526315789473684;0.447368421052632
Control.SRR15539824;39;40;0.615384615384615;15;24;0.115384615384615;0.384615384615385
Control.SRR15539824;39;40;0.435897435897436;22;17;0.0641025641025641;0.435897435897436
Control.SRR15539824;44;40;0.363636363636364;28;16;0.136363636363636;0.363636363636364
Control.SRR15539824;41;40;0.463414634146341;22;19;0.0365853658536585;0.463414634146341
Control.SRR15539824;36;40;0.555555555555556;16;20;0.0555555555555556;0.444444444444444
Control.SRR15539824;42;40;0.642857142857143;15;27;0.142857142857143;0.357142857142857
Control.SRR15539824;44;40;0.545454545454545;20;24;0.0454545454545454;0.454545454545455
Control.SRR15539824;46;40;0.565217391304348;20;26;0.0652173913043478;0.434782608695652
Control.SRR15539824;45;40;0.577777777777778;19;26;0.0777777777777777;0.422222222222222
Control.SRR15539824;44;40;0.545454545454545;20;24;0.0454545454545454;0.454545454545455
Control.SRR15539824;41;40;0.51219512195122;20;21;0.0121951219512195;0.48780487804878
Control.SRR15539824;37;40;0.486486486486487;19;18;0.0135135135135135;0.486486486486487
Control.SRR15539824;42;40;0.285714285714286;30;12;0.214285714285714;0.285714285714286
Control.SRR15539824;38;40;0.368421052631579;24;14;0.131578947368421;0.368421052631579
Control.SRR15539824;38;40;0.578947368421053;16;22;0.0789473684210527;0.421052631578947
Control.SRR15539824;42;40;0.547619047619048;19;23;0.0476190476190477;0.452380952380952
Control.SRR15539824;45;40;0.511111111111111;22;23;0.0111111111111111;0.488888888888889
Control.SRR15539824;39;40;0.58974358974359;16;23;0.0897435897435898;0.41025641025641
Control.SRR15539824;36;40;0.583333333333333;15;21;0.0833333333333334;0.416666666666667
Control.SRR15539824;38;40;0.526315789473684;18;20;0.0263157894736842;0.473684210526316
Control.SRR15539824;39;40;0.538461538461538;18;21;0.0384615384615384;0.461538461538462
Control.SRR15539824;44;40;0.522727272727273;21;23;0.0227272727272727;0.477272727272727
Control.SRR15539824;36;40;0.444444444444444;20;16;0.0555555555555556;0.444444444444444
Control.SRR15539824;39;40;0.538461538461538;18;21;0.0384615384615384;0.461538461538462
Control.SRR15539824;40;40;0.45;22;18;0.05;0.45
Control.SRR15539824;46;40;0.5;23;23;0;0.5
Control.SRR15539824;38;40;0.394736842105263;23;15;0.105263157894737;0.394736842105263
Control.SRR15539824;42;40;0.428571428571429;24;18;0.0714285714285715;0.428571428571429
Control.SRR15539824;46;40;0.608695652173913;18;28;0.108695652173913;0.391304347826087
Control.SRR15539824;38;40;0.657894736842105;13;25;0.157894736842105;0.342105263157895
Control.SRR15539824;41;40;0.414634146341463;24;17;0.0853658536585366;0.414634146341463
Control.SRR15539824;47;40;0.51063829787234;23;24;0.0106382978723404;0.48936170212766
Control.SRR15539824;35;40;0.542857142857143;16;19;0.0428571428571428;0.457142857142857
Control.SRR15539824;40;40;0.55;18;22;0.05;0.45
Control.SRR15539824;40;40;0.125;35;5;0.375;0.125
Control.SRR15539824;43;40;0.348837209302326;28;15;0.151162790697674;0.348837209302326
Control.SRR15539824;41;40;0.463414634146341;22;19;0.0365853658536585;0.463414634146341
Control.SRR15539824;45;40;0.577777777777778;19;26;0.0777777777777777;0.422222222222222
Control.SRR15539824;43;40;0.465116279069767;23;20;0.0348837209302326;0.465116279069767
Control.SRR15539824;47;40;0.425531914893617;27;20;0.074468085106383;0.425531914893617
Control.SRR15539824;43;40;0.534883720930233;20;23;0.0348837209302325;0.465116279069767
Control.SRR15539824;39;40;0.487179487179487;20;19;0.0128205128205128;0.487179487179487
Control.SRR15539824;44;40;0.704545454545455;13;31;0.204545454545455;0.295454545454545
Control.SRR15539824;38;40;0.526315789473684;18;20;0.0263157894736842;0.473684210526316
Control.SRR15539824;35;40;0.342857142857143;23;12;0.157142857142857;0.342857142857143
Control.SRR15539824;41;40;0.463414634146341;22;19;0.0365853658536585;0.463414634146341
Control.SRR15539824;35;40;0.542857142857143;16;19;0.0428571428571428;0.457142857142857
Control.SRR15539824;35;40;0.542857142857143;16;19;0.0428571428571428;0.457142857142857
Control.SRR15539824;36;40;0.694444444444444;11;25;0.194444444444444;0.305555555555556
Control.SRR15539824;40;40;0.55;18;22;0.05;0.45
Control.SRR15539824;38;40;0.447368421052632;21;17;0.0526315789473684;0.447368421052632
Control.SRR15539824;42;40;0.619047619047619;16;26;0.119047619047619;0.380952380952381
Control.SRR15539824;36;40;0.416666666666667;21;15;0.0833333333333333;0.416666666666667
Control.SRR15539824;41;40;0.707317073170732;12;29;0.207317073170732;0.292682926829268
Control.SRR15539824;39;40;0.384615384615385;24;15;0.115384615384615;0.384615384615385
Control.SRR15539824;37;40;0.486486486486487;19;18;0.0135135135135135;0.486486486486487
Control.SRR15539824;47;40;0.531914893617021;22;25;0.0319148936170213;0.468085106382979
Control.SRR15539824;40;40;0.525;19;21;0.025;0.475
Control.SRR15539824;36;40;0.527777777777778;17;19;0.0277777777777778;0.472222222222222
Control.SRR15539824;42;40;0.380952380952381;26;16;0.119047619047619;0.380952380952381
Control.SRR15539824;46;40;0.478260869565217;24;22;0.0217391304347826;0.478260869565217
Control.SRR15539824;35;40;0.485714285714286;18;17;0.0142857142857143;0.485714285714286
Control.SRR15539824;35;40;0.571428571428571;15;20;0.0714285714285714;0.428571428571429
Control.SRR15539824;36;40;0.277777777777778;26;10;0.222222222222222;0.277777777777778
Control.SRR15539824;37;40;0.459459459459459;20;17;0.0405405405405405;0.459459459459459
Control.SRR15539824;43;40;0.488372093023256;22;21;0.0116279069767442;0.488372093023256
Control.SRR15539824;42;40;0.428571428571429;24;18;0.0714285714285715;0.428571428571429
Control.SRR15539824;44;40;0.431818181818182;25;19;0.0681818181818182;0.431818181818182
Control.SRR15539824;45;40;0.533333333333333;21;24;0.0333333333333333;0.466666666666667
Control.SRR15539824;38;40;0.342105263157895;25;13;0.157894736842105;0.342105263157895
Control.SRR15539824;41;40;0.48780487804878;21;20;0.0121951219512195;0.48780487804878
Control.SRR15539824;39;40;0.615384615384615;15;24;0.115384615384615;0.384615384615385
Control.SRR15539824;43;40;0.581395348837209;18;25;0.0813953488372093;0.418604651162791
Control.SRR15539824;40;40;0.525;19;21;0.025;0.475
Control.SRR15539824;44;40;0.522727272727273;21;23;0.0227272727272727;0.477272727272727
Control.SRR15539824;43;40;0.488372093023256;22;21;0.0116279069767442;0.488372093023256
Control.SRR15539824;43;40;0.418604651162791;25;18;0.0813953488372093;0.418604651162791
Control.SRR15539824;43;40;0.372093023255814;27;16;0.127906976744186;0.372093023255814
Control.SRR15539824;43;40;0.534883720930233;20;23;0.0348837209302325;0.465116279069767
Control.SRR15539824;43;40;0.465116279069767;23;20;0.0348837209302326;0.465116279069767
Control.SRR15539824;38;40;0.5;19;19;0;0.5
Control.SRR15539824;37;40;0.540540540540541;17;20;0.0405405405405406;0.459459459459459
Control.SRR15539824;36;40;0.527777777777778;17;19;0.0277777777777778;0.472222222222222
Control.SRR15539824;40;40;0.35;26;14;0.15;0.35
Control.SRR15539824;36;40;0.5;18;18;0;0.5
Control.SRR15539824;39;40;0.461538461538462;21;18;0.0384615384615384;0.461538461538462
Control.SRR15539824;38;40;0.421052631578947;22;16;0.0789473684210527;0.421052631578947
Control.SRR15539824;35;40;0.457142857142857;19;16;0.0428571428571429;0.457142857142857
Control.SRR15539824;42;40;0.476190476190476;22;20;0.0238095238095238;0.476190476190476
Control.SRR15539824;42;40;0.571428571428571;18;24;0.0714285714285714;0.428571428571429
Control.SRR15539824;39;40;0.58974358974359;16;23;0.0897435897435898;0.41025641025641
Control.SRR15539824;36;40;0.416666666666667;21;15;0.0833333333333333;0.416666666666667
Control.SRR15539824;40;40;0.55;18;22;0.05;0.45
Control.SRR15539824;38;40;0.552631578947368;17;21;0.0526315789473685;0.447368421052632
Control.SRR15539824;41;40;0.51219512195122;20;21;0.0121951219512195;0.48780487804878
Control.SRR15539824;44;40;0.454545454545455;24;20;0.0454545454545455;0.454545454545455
Control.SRR15539824;37;40;0.513513513513513;18;19;0.0135135135135135;0.486486486486487
Control.SRR15539824;36;40;0.444444444444444;20;16;0.0555555555555556;0.444444444444444
Control.SRR15539824;44;40;0.636363636363636;16;28;0.136363636363636;0.363636363636364
Control.SRR15539824;46;40;0.5;23;23;0;0.5
Control.SRR15539824;38;40;0.447368421052632;21;17;0.0526315789473684;0.447368421052632
Control.SRR15539824;40;40;0.55;18;22;0.05;0.45
Control.SRR15539824;39;40;0.41025641025641;23;16;0.0897435897435898;0.41025641025641
Control.SRR15539824;41;40;0.439024390243902;23;18;0.0609756097560976;0.439024390243902
Control.SRR15539824;35;40;0.542857142857143;16;19;0.0428571428571428;0.457142857142857
Control.SRR15539824;46;40;0.58695652173913;19;27;0.0869565217391305;0.41304347826087
Control.SRR15539824;36;40;0.388888888888889;22;14;0.111111111111111;0.388888888888889
Control.SRR15539824;37;40;0.621621621621622;14;23;0.121621621621622;0.378378378378378
Control.SRR15539824;39;40;0.435897435897436;22;17;0.0641025641025641;0.435897435897436
Control.SRR15539824;43;40;0.511627906976744;21;22;0.0116279069767442;0.488372093023256
Control.SRR15539824;44;40;0.545454545454545;20;24;0.0454545454545454;0.454545454545455
Control.SRR15539824;38;40;0.657894736842105;13;25;0.157894736842105;0.342105263157895
Control.SRR15539824;44;40;0.386363636363636;27;17;0.113636363636364;0.386363636363636
Control.SRR15539824;46;40;0.630434782608696;17;29;0.130434782608696;0.369565217391304
Control.SRR15539824;36;40;0.472222222222222;19;17;0.0277777777777778;0.472222222222222
Control.SRR15539824;38;40;0.394736842105263;23;15;0.105263157894737;0.394736842105263
Control.SRR15539824;43;40;0.441860465116279;24;19;0.0581395348837209;0.441860465116279
Control.SRR15539824;36;40;0.527777777777778;17;19;0.0277777777777778;0.472222222222222
Control.SRR15539824;42;40;0.476190476190476;22;20;0.0238095238095238;0.476190476190476
Control.SRR15539824;39;40;0.461538461538462;21;18;0.0384615384615384;0.461538461538462
Control.SRR15539824;43;40;0.395348837209302;26;17;0.104651162790698;0.395348837209302
Control.SRR15539824;46;40;0.5;23;23;0;0.5
Control.SRR15539824;44;40;0.454545454545455;24;20;0.0454545454545455;0.454545454545455
Control.SRR15539824;38;40;0.473684210526316;20;18;0.0263157894736842;0.473684210526316
Control.SRR15539824;41;40;0.585365853658537;17;24;0.0853658536585366;0.414634146341463
Control.SRR15539824;40;40;0.525;19;21;0.025;0.475
Control.SRR15539824;43;40;0.534883720930233;20;23;0.0348837209302325;0.465116279069767
Control.SRR15539824;44;40;0.386363636363636;27;17;0.113636363636364;0.386363636363636
Control.SRR15539824;38;40;0.526315789473684;18;20;0.0263157894736842;0.473684210526316
Control.SRR15539824;40;40;0.425;23;17;0.075;0.425
Control.SRR15539824;43;40;0.418604651162791;25;18;0.0813953488372093;0.418604651162791
Control.SRR15539824;43;40;0.418604651162791;25;18;0.0813953488372093;0.418604651162791
Control.SRR15539824;44;40;0.545454545454545;20;24;0.0454545454545454;0.454545454545455
Control.SRR15539824;36;40;0.444444444444444;20;16;0.0555555555555556;0.444444444444444
Control.SRR15539824;44;40;0.522727272727273;21;23;0.0227272727272727;0.477272727272727
Control.SRR15539824;45;40;0.577777777777778;19;26;0.0777777777777777;0.422222222222222
Control.SRR15539824;35;40;0.342857142857143;23;12;0.157142857142857;0.342857142857143
Control.SRR15539824;41;40;0.48780487804878;21;20;0.0121951219512195;0.48780487804878
Control.SRR15539824;42;40;0.595238095238095;17;25;0.0952380952380952;0.404761904761905
Control.SRR15539824;42;40;0.547619047619048;19;23;0.0476190476190477;0.452380952380952
Control.SRR15539824;39;40;0.435897435897436;22;17;0.0641025641025641;0.435897435897436
Control.SRR15539824;39;40;0.512820512820513;19;20;0.0128205128205128;0.487179487179487
Control.SRR15539824;36;40;0.583333333333333;15;21;0.0833333333333334;0.416666666666667
Control.SRR15539824;44;40;0.522727272727273;21;23;0.0227272727272727;0.477272727272727
Control.SRR15539824;40;40;0.475;21;19;0.025;0.475
Control.SRR15539824;42;40;0.547619047619048;19;23;0.0476190476190477;0.452380952380952
Control.SRR15539824;44;40;0.5;22;22;0;0.5
Control.SRR15539824;47;40;0.425531914893617;27;20;0.074468085106383;0.425531914893617
Control.SRR15539824;43;40;0.581395348837209;18;25;0.0813953488372093;0.418604651162791
Control.SRR15539824;40;40;0.425;23;17;0.075;0.425
Control.SRR15539824;37;40;0.513513513513513;18;19;0.0135135135135135;0.486486486486487
Control.SRR15539824;37;40;0.432432432432432;21;16;0.0675675675675675;0.432432432432432
Control.SRR15539824;41;40;0.634146341463415;15;26;0.134146341463415;0.365853658536585
Control.SRR15539824;39;40;0.384615384615385;24;15;0.115384615384615;0.384615384615385
Control.SRR15539824;35;40;0.657142857142857;12;23;0.157142857142857;0.342857142857143
Control.SRR15539824;35;40;0.685714285714286;11;24;0.185714285714286;0.314285714285714
Control.SRR15539824;41;40;0.463414634146341;22;19;0.0365853658536585;0.463414634146341
Control.SRR15539824;39;40;0.384615384615385;24;15;0.115384615384615;0.384615384615385
Control.SRR15539824;35;40;0.628571428571429;13;22;0.128571428571429;0.371428571428571
Control.SRR15539824;44;40;0.5;22;22;0;0.5
Control.SRR15539824;38;40;0.578947368421053;16;22;0.0789473684210527;0.421052631578947
Control.SRR15539824;42;40;0.619047619047619;16;26;0.119047619047619;0.380952380952381
Control.SRR15539824;46;40;0.565217391304348;20;26;0.0652173913043478;0.434782608695652
Control.SRR15539824;44;40;0.477272727272727;23;21;0.0227272727272727;0.477272727272727
Control.SRR15539824;47;40;0.531914893617021;22;25;0.0319148936170213;0.468085106382979
Control.SRR15539824;35;40;0.4;21;14;0.1;0.4
Control.SRR15539824;35;40;0.542857142857143;16;19;0.0428571428571428;0.457142857142857
Control.SRR15539824;42;40;0.428571428571429;24;18;0.0714285714285715;0.428571428571429
Control.SRR15539824;39;40;0.564102564102564;17;22;0.0641025641025641;0.435897435897436
Control.SRR15539824;36;40;0.583333333333333;15;21;0.0833333333333334;0.416666666666667
Control.SRR15539824;35;40;0.457142857142857;19;16;0.0428571428571429;0.457142857142857
Control.SRR15539824;35;40;0.457142857142857;19;16;0.0428571428571429;0.457142857142857
Control.SRR15539824;39;40;0.564102564102564;17;22;0.0641025641025641;0.435897435897436
Control.SRR15539824;36;40;0.333333333333333;24;12;0.166666666666667;0.333333333333333
Control.SRR15539824;42;40;0.595238095238095;17;25;0.0952380952380952;0.404761904761905
Control.SRR15539824;43;40;0.488372093023256;22;21;0.0116279069767442;0.488372093023256
Control.SRR15539824;43;40;0.441860465116279;24;19;0.0581395348837209;0.441860465116279
Control.SRR15539824;44;40;0.5;22;22;0;0.5
Control.SRR15539824;44;40;0.659090909090909;15;29;0.159090909090909;0.340909090909091
Control.SRR15539824;44;40;0.454545454545455;24;20;0.0454545454545455;0.454545454545455
Control.SRR15539824;42;40;0.476190476190476;22;20;0.0238095238095238;0.476190476190476
Control.SRR15539824;47;40;0.574468085106383;20;27;0.074468085106383;0.425531914893617
Control.SRR15539824;35;40;0.371428571428571;22;13;0.128571428571429;0.371428571428571
Control.SRR15539824;36;40;0.416666666666667;21;15;0.0833333333333333;0.416666666666667
Control.SRR15539824;36;40;0.5;18;18;0;0.5
Control.SRR15539824;37;40;0.567567567567568;16;21;0.0675675675675675;0.432432432432432
Control.SRR15539824;43;40;0.325581395348837;29;14;0.174418604651163;0.325581395348837
Control.SRR15539824;35;40;0.514285714285714;17;18;0.0142857142857142;0.485714285714286
Control.SRR15539824;40;40;0.425;23;17;0.075;0.425
Control.SRR15539824;35;40;0.4;21;14;0.1;0.4
Control.SRR15539824;40;40;0.525;19;21;0.025;0.475
Control.SRR15539824;36;40;0.472222222222222;19;17;0.0277777777777778;0.472222222222222
Control.SRR15539824;36;40;0.722222222222222;10;26;0.222222222222222;0.277777777777778
Control.SRR15539824;45;40;0.511111111111111;22;23;0.0111111111111111;0.488888888888889
Control.SRR15539824;47;40;0.574468085106383;20;27;0.074468085106383;0.425531914893617
Control.SRR15539824;37;40;0.486486486486487;19;18;0.0135135135135135;0.486486486486487
Control.SRR15539824;36;40;0.416666666666667;21;15;0.0833333333333333;0.416666666666667
Control.SRR15539824;36;40;0.527777777777778;17;19;0.0277777777777778;0.472222222222222
Control.SRR15539824;45;40;0.533333333333333;21;24;0.0333333333333333;0.466666666666667
Control.SRR15539824;46;40;0.434782608695652;26;20;0.0652173913043478;0.434782608695652
Control.SRR15539824;46;40;0.478260869565217;24;22;0.0217391304347826;0.478260869565217
Control.SRR15539824;38;40;0.631578947368421;14;24;0.131578947368421;0.368421052631579
Control.SRR15539824;36;40;0.416666666666667;21;15;0.0833333333333333;0.416666666666667
Control.SRR15539824;39;40;0.538461538461538;18;21;0.0384615384615384;0.461538461538462
Control.SRR15539824;39;40;0.512820512820513;19;20;0.0128205128205128;0.487179487179487
Control.SRR15539824;37;40;0.594594594594595;15;22;0.0945945945945946;0.405405405405405
Control.SRR15539824;37;40;0.540540540540541;17;20;0.0405405405405406;0.459459459459459
Control.SRR15539824;47;40;0.425531914893617;27;20;0.074468085106383;0.425531914893617
Control.SRR15539824;39;40;0.487179487179487;20;19;0.0128205128205128;0.487179487179487
Control.SRR15539824;37;40;0.405405405405405;22;15;0.0945945945945946;0.405405405405405
Control.SRR15539824;36;40;0.444444444444444;20;16;0.0555555555555556;0.444444444444444
Control.SRR15539824;45;40;0.511111111111111;22;23;0.0111111111111111;0.488888888888889
Control.SRR15539824;47;40;0.51063829787234;23;24;0.0106382978723404;0.48936170212766
Control.SRR15539824;42;40;0.595238095238095;17;25;0.0952380952380952;0.404761904761905
Control.SRR15539824;39;40;0.307692307692308;27;12;0.192307692307692;0.307692307692308
Control.SRR15539824;36;40;0.583333333333333;15;21;0.0833333333333334;0.416666666666667
Control.SRR15539824;36;40;0.5;18;18;0;0.5
Control.SRR15539824;44;40;0.477272727272727;23;21;0.0227272727272727;0.477272727272727
Control.SRR15539824;43;40;0.465116279069767;23;20;0.0348837209302326;0.465116279069767
Control.SRR15539824;38;40;0.447368421052632;21;17;0.0526315789473684;0.447368421052632
Control.SRR15539824;36;40;0.555555555555556;16;20;0.0555555555555556;0.444444444444444
Control.SRR15539824;39;40;0.615384615384615;15;24;0.115384615384615;0.384615384615385
Control.SRR15539824;38;40;0.578947368421053;16;22;0.0789473684210527;0.421052631578947
Control.SRR15539824;35;40;0.571428571428571;15;20;0.0714285714285714;0.428571428571429
Control.SRR15539824;37;40;0.594594594594595;15;22;0.0945945945945946;0.405405405405405
Control.SRR15539824;35;40;0.514285714285714;17;18;0.0142857142857142;0.485714285714286
Control.SRR15539824;46;40;0.41304347826087;27;19;0.0869565217391304;0.41304347826087
Control.SRR15539824;46;40;0.58695652173913;19;27;0.0869565217391305;0.41304347826087
Control.SRR15539824;39;40;0.538461538461538;18;21;0.0384615384615384;0.461538461538462
Control.SRR15539824;43;40;0.418604651162791;25;18;0.0813953488372093;0.418604651162791
Control.SRR15539824;45;40;0.4;27;18;0.1;0.4
Control.SRR15539824;42;40;0.476190476190476;22;20;0.0238095238095238;0.476190476190476
Control.SRR15539824;40;40;0.65;14;26;0.15;0.35
Control.SRR15539824;38;40;0.447368421052632;21;17;0.0526315789473684;0.447368421052632
Control.SRR15539824;36;40;0.527777777777778;17;19;0.0277777777777778;0.472222222222222
Control.SRR15539824;37;40;0.540540540540541;17;20;0.0405405405405406;0.459459459459459
Control.SRR15539824;41;40;0.414634146341463;24;17;0.0853658536585366;0.414634146341463
Control.SRR15539824;40;40;0.475;21;19;0.025;0.475
Control.SRR15539824;44;40;0.522727272727273;21;23;0.0227272727272727;0.477272727272727
Control.SRR15539824;45;40;0.577777777777778;19;26;0.0777777777777777;0.422222222222222
Control.SRR15539824;36;40;0.527777777777778;17;19;0.0277777777777778;0.472222222222222
Control.SRR15539824;38;40;0.421052631578947;22;16;0.0789473684210527;0.421052631578947
Control.SRR15539824;35;40;0.6;14;21;0.1;0.4
Control.SRR15539824;40;40;0.4;24;16;0.1;0.4
Control.SRR15539824;42;40;0.5;21;21;0;0.5
Control.SRR15539824;41;40;0.48780487804878;21;20;0.0121951219512195;0.48780487804878
Control.SRR15539824;35;40;0.371428571428571;22;13;0.128571428571429;0.371428571428571
Control.SRR15539824;35;40;0.571428571428571;15;20;0.0714285714285714;0.428571428571429
Control.SRR15539824;39;40;0.435897435897436;22;17;0.0641025641025641;0.435897435897436
Control.SRR15539824;35;40;0.514285714285714;17;18;0.0142857142857142;0.485714285714286
Control.SRR15539824;37;40;0.567567567567568;16;21;0.0675675675675675;0.432432432432432
Control.SRR15539824;44;40;0.363636363636364;28;16;0.136363636363636;0.363636363636364
Control.SRR15539824;43;40;0.534883720930233;20;23;0.0348837209302325;0.465116279069767
Control.SRR15539824;43;40;0.558139534883721;19;24;0.0581395348837209;0.441860465116279
Control.SRR15539824;38;40;0.552631578947368;17;21;0.0526315789473685;0.447368421052632
Control.SRR15539824;41;40;0.585365853658537;17;24;0.0853658536585366;0.414634146341463
Control.SRR15539824;44;40;0.5;22;22;0;0.5
Control.SRR15539824;38;40;0.447368421052632;21;17;0.0526315789473684;0.447368421052632
Control.SRR15539824;35;40;0.6;14;21;0.1;0.4
Control.SRR15539824;35;40;0.485714285714286;18;17;0.0142857142857143;0.485714285714286
Control.SRR15539824;38;40;0.5;19;19;0;0.5
Control.SRR15539824;36;40;0.388888888888889;22;14;0.111111111111111;0.388888888888889
Control.SRR15539824;39;40;0.435897435897436;22;17;0.0641025641025641;0.435897435897436
Control.SRR15539824;35;40;0.428571428571429;20;15;0.0714285714285715;0.428571428571429
Control.SRR15539824;40;40;0.45;22;18;0.05;0.45
Control.SRR15539824;39;40;0.487179487179487;20;19;0.0128205128205128;0.487179487179487
Control.SRR15539824;37;40;0.513513513513513;18;19;0.0135135135135135;0.486486486486487
Control.SRR15539824;39;40;0.435897435897436;22;17;0.0641025641025641;0.435897435897436
Control.SRR15539824;41;40;0.463414634146341;22;19;0.0365853658536585;0.463414634146341
Control.SRR15539824;37;40;0.702702702702703;11;26;0.202702702702703;0.297297297297297
Control.SRR15539824;44;40;0.386363636363636;27;17;0.113636363636364;0.386363636363636
Control.SRR15539824;43;40;0.534883720930233;20;23;0.0348837209302325;0.465116279069767
Control.SRR15539824;36;40;0.416666666666667;21;15;0.0833333333333333;0.416666666666667
Control.SRR15539824;42;40;0.523809523809524;20;22;0.0238095238095238;0.476190476190476
Control.SRR15539824;39;40;0.435897435897436;22;17;0.0641025641025641;0.435897435897436
Control.SRR15539824;42;40;0.523809523809524;20;22;0.0238095238095238;0.476190476190476
Control.SRR15539824;35;40;0.6;14;21;0.1;0.4
Control.SRR15539824;35;40;0.542857142857143;16;19;0.0428571428571428;0.457142857142857
Control.SRR15539824;41;40;0.414634146341463;24;17;0.0853658536585366;0.414634146341463
Control.SRR15539824;39;40;0.512820512820513;19;20;0.0128205128205128;0.487179487179487
Control.SRR15539824;37;40;0.621621621621622;14;23;0.121621621621622;0.378378378378378
Control.SRR15539824;39;40;0.487179487179487;20;19;0.0128205128205128;0.487179487179487
Control.SRR15539824;46;40;0.5;23;23;0;0.5
Control.SRR15539824;44;40;0.386363636363636;27;17;0.113636363636364;0.386363636363636
Control.SRR15539824;43;40;0.534883720930233;20;23;0.0348837209302325;0.465116279069767
Control.SRR15539824;35;40;0.4;21;14;0.1;0.4
Control.SRR15539824;40;40;0.475;21;19;0.025;0.475
Control.SRR15539824;47;40;0.531914893617021;22;25;0.0319148936170213;0.468085106382979
Control.SRR15539824;46;40;0.478260869565217;24;22;0.0217391304347826;0.478260869565217
Control.SRR15539824;38;40;0.421052631578947;22;16;0.0789473684210527;0.421052631578947
Control.SRR15539824;41;40;0.48780487804878;21;20;0.0121951219512195;0.48780487804878
Control.SRR15539824;43;40;0.511627906976744;21;22;0.0116279069767442;0.488372093023256
Control.SRR15539824;44;40;0.545454545454545;20;24;0.0454545454545454;0.454545454545455
Control.SRR15539824;40;40;0.575;17;23;0.075;0.425
Control.SRR15539824;40;40;0.5;20;20;0;0.5
Control.SRR15539824;46;40;0.5;23;23;0;0.5
Control.SRR15539824;38;40;0.631578947368421;14;24;0.131578947368421;0.368421052631579
Control.SRR15539824;36;40;0.5;18;18;0;0.5
Control.SRR15539824;42;40;0.523809523809524;20;22;0.0238095238095238;0.476190476190476
Control.SRR15539824;42;40;0.523809523809524;20;22;0.0238095238095238;0.476190476190476
Control.SRR15539824;45;40;0.511111111111111;22;23;0.0111111111111111;0.488888888888889
Control.SRR15539824;42;40;0.476190476190476;22;20;0.0238095238095238;0.476190476190476
Control.SRR15539824;39;40;0.615384615384615;15;24;0.115384615384615;0.384615384615385
Control.SRR15539824;45;40;0.488888888888889;23;22;0.0111111111111111;0.488888888888889
Control.SRR15539824;38;40;0.763157894736842;9;29;0.263157894736842;0.236842105263158
Control.SRR15539824;35;40;0.4;21;14;0.1;0.4
Control.SRR15539824;37;40;0.432432432432432;21;16;0.0675675675675675;0.432432432432432
Control.SRR15539824;43;40;0.465116279069767;23;20;0.0348837209302326;0.465116279069767
Control.SRR15539824;37;40;0.432432432432432;21;16;0.0675675675675675;0.432432432432432
Control.SRR15539824;35;40;0.428571428571429;20;15;0.0714285714285715;0.428571428571429
Control.SRR15539824;37;40;0.351351351351351;24;13;0.148648648648649;0.351351351351351
Control.SRR15539824;42;40;0.452380952380952;23;19;0.0476190476190476;0.452380952380952
Control.SRR15539824;36;40;0.555555555555556;16;20;0.0555555555555556;0.444444444444444
Control.SRR15539824;42;40;0.547619047619048;19;23;0.0476190476190477;0.452380952380952
Control.SRR15539824;47;40;0.404255319148936;28;19;0.0957446808510639;0.404255319148936
Control.SRR15539824;37;40;0.486486486486487;19;18;0.0135135135135135;0.486486486486487
Control.SRR15539824;41;40;0.536585365853659;19;22;0.0365853658536586;0.463414634146341
Control.SRR15539824;38;40;0.552631578947368;17;21;0.0526315789473685;0.447368421052632
Control.SRR15539824;39;40;0.512820512820513;19;20;0.0128205128205128;0.487179487179487
Control.SRR15539824;37;40;0.594594594594595;15;22;0.0945945945945946;0.405405405405405
Control.SRR15539824;39;40;0.538461538461538;18;21;0.0384615384615384;0.461538461538462
Control.SRR15539824;45;40;0.6;18;27;0.1;0.4
Control.SRR15539824;37;40;0.513513513513513;18;19;0.0135135135135135;0.486486486486487
Control.SRR15539824;38;40;0.631578947368421;14;24;0.131578947368421;0.368421052631579
Control.SRR15539824;40;40;0.45;22;18;0.05;0.45
Control.SRR15539824;37;40;0.459459459459459;20;17;0.0405405405405405;0.459459459459459
Control.SRR15539824;40;40;0.5;20;20;0;0.5
Control.SRR15539824;41;40;0.536585365853659;19;22;0.0365853658536586;0.463414634146341
Control.SRR15539824;46;40;0.5;23;23;0;0.5
Control.SRR15539824;42;40;0.357142857142857;27;15;0.142857142857143;0.357142857142857
Control.SRR15539824;36;40;0.555555555555556;16;20;0.0555555555555556;0.444444444444444
Control.SRR15539824;36;40;0.472222222222222;19;17;0.0277777777777778;0.472222222222222
Control.SRR15539824;36;40;0.583333333333333;15;21;0.0833333333333334;0.416666666666667
Control.SRR15539824;36;40;0.5;18;18;0;0.5
Control.SRR15539824;42;40;0.69047619047619;13;29;0.19047619047619;0.30952380952381
Control.SRR15539824;47;40;0.531914893617021;22;25;0.0319148936170213;0.468085106382979
Control.SRR15539824;42;40;0.452380952380952;23;19;0.0476190476190476;0.452380952380952
Control.SRR15539824;41;40;0.463414634146341;22;19;0.0365853658536585;0.463414634146341
Control.SRR15539824;39;40;0.538461538461538;18;21;0.0384615384615384;0.461538461538462
Control.SRR15539824;41;40;0.390243902439024;25;16;0.109756097560976;0.390243902439024
Control.SRR15539824;37;40;0.378378378378378;23;14;0.121621621621622;0.378378378378378
Control.SRR15539824;38;40;0.473684210526316;20;18;0.0263157894736842;0.473684210526316
Control.SRR15539824;36;40;0.5;18;18;0;0.5
Control.SRR15539824;44;40;0.522727272727273;21;23;0.0227272727272727;0.477272727272727
Control.SRR15539824;46;40;0.58695652173913;19;27;0.0869565217391305;0.41304347826087
Control.SRR15539824;37;40;0.432432432432432;21;16;0.0675675675675675;0.432432432432432
Control.SRR15539824;42;40;0.261904761904762;31;11;0.238095238095238;0.261904761904762
Control.SRR15539824;38;40;0.473684210526316;20;18;0.0263157894736842;0.473684210526316
Control.SRR15539824;42;40;0.452380952380952;23;19;0.0476190476190476;0.452380952380952
Control.SRR15539824;43;40;0.372093023255814;27;16;0.127906976744186;0.372093023255814
Control.SRR15539824;35;40;0.485714285714286;18;17;0.0142857142857143;0.485714285714286
Control.SRR15539824;38;40;0.578947368421053;16;22;0.0789473684210527;0.421052631578947
Control.SRR15539824;38;40;0.473684210526316;20;18;0.0263157894736842;0.473684210526316
Control.SRR15539824;35;40;0.514285714285714;17;18;0.0142857142857142;0.485714285714286
Control.SRR15539824;45;40;0.6;18;27;0.1;0.4
Control.SRR15539824;36;40;0.444444444444444;20;16;0.0555555555555556;0.444444444444444
Control.SRR15539824;44;40;0.522727272727273;21;23;0.0227272727272727;0.477272727272727
Control.SRR15539824;43;40;0.325581395348837;29;14;0.174418604651163;0.325581395348837
Control.SRR15539824;42;40;0.547619047619048;19;23;0.0476190476190477;0.452380952380952
Control.SRR15539824;38;40;0.526315789473684;18;20;0.0263157894736842;0.473684210526316
Control.SRR15539824;40;40;0.475;21;19;0.025;0.475
Control.SRR15539824;46;40;0.456521739130435;25;21;0.0434782608695652;0.456521739130435
Control.SRR15539824;35;40;0.542857142857143;16;19;0.0428571428571428;0.457142857142857
Control.SRR15539824;39;40;0.487179487179487;20;19;0.0128205128205128;0.487179487179487
Control.SRR15539824;37;40;0.567567567567568;16;21;0.0675675675675675;0.432432432432432
Control.SRR15539824;46;40;0.369565217391304;29;17;0.130434782608696;0.369565217391304
Control.SRR15539824;46;40;0.456521739130435;25;21;0.0434782608695652;0.456521739130435
Control.SRR15539824;44;40;0.659090909090909;15;29;0.159090909090909;0.340909090909091
Control.SRR15539824;37;40;0.513513513513513;18;19;0.0135135135135135;0.486486486486487
Control.SRR15539824;45;40;0.577777777777778;19;26;0.0777777777777777;0.422222222222222
Control.SRR15539824;42;40;0.476190476190476;22;20;0.0238095238095238;0.476190476190476
Control.SRR15539824;45;40;0.466666666666667;24;21;0.0333333333333333;0.466666666666667
Control.SRR15539824;39;40;0.666666666666667;13;26;0.166666666666667;0.333333333333333
Control.SRR15539824;39;40;0.333333333333333;26;13;0.166666666666667;0.333333333333333
Control.SRR15539824;43;40;0.465116279069767;23;20;0.0348837209302326;0.465116279069767
Control.SRR15539824;42;40;0.571428571428571;18;24;0.0714285714285714;0.428571428571429
Control.SRR15539824;39;40;0.512820512820513;19;20;0.0128205128205128;0.487179487179487
Control.SRR15539824;40;40;0.325;27;13;0.175;0.325
Control.SRR15539824;39;40;0.487179487179487;20;19;0.0128205128205128;0.487179487179487
Control.SRR15539824;38;40;0.5;19;19;0;0.5
Control.SRR15539824;43;40;0.511627906976744;21;22;0.0116279069767442;0.488372093023256
Control.SRR15539824;40;40;0.525;19;21;0.025;0.475
Control.SRR15539824;39;40;0.358974358974359;25;14;0.141025641025641;0.358974358974359
Control.SRR15539824;40;40;0.6;16;24;0.1;0.4
Control.SRR15539824;43;40;0.558139534883721;19;24;0.0581395348837209;0.441860465116279
Control.SRR15539824;42;40;0.428571428571429;24;18;0.0714285714285715;0.428571428571429
Control.SRR15539824;36;40;0.416666666666667;21;15;0.0833333333333333;0.416666666666667
Control.SRR15539824;35;40;0.428571428571429;20;15;0.0714285714285715;0.428571428571429
Control.SRR15539824;35;40;0.485714285714286;18;17;0.0142857142857143;0.485714285714286
Control.SRR15539824;41;40;0.48780487804878;21;20;0.0121951219512195;0.48780487804878
Control.SRR15539824;38;40;0.315789473684211;26;12;0.184210526315789;0.315789473684211
Control.SRR15539824;40;40;0.425;23;17;0.075;0.425
Control.SRR15539824;35;40;0.485714285714286;18;17;0.0142857142857143;0.485714285714286
Control.SRR15539824;43;40;0.372093023255814;27;16;0.127906976744186;0.372093023255814
Control.SRR15539824;43;40;0.651162790697674;15;28;0.151162790697674;0.348837209302326
Control.SRR15539824;35;40;0.685714285714286;11;24;0.185714285714286;0.314285714285714
Control.SRR15539824;45;40;0.488888888888889;23;22;0.0111111111111111;0.488888888888889
Control.SRR15539824;41;40;0.560975609756098;18;23;0.0609756097560976;0.439024390243902
Control.SRR15539824;41;40;0.463414634146341;22;19;0.0365853658536585;0.463414634146341
Control.SRR15539824;41;40;0.414634146341463;24;17;0.0853658536585366;0.414634146341463
Control.SRR15539824;44;40;0.545454545454545;20;24;0.0454545454545454;0.454545454545455
Control.SRR15539824;41;40;0.390243902439024;25;16;0.109756097560976;0.390243902439024
Control.SRR15539824;37;40;0.486486486486487;19;18;0.0135135135135135;0.486486486486487
Control.SRR15539824;36;40;0.444444444444444;20;16;0.0555555555555556;0.444444444444444
Control.SRR15539824;39;40;0.461538461538462;21;18;0.0384615384615384;0.461538461538462
Control.SRR15539824;37;40;0.567567567567568;16;21;0.0675675675675675;0.432432432432432
Control.SRR15539824;35;40;0.542857142857143;16;19;0.0428571428571428;0.457142857142857
Control.SRR15539824;35;40;0.542857142857143;16;19;0.0428571428571428;0.457142857142857
Control.SRR15539824;38;40;0.605263157894737;15;23;0.105263157894737;0.394736842105263
Control.SRR15539824;37;40;0.648648648648649;13;24;0.148648648648649;0.351351351351351
Control.SRR15539824;39;40;0.615384615384615;15;24;0.115384615384615;0.384615384615385
Control.SRR15539824;45;40;0.444444444444444;25;20;0.0555555555555556;0.444444444444444
Control.SRR15539824;39;40;0.435897435897436;22;17;0.0641025641025641;0.435897435897436
Control.SRR15539824;41;40;0.658536585365854;14;27;0.158536585365854;0.341463414634146
Control.SRR15539824;43;40;0.627906976744186;16;27;0.127906976744186;0.372093023255814
Control.SRR15539824;36;40;0.611111111111111;14;22;0.111111111111111;0.388888888888889
Control.SRR15539824;38;40;0.421052631578947;22;16;0.0789473684210527;0.421052631578947
Control.SRR15539824;36;40;0.5;18;18;0;0.5
Control.SRR15539824;41;40;0.439024390243902;23;18;0.0609756097560976;0.439024390243902
Control.SRR15539824;41;40;0.536585365853659;19;22;0.0365853658536586;0.463414634146341
Control.SRR15539824;40;40;0.475;21;19;0.025;0.475
Control.SRR15539824;44;40;0.431818181818182;25;19;0.0681818181818182;0.431818181818182
Control.SRR15539824;35;40;0.457142857142857;19;16;0.0428571428571429;0.457142857142857
Control.SRR15539824;44;40;0.5;22;22;0;0.5
Control.SRR15539824;35;40;0.485714285714286;18;17;0.0142857142857143;0.485714285714286
Control.SRR15539824;38;40;0.5;19;19;0;0.5
Control.SRR15539824;45;40;0.622222222222222;17;28;0.122222222222222;0.377777777777778
Control.SRR15539824;42;40;0.476190476190476;22;20;0.0238095238095238;0.476190476190476
Control.SRR15539824;41;40;0.439024390243902;23;18;0.0609756097560976;0.439024390243902
Control.SRR15539824;42;40;0.404761904761905;25;17;0.0952380952380952;0.404761904761905
Control.SRR15539824;38;40;0.631578947368421;14;24;0.131578947368421;0.368421052631579
Control.SRR15539824;39;40;0.487179487179487;20;19;0.0128205128205128;0.487179487179487
Control.SRR15539824;35;40;0.514285714285714;17;18;0.0142857142857142;0.485714285714286
Control.SRR15539824;42;40;0.5;21;21;0;0.5
Control.SRR15539824;41;40;0.48780487804878;21;20;0.0121951219512195;0.48780487804878
Control.SRR15539824;42;40;0.404761904761905;25;17;0.0952380952380952;0.404761904761905
Control.SRR15539824;40;40;0.375;25;15;0.125;0.375
Control.SRR15539824;39;40;0.333333333333333;26;13;0.166666666666667;0.333333333333333
Control.SRR15539824;38;40;0.631578947368421;14;24;0.131578947368421;0.368421052631579
Control.SRR15539824;40;40;0.475;21;19;0.025;0.475
Control.SRR15539824;37;40;0.567567567567568;16;21;0.0675675675675675;0.432432432432432
Control.SRR15539824;42;40;0.5;21;21;0;0.5
Control.SRR15539824;36;40;0.5;18;18;0;0.5
Control.SRR15539824;42;40;0.547619047619048;19;23;0.0476190476190477;0.452380952380952
Control.SRR15539824;45;40;0.511111111111111;22;23;0.0111111111111111;0.488888888888889
Control.SRR15539824;43;40;0.651162790697674;15;28;0.151162790697674;0.348837209302326
Control.SRR15539824;36;40;0.555555555555556;16;20;0.0555555555555556;0.444444444444444
Control.SRR15539824;38;40;0.447368421052632;21;17;0.0526315789473684;0.447368421052632
Control.SRR15539824;39;40;0.461538461538462;21;18;0.0384615384615384;0.461538461538462
Control.SRR15539824;36;40;0.444444444444444;20;16;0.0555555555555556;0.444444444444444
Control.SRR15539824;38;40;0.526315789473684;18;20;0.0263157894736842;0.473684210526316
Control.SRR15539824;37;40;0.378378378378378;23;14;0.121621621621622;0.378378378378378
Control.SRR15539824;38;40;0.5;19;19;0;0.5
Control.SRR15539824;44;40;0.590909090909091;18;26;0.0909090909090909;0.409090909090909
Control.SRR15539824;39;40;0.615384615384615;15;24;0.115384615384615;0.384615384615385
Control.SRR15539824;44;40;0.318181818181818;30;14;0.181818181818182;0.318181818181818
Control.SRR15539824;35;40;0.485714285714286;18;17;0.0142857142857143;0.485714285714286
Control.SRR15539824;41;40;0.536585365853659;19;22;0.0365853658536586;0.463414634146341
Control.SRR15539824;41;40;0.48780487804878;21;20;0.0121951219512195;0.48780487804878
Control.SRR15539824;37;40;0.432432432432432;21;16;0.0675675675675675;0.432432432432432
Control.SRR15539824;41;40;0.463414634146341;22;19;0.0365853658536585;0.463414634146341
Control.SRR15539824;41;40;0.536585365853659;19;22;0.0365853658536586;0.463414634146341
Control.SRR15539824;44;40;0.568181818181818;19;25;0.0681818181818182;0.431818181818182
Control.SRR15539824;39;40;0.564102564102564;17;22;0.0641025641025641;0.435897435897436
Control.SRR15539824;35;40;0.4;21;14;0.1;0.4
Control.SRR15539824;42;40;0.476190476190476;22;20;0.0238095238095238;0.476190476190476
Control.SRR15539824;42;40;0.547619047619048;19;23;0.0476190476190477;0.452380952380952
Control.SRR15539824;41;40;0.51219512195122;20;21;0.0121951219512195;0.48780487804878
Control.SRR15539824;38;40;0.526315789473684;18;20;0.0263157894736842;0.473684210526316
Control.SRR15539824;40;40;0.55;18;22;0.05;0.45
Control.SRR15539824;44;40;0.5;22;22;0;0.5
Control.SRR15539824;45;40;0.466666666666667;24;21;0.0333333333333333;0.466666666666667
Control.SRR15539824;45;40;0.511111111111111;22;23;0.0111111111111111;0.488888888888889
Control.SRR15539824;45;40;0.688888888888889;14;31;0.188888888888889;0.311111111111111
Control.SRR15539824;43;40;0.581395348837209;18;25;0.0813953488372093;0.418604651162791
Control.SRR15539824;45;40;0.422222222222222;26;19;0.0777777777777778;0.422222222222222
Control.SRR15539824;39;40;0.435897435897436;22;17;0.0641025641025641;0.435897435897436
Control.SRR15539824;37;40;0.513513513513513;18;19;0.0135135135135135;0.486486486486487
Control.SRR15539824;41;40;0.51219512195122;20;21;0.0121951219512195;0.48780487804878
Control.SRR15539824;44;40;0.590909090909091;18;26;0.0909090909090909;0.409090909090909
Control.SRR15539824;45;40;0.488888888888889;23;22;0.0111111111111111;0.488888888888889
Control.SRR15539824;38;40;0.526315789473684;18;20;0.0263157894736842;0.473684210526316
Control.SRR15539824;42;40;0.452380952380952;23;19;0.0476190476190476;0.452380952380952
Control.SRR15539824;45;40;0.555555555555556;20;25;0.0555555555555556;0.444444444444444
Control.SRR15539824;37;40;0.540540540540541;17;20;0.0405405405405406;0.459459459459459
Control.SRR15539824;37;40;0.621621621621622;14;23;0.121621621621622;0.378378378378378
Control.SRR15539824;35;40;0.542857142857143;16;19;0.0428571428571428;0.457142857142857
Control.SRR15539824;42;40;0.523809523809524;20;22;0.0238095238095238;0.476190476190476
Control.SRR15539824;42;40;0.523809523809524;20;22;0.0238095238095238;0.476190476190476
Control.SRR15539824;41;40;0.536585365853659;19;22;0.0365853658536586;0.463414634146341
Control.SRR15539824;39;40;0.435897435897436;22;17;0.0641025641025641;0.435897435897436
Control.SRR15539824;40;40;0.6;16;24;0.1;0.4
Control.SRR15539824;41;40;0.51219512195122;20;21;0.0121951219512195;0.48780487804878
Control.SRR15539824;36;40;0.444444444444444;20;16;0.0555555555555556;0.444444444444444
Control.SRR15539824;38;40;0.368421052631579;24;14;0.131578947368421;0.368421052631579
Control.SRR15539824;45;40;0.466666666666667;24;21;0.0333333333333333;0.466666666666667
Control.SRR15539824;40;40;0.375;25;15;0.125;0.375
Control.SRR15539824;44;40;0.545454545454545;20;24;0.0454545454545454;0.454545454545455
Control.SRR15539824;42;40;0.404761904761905;25;17;0.0952380952380952;0.404761904761905
Control.SRR15539824;42;40;0.5;21;21;0;0.5
Control.SRR15539824;45;40;0.6;18;27;0.1;0.4
Control.SRR15539824;38;40;0.473684210526316;20;18;0.0263157894736842;0.473684210526316
Control.SRR15539824;40;40;0.375;25;15;0.125;0.375
Control.SRR15539824;38;40;0.368421052631579;24;14;0.131578947368421;0.368421052631579
Control.SRR15539824;36;40;0.583333333333333;15;21;0.0833333333333334;0.416666666666667
Control.SRR15539824;42;40;0.523809523809524;20;22;0.0238095238095238;0.476190476190476
Control.SRR15539824;42;40;0.571428571428571;18;24;0.0714285714285714;0.428571428571429
Control.SRR15539824;42;40;0.404761904761905;25;17;0.0952380952380952;0.404761904761905
Control.SRR15539824;41;40;0.439024390243902;23;18;0.0609756097560976;0.439024390243902
Control.SRR15539824;40;40;0.675;13;27;0.175;0.325
Control.SRR15539824;41;40;0.439024390243902;23;18;0.0609756097560976;0.439024390243902
Control.SRR15539824;43;40;0.558139534883721;19;24;0.0581395348837209;0.441860465116279
Control.SRR15539824;40;40;0.575;17;23;0.075;0.425
Control.SRR15539824;39;40;0.512820512820513;19;20;0.0128205128205128;0.487179487179487
Control.SRR15539824;40;40;0.55;18;22;0.05;0.45
Control.SRR15539824;39;40;0.666666666666667;13;26;0.166666666666667;0.333333333333333
Control.SRR15539824;40;40;0.55;18;22;0.05;0.45
Control.SRR15539824;35;40;0.4;21;14;0.1;0.4
Control.SRR15539824;39;40;0.564102564102564;17;22;0.0641025641025641;0.435897435897436
Control.SRR15539824;37;40;0.513513513513513;18;19;0.0135135135135135;0.486486486486487
Control.SRR15539824;42;40;0.428571428571429;24;18;0.0714285714285715;0.428571428571429
Control.SRR15539824;38;40;0.552631578947368;17;21;0.0526315789473685;0.447368421052632
Control.SRR15539824;43;40;0.511627906976744;21;22;0.0116279069767442;0.488372093023256
Control.SRR15539824;38;40;0.342105263157895;25;13;0.157894736842105;0.342105263157895
Control.SRR15539824;42;40;0.476190476190476;22;20;0.0238095238095238;0.476190476190476
Control.SRR15539824;35;40;0.571428571428571;15;20;0.0714285714285714;0.428571428571429
Control.SRR15539824;39;40;0.487179487179487;20;19;0.0128205128205128;0.487179487179487
Control.SRR15539824;43;40;0.581395348837209;18;25;0.0813953488372093;0.418604651162791
Control.SRR15539824;42;40;0.476190476190476;22;20;0.0238095238095238;0.476190476190476
Control.SRR15539824;36;40;0.694444444444444;11;25;0.194444444444444;0.305555555555556
Control.SRR15539824;41;40;0.585365853658537;17;24;0.0853658536585366;0.414634146341463
Control.SRR15539824;43;40;0.488372093023256;22;21;0.0116279069767442;0.488372093023256
Control.SRR15539824;38;40;0.421052631578947;22;16;0.0789473684210527;0.421052631578947
Control.SRR15539824;40;40;0.45;22;18;0.05;0.45
Control.SRR15539824;41;40;0.560975609756098;18;23;0.0609756097560976;0.439024390243902
Control.SRR15539824;39;40;0.615384615384615;15;24;0.115384615384615;0.384615384615385
Control.SRR15539824;35;40;0.428571428571429;20;15;0.0714285714285715;0.428571428571429
Control.SRR15539824;35;40;0.514285714285714;17;18;0.0142857142857142;0.485714285714286
Control.SRR15539824;41;40;0.390243902439024;25;16;0.109756097560976;0.390243902439024
Control.SRR15539824;45;40;0.444444444444444;25;20;0.0555555555555556;0.444444444444444
Control.SRR15539824;43;40;0.674418604651163;14;29;0.174418604651163;0.325581395348837
Control.SRR15539824;36;40;0.5;18;18;0;0.5
Control.SRR15539824;38;40;0.421052631578947;22;16;0.0789473684210527;0.421052631578947
Control.SRR15539824;36;40;0.444444444444444;20;16;0.0555555555555556;0.444444444444444
Control.SRR15539824;36;40;0.583333333333333;15;21;0.0833333333333334;0.416666666666667
Control.SRR15539824;36;40;0.5;18;18;0;0.5
Control.SRR15539824;42;40;0.5;21;21;0;0.5
Control.SRR15539824;41;40;0.390243902439024;25;16;0.109756097560976;0.390243902439024
Control.SRR15539824;39;40;0.461538461538462;21;18;0.0384615384615384;0.461538461538462
Control.SRR15539824;43;40;0.674418604651163;14;29;0.174418604651163;0.325581395348837
Control.SRR15539824;40;40;0.35;26;14;0.15;0.35
Control.SRR15539824;38;40;0.289473684210526;27;11;0.210526315789474;0.289473684210526
Control.SRR15539824;42;40;0.571428571428571;18;24;0.0714285714285714;0.428571428571429
Control.SRR15539824;41;40;0.51219512195122;20;21;0.0121951219512195;0.48780487804878
Control.SRR15539824;42;40;0.571428571428571;18;24;0.0714285714285714;0.428571428571429
Control.SRR15539824;39;40;0.512820512820513;19;20;0.0128205128205128;0.487179487179487
Control.SRR15539824;43;40;0.418604651162791;25;18;0.0813953488372093;0.418604651162791
Control.SRR15539824;43;40;0.511627906976744;21;22;0.0116279069767442;0.488372093023256
Control.SRR15539824;45;40;0.466666666666667;24;21;0.0333333333333333;0.466666666666667
Control.SRR15539824;39;40;0.58974358974359;16;23;0.0897435897435898;0.41025641025641
Control.SRR15539824;43;40;0.372093023255814;27;16;0.127906976744186;0.372093023255814
Control.SRR15539824;41;40;0.365853658536585;26;15;0.134146341463415;0.365853658536585
Control.SRR15539824;44;40;0.477272727272727;23;21;0.0227272727272727;0.477272727272727
Control.SRR15539824;43;40;0.348837209302326;28;15;0.151162790697674;0.348837209302326
Control.SRR15539824;38;40;0.684210526315789;12;26;0.184210526315789;0.315789473684211
Control.SRR15539824;41;40;0.439024390243902;23;18;0.0609756097560976;0.439024390243902
Control.SRR15539824;36;40;0.583333333333333;15;21;0.0833333333333334;0.416666666666667
Control.SRR15539824;45;40;0.333333333333333;30;15;0.166666666666667;0.333333333333333
Control.SRR15539824;39;40;0.487179487179487;20;19;0.0128205128205128;0.487179487179487
Control.SRR15539824;43;40;0.697674418604651;13;30;0.197674418604651;0.302325581395349
Control.SRR15539824;36;40;0.611111111111111;14;22;0.111111111111111;0.388888888888889
Control.SRR15539824;37;40;0.540540540540541;17;20;0.0405405405405406;0.459459459459459
Control.SRR15539824;41;40;0.48780487804878;21;20;0.0121951219512195;0.48780487804878
Control.SRR15539824;39;40;0.538461538461538;18;21;0.0384615384615384;0.461538461538462
Control.SRR15539824;38;40;0.5;19;19;0;0.5
Control.SRR15539824;45;40;0.444444444444444;25;20;0.0555555555555556;0.444444444444444
Control.SRR15539824;37;40;0.378378378378378;23;14;0.121621621621622;0.378378378378378
Control.SRR15539824;39;40;0.435897435897436;22;17;0.0641025641025641;0.435897435897436
Control.SRR15539824;40;40;0.525;19;21;0.025;0.475
Control.SRR15539824;45;40;0.466666666666667;24;21;0.0333333333333333;0.466666666666667
Control.SRR15539824;38;40;0.447368421052632;21;17;0.0526315789473684;0.447368421052632
Control.SRR15539824;45;40;0.4;27;18;0.1;0.4
Control.SRR15539824;38;40;0.526315789473684;18;20;0.0263157894736842;0.473684210526316
Control.SRR15539824;41;40;0.463414634146341;22;19;0.0365853658536585;0.463414634146341
Control.SRR15539824;36;40;0.638888888888889;13;23;0.138888888888889;0.361111111111111
Control.SRR15539824;35;40;0.285714285714286;25;10;0.214285714285714;0.285714285714286
Control.SRR15539824;37;40;0.459459459459459;20;17;0.0405405405405405;0.459459459459459
Control.SRR15539824;39;40;0.384615384615385;24;15;0.115384615384615;0.384615384615385
Control.SRR15539824;41;40;0.365853658536585;26;15;0.134146341463415;0.365853658536585
Control.SRR15539824;44;40;0.545454545454545;20;24;0.0454545454545454;0.454545454545455
Control.SRR15539824;45;40;0.4;27;18;0.1;0.4
Control.SRR15539824;44;40;0.681818181818182;14;30;0.181818181818182;0.318181818181818
Control.SRR15539824;45;40;0.577777777777778;19;26;0.0777777777777777;0.422222222222222
Control.SRR15539824;43;40;0.511627906976744;21;22;0.0116279069767442;0.488372093023256
Control.SRR15539824;44;40;0.5;22;22;0;0.5
Control.SRR15539824;44;40;0.613636363636364;17;27;0.113636363636364;0.386363636363636
Control.SRR15539824;39;40;0.564102564102564;17;22;0.0641025641025641;0.435897435897436
Control.SRR15539824;39;40;0.538461538461538;18;21;0.0384615384615384;0.461538461538462
Control.SRR15539824;40;40;0.475;21;19;0.025;0.475
Control.SRR15539824;38;40;0.5;19;19;0;0.5
Control.SRR15539824;37;40;0.378378378378378;23;14;0.121621621621622;0.378378378378378
Control.SRR15539824;36;40;0.555555555555556;16;20;0.0555555555555556;0.444444444444444
Control.SRR15539824;43;40;0.651162790697674;15;28;0.151162790697674;0.348837209302326
Control.SRR15539824;44;40;0.522727272727273;21;23;0.0227272727272727;0.477272727272727
Control.SRR15539824;39;40;0.384615384615385;24;15;0.115384615384615;0.384615384615385
Control.SRR15539824;40;40;0.275;29;11;0.225;0.275
Control.SRR15539824;44;40;0.454545454545455;24;20;0.0454545454545455;0.454545454545455
Control.SRR15539824;41;40;0.536585365853659;19;22;0.0365853658536586;0.463414634146341
Control.SRR15539824;43;40;0.418604651162791;25;18;0.0813953488372093;0.418604651162791
Control.SRR15539824;43;40;0.488372093023256;22;21;0.0116279069767442;0.488372093023256
Control.SRR15539824;42;40;0.476190476190476;22;20;0.0238095238095238;0.476190476190476
Control.SRR15539824;43;40;0.441860465116279;24;19;0.0581395348837209;0.441860465116279
Control.SRR15539824;38;40;0.605263157894737;15;23;0.105263157894737;0.394736842105263
Control.SRR15539824;35;40;0.485714285714286;18;17;0.0142857142857143;0.485714285714286
Control.SRR15539824;43;40;0.534883720930233;20;23;0.0348837209302325;0.465116279069767
Control.SRR15539824;45;40;0.488888888888889;23;22;0.0111111111111111;0.488888888888889
Control.SRR15539824;36;40;0.472222222222222;19;17;0.0277777777777778;0.472222222222222
Control.SRR15539824;44;40;0.477272727272727;23;21;0.0227272727272727;0.477272727272727
Control.SRR15539824;41;40;0.439024390243902;23;18;0.0609756097560976;0.439024390243902
Control.SRR15539824;44;40;0.590909090909091;18;26;0.0909090909090909;0.409090909090909
Control.SRR15539824;41;40;0.51219512195122;20;21;0.0121951219512195;0.48780487804878
Control.SRR15539824;35;40;0.571428571428571;15;20;0.0714285714285714;0.428571428571429
Control.SRR15539824;40;40;0.55;18;22;0.05;0.45
Control.SRR15539824;41;40;0.48780487804878;21;20;0.0121951219512195;0.48780487804878
Control.SRR15539824;36;40;0.472222222222222;19;17;0.0277777777777778;0.472222222222222
Control.SRR15539824;36;40;0.611111111111111;14;22;0.111111111111111;0.388888888888889
Control.SRR15539824;45;40;0.488888888888889;23;22;0.0111111111111111;0.488888888888889
Control.SRR15539824;44;40;0.568181818181818;19;25;0.0681818181818182;0.431818181818182
Control.SRR15539824;38;40;0.578947368421053;16;22;0.0789473684210527;0.421052631578947
Control.SRR15539824;41;40;0.463414634146341;22;19;0.0365853658536585;0.463414634146341
Control.SRR15539824;41;40;0.463414634146341;22;19;0.0365853658536585;0.463414634146341
Control.SRR15539824;43;40;0.604651162790698;17;26;0.104651162790698;0.395348837209302
Control.SRR15539824;42;40;0.547619047619048;19;23;0.0476190476190477;0.452380952380952
Control.SRR15539824;41;40;0.536585365853659;19;22;0.0365853658536586;0.463414634146341
Control.SRR15539824;41;40;0.414634146341463;24;17;0.0853658536585366;0.414634146341463
Control.SRR15539824;44;40;0.454545454545455;24;20;0.0454545454545455;0.454545454545455
Control.SRR15539824;41;40;0.463414634146341;22;19;0.0365853658536585;0.463414634146341
Control.SRR15539824;39;40;0.512820512820513;19;20;0.0128205128205128;0.487179487179487
Control.SRR15539824;36;40;0.416666666666667;21;15;0.0833333333333333;0.416666666666667
Control.SRR15539824;37;40;0.486486486486487;19;18;0.0135135135135135;0.486486486486487
Control.SRR15539824;39;40;0.461538461538462;21;18;0.0384615384615384;0.461538461538462
Control.SRR15539824;38;40;0.552631578947368;17;21;0.0526315789473685;0.447368421052632
Control.SRR15539824;44;40;0.522727272727273;21;23;0.0227272727272727;0.477272727272727
Control.SRR15539824;43;40;0.627906976744186;16;27;0.127906976744186;0.372093023255814
Control.SRR15539824;36;40;0.611111111111111;14;22;0.111111111111111;0.388888888888889
Control.SRR15539824;38;40;0.368421052631579;24;14;0.131578947368421;0.368421052631579
Control.SRR15539824;43;40;0.581395348837209;18;25;0.0813953488372093;0.418604651162791
Control.SRR15539824;42;40;0.380952380952381;26;16;0.119047619047619;0.380952380952381
Control.SRR15539824;35;40;0.685714285714286;11;24;0.185714285714286;0.314285714285714
Control.SRR15539824;42;40;0.452380952380952;23;19;0.0476190476190476;0.452380952380952
Control.SRR15539824;41;40;0.48780487804878;21;20;0.0121951219512195;0.48780487804878
Control.SRR15539824;44;40;0.454545454545455;24;20;0.0454545454545455;0.454545454545455
Control.SRR15539824;43;40;0.441860465116279;24;19;0.0581395348837209;0.441860465116279
Control.SRR15539824;37;40;0.486486486486487;19;18;0.0135135135135135;0.486486486486487
Control.SRR15539824;37;40;0.378378378378378;23;14;0.121621621621622;0.378378378378378
Control.SRR15539824;38;40;0.578947368421053;16;22;0.0789473684210527;0.421052631578947
Control.SRR15539824;41;40;0.609756097560976;16;25;0.109756097560976;0.390243902439024
Control.SRR15539824;40;40;0.475;21;19;0.025;0.475
Control.SRR15539824;36;40;0.361111111111111;23;13;0.138888888888889;0.361111111111111
Control.SRR15539824;36;40;0.416666666666667;21;15;0.0833333333333333;0.416666666666667
Control.SRR15539824;39;40;0.358974358974359;25;14;0.141025641025641;0.358974358974359
Control.SRR15539824;42;40;0.547619047619048;19;23;0.0476190476190477;0.452380952380952
Control.SRR15539824;35;40;0.571428571428571;15;20;0.0714285714285714;0.428571428571429
Control.SRR15539824;39;40;0.538461538461538;18;21;0.0384615384615384;0.461538461538462
Control.SRR15539824;43;40;0.465116279069767;23;20;0.0348837209302326;0.465116279069767
Control.SRR15539824;43;40;0.395348837209302;26;17;0.104651162790698;0.395348837209302
Control.SRR15539824;43;40;0.418604651162791;25;18;0.0813953488372093;0.418604651162791
Control.SRR15539824;42;40;0.523809523809524;20;22;0.0238095238095238;0.476190476190476
Control.SRR15539824;43;40;0.441860465116279;24;19;0.0581395348837209;0.441860465116279
Control.SRR15539824;41;40;0.609756097560976;16;25;0.109756097560976;0.390243902439024
Control.SRR15539824;39;40;0.487179487179487;20;19;0.0128205128205128;0.487179487179487
Control.SRR15539824;41;40;0.585365853658537;17;24;0.0853658536585366;0.414634146341463
Control.SRR15539824;41;40;0.536585365853659;19;22;0.0365853658536586;0.463414634146341
Control.SRR15539824;41;40;0.439024390243902;23;18;0.0609756097560976;0.439024390243902
Control.SRR15539824;43;40;0.488372093023256;22;21;0.0116279069767442;0.488372093023256
Control.SRR15539824;40;40;0.675;13;27;0.175;0.325
Control.SRR15539824;40;40;0.55;18;22;0.05;0.45
Control.SRR15539824;37;40;0.486486486486487;19;18;0.0135135135135135;0.486486486486487
Control.SRR15539824;40;40;0.55;18;22;0.05;0.45
Control.SRR15539824;41;40;0.51219512195122;20;21;0.0121951219512195;0.48780487804878
Control.SRR15539824;37;40;0.540540540540541;17;20;0.0405405405405406;0.459459459459459
Control.SRR15539824;42;40;0.380952380952381;26;16;0.119047619047619;0.380952380952381
Control.SRR15539824;39;40;0.461538461538462;21;18;0.0384615384615384;0.461538461538462
Control.SRR15539824;42;40;0.5;21;21;0;0.5
Control.SRR15539824;45;40;0.511111111111111;22;23;0.0111111111111111;0.488888888888889
Control.SRR15539824;42;40;0.5;21;21;0;0.5
Control.SRR15539824;37;40;0.405405405405405;22;15;0.0945945945945946;0.405405405405405
Control.SRR15539824;37;40;0.324324324324324;25;12;0.175675675675676;0.324324324324324
Control.SRR15539824;45;40;0.488888888888889;23;22;0.0111111111111111;0.488888888888889
Control.SRR15539824;37;40;0.567567567567568;16;21;0.0675675675675675;0.432432432432432
Control.SRR15539824;41;40;0.536585365853659;19;22;0.0365853658536586;0.463414634146341
Control.SRR15539824;41;40;0.585365853658537;17;24;0.0853658536585366;0.414634146341463
Control.SRR15539824;37;40;0.621621621621622;14;23;0.121621621621622;0.378378378378378
Control.SRR15539824;39;40;0.461538461538462;21;18;0.0384615384615384;0.461538461538462
Control.SRR15539824;37;40;0.459459459459459;20;17;0.0405405405405405;0.459459459459459
Control.SRR15539824;42;40;0.619047619047619;16;26;0.119047619047619;0.380952380952381
Control.SRR15539824;35;40;0.514285714285714;17;18;0.0142857142857142;0.485714285714286
Control.SRR15539824;44;40;0.5;22;22;0;0.5
Control.SRR15539824;36;40;0.25;27;9;0.25;0.25
Control.SRR15539824;37;40;0.405405405405405;22;15;0.0945945945945946;0.405405405405405
Control.SRR15539824;42;40;0.523809523809524;20;22;0.0238095238095238;0.476190476190476
Control.SRR15539824;35;40;0.485714285714286;18;17;0.0142857142857143;0.485714285714286
Control.SRR15539824;44;40;0.522727272727273;21;23;0.0227272727272727;0.477272727272727
Control.SRR15539824;42;40;0.476190476190476;22;20;0.0238095238095238;0.476190476190476
Control.SRR15539824;38;40;0.526315789473684;18;20;0.0263157894736842;0.473684210526316
Control.SRR15539824;38;40;0.526315789473684;18;20;0.0263157894736842;0.473684210526316
Control.SRR15539824;40;40;0.525;19;21;0.025;0.475
Control.SRR15539824;39;40;0.538461538461538;18;21;0.0384615384615384;0.461538461538462
Control.SRR15539824;43;40;0.581395348837209;18;25;0.0813953488372093;0.418604651162791
Control.SRR15539824;41;40;0.48780487804878;21;20;0.0121951219512195;0.48780487804878
Control.SRR15539824;45;40;0.466666666666667;24;21;0.0333333333333333;0.466666666666667
Control.SRR15539824;40;40;0.325;27;13;0.175;0.325
Control.SRR15539824;35;40;0.485714285714286;18;17;0.0142857142857143;0.485714285714286
Control.SRR15539824;44;40;0.522727272727273;21;23;0.0227272727272727;0.477272727272727
Control.SRR15539824;35;40;0.6;14;21;0.1;0.4
Control.SRR15539824;39;40;0.615384615384615;15;24;0.115384615384615;0.384615384615385
Control.SRR15539824;45;40;0.577777777777778;19;26;0.0777777777777777;0.422222222222222
Control.SRR15539824;39;40;0.461538461538462;21;18;0.0384615384615384;0.461538461538462
Control.SRR15539824;40;40;0.425;23;17;0.075;0.425
Control.SRR15539824;42;40;0.452380952380952;23;19;0.0476190476190476;0.452380952380952
Control.SRR15539824;43;40;0.581395348837209;18;25;0.0813953488372093;0.418604651162791
Control.SRR15539824;35;40;0.514285714285714;17;18;0.0142857142857142;0.485714285714286
Control.SRR15539824;38;40;0.421052631578947;22;16;0.0789473684210527;0.421052631578947
Control.SRR15539824;41;40;0.51219512195122;20;21;0.0121951219512195;0.48780487804878
Control.SRR15539824;36;40;0.555555555555556;16;20;0.0555555555555556;0.444444444444444
Control.SRR15539824;42;40;0.476190476190476;22;20;0.0238095238095238;0.476190476190476
Control.SRR15539824;42;40;0.404761904761905;25;17;0.0952380952380952;0.404761904761905
Control.SRR15539824;41;40;0.390243902439024;25;16;0.109756097560976;0.390243902439024
Control.SRR15539824;39;40;0.512820512820513;19;20;0.0128205128205128;0.487179487179487
Control.SRR15539824;41;40;0.414634146341463;24;17;0.0853658536585366;0.414634146341463
Control.SRR15539824;42;40;0.523809523809524;20;22;0.0238095238095238;0.476190476190476
Control.SRR15539824;44;40;0.522727272727273;21;23;0.0227272727272727;0.477272727272727
Control.SRR15539824;37;40;0.378378378378378;23;14;0.121621621621622;0.378378378378378
Control.SRR15539824;42;40;0.428571428571429;24;18;0.0714285714285715;0.428571428571429
Control.SRR15539824;44;40;0.454545454545455;24;20;0.0454545454545455;0.454545454545455
Control.SRR15539824;41;40;0.365853658536585;26;15;0.134146341463415;0.365853658536585
Control.SRR15539824;40;40;0.525;19;21;0.025;0.475
Control.SRR15539824;35;40;0.571428571428571;15;20;0.0714285714285714;0.428571428571429
Control.SRR15539824;44;40;0.431818181818182;25;19;0.0681818181818182;0.431818181818182
Control.SRR15539824;37;40;0.513513513513513;18;19;0.0135135135135135;0.486486486486487
Control.SRR15539824;35;40;0.542857142857143;16;19;0.0428571428571428;0.457142857142857
Control.SRR15539824;43;40;0.534883720930233;20;23;0.0348837209302325;0.465116279069767
Control.SRR15539824;38;40;0.578947368421053;16;22;0.0789473684210527;0.421052631578947
Control.SRR15539824;42;40;0.476190476190476;22;20;0.0238095238095238;0.476190476190476
Control.SRR15539824;38;40;0.473684210526316;20;18;0.0263157894736842;0.473684210526316
Control.SRR15539824;41;40;0.585365853658537;17;24;0.0853658536585366;0.414634146341463
Control.SRR15539824;44;40;0.590909090909091;18;26;0.0909090909090909;0.409090909090909
Control.SRR15539824;39;40;0.435897435897436;22;17;0.0641025641025641;0.435897435897436
Control.SRR15539824;35;40;0.342857142857143;23;12;0.157142857142857;0.342857142857143
Control.SRR15539824;37;40;0.432432432432432;21;16;0.0675675675675675;0.432432432432432
Control.SRR15539824;37;40;0.432432432432432;21;16;0.0675675675675675;0.432432432432432
Control.SRR15539824;35;40;0.428571428571429;20;15;0.0714285714285715;0.428571428571429
Control.SRR15539824;44;40;0.568181818181818;19;25;0.0681818181818182;0.431818181818182
Control.SRR15539824;44;40;0.590909090909091;18;26;0.0909090909090909;0.409090909090909
Control.SRR15539824;42;40;0.5;21;21;0;0.5
Control.SRR15539824;39;40;0.41025641025641;23;16;0.0897435897435898;0.41025641025641
Control.SRR15539824;45;40;0.488888888888889;23;22;0.0111111111111111;0.488888888888889
Control.SRR15539824;44;40;0.522727272727273;21;23;0.0227272727272727;0.477272727272727
Control.SRR15539824;36;40;0.75;9;27;0.25;0.25
Control.SRR15539824;35;40;0.628571428571429;13;22;0.128571428571429;0.371428571428571
Control.SRR15539824;38;40;0.5;19;19;0;0.5
Control.SRR15539824;45;40;0.622222222222222;17;28;0.122222222222222;0.377777777777778
Control.SRR15539824;36;40;0.583333333333333;15;21;0.0833333333333334;0.416666666666667
Control.SRR15539824;38;40;0.578947368421053;16;22;0.0789473684210527;0.421052631578947
Control.SRR15539824;37;40;0.405405405405405;22;15;0.0945945945945946;0.405405405405405
Control.SRR15539824;41;40;0.585365853658537;17;24;0.0853658536585366;0.414634146341463
Control.SRR15539824;37;40;0.459459459459459;20;17;0.0405405405405405;0.459459459459459
Control.SRR15539824;45;40;0.6;18;27;0.1;0.4
Control.SRR15539824;38;40;0.578947368421053;16;22;0.0789473684210527;0.421052631578947
Control.SRR15539824;36;40;0.5;18;18;0;0.5
Control.SRR15539824;39;40;0.564102564102564;17;22;0.0641025641025641;0.435897435897436
Control.SRR15539824;43;40;0.651162790697674;15;28;0.151162790697674;0.348837209302326
Control.SRR15539824;37;40;0.594594594594595;15;22;0.0945945945945946;0.405405405405405
Control.SRR15539824;44;40;0.454545454545455;24;20;0.0454545454545455;0.454545454545455
Control.SRR15539824;44;40;0.477272727272727;23;21;0.0227272727272727;0.477272727272727
Control.SRR15539824;39;40;0.564102564102564;17;22;0.0641025641025641;0.435897435897436
Control.SRR15539824;40;40;0.575;17;23;0.075;0.425
Control.SRR15539824;43;40;0.511627906976744;21;22;0.0116279069767442;0.488372093023256
Control.SRR15539824;41;40;0.560975609756098;18;23;0.0609756097560976;0.439024390243902
Control.SRR15539824;45;40;0.466666666666667;24;21;0.0333333333333333;0.466666666666667
Control.SRR15539824;45;40;0.511111111111111;22;23;0.0111111111111111;0.488888888888889
Control.SRR15539824;39;40;0.564102564102564;17;22;0.0641025641025641;0.435897435897436
Control.SRR15539824;42;40;0.404761904761905;25;17;0.0952380952380952;0.404761904761905
Control.SRR15539824;38;40;0.473684210526316;20;18;0.0263157894736842;0.473684210526316
Control.SRR15539824;43;40;0.534883720930233;20;23;0.0348837209302325;0.465116279069767
Control.SRR15539824;39;40;0.538461538461538;18;21;0.0384615384615384;0.461538461538462
Control.SRR15539824;42;40;0.642857142857143;15;27;0.142857142857143;0.357142857142857
Control.SRR15539824;35;40;0.485714285714286;18;17;0.0142857142857143;0.485714285714286
Control.SRR15539824;37;40;0.351351351351351;24;13;0.148648648648649;0.351351351351351
Control.SRR15539824;39;40;0.487179487179487;20;19;0.0128205128205128;0.487179487179487
Control.SRR15539824;40;40;0.55;18;22;0.05;0.45
Control.SRR15539824;35;40;0.428571428571429;20;15;0.0714285714285715;0.428571428571429
Control.SRR15539824;37;40;0.540540540540541;17;20;0.0405405405405406;0.459459459459459
Control.SRR15539824;39;40;0.333333333333333;26;13;0.166666666666667;0.333333333333333
Control.SRR15539824;45;40;0.511111111111111;22;23;0.0111111111111111;0.488888888888889
Control.SRR15539824;44;40;0.568181818181818;19;25;0.0681818181818182;0.431818181818182
Control.SRR15539824;35;40;0.514285714285714;17;18;0.0142857142857142;0.485714285714286
Control.SRR15539824;35;40;0.457142857142857;19;16;0.0428571428571429;0.457142857142857
Control.SRR15539824;36;40;0.472222222222222;19;17;0.0277777777777778;0.472222222222222
Control.SRR15539824;35;40;0.314285714285714;24;11;0.185714285714286;0.314285714285714
Control.SRR15539824;43;40;0.511627906976744;21;22;0.0116279069767442;0.488372093023256
Control.SRR15539824;42;40;0.476190476190476;22;20;0.0238095238095238;0.476190476190476
Control.SRR15539824;35;40;0.6;14;21;0.1;0.4
Control.SRR15539824;36;40;0.5;18;18;0;0.5
Control.SRR15539824;42;40;0.380952380952381;26;16;0.119047619047619;0.380952380952381
Control.SRR15539824;41;40;0.536585365853659;19;22;0.0365853658536586;0.463414634146341
Control.SRR15539824;37;40;0.486486486486487;19;18;0.0135135135135135;0.486486486486487
Control.SRR15539824;43;40;0.534883720930233;20;23;0.0348837209302325;0.465116279069767
Control.SRR15539824;44;40;0.636363636363636;16;28;0.136363636363636;0.363636363636364
Control.SRR15539824;45;40;0.466666666666667;24;21;0.0333333333333333;0.466666666666667
Control.SRR15539824;43;40;0.465116279069767;23;20;0.0348837209302326;0.465116279069767
Control.SRR15539824;42;40;0.523809523809524;20;22;0.0238095238095238;0.476190476190476
Control.SRR15539824;44;40;0.431818181818182;25;19;0.0681818181818182;0.431818181818182
Control.SRR15539824;44;40;0.522727272727273;21;23;0.0227272727272727;0.477272727272727
Control.SRR15539824;38;40;0.5;19;19;0;0.5
Control.SRR15539824;36;40;0.5;18;18;0;0.5
Control.SRR15539824;41;40;0.51219512195122;20;21;0.0121951219512195;0.48780487804878
Control.SRR15539824;41;40;0.463414634146341;22;19;0.0365853658536585;0.463414634146341
Control.SRR15539824;36;40;0.5;18;18;0;0.5
Control.SRR15539824;41;40;0.463414634146341;22;19;0.0365853658536585;0.463414634146341
Control.SRR15539824;41;40;0.317073170731707;28;13;0.182926829268293;0.317073170731707
Control.SRR15539824;41;40;0.585365853658537;17;24;0.0853658536585366;0.414634146341463
Control.SRR15539824;36;40;0.472222222222222;19;17;0.0277777777777778;0.472222222222222
Control.SRR15539824;43;40;0.488372093023256;22;21;0.0116279069767442;0.488372093023256
Control.SRR15539824;35;40;0.657142857142857;12;23;0.157142857142857;0.342857142857143
Control.SRR15539824;35;40;0.457142857142857;19;16;0.0428571428571429;0.457142857142857
Control.SRR15539824;41;40;0.536585365853659;19;22;0.0365853658536586;0.463414634146341
Control.SRR15539824;35;40;0.485714285714286;18;17;0.0142857142857143;0.485714285714286
Control.SRR15539824;35;40;0.485714285714286;18;17;0.0142857142857143;0.485714285714286
Control.SRR15539824;44;40;0.477272727272727;23;21;0.0227272727272727;0.477272727272727
Control.SRR15539824;37;40;0.72972972972973;10;27;0.22972972972973;0.27027027027027
Control.SRR15539824;38;40;0.526315789473684;18;20;0.0263157894736842;0.473684210526316
Control.SRR15539824;37;40;0.513513513513513;18;19;0.0135135135135135;0.486486486486487
Control.SRR15539824;39;40;0.538461538461538;18;21;0.0384615384615384;0.461538461538462
Control.SRR15539824;40;40;0.575;17;23;0.075;0.425
Control.SRR15539824;41;40;0.51219512195122;20;21;0.0121951219512195;0.48780487804878
Control.SRR15539824;42;40;0.547619047619048;19;23;0.0476190476190477;0.452380952380952
Control.SRR15539824;39;40;0.615384615384615;15;24;0.115384615384615;0.384615384615385
Control.SRR15539824;39;40;0.615384615384615;15;24;0.115384615384615;0.384615384615385
Control.SRR15539824;37;40;0.459459459459459;20;17;0.0405405405405405;0.459459459459459
Control.SRR15539824;42;40;0.523809523809524;20;22;0.0238095238095238;0.476190476190476
Control.SRR15539824;42;40;0.547619047619048;19;23;0.0476190476190477;0.452380952380952
Control.SRR15539824;45;40;0.533333333333333;21;24;0.0333333333333333;0.466666666666667
Control.SRR15539824;39;40;0.641025641025641;14;25;0.141025641025641;0.358974358974359
Control.SRR15539824;40;40;0.475;21;19;0.025;0.475
Control.SRR15539824;44;40;0.454545454545455;24;20;0.0454545454545455;0.454545454545455
Control.SRR15539824;40;40;0.575;17;23;0.075;0.425
Control.SRR15539824;40;40;0.325;27;13;0.175;0.325
Control.SRR15539824;43;40;0.441860465116279;24;19;0.0581395348837209;0.441860465116279
Control.SRR15539824;43;40;0.488372093023256;22;21;0.0116279069767442;0.488372093023256
Control.SRR15539824;42;40;0.5;21;21;0;0.5
Control.SRR15539824;40;40;0.375;25;15;0.125;0.375
Control.SRR15539824;37;40;0.702702702702703;11;26;0.202702702702703;0.297297297297297
Control.SRR15539824;45;40;0.644444444444444;16;29;0.144444444444444;0.355555555555556
Control.SRR15539824;39;40;0.564102564102564;17;22;0.0641025641025641;0.435897435897436
Control.SRR15539824;43;40;0.465116279069767;23;20;0.0348837209302326;0.465116279069767
Control.SRR15539824;39;40;0.461538461538462;21;18;0.0384615384615384;0.461538461538462
Control.SRR15539824;40;40;0.45;22;18;0.05;0.45
Control.SRR15539824;41;40;0.439024390243902;23;18;0.0609756097560976;0.439024390243902
Control.SRR15539824;42;40;0.571428571428571;18;24;0.0714285714285714;0.428571428571429
Control.SRR15539824;41;40;0.463414634146341;22;19;0.0365853658536585;0.463414634146341
Control.SRR15539824;45;40;0.577777777777778;19;26;0.0777777777777777;0.422222222222222
Control.SRR15539824;36;40;0.472222222222222;19;17;0.0277777777777778;0.472222222222222
Control.SRR15539824;42;40;0.285714285714286;30;12;0.214285714285714;0.285714285714286
Control.SRR15539824;39;40;0.461538461538462;21;18;0.0384615384615384;0.461538461538462
Control.SRR15539824;41;40;0.51219512195122;20;21;0.0121951219512195;0.48780487804878
Control.SRR15539824;43;40;0.465116279069767;23;20;0.0348837209302326;0.465116279069767
Control.SRR15539824;43;40;0.418604651162791;25;18;0.0813953488372093;0.418604651162791
Control.SRR15539824;39;40;0.512820512820513;19;20;0.0128205128205128;0.487179487179487
Control.SRR15539824;38;40;0.605263157894737;15;23;0.105263157894737;0.394736842105263
Control.SRR15539824;38;40;0.526315789473684;18;20;0.0263157894736842;0.473684210526316
Control.SRR15539824;41;40;0.463414634146341;22;19;0.0365853658536585;0.463414634146341
Control.SRR15539824;41;40;0.439024390243902;23;18;0.0609756097560976;0.439024390243902
Control.SRR15539824;38;40;0.684210526315789;12;26;0.184210526315789;0.315789473684211
Control.SRR15539824;38;40;0.5;19;19;0;0.5
Control.SRR15539824;40;40;0.6;16;24;0.1;0.4
Control.SRR15539824;45;40;0.311111111111111;31;14;0.188888888888889;0.311111111111111
Control.SRR15539824;44;40;0.477272727272727;23;21;0.0227272727272727;0.477272727272727
Control.SRR15539824;35;40;0.514285714285714;17;18;0.0142857142857142;0.485714285714286
Control.SRR15539824;37;40;0.378378378378378;23;14;0.121621621621622;0.378378378378378
Control.SRR15539824;41;40;0.463414634146341;22;19;0.0365853658536585;0.463414634146341
Control.SRR15539824;45;40;0.444444444444444;25;20;0.0555555555555556;0.444444444444444
Control.SRR15539824;45;40;0.488888888888889;23;22;0.0111111111111111;0.488888888888889
Control.SRR15539824;41;40;0.536585365853659;19;22;0.0365853658536586;0.463414634146341
Control.SRR15539824;38;40;0.657894736842105;13;25;0.157894736842105;0.342105263157895
Control.SRR15539824;39;40;0.487179487179487;20;19;0.0128205128205128;0.487179487179487
Control.SRR15539824;44;40;0.5;22;22;0;0.5
Control.SRR15539824;36;40;0.527777777777778;17;19;0.0277777777777778;0.472222222222222
Control.SRR15539824;37;40;0.459459459459459;20;17;0.0405405405405405;0.459459459459459
Control.SRR15539824;43;40;0.604651162790698;17;26;0.104651162790698;0.395348837209302
Control.SRR15539824;36;40;0.277777777777778;26;10;0.222222222222222;0.277777777777778
Control.SRR15539824;44;40;0.545454545454545;20;24;0.0454545454545454;0.454545454545455
Control.SRR15539824;43;40;0.651162790697674;15;28;0.151162790697674;0.348837209302326
Control.SRR15539824;42;40;0.523809523809524;20;22;0.0238095238095238;0.476190476190476
Control.SRR15539824;36;40;0.472222222222222;19;17;0.0277777777777778;0.472222222222222
Control.SRR15539824;35;40;0.657142857142857;12;23;0.157142857142857;0.342857142857143
Control.SRR15539824;43;40;0.581395348837209;18;25;0.0813953488372093;0.418604651162791
Control.SRR15539824;38;40;0.5;19;19;0;0.5
Control.SRR15539824;38;40;0.447368421052632;21;17;0.0526315789473684;0.447368421052632
Control.SRR15539824;43;40;0.511627906976744;21;22;0.0116279069767442;0.488372093023256
Control.SRR15539824;41;40;0.463414634146341;22;19;0.0365853658536585;0.463414634146341
Control.SRR15539824;41;40;0.731707317073171;11;30;0.231707317073171;0.268292682926829
Control.SRR15539824;39;40;0.58974358974359;16;23;0.0897435897435898;0.41025641025641
Control.SRR15539824;35;40;0.428571428571429;20;15;0.0714285714285715;0.428571428571429
Control.SRR15539824;35;40;0.428571428571429;20;15;0.0714285714285715;0.428571428571429
Control.SRR15539824;41;40;0.51219512195122;20;21;0.0121951219512195;0.48780487804878
Control.SRR15539824;39;40;0.564102564102564;17;22;0.0641025641025641;0.435897435897436
Control.SRR15539824;38;40;0.342105263157895;25;13;0.157894736842105;0.342105263157895
Control.SRR15539824;35;40;0.4;21;14;0.1;0.4
Control.SRR15539824;35;40;0.428571428571429;20;15;0.0714285714285715;0.428571428571429
Control.SRR15539824;39;40;0.641025641025641;14;25;0.141025641025641;0.358974358974359
Control.SRR15539824;45;40;0.466666666666667;24;21;0.0333333333333333;0.466666666666667
Control.SRR15539824;40;40;0.575;17;23;0.075;0.425
Control.SRR15539824;45;40;0.288888888888889;32;13;0.211111111111111;0.288888888888889
Control.SRR15539824;40;40;0.575;17;23;0.075;0.425
Control.SRR15539824;39;40;0.538461538461538;18;21;0.0384615384615384;0.461538461538462
Control.SRR15539824;35;40;0.371428571428571;22;13;0.128571428571429;0.371428571428571
Control.SRR15539824;41;40;0.51219512195122;20;21;0.0121951219512195;0.48780487804878
Control.SRR15539824;42;40;0.571428571428571;18;24;0.0714285714285714;0.428571428571429
Control.SRR15539824;38;40;0.473684210526316;20;18;0.0263157894736842;0.473684210526316
Control.SRR15539824;45;40;0.466666666666667;24;21;0.0333333333333333;0.466666666666667
Control.SRR15539824;36;40;0.583333333333333;15;21;0.0833333333333334;0.416666666666667
Control.SRR15539824;37;40;0.540540540540541;17;20;0.0405405405405406;0.459459459459459
Control.SRR15539824;42;40;0.476190476190476;22;20;0.0238095238095238;0.476190476190476
Control.SRR15539824;45;40;0.577777777777778;19;26;0.0777777777777777;0.422222222222222
Control.SRR15539824;45;40;0.444444444444444;25;20;0.0555555555555556;0.444444444444444
Control.SRR15539824;38;40;0.447368421052632;21;17;0.0526315789473684;0.447368421052632
Control.SRR15539824;40;40;0.6;16;24;0.1;0.4
Control.SRR15539824;39;40;0.461538461538462;21;18;0.0384615384615384;0.461538461538462
Control.SRR15539824;41;40;0.609756097560976;16;25;0.109756097560976;0.390243902439024
Control.SRR15539824;35;40;0.485714285714286;18;17;0.0142857142857143;0.485714285714286
Control.SRR15539824;39;40;0.461538461538462;21;18;0.0384615384615384;0.461538461538462
Control.SRR15539824;39;40;0.435897435897436;22;17;0.0641025641025641;0.435897435897436
Control.SRR15539824;35;40;0.514285714285714;17;18;0.0142857142857142;0.485714285714286
Control.SRR15539824;43;40;0.511627906976744;21;22;0.0116279069767442;0.488372093023256
Control.SRR15539824;42;40;0.476190476190476;22;20;0.0238095238095238;0.476190476190476
Control.SRR15539824;44;40;0.522727272727273;21;23;0.0227272727272727;0.477272727272727
Control.SRR15539824;45;40;0.511111111111111;22;23;0.0111111111111111;0.488888888888889
Control.SRR15539824;35;40;0.485714285714286;18;17;0.0142857142857143;0.485714285714286
Control.SRR15539824;39;40;0.333333333333333;26;13;0.166666666666667;0.333333333333333
Control.SRR15539824;38;40;0.447368421052632;21;17;0.0526315789473684;0.447368421052632
Control.SRR15539824;43;40;0.395348837209302;26;17;0.104651162790698;0.395348837209302
Control.SRR15539824;41;40;0.414634146341463;24;17;0.0853658536585366;0.414634146341463
Control.SRR15539824;43;40;0.558139534883721;19;24;0.0581395348837209;0.441860465116279
Control.SRR15539824;37;40;0.513513513513513;18;19;0.0135135135135135;0.486486486486487
Control.SRR15539824;43;40;0.488372093023256;22;21;0.0116279069767442;0.488372093023256
Control.SRR15539824;43;40;0.465116279069767;23;20;0.0348837209302326;0.465116279069767
Control.SRR15539824;42;40;0.452380952380952;23;19;0.0476190476190476;0.452380952380952
Control.SRR15539824;44;40;0.477272727272727;23;21;0.0227272727272727;0.477272727272727
Control.SRR15539824;35;40;0.428571428571429;20;15;0.0714285714285715;0.428571428571429
Control.SRR15539824;43;40;0.627906976744186;16;27;0.127906976744186;0.372093023255814
Control.SRR15539824;41;40;0.48780487804878;21;20;0.0121951219512195;0.48780487804878
Control.SRR15539824;35;40;0.428571428571429;20;15;0.0714285714285715;0.428571428571429
Control.SRR15539824;35;40;0.485714285714286;18;17;0.0142857142857143;0.485714285714286
Control.SRR15539824;41;40;0.48780487804878;21;20;0.0121951219512195;0.48780487804878
Control.SRR15539824;35;40;0.514285714285714;17;18;0.0142857142857142;0.485714285714286
Control.SRR15539824;45;40;0.377777777777778;28;17;0.122222222222222;0.377777777777778
Control.SRR15539824;45;40;0.644444444444444;16;29;0.144444444444444;0.355555555555556
Control.SRR15539824;36;40;0.583333333333333;15;21;0.0833333333333334;0.416666666666667
Control.SRR15539824;42;40;0.476190476190476;22;20;0.0238095238095238;0.476190476190476
Control.SRR15539824;37;40;0.351351351351351;24;13;0.148648648648649;0.351351351351351
Control.SRR15539824;36;40;0.333333333333333;24;12;0.166666666666667;0.333333333333333
Control.SRR15539824;35;40;0.514285714285714;17;18;0.0142857142857142;0.485714285714286
Control.SRR15539824;38;40;0.578947368421053;16;22;0.0789473684210527;0.421052631578947
Control.SRR15539824;37;40;0.513513513513513;18;19;0.0135135135135135;0.486486486486487
Control.SRR15539824;45;40;0.466666666666667;24;21;0.0333333333333333;0.466666666666667
Control.SRR15539824;39;40;0.58974358974359;16;23;0.0897435897435898;0.41025641025641
Control.SRR15539824;42;40;0.357142857142857;27;15;0.142857142857143;0.357142857142857
Control.SRR15539824;45;40;0.644444444444444;16;29;0.144444444444444;0.355555555555556
Control.SRR15539824;42;40;0.452380952380952;23;19;0.0476190476190476;0.452380952380952
Control.SRR15539824;41;40;0.463414634146341;22;19;0.0365853658536585;0.463414634146341
Control.SRR15539824;36;40;0.555555555555556;16;20;0.0555555555555556;0.444444444444444
Control.SRR15539824;41;40;0.341463414634146;27;14;0.158536585365854;0.341463414634146
Control.SRR15539824;42;40;0.452380952380952;23;19;0.0476190476190476;0.452380952380952
Control.SRR15539824;38;40;0.5;19;19;0;0.5
Control.SRR15539824;36;40;0.444444444444444;20;16;0.0555555555555556;0.444444444444444
Control.SRR15539824;38;40;0.447368421052632;21;17;0.0526315789473684;0.447368421052632
Control.SRR15539824;41;40;0.585365853658537;17;24;0.0853658536585366;0.414634146341463
Control.SRR15539824;35;40;0.657142857142857;12;23;0.157142857142857;0.342857142857143
Control.SRR15539824;39;40;0.538461538461538;18;21;0.0384615384615384;0.461538461538462
Control.SRR15539824;44;40;0.454545454545455;24;20;0.0454545454545455;0.454545454545455
Control.SRR15539824;45;40;0.422222222222222;26;19;0.0777777777777778;0.422222222222222
Control.SRR15539824;44;40;0.613636363636364;17;27;0.113636363636364;0.386363636363636
Control.SRR15539824;43;40;0.488372093023256;22;21;0.0116279069767442;0.488372093023256
Control.SRR15539824;38;40;0.421052631578947;22;16;0.0789473684210527;0.421052631578947
Control.SRR15539824;44;40;0.545454545454545;20;24;0.0454545454545454;0.454545454545455
Control.SRR15539824;38;40;0.552631578947368;17;21;0.0526315789473685;0.447368421052632
Control.SRR15539824;38;40;0.473684210526316;20;18;0.0263157894736842;0.473684210526316
Control.SRR15539824;42;40;0.333333333333333;28;14;0.166666666666667;0.333333333333333
Control.SRR15539824;42;40;0.595238095238095;17;25;0.0952380952380952;0.404761904761905
Control.SRR15539824;38;40;0.473684210526316;20;18;0.0263157894736842;0.473684210526316
Control.SRR15539824;35;40;0.485714285714286;18;17;0.0142857142857143;0.485714285714286
Control.SRR15539824;45;40;0.488888888888889;23;22;0.0111111111111111;0.488888888888889
Control.SRR15539824;40;40;0.475;21;19;0.025;0.475
Control.SRR15539824;38;40;0.473684210526316;20;18;0.0263157894736842;0.473684210526316
Control.SRR15539824;39;40;0.666666666666667;13;26;0.166666666666667;0.333333333333333
Control.SRR15539824;36;40;0.611111111111111;14;22;0.111111111111111;0.388888888888889
Control.SRR15539824;42;40;0.476190476190476;22;20;0.0238095238095238;0.476190476190476
Control.SRR15539824;42;40;0.547619047619048;19;23;0.0476190476190477;0.452380952380952
Control.SRR15539824;43;40;0.441860465116279;24;19;0.0581395348837209;0.441860465116279
Control.SRR15539824;45;40;0.533333333333333;21;24;0.0333333333333333;0.466666666666667
Control.SRR15539824;38;40;0.526315789473684;18;20;0.0263157894736842;0.473684210526316
Control.SRR15539824;41;40;0.536585365853659;19;22;0.0365853658536586;0.463414634146341
Control.SRR15539824;37;40;0.72972972972973;10;27;0.22972972972973;0.27027027027027
Control.SRR15539824;42;40;0.595238095238095;17;25;0.0952380952380952;0.404761904761905
Control.SRR15539824;39;40;0.358974358974359;25;14;0.141025641025641;0.358974358974359
Control.SRR15539824;36;40;0.666666666666667;12;24;0.166666666666667;0.333333333333333
Control.SRR15539824;43;40;0.627906976744186;16;27;0.127906976744186;0.372093023255814
Control.SRR15539824;42;40;0.357142857142857;27;15;0.142857142857143;0.357142857142857
Control.SRR15539824;45;40;0.511111111111111;22;23;0.0111111111111111;0.488888888888889
Control.SRR15539824;41;40;0.658536585365854;14;27;0.158536585365854;0.341463414634146
Control.SRR15539824;40;40;0.575;17;23;0.075;0.425
Control.SRR15539824;42;40;0.523809523809524;20;22;0.0238095238095238;0.476190476190476
Control.SRR15539824;41;40;0.51219512195122;20;21;0.0121951219512195;0.48780487804878
Control.SRR15539824;44;40;0.409090909090909;26;18;0.0909090909090909;0.409090909090909
Control.SRR15539824;36;40;0.305555555555556;25;11;0.194444444444444;0.305555555555556
Control.SRR15539824;44;40;0.386363636363636;27;17;0.113636363636364;0.386363636363636
Control.SRR15539824;39;40;0.461538461538462;21;18;0.0384615384615384;0.461538461538462
Control.SRR15539824;38;40;0.447368421052632;21;17;0.0526315789473684;0.447368421052632
Control.SRR15539824;37;40;0.567567567567568;16;21;0.0675675675675675;0.432432432432432
Control.SRR15539824;40;40;0.575;17;23;0.075;0.425
Control.SRR15539824;41;40;0.48780487804878;21;20;0.0121951219512195;0.48780487804878
Control.SRR15539824;36;40;0.444444444444444;20;16;0.0555555555555556;0.444444444444444
Control.SRR15539824;36;40;0.555555555555556;16;20;0.0555555555555556;0.444444444444444
Control.SRR15539824;45;40;0.466666666666667;24;21;0.0333333333333333;0.466666666666667
Control.SRR15539824;35;40;0.457142857142857;19;16;0.0428571428571429;0.457142857142857
Control.SRR15539824;43;40;0.534883720930233;20;23;0.0348837209302325;0.465116279069767
Control.SRR15539824;43;40;0.441860465116279;24;19;0.0581395348837209;0.441860465116279
Control.SRR15539824;41;40;0.463414634146341;22;19;0.0365853658536585;0.463414634146341
Control.SRR15539824;35;40;0.485714285714286;18;17;0.0142857142857143;0.485714285714286
Control.SRR15539824;45;40;0.6;18;27;0.1;0.4
Control.SRR15539824;38;40;0.421052631578947;22;16;0.0789473684210527;0.421052631578947
Control.SRR15539824;36;40;0.472222222222222;19;17;0.0277777777777778;0.472222222222222
Control.SRR15539824;38;40;0.578947368421053;16;22;0.0789473684210527;0.421052631578947
Control.SRR15539824;36;40;0.694444444444444;11;25;0.194444444444444;0.305555555555556
Control.SRR15539824;41;40;0.634146341463415;15;26;0.134146341463415;0.365853658536585
Control.SRR15539824;43;40;0.534883720930233;20;23;0.0348837209302325;0.465116279069767
Control.SRR15539824;44;40;0.568181818181818;19;25;0.0681818181818182;0.431818181818182
Control.SRR15539824;37;40;0.567567567567568;16;21;0.0675675675675675;0.432432432432432
Control.SRR15539824;38;40;0.5;19;19;0;0.5
Control.SRR15539824;38;40;0.552631578947368;17;21;0.0526315789473685;0.447368421052632
Control.SRR15539824;36;40;0.666666666666667;12;24;0.166666666666667;0.333333333333333
Control.SRR15539824;42;40;0.5;21;21;0;0.5
Control.SRR15539824;40;40;0.475;21;19;0.025;0.475
Control.SRR15539824;36;40;0.583333333333333;15;21;0.0833333333333334;0.416666666666667
Control.SRR15539824;43;40;0.627906976744186;16;27;0.127906976744186;0.372093023255814
Control.SRR15539824;38;40;0.447368421052632;21;17;0.0526315789473684;0.447368421052632
Control.SRR15539824;36;40;0.638888888888889;13;23;0.138888888888889;0.361111111111111
Control.SRR15539824;37;40;0.432432432432432;21;16;0.0675675675675675;0.432432432432432
Control.SRR15539824;42;40;0.5;21;21;0;0.5
Control.SRR15539824;39;40;0.41025641025641;23;16;0.0897435897435898;0.41025641025641
Control.SRR15539824;43;40;0.534883720930233;20;23;0.0348837209302325;0.465116279069767
Control.SRR15539824;44;40;0.545454545454545;20;24;0.0454545454545454;0.454545454545455
Control.SRR15539824;44;40;0.545454545454545;20;24;0.0454545454545454;0.454545454545455
Control.SRR15539824;37;40;0.432432432432432;21;16;0.0675675675675675;0.432432432432432
Control.SRR15539824;38;40;0.526315789473684;18;20;0.0263157894736842;0.473684210526316
Control.SRR15539824;43;40;0.558139534883721;19;24;0.0581395348837209;0.441860465116279
Control.SRR15539824;38;40;0.473684210526316;20;18;0.0263157894736842;0.473684210526316
Control.SRR15539824;38;40;0.421052631578947;22;16;0.0789473684210527;0.421052631578947
Control.SRR15539824;43;40;0.581395348837209;18;25;0.0813953488372093;0.418604651162791
Control.SRR15539824;40;40;0.475;21;19;0.025;0.475
Control.SRR15539824;43;40;0.465116279069767;23;20;0.0348837209302326;0.465116279069767
Control.SRR15539824;38;40;0.578947368421053;16;22;0.0789473684210527;0.421052631578947
Control.SRR15539824;45;40;0.422222222222222;26;19;0.0777777777777778;0.422222222222222
Control.SRR15539824;43;40;0.581395348837209;18;25;0.0813953488372093;0.418604651162791
Control.SRR15539824;41;40;0.51219512195122;20;21;0.0121951219512195;0.48780487804878
Control.SRR15539824;42;40;0.452380952380952;23;19;0.0476190476190476;0.452380952380952
Control.SRR15539824;36;40;0.555555555555556;16;20;0.0555555555555556;0.444444444444444
Control.SRR15539824;36;40;0.527777777777778;17;19;0.0277777777777778;0.472222222222222
Control.SRR15539824;39;40;0.487179487179487;20;19;0.0128205128205128;0.487179487179487
Control.SRR15539824;41;40;0.390243902439024;25;16;0.109756097560976;0.390243902439024
Control.SRR15539824;36;40;0.666666666666667;12;24;0.166666666666667;0.333333333333333
Control.SRR15539824;39;40;0.461538461538462;21;18;0.0384615384615384;0.461538461538462
Control.SRR15539824;40;40;0.375;25;15;0.125;0.375
Control.SRR15539824;40;40;0.55;18;22;0.05;0.45
Control.SRR15539824;45;40;0.444444444444444;25;20;0.0555555555555556;0.444444444444444
Control.SRR15539824;45;40;0.488888888888889;23;22;0.0111111111111111;0.488888888888889
Control.SRR15539824;40;40;0.625;15;25;0.125;0.375
Control.SRR15539824;41;40;0.585365853658537;17;24;0.0853658536585366;0.414634146341463
Control.SRR15539824;43;40;0.511627906976744;21;22;0.0116279069767442;0.488372093023256
Control.SRR15539824;43;40;0.558139534883721;19;24;0.0581395348837209;0.441860465116279
Control.SRR15539824;42;40;0.571428571428571;18;24;0.0714285714285714;0.428571428571429
Control.SRR15539824;39;40;0.384615384615385;24;15;0.115384615384615;0.384615384615385
Control.SRR15539824;45;40;0.555555555555556;20;25;0.0555555555555556;0.444444444444444
Control.SRR15539824;43;40;0.511627906976744;21;22;0.0116279069767442;0.488372093023256
Control.SRR15539824;35;40;0.428571428571429;20;15;0.0714285714285715;0.428571428571429
Control.SRR15539824;43;40;0.441860465116279;24;19;0.0581395348837209;0.441860465116279
Control.SRR15539824;45;40;0.555555555555556;20;25;0.0555555555555556;0.444444444444444
Control.SRR15539824;40;40;0.4;24;16;0.1;0.4
Control.SRR15539824;42;40;0.428571428571429;24;18;0.0714285714285715;0.428571428571429
Control.SRR15539824;44;40;0.386363636363636;27;17;0.113636363636364;0.386363636363636
Control.SRR15539824;42;40;0.476190476190476;22;20;0.0238095238095238;0.476190476190476
Control.SRR15539824;45;40;0.577777777777778;19;26;0.0777777777777777;0.422222222222222
Control.SRR15539824;44;40;0.431818181818182;25;19;0.0681818181818182;0.431818181818182
Control.SRR15539824;43;40;0.418604651162791;25;18;0.0813953488372093;0.418604651162791
Control.SRR15539824;43;40;0.465116279069767;23;20;0.0348837209302326;0.465116279069767
Control.SRR15539824;39;40;0.384615384615385;24;15;0.115384615384615;0.384615384615385
Control.SRR15539824;41;40;0.560975609756098;18;23;0.0609756097560976;0.439024390243902
Control.SRR15539824;39;40;0.641025641025641;14;25;0.141025641025641;0.358974358974359
Control.SRR15539824;40;40;0.6;16;24;0.1;0.4
Control.SRR15539824;37;40;0.648648648648649;13;24;0.148648648648649;0.351351351351351
Control.SRR15539824;37;40;0.540540540540541;17;20;0.0405405405405406;0.459459459459459
Control.SRR15539824;45;40;0.488888888888889;23;22;0.0111111111111111;0.488888888888889
Control.SRR15539824;43;40;0.558139534883721;19;24;0.0581395348837209;0.441860465116279
Control.SRR15539824;44;40;0.5;22;22;0;0.5
Control.SRR15539824;37;40;0.513513513513513;18;19;0.0135135135135135;0.486486486486487
Control.SRR15539824;36;40;0.555555555555556;16;20;0.0555555555555556;0.444444444444444
Control.SRR15539824;40;40;0.475;21;19;0.025;0.475
Control.SRR15539824;36;40;0.416666666666667;21;15;0.0833333333333333;0.416666666666667
Control.SRR15539824;43;40;0.488372093023256;22;21;0.0116279069767442;0.488372093023256
Control.SRR15539824;36;40;0.333333333333333;24;12;0.166666666666667;0.333333333333333
Control.SRR15539824;36;40;0.472222222222222;19;17;0.0277777777777778;0.472222222222222
Control.SRR15539824;40;40;0.475;21;19;0.025;0.475
Control.SRR15539824;44;40;0.545454545454545;20;24;0.0454545454545454;0.454545454545455
Control.SRR15539824;41;40;0.609756097560976;16;25;0.109756097560976;0.390243902439024
Control.SRR15539824;43;40;0.581395348837209;18;25;0.0813953488372093;0.418604651162791
Control.SRR15539824;39;40;0.564102564102564;17;22;0.0641025641025641;0.435897435897436
Control.SRR15539824;43;40;0.488372093023256;22;21;0.0116279069767442;0.488372093023256
Control.SRR15539824;38;40;0.605263157894737;15;23;0.105263157894737;0.394736842105263
Control.SRR15539824;44;40;0.454545454545455;24;20;0.0454545454545455;0.454545454545455
Control.SRR15539824;43;40;0.441860465116279;24;19;0.0581395348837209;0.441860465116279
Control.SRR15539824;35;40;0.371428571428571;22;13;0.128571428571429;0.371428571428571
Control.SRR15539824;43;40;0.418604651162791;25;18;0.0813953488372093;0.418604651162791
Control.SRR15539824;43;40;0.418604651162791;25;18;0.0813953488372093;0.418604651162791
Control.SRR15539824;38;40;0.578947368421053;16;22;0.0789473684210527;0.421052631578947
Control.SRR15539824;41;40;0.609756097560976;16;25;0.109756097560976;0.390243902439024
Control.SRR15539824;39;40;0.333333333333333;26;13;0.166666666666667;0.333333333333333
Control.SRR15539824;37;40;0.459459459459459;20;17;0.0405405405405405;0.459459459459459
Control.SRR15539824;38;40;0.473684210526316;20;18;0.0263157894736842;0.473684210526316
Control.SRR15539824;41;40;0.609756097560976;16;25;0.109756097560976;0.390243902439024
Control.SRR15539824;37;40;0.540540540540541;17;20;0.0405405405405406;0.459459459459459
Control.SRR15539824;39;40;0.538461538461538;18;21;0.0384615384615384;0.461538461538462
Control.SRR15539824;43;40;0.534883720930233;20;23;0.0348837209302325;0.465116279069767
Control.SRR15539824;38;40;0.526315789473684;18;20;0.0263157894736842;0.473684210526316
Control.SRR15539824;37;40;0.486486486486487;19;18;0.0135135135135135;0.486486486486487
Control.SRR15539824;41;40;0.51219512195122;20;21;0.0121951219512195;0.48780487804878
Control.SRR15539824;35;40;0.485714285714286;18;17;0.0142857142857143;0.485714285714286
Control.SRR15539824;37;40;0.486486486486487;19;18;0.0135135135135135;0.486486486486487
Control.SRR15539824;39;40;0.461538461538462;21;18;0.0384615384615384;0.461538461538462
Control.SRR15539824;41;40;0.414634146341463;24;17;0.0853658536585366;0.414634146341463
Control.SRR15539824;39;40;0.487179487179487;20;19;0.0128205128205128;0.487179487179487
Control.SRR15539824;35;40;0.628571428571429;13;22;0.128571428571429;0.371428571428571
Control.SRR15539824;41;40;0.390243902439024;25;16;0.109756097560976;0.390243902439024
Control.SRR15539824;40;40;0.525;19;21;0.025;0.475
Control.SRR15539824;35;40;0.457142857142857;19;16;0.0428571428571429;0.457142857142857
Control.SRR15539824;37;40;0.432432432432432;21;16;0.0675675675675675;0.432432432432432
Control.SRR15539824;41;40;0.560975609756098;18;23;0.0609756097560976;0.439024390243902
Control.SRR15539824;39;40;0.487179487179487;20;19;0.0128205128205128;0.487179487179487
Control.SRR15539824;44;40;0.522727272727273;21;23;0.0227272727272727;0.477272727272727
Control.SRR15539824;42;40;0.404761904761905;25;17;0.0952380952380952;0.404761904761905
Control.SRR15539824;44;40;0.613636363636364;17;27;0.113636363636364;0.386363636363636
Control.SRR15539824;44;40;0.5;22;22;0;0.5
Control.SRR15539824;37;40;0.486486486486487;19;18;0.0135135135135135;0.486486486486487
Control.SRR15539824;41;40;0.51219512195122;20;21;0.0121951219512195;0.48780487804878
Control.SRR15539824;45;40;0.6;18;27;0.1;0.4
Control.SRR15539824;38;40;0.421052631578947;22;16;0.0789473684210527;0.421052631578947
Control.SRR15539824;39;40;0.564102564102564;17;22;0.0641025641025641;0.435897435897436
Control.SRR15539824;38;40;0.5;19;19;0;0.5
Control.SRR15539824;39;40;0.564102564102564;17;22;0.0641025641025641;0.435897435897436
Control.SRR15539824;39;40;0.512820512820513;19;20;0.0128205128205128;0.487179487179487
Control.SRR15539824;38;40;0.342105263157895;25;13;0.157894736842105;0.342105263157895
Control.SRR15539824;45;40;0.488888888888889;23;22;0.0111111111111111;0.488888888888889
Control.SRR15539824;42;40;0.452380952380952;23;19;0.0476190476190476;0.452380952380952
Control.SRR15539824;36;40;0.555555555555556;16;20;0.0555555555555556;0.444444444444444
Control.SRR15539824;38;40;0.5;19;19;0;0.5
Control.SRR15539824;35;40;0.485714285714286;18;17;0.0142857142857143;0.485714285714286
Control.SRR15539824;43;40;0.581395348837209;18;25;0.0813953488372093;0.418604651162791
Control.SRR15539824;44;40;0.477272727272727;23;21;0.0227272727272727;0.477272727272727
Control.SRR15539824;42;40;0.619047619047619;16;26;0.119047619047619;0.380952380952381
Control.SRR15539824;38;40;0.526315789473684;18;20;0.0263157894736842;0.473684210526316
Control.SRR15539824;40;40;0.55;18;22;0.05;0.45
Control.SRR15539824;37;40;0.486486486486487;19;18;0.0135135135135135;0.486486486486487
Control.SRR15539824;45;40;0.533333333333333;21;24;0.0333333333333333;0.466666666666667
Control.SRR15539824;36;40;0.472222222222222;19;17;0.0277777777777778;0.472222222222222
Control.SRR15539824;44;40;0.522727272727273;21;23;0.0227272727272727;0.477272727272727
Control.SRR15539824;39;40;0.512820512820513;19;20;0.0128205128205128;0.487179487179487
Control.SRR15539824;45;40;0.533333333333333;21;24;0.0333333333333333;0.466666666666667
Control.SRR15539824;39;40;0.487179487179487;20;19;0.0128205128205128;0.487179487179487
Control.SRR15539824;35;40;0.514285714285714;17;18;0.0142857142857142;0.485714285714286
Control.SRR15539824;43;40;0.534883720930233;20;23;0.0348837209302325;0.465116279069767
Control.SRR15539824;37;40;0.540540540540541;17;20;0.0405405405405406;0.459459459459459
Control.SRR15539824;40;40;0.65;14;26;0.15;0.35
Control.SRR15539824;40;40;0.6;16;24;0.1;0.4
Control.SRR15539824;40;40;0.7;12;28;0.2;0.3
Control.SRR15539824;42;40;0.571428571428571;18;24;0.0714285714285714;0.428571428571429
Control.SRR15539824;37;40;0.378378378378378;23;14;0.121621621621622;0.378378378378378
Control.SRR15539824;44;40;0.590909090909091;18;26;0.0909090909090909;0.409090909090909
Control.SRR15539824;43;40;0.418604651162791;25;18;0.0813953488372093;0.418604651162791
Control.SRR15539824;40;40;0.575;17;23;0.075;0.425
Control.SRR15539824;38;40;0.447368421052632;21;17;0.0526315789473684;0.447368421052632
Control.SRR15539824;40;40;0.4;24;16;0.1;0.4
Control.SRR15539824;40;40;0.4;24;16;0.1;0.4
Control.SRR15539824;40;40;0.35;26;14;0.15;0.35
Control.SRR15539824;43;40;0.488372093023256;22;21;0.0116279069767442;0.488372093023256
Control.SRR15539824;40;40;0.525;19;21;0.025;0.475
Control.SRR15539824;36;40;0.444444444444444;20;16;0.0555555555555556;0.444444444444444
Control.SRR15539824;40;40;0.325;27;13;0.175;0.325
Control.SRR15539824;43;40;0.465116279069767;23;20;0.0348837209302326;0.465116279069767
Control.SRR15539824;40;40;0.425;23;17;0.075;0.425
Control.SRR15539824;36;40;0.583333333333333;15;21;0.0833333333333334;0.416666666666667
Control.SRR15539824;39;40;0.487179487179487;20;19;0.0128205128205128;0.487179487179487
Control.SRR15539824;40;40;0.65;14;26;0.15;0.35
Control.SRR15539824;44;40;0.5;22;22;0;0.5
Control.SRR15539824;43;40;0.488372093023256;22;21;0.0116279069767442;0.488372093023256
Control.SRR15539824;44;40;0.5;22;22;0;0.5
Control.SRR15539824;44;40;0.613636363636364;17;27;0.113636363636364;0.386363636363636
Control.SRR15539824;43;40;0.651162790697674;15;28;0.151162790697674;0.348837209302326
Control.SRR15539824;37;40;0.540540540540541;17;20;0.0405405405405406;0.459459459459459
Control.SRR15539824;44;40;0.522727272727273;21;23;0.0227272727272727;0.477272727272727
Control.SRR15539824;40;40;0.5;20;20;0;0.5
Control.SRR15539824;37;40;0.486486486486487;19;18;0.0135135135135135;0.486486486486487
Control.SRR15539824;40;40;0.5;20;20;0;0.5
Control.SRR15539824;36;40;0.638888888888889;13;23;0.138888888888889;0.361111111111111
Control.SRR15539824;38;40;0.552631578947368;17;21;0.0526315789473685;0.447368421052632
Control.SRR15539824;39;40;0.564102564102564;17;22;0.0641025641025641;0.435897435897436
Control.SRR15539824;45;40;0.466666666666667;24;21;0.0333333333333333;0.466666666666667
Control.SRR15539824;40;40;0.55;18;22;0.05;0.45
Control.SRR15539824;38;40;0.631578947368421;14;24;0.131578947368421;0.368421052631579
Control.SRR15539824;42;40;0.571428571428571;18;24;0.0714285714285714;0.428571428571429
Control.SRR15539824;37;40;0.459459459459459;20;17;0.0405405405405405;0.459459459459459
Control.SRR15539824;39;40;0.487179487179487;20;19;0.0128205128205128;0.487179487179487
Control.SRR15539824;43;40;0.488372093023256;22;21;0.0116279069767442;0.488372093023256
Control.SRR15539824;37;40;0.459459459459459;20;17;0.0405405405405405;0.459459459459459
Control.SRR15539824;45;40;0.533333333333333;21;24;0.0333333333333333;0.466666666666667
Control.SRR15539824;42;40;0.595238095238095;17;25;0.0952380952380952;0.404761904761905
Control.SRR15539824;35;40;0.6;14;21;0.1;0.4
Control.SRR15539824;38;40;0.368421052631579;24;14;0.131578947368421;0.368421052631579
Control.SRR15539824;44;40;0.454545454545455;24;20;0.0454545454545455;0.454545454545455
Control.SRR15539824;35;40;0.314285714285714;24;11;0.185714285714286;0.314285714285714
Control.SRR15539824;44;40;0.659090909090909;15;29;0.159090909090909;0.340909090909091
Control.SRR15539824;42;40;0.595238095238095;17;25;0.0952380952380952;0.404761904761905
Control.SRR15539824;40;40;0.575;17;23;0.075;0.425
Control.SRR15539824;42;40;0.547619047619048;19;23;0.0476190476190477;0.452380952380952
Control.SRR15539824;37;40;0.459459459459459;20;17;0.0405405405405405;0.459459459459459
Control.SRR15539824;36;40;0.5;18;18;0;0.5
Control.SRR15539824;37;40;0.540540540540541;17;20;0.0405405405405406;0.459459459459459
Control.SRR15539824;40;40;0.5;20;20;0;0.5
Control.SRR15539824;36;40;0.472222222222222;19;17;0.0277777777777778;0.472222222222222
Control.SRR15539824;43;40;0.418604651162791;25;18;0.0813953488372093;0.418604651162791
Control.SRR15539824;44;40;0.545454545454545;20;24;0.0454545454545454;0.454545454545455
Control.SRR15539824;45;40;0.488888888888889;23;22;0.0111111111111111;0.488888888888889
Control.SRR15539824;43;40;0.348837209302326;28;15;0.151162790697674;0.348837209302326
Control.SRR15539824;43;40;0.465116279069767;23;20;0.0348837209302326;0.465116279069767
Control.SRR15539824;38;40;0.526315789473684;18;20;0.0263157894736842;0.473684210526316
Control.SRR15539824;41;40;0.463414634146341;22;19;0.0365853658536585;0.463414634146341
Control.SRR15539824;43;40;0.651162790697674;15;28;0.151162790697674;0.348837209302326
Control.SRR15539824;45;40;0.266666666666667;33;12;0.233333333333333;0.266666666666667
Control.SRR15539824;40;40;0.55;18;22;0.05;0.45
Control.SRR15539824;45;40;0.488888888888889;23;22;0.0111111111111111;0.488888888888889
Control.SRR15539824;39;40;0.384615384615385;24;15;0.115384615384615;0.384615384615385
Control.SRR15539824;36;40;0.555555555555556;16;20;0.0555555555555556;0.444444444444444
Control.SRR15539824;45;40;0.488888888888889;23;22;0.0111111111111111;0.488888888888889
Control.SRR15539824;43;40;0.581395348837209;18;25;0.0813953488372093;0.418604651162791
Control.SRR15539824;40;40;0.5;20;20;0;0.5
Control.SRR15539824;36;40;0.416666666666667;21;15;0.0833333333333333;0.416666666666667
Control.SRR15539824;36;40;0.638888888888889;13;23;0.138888888888889;0.361111111111111
Control.SRR15539824;37;40;0.378378378378378;23;14;0.121621621621622;0.378378378378378
Control.SRR15539824;36;40;0.583333333333333;15;21;0.0833333333333334;0.416666666666667
Control.SRR15539824;40;40;0.55;18;22;0.05;0.45
Control.SRR15539824;35;40;0.4;21;14;0.1;0.4
Control.SRR15539824;35;40;0.485714285714286;18;17;0.0142857142857143;0.485714285714286
Control.SRR15539824;43;40;0.581395348837209;18;25;0.0813953488372093;0.418604651162791
Control.SRR15539824;37;40;0.567567567567568;16;21;0.0675675675675675;0.432432432432432
Control.SRR15539824;42;40;0.404761904761905;25;17;0.0952380952380952;0.404761904761905
Control.SRR15539824;39;40;0.461538461538462;21;18;0.0384615384615384;0.461538461538462
Control.SRR15539824;41;40;0.390243902439024;25;16;0.109756097560976;0.390243902439024
Control.SRR15539824;39;40;0.512820512820513;19;20;0.0128205128205128;0.487179487179487
Control.SRR15539824;42;40;0.571428571428571;18;24;0.0714285714285714;0.428571428571429
Control.SRR15539824;42;40;0.476190476190476;22;20;0.0238095238095238;0.476190476190476
Control.SRR15539824;45;40;0.444444444444444;25;20;0.0555555555555556;0.444444444444444
Control.SRR15539824;45;40;0.4;27;18;0.1;0.4
Control.SRR15539824;42;40;0.452380952380952;23;19;0.0476190476190476;0.452380952380952
Control.SRR15539824;36;40;0.472222222222222;19;17;0.0277777777777778;0.472222222222222
Control.SRR15539824;41;40;0.658536585365854;14;27;0.158536585365854;0.341463414634146
Control.SRR15539824;40;40;0.325;27;13;0.175;0.325
Control.SRR15539824;38;40;0.526315789473684;18;20;0.0263157894736842;0.473684210526316
Control.SRR15539824;38;40;0.368421052631579;24;14;0.131578947368421;0.368421052631579
Control.SRR15539824;39;40;0.564102564102564;17;22;0.0641025641025641;0.435897435897436
Control.SRR15539824;39;40;0.307692307692308;27;12;0.192307692307692;0.307692307692308
Control.SRR15539824;40;40;0.475;21;19;0.025;0.475
Control.SRR15539824;39;40;0.615384615384615;15;24;0.115384615384615;0.384615384615385
Control.SRR15539824;42;40;0.5;21;21;0;0.5
Control.SRR15539824;42;40;0.5;21;21;0;0.5
Control.SRR15539824;36;40;0.527777777777778;17;19;0.0277777777777778;0.472222222222222
Control.SRR15539824;43;40;0.488372093023256;22;21;0.0116279069767442;0.488372093023256
Control.SRR15539824;44;40;0.568181818181818;19;25;0.0681818181818182;0.431818181818182
Control.SRR15539824;39;40;0.58974358974359;16;23;0.0897435897435898;0.41025641025641
Control.SRR15539824;39;40;0.564102564102564;17;22;0.0641025641025641;0.435897435897436
Control.SRR15539824;43;40;0.627906976744186;16;27;0.127906976744186;0.372093023255814
Control.SRR15539824;43;40;0.581395348837209;18;25;0.0813953488372093;0.418604651162791
Control.SRR15539824;42;40;0.428571428571429;24;18;0.0714285714285715;0.428571428571429
Control.SRR15539824;38;40;0.552631578947368;17;21;0.0526315789473685;0.447368421052632
Control.SRR15539824;36;40;0.5;18;18;0;0.5
Control.SRR15539824;39;40;0.487179487179487;20;19;0.0128205128205128;0.487179487179487
Control.SRR15539824;45;40;0.377777777777778;28;17;0.122222222222222;0.377777777777778
Control.SRR15539824;36;40;0.5;18;18;0;0.5
Control.SRR15539824;44;40;0.477272727272727;23;21;0.0227272727272727;0.477272727272727
Control.SRR15539824;40;40;0.525;19;21;0.025;0.475
Control.SRR15539824;42;40;0.619047619047619;16;26;0.119047619047619;0.380952380952381
Control.SRR15539824;38;40;0.552631578947368;17;21;0.0526315789473685;0.447368421052632
Control.SRR15539824;45;40;0.533333333333333;21;24;0.0333333333333333;0.466666666666667
Control.SRR15539824;39;40;0.435897435897436;22;17;0.0641025641025641;0.435897435897436
Control.SRR15539824;44;40;0.431818181818182;25;19;0.0681818181818182;0.431818181818182
Control.SRR15539824;41;40;0.634146341463415;15;26;0.134146341463415;0.365853658536585
Control.SRR15539824;38;40;0.473684210526316;20;18;0.0263157894736842;0.473684210526316
Control.SRR15539824;43;40;0.604651162790698;17;26;0.104651162790698;0.395348837209302
Control.SRR15539824;44;40;0.522727272727273;21;23;0.0227272727272727;0.477272727272727
Control.SRR15539824;38;40;0.526315789473684;18;20;0.0263157894736842;0.473684210526316
Control.SRR15539824;45;40;0.533333333333333;21;24;0.0333333333333333;0.466666666666667
Control.SRR15539824;37;40;0.459459459459459;20;17;0.0405405405405405;0.459459459459459
Control.SRR15539824;45;40;0.555555555555556;20;25;0.0555555555555556;0.444444444444444
Control.SRR15539824;40;40;0.425;23;17;0.075;0.425
Control.SRR15539824;44;40;0.454545454545455;24;20;0.0454545454545455;0.454545454545455
Control.SRR15539824;44;40;0.5;22;22;0;0.5
Control.SRR15539824;38;40;0.394736842105263;23;15;0.105263157894737;0.394736842105263
Control.SRR15539824;40;40;0.475;21;19;0.025;0.475
Control.SRR15539824;42;40;0.452380952380952;23;19;0.0476190476190476;0.452380952380952
Control.SRR15539824;38;40;0.447368421052632;21;17;0.0526315789473684;0.447368421052632
Control.SRR15539824;36;40;0.388888888888889;22;14;0.111111111111111;0.388888888888889
Control.SRR15539824;36;40;0.444444444444444;20;16;0.0555555555555556;0.444444444444444
Control.SRR15539824;41;40;0.463414634146341;22;19;0.0365853658536585;0.463414634146341
Control.SRR15539824;36;40;0.666666666666667;12;24;0.166666666666667;0.333333333333333
Control.SRR15539824;40;40;0.625;15;25;0.125;0.375
Control.SRR15539824;40;40;0.65;14;26;0.15;0.35
Control.SRR15539824;35;40;0.485714285714286;18;17;0.0142857142857143;0.485714285714286
Control.SRR15539824;44;40;0.5;22;22;0;0.5
Control.SRR15539824;39;40;0.461538461538462;21;18;0.0384615384615384;0.461538461538462
Control.SRR15539824;41;40;0.365853658536585;26;15;0.134146341463415;0.365853658536585
Control.SRR15539824;37;40;0.567567567567568;16;21;0.0675675675675675;0.432432432432432
Control.SRR15539824;36;40;0.333333333333333;24;12;0.166666666666667;0.333333333333333
Control.SRR15539824;41;40;0.414634146341463;24;17;0.0853658536585366;0.414634146341463
Control.SRR15539824;38;40;0.5;19;19;0;0.5
Control.SRR15539824;44;40;0.454545454545455;24;20;0.0454545454545455;0.454545454545455
Control.SRR15539824;37;40;0.513513513513513;18;19;0.0135135135135135;0.486486486486487
Control.SRR15539824;43;40;0.441860465116279;24;19;0.0581395348837209;0.441860465116279
Control.SRR15539824;45;40;0.555555555555556;20;25;0.0555555555555556;0.444444444444444
Control.SRR15539824;41;40;0.51219512195122;20;21;0.0121951219512195;0.48780487804878
Control.SRR15539824;41;40;0.51219512195122;20;21;0.0121951219512195;0.48780487804878
Control.SRR15539824;42;40;0.476190476190476;22;20;0.0238095238095238;0.476190476190476
Control.SRR15539824;45;40;0.577777777777778;19;26;0.0777777777777777;0.422222222222222
Control.SRR15539824;36;40;0.527777777777778;17;19;0.0277777777777778;0.472222222222222
Control.SRR15539824;38;40;0.526315789473684;18;20;0.0263157894736842;0.473684210526316
Control.SRR15539824;41;40;0.48780487804878;21;20;0.0121951219512195;0.48780487804878
Control.SRR15539824;35;40;0.628571428571429;13;22;0.128571428571429;0.371428571428571
Control.SRR15539824;35;40;0.514285714285714;17;18;0.0142857142857142;0.485714285714286
Control.SRR15539824;40;40;0.4;24;16;0.1;0.4
Control.SRR15539824;35;40;0.542857142857143;16;19;0.0428571428571428;0.457142857142857
Control.SRR15539824;42;40;0.476190476190476;22;20;0.0238095238095238;0.476190476190476
Control.SRR15539824;40;40;0.35;26;14;0.15;0.35
Control.SRR15539824;42;40;0.476190476190476;22;20;0.0238095238095238;0.476190476190476
Control.SRR15539824;36;40;0.472222222222222;19;17;0.0277777777777778;0.472222222222222
Control.SRR15539824;43;40;0.697674418604651;13;30;0.197674418604651;0.302325581395349
Control.SRR15539824;38;40;0.394736842105263;23;15;0.105263157894737;0.394736842105263
Control.SRR15539824;38;40;0.447368421052632;21;17;0.0526315789473684;0.447368421052632
Control.SRR15539824;40;40;0.55;18;22;0.05;0.45
Control.SRR15539824;43;40;0.534883720930233;20;23;0.0348837209302325;0.465116279069767
Control.SRR15539824;45;40;0.533333333333333;21;24;0.0333333333333333;0.466666666666667
Control.SRR15539824;37;40;0.567567567567568;16;21;0.0675675675675675;0.432432432432432
Control.SRR15539824;42;40;0.619047619047619;16;26;0.119047619047619;0.380952380952381
Control.SRR15539824;36;40;0.527777777777778;17;19;0.0277777777777778;0.472222222222222
Control.SRR15539824;42;40;0.476190476190476;22;20;0.0238095238095238;0.476190476190476
Control.SRR15539824;40;40;0.5;20;20;0;0.5
Control.SRR15539824;38;40;0.526315789473684;18;20;0.0263157894736842;0.473684210526316
Control.SRR15539824;35;40;0.571428571428571;15;20;0.0714285714285714;0.428571428571429
Control.SRR15539824;41;40;0.560975609756098;18;23;0.0609756097560976;0.439024390243902
Control.SRR15539824;40;40;0.425;23;17;0.075;0.425
Control.SRR15539824;39;40;0.641025641025641;14;25;0.141025641025641;0.358974358974359
Control.SRR15539824;44;40;0.431818181818182;25;19;0.0681818181818182;0.431818181818182
Control.SRR15539824;42;40;0.476190476190476;22;20;0.0238095238095238;0.476190476190476
Control.SRR15539824;40;40;0.425;23;17;0.075;0.425
Control.SRR15539824;45;40;0.511111111111111;22;23;0.0111111111111111;0.488888888888889
Control.SRR15539824;37;40;0.486486486486487;19;18;0.0135135135135135;0.486486486486487
Control.SRR15539824;39;40;0.58974358974359;16;23;0.0897435897435898;0.41025641025641
Control.SRR15539824;40;40;0.525;19;21;0.025;0.475
Control.SRR15539824;39;40;0.58974358974359;16;23;0.0897435897435898;0.41025641025641
Control.SRR15539824;38;40;0.447368421052632;21;17;0.0526315789473684;0.447368421052632
Control.SRR15539824;44;40;0.5;22;22;0;0.5
Control.SRR15539824;44;40;0.386363636363636;27;17;0.113636363636364;0.386363636363636
Control.SRR15539824;45;40;0.488888888888889;23;22;0.0111111111111111;0.488888888888889
Control.SRR15539824;43;40;0.558139534883721;19;24;0.0581395348837209;0.441860465116279
Control.SRR15539824;45;40;0.422222222222222;26;19;0.0777777777777778;0.422222222222222
Control.SRR15539824;38;40;0.526315789473684;18;20;0.0263157894736842;0.473684210526316
Control.SRR15539824;35;40;0.657142857142857;12;23;0.157142857142857;0.342857142857143
Control.SRR15539824;44;40;0.454545454545455;24;20;0.0454545454545455;0.454545454545455
Control.SRR15539824;37;40;0.486486486486487;19;18;0.0135135135135135;0.486486486486487
Control.SRR15539824;35;40;0.514285714285714;17;18;0.0142857142857142;0.485714285714286
Control.SRR15539824;42;40;0.428571428571429;24;18;0.0714285714285715;0.428571428571429
Control.SRR15539824;41;40;0.560975609756098;18;23;0.0609756097560976;0.439024390243902
Control.SRR15539824;40;40;0.55;18;22;0.05;0.45
Control.SRR15539824;39;40;0.512820512820513;19;20;0.0128205128205128;0.487179487179487
Control.SRR15539824;41;40;0.560975609756098;18;23;0.0609756097560976;0.439024390243902
Control.SRR15539824;39;40;0.538461538461538;18;21;0.0384615384615384;0.461538461538462
Control.SRR15539824;41;40;0.560975609756098;18;23;0.0609756097560976;0.439024390243902
Control.SRR15539824;44;40;0.5;22;22;0;0.5
Control.SRR15539824;44;40;0.5;22;22;0;0.5
Control.SRR15539824;38;40;0.605263157894737;15;23;0.105263157894737;0.394736842105263
Control.SRR15539824;39;40;0.538461538461538;18;21;0.0384615384615384;0.461538461538462
Control.SRR15539824;40;40;0.475;21;19;0.025;0.475
Control.SRR15539824;37;40;0.486486486486487;19;18;0.0135135135135135;0.486486486486487
Control.SRR15539824;40;40;0.525;19;21;0.025;0.475
Control.SRR15539824;41;40;0.634146341463415;15;26;0.134146341463415;0.365853658536585
Control.SRR15539824;44;40;0.477272727272727;23;21;0.0227272727272727;0.477272727272727
Control.SRR15539824;40;40;0.375;25;15;0.125;0.375
Control.SRR15539824;44;40;0.659090909090909;15;29;0.159090909090909;0.340909090909091
Control.SRR15539824;45;40;0.355555555555556;29;16;0.144444444444444;0.355555555555556
Control.SRR15539824;43;40;0.558139534883721;19;24;0.0581395348837209;0.441860465116279
Control.SRR15539824;36;40;0.444444444444444;20;16;0.0555555555555556;0.444444444444444
Control.SRR15539824;43;40;0.488372093023256;22;21;0.0116279069767442;0.488372093023256
Control.SRR15539824;45;40;0.555555555555556;20;25;0.0555555555555556;0.444444444444444
Control.SRR15539824;41;40;0.463414634146341;22;19;0.0365853658536585;0.463414634146341
Control.SRR15539824;37;40;0.567567567567568;16;21;0.0675675675675675;0.432432432432432
Control.SRR15539824;40;40;0.5;20;20;0;0.5
Control.SRR15539824;36;40;0.527777777777778;17;19;0.0277777777777778;0.472222222222222
Control.SRR15539824;44;40;0.477272727272727;23;21;0.0227272727272727;0.477272727272727
Control.SRR15539824;43;40;0.418604651162791;25;18;0.0813953488372093;0.418604651162791
Control.SRR15539824;42;40;0.642857142857143;15;27;0.142857142857143;0.357142857142857
Control.SRR15539824;41;40;0.48780487804878;21;20;0.0121951219512195;0.48780487804878
Control.SRR15539824;42;40;0.404761904761905;25;17;0.0952380952380952;0.404761904761905
Control.SRR15539824;41;40;0.463414634146341;22;19;0.0365853658536585;0.463414634146341
Control.SRR15539824;45;40;0.466666666666667;24;21;0.0333333333333333;0.466666666666667
Control.SRR15539824;38;40;0.473684210526316;20;18;0.0263157894736842;0.473684210526316
Control.SRR15539824;42;40;0.428571428571429;24;18;0.0714285714285715;0.428571428571429
Control.SRR15539824;40;40;0.4;24;16;0.1;0.4
Control.SRR15539824;43;40;0.511627906976744;21;22;0.0116279069767442;0.488372093023256
Control.SRR15539824;45;40;0.511111111111111;22;23;0.0111111111111111;0.488888888888889
Control.SRR15539824;44;40;0.613636363636364;17;27;0.113636363636364;0.386363636363636
Control.SRR15539824;40;40;0.475;21;19;0.025;0.475
Control.SRR15539824;36;40;0.583333333333333;15;21;0.0833333333333334;0.416666666666667
Control.SRR15539824;42;40;0.523809523809524;20;22;0.0238095238095238;0.476190476190476
Control.SRR15539824;41;40;0.536585365853659;19;22;0.0365853658536586;0.463414634146341
Control.SRR15539824;38;40;0.578947368421053;16;22;0.0789473684210527;0.421052631578947
Control.SRR15539824;43;40;0.511627906976744;21;22;0.0116279069767442;0.488372093023256
Control.SRR15539824;41;40;0.585365853658537;17;24;0.0853658536585366;0.414634146341463
Control.SRR15539824;38;40;0.5;19;19;0;0.5
Control.SRR15539824;43;40;0.465116279069767;23;20;0.0348837209302326;0.465116279069767
Control.SRR15539824;45;40;0.444444444444444;25;20;0.0555555555555556;0.444444444444444
Control.SRR15539824;36;40;0.611111111111111;14;22;0.111111111111111;0.388888888888889
Control.SRR15539824;38;40;0.657894736842105;13;25;0.157894736842105;0.342105263157895
Control.SRR15539824;42;40;0.428571428571429;24;18;0.0714285714285715;0.428571428571429
Control.SRR15539824;43;40;0.511627906976744;21;22;0.0116279069767442;0.488372093023256
Control.SRR15539824;36;40;0.666666666666667;12;24;0.166666666666667;0.333333333333333
Control.SRR15539824;39;40;0.512820512820513;19;20;0.0128205128205128;0.487179487179487
Control.SRR15539824;40;40;0.6;16;24;0.1;0.4
Control.SRR15539824;41;40;0.536585365853659;19;22;0.0365853658536586;0.463414634146341
Control.SRR15539824;35;40;0.6;14;21;0.1;0.4
Control.SRR15539824;39;40;0.461538461538462;21;18;0.0384615384615384;0.461538461538462
Control.SRR15539824;45;40;0.444444444444444;25;20;0.0555555555555556;0.444444444444444
Control.SRR15539824;45;40;0.466666666666667;24;21;0.0333333333333333;0.466666666666667
Control.SRR15539824;44;40;0.5;22;22;0;0.5
Control.SRR15539824;38;40;0.552631578947368;17;21;0.0526315789473685;0.447368421052632
Control.SRR15539824;44;40;0.454545454545455;24;20;0.0454545454545455;0.454545454545455
Control.SRR15539824;38;40;0.342105263157895;25;13;0.157894736842105;0.342105263157895
Control.SRR15539824;45;40;0.466666666666667;24;21;0.0333333333333333;0.466666666666667
Control.SRR15539824;36;40;0.416666666666667;21;15;0.0833333333333333;0.416666666666667
Control.SRR15539824;36;40;0.555555555555556;16;20;0.0555555555555556;0.444444444444444
Control.SRR15539824;38;40;0.578947368421053;16;22;0.0789473684210527;0.421052631578947
Control.SRR15539824;40;40;0.425;23;17;0.075;0.425
Control.SRR15539824;37;40;0.621621621621622;14;23;0.121621621621622;0.378378378378378
Control.SRR15539824;40;40;0.5;20;20;0;0.5
Control.SRR15539824;37;40;0.540540540540541;17;20;0.0405405405405406;0.459459459459459
Control.SRR15539824;37;40;0.540540540540541;17;20;0.0405405405405406;0.459459459459459
Control.SRR15539824;36;40;0.583333333333333;15;21;0.0833333333333334;0.416666666666667
Control.SRR15539824;44;40;0.386363636363636;27;17;0.113636363636364;0.386363636363636
Control.SRR15539824;40;40;0.45;22;18;0.05;0.45
Control.SRR15539824;38;40;0.526315789473684;18;20;0.0263157894736842;0.473684210526316
Control.SRR15539824;39;40;0.41025641025641;23;16;0.0897435897435898;0.41025641025641
Control.SRR15539824;39;40;0.487179487179487;20;19;0.0128205128205128;0.487179487179487
Control.SRR15539824;42;40;0.571428571428571;18;24;0.0714285714285714;0.428571428571429
Control.SRR15539824;36;40;0.5;18;18;0;0.5
Control.SRR15539824;37;40;0.540540540540541;17;20;0.0405405405405406;0.459459459459459
Control.SRR15539824;42;40;0.404761904761905;25;17;0.0952380952380952;0.404761904761905
Control.SRR15539824;45;40;0.6;18;27;0.1;0.4
Control.SRR15539824;44;40;0.590909090909091;18;26;0.0909090909090909;0.409090909090909
Control.SRR15539824;41;40;0.390243902439024;25;16;0.109756097560976;0.390243902439024
Control.SRR15539824;42;40;0.523809523809524;20;22;0.0238095238095238;0.476190476190476
Control.SRR15539824;38;40;0.552631578947368;17;21;0.0526315789473685;0.447368421052632
Control.SRR15539824;45;40;0.533333333333333;21;24;0.0333333333333333;0.466666666666667
Control.SRR15539824;36;40;0.638888888888889;13;23;0.138888888888889;0.361111111111111
Control.SRR15539824;35;40;0.485714285714286;18;17;0.0142857142857143;0.485714285714286
Control.SRR15539824;42;40;0.404761904761905;25;17;0.0952380952380952;0.404761904761905
Control.SRR15539824;39;40;0.564102564102564;17;22;0.0641025641025641;0.435897435897436
Control.SRR15539824;37;40;0.513513513513513;18;19;0.0135135135135135;0.486486486486487
Control.SRR15539824;38;40;0.578947368421053;16;22;0.0789473684210527;0.421052631578947
Control.SRR15539824;39;40;0.512820512820513;19;20;0.0128205128205128;0.487179487179487
Control.SRR15539824;44;40;0.568181818181818;19;25;0.0681818181818182;0.431818181818182
Control.SRR15539824;39;40;0.666666666666667;13;26;0.166666666666667;0.333333333333333
Control.SRR15539824;36;40;0.416666666666667;21;15;0.0833333333333333;0.416666666666667
Control.SRR15539824;41;40;0.48780487804878;21;20;0.0121951219512195;0.48780487804878
Control.SRR15539824;42;40;0.404761904761905;25;17;0.0952380952380952;0.404761904761905
Control.SRR15539824;35;40;0.314285714285714;24;11;0.185714285714286;0.314285714285714
Control.SRR15539824;38;40;0.368421052631579;24;14;0.131578947368421;0.368421052631579
Control.SRR15539824;42;40;0.476190476190476;22;20;0.0238095238095238;0.476190476190476
Control.SRR15539824;45;40;0.466666666666667;24;21;0.0333333333333333;0.466666666666667
Control.SRR15539824;44;40;0.386363636363636;27;17;0.113636363636364;0.386363636363636
Control.SRR15539824;36;40;0.694444444444444;11;25;0.194444444444444;0.305555555555556
Control.SRR15539824;41;40;0.48780487804878;21;20;0.0121951219512195;0.48780487804878
Control.SRR15539824;39;40;0.487179487179487;20;19;0.0128205128205128;0.487179487179487
Control.SRR15539824;42;40;0.404761904761905;25;17;0.0952380952380952;0.404761904761905
Control.SRR15539824;40;40;0.575;17;23;0.075;0.425
Control.SRR15539824;45;40;0.511111111111111;22;23;0.0111111111111111;0.488888888888889
Control.SRR15539824;35;40;0.457142857142857;19;16;0.0428571428571429;0.457142857142857
Control.SRR15539824;36;40;0.555555555555556;16;20;0.0555555555555556;0.444444444444444
Control.SRR15539824;43;40;0.534883720930233;20;23;0.0348837209302325;0.465116279069767
Control.SRR15539824;38;40;0.605263157894737;15;23;0.105263157894737;0.394736842105263
Control.SRR15539824;38;40;0.394736842105263;23;15;0.105263157894737;0.394736842105263
Control.SRR15539824;43;40;0.534883720930233;20;23;0.0348837209302325;0.465116279069767
Control.SRR15539824;40;40;0.425;23;17;0.075;0.425
Control.SRR15539824;43;40;0.534883720930233;20;23;0.0348837209302325;0.465116279069767
Control.SRR15539824;43;40;0.488372093023256;22;21;0.0116279069767442;0.488372093023256
Control.SRR15539824;37;40;0.405405405405405;22;15;0.0945945945945946;0.405405405405405
Control.SRR15539824;37;40;0.540540540540541;17;20;0.0405405405405406;0.459459459459459
Control.SRR15539824;45;40;0.6;18;27;0.1;0.4
Control.SRR15539824;39;40;0.692307692307692;12;27;0.192307692307692;0.307692307692308
Control.SRR15539824;39;40;0.487179487179487;20;19;0.0128205128205128;0.487179487179487
Control.SRR15539824;37;40;0.378378378378378;23;14;0.121621621621622;0.378378378378378
Control.SRR15539824;40;40;0.5;20;20;0;0.5
Control.SRR15539824;37;40;0.297297297297297;26;11;0.202702702702703;0.297297297297297
Control.SRR15539824;35;40;0.542857142857143;16;19;0.0428571428571428;0.457142857142857
Control.SRR15539824;35;40;0.6;14;21;0.1;0.4
Control.SRR15539824;40;40;0.425;23;17;0.075;0.425
Control.SRR15539824;45;40;0.555555555555556;20;25;0.0555555555555556;0.444444444444444
Control.SRR15539824;42;40;0.452380952380952;23;19;0.0476190476190476;0.452380952380952
Control.SRR15539824;36;40;0.666666666666667;12;24;0.166666666666667;0.333333333333333
Control.SRR15539824;45;40;0.533333333333333;21;24;0.0333333333333333;0.466666666666667
Control.SRR15539824;35;40;0.485714285714286;18;17;0.0142857142857143;0.485714285714286
Control.SRR15539824;40;40;0.475;21;19;0.025;0.475
Control.SRR15539824;39;40;0.564102564102564;17;22;0.0641025641025641;0.435897435897436
Control.SRR15539824;44;40;0.454545454545455;24;20;0.0454545454545455;0.454545454545455
Control.SRR15539824;37;40;0.702702702702703;11;26;0.202702702702703;0.297297297297297
Control.SRR15539824;40;40;0.625;15;25;0.125;0.375
Control.SRR15539824;44;40;0.454545454545455;24;20;0.0454545454545455;0.454545454545455
Control.SRR15539824;36;40;0.444444444444444;20;16;0.0555555555555556;0.444444444444444
Control.SRR15539824;44;40;0.522727272727273;21;23;0.0227272727272727;0.477272727272727
Control.SRR15539824;39;40;0.564102564102564;17;22;0.0641025641025641;0.435897435897436
Control.SRR15539824;38;40;0.526315789473684;18;20;0.0263157894736842;0.473684210526316
Control.SRR15539824;40;40;0.575;17;23;0.075;0.425
Control.SRR15539824;41;40;0.463414634146341;22;19;0.0365853658536585;0.463414634146341
Control.SRR15539824;41;40;0.658536585365854;14;27;0.158536585365854;0.341463414634146
Control.SRR15539824;44;40;0.477272727272727;23;21;0.0227272727272727;0.477272727272727
Control.SRR15539824;43;40;0.465116279069767;23;20;0.0348837209302326;0.465116279069767
Control.SRR15539824;37;40;0.405405405405405;22;15;0.0945945945945946;0.405405405405405
Control.SRR15539824;38;40;0.552631578947368;17;21;0.0526315789473685;0.447368421052632
Control.SRR15539824;35;40;0.571428571428571;15;20;0.0714285714285714;0.428571428571429
Control.SRR15539824;44;40;0.386363636363636;27;17;0.113636363636364;0.386363636363636
Control.SRR15539824;38;40;0.368421052631579;24;14;0.131578947368421;0.368421052631579
Control.SRR15539824;39;40;0.461538461538462;21;18;0.0384615384615384;0.461538461538462
Control.SRR15539824;45;40;0.488888888888889;23;22;0.0111111111111111;0.488888888888889
Control.SRR15539824;42;40;0.547619047619048;19;23;0.0476190476190477;0.452380952380952
Control.SRR15539824;44;40;0.454545454545455;24;20;0.0454545454545455;0.454545454545455
Control.SRR15539824;40;40;0.425;23;17;0.075;0.425
Control.SRR15539824;43;40;0.511627906976744;21;22;0.0116279069767442;0.488372093023256
Control.SRR15539824;42;40;0.428571428571429;24;18;0.0714285714285715;0.428571428571429
Control.SRR15539824;45;40;0.622222222222222;17;28;0.122222222222222;0.377777777777778
Control.SRR15539824;39;40;0.384615384615385;24;15;0.115384615384615;0.384615384615385
Control.SRR15539824;45;40;0.577777777777778;19;26;0.0777777777777777;0.422222222222222
Control.SRR15539824;42;40;0.380952380952381;26;16;0.119047619047619;0.380952380952381
Control.SRR15539824;36;40;0.472222222222222;19;17;0.0277777777777778;0.472222222222222
Control.SRR15539824;44;40;0.454545454545455;24;20;0.0454545454545455;0.454545454545455
Control.SRR15539824;41;40;0.463414634146341;22;19;0.0365853658536585;0.463414634146341
Control.SRR15539824;40;40;0.5;20;20;0;0.5
Control.SRR15539824;43;40;0.558139534883721;19;24;0.0581395348837209;0.441860465116279
Control.SRR15539824;44;40;0.613636363636364;17;27;0.113636363636364;0.386363636363636
Control.SRR15539824;36;40;0.527777777777778;17;19;0.0277777777777778;0.472222222222222
Control.SRR15539824;40;40;0.375;25;15;0.125;0.375
Control.SRR15539824;43;40;0.558139534883721;19;24;0.0581395348837209;0.441860465116279
Control.SRR15539824;35;40;0.4;21;14;0.1;0.4
Control.SRR15539824;37;40;0.459459459459459;20;17;0.0405405405405405;0.459459459459459
Control.SRR15539824;42;40;0.404761904761905;25;17;0.0952380952380952;0.404761904761905
Control.SRR15539824;36;40;0.527777777777778;17;19;0.0277777777777778;0.472222222222222
Control.SRR15539824;42;40;0.5;21;21;0;0.5
Control.SRR15539824;41;40;0.463414634146341;22;19;0.0365853658536585;0.463414634146341
Control.SRR15539824;44;40;0.454545454545455;24;20;0.0454545454545455;0.454545454545455
Control.SRR15539824;35;40;0.714285714285714;10;25;0.214285714285714;0.285714285714286
Control.SRR15539824;43;40;0.534883720930233;20;23;0.0348837209302325;0.465116279069767
Control.SRR15539824;39;40;0.538461538461538;18;21;0.0384615384615384;0.461538461538462
Control.SRR15539824;43;40;0.465116279069767;23;20;0.0348837209302326;0.465116279069767
Control.SRR15539824;38;40;0.447368421052632;21;17;0.0526315789473684;0.447368421052632
Control.SRR15539824;38;40;0.421052631578947;22;16;0.0789473684210527;0.421052631578947
Control.SRR15539824;43;40;0.604651162790698;17;26;0.104651162790698;0.395348837209302
Control.SRR15539824;45;40;0.422222222222222;26;19;0.0777777777777778;0.422222222222222
Control.SRR15539824;43;40;0.627906976744186;16;27;0.127906976744186;0.372093023255814
Control.SRR15539824;36;40;0.472222222222222;19;17;0.0277777777777778;0.472222222222222
Control.SRR15539824;42;40;0.595238095238095;17;25;0.0952380952380952;0.404761904761905
Control.SRR15539824;44;40;0.659090909090909;15;29;0.159090909090909;0.340909090909091
Control.SRR15539824;43;40;0.581395348837209;18;25;0.0813953488372093;0.418604651162791
Control.SRR15539824;39;40;0.461538461538462;21;18;0.0384615384615384;0.461538461538462
Control.SRR15539824;35;40;0.457142857142857;19;16;0.0428571428571429;0.457142857142857
Control.SRR15539824;35;40;0.4;21;14;0.1;0.4
Control.SRR15539824;40;40;0.475;21;19;0.025;0.475
Control.SRR15539824;35;40;0.457142857142857;19;16;0.0428571428571429;0.457142857142857
Control.SRR15539824;36;40;0.5;18;18;0;0.5
Control.SRR15539824;37;40;0.513513513513513;18;19;0.0135135135135135;0.486486486486487
Control.SRR15539824;41;40;0.463414634146341;22;19;0.0365853658536585;0.463414634146341
Control.SRR15539824;41;40;0.51219512195122;20;21;0.0121951219512195;0.48780487804878
Control.SRR15539824;39;40;0.615384615384615;15;24;0.115384615384615;0.384615384615385
Control.SRR15539824;42;40;0.452380952380952;23;19;0.0476190476190476;0.452380952380952
Control.SRR15539824;45;40;0.577777777777778;19;26;0.0777777777777777;0.422222222222222
Control.SRR15539824;43;40;0.441860465116279;24;19;0.0581395348837209;0.441860465116279
Control.SRR15539824;38;40;0.473684210526316;20;18;0.0263157894736842;0.473684210526316
Control.SRR15539824;41;40;0.560975609756098;18;23;0.0609756097560976;0.439024390243902
Control.SRR15539824;44;40;0.568181818181818;19;25;0.0681818181818182;0.431818181818182
Control.SRR15539824;40;40;0.45;22;18;0.05;0.45
Control.SRR15539824;39;40;0.487179487179487;20;19;0.0128205128205128;0.487179487179487
Control.SRR15539824;41;40;0.51219512195122;20;21;0.0121951219512195;0.48780487804878
Control.SRR15539824;45;40;0.466666666666667;24;21;0.0333333333333333;0.466666666666667
Control.SRR15539824;36;40;0.472222222222222;19;17;0.0277777777777778;0.472222222222222
Control.SRR15539824;38;40;0.605263157894737;15;23;0.105263157894737;0.394736842105263
Control.SRR15539824;45;40;0.4;27;18;0.1;0.4
Control.SRR15539824;44;40;0.5;22;22;0;0.5
Control.SRR15539824;41;40;0.536585365853659;19;22;0.0365853658536586;0.463414634146341
Control.SRR15539824;43;40;0.511627906976744;21;22;0.0116279069767442;0.488372093023256
Control.SRR15539824;41;40;0.609756097560976;16;25;0.109756097560976;0.390243902439024
Control.SRR15539824;37;40;0.621621621621622;14;23;0.121621621621622;0.378378378378378
Control.SRR15539824;41;40;0.560975609756098;18;23;0.0609756097560976;0.439024390243902
Control.SRR15539824;45;40;0.466666666666667;24;21;0.0333333333333333;0.466666666666667
Control.SRR15539824;36;40;0.472222222222222;19;17;0.0277777777777778;0.472222222222222
Control.SRR15539824;39;40;0.41025641025641;23;16;0.0897435897435898;0.41025641025641
Control.SRR15539824;38;40;0.526315789473684;18;20;0.0263157894736842;0.473684210526316
Control.SRR15539824;41;40;0.51219512195122;20;21;0.0121951219512195;0.48780487804878
Control.SRR15539824;38;40;0.552631578947368;17;21;0.0526315789473685;0.447368421052632
Control.SRR15539824;43;40;0.488372093023256;22;21;0.0116279069767442;0.488372093023256
Control.SRR15539824;42;40;0.619047619047619;16;26;0.119047619047619;0.380952380952381
Control.SRR15539824;39;40;0.564102564102564;17;22;0.0641025641025641;0.435897435897436
Control.SRR15539824;43;40;0.418604651162791;25;18;0.0813953488372093;0.418604651162791
Control.SRR15539824;37;40;0.567567567567568;16;21;0.0675675675675675;0.432432432432432
Control.SRR15539824;40;40;0.475;21;19;0.025;0.475
Control.SRR15539824;38;40;0.552631578947368;17;21;0.0526315789473685;0.447368421052632
Control.SRR15539824;40;40;0.525;19;21;0.025;0.475
Control.SRR15539824;37;40;0.513513513513513;18;19;0.0135135135135135;0.486486486486487
Control.SRR15539824;40;40;0.525;19;21;0.025;0.475
Control.SRR15539824;39;40;0.615384615384615;15;24;0.115384615384615;0.384615384615385
Control.SRR15539824;42;40;0.5;21;21;0;0.5
Control.SRR15539824;44;40;0.613636363636364;17;27;0.113636363636364;0.386363636363636
Control.SRR15539824;39;40;0.538461538461538;18;21;0.0384615384615384;0.461538461538462
Control.SRR15539824;38;40;0.421052631578947;22;16;0.0789473684210527;0.421052631578947
Control.SRR15539824;37;40;0.621621621621622;14;23;0.121621621621622;0.378378378378378
Control.SRR15539824;45;40;0.622222222222222;17;28;0.122222222222222;0.377777777777778
Control.SRR15539824;41;40;0.658536585365854;14;27;0.158536585365854;0.341463414634146
Control.SRR15539824;38;40;0.631578947368421;14;24;0.131578947368421;0.368421052631579
Control.SRR15539824;35;40;0.4;21;14;0.1;0.4
Control.SRR15539824;40;40;0.55;18;22;0.05;0.45
Control.SRR15539824;43;40;0.441860465116279;24;19;0.0581395348837209;0.441860465116279
Control.SRR15539824;42;40;0.523809523809524;20;22;0.0238095238095238;0.476190476190476
Control.SRR15539824;37;40;0.540540540540541;17;20;0.0405405405405406;0.459459459459459
Control.SRR15539824;35;40;0.542857142857143;16;19;0.0428571428571428;0.457142857142857
Control.SRR15539824;37;40;0.459459459459459;20;17;0.0405405405405405;0.459459459459459
Control.SRR15539824;45;40;0.622222222222222;17;28;0.122222222222222;0.377777777777778
Control.SRR15539824;39;40;0.435897435897436;22;17;0.0641025641025641;0.435897435897436
Control.SRR15539824;45;40;0.622222222222222;17;28;0.122222222222222;0.377777777777778
Control.SRR15539824;44;40;0.409090909090909;26;18;0.0909090909090909;0.409090909090909
Control.SRR15539824;37;40;0.405405405405405;22;15;0.0945945945945946;0.405405405405405
Control.SRR15539824;37;40;0.486486486486487;19;18;0.0135135135135135;0.486486486486487
Control.SRR15539824;39;40;0.41025641025641;23;16;0.0897435897435898;0.41025641025641
Control.SRR15539824;39;40;0.487179487179487;20;19;0.0128205128205128;0.487179487179487
Control.SRR15539824;35;40;0.2;28;7;0.3;0.2
Control.SRR15539824;41;40;0.48780487804878;21;20;0.0121951219512195;0.48780487804878
Control.SRR15539824;38;40;0.394736842105263;23;15;0.105263157894737;0.394736842105263
Control.SRR15539824;44;40;0.454545454545455;24;20;0.0454545454545455;0.454545454545455
Control.SRR15539824;44;40;0.5;22;22;0;0.5
Control.SRR15539824;41;40;0.463414634146341;22;19;0.0365853658536585;0.463414634146341
Control.SRR15539824;41;40;0.560975609756098;18;23;0.0609756097560976;0.439024390243902
Control.SRR15539824;35;40;0.542857142857143;16;19;0.0428571428571428;0.457142857142857
Control.SRR15539824;35;40;0.6;14;21;0.1;0.4
Control.SRR15539824;44;40;0.545454545454545;20;24;0.0454545454545454;0.454545454545455
Control.SRR15539824;41;40;0.609756097560976;16;25;0.109756097560976;0.390243902439024
Control.SRR15539824;42;40;0.5;21;21;0;0.5
Control.SRR15539824;36;40;0.5;18;18;0;0.5
Control.SRR15539824;45;40;0.466666666666667;24;21;0.0333333333333333;0.466666666666667
Control.SRR15539824;38;40;0.394736842105263;23;15;0.105263157894737;0.394736842105263
Control.SRR15539824;44;40;0.5;22;22;0;0.5
Control.SRR15539824;40;40;0.575;17;23;0.075;0.425
Control.SRR15539824;38;40;0.578947368421053;16;22;0.0789473684210527;0.421052631578947
Control.SRR15539824;44;40;0.568181818181818;19;25;0.0681818181818182;0.431818181818182
Control.SRR15539824;36;40;0.555555555555556;16;20;0.0555555555555556;0.444444444444444
Control.SRR15539824;35;40;0.342857142857143;23;12;0.157142857142857;0.342857142857143
Control.SRR15539824;44;40;0.545454545454545;20;24;0.0454545454545454;0.454545454545455
Control.SRR15539824;44;40;0.363636363636364;28;16;0.136363636363636;0.363636363636364
Control.SRR15539824;39;40;0.461538461538462;21;18;0.0384615384615384;0.461538461538462
Control.SRR15539824;34;40;0.5;17;17;0;0.5
Control.SRR15539824;38;40;0.578947368421053;16;22;0.0789473684210527;0.421052631578947
Control.SRR15539824;38;40;0.342105263157895;25;13;0.157894736842105;0.342105263157895
Control.SRR15539824;44;40;0.522727272727273;21;23;0.0227272727272727;0.477272727272727
Control.SRR15539824;35;40;0.542857142857143;16;19;0.0428571428571428;0.457142857142857
Control.SRR15539824;40;40;0.55;18;22;0.05;0.45
Control.SRR15539824;39;40;0.435897435897436;22;17;0.0641025641025641;0.435897435897436
Control.SRR15539824;35;40;0.428571428571429;20;15;0.0714285714285715;0.428571428571429
Control.SRR15539824;44;40;0.454545454545455;24;20;0.0454545454545455;0.454545454545455
Control.SRR15539824;37;40;0.513513513513513;18;19;0.0135135135135135;0.486486486486487
Control.SRR15539824;44;40;0.522727272727273;21;23;0.0227272727272727;0.477272727272727
Control.SRR15539824;34;40;0.470588235294118;18;16;0.0294117647058824;0.470588235294118
Control.SRR15539824;34;40;0.5;17;17;0;0.5
Control.SRR15539824;37;40;0.540540540540541;17;20;0.0405405405405406;0.459459459459459
Control.SRR15539824;41;40;0.536585365853659;19;22;0.0365853658536586;0.463414634146341
Control.SRR15539824;42;40;0.5;21;21;0;0.5
Control.SRR15539824;43;40;0.511627906976744;21;22;0.0116279069767442;0.488372093023256
Control.SRR15539824;41;40;0.365853658536585;26;15;0.134146341463415;0.365853658536585
Control.SRR15539824;41;40;0.536585365853659;19;22;0.0365853658536586;0.463414634146341
Control.SRR15539824;41;40;0.682926829268293;13;28;0.182926829268293;0.317073170731707
Control.SRR15539824;40;40;0.475;21;19;0.025;0.475
Control.SRR15539824;43;40;0.511627906976744;21;22;0.0116279069767442;0.488372093023256
Control.SRR15539824;41;40;0.439024390243902;23;18;0.0609756097560976;0.439024390243902
Control.SRR15539824;36;40;0.5;18;18;0;0.5
Control.SRR15539824;36;40;0.444444444444444;20;16;0.0555555555555556;0.444444444444444
Control.SRR15539824;35;40;0.4;21;14;0.1;0.4
Control.SRR15539824;34;40;0.382352941176471;21;13;0.117647058823529;0.382352941176471
Control.SRR15539824;35;40;0.4;21;14;0.1;0.4
Control.SRR15539824;37;40;0.405405405405405;22;15;0.0945945945945946;0.405405405405405
Control.SRR15539824;41;40;0.536585365853659;19;22;0.0365853658536586;0.463414634146341
Control.SRR15539824;40;40;0.525;19;21;0.025;0.475
Control.SRR15539824;42;40;0.595238095238095;17;25;0.0952380952380952;0.404761904761905
Control.SRR15539824;43;40;0.488372093023256;22;21;0.0116279069767442;0.488372093023256
Control.SRR15539824;42;40;0.571428571428571;18;24;0.0714285714285714;0.428571428571429
Control.SRR15539824;34;40;0.558823529411765;15;19;0.0588235294117647;0.441176470588235
Control.SRR15539824;37;40;0.432432432432432;21;16;0.0675675675675675;0.432432432432432
Control.SRR15539824;40;40;0.4;24;16;0.1;0.4
Control.SRR15539824;41;40;0.51219512195122;20;21;0.0121951219512195;0.48780487804878
Control.SRR15539824;40;40;0.525;19;21;0.025;0.475
Control.SRR15539824;34;40;0.558823529411765;15;19;0.0588235294117647;0.441176470588235
Control.SRR15539824;34;40;0.411764705882353;20;14;0.0882352941176471;0.411764705882353
Control.SRR15539824;37;40;0.648648648648649;13;24;0.148648648648649;0.351351351351351
Control.SRR15539824;44;40;0.545454545454545;20;24;0.0454545454545454;0.454545454545455
Control.SRR15539824;38;40;0.552631578947368;17;21;0.0526315789473685;0.447368421052632
Control.SRR15539824;39;40;0.461538461538462;21;18;0.0384615384615384;0.461538461538462
Control.SRR15539824;35;40;0.4;21;14;0.1;0.4
Control.SRR15539824;44;40;0.568181818181818;19;25;0.0681818181818182;0.431818181818182
Control.SRR15539824;43;40;0.441860465116279;24;19;0.0581395348837209;0.441860465116279
Control.SRR15539824;40;40;0.425;23;17;0.075;0.425
Control.SRR15539824;39;40;0.461538461538462;21;18;0.0384615384615384;0.461538461538462
Control.SRR15539824;42;40;0.476190476190476;22;20;0.0238095238095238;0.476190476190476
Control.SRR15539824;37;40;0.405405405405405;22;15;0.0945945945945946;0.405405405405405
Control.SRR15539824;38;40;0.368421052631579;24;14;0.131578947368421;0.368421052631579
Control.SRR15539824;38;40;0.5;19;19;0;0.5
Control.SRR15539824;39;40;0.564102564102564;17;22;0.0641025641025641;0.435897435897436
Control.SRR15539824;37;40;0.567567567567568;16;21;0.0675675675675675;0.432432432432432
Control.SRR15539824;35;40;0.457142857142857;19;16;0.0428571428571429;0.457142857142857
Control.SRR15539824;35;40;0.485714285714286;18;17;0.0142857142857143;0.485714285714286
Control.SRR15539824;42;40;0.5;21;21;0;0.5
Control.SRR15539824;41;40;0.536585365853659;19;22;0.0365853658536586;0.463414634146341
Control.SRR15539824;41;40;0.536585365853659;19;22;0.0365853658536586;0.463414634146341
Control.SRR15539824;35;40;0.457142857142857;19;16;0.0428571428571429;0.457142857142857
Control.SRR15539824;41;40;0.51219512195122;20;21;0.0121951219512195;0.48780487804878
Control.SRR15539824;40;40;0.45;22;18;0.05;0.45
Control.SRR15539824;36;40;0.472222222222222;19;17;0.0277777777777778;0.472222222222222
Control.SRR15539824;43;40;0.488372093023256;22;21;0.0116279069767442;0.488372093023256
Control.SRR15539824;41;40;0.634146341463415;15;26;0.134146341463415;0.365853658536585
Control.SRR15539824;36;40;0.5;18;18;0;0.5
Control.SRR15539824;39;40;0.333333333333333;26;13;0.166666666666667;0.333333333333333
Control.SRR15539824;38;40;0.5;19;19;0;0.5
Control.SRR15539824;40;40;0.6;16;24;0.1;0.4
Control.SRR15539824;35;40;0.571428571428571;15;20;0.0714285714285714;0.428571428571429
Control.SRR15539824;35;40;0.457142857142857;19;16;0.0428571428571429;0.457142857142857
Control.SRR15539824;38;40;0.394736842105263;23;15;0.105263157894737;0.394736842105263
Control.SRR15539824;34;40;0.382352941176471;21;13;0.117647058823529;0.382352941176471
Control.SRR15539824;36;40;0.611111111111111;14;22;0.111111111111111;0.388888888888889
Control.SRR15539824;36;40;0.583333333333333;15;21;0.0833333333333334;0.416666666666667
Control.SRR15539824;43;40;0.418604651162791;25;18;0.0813953488372093;0.418604651162791
Control.SRR15539824;41;40;0.317073170731707;28;13;0.182926829268293;0.317073170731707
Control.SRR15539824;39;40;0.461538461538462;21;18;0.0384615384615384;0.461538461538462
Control.SRR15539824;41;40;0.48780487804878;21;20;0.0121951219512195;0.48780487804878
Control.SRR15539824;35;40;0.342857142857143;23;12;0.157142857142857;0.342857142857143
Control.SRR15539824;42;40;0.428571428571429;24;18;0.0714285714285715;0.428571428571429
Control.SRR15539824;39;40;0.41025641025641;23;16;0.0897435897435898;0.41025641025641
Control.SRR15539824;35;40;0.542857142857143;16;19;0.0428571428571428;0.457142857142857
Control.SRR15539824;35;40;0.485714285714286;18;17;0.0142857142857143;0.485714285714286
Control.SRR15539824;42;40;0.5;21;21;0;0.5
Control.SRR15539824;34;40;0.470588235294118;18;16;0.0294117647058824;0.470588235294118
Control.SRR15539824;36;40;0.555555555555556;16;20;0.0555555555555556;0.444444444444444
Control.SRR15539824;36;40;0.444444444444444;20;16;0.0555555555555556;0.444444444444444
Control.SRR15539824;44;40;0.522727272727273;21;23;0.0227272727272727;0.477272727272727
Control.SRR15539824;44;40;0.5;22;22;0;0.5
Control.SRR15539824;38;40;0.684210526315789;12;26;0.184210526315789;0.315789473684211
Control.SRR15539824;41;40;0.536585365853659;19;22;0.0365853658536586;0.463414634146341
Control.SRR15539824;40;40;0.425;23;17;0.075;0.425
Control.SRR15539824;41;40;0.439024390243902;23;18;0.0609756097560976;0.439024390243902
Control.SRR15539824;35;40;0.514285714285714;17;18;0.0142857142857142;0.485714285714286
Control.SRR15539824;40;40;0.5;20;20;0;0.5
Control.SRR15539824;38;40;0.342105263157895;25;13;0.157894736842105;0.342105263157895
Control.SRR15539824;40;40;0.45;22;18;0.05;0.45
Control.SRR15539824;39;40;0.666666666666667;13;26;0.166666666666667;0.333333333333333
Control.SRR15539824;43;40;0.441860465116279;24;19;0.0581395348837209;0.441860465116279
Control.SRR15539824;34;40;0.676470588235294;11;23;0.176470588235294;0.323529411764706
Control.SRR15539824;43;40;0.465116279069767;23;20;0.0348837209302326;0.465116279069767
Control.SRR15539824;44;40;0.5;22;22;0;0.5
Control.SRR15539824;42;40;0.476190476190476;22;20;0.0238095238095238;0.476190476190476
Control.SRR15539824;36;40;0.472222222222222;19;17;0.0277777777777778;0.472222222222222
Control.SRR15539824;36;40;0.5;18;18;0;0.5
Control.SRR15539824;39;40;0.461538461538462;21;18;0.0384615384615384;0.461538461538462
Control.SRR15539824;42;40;0.619047619047619;16;26;0.119047619047619;0.380952380952381
Control.SRR15539824;40;40;0.65;14;26;0.15;0.35
Control.SRR15539824;35;40;0.514285714285714;17;18;0.0142857142857142;0.485714285714286
Control.SRR15539824;34;40;0.382352941176471;21;13;0.117647058823529;0.382352941176471
Control.SRR15539824;42;40;0.404761904761905;25;17;0.0952380952380952;0.404761904761905
Control.SRR15539824;37;40;0.432432432432432;21;16;0.0675675675675675;0.432432432432432
Control.SRR15539824;36;40;0.361111111111111;23;13;0.138888888888889;0.361111111111111
Control.SRR15539824;39;40;0.461538461538462;21;18;0.0384615384615384;0.461538461538462
Control.SRR15539824;41;40;0.51219512195122;20;21;0.0121951219512195;0.48780487804878
Control.SRR15539824;36;40;0.583333333333333;15;21;0.0833333333333334;0.416666666666667
Control.SRR15539824;38;40;0.605263157894737;15;23;0.105263157894737;0.394736842105263
Control.SRR15539824;36;40;0.555555555555556;16;20;0.0555555555555556;0.444444444444444
Control.SRR15539824;35;40;0.457142857142857;19;16;0.0428571428571429;0.457142857142857
Control.SRR15539824;36;40;0.583333333333333;15;21;0.0833333333333334;0.416666666666667
Control.SRR15539824;35;40;0.514285714285714;17;18;0.0142857142857142;0.485714285714286
Control.SRR15539824;40;40;0.4;24;16;0.1;0.4
Control.SRR15539824;42;40;0.547619047619048;19;23;0.0476190476190477;0.452380952380952
Control.SRR15539824;38;40;0.631578947368421;14;24;0.131578947368421;0.368421052631579
Control.SRR15539824;36;40;0.444444444444444;20;16;0.0555555555555556;0.444444444444444
Control.SRR15539824;39;40;0.435897435897436;22;17;0.0641025641025641;0.435897435897436
Control.SRR15539824;41;40;0.536585365853659;19;22;0.0365853658536586;0.463414634146341
Control.SRR15539824;37;40;0.351351351351351;24;13;0.148648648648649;0.351351351351351
Control.SRR15539824;37;40;0.594594594594595;15;22;0.0945945945945946;0.405405405405405
Control.SRR15539824;42;40;0.476190476190476;22;20;0.0238095238095238;0.476190476190476
Control.SRR15539824;43;40;0.511627906976744;21;22;0.0116279069767442;0.488372093023256
Control.SRR15539824;42;40;0.476190476190476;22;20;0.0238095238095238;0.476190476190476
Control.SRR15539824;36;40;0.555555555555556;16;20;0.0555555555555556;0.444444444444444
Control.SRR15539824;42;40;0.523809523809524;20;22;0.0238095238095238;0.476190476190476
Control.SRR15539824;42;40;0.523809523809524;20;22;0.0238095238095238;0.476190476190476
Control.SRR15539824;34;40;0.5;17;17;0;0.5
Control.SRR15539824;43;40;0.418604651162791;25;18;0.0813953488372093;0.418604651162791
Control.SRR15539824;40;40;0.375;25;15;0.125;0.375
Control.SRR15539824;43;40;0.534883720930233;20;23;0.0348837209302325;0.465116279069767
Control.SRR15539824;40;40;0.675;13;27;0.175;0.325
Control.SRR15539824;39;40;0.512820512820513;19;20;0.0128205128205128;0.487179487179487
Control.SRR15539824;38;40;0.5;19;19;0;0.5
Control.SRR15539824;37;40;0.459459459459459;20;17;0.0405405405405405;0.459459459459459
Control.SRR15539824;39;40;0.538461538461538;18;21;0.0384615384615384;0.461538461538462
Control.SRR15539824;42;40;0.571428571428571;18;24;0.0714285714285714;0.428571428571429
Control.SRR15539824;37;40;0.405405405405405;22;15;0.0945945945945946;0.405405405405405
Control.SRR15539824;43;40;0.465116279069767;23;20;0.0348837209302326;0.465116279069767
Control.SRR15539824;41;40;0.48780487804878;21;20;0.0121951219512195;0.48780487804878
Control.SRR15539824;44;40;0.340909090909091;29;15;0.159090909090909;0.340909090909091
Control.SRR15539824;43;40;0.558139534883721;19;24;0.0581395348837209;0.441860465116279
Control.SRR15539824;42;40;0.642857142857143;15;27;0.142857142857143;0.357142857142857
Control.SRR15539824;44;40;0.477272727272727;23;21;0.0227272727272727;0.477272727272727
Control.SRR15539824;34;40;0.529411764705882;16;18;0.0294117647058824;0.470588235294118
Control.SRR15539824;38;40;0.5;19;19;0;0.5
Control.SRR15539824;36;40;0.388888888888889;22;14;0.111111111111111;0.388888888888889
Control.SRR15539824;41;40;0.51219512195122;20;21;0.0121951219512195;0.48780487804878
Control.SRR15539824;38;40;0.5;19;19;0;0.5
Control.SRR15539824;36;40;0.527777777777778;17;19;0.0277777777777778;0.472222222222222
Control.SRR15539824;44;40;0.5;22;22;0;0.5
Control.SRR15539824;40;40;0.55;18;22;0.05;0.45
Control.SRR15539824;39;40;0.564102564102564;17;22;0.0641025641025641;0.435897435897436
Control.SRR15539824;43;40;0.465116279069767;23;20;0.0348837209302326;0.465116279069767
Control.SRR15539824;42;40;0.404761904761905;25;17;0.0952380952380952;0.404761904761905
Control.SRR15539824;41;40;0.536585365853659;19;22;0.0365853658536586;0.463414634146341
Control.SRR15539824;37;40;0.621621621621622;14;23;0.121621621621622;0.378378378378378
Control.SRR15539824;44;40;0.545454545454545;20;24;0.0454545454545454;0.454545454545455
Control.SRR15539824;35;40;0.514285714285714;17;18;0.0142857142857142;0.485714285714286
Control.SRR15539824;38;40;0.657894736842105;13;25;0.157894736842105;0.342105263157895
Control.SRR15539824;35;40;0.514285714285714;17;18;0.0142857142857142;0.485714285714286
Control.SRR15539824;36;40;0.361111111111111;23;13;0.138888888888889;0.361111111111111
Control.SRR15539824;40;40;0.45;22;18;0.05;0.45
Control.SRR15539824;41;40;0.682926829268293;13;28;0.182926829268293;0.317073170731707
Control.SRR15539824;39;40;0.358974358974359;25;14;0.141025641025641;0.358974358974359
Control.SRR15539824;35;40;0.514285714285714;17;18;0.0142857142857142;0.485714285714286
Control.SRR15539824;43;40;0.581395348837209;18;25;0.0813953488372093;0.418604651162791
Control.SRR15539824;43;40;0.581395348837209;18;25;0.0813953488372093;0.418604651162791
Control.SRR15539824;41;40;0.658536585365854;14;27;0.158536585365854;0.341463414634146
Control.SRR15539824;42;40;0.523809523809524;20;22;0.0238095238095238;0.476190476190476
Control.SRR15539824;35;40;0.4;21;14;0.1;0.4
Control.SRR15539824;36;40;0.555555555555556;16;20;0.0555555555555556;0.444444444444444
Control.SRR15539824;38;40;0.421052631578947;22;16;0.0789473684210527;0.421052631578947
Control.SRR15539824;44;40;0.409090909090909;26;18;0.0909090909090909;0.409090909090909
Control.SRR15539824;37;40;0.486486486486487;19;18;0.0135135135135135;0.486486486486487
Control.SRR15539824;42;40;0.476190476190476;22;20;0.0238095238095238;0.476190476190476
Control.SRR15539824;42;40;0.476190476190476;22;20;0.0238095238095238;0.476190476190476
Control.SRR15539824;36;40;0.472222222222222;19;17;0.0277777777777778;0.472222222222222
Control.SRR15539824;40;40;0.4;24;16;0.1;0.4
Control.SRR15539824;43;40;0.465116279069767;23;20;0.0348837209302326;0.465116279069767
Control.SRR15539824;39;40;0.564102564102564;17;22;0.0641025641025641;0.435897435897436
Control.SRR15539824;37;40;0.405405405405405;22;15;0.0945945945945946;0.405405405405405
Control.SRR15539824;34;40;0.676470588235294;11;23;0.176470588235294;0.323529411764706
Control.SRR15539824;36;40;0.361111111111111;23;13;0.138888888888889;0.361111111111111
Control.SRR15539824;40;40;0.45;22;18;0.05;0.45
Control.SRR15539824;44;40;0.522727272727273;21;23;0.0227272727272727;0.477272727272727
Control.SRR15539824;34;40;0.5;17;17;0;0.5
Control.SRR15539824;38;40;0.5;19;19;0;0.5
Control.SRR15539824;35;40;0.514285714285714;17;18;0.0142857142857142;0.485714285714286
Control.SRR15539824;41;40;0.634146341463415;15;26;0.134146341463415;0.365853658536585
Control.SRR15539824;43;40;0.488372093023256;22;21;0.0116279069767442;0.488372093023256
Control.SRR15539824;37;40;0.540540540540541;17;20;0.0405405405405406;0.459459459459459
Control.SRR15539824;42;40;0.547619047619048;19;23;0.0476190476190477;0.452380952380952
Control.SRR15539824;38;40;0.552631578947368;17;21;0.0526315789473685;0.447368421052632
Control.SRR15539824;41;40;0.560975609756098;18;23;0.0609756097560976;0.439024390243902
Control.SRR15539824;39;40;0.512820512820513;19;20;0.0128205128205128;0.487179487179487
Control.SRR15539824;36;40;0.361111111111111;23;13;0.138888888888889;0.361111111111111
Control.SRR15539824;38;40;0.473684210526316;20;18;0.0263157894736842;0.473684210526316
Control.SRR15539824;36;40;0.694444444444444;11;25;0.194444444444444;0.305555555555556
Control.SRR15539824;35;40;0.657142857142857;12;23;0.157142857142857;0.342857142857143
Control.SRR15539824;40;40;0.5;20;20;0;0.5
Control.SRR15539824;34;40;0.382352941176471;21;13;0.117647058823529;0.382352941176471
Control.SRR15539824;40;40;0.475;21;19;0.025;0.475
Control.SRR15539824;43;40;0.581395348837209;18;25;0.0813953488372093;0.418604651162791
Control.SRR15539824;43;40;0.627906976744186;16;27;0.127906976744186;0.372093023255814
Control.SRR15539824;44;40;0.318181818181818;30;14;0.181818181818182;0.318181818181818
Control.SRR15539824;35;40;0.514285714285714;17;18;0.0142857142857142;0.485714285714286
Control.SRR15539824;39;40;0.666666666666667;13;26;0.166666666666667;0.333333333333333
Control.SRR15539824;44;40;0.613636363636364;17;27;0.113636363636364;0.386363636363636
Control.SRR15539824;36;40;0.555555555555556;16;20;0.0555555555555556;0.444444444444444
Control.SRR15539824;35;40;0.371428571428571;22;13;0.128571428571429;0.371428571428571
Control.SRR15539824;35;40;0.657142857142857;12;23;0.157142857142857;0.342857142857143
Control.SRR15539824;40;40;0.325;27;13;0.175;0.325
Control.SRR15539824;43;40;0.488372093023256;22;21;0.0116279069767442;0.488372093023256
Control.SRR15539824;44;40;0.568181818181818;19;25;0.0681818181818182;0.431818181818182
Control.SRR15539824;36;40;0.444444444444444;20;16;0.0555555555555556;0.444444444444444
Control.SRR15539824;34;40;0.470588235294118;18;16;0.0294117647058824;0.470588235294118
Control.SRR15539824;41;40;0.609756097560976;16;25;0.109756097560976;0.390243902439024
Control.SRR15539824;35;40;0.571428571428571;15;20;0.0714285714285714;0.428571428571429
Control.SRR15539824;44;40;0.613636363636364;17;27;0.113636363636364;0.386363636363636
Control.SRR15539824;41;40;0.414634146341463;24;17;0.0853658536585366;0.414634146341463
Control.SRR15539824;37;40;0.459459459459459;20;17;0.0405405405405405;0.459459459459459
Control.SRR15539824;40;40;0.525;19;21;0.025;0.475
Control.SRR15539824;35;40;0.485714285714286;18;17;0.0142857142857143;0.485714285714286
Control.SRR15539824;36;40;0.416666666666667;21;15;0.0833333333333333;0.416666666666667
Control.SRR15539824;41;40;0.463414634146341;22;19;0.0365853658536585;0.463414634146341
Control.SRR15539824;43;40;0.441860465116279;24;19;0.0581395348837209;0.441860465116279
Control.SRR15539824;44;40;0.431818181818182;25;19;0.0681818181818182;0.431818181818182
Control.SRR15539824;37;40;0.459459459459459;20;17;0.0405405405405405;0.459459459459459
Control.SRR15539824;44;40;0.431818181818182;25;19;0.0681818181818182;0.431818181818182
Control.SRR15539824;35;40;0.485714285714286;18;17;0.0142857142857143;0.485714285714286
Control.SRR15539824;42;40;0.476190476190476;22;20;0.0238095238095238;0.476190476190476
Control.SRR15539824;43;40;0.465116279069767;23;20;0.0348837209302326;0.465116279069767
Control.SRR15539824;41;40;0.48780487804878;21;20;0.0121951219512195;0.48780487804878
Control.SRR15539824;35;40;0.542857142857143;16;19;0.0428571428571428;0.457142857142857
Control.SRR15539824;43;40;0.372093023255814;27;16;0.127906976744186;0.372093023255814
Control.SRR15539824;40;40;0.55;18;22;0.05;0.45
Control.SRR15539824;40;40;0.525;19;21;0.025;0.475
Control.SRR15539824;36;40;0.583333333333333;15;21;0.0833333333333334;0.416666666666667
Control.SRR15539824;41;40;0.51219512195122;20;21;0.0121951219512195;0.48780487804878
Control.SRR15539824;35;40;0.457142857142857;19;16;0.0428571428571429;0.457142857142857
Control.SRR15539824;44;40;0.431818181818182;25;19;0.0681818181818182;0.431818181818182
Control.SRR15539824;44;40;0.431818181818182;25;19;0.0681818181818182;0.431818181818182
Control.SRR15539824;44;40;0.522727272727273;21;23;0.0227272727272727;0.477272727272727
Control.SRR15539824;43;40;0.581395348837209;18;25;0.0813953488372093;0.418604651162791
Control.SRR15539824;42;40;0.595238095238095;17;25;0.0952380952380952;0.404761904761905
Control.SRR15539824;37;40;0.513513513513513;18;19;0.0135135135135135;0.486486486486487
Control.SRR15539824;37;40;0.540540540540541;17;20;0.0405405405405406;0.459459459459459
Control.SRR15539824;44;40;0.590909090909091;18;26;0.0909090909090909;0.409090909090909
Control.SRR15539824;35;40;0.514285714285714;17;18;0.0142857142857142;0.485714285714286
Control.SRR15539824;34;40;0.441176470588235;19;15;0.0588235294117647;0.441176470588235
Control.SRR15539824;39;40;0.384615384615385;24;15;0.115384615384615;0.384615384615385
Control.SRR15539824;42;40;0.476190476190476;22;20;0.0238095238095238;0.476190476190476
Control.SRR15539824;42;40;0.428571428571429;24;18;0.0714285714285715;0.428571428571429
Control.SRR15539824;37;40;0.459459459459459;20;17;0.0405405405405405;0.459459459459459
Control.SRR15539824;36;40;0.527777777777778;17;19;0.0277777777777778;0.472222222222222
Control.SRR15539824;36;40;0.5;18;18;0;0.5
Control.SRR15539824;38;40;0.526315789473684;18;20;0.0263157894736842;0.473684210526316
Control.SRR15539824;36;40;0.583333333333333;15;21;0.0833333333333334;0.416666666666667
Control.SRR15539824;43;40;0.534883720930233;20;23;0.0348837209302325;0.465116279069767
Control.SRR15539824;34;40;0.529411764705882;16;18;0.0294117647058824;0.470588235294118
Control.SRR15539824;35;40;0.514285714285714;17;18;0.0142857142857142;0.485714285714286
Control.SRR15539824;37;40;0.432432432432432;21;16;0.0675675675675675;0.432432432432432
Control.SRR15539824;34;40;0.411764705882353;20;14;0.0882352941176471;0.411764705882353
Control.SRR15539824;35;40;0.6;14;21;0.1;0.4
Control.SRR15539824;43;40;0.441860465116279;24;19;0.0581395348837209;0.441860465116279
Control.SRR15539824;36;40;0.472222222222222;19;17;0.0277777777777778;0.472222222222222
Control.SRR15539824;35;40;0.428571428571429;20;15;0.0714285714285715;0.428571428571429
Control.SRR15539824;41;40;0.365853658536585;26;15;0.134146341463415;0.365853658536585
Control.SRR15539824;44;40;0.568181818181818;19;25;0.0681818181818182;0.431818181818182
Control.SRR15539824;41;40;0.48780487804878;21;20;0.0121951219512195;0.48780487804878
Control.SRR15539824;42;40;0.5;21;21;0;0.5
Control.SRR15539824;37;40;0.675675675675676;12;25;0.175675675675676;0.324324324324324
Control.SRR15539824;39;40;0.358974358974359;25;14;0.141025641025641;0.358974358974359
Control.SRR15539824;34;40;0.5;17;17;0;0.5
Control.SRR15539824;41;40;0.585365853658537;17;24;0.0853658536585366;0.414634146341463
Control.SRR15539824;36;40;0.583333333333333;15;21;0.0833333333333334;0.416666666666667
Control.SRR15539824;35;40;0.485714285714286;18;17;0.0142857142857143;0.485714285714286
Control.SRR15539824;41;40;0.439024390243902;23;18;0.0609756097560976;0.439024390243902
Control.SRR15539824;44;40;0.454545454545455;24;20;0.0454545454545455;0.454545454545455
Control.SRR15539824;37;40;0.486486486486487;19;18;0.0135135135135135;0.486486486486487
Control.SRR15539824;41;40;0.390243902439024;25;16;0.109756097560976;0.390243902439024
Control.SRR15539824;36;40;0.583333333333333;15;21;0.0833333333333334;0.416666666666667
Control.SRR15539824;40;40;0.7;12;28;0.2;0.3
Control.SRR15539824;35;40;0.457142857142857;19;16;0.0428571428571429;0.457142857142857
Control.SRR15539824;37;40;0.594594594594595;15;22;0.0945945945945946;0.405405405405405
Control.SRR15539824;42;40;0.5;21;21;0;0.5
Control.SRR15539824;44;40;0.568181818181818;19;25;0.0681818181818182;0.431818181818182
Control.SRR15539824;39;40;0.435897435897436;22;17;0.0641025641025641;0.435897435897436
Control.SRR15539824;42;40;0.619047619047619;16;26;0.119047619047619;0.380952380952381
Control.SRR15539824;43;40;0.488372093023256;22;21;0.0116279069767442;0.488372093023256
Control.SRR15539824;36;40;0.361111111111111;23;13;0.138888888888889;0.361111111111111
Control.SRR15539824;43;40;0.558139534883721;19;24;0.0581395348837209;0.441860465116279
Control.SRR15539824;37;40;0.432432432432432;21;16;0.0675675675675675;0.432432432432432
Control.SRR15539824;40;40;0.5;20;20;0;0.5
Control.SRR15539824;41;40;0.536585365853659;19;22;0.0365853658536586;0.463414634146341
Control.SRR15539824;43;40;0.558139534883721;19;24;0.0581395348837209;0.441860465116279
Control.SRR15539824;39;40;0.58974358974359;16;23;0.0897435897435898;0.41025641025641
Control.SRR15539824;43;40;0.558139534883721;19;24;0.0581395348837209;0.441860465116279
Control.SRR15539824;43;40;0.534883720930233;20;23;0.0348837209302325;0.465116279069767
Control.SRR15539824;41;40;0.658536585365854;14;27;0.158536585365854;0.341463414634146
Control.SRR15539824;43;40;0.418604651162791;25;18;0.0813953488372093;0.418604651162791
Control.SRR15539824;40;40;0.5;20;20;0;0.5
Control.SRR15539824;41;40;0.390243902439024;25;16;0.109756097560976;0.390243902439024
Control.SRR15539824;38;40;0.526315789473684;18;20;0.0263157894736842;0.473684210526316
Control.SRR15539824;39;40;0.41025641025641;23;16;0.0897435897435898;0.41025641025641
Control.SRR15539824;44;40;0.409090909090909;26;18;0.0909090909090909;0.409090909090909
Control.SRR15539824;40;40;0.425;23;17;0.075;0.425
Control.SRR15539824;35;40;0.6;14;21;0.1;0.4
Control.SRR15539824;43;40;0.511627906976744;21;22;0.0116279069767442;0.488372093023256
Control.SRR15539824;37;40;0.540540540540541;17;20;0.0405405405405406;0.459459459459459
Control.SRR15539824;42;40;0.571428571428571;18;24;0.0714285714285714;0.428571428571429
Control.SRR15539824;39;40;0.41025641025641;23;16;0.0897435897435898;0.41025641025641
Control.SRR15539824;40;40;0.575;17;23;0.075;0.425
Control.SRR15539824;37;40;0.540540540540541;17;20;0.0405405405405406;0.459459459459459
Control.SRR15539824;41;40;0.585365853658537;17;24;0.0853658536585366;0.414634146341463
Control.SRR15539824;37;40;0.540540540540541;17;20;0.0405405405405406;0.459459459459459
Control.SRR15539824;40;40;0.45;22;18;0.05;0.45
Control.SRR15539824;43;40;0.488372093023256;22;21;0.0116279069767442;0.488372093023256
Control.SRR15539824;40;40;0.575;17;23;0.075;0.425
Control.SRR15539824;34;40;0.352941176470588;22;12;0.147058823529412;0.352941176470588
Control.SRR15539824;39;40;0.487179487179487;20;19;0.0128205128205128;0.487179487179487
Control.SRR15539824;39;40;0.641025641025641;14;25;0.141025641025641;0.358974358974359
Control.SRR15539824;41;40;0.463414634146341;22;19;0.0365853658536585;0.463414634146341
Control.SRR15539824;36;40;0.388888888888889;22;14;0.111111111111111;0.388888888888889
Control.SRR15539824;34;40;0.529411764705882;16;18;0.0294117647058824;0.470588235294118
Control.SRR15539824;41;40;0.560975609756098;18;23;0.0609756097560976;0.439024390243902
Control.SRR15539824;40;40;0.55;18;22;0.05;0.45
Control.SRR15539824;40;40;0.55;18;22;0.05;0.45
Control.SRR15539824;37;40;0.432432432432432;21;16;0.0675675675675675;0.432432432432432
Control.SRR15539824;35;40;0.428571428571429;20;15;0.0714285714285715;0.428571428571429
Control.SRR15539824;40;40;0.45;22;18;0.05;0.45
Control.SRR15539824;37;40;0.405405405405405;22;15;0.0945945945945946;0.405405405405405
Control.SRR15539824;40;40;0.45;22;18;0.05;0.45
Control.SRR15539824;39;40;0.487179487179487;20;19;0.0128205128205128;0.487179487179487
Control.SRR15539824;44;40;0.409090909090909;26;18;0.0909090909090909;0.409090909090909
Control.SRR15539824;43;40;0.372093023255814;27;16;0.127906976744186;0.372093023255814
Control.SRR15539824;39;40;0.41025641025641;23;16;0.0897435897435898;0.41025641025641
Control.SRR15539824;38;40;0.631578947368421;14;24;0.131578947368421;0.368421052631579
Control.SRR15539824;44;40;0.386363636363636;27;17;0.113636363636364;0.386363636363636
Control.SRR15539824;34;40;0.588235294117647;14;20;0.0882352941176471;0.411764705882353
Control.SRR15539824;43;40;0.418604651162791;25;18;0.0813953488372093;0.418604651162791
Control.SRR15539824;38;40;0.421052631578947;22;16;0.0789473684210527;0.421052631578947
Control.SRR15539824;38;40;0.526315789473684;18;20;0.0263157894736842;0.473684210526316
Control.SRR15539824;37;40;0.540540540540541;17;20;0.0405405405405406;0.459459459459459
Control.SRR15539824;38;40;0.578947368421053;16;22;0.0789473684210527;0.421052631578947
Control.SRR15539824;36;40;0.444444444444444;20;16;0.0555555555555556;0.444444444444444
Control.SRR15539824;42;40;0.523809523809524;20;22;0.0238095238095238;0.476190476190476
Control.SRR15539824;35;40;0.628571428571429;13;22;0.128571428571429;0.371428571428571
Control.SRR15539824;35;40;0.314285714285714;24;11;0.185714285714286;0.314285714285714
Control.SRR15539824;41;40;0.48780487804878;21;20;0.0121951219512195;0.48780487804878
Control.SRR15539824;42;40;0.428571428571429;24;18;0.0714285714285715;0.428571428571429
Control.SRR15539824;40;40;0.5;20;20;0;0.5
Control.SRR15539824;41;40;0.390243902439024;25;16;0.109756097560976;0.390243902439024
Control.SRR15539824;41;40;0.536585365853659;19;22;0.0365853658536586;0.463414634146341
Control.SRR15539824;42;40;0.5;21;21;0;0.5
Control.SRR15539824;42;40;0.547619047619048;19;23;0.0476190476190477;0.452380952380952
Control.SRR15539824;37;40;0.567567567567568;16;21;0.0675675675675675;0.432432432432432
Control.SRR15539824;37;40;0.594594594594595;15;22;0.0945945945945946;0.405405405405405
Control.SRR15539824;35;40;0.657142857142857;12;23;0.157142857142857;0.342857142857143
Control.SRR15539824;37;40;0.594594594594595;15;22;0.0945945945945946;0.405405405405405
Control.SRR15539824;34;40;0.529411764705882;16;18;0.0294117647058824;0.470588235294118
Control.SRR15539824;42;40;0.452380952380952;23;19;0.0476190476190476;0.452380952380952
Control.SRR15539824;44;40;0.5;22;22;0;0.5
Control.SRR15539824;36;40;0.444444444444444;20;16;0.0555555555555556;0.444444444444444
Control.SRR15539824;38;40;0.421052631578947;22;16;0.0789473684210527;0.421052631578947
Control.SRR15539824;41;40;0.463414634146341;22;19;0.0365853658536585;0.463414634146341
Control.SRR15539824;44;40;0.340909090909091;29;15;0.159090909090909;0.340909090909091
Control.SRR15539824;41;40;0.634146341463415;15;26;0.134146341463415;0.365853658536585
Control.SRR15539824;37;40;0.486486486486487;19;18;0.0135135135135135;0.486486486486487
Control.SRR15539824;42;40;0.452380952380952;23;19;0.0476190476190476;0.452380952380952
Control.SRR15539824;41;40;0.390243902439024;25;16;0.109756097560976;0.390243902439024
Control.SRR15539824;42;40;0.619047619047619;16;26;0.119047619047619;0.380952380952381
Control.SRR15539824;41;40;0.51219512195122;20;21;0.0121951219512195;0.48780487804878
Control.SRR15539824;44;40;0.681818181818182;14;30;0.181818181818182;0.318181818181818
Control.SRR15539824;41;40;0.463414634146341;22;19;0.0365853658536585;0.463414634146341
Control.SRR15539824;37;40;0.486486486486487;19;18;0.0135135135135135;0.486486486486487
Control.SRR15539824;37;40;0.540540540540541;17;20;0.0405405405405406;0.459459459459459
Control.SRR15539824;42;40;0.5;21;21;0;0.5
Control.SRR15539824;42;40;0.452380952380952;23;19;0.0476190476190476;0.452380952380952
Control.SRR15539824;38;40;0.5;19;19;0;0.5
Control.SRR15539824;35;40;0.485714285714286;18;17;0.0142857142857143;0.485714285714286
Control.SRR15539824;36;40;0.527777777777778;17;19;0.0277777777777778;0.472222222222222
Control.SRR15539824;37;40;0.540540540540541;17;20;0.0405405405405406;0.459459459459459
Control.SRR15539824;38;40;0.473684210526316;20;18;0.0263157894736842;0.473684210526316
Control.SRR15539824;38;40;0.552631578947368;17;21;0.0526315789473685;0.447368421052632
Control.SRR15539824;41;40;0.48780487804878;21;20;0.0121951219512195;0.48780487804878
Control.SRR15539824;44;40;0.431818181818182;25;19;0.0681818181818182;0.431818181818182
Control.SRR15539824;35;40;0.457142857142857;19;16;0.0428571428571429;0.457142857142857
Control.SRR15539824;44;40;0.409090909090909;26;18;0.0909090909090909;0.409090909090909
Control.SRR15539824;38;40;0.5;19;19;0;0.5
Control.SRR15539824;39;40;0.641025641025641;14;25;0.141025641025641;0.358974358974359
Control.SRR15539824;44;40;0.522727272727273;21;23;0.0227272727272727;0.477272727272727
Control.SRR15539824;37;40;0.567567567567568;16;21;0.0675675675675675;0.432432432432432
Control.SRR15539824;39;40;0.461538461538462;21;18;0.0384615384615384;0.461538461538462
Control.SRR15539824;35;40;0.6;14;21;0.1;0.4
Control.SRR15539824;43;40;0.627906976744186;16;27;0.127906976744186;0.372093023255814
Control.SRR15539824;39;40;0.564102564102564;17;22;0.0641025641025641;0.435897435897436
Control.SRR15539824;41;40;0.390243902439024;25;16;0.109756097560976;0.390243902439024
Control.SRR15539824;43;40;0.558139534883721;19;24;0.0581395348837209;0.441860465116279
Control.SRR15539824;43;40;0.441860465116279;24;19;0.0581395348837209;0.441860465116279
Control.SRR15539824;43;40;0.395348837209302;26;17;0.104651162790698;0.395348837209302
Control.SRR15539824;36;40;0.583333333333333;15;21;0.0833333333333334;0.416666666666667
Control.SRR15539824;40;40;0.625;15;25;0.125;0.375
Control.SRR15539824;36;40;0.5;18;18;0;0.5
Control.SRR15539824;43;40;0.488372093023256;22;21;0.0116279069767442;0.488372093023256
Control.SRR15539824;34;40;0.5;17;17;0;0.5
Control.SRR15539824;40;40;0.375;25;15;0.125;0.375
Control.SRR15539824;43;40;0.441860465116279;24;19;0.0581395348837209;0.441860465116279
Control.SRR15539824;42;40;0.571428571428571;18;24;0.0714285714285714;0.428571428571429
Control.SRR15539824;44;40;0.431818181818182;25;19;0.0681818181818182;0.431818181818182
Control.SRR15539824;37;40;0.459459459459459;20;17;0.0405405405405405;0.459459459459459
Control.SRR15539824;43;40;0.441860465116279;24;19;0.0581395348837209;0.441860465116279
Control.SRR15539824;42;40;0.452380952380952;23;19;0.0476190476190476;0.452380952380952
Control.SRR15539824;43;40;0.534883720930233;20;23;0.0348837209302325;0.465116279069767
Control.SRR15539824;36;40;0.555555555555556;16;20;0.0555555555555556;0.444444444444444
Control.SRR15539824;34;40;0.441176470588235;19;15;0.0588235294117647;0.441176470588235
Control.SRR15539824;40;40;0.525;19;21;0.025;0.475
Control.SRR15539824;44;40;0.5;22;22;0;0.5
Control.SRR15539824;43;40;0.348837209302326;28;15;0.151162790697674;0.348837209302326
Control.SRR15539824;39;40;0.564102564102564;17;22;0.0641025641025641;0.435897435897436
Control.SRR15539824;37;40;0.513513513513513;18;19;0.0135135135135135;0.486486486486487
Control.SRR15539824;39;40;0.461538461538462;21;18;0.0384615384615384;0.461538461538462
Control.SRR15539824;37;40;0.459459459459459;20;17;0.0405405405405405;0.459459459459459
Control.SRR15539824;44;40;0.272727272727273;32;12;0.227272727272727;0.272727272727273
Control.SRR15539824;44;40;0.477272727272727;23;21;0.0227272727272727;0.477272727272727
Control.SRR15539824;35;40;0.428571428571429;20;15;0.0714285714285715;0.428571428571429
Control.SRR15539824;35;40;0.485714285714286;18;17;0.0142857142857143;0.485714285714286
Control.SRR15539824;41;40;0.731707317073171;11;30;0.231707317073171;0.268292682926829
Control.SRR15539824;37;40;0.513513513513513;18;19;0.0135135135135135;0.486486486486487
Control.SRR15539824;36;40;0.583333333333333;15;21;0.0833333333333334;0.416666666666667
Control.SRR15539824;40;40;0.475;21;19;0.025;0.475
Control.SRR15539824;35;40;0.571428571428571;15;20;0.0714285714285714;0.428571428571429
Control.SRR15539824;44;40;0.431818181818182;25;19;0.0681818181818182;0.431818181818182
Control.SRR15539824;44;40;0.545454545454545;20;24;0.0454545454545454;0.454545454545455
Control.SRR15539824;36;40;0.388888888888889;22;14;0.111111111111111;0.388888888888889
Control.SRR15539824;42;40;0.476190476190476;22;20;0.0238095238095238;0.476190476190476
Control.SRR15539824;38;40;0.605263157894737;15;23;0.105263157894737;0.394736842105263
Control.SRR15539824;43;40;0.372093023255814;27;16;0.127906976744186;0.372093023255814
Control.SRR15539824;36;40;0.5;18;18;0;0.5
Control.SRR15539824;42;40;0.571428571428571;18;24;0.0714285714285714;0.428571428571429
Control.SRR15539824;43;40;0.511627906976744;21;22;0.0116279069767442;0.488372093023256
Control.SRR15539824;37;40;0.513513513513513;18;19;0.0135135135135135;0.486486486486487
Control.SRR15539824;39;40;0.538461538461538;18;21;0.0384615384615384;0.461538461538462
Control.SRR15539824;39;40;0.41025641025641;23;16;0.0897435897435898;0.41025641025641
Control.SRR15539824;38;40;0.473684210526316;20;18;0.0263157894736842;0.473684210526316
Control.SRR15539824;44;40;0.5;22;22;0;0.5
Control.SRR15539824;39;40;0.487179487179487;20;19;0.0128205128205128;0.487179487179487
Control.SRR15539824;38;40;0.578947368421053;16;22;0.0789473684210527;0.421052631578947
Control.SRR15539824;34;40;0.441176470588235;19;15;0.0588235294117647;0.441176470588235
Control.SRR15539824;38;40;0.447368421052632;21;17;0.0526315789473684;0.447368421052632
Control.SRR15539824;36;40;0.583333333333333;15;21;0.0833333333333334;0.416666666666667
Control.SRR15539824;42;40;0.428571428571429;24;18;0.0714285714285715;0.428571428571429
Control.SRR15539824;40;40;0.525;19;21;0.025;0.475
Control.SRR15539824;41;40;0.390243902439024;25;16;0.109756097560976;0.390243902439024
Control.SRR15539824;44;40;0.363636363636364;28;16;0.136363636363636;0.363636363636364
Control.SRR15539824;44;40;0.545454545454545;20;24;0.0454545454545454;0.454545454545455
Control.SRR15539824;37;40;0.594594594594595;15;22;0.0945945945945946;0.405405405405405
Control.SRR15539824;37;40;0.567567567567568;16;21;0.0675675675675675;0.432432432432432
Control.SRR15539824;40;40;0.45;22;18;0.05;0.45
Control.SRR15539824;38;40;0.526315789473684;18;20;0.0263157894736842;0.473684210526316
Control.SRR15539824;36;40;0.527777777777778;17;19;0.0277777777777778;0.472222222222222
Control.SRR15539824;40;40;0.5;20;20;0;0.5
Control.SRR15539824;38;40;0.394736842105263;23;15;0.105263157894737;0.394736842105263
Control.SRR15539824;37;40;0.459459459459459;20;17;0.0405405405405405;0.459459459459459
Control.SRR15539824;40;40;0.45;22;18;0.05;0.45
Control.SRR15539824;38;40;0.5;19;19;0;0.5
Control.SRR15539824;35;40;0.428571428571429;20;15;0.0714285714285715;0.428571428571429
Control.SRR15539824;41;40;0.51219512195122;20;21;0.0121951219512195;0.48780487804878
Control.SRR15539824;41;40;0.414634146341463;24;17;0.0853658536585366;0.414634146341463
Control.SRR15539824;40;40;0.55;18;22;0.05;0.45
Control.SRR15539824;35;40;0.571428571428571;15;20;0.0714285714285714;0.428571428571429
Control.SRR15539824;40;40;0.575;17;23;0.075;0.425
Control.SRR15539824;44;40;0.477272727272727;23;21;0.0227272727272727;0.477272727272727
Control.SRR15539824;42;40;0.523809523809524;20;22;0.0238095238095238;0.476190476190476
Control.SRR15539824;38;40;0.5;19;19;0;0.5
Control.SRR15539824;34;40;0.588235294117647;14;20;0.0882352941176471;0.411764705882353
Control.SRR15539824;41;40;0.560975609756098;18;23;0.0609756097560976;0.439024390243902
Control.SRR15539824;38;40;0.578947368421053;16;22;0.0789473684210527;0.421052631578947
Control.SRR15539824;41;40;0.48780487804878;21;20;0.0121951219512195;0.48780487804878
Control.SRR15539824;37;40;0.486486486486487;19;18;0.0135135135135135;0.486486486486487
Control.SRR15539824;35;40;0.657142857142857;12;23;0.157142857142857;0.342857142857143
Control.SRR15539824;39;40;0.512820512820513;19;20;0.0128205128205128;0.487179487179487
Control.SRR15539824;44;40;0.568181818181818;19;25;0.0681818181818182;0.431818181818182
Control.SRR15539824;44;40;0.454545454545455;24;20;0.0454545454545455;0.454545454545455
Control.SRR15539824;42;40;0.5;21;21;0;0.5
Control.SRR15539824;35;40;0.628571428571429;13;22;0.128571428571429;0.371428571428571
Control.SRR15539824;41;40;0.560975609756098;18;23;0.0609756097560976;0.439024390243902
Control.SRR15539824;44;40;0.545454545454545;20;24;0.0454545454545454;0.454545454545455
Control.SRR15539824;43;40;0.348837209302326;28;15;0.151162790697674;0.348837209302326
Control.SRR15539824;41;40;0.536585365853659;19;22;0.0365853658536586;0.463414634146341
Control.SRR15539824;42;40;0.5;21;21;0;0.5
Control.SRR15539824;36;40;0.611111111111111;14;22;0.111111111111111;0.388888888888889
Control.SRR15539824;37;40;0.486486486486487;19;18;0.0135135135135135;0.486486486486487
Control.SRR15539824;39;40;0.512820512820513;19;20;0.0128205128205128;0.487179487179487
Control.SRR15539824;35;40;0.657142857142857;12;23;0.157142857142857;0.342857142857143
Control.SRR15539824;34;40;0.411764705882353;20;14;0.0882352941176471;0.411764705882353
Control.SRR15539824;39;40;0.564102564102564;17;22;0.0641025641025641;0.435897435897436
Control.SRR15539824;34;40;0.411764705882353;20;14;0.0882352941176471;0.411764705882353
Control.SRR15539824;42;40;0.5;21;21;0;0.5
Control.SRR15539824;36;40;0.444444444444444;20;16;0.0555555555555556;0.444444444444444
Control.SRR15539824;42;40;0.547619047619048;19;23;0.0476190476190477;0.452380952380952
Control.SRR15539824;44;40;0.545454545454545;20;24;0.0454545454545454;0.454545454545455
Control.SRR15539824;38;40;0.552631578947368;17;21;0.0526315789473685;0.447368421052632
Control.SRR15539824;40;40;0.7;12;28;0.2;0.3
Control.SRR15539824;42;40;0.357142857142857;27;15;0.142857142857143;0.357142857142857
Control.SRR15539824;37;40;0.351351351351351;24;13;0.148648648648649;0.351351351351351
Control.SRR15539824;40;40;0.525;19;21;0.025;0.475
Control.SRR15539824;35;40;0.457142857142857;19;16;0.0428571428571429;0.457142857142857
Control.SRR15539824;34;40;0.588235294117647;14;20;0.0882352941176471;0.411764705882353
Control.SRR15539824;43;40;0.604651162790698;17;26;0.104651162790698;0.395348837209302
Control.SRR15539824;44;40;0.590909090909091;18;26;0.0909090909090909;0.409090909090909
Control.SRR15539824;42;40;0.452380952380952;23;19;0.0476190476190476;0.452380952380952
Control.SRR15539824;39;40;0.615384615384615;15;24;0.115384615384615;0.384615384615385
Control.SRR15539824;37;40;0.405405405405405;22;15;0.0945945945945946;0.405405405405405
Control.SRR15539824;38;40;0.394736842105263;23;15;0.105263157894737;0.394736842105263
Control.SRR15539824;42;40;0.30952380952381;29;13;0.19047619047619;0.30952380952381
Control.SRR15539824;41;40;0.658536585365854;14;27;0.158536585365854;0.341463414634146
Control.SRR15539824;40;40;0.45;22;18;0.05;0.45
Control.SRR15539824;40;40;0.4;24;16;0.1;0.4
Control.SRR15539824;39;40;0.512820512820513;19;20;0.0128205128205128;0.487179487179487
Control.SRR15539824;40;40;0.575;17;23;0.075;0.425
Control.SRR15539824;39;40;0.461538461538462;21;18;0.0384615384615384;0.461538461538462
Control.SRR15539824;43;40;0.418604651162791;25;18;0.0813953488372093;0.418604651162791
Control.SRR15539824;37;40;0.405405405405405;22;15;0.0945945945945946;0.405405405405405
Control.SRR15539824;34;40;0.441176470588235;19;15;0.0588235294117647;0.441176470588235
Control.SRR15539824;38;40;0.394736842105263;23;15;0.105263157894737;0.394736842105263
Control.SRR15539824;43;40;0.488372093023256;22;21;0.0116279069767442;0.488372093023256
Control.SRR15539824;37;40;0.567567567567568;16;21;0.0675675675675675;0.432432432432432
Control.SRR15539824;42;40;0.357142857142857;27;15;0.142857142857143;0.357142857142857
Control.SRR15539824;42;40;0.523809523809524;20;22;0.0238095238095238;0.476190476190476
Control.SRR15539824;35;40;0.457142857142857;19;16;0.0428571428571429;0.457142857142857
Control.SRR15539824;37;40;0.378378378378378;23;14;0.121621621621622;0.378378378378378
Control.SRR15539824;40;40;0.475;21;19;0.025;0.475
Control.SRR15539824;40;40;0.65;14;26;0.15;0.35
Control.SRR15539824;38;40;0.552631578947368;17;21;0.0526315789473685;0.447368421052632
Control.SRR15539824;44;40;0.477272727272727;23;21;0.0227272727272727;0.477272727272727
Control.SRR15539824;42;40;0.547619047619048;19;23;0.0476190476190477;0.452380952380952
Control.SRR15539824;35;40;0.542857142857143;16;19;0.0428571428571428;0.457142857142857
Control.SRR15539824;35;40;0.514285714285714;17;18;0.0142857142857142;0.485714285714286
Control.SRR15539824;35;40;0.485714285714286;18;17;0.0142857142857143;0.485714285714286
Control.SRR15539824;40;40;0.675;13;27;0.175;0.325
Control.SRR15539824;43;40;0.488372093023256;22;21;0.0116279069767442;0.488372093023256
Control.SRR15539824;41;40;0.48780487804878;21;20;0.0121951219512195;0.48780487804878
Control.SRR15539824;40;40;0.475;21;19;0.025;0.475
Control.SRR15539824;41;40;0.51219512195122;20;21;0.0121951219512195;0.48780487804878
Control.SRR15539824;38;40;0.447368421052632;21;17;0.0526315789473684;0.447368421052632
Control.SRR15539824;39;40;0.41025641025641;23;16;0.0897435897435898;0.41025641025641
Control.SRR15539824;44;40;0.568181818181818;19;25;0.0681818181818182;0.431818181818182
Control.SRR15539824;35;40;0.485714285714286;18;17;0.0142857142857143;0.485714285714286
Control.SRR15539824;40;40;0.65;14;26;0.15;0.35
Control.SRR15539824;44;40;0.568181818181818;19;25;0.0681818181818182;0.431818181818182
Control.SRR15539824;44;40;0.568181818181818;19;25;0.0681818181818182;0.431818181818182
Control.SRR15539824;44;40;0.522727272727273;21;23;0.0227272727272727;0.477272727272727
Control.SRR15539824;41;40;0.536585365853659;19;22;0.0365853658536586;0.463414634146341
Control.SRR15539824;37;40;0.432432432432432;21;16;0.0675675675675675;0.432432432432432
Control.SRR15539824;35;40;0.657142857142857;12;23;0.157142857142857;0.342857142857143
Control.SRR15539824;37;40;0.432432432432432;21;16;0.0675675675675675;0.432432432432432
Control.SRR15539824;37;40;0.594594594594595;15;22;0.0945945945945946;0.405405405405405
Control.SRR15539824;39;40;0.435897435897436;22;17;0.0641025641025641;0.435897435897436
Control.SRR15539824;35;40;0.4;21;14;0.1;0.4
Control.SRR15539824;34;40;0.470588235294118;18;16;0.0294117647058824;0.470588235294118
Control.SRR15539824;39;40;0.512820512820513;19;20;0.0128205128205128;0.487179487179487
Control.SRR15539824;41;40;0.463414634146341;22;19;0.0365853658536585;0.463414634146341
Control.SRR15539824;40;40;0.45;22;18;0.05;0.45
Control.SRR15539824;36;40;0.638888888888889;13;23;0.138888888888889;0.361111111111111
Control.SRR15539824;38;40;0.605263157894737;15;23;0.105263157894737;0.394736842105263
Control.SRR15539824;43;40;0.488372093023256;22;21;0.0116279069767442;0.488372093023256
Control.SRR15539824;36;40;0.694444444444444;11;25;0.194444444444444;0.305555555555556
Control.SRR15539824;35;40;0.542857142857143;16;19;0.0428571428571428;0.457142857142857
Control.SRR15539824;39;40;0.435897435897436;22;17;0.0641025641025641;0.435897435897436
Control.SRR15539824;43;40;0.534883720930233;20;23;0.0348837209302325;0.465116279069767
Control.SRR15539824;36;40;0.361111111111111;23;13;0.138888888888889;0.361111111111111
Control.SRR15539824;34;40;0.441176470588235;19;15;0.0588235294117647;0.441176470588235
Control.SRR15539824;44;40;0.431818181818182;25;19;0.0681818181818182;0.431818181818182
Control.SRR15539824;41;40;0.51219512195122;20;21;0.0121951219512195;0.48780487804878
Control.SRR15539824;36;40;0.638888888888889;13;23;0.138888888888889;0.361111111111111
Control.SRR15539824;34;40;0.411764705882353;20;14;0.0882352941176471;0.411764705882353
Control.SRR15539824;40;40;0.5;20;20;0;0.5
Control.SRR15539824;43;40;0.418604651162791;25;18;0.0813953488372093;0.418604651162791
Control.SRR15539824;40;40;0.475;21;19;0.025;0.475
Control.SRR15539824;36;40;0.5;18;18;0;0.5
Control.SRR15539824;39;40;0.435897435897436;22;17;0.0641025641025641;0.435897435897436
Control.SRR15539824;37;40;0.459459459459459;20;17;0.0405405405405405;0.459459459459459
Control.SRR15539824;44;40;0.477272727272727;23;21;0.0227272727272727;0.477272727272727
Control.SRR15539824;44;40;0.5;22;22;0;0.5
Control.SRR15539824;37;40;0.513513513513513;18;19;0.0135135135135135;0.486486486486487
Control.SRR15539824;34;40;0.588235294117647;14;20;0.0882352941176471;0.411764705882353
Control.SRR15539824;42;40;0.452380952380952;23;19;0.0476190476190476;0.452380952380952
Control.SRR15539824;35;40;0.628571428571429;13;22;0.128571428571429;0.371428571428571
Control.SRR15539824;42;40;0.547619047619048;19;23;0.0476190476190477;0.452380952380952
Control.SRR15539824;39;40;0.538461538461538;18;21;0.0384615384615384;0.461538461538462
Control.SRR15539824;39;40;0.512820512820513;19;20;0.0128205128205128;0.487179487179487
Control.SRR15539824;35;40;0.428571428571429;20;15;0.0714285714285715;0.428571428571429
Control.SRR15539824;39;40;0.564102564102564;17;22;0.0641025641025641;0.435897435897436
Control.SRR15539824;40;40;0.6;16;24;0.1;0.4
Control.SRR15539824;35;40;0.657142857142857;12;23;0.157142857142857;0.342857142857143
Control.SRR15539824;36;40;0.527777777777778;17;19;0.0277777777777778;0.472222222222222
Control.SRR15539824;39;40;0.538461538461538;18;21;0.0384615384615384;0.461538461538462
Control.SRR15539824;36;40;0.555555555555556;16;20;0.0555555555555556;0.444444444444444
Control.SRR15539824;43;40;0.441860465116279;24;19;0.0581395348837209;0.441860465116279
Control.SRR15539824;38;40;0.552631578947368;17;21;0.0526315789473685;0.447368421052632
Control.SRR15539824;37;40;0.513513513513513;18;19;0.0135135135135135;0.486486486486487
Control.SRR15539824;39;40;0.58974358974359;16;23;0.0897435897435898;0.41025641025641
Control.SRR15539824;36;40;0.638888888888889;13;23;0.138888888888889;0.361111111111111
Control.SRR15539824;39;40;0.487179487179487;20;19;0.0128205128205128;0.487179487179487
Control.SRR15539824;40;40;0.725;11;29;0.225;0.275
Control.SRR15539824;39;40;0.512820512820513;19;20;0.0128205128205128;0.487179487179487
Control.SRR15539824;35;40;0.514285714285714;17;18;0.0142857142857142;0.485714285714286
Control.SRR15539824;36;40;0.583333333333333;15;21;0.0833333333333334;0.416666666666667
Control.SRR15539824;36;40;0.416666666666667;21;15;0.0833333333333333;0.416666666666667
Control.SRR15539824;34;40;0.588235294117647;14;20;0.0882352941176471;0.411764705882353
Control.SRR15539824;37;40;0.540540540540541;17;20;0.0405405405405406;0.459459459459459
Control.SRR15539824;34;40;0.441176470588235;19;15;0.0588235294117647;0.441176470588235
Control.SRR15539824;39;40;0.435897435897436;22;17;0.0641025641025641;0.435897435897436
Control.SRR15539824;37;40;0.540540540540541;17;20;0.0405405405405406;0.459459459459459
Control.SRR15539824;41;40;0.536585365853659;19;22;0.0365853658536586;0.463414634146341
Control.SRR15539824;37;40;0.459459459459459;20;17;0.0405405405405405;0.459459459459459
Control.SRR15539824;35;40;0.571428571428571;15;20;0.0714285714285714;0.428571428571429
Control.SRR15539824;34;40;0.529411764705882;16;18;0.0294117647058824;0.470588235294118
Control.SRR15539824;43;40;0.395348837209302;26;17;0.104651162790698;0.395348837209302
Control.SRR15539824;44;40;0.431818181818182;25;19;0.0681818181818182;0.431818181818182
Control.SRR15539824;42;40;0.642857142857143;15;27;0.142857142857143;0.357142857142857
Control.SRR15539824;40;40;0.425;23;17;0.075;0.425
Control.SRR15539824;38;40;0.552631578947368;17;21;0.0526315789473685;0.447368421052632
Control.SRR15539824;41;40;0.560975609756098;18;23;0.0609756097560976;0.439024390243902
Control.SRR15539824;35;40;0.514285714285714;17;18;0.0142857142857142;0.485714285714286
Control.SRR15539824;36;40;0.444444444444444;20;16;0.0555555555555556;0.444444444444444
Control.SRR15539824;41;40;0.48780487804878;21;20;0.0121951219512195;0.48780487804878
Control.SRR15539824;40;40;0.55;18;22;0.05;0.45
Control.SRR15539824;34;40;0.382352941176471;21;13;0.117647058823529;0.382352941176471
Control.SRR15539824;39;40;0.512820512820513;19;20;0.0128205128205128;0.487179487179487
Control.SRR15539824;43;40;0.465116279069767;23;20;0.0348837209302326;0.465116279069767
Control.SRR15539824;38;40;0.552631578947368;17;21;0.0526315789473685;0.447368421052632
Control.SRR15539824;39;40;0.666666666666667;13;26;0.166666666666667;0.333333333333333
Control.SRR15539824;42;40;0.523809523809524;20;22;0.0238095238095238;0.476190476190476
Control.SRR15539824;39;40;0.58974358974359;16;23;0.0897435897435898;0.41025641025641
Control.SRR15539824;40;40;0.65;14;26;0.15;0.35
Control.SRR15539824;40;40;0.625;15;25;0.125;0.375
Control.SRR15539824;36;40;0.472222222222222;19;17;0.0277777777777778;0.472222222222222
Control.SRR15539824;37;40;0.459459459459459;20;17;0.0405405405405405;0.459459459459459
Control.SRR15539824;39;40;0.487179487179487;20;19;0.0128205128205128;0.487179487179487
Control.SRR15539824;36;40;0.472222222222222;19;17;0.0277777777777778;0.472222222222222
Control.SRR15539824;43;40;0.627906976744186;16;27;0.127906976744186;0.372093023255814
Control.SRR15539824;39;40;0.461538461538462;21;18;0.0384615384615384;0.461538461538462
Control.SRR15539824;39;40;0.564102564102564;17;22;0.0641025641025641;0.435897435897436
Control.SRR15539824;41;40;0.51219512195122;20;21;0.0121951219512195;0.48780487804878
Control.SRR15539824;40;40;0.575;17;23;0.075;0.425
Control.SRR15539824;41;40;0.560975609756098;18;23;0.0609756097560976;0.439024390243902
Control.SRR15539824;40;40;0.4;24;16;0.1;0.4
Control.SRR15539824;37;40;0.513513513513513;18;19;0.0135135135135135;0.486486486486487
Control.SRR15539824;42;40;0.571428571428571;18;24;0.0714285714285714;0.428571428571429
Control.SRR15539824;35;40;0.542857142857143;16;19;0.0428571428571428;0.457142857142857
Control.SRR15539824;37;40;0.351351351351351;24;13;0.148648648648649;0.351351351351351
Control.SRR15539824;44;40;0.409090909090909;26;18;0.0909090909090909;0.409090909090909
Control.SRR15539824;42;40;0.428571428571429;24;18;0.0714285714285715;0.428571428571429
Control.SRR15539824;41;40;0.365853658536585;26;15;0.134146341463415;0.365853658536585
Control.SRR15539824;38;40;0.447368421052632;21;17;0.0526315789473684;0.447368421052632
Control.SRR15539824;39;40;0.512820512820513;19;20;0.0128205128205128;0.487179487179487
Control.SRR15539824;36;40;0.388888888888889;22;14;0.111111111111111;0.388888888888889
Control.SRR15539824;45;40;0.577777777777778;19;26;0.0777777777777777;0.422222222222222
Control.SRR15539824;44;40;0.522727272727273;21;23;0.0227272727272727;0.477272727272727
Control.SRR15539824;41;40;0.48780487804878;21;20;0.0121951219512195;0.48780487804878
Control.SRR15539824;42;40;0.5;21;21;0;0.5
Control.SRR15539824;36;40;0.472222222222222;19;17;0.0277777777777778;0.472222222222222
Control.SRR15539824;41;40;0.536585365853659;19;22;0.0365853658536586;0.463414634146341
Control.SRR15539824;40;40;0.475;21;19;0.025;0.475
Control.SRR15539824;38;40;0.552631578947368;17;21;0.0526315789473685;0.447368421052632
Control.SRR15539824;36;40;0.638888888888889;13;23;0.138888888888889;0.361111111111111
Control.SRR15539824;40;40;0.525;19;21;0.025;0.475
Control.SRR15539824;42;40;0.547619047619048;19;23;0.0476190476190477;0.452380952380952
Control.SRR15539824;38;40;0.657894736842105;13;25;0.157894736842105;0.342105263157895
Control.SRR15539824;44;40;0.613636363636364;17;27;0.113636363636364;0.386363636363636
Control.SRR15539824;39;40;0.538461538461538;18;21;0.0384615384615384;0.461538461538462
Control.SRR15539824;39;40;0.512820512820513;19;20;0.0128205128205128;0.487179487179487
Control.SRR15539824;43;40;0.395348837209302;26;17;0.104651162790698;0.395348837209302
Control.SRR15539824;45;40;0.577777777777778;19;26;0.0777777777777777;0.422222222222222
Control.SRR15539824;42;40;0.333333333333333;28;14;0.166666666666667;0.333333333333333
Control.SRR15539824;42;40;0.428571428571429;24;18;0.0714285714285715;0.428571428571429
Control.SRR15539824;37;40;0.594594594594595;15;22;0.0945945945945946;0.405405405405405
Control.SRR15539824;36;40;0.527777777777778;17;19;0.0277777777777778;0.472222222222222
Control.SRR15539824;42;40;0.5;21;21;0;0.5
Control.SRR15539824;44;40;0.454545454545455;24;20;0.0454545454545455;0.454545454545455
Control.SRR15539824;41;40;0.48780487804878;21;20;0.0121951219512195;0.48780487804878
Control.SRR15539824;42;40;0.428571428571429;24;18;0.0714285714285715;0.428571428571429
Control.SRR15539824;37;40;0.432432432432432;21;16;0.0675675675675675;0.432432432432432
Control.SRR15539824;38;40;0.5;19;19;0;0.5
Control.SRR15539824;37;40;0.675675675675676;12;25;0.175675675675676;0.324324324324324
Control.SRR15539824;44;40;0.613636363636364;17;27;0.113636363636364;0.386363636363636
Control.SRR15539824;37;40;0.405405405405405;22;15;0.0945945945945946;0.405405405405405
Control.SRR15539824;43;40;0.441860465116279;24;19;0.0581395348837209;0.441860465116279
Control.SRR15539824;43;40;0.534883720930233;20;23;0.0348837209302325;0.465116279069767
Control.SRR15539824;44;40;0.477272727272727;23;21;0.0227272727272727;0.477272727272727
Control.SRR15539824;40;40;0.575;17;23;0.075;0.425
Control.SRR15539824;36;40;0.472222222222222;19;17;0.0277777777777778;0.472222222222222
Control.SRR15539824;41;40;0.585365853658537;17;24;0.0853658536585366;0.414634146341463
Control.SRR15539824;43;40;0.418604651162791;25;18;0.0813953488372093;0.418604651162791
Control.SRR15539824;43;40;0.558139534883721;19;24;0.0581395348837209;0.441860465116279
Control.SRR15539824;42;40;0.476190476190476;22;20;0.0238095238095238;0.476190476190476
Control.SRR15539824;35;40;0.542857142857143;16;19;0.0428571428571428;0.457142857142857
Control.SRR15539824;43;40;0.465116279069767;23;20;0.0348837209302326;0.465116279069767
Control.SRR15539824;41;40;0.48780487804878;21;20;0.0121951219512195;0.48780487804878
Control.SRR15539824;39;40;0.615384615384615;15;24;0.115384615384615;0.384615384615385
Control.SRR15539824;41;40;0.48780487804878;21;20;0.0121951219512195;0.48780487804878
Control.SRR15539824;35;40;0.6;14;21;0.1;0.4
Control.SRR15539824;35;40;0.485714285714286;18;17;0.0142857142857143;0.485714285714286
Control.SRR15539824;42;40;0.476190476190476;22;20;0.0238095238095238;0.476190476190476
Control.SRR15539824;45;40;0.533333333333333;21;24;0.0333333333333333;0.466666666666667
Control.SRR15539824;36;40;0.5;18;18;0;0.5
Control.SRR15539824;43;40;0.534883720930233;20;23;0.0348837209302325;0.465116279069767
Control.SRR15539824;41;40;0.48780487804878;21;20;0.0121951219512195;0.48780487804878
Control.SRR15539824;42;40;0.571428571428571;18;24;0.0714285714285714;0.428571428571429
Control.SRR15539824;41;40;0.48780487804878;21;20;0.0121951219512195;0.48780487804878
Control.SRR15539824;36;40;0.5;18;18;0;0.5
Control.SRR15539824;42;40;0.476190476190476;22;20;0.0238095238095238;0.476190476190476
Control.SRR15539824;41;40;0.365853658536585;26;15;0.134146341463415;0.365853658536585
Control.SRR15539824;41;40;0.463414634146341;22;19;0.0365853658536585;0.463414634146341
Control.SRR15539824;40;40;0.5;20;20;0;0.5
Control.SRR15539824;37;40;0.513513513513513;18;19;0.0135135135135135;0.486486486486487
Control.SRR15539824;36;40;0.555555555555556;16;20;0.0555555555555556;0.444444444444444
Control.SRR15539824;37;40;0.594594594594595;15;22;0.0945945945945946;0.405405405405405
Control.SRR15539824;43;40;0.511627906976744;21;22;0.0116279069767442;0.488372093023256
Control.SRR15539824;42;40;0.571428571428571;18;24;0.0714285714285714;0.428571428571429
Control.SRR15539824;37;40;0.405405405405405;22;15;0.0945945945945946;0.405405405405405
Control.SRR15539824;44;40;0.568181818181818;19;25;0.0681818181818182;0.431818181818182
Control.SRR15539824;41;40;0.463414634146341;22;19;0.0365853658536585;0.463414634146341
Control.SRR15539824;37;40;0.513513513513513;18;19;0.0135135135135135;0.486486486486487
Control.SRR15539824;41;40;0.341463414634146;27;14;0.158536585365854;0.341463414634146
Control.SRR15539824;42;40;0.404761904761905;25;17;0.0952380952380952;0.404761904761905
Control.SRR15539824;40;40;0.575;17;23;0.075;0.425
Control.SRR15539824;37;40;0.513513513513513;18;19;0.0135135135135135;0.486486486486487
Control.SRR15539824;43;40;0.534883720930233;20;23;0.0348837209302325;0.465116279069767
Control.SRR15539824;38;40;0.526315789473684;18;20;0.0263157894736842;0.473684210526316
Control.SRR15539824;41;40;0.609756097560976;16;25;0.109756097560976;0.390243902439024
Control.SRR15539824;40;40;0.525;19;21;0.025;0.475
Control.SRR15539824;43;40;0.604651162790698;17;26;0.104651162790698;0.395348837209302
Control.SRR15539824;44;40;0.431818181818182;25;19;0.0681818181818182;0.431818181818182
Control.SRR15539824;36;40;0.583333333333333;15;21;0.0833333333333334;0.416666666666667
Control.SRR15539824;41;40;0.609756097560976;16;25;0.109756097560976;0.390243902439024
Control.SRR15539824;44;40;0.454545454545455;24;20;0.0454545454545455;0.454545454545455
Control.SRR15539824;37;40;0.459459459459459;20;17;0.0405405405405405;0.459459459459459
Control.SRR15539824;35;40;0.457142857142857;19;16;0.0428571428571429;0.457142857142857
Control.SRR15539824;40;40;0.5;20;20;0;0.5
Control.SRR15539824;36;40;0.25;27;9;0.25;0.25
Control.SRR15539824;43;40;0.511627906976744;21;22;0.0116279069767442;0.488372093023256
Control.SRR15539824;35;40;0.514285714285714;17;18;0.0142857142857142;0.485714285714286
Control.SRR15539824;41;40;0.536585365853659;19;22;0.0365853658536586;0.463414634146341
Control.SRR15539824;44;40;0.545454545454545;20;24;0.0454545454545454;0.454545454545455
Control.SRR15539824;41;40;0.439024390243902;23;18;0.0609756097560976;0.439024390243902
Control.SRR15539824;42;40;0.428571428571429;24;18;0.0714285714285715;0.428571428571429
Control.SRR15539824;41;40;0.390243902439024;25;16;0.109756097560976;0.390243902439024
Control.SRR15539824;45;40;0.622222222222222;17;28;0.122222222222222;0.377777777777778
Control.SRR15539824;40;40;0.525;19;21;0.025;0.475
Control.SRR15539824;45;40;0.577777777777778;19;26;0.0777777777777777;0.422222222222222
Control.SRR15539824;37;40;0.486486486486487;19;18;0.0135135135135135;0.486486486486487
Control.SRR15539824;44;40;0.454545454545455;24;20;0.0454545454545455;0.454545454545455
Control.SRR15539824;37;40;0.675675675675676;12;25;0.175675675675676;0.324324324324324
Control.SRR15539824;38;40;0.552631578947368;17;21;0.0526315789473685;0.447368421052632
Control.SRR15539824;41;40;0.414634146341463;24;17;0.0853658536585366;0.414634146341463
Control.SRR15539824;40;40;0.575;17;23;0.075;0.425
Control.SRR15539824;44;40;0.522727272727273;21;23;0.0227272727272727;0.477272727272727
Control.SRR15539824;40;40;0.55;18;22;0.05;0.45
Control.SRR15539824;42;40;0.5;21;21;0;0.5
Control.SRR15539824;41;40;0.585365853658537;17;24;0.0853658536585366;0.414634146341463
Control.SRR15539824;37;40;0.378378378378378;23;14;0.121621621621622;0.378378378378378
Control.SRR15539824;43;40;0.558139534883721;19;24;0.0581395348837209;0.441860465116279
Control.SRR15539824;40;40;0.6;16;24;0.1;0.4
Control.SRR15539824;37;40;0.540540540540541;17;20;0.0405405405405406;0.459459459459459
Control.SRR15539824;39;40;0.41025641025641;23;16;0.0897435897435898;0.41025641025641
Control.SRR15539824;40;40;0.425;23;17;0.075;0.425
Control.SRR15539824;39;40;0.564102564102564;17;22;0.0641025641025641;0.435897435897436
Control.SRR15539824;35;40;0.514285714285714;17;18;0.0142857142857142;0.485714285714286
Control.SRR15539824;40;40;0.45;22;18;0.05;0.45
Control.SRR15539824;42;40;0.285714285714286;30;12;0.214285714285714;0.285714285714286
Control.SRR15539824;43;40;0.441860465116279;24;19;0.0581395348837209;0.441860465116279
Control.SRR15539824;41;40;0.560975609756098;18;23;0.0609756097560976;0.439024390243902
Control.SRR15539824;41;40;0.414634146341463;24;17;0.0853658536585366;0.414634146341463
Control.SRR15539824;42;40;0.5;21;21;0;0.5
Control.SRR15539824;44;40;0.590909090909091;18;26;0.0909090909090909;0.409090909090909
Control.SRR15539824;35;40;0.571428571428571;15;20;0.0714285714285714;0.428571428571429
Control.SRR15539824;38;40;0.552631578947368;17;21;0.0526315789473685;0.447368421052632
Control.SRR15539824;36;40;0.472222222222222;19;17;0.0277777777777778;0.472222222222222
Control.SRR15539824;45;40;0.6;18;27;0.1;0.4
Control.SRR15539824;43;40;0.465116279069767;23;20;0.0348837209302326;0.465116279069767
Control.SRR15539824;41;40;0.560975609756098;18;23;0.0609756097560976;0.439024390243902
Control.SRR15539824;35;40;0.485714285714286;18;17;0.0142857142857143;0.485714285714286
Control.SRR15539824;39;40;0.435897435897436;22;17;0.0641025641025641;0.435897435897436
Control.SRR15539824;44;40;0.409090909090909;26;18;0.0909090909090909;0.409090909090909
Control.SRR15539824;41;40;0.463414634146341;22;19;0.0365853658536585;0.463414634146341
Control.SRR15539824;39;40;0.564102564102564;17;22;0.0641025641025641;0.435897435897436
Control.SRR15539824;36;40;0.611111111111111;14;22;0.111111111111111;0.388888888888889
Control.SRR15539824;37;40;0.405405405405405;22;15;0.0945945945945946;0.405405405405405
Control.SRR15539824;39;40;0.538461538461538;18;21;0.0384615384615384;0.461538461538462
Control.SRR15539824;38;40;0.578947368421053;16;22;0.0789473684210527;0.421052631578947
Control.SRR15539824;41;40;0.560975609756098;18;23;0.0609756097560976;0.439024390243902
Control.SRR15539824;35;40;0.485714285714286;18;17;0.0142857142857143;0.485714285714286
Control.SRR15539824;39;40;0.564102564102564;17;22;0.0641025641025641;0.435897435897436
Control.SRR15539824;41;40;0.48780487804878;21;20;0.0121951219512195;0.48780487804878
Control.SRR15539824;45;40;0.555555555555556;20;25;0.0555555555555556;0.444444444444444
Control.SRR15539824;41;40;0.560975609756098;18;23;0.0609756097560976;0.439024390243902
Control.SRR15539824;44;40;0.386363636363636;27;17;0.113636363636364;0.386363636363636
Control.SRR15539824;37;40;0.486486486486487;19;18;0.0135135135135135;0.486486486486487
Control.SRR15539824;42;40;0.428571428571429;24;18;0.0714285714285715;0.428571428571429
Control.SRR15539824;42;40;0.571428571428571;18;24;0.0714285714285714;0.428571428571429
Control.SRR15539824;43;40;0.488372093023256;22;21;0.0116279069767442;0.488372093023256
Control.SRR15539824;43;40;0.511627906976744;21;22;0.0116279069767442;0.488372093023256
Control.SRR15539824;37;40;0.513513513513513;18;19;0.0135135135135135;0.486486486486487
Control.SRR15539824;44;40;0.5;22;22;0;0.5
Control.SRR15539824;40;40;0.45;22;18;0.05;0.45
Control.SRR15539824;35;40;0.485714285714286;18;17;0.0142857142857143;0.485714285714286
Control.SRR15539824;41;40;0.439024390243902;23;18;0.0609756097560976;0.439024390243902
Control.SRR15539824;44;40;0.5;22;22;0;0.5
Control.SRR15539824;43;40;0.441860465116279;24;19;0.0581395348837209;0.441860465116279
Control.SRR15539824;42;40;0.547619047619048;19;23;0.0476190476190477;0.452380952380952
Control.SRR15539824;36;40;0.416666666666667;21;15;0.0833333333333333;0.416666666666667
Control.SRR15539824;44;40;0.522727272727273;21;23;0.0227272727272727;0.477272727272727
Control.SRR15539824;36;40;0.5;18;18;0;0.5
Control.SRR15539824;35;40;0.514285714285714;17;18;0.0142857142857142;0.485714285714286
Control.SRR15539824;35;40;0.6;14;21;0.1;0.4
Control.SRR15539824;39;40;0.512820512820513;19;20;0.0128205128205128;0.487179487179487
Control.SRR15539824;41;40;0.463414634146341;22;19;0.0365853658536585;0.463414634146341
Control.SRR15539824;44;40;0.409090909090909;26;18;0.0909090909090909;0.409090909090909
Control.SRR15539824;44;40;0.477272727272727;23;21;0.0227272727272727;0.477272727272727
Control.SRR15539824;41;40;0.439024390243902;23;18;0.0609756097560976;0.439024390243902
Control.SRR15539824;45;40;0.466666666666667;24;21;0.0333333333333333;0.466666666666667
Control.SRR15539824;45;40;0.511111111111111;22;23;0.0111111111111111;0.488888888888889
Control.SRR15539824;41;40;0.341463414634146;27;14;0.158536585365854;0.341463414634146
Control.SRR15539824;41;40;0.51219512195122;20;21;0.0121951219512195;0.48780487804878
Control.SRR15539824;41;40;0.414634146341463;24;17;0.0853658536585366;0.414634146341463
Control.SRR15539824;37;40;0.513513513513513;18;19;0.0135135135135135;0.486486486486487
Control.SRR15539824;44;40;0.568181818181818;19;25;0.0681818181818182;0.431818181818182
Control.SRR15539824;37;40;0.486486486486487;19;18;0.0135135135135135;0.486486486486487
Control.SRR15539824;35;40;0.514285714285714;17;18;0.0142857142857142;0.485714285714286
Control.SRR15539824;37;40;0.405405405405405;22;15;0.0945945945945946;0.405405405405405
Control.SRR15539824;38;40;0.368421052631579;24;14;0.131578947368421;0.368421052631579
Control.SRR15539824;37;40;0.513513513513513;18;19;0.0135135135135135;0.486486486486487
Control.SRR15539824;39;40;0.641025641025641;14;25;0.141025641025641;0.358974358974359
Control.SRR15539824;38;40;0.447368421052632;21;17;0.0526315789473684;0.447368421052632
Control.SRR15539824;40;40;0.45;22;18;0.05;0.45
Control.SRR15539824;41;40;0.536585365853659;19;22;0.0365853658536586;0.463414634146341
Control.SRR15539824;35;40;0.457142857142857;19;16;0.0428571428571429;0.457142857142857
Control.SRR15539824;41;40;0.560975609756098;18;23;0.0609756097560976;0.439024390243902
Control.SRR15539824;39;40;0.282051282051282;28;11;0.217948717948718;0.282051282051282
Control.SRR15539824;35;40;0.4;21;14;0.1;0.4
Control.SRR15539824;35;40;0.657142857142857;12;23;0.157142857142857;0.342857142857143
Control.SRR15539824;40;40;0.55;18;22;0.05;0.45
Control.SRR15539824;39;40;0.384615384615385;24;15;0.115384615384615;0.384615384615385
Control.SRR15539824;40;40;0.425;23;17;0.075;0.425
Control.SRR15539824;42;40;0.428571428571429;24;18;0.0714285714285715;0.428571428571429
Control.SRR15539824;45;40;0.466666666666667;24;21;0.0333333333333333;0.466666666666667
Control.SRR15539824;38;40;0.421052631578947;22;16;0.0789473684210527;0.421052631578947
Control.SRR15539824;44;40;0.522727272727273;21;23;0.0227272727272727;0.477272727272727
Control.SRR15539824;40;40;0.4;24;16;0.1;0.4
Control.SRR15539824;44;40;0.477272727272727;23;21;0.0227272727272727;0.477272727272727
Control.SRR15539824;45;40;0.577777777777778;19;26;0.0777777777777777;0.422222222222222
Control.SRR15539824;36;40;0.472222222222222;19;17;0.0277777777777778;0.472222222222222
Control.SRR15539824;36;40;0.444444444444444;20;16;0.0555555555555556;0.444444444444444
Control.SRR15539824;36;40;0.472222222222222;19;17;0.0277777777777778;0.472222222222222
Control.SRR15539824;40;40;0.475;21;19;0.025;0.475
Control.SRR15539824;44;40;0.386363636363636;27;17;0.113636363636364;0.386363636363636
Control.SRR15539824;38;40;0.447368421052632;21;17;0.0526315789473684;0.447368421052632
Control.SRR15539824;35;40;0.542857142857143;16;19;0.0428571428571428;0.457142857142857
Control.SRR15539824;37;40;0.513513513513513;18;19;0.0135135135135135;0.486486486486487
Control.SRR15539824;44;40;0.522727272727273;21;23;0.0227272727272727;0.477272727272727
Control.SRR15539824;39;40;0.461538461538462;21;18;0.0384615384615384;0.461538461538462
Control.SRR15539824;40;40;0.45;22;18;0.05;0.45
Control.SRR15539824;42;40;0.547619047619048;19;23;0.0476190476190477;0.452380952380952
Control.SRR15539824;45;40;0.4;27;18;0.1;0.4
Control.SRR15539824;44;40;0.454545454545455;24;20;0.0454545454545455;0.454545454545455
Control.SRR15539824;37;40;0.540540540540541;17;20;0.0405405405405406;0.459459459459459
Control.SRR15539824;45;40;0.6;18;27;0.1;0.4
Control.SRR15539824;42;40;0.5;21;21;0;0.5
Control.SRR15539824;36;40;0.555555555555556;16;20;0.0555555555555556;0.444444444444444
Control.SRR15539824;42;40;0.476190476190476;22;20;0.0238095238095238;0.476190476190476
Control.SRR15539824;36;40;0.472222222222222;19;17;0.0277777777777778;0.472222222222222
Control.SRR15539824;39;40;0.487179487179487;20;19;0.0128205128205128;0.487179487179487
Control.SRR15539824;40;40;0.525;19;21;0.025;0.475
Control.SRR15539824;38;40;0.421052631578947;22;16;0.0789473684210527;0.421052631578947
Control.SRR15539824;35;40;0.514285714285714;17;18;0.0142857142857142;0.485714285714286
Control.SRR15539824;39;40;0.58974358974359;16;23;0.0897435897435898;0.41025641025641
Control.SRR15539824;38;40;0.526315789473684;18;20;0.0263157894736842;0.473684210526316
Control.SRR15539824;43;40;0.558139534883721;19;24;0.0581395348837209;0.441860465116279
Control.SRR15539824;40;40;0.55;18;22;0.05;0.45
Control.SRR15539824;39;40;0.717948717948718;11;28;0.217948717948718;0.282051282051282
Control.SRR15539824;45;40;0.488888888888889;23;22;0.0111111111111111;0.488888888888889
Control.SRR15539824;43;40;0.511627906976744;21;22;0.0116279069767442;0.488372093023256
Control.SRR15539824;39;40;0.58974358974359;16;23;0.0897435897435898;0.41025641025641
Control.SRR15539824;40;40;0.6;16;24;0.1;0.4
Control.SRR15539824;44;40;0.454545454545455;24;20;0.0454545454545455;0.454545454545455
Control.SRR15539824;37;40;0.405405405405405;22;15;0.0945945945945946;0.405405405405405
Control.SRR15539824;43;40;0.465116279069767;23;20;0.0348837209302326;0.465116279069767
Control.SRR15539824;44;40;0.409090909090909;26;18;0.0909090909090909;0.409090909090909
Control.SRR15539824;35;40;0.542857142857143;16;19;0.0428571428571428;0.457142857142857
Control.SRR15539824;42;40;0.428571428571429;24;18;0.0714285714285715;0.428571428571429
Control.SRR15539824;45;40;0.622222222222222;17;28;0.122222222222222;0.377777777777778
Control.SRR15539824;37;40;0.432432432432432;21;16;0.0675675675675675;0.432432432432432
Control.SRR15539824;41;40;0.341463414634146;27;14;0.158536585365854;0.341463414634146
Control.SRR15539824;44;40;0.409090909090909;26;18;0.0909090909090909;0.409090909090909
Control.SRR15539824;38;40;0.5;19;19;0;0.5
Control.SRR15539824;45;40;0.6;18;27;0.1;0.4
Control.SRR15539824;41;40;0.560975609756098;18;23;0.0609756097560976;0.439024390243902
Control.SRR15539824;36;40;0.583333333333333;15;21;0.0833333333333334;0.416666666666667
Control.SRR15539824;37;40;0.540540540540541;17;20;0.0405405405405406;0.459459459459459
Control.SRR15539824;37;40;0.486486486486487;19;18;0.0135135135135135;0.486486486486487
Control.SRR15539824;38;40;0.421052631578947;22;16;0.0789473684210527;0.421052631578947
Control.SRR15539824;41;40;0.317073170731707;28;13;0.182926829268293;0.317073170731707
Control.SRR15539824;42;40;0.523809523809524;20;22;0.0238095238095238;0.476190476190476
Control.SRR15539824;40;40;0.525;19;21;0.025;0.475
Control.SRR15539824;37;40;0.513513513513513;18;19;0.0135135135135135;0.486486486486487
Control.SRR15539824;39;40;0.538461538461538;18;21;0.0384615384615384;0.461538461538462
Control.SRR15539824;36;40;0.416666666666667;21;15;0.0833333333333333;0.416666666666667
Control.SRR15539824;38;40;0.473684210526316;20;18;0.0263157894736842;0.473684210526316
Control.SRR15539824;40;40;0.625;15;25;0.125;0.375
Control.SRR15539824;38;40;0.736842105263158;10;28;0.236842105263158;0.263157894736842
Control.SRR15539824;37;40;0.567567567567568;16;21;0.0675675675675675;0.432432432432432
Control.SRR15539824;40;40;0.55;18;22;0.05;0.45
Control.SRR15539824;39;40;0.641025641025641;14;25;0.141025641025641;0.358974358974359
Control.SRR15539824;40;40;0.525;19;21;0.025;0.475
Control.SRR15539824;35;40;0.4;21;14;0.1;0.4
Control.SRR15539824;45;40;0.488888888888889;23;22;0.0111111111111111;0.488888888888889
Control.SRR15539824;37;40;0.459459459459459;20;17;0.0405405405405405;0.459459459459459
Control.SRR15539824;39;40;0.435897435897436;22;17;0.0641025641025641;0.435897435897436
Control.SRR15539824;40;40;0.525;19;21;0.025;0.475
Control.SRR15539824;40;40;0.475;21;19;0.025;0.475
Control.SRR15539824;37;40;0.297297297297297;26;11;0.202702702702703;0.297297297297297
Control.SRR15539824;35;40;0.285714285714286;25;10;0.214285714285714;0.285714285714286
Control.SRR15539824;37;40;0.567567567567568;16;21;0.0675675675675675;0.432432432432432
Control.SRR15539824;42;40;0.476190476190476;22;20;0.0238095238095238;0.476190476190476
Control.SRR15539824;38;40;0.447368421052632;21;17;0.0526315789473684;0.447368421052632
Control.SRR15539824;45;40;0.622222222222222;17;28;0.122222222222222;0.377777777777778
Control.SRR15539824;41;40;0.560975609756098;18;23;0.0609756097560976;0.439024390243902
Control.SRR15539824;39;40;0.41025641025641;23;16;0.0897435897435898;0.41025641025641
Control.SRR15539824;44;40;0.477272727272727;23;21;0.0227272727272727;0.477272727272727
Control.SRR15539824;43;40;0.372093023255814;27;16;0.127906976744186;0.372093023255814
Control.SRR15539824;44;40;0.522727272727273;21;23;0.0227272727272727;0.477272727272727
Control.SRR15539824;42;40;0.595238095238095;17;25;0.0952380952380952;0.404761904761905
Control.SRR15539824;36;40;0.444444444444444;20;16;0.0555555555555556;0.444444444444444
Control.SRR15539824;44;40;0.340909090909091;29;15;0.159090909090909;0.340909090909091
Control.SRR15539824;43;40;0.627906976744186;16;27;0.127906976744186;0.372093023255814
Control.SRR15539824;42;40;0.571428571428571;18;24;0.0714285714285714;0.428571428571429
Control.SRR15539824;37;40;0.432432432432432;21;16;0.0675675675675675;0.432432432432432
Control.SRR15539824;42;40;0.5;21;21;0;0.5
Control.SRR15539824;44;40;0.386363636363636;27;17;0.113636363636364;0.386363636363636
Control.SRR15539824;41;40;0.463414634146341;22;19;0.0365853658536585;0.463414634146341
Control.SRR15539824;42;40;0.404761904761905;25;17;0.0952380952380952;0.404761904761905
Control.SRR15539824;37;40;0.27027027027027;27;10;0.22972972972973;0.27027027027027
Control.SRR15539824;37;40;0.459459459459459;20;17;0.0405405405405405;0.459459459459459
Control.SRR15539824;40;40;0.4;24;16;0.1;0.4
Control.SRR15539824;39;40;0.358974358974359;25;14;0.141025641025641;0.358974358974359
Control.SRR15539824;38;40;0.552631578947368;17;21;0.0526315789473685;0.447368421052632
Control.SRR15539824;43;40;0.581395348837209;18;25;0.0813953488372093;0.418604651162791
Control.SRR15539824;44;40;0.522727272727273;21;23;0.0227272727272727;0.477272727272727
Control.SRR15539824;42;40;0.547619047619048;19;23;0.0476190476190477;0.452380952380952
Control.SRR15539824;40;40;0.4;24;16;0.1;0.4
Control.SRR15539824;42;40;0.523809523809524;20;22;0.0238095238095238;0.476190476190476
Control.SRR15539824;36;40;0.472222222222222;19;17;0.0277777777777778;0.472222222222222
Control.SRR15539824;42;40;0.5;21;21;0;0.5
Control.SRR15539824;38;40;0.526315789473684;18;20;0.0263157894736842;0.473684210526316
Control.SRR15539824;38;40;0.526315789473684;18;20;0.0263157894736842;0.473684210526316
Control.SRR15539824;39;40;0.512820512820513;19;20;0.0128205128205128;0.487179487179487
Control.SRR15539824;44;40;0.431818181818182;25;19;0.0681818181818182;0.431818181818182
Control.SRR15539824;38;40;0.421052631578947;22;16;0.0789473684210527;0.421052631578947
Control.SRR15539824;39;40;0.358974358974359;25;14;0.141025641025641;0.358974358974359
Control.SRR15539824;44;40;0.454545454545455;24;20;0.0454545454545455;0.454545454545455
Control.SRR15539824;41;40;0.536585365853659;19;22;0.0365853658536586;0.463414634146341
Control.SRR15539824;42;40;0.571428571428571;18;24;0.0714285714285714;0.428571428571429
Control.SRR15539824;44;40;0.545454545454545;20;24;0.0454545454545454;0.454545454545455
Control.SRR15539824;39;40;0.41025641025641;23;16;0.0897435897435898;0.41025641025641
Control.SRR15539824;45;40;0.4;27;18;0.1;0.4
Control.SRR15539824;40;40;0.4;24;16;0.1;0.4
Control.SRR15539824;44;40;0.5;22;22;0;0.5
Control.SRR15539824;37;40;0.567567567567568;16;21;0.0675675675675675;0.432432432432432
Control.SRR15539824;43;40;0.581395348837209;18;25;0.0813953488372093;0.418604651162791
Control.SRR15539824;35;40;0.657142857142857;12;23;0.157142857142857;0.342857142857143
Control.SRR15539824;42;40;0.452380952380952;23;19;0.0476190476190476;0.452380952380952
Control.SRR15539824;36;40;0.416666666666667;21;15;0.0833333333333333;0.416666666666667
Control.SRR15539824;43;40;0.558139534883721;19;24;0.0581395348837209;0.441860465116279
Control.SRR15539824;44;40;0.522727272727273;21;23;0.0227272727272727;0.477272727272727
Control.SRR15539824;41;40;0.585365853658537;17;24;0.0853658536585366;0.414634146341463
Control.SRR15539824;35;40;0.514285714285714;17;18;0.0142857142857142;0.485714285714286
Control.SRR15539824;43;40;0.372093023255814;27;16;0.127906976744186;0.372093023255814
Control.SRR15539824;37;40;0.405405405405405;22;15;0.0945945945945946;0.405405405405405
Control.SRR15539824;39;40;0.512820512820513;19;20;0.0128205128205128;0.487179487179487
Control.SRR15539824;40;40;0.5;20;20;0;0.5
Control.SRR15539824;35;40;0.514285714285714;17;18;0.0142857142857142;0.485714285714286
Control.SRR15539824;38;40;0.5;19;19;0;0.5
Control.SRR15539824;38;40;0.447368421052632;21;17;0.0526315789473684;0.447368421052632
Control.SRR15539824;38;40;0.421052631578947;22;16;0.0789473684210527;0.421052631578947
Control.SRR15539824;37;40;0.486486486486487;19;18;0.0135135135135135;0.486486486486487
Control.SRR15539824;41;40;0.560975609756098;18;23;0.0609756097560976;0.439024390243902
Control.SRR15539824;41;40;0.390243902439024;25;16;0.109756097560976;0.390243902439024
Control.SRR15539824;41;40;0.536585365853659;19;22;0.0365853658536586;0.463414634146341
Control.SRR15539824;41;40;0.414634146341463;24;17;0.0853658536585366;0.414634146341463
Control.SRR15539824;45;40;0.555555555555556;20;25;0.0555555555555556;0.444444444444444
Control.SRR15539824;37;40;0.513513513513513;18;19;0.0135135135135135;0.486486486486487
Control.SRR15539824;40;40;0.45;22;18;0.05;0.45
Control.SRR15539824;40;40;0.45;22;18;0.05;0.45
Control.SRR15539824;42;40;0.476190476190476;22;20;0.0238095238095238;0.476190476190476
Control.SRR15539824;42;40;0.476190476190476;22;20;0.0238095238095238;0.476190476190476
Control.SRR15539824;43;40;0.465116279069767;23;20;0.0348837209302326;0.465116279069767
Control.SRR15539824;43;40;0.604651162790698;17;26;0.104651162790698;0.395348837209302
Control.SRR15539824;43;40;0.511627906976744;21;22;0.0116279069767442;0.488372093023256
Control.SRR15539824;36;40;0.5;18;18;0;0.5
Control.SRR15539824;44;40;0.5;22;22;0;0.5
Control.SRR15539824;44;40;0.5;22;22;0;0.5
Control.SRR15539824;44;40;0.409090909090909;26;18;0.0909090909090909;0.409090909090909
Control.SRR15539824;43;40;0.534883720930233;20;23;0.0348837209302325;0.465116279069767
Control.SRR15539824;43;40;0.511627906976744;21;22;0.0116279069767442;0.488372093023256
Control.SRR15539824;45;40;0.444444444444444;25;20;0.0555555555555556;0.444444444444444
Control.SRR15539824;41;40;0.463414634146341;22;19;0.0365853658536585;0.463414634146341
Control.SRR15539824;36;40;0.5;18;18;0;0.5
Control.SRR15539824;37;40;0.459459459459459;20;17;0.0405405405405405;0.459459459459459
Control.SRR15539824;45;40;0.488888888888889;23;22;0.0111111111111111;0.488888888888889
Control.SRR15539824;45;40;0.488888888888889;23;22;0.0111111111111111;0.488888888888889
Control.SRR15539824;37;40;0.486486486486487;19;18;0.0135135135135135;0.486486486486487
Control.SRR15539824;37;40;0.432432432432432;21;16;0.0675675675675675;0.432432432432432
Control.SRR15539824;36;40;0.583333333333333;15;21;0.0833333333333334;0.416666666666667
Control.SRR15539824;44;40;0.568181818181818;19;25;0.0681818181818182;0.431818181818182
Control.SRR15539824;37;40;0.324324324324324;25;12;0.175675675675676;0.324324324324324
Control.SRR15539824;39;40;0.487179487179487;20;19;0.0128205128205128;0.487179487179487
Control.SRR15539824;35;40;0.571428571428571;15;20;0.0714285714285714;0.428571428571429
Control.SRR15539824;39;40;0.384615384615385;24;15;0.115384615384615;0.384615384615385
Control.SRR15539824;44;40;0.568181818181818;19;25;0.0681818181818182;0.431818181818182
Control.SRR15539824;39;40;0.435897435897436;22;17;0.0641025641025641;0.435897435897436
Control.SRR15539824;35;40;0.514285714285714;17;18;0.0142857142857142;0.485714285714286
Control.SRR15539824;45;40;0.488888888888889;23;22;0.0111111111111111;0.488888888888889
Control.SRR15539824;45;40;0.622222222222222;17;28;0.122222222222222;0.377777777777778
Control.SRR15539824;35;40;0.428571428571429;20;15;0.0714285714285715;0.428571428571429
Control.SRR15539824;39;40;0.538461538461538;18;21;0.0384615384615384;0.461538461538462
Control.SRR15539824;38;40;0.421052631578947;22;16;0.0789473684210527;0.421052631578947
Control.SRR15539824;44;40;0.431818181818182;25;19;0.0681818181818182;0.431818181818182
Control.SRR15539824;38;40;0.526315789473684;18;20;0.0263157894736842;0.473684210526316
Control.SRR15539824;45;40;0.422222222222222;26;19;0.0777777777777778;0.422222222222222
Control.SRR15539824;44;40;0.522727272727273;21;23;0.0227272727272727;0.477272727272727
Control.SRR15539824;44;40;0.477272727272727;23;21;0.0227272727272727;0.477272727272727
Control.SRR15539824;44;40;0.522727272727273;21;23;0.0227272727272727;0.477272727272727
Control.SRR15539824;42;40;0.523809523809524;20;22;0.0238095238095238;0.476190476190476
Control.SRR15539824;40;40;0.475;21;19;0.025;0.475
Control.SRR15539824;38;40;0.552631578947368;17;21;0.0526315789473685;0.447368421052632
Control.SRR15539824;35;40;0.457142857142857;19;16;0.0428571428571429;0.457142857142857
Control.SRR15539824;37;40;0.405405405405405;22;15;0.0945945945945946;0.405405405405405
Control.SRR15539824;42;40;0.595238095238095;17;25;0.0952380952380952;0.404761904761905
Control.SRR15539824;41;40;0.390243902439024;25;16;0.109756097560976;0.390243902439024
Control.SRR15539824;39;40;0.58974358974359;16;23;0.0897435897435898;0.41025641025641
Control.SRR15539824;42;40;0.357142857142857;27;15;0.142857142857143;0.357142857142857
Control.SRR15539824;41;40;0.51219512195122;20;21;0.0121951219512195;0.48780487804878
Control.SRR15539824;36;40;0.444444444444444;20;16;0.0555555555555556;0.444444444444444
Control.SRR15539824;39;40;0.41025641025641;23;16;0.0897435897435898;0.41025641025641
Control.SRR15539824;38;40;0.578947368421053;16;22;0.0789473684210527;0.421052631578947
Control.SRR15539824;37;40;0.405405405405405;22;15;0.0945945945945946;0.405405405405405
Control.SRR15539824;43;40;0.465116279069767;23;20;0.0348837209302326;0.465116279069767
Control.SRR15539824;37;40;0.459459459459459;20;17;0.0405405405405405;0.459459459459459
Control.SRR15539824;38;40;0.368421052631579;24;14;0.131578947368421;0.368421052631579
Control.SRR15539824;36;40;0.472222222222222;19;17;0.0277777777777778;0.472222222222222
Control.SRR15539824;38;40;0.552631578947368;17;21;0.0526315789473685;0.447368421052632
Control.SRR15539824;35;40;0.428571428571429;20;15;0.0714285714285715;0.428571428571429
Control.SRR15539824;41;40;0.536585365853659;19;22;0.0365853658536586;0.463414634146341
Control.SRR15539824;37;40;0.540540540540541;17;20;0.0405405405405406;0.459459459459459
Control.SRR15539824;36;40;0.527777777777778;17;19;0.0277777777777778;0.472222222222222
Control.SRR15539824;37;40;0.540540540540541;17;20;0.0405405405405406;0.459459459459459
Control.SRR15539824;39;40;0.58974358974359;16;23;0.0897435897435898;0.41025641025641
Control.SRR15539824;38;40;0.526315789473684;18;20;0.0263157894736842;0.473684210526316
Control.SRR15539824;36;40;0.638888888888889;13;23;0.138888888888889;0.361111111111111
Control.SRR15539824;38;40;0.552631578947368;17;21;0.0526315789473685;0.447368421052632
Control.SRR15539824;38;40;0.578947368421053;16;22;0.0789473684210527;0.421052631578947
Control.SRR15539824;36;40;0.527777777777778;17;19;0.0277777777777778;0.472222222222222
Control.SRR15539824;35;40;0.514285714285714;17;18;0.0142857142857142;0.485714285714286
Control.SRR15539824;37;40;0.567567567567568;16;21;0.0675675675675675;0.432432432432432
Control.SRR15539824;36;40;0.527777777777778;17;19;0.0277777777777778;0.472222222222222
Control.SRR15539824;39;40;0.538461538461538;18;21;0.0384615384615384;0.461538461538462
Control.SRR15539824;35;40;0.514285714285714;17;18;0.0142857142857142;0.485714285714286
Control.SRR15539824;36;40;0.444444444444444;20;16;0.0555555555555556;0.444444444444444
Control.SRR15539824;35;40;0.571428571428571;15;20;0.0714285714285714;0.428571428571429
Control.SRR15539824;40;40;0.45;22;18;0.05;0.45
Control.SRR15539824;43;40;0.511627906976744;21;22;0.0116279069767442;0.488372093023256
Control.SRR15539824;35;40;0.485714285714286;18;17;0.0142857142857143;0.485714285714286
Control.SRR15539824;35;40;0.314285714285714;24;11;0.185714285714286;0.314285714285714
Control.SRR15539824;42;40;0.619047619047619;16;26;0.119047619047619;0.380952380952381
Control.SRR15539824;40;40;0.65;14;26;0.15;0.35
Control.SRR15539824;42;40;0.404761904761905;25;17;0.0952380952380952;0.404761904761905
Control.SRR15539824;40;40;0.425;23;17;0.075;0.425
Control.SRR15539824;37;40;0.351351351351351;24;13;0.148648648648649;0.351351351351351
Control.SRR15539824;37;40;0.432432432432432;21;16;0.0675675675675675;0.432432432432432
Control.SRR15539824;38;40;0.447368421052632;21;17;0.0526315789473684;0.447368421052632
Control.SRR15539824;40;40;0.55;18;22;0.05;0.45
Control.SRR15539824;36;40;0.472222222222222;19;17;0.0277777777777778;0.472222222222222
Control.SRR15539824;41;40;0.536585365853659;19;22;0.0365853658536586;0.463414634146341
Control.SRR15539824;42;40;0.428571428571429;24;18;0.0714285714285715;0.428571428571429
Control.SRR15539824;44;40;0.5;22;22;0;0.5
Control.SRR15539824;42;40;0.571428571428571;18;24;0.0714285714285714;0.428571428571429
Control.SRR15539824;39;40;0.461538461538462;21;18;0.0384615384615384;0.461538461538462
Control.SRR15539824;35;40;0.457142857142857;19;16;0.0428571428571429;0.457142857142857
Control.SRR15539824;36;40;0.527777777777778;17;19;0.0277777777777778;0.472222222222222
Control.SRR15539824;40;40;0.475;21;19;0.025;0.475
Control.SRR15539824;40;40;0.5;20;20;0;0.5
Control.SRR15539824;41;40;0.439024390243902;23;18;0.0609756097560976;0.439024390243902
Control.SRR15539824;43;40;0.418604651162791;25;18;0.0813953488372093;0.418604651162791
Control.SRR15539824;45;40;0.533333333333333;21;24;0.0333333333333333;0.466666666666667
Control.SRR15539824;35;40;0.485714285714286;18;17;0.0142857142857143;0.485714285714286
Control.SRR15539824;35;40;0.514285714285714;17;18;0.0142857142857142;0.485714285714286
Control.SRR15539824;43;40;0.697674418604651;13;30;0.197674418604651;0.302325581395349
Control.SRR15539824;44;40;0.545454545454545;20;24;0.0454545454545454;0.454545454545455
Control.SRR15539824;44;40;0.568181818181818;19;25;0.0681818181818182;0.431818181818182
Control.SRR15539824;36;40;0.472222222222222;19;17;0.0277777777777778;0.472222222222222
Control.SRR15539824;37;40;0.513513513513513;18;19;0.0135135135135135;0.486486486486487
Control.SRR15539824;38;40;0.526315789473684;18;20;0.0263157894736842;0.473684210526316
Control.SRR15539824;41;40;0.439024390243902;23;18;0.0609756097560976;0.439024390243902
Control.SRR15539824;43;40;0.534883720930233;20;23;0.0348837209302325;0.465116279069767
Control.SRR15539824;42;40;0.476190476190476;22;20;0.0238095238095238;0.476190476190476
Control.SRR15539824;43;40;0.488372093023256;22;21;0.0116279069767442;0.488372093023256
Control.SRR15539824;37;40;0.540540540540541;17;20;0.0405405405405406;0.459459459459459
Control.SRR15539824;40;40;0.325;27;13;0.175;0.325
Control.SRR15539824;35;40;0.485714285714286;18;17;0.0142857142857143;0.485714285714286
Control.SRR15539824;45;40;0.644444444444444;16;29;0.144444444444444;0.355555555555556
Control.SRR15539824;38;40;0.315789473684211;26;12;0.184210526315789;0.315789473684211
Control.SRR15539824;39;40;0.512820512820513;19;20;0.0128205128205128;0.487179487179487
Control.SRR15539824;44;40;0.522727272727273;21;23;0.0227272727272727;0.477272727272727
Control.SRR15539824;36;40;0.527777777777778;17;19;0.0277777777777778;0.472222222222222
Control.SRR15539824;41;40;0.51219512195122;20;21;0.0121951219512195;0.48780487804878
Control.SRR15539824;43;40;0.534883720930233;20;23;0.0348837209302325;0.465116279069767
Control.SRR15539824;45;40;0.555555555555556;20;25;0.0555555555555556;0.444444444444444
Control.SRR15539824;37;40;0.324324324324324;25;12;0.175675675675676;0.324324324324324
Control.SRR15539824;44;40;0.590909090909091;18;26;0.0909090909090909;0.409090909090909
Control.SRR15539824;39;40;0.615384615384615;15;24;0.115384615384615;0.384615384615385
Control.SRR15539824;39;40;0.435897435897436;22;17;0.0641025641025641;0.435897435897436
Control.SRR15539824;39;40;0.564102564102564;17;22;0.0641025641025641;0.435897435897436
Control.SRR15539824;38;40;0.526315789473684;18;20;0.0263157894736842;0.473684210526316
Control.SRR15539824;37;40;0.567567567567568;16;21;0.0675675675675675;0.432432432432432
Control.SRR15539824;45;40;0.355555555555556;29;16;0.144444444444444;0.355555555555556
Control.SRR15539824;37;40;0.567567567567568;16;21;0.0675675675675675;0.432432432432432
Control.SRR15539824;45;40;0.466666666666667;24;21;0.0333333333333333;0.466666666666667
Control.SRR15539824;37;40;0.567567567567568;16;21;0.0675675675675675;0.432432432432432
Control.SRR15539824;35;40;0.6;14;21;0.1;0.4
Control.SRR15539824;35;40;0.6;14;21;0.1;0.4
Control.SRR15539824;35;40;0.571428571428571;15;20;0.0714285714285714;0.428571428571429
Control.SRR15539824;37;40;0.486486486486487;19;18;0.0135135135135135;0.486486486486487
Control.SRR15539824;45;40;0.444444444444444;25;20;0.0555555555555556;0.444444444444444
Control.SRR15539824;39;40;0.487179487179487;20;19;0.0128205128205128;0.487179487179487
Control.SRR15539824;41;40;0.560975609756098;18;23;0.0609756097560976;0.439024390243902
Control.SRR15539824;45;40;0.488888888888889;23;22;0.0111111111111111;0.488888888888889
Control.SRR15539824;36;40;0.333333333333333;24;12;0.166666666666667;0.333333333333333
Control.SRR15539824;40;40;0.45;22;18;0.05;0.45
Control.SRR15539824;45;40;0.622222222222222;17;28;0.122222222222222;0.377777777777778
Control.SRR15539824;45;40;0.422222222222222;26;19;0.0777777777777778;0.422222222222222
Control.SRR15539824;37;40;0.594594594594595;15;22;0.0945945945945946;0.405405405405405
Control.SRR15539824;35;40;0.485714285714286;18;17;0.0142857142857143;0.485714285714286
Control.SRR15539824;39;40;0.358974358974359;25;14;0.141025641025641;0.358974358974359
Control.SRR15539824;38;40;0.447368421052632;21;17;0.0526315789473684;0.447368421052632
Control.SRR15539824;43;40;0.627906976744186;16;27;0.127906976744186;0.372093023255814
Control.SRR15539824;40;40;0.6;16;24;0.1;0.4
Control.SRR15539824;40;40;0.425;23;17;0.075;0.425
Control.SRR15539824;42;40;0.547619047619048;19;23;0.0476190476190477;0.452380952380952
Control.SRR15539824;44;40;0.636363636363636;16;28;0.136363636363636;0.363636363636364
Control.SRR15539824;43;40;0.441860465116279;24;19;0.0581395348837209;0.441860465116279
Control.SRR15539824;37;40;0.648648648648649;13;24;0.148648648648649;0.351351351351351
Control.SRR15539824;38;40;0.526315789473684;18;20;0.0263157894736842;0.473684210526316
Control.SRR15539824;36;40;0.416666666666667;21;15;0.0833333333333333;0.416666666666667
Control.SRR15539824;42;40;0.5;21;21;0;0.5
Control.SRR15539824;40;40;0.425;23;17;0.075;0.425
Control.SRR15539824;41;40;0.536585365853659;19;22;0.0365853658536586;0.463414634146341
Control.SRR15539824;41;40;0.48780487804878;21;20;0.0121951219512195;0.48780487804878
Control.SRR15539824;39;40;0.564102564102564;17;22;0.0641025641025641;0.435897435897436
Control.SRR15539824;36;40;0.555555555555556;16;20;0.0555555555555556;0.444444444444444
Control.SRR15539824;41;40;0.48780487804878;21;20;0.0121951219512195;0.48780487804878
Control.SRR15539824;37;40;0.567567567567568;16;21;0.0675675675675675;0.432432432432432
Control.SRR15539824;39;40;0.615384615384615;15;24;0.115384615384615;0.384615384615385
Control.SRR15539824;39;40;0.538461538461538;18;21;0.0384615384615384;0.461538461538462
Control.SRR15539824;41;40;0.414634146341463;24;17;0.0853658536585366;0.414634146341463
Control.SRR15539824;40;40;0.5;20;20;0;0.5
Control.SRR15539824;38;40;0.552631578947368;17;21;0.0526315789473685;0.447368421052632
Control.SRR15539824;36;40;0.555555555555556;16;20;0.0555555555555556;0.444444444444444
Control.SRR15539824;37;40;0.459459459459459;20;17;0.0405405405405405;0.459459459459459
Control.SRR15539824;34;40;0.5;17;17;0;0.5
Control.SRR15539824;37;40;0.540540540540541;17;20;0.0405405405405406;0.459459459459459
Control.SRR15539824;37;40;0.621621621621622;14;23;0.121621621621622;0.378378378378378
Control.SRR15539824;42;40;0.476190476190476;22;20;0.0238095238095238;0.476190476190476
Control.SRR15539824;42;40;0.547619047619048;19;23;0.0476190476190477;0.452380952380952
Control.SRR15539824;43;40;0.534883720930233;20;23;0.0348837209302325;0.465116279069767
Control.SRR15539824;41;40;0.365853658536585;26;15;0.134146341463415;0.365853658536585
Control.SRR15539824;38;40;0.421052631578947;22;16;0.0789473684210527;0.421052631578947
Control.SRR15539824;36;40;0.5;18;18;0;0.5
Control.SRR15539824;36;40;0.5;18;18;0;0.5
Control.SRR15539824;41;40;0.439024390243902;23;18;0.0609756097560976;0.439024390243902
Control.SRR15539824;36;40;0.277777777777778;26;10;0.222222222222222;0.277777777777778
Control.SRR15539824;34;40;0.617647058823529;13;21;0.117647058823529;0.382352941176471
Control.SRR15539824;42;40;0.571428571428571;18;24;0.0714285714285714;0.428571428571429
Control.SRR15539824;34;40;0.558823529411765;15;19;0.0588235294117647;0.441176470588235
Control.SRR15539824;40;40;0.4;24;16;0.1;0.4
Control.SRR15539824;36;40;0.611111111111111;14;22;0.111111111111111;0.388888888888889
Control.SRR15539824;36;40;0.305555555555556;25;11;0.194444444444444;0.305555555555556
Control.SRR15539824;36;40;0.472222222222222;19;17;0.0277777777777778;0.472222222222222
Control.SRR15539824;39;40;0.435897435897436;22;17;0.0641025641025641;0.435897435897436
Control.SRR15539824;43;40;0.651162790697674;15;28;0.151162790697674;0.348837209302326
Control.SRR15539824;36;40;0.583333333333333;15;21;0.0833333333333334;0.416666666666667
Control.SRR15539824;35;40;0.542857142857143;16;19;0.0428571428571428;0.457142857142857
Control.SRR15539824;37;40;0.540540540540541;17;20;0.0405405405405406;0.459459459459459
Control.SRR15539824;34;40;0.5;17;17;0;0.5
Control.SRR15539824;36;40;0.416666666666667;21;15;0.0833333333333333;0.416666666666667
Control.SRR15539824;37;40;0.432432432432432;21;16;0.0675675675675675;0.432432432432432
Control.SRR15539824;42;40;0.5;21;21;0;0.5
Control.SRR15539824;35;40;0.542857142857143;16;19;0.0428571428571428;0.457142857142857
Control.SRR15539824;38;40;0.578947368421053;16;22;0.0789473684210527;0.421052631578947
Control.SRR15539824;37;40;0.513513513513513;18;19;0.0135135135135135;0.486486486486487
Control.SRR15539824;39;40;0.435897435897436;22;17;0.0641025641025641;0.435897435897436
Control.SRR15539824;35;40;0.457142857142857;19;16;0.0428571428571429;0.457142857142857
Control.SRR15539824;37;40;0.459459459459459;20;17;0.0405405405405405;0.459459459459459
Control.SRR15539824;41;40;0.48780487804878;21;20;0.0121951219512195;0.48780487804878
Control.SRR15539824;44;40;0.409090909090909;26;18;0.0909090909090909;0.409090909090909
Control.SRR15539824;35;40;0.514285714285714;17;18;0.0142857142857142;0.485714285714286
Control.SRR15539824;43;40;0.418604651162791;25;18;0.0813953488372093;0.418604651162791
Control.SRR15539824;42;40;0.595238095238095;17;25;0.0952380952380952;0.404761904761905
Control.SRR15539824;40;40;0.525;19;21;0.025;0.475
Control.SRR15539824;34;40;0.382352941176471;21;13;0.117647058823529;0.382352941176471
Control.SRR15539824;39;40;0.358974358974359;25;14;0.141025641025641;0.358974358974359
Control.SRR15539824;37;40;0.486486486486487;19;18;0.0135135135135135;0.486486486486487
Control.SRR15539824;41;40;0.463414634146341;22;19;0.0365853658536585;0.463414634146341
Control.SRR15539824;38;40;0.5;19;19;0;0.5
Control.SRR15539824;35;40;0.457142857142857;19;16;0.0428571428571429;0.457142857142857
Control.SRR15539824;36;40;0.444444444444444;20;16;0.0555555555555556;0.444444444444444
Control.SRR15539824;39;40;0.512820512820513;19;20;0.0128205128205128;0.487179487179487
Control.SRR15539824;34;40;0.558823529411765;15;19;0.0588235294117647;0.441176470588235
Control.SRR15539824;40;40;0.425;23;17;0.075;0.425
Control.SRR15539824;34;40;0.676470588235294;11;23;0.176470588235294;0.323529411764706
Control.SRR15539824;37;40;0.486486486486487;19;18;0.0135135135135135;0.486486486486487
Control.SRR15539824;34;40;0.529411764705882;16;18;0.0294117647058824;0.470588235294118
Control.SRR15539824;42;40;0.5;21;21;0;0.5
Control.SRR15539824;40;40;0.55;18;22;0.05;0.45
Control.SRR15539824;38;40;0.421052631578947;22;16;0.0789473684210527;0.421052631578947
Control.SRR15539824;38;40;0.473684210526316;20;18;0.0263157894736842;0.473684210526316
Control.SRR15539824;37;40;0.621621621621622;14;23;0.121621621621622;0.378378378378378
Control.SRR15539824;44;40;0.454545454545455;24;20;0.0454545454545455;0.454545454545455
Control.SRR15539824;39;40;0.538461538461538;18;21;0.0384615384615384;0.461538461538462
Control.SRR15539824;41;40;0.463414634146341;22;19;0.0365853658536585;0.463414634146341
Control.SRR15539824;36;40;0.555555555555556;16;20;0.0555555555555556;0.444444444444444
Control.SRR15539824;37;40;0.486486486486487;19;18;0.0135135135135135;0.486486486486487
Control.SRR15539824;37;40;0.567567567567568;16;21;0.0675675675675675;0.432432432432432
Control.SRR15539824;44;40;0.545454545454545;20;24;0.0454545454545454;0.454545454545455
Control.SRR15539824;42;40;0.452380952380952;23;19;0.0476190476190476;0.452380952380952
Control.SRR15539824;42;40;0.595238095238095;17;25;0.0952380952380952;0.404761904761905
Control.SRR15539824;37;40;0.513513513513513;18;19;0.0135135135135135;0.486486486486487
Control.SRR15539824;36;40;0.444444444444444;20;16;0.0555555555555556;0.444444444444444
Control.SRR15539824;41;40;0.463414634146341;22;19;0.0365853658536585;0.463414634146341
Control.SRR15539824;34;40;0.558823529411765;15;19;0.0588235294117647;0.441176470588235
Control.SRR15539824;44;40;0.386363636363636;27;17;0.113636363636364;0.386363636363636
Control.SRR15539824;38;40;0.447368421052632;21;17;0.0526315789473684;0.447368421052632
Control.SRR15539824;34;40;0.617647058823529;13;21;0.117647058823529;0.382352941176471
Control.SRR15539824;43;40;0.441860465116279;24;19;0.0581395348837209;0.441860465116279
Control.SRR15539824;36;40;0.666666666666667;12;24;0.166666666666667;0.333333333333333
Control.SRR15539824;35;40;0.685714285714286;11;24;0.185714285714286;0.314285714285714
Control.SRR15539824;42;40;0.523809523809524;20;22;0.0238095238095238;0.476190476190476
Control.SRR15539824;36;40;0.472222222222222;19;17;0.0277777777777778;0.472222222222222
Control.SRR15539824;40;40;0.525;19;21;0.025;0.475
Control.SRR15539824;39;40;0.487179487179487;20;19;0.0128205128205128;0.487179487179487
Control.SRR15539824;40;40;0.5;20;20;0;0.5
Control.SRR15539824;35;40;0.485714285714286;18;17;0.0142857142857143;0.485714285714286
Control.SRR15539824;35;40;0.657142857142857;12;23;0.157142857142857;0.342857142857143
Control.SRR15539824;36;40;0.472222222222222;19;17;0.0277777777777778;0.472222222222222
Control.SRR15539824;35;40;0.342857142857143;23;12;0.157142857142857;0.342857142857143
Control.SRR15539824;39;40;0.435897435897436;22;17;0.0641025641025641;0.435897435897436
Control.SRR15539824;42;40;0.476190476190476;22;20;0.0238095238095238;0.476190476190476
Control.SRR15539824;36;40;0.361111111111111;23;13;0.138888888888889;0.361111111111111
Control.SRR15539824;41;40;0.365853658536585;26;15;0.134146341463415;0.365853658536585
Control.SRR15539824;36;40;0.416666666666667;21;15;0.0833333333333333;0.416666666666667
Control.SRR15539824;35;40;0.428571428571429;20;15;0.0714285714285715;0.428571428571429
Control.SRR15539824;40;40;0.425;23;17;0.075;0.425
Control.SRR15539824;40;40;0.5;20;20;0;0.5
Control.SRR15539824;40;40;0.675;13;27;0.175;0.325
Control.SRR15539824;35;40;0.485714285714286;18;17;0.0142857142857143;0.485714285714286
Control.SRR15539824;36;40;0.472222222222222;19;17;0.0277777777777778;0.472222222222222
Control.SRR15539824;38;40;0.552631578947368;17;21;0.0526315789473685;0.447368421052632
Control.SRR15539824;43;40;0.511627906976744;21;22;0.0116279069767442;0.488372093023256
Control.SRR15539824;42;40;0.523809523809524;20;22;0.0238095238095238;0.476190476190476
Control.SRR15539824;37;40;0.540540540540541;17;20;0.0405405405405406;0.459459459459459
Control.SRR15539824;36;40;0.527777777777778;17;19;0.0277777777777778;0.472222222222222
Control.SRR15539824;44;40;0.568181818181818;19;25;0.0681818181818182;0.431818181818182
Control.SRR15539824;38;40;0.605263157894737;15;23;0.105263157894737;0.394736842105263
Control.SRR15539824;38;40;0.578947368421053;16;22;0.0789473684210527;0.421052631578947
Control.SRR15539824;39;40;0.384615384615385;24;15;0.115384615384615;0.384615384615385
Control.SRR15539824;34;40;0.441176470588235;19;15;0.0588235294117647;0.441176470588235
Control.SRR15539824;35;40;0.657142857142857;12;23;0.157142857142857;0.342857142857143
Control.SRR15539824;37;40;0.594594594594595;15;22;0.0945945945945946;0.405405405405405
Control.SRR15539824;37;40;0.513513513513513;18;19;0.0135135135135135;0.486486486486487
Control.SRR15539824;38;40;0.5;19;19;0;0.5
Control.SRR15539824;39;40;0.487179487179487;20;19;0.0128205128205128;0.487179487179487
Control.SRR15539824;38;40;0.526315789473684;18;20;0.0263157894736842;0.473684210526316
Control.SRR15539824;37;40;0.432432432432432;21;16;0.0675675675675675;0.432432432432432
Control.SRR15539824;35;40;0.4;21;14;0.1;0.4
Control.SRR15539824;39;40;0.512820512820513;19;20;0.0128205128205128;0.487179487179487
Control.SRR15539824;38;40;0.447368421052632;21;17;0.0526315789473684;0.447368421052632
Control.SRR15539824;39;40;0.538461538461538;18;21;0.0384615384615384;0.461538461538462
Control.SRR15539824;41;40;0.536585365853659;19;22;0.0365853658536586;0.463414634146341
Control.SRR15539824;36;40;0.472222222222222;19;17;0.0277777777777778;0.472222222222222
Control.SRR15539824;39;40;0.564102564102564;17;22;0.0641025641025641;0.435897435897436
Control.SRR15539824;42;40;0.452380952380952;23;19;0.0476190476190476;0.452380952380952
Control.SRR15539824;39;40;0.384615384615385;24;15;0.115384615384615;0.384615384615385
Control.SRR15539824;44;40;0.409090909090909;26;18;0.0909090909090909;0.409090909090909
Control.SRR15539824;42;40;0.642857142857143;15;27;0.142857142857143;0.357142857142857
Control.SRR15539824;43;40;0.581395348837209;18;25;0.0813953488372093;0.418604651162791
Control.SRR15539824;43;40;0.488372093023256;22;21;0.0116279069767442;0.488372093023256
Control.SRR15539824;38;40;0.473684210526316;20;18;0.0263157894736842;0.473684210526316
Control.SRR15539824;41;40;0.560975609756098;18;23;0.0609756097560976;0.439024390243902
Control.SRR15539824;36;40;0.666666666666667;12;24;0.166666666666667;0.333333333333333
Control.SRR15539824;36;40;0.444444444444444;20;16;0.0555555555555556;0.444444444444444
Control.SRR15539824;40;40;0.675;13;27;0.175;0.325
Control.SRR15539824;43;40;0.441860465116279;24;19;0.0581395348837209;0.441860465116279
Control.SRR15539824;34;40;0.411764705882353;20;14;0.0882352941176471;0.411764705882353
Control.SRR15539824;42;40;0.523809523809524;20;22;0.0238095238095238;0.476190476190476
Control.SRR15539824;34;40;0.382352941176471;21;13;0.117647058823529;0.382352941176471
Control.SRR15539824;38;40;0.473684210526316;20;18;0.0263157894736842;0.473684210526316
Control.SRR15539824;43;40;0.558139534883721;19;24;0.0581395348837209;0.441860465116279
Control.SRR15539824;44;40;0.409090909090909;26;18;0.0909090909090909;0.409090909090909
Control.SRR15539824;40;40;0.325;27;13;0.175;0.325
Control.SRR15539824;39;40;0.461538461538462;21;18;0.0384615384615384;0.461538461538462
Control.SRR15539824;41;40;0.51219512195122;20;21;0.0121951219512195;0.48780487804878
Control.SRR15539824;40;40;0.4;24;16;0.1;0.4
Control.SRR15539824;43;40;0.558139534883721;19;24;0.0581395348837209;0.441860465116279
Control.SRR15539824;43;40;0.395348837209302;26;17;0.104651162790698;0.395348837209302
Control.SRR15539824;34;40;0.647058823529412;12;22;0.147058823529412;0.352941176470588
Control.SRR15539824;43;40;0.511627906976744;21;22;0.0116279069767442;0.488372093023256
Control.SRR15539824;44;40;0.568181818181818;19;25;0.0681818181818182;0.431818181818182
Control.SRR15539824;35;40;0.428571428571429;20;15;0.0714285714285715;0.428571428571429
Control.SRR15539824;42;40;0.476190476190476;22;20;0.0238095238095238;0.476190476190476
Control.SRR15539824;38;40;0.631578947368421;14;24;0.131578947368421;0.368421052631579
Control.SRR15539824;43;40;0.441860465116279;24;19;0.0581395348837209;0.441860465116279
Control.SRR15539824;44;40;0.409090909090909;26;18;0.0909090909090909;0.409090909090909
Control.SRR15539824;39;40;0.512820512820513;19;20;0.0128205128205128;0.487179487179487
Control.SRR15539824;38;40;0.605263157894737;15;23;0.105263157894737;0.394736842105263
Control.SRR15539824;37;40;0.351351351351351;24;13;0.148648648648649;0.351351351351351
Control.SRR15539824;39;40;0.564102564102564;17;22;0.0641025641025641;0.435897435897436
Control.SRR15539824;37;40;0.513513513513513;18;19;0.0135135135135135;0.486486486486487
Control.SRR15539824;37;40;0.567567567567568;16;21;0.0675675675675675;0.432432432432432
Control.SRR15539824;42;40;0.619047619047619;16;26;0.119047619047619;0.380952380952381
Control.SRR15539824;38;40;0.368421052631579;24;14;0.131578947368421;0.368421052631579
Control.SRR15539824;41;40;0.390243902439024;25;16;0.109756097560976;0.390243902439024
Control.SRR15539824;37;40;0.405405405405405;22;15;0.0945945945945946;0.405405405405405
Control.SRR15539824;43;40;0.441860465116279;24;19;0.0581395348837209;0.441860465116279
Control.SRR15539824;43;40;0.627906976744186;16;27;0.127906976744186;0.372093023255814
Control.SRR15539824;37;40;0.351351351351351;24;13;0.148648648648649;0.351351351351351
Control.SRR15539824;34;40;0.5;17;17;0;0.5
Control.SRR15539824;38;40;0.473684210526316;20;18;0.0263157894736842;0.473684210526316
Control.SRR15539824;43;40;0.511627906976744;21;22;0.0116279069767442;0.488372093023256
Control.SRR15539824;43;40;0.418604651162791;25;18;0.0813953488372093;0.418604651162791
Control.SRR15539824;44;40;0.454545454545455;24;20;0.0454545454545455;0.454545454545455
Control.SRR15539824;41;40;0.585365853658537;17;24;0.0853658536585366;0.414634146341463
Control.SRR15539824;41;40;0.463414634146341;22;19;0.0365853658536585;0.463414634146341
Control.SRR15539824;39;40;0.512820512820513;19;20;0.0128205128205128;0.487179487179487
Control.SRR15539824;38;40;0.5;19;19;0;0.5
Control.SRR15539824;36;40;0.388888888888889;22;14;0.111111111111111;0.388888888888889
Control.SRR15539824;34;40;0.558823529411765;15;19;0.0588235294117647;0.441176470588235
Control.SRR15539824;41;40;0.51219512195122;20;21;0.0121951219512195;0.48780487804878
Control.SRR15539824;35;40;0.428571428571429;20;15;0.0714285714285715;0.428571428571429
Control.SRR15539824;39;40;0.666666666666667;13;26;0.166666666666667;0.333333333333333
Control.SRR15539824;43;40;0.488372093023256;22;21;0.0116279069767442;0.488372093023256
Control.SRR15539824;34;40;0.470588235294118;18;16;0.0294117647058824;0.470588235294118
Control.SRR15539824;35;40;0.657142857142857;12;23;0.157142857142857;0.342857142857143
Control.SRR15539824;34;40;0.588235294117647;14;20;0.0882352941176471;0.411764705882353
Control.SRR15539824;42;40;0.547619047619048;19;23;0.0476190476190477;0.452380952380952
Control.SRR15539824;40;40;0.55;18;22;0.05;0.45
Control.SRR15539824;43;40;0.418604651162791;25;18;0.0813953488372093;0.418604651162791
Control.SRR15539824;37;40;0.513513513513513;18;19;0.0135135135135135;0.486486486486487
Control.SRR15539824;42;40;0.333333333333333;28;14;0.166666666666667;0.333333333333333
Control.SRR15539824;41;40;0.560975609756098;18;23;0.0609756097560976;0.439024390243902
Control.SRR15539824;36;40;0.416666666666667;21;15;0.0833333333333333;0.416666666666667
Control.SRR15539824;35;40;0.514285714285714;17;18;0.0142857142857142;0.485714285714286
Control.SRR15539824;35;40;0.628571428571429;13;22;0.128571428571429;0.371428571428571
Control.SRR15539824;39;40;0.615384615384615;15;24;0.115384615384615;0.384615384615385
Control.SRR15539824;41;40;0.414634146341463;24;17;0.0853658536585366;0.414634146341463
Control.SRR15539824;43;40;0.465116279069767;23;20;0.0348837209302326;0.465116279069767
Control.SRR15539824;42;40;0.523809523809524;20;22;0.0238095238095238;0.476190476190476
Control.SRR15539824;39;40;0.487179487179487;20;19;0.0128205128205128;0.487179487179487
Control.SRR15539824;37;40;0.486486486486487;19;18;0.0135135135135135;0.486486486486487
Control.SRR15539824;38;40;0.447368421052632;21;17;0.0526315789473684;0.447368421052632
Control.SRR15539824;36;40;0.583333333333333;15;21;0.0833333333333334;0.416666666666667
Control.SRR15539824;41;40;0.414634146341463;24;17;0.0853658536585366;0.414634146341463
Control.SRR15539824;37;40;0.621621621621622;14;23;0.121621621621622;0.378378378378378
Control.SRR15539824;34;40;0.441176470588235;19;15;0.0588235294117647;0.441176470588235
Control.SRR15539824;39;40;0.538461538461538;18;21;0.0384615384615384;0.461538461538462
Control.SRR15539824;44;40;0.363636363636364;28;16;0.136363636363636;0.363636363636364
Control.SRR15539824;35;40;0.542857142857143;16;19;0.0428571428571428;0.457142857142857
Control.SRR15539824;36;40;0.388888888888889;22;14;0.111111111111111;0.388888888888889
Control.SRR15539824;35;40;0.485714285714286;18;17;0.0142857142857143;0.485714285714286
Control.SRR15539824;34;40;0.5;17;17;0;0.5
Control.SRR15539824;41;40;0.48780487804878;21;20;0.0121951219512195;0.48780487804878
Control.SRR15539824;43;40;0.558139534883721;19;24;0.0581395348837209;0.441860465116279
Control.SRR15539824;34;40;0.5;17;17;0;0.5
Control.SRR15539824;36;40;0.444444444444444;20;16;0.0555555555555556;0.444444444444444
Control.SRR15539824;44;40;0.613636363636364;17;27;0.113636363636364;0.386363636363636
Control.SRR15539824;34;40;0.558823529411765;15;19;0.0588235294117647;0.441176470588235
Control.SRR15539824;39;40;0.435897435897436;22;17;0.0641025641025641;0.435897435897436
Control.SRR15539824;38;40;0.578947368421053;16;22;0.0789473684210527;0.421052631578947
Control.SRR15539824;36;40;0.416666666666667;21;15;0.0833333333333333;0.416666666666667
Control.SRR15539824;39;40;0.461538461538462;21;18;0.0384615384615384;0.461538461538462
Control.SRR15539824;40;40;0.5;20;20;0;0.5
Control.SRR15539824;43;40;0.465116279069767;23;20;0.0348837209302326;0.465116279069767
Control.SRR15539824;40;40;0.45;22;18;0.05;0.45
Control.SRR15539824;44;40;0.590909090909091;18;26;0.0909090909090909;0.409090909090909
Control.SRR15539824;41;40;0.536585365853659;19;22;0.0365853658536586;0.463414634146341
Control.SRR15539824;38;40;0.447368421052632;21;17;0.0526315789473684;0.447368421052632
Control.SRR15539824;39;40;0.461538461538462;21;18;0.0384615384615384;0.461538461538462
Control.SRR15539824;36;40;0.611111111111111;14;22;0.111111111111111;0.388888888888889
Control.SRR15539824;41;40;0.536585365853659;19;22;0.0365853658536586;0.463414634146341
Control.SRR15539824;41;40;0.439024390243902;23;18;0.0609756097560976;0.439024390243902
Control.SRR15539824;43;40;0.418604651162791;25;18;0.0813953488372093;0.418604651162791
Control.SRR15539824;42;40;0.523809523809524;20;22;0.0238095238095238;0.476190476190476
Control.SRR15539824;37;40;0.405405405405405;22;15;0.0945945945945946;0.405405405405405
Control.SRR15539824;35;40;0.4;21;14;0.1;0.4
Control.SRR15539824;39;40;0.435897435897436;22;17;0.0641025641025641;0.435897435897436
Control.SRR15539824;43;40;0.558139534883721;19;24;0.0581395348837209;0.441860465116279
Control.SRR15539824;37;40;0.432432432432432;21;16;0.0675675675675675;0.432432432432432
Control.SRR15539824;43;40;0.720930232558139;12;31;0.220930232558139;0.27906976744186
Control.SRR15539824;41;40;0.390243902439024;25;16;0.109756097560976;0.390243902439024
Control.SRR15539824;44;40;0.386363636363636;27;17;0.113636363636364;0.386363636363636
Control.SRR15539824;38;40;0.394736842105263;23;15;0.105263157894737;0.394736842105263
Control.SRR15539824;40;40;0.475;21;19;0.025;0.475
Control.SRR15539824;39;40;0.538461538461538;18;21;0.0384615384615384;0.461538461538462
Control.SRR15539824;42;40;0.452380952380952;23;19;0.0476190476190476;0.452380952380952
Control.SRR15539824;43;40;0.465116279069767;23;20;0.0348837209302326;0.465116279069767
Control.SRR15539824;37;40;0.378378378378378;23;14;0.121621621621622;0.378378378378378
Control.SRR15539824;34;40;0.588235294117647;14;20;0.0882352941176471;0.411764705882353
Control.SRR15539824;35;40;0.514285714285714;17;18;0.0142857142857142;0.485714285714286
Control.SRR15539824;42;40;0.5;21;21;0;0.5
Control.SRR15539824;36;40;0.527777777777778;17;19;0.0277777777777778;0.472222222222222
Control.SRR15539824;36;40;0.416666666666667;21;15;0.0833333333333333;0.416666666666667
Control.SRR15539824;40;40;0.525;19;21;0.025;0.475
Control.SRR15539824;40;40;0.5;20;20;0;0.5
Control.SRR15539824;42;40;0.380952380952381;26;16;0.119047619047619;0.380952380952381
Control.SRR15539824;36;40;0.388888888888889;22;14;0.111111111111111;0.388888888888889
Control.SRR15539824;41;40;0.390243902439024;25;16;0.109756097560976;0.390243902439024
Control.SRR15539824;43;40;0.534883720930233;20;23;0.0348837209302325;0.465116279069767
Control.SRR15539824;41;40;0.48780487804878;21;20;0.0121951219512195;0.48780487804878
Control.SRR15539824;34;40;0.323529411764706;23;11;0.176470588235294;0.323529411764706
Control.SRR15539824;39;40;0.666666666666667;13;26;0.166666666666667;0.333333333333333
Control.SRR15539824;40;40;0.225;31;9;0.275;0.225
Control.SRR15539824;38;40;0.578947368421053;16;22;0.0789473684210527;0.421052631578947
Control.SRR15539824;42;40;0.476190476190476;22;20;0.0238095238095238;0.476190476190476
Control.SRR15539824;37;40;0.540540540540541;17;20;0.0405405405405406;0.459459459459459
Control.SRR15539824;34;40;0.617647058823529;13;21;0.117647058823529;0.382352941176471
Control.SRR15539824;40;40;0.55;18;22;0.05;0.45
Control.SRR15539824;43;40;0.558139534883721;19;24;0.0581395348837209;0.441860465116279
Control.SRR15539824;41;40;0.48780487804878;21;20;0.0121951219512195;0.48780487804878
Control.SRR15539824;37;40;0.486486486486487;19;18;0.0135135135135135;0.486486486486487
Control.SRR15539824;39;40;0.538461538461538;18;21;0.0384615384615384;0.461538461538462
Control.SRR15539824;44;40;0.5;22;22;0;0.5
Control.SRR15539824;37;40;0.405405405405405;22;15;0.0945945945945946;0.405405405405405
Control.SRR15539824;39;40;0.666666666666667;13;26;0.166666666666667;0.333333333333333
Control.SRR15539824;43;40;0.348837209302326;28;15;0.151162790697674;0.348837209302326
Control.SRR15539824;40;40;0.5;20;20;0;0.5
Control.SRR15539824;38;40;0.473684210526316;20;18;0.0263157894736842;0.473684210526316
Control.SRR15539824;38;40;0.447368421052632;21;17;0.0526315789473684;0.447368421052632
Control.SRR15539824;38;40;0.447368421052632;21;17;0.0526315789473684;0.447368421052632
Control.SRR15539824;41;40;0.463414634146341;22;19;0.0365853658536585;0.463414634146341
Control.SRR15539824;40;40;0.425;23;17;0.075;0.425
Control.SRR15539824;37;40;0.432432432432432;21;16;0.0675675675675675;0.432432432432432
Control.SRR15539824;41;40;0.536585365853659;19;22;0.0365853658536586;0.463414634146341
Control.SRR15539824;43;40;0.581395348837209;18;25;0.0813953488372093;0.418604651162791
Control.SRR15539824;42;40;0.5;21;21;0;0.5
Control.SRR15539824;41;40;0.536585365853659;19;22;0.0365853658536586;0.463414634146341
Control.SRR15539824;42;40;0.452380952380952;23;19;0.0476190476190476;0.452380952380952
Control.SRR15539824;43;40;0.488372093023256;22;21;0.0116279069767442;0.488372093023256
Control.SRR15539824;44;40;0.522727272727273;21;23;0.0227272727272727;0.477272727272727
Control.SRR15539824;34;40;0.382352941176471;21;13;0.117647058823529;0.382352941176471
Control.SRR15539824;35;40;0.514285714285714;17;18;0.0142857142857142;0.485714285714286
Control.SRR15539824;34;40;0.529411764705882;16;18;0.0294117647058824;0.470588235294118
Control.SRR15539824;44;40;0.477272727272727;23;21;0.0227272727272727;0.477272727272727
Control.SRR15539824;39;40;0.615384615384615;15;24;0.115384615384615;0.384615384615385
Control.SRR15539824;44;40;0.454545454545455;24;20;0.0454545454545455;0.454545454545455
Control.SRR15539824;39;40;0.435897435897436;22;17;0.0641025641025641;0.435897435897436
Control.SRR15539824;42;40;0.571428571428571;18;24;0.0714285714285714;0.428571428571429
Control.SRR15539824;37;40;0.540540540540541;17;20;0.0405405405405406;0.459459459459459
Control.SRR15539824;44;40;0.431818181818182;25;19;0.0681818181818182;0.431818181818182
Control.SRR15539824;39;40;0.435897435897436;22;17;0.0641025641025641;0.435897435897436
Control.SRR15539824;42;40;0.5;21;21;0;0.5
Control.SRR15539824;39;40;0.358974358974359;25;14;0.141025641025641;0.358974358974359
Control.SRR15539824;34;40;0.529411764705882;16;18;0.0294117647058824;0.470588235294118
Control.SRR15539824;36;40;0.416666666666667;21;15;0.0833333333333333;0.416666666666667
Control.SRR15539824;35;40;0.457142857142857;19;16;0.0428571428571429;0.457142857142857
Control.SRR15539824;39;40;0.564102564102564;17;22;0.0641025641025641;0.435897435897436
Control.SRR15539824;39;40;0.564102564102564;17;22;0.0641025641025641;0.435897435897436
Control.SRR15539824;38;40;0.447368421052632;21;17;0.0526315789473684;0.447368421052632
Control.SRR15539824;38;40;0.394736842105263;23;15;0.105263157894737;0.394736842105263
Control.SRR15539824;41;40;0.609756097560976;16;25;0.109756097560976;0.390243902439024
Control.SRR15539824;38;40;0.5;19;19;0;0.5
Control.SRR15539824;38;40;0.473684210526316;20;18;0.0263157894736842;0.473684210526316
Control.SRR15539824;36;40;0.5;18;18;0;0.5
Control.SRR15539824;38;40;0.552631578947368;17;21;0.0526315789473685;0.447368421052632
Control.SRR15539824;38;40;0.5;19;19;0;0.5
Control.SRR15539824;37;40;0.378378378378378;23;14;0.121621621621622;0.378378378378378
Control.SRR15539824;43;40;0.232558139534884;33;10;0.267441860465116;0.232558139534884
Control.SRR15539824;42;40;0.428571428571429;24;18;0.0714285714285715;0.428571428571429
Control.SRR15539824;34;40;0.588235294117647;14;20;0.0882352941176471;0.411764705882353
Control.SRR15539824;41;40;0.585365853658537;17;24;0.0853658536585366;0.414634146341463
Control.SRR15539824;36;40;0.277777777777778;26;10;0.222222222222222;0.277777777777778
Control.SRR15539824;41;40;0.609756097560976;16;25;0.109756097560976;0.390243902439024
Control.SRR15539824;36;40;0.583333333333333;15;21;0.0833333333333334;0.416666666666667
Control.SRR15539824;34;40;0.558823529411765;15;19;0.0588235294117647;0.441176470588235
Control.SRR15539824;41;40;0.439024390243902;23;18;0.0609756097560976;0.439024390243902
Control.SRR15539824;43;40;0.534883720930233;20;23;0.0348837209302325;0.465116279069767
Control.SRR15539824;41;40;0.439024390243902;23;18;0.0609756097560976;0.439024390243902
Control.SRR15539824;42;40;0.619047619047619;16;26;0.119047619047619;0.380952380952381
Control.SRR15539824;38;40;0.447368421052632;21;17;0.0526315789473684;0.447368421052632
Control.SRR15539824;35;40;0.685714285714286;11;24;0.185714285714286;0.314285714285714
Control.SRR15539824;37;40;0.486486486486487;19;18;0.0135135135135135;0.486486486486487
Control.SRR15539824;44;40;0.431818181818182;25;19;0.0681818181818182;0.431818181818182
Control.SRR15539824;43;40;0.372093023255814;27;16;0.127906976744186;0.372093023255814
Control.SRR15539824;43;40;0.511627906976744;21;22;0.0116279069767442;0.488372093023256
Control.SRR15539824;41;40;0.658536585365854;14;27;0.158536585365854;0.341463414634146
Control.SRR15539824;38;40;0.5;19;19;0;0.5
Control.SRR15539824;36;40;0.305555555555556;25;11;0.194444444444444;0.305555555555556
Control.SRR15539824;36;40;0.472222222222222;19;17;0.0277777777777778;0.472222222222222
Control.SRR15539824;34;40;0.558823529411765;15;19;0.0588235294117647;0.441176470588235
Control.SRR15539824;34;40;0.529411764705882;16;18;0.0294117647058824;0.470588235294118
Control.SRR15539824;43;40;0.511627906976744;21;22;0.0116279069767442;0.488372093023256
Control.SRR15539824;41;40;0.536585365853659;19;22;0.0365853658536586;0.463414634146341
Control.SRR15539824;38;40;0.526315789473684;18;20;0.0263157894736842;0.473684210526316
Control.SRR15539824;37;40;0.459459459459459;20;17;0.0405405405405405;0.459459459459459
Control.SRR15539824;40;40;0.425;23;17;0.075;0.425
Control.SRR15539824;36;40;0.5;18;18;0;0.5
Control.SRR15539824;38;40;0.684210526315789;12;26;0.184210526315789;0.315789473684211
Control.SRR15539824;38;40;0.578947368421053;16;22;0.0789473684210527;0.421052631578947
Control.SRR15539824;38;40;0.289473684210526;27;11;0.210526315789474;0.289473684210526
Control.SRR15539824;40;40;0.55;18;22;0.05;0.45
Control.SRR15539824;39;40;0.538461538461538;18;21;0.0384615384615384;0.461538461538462
Control.SRR15539824;36;40;0.444444444444444;20;16;0.0555555555555556;0.444444444444444
Control.SRR15539824;39;40;0.538461538461538;18;21;0.0384615384615384;0.461538461538462
Control.SRR15539824;36;40;0.444444444444444;20;16;0.0555555555555556;0.444444444444444
Control.SRR15539824;38;40;0.473684210526316;20;18;0.0263157894736842;0.473684210526316
Control.SRR15539824;41;40;0.51219512195122;20;21;0.0121951219512195;0.48780487804878
Control.SRR15539824;38;40;0.368421052631579;24;14;0.131578947368421;0.368421052631579
Control.SRR15539824;40;40;0.5;20;20;0;0.5
Control.SRR15539824;38;40;0.552631578947368;17;21;0.0526315789473685;0.447368421052632
Control.SRR15539824;38;40;0.526315789473684;18;20;0.0263157894736842;0.473684210526316
Control.SRR15539824;35;40;0.514285714285714;17;18;0.0142857142857142;0.485714285714286
Control.SRR15539824;39;40;0.512820512820513;19;20;0.0128205128205128;0.487179487179487
Control.SRR15539824;34;40;0.529411764705882;16;18;0.0294117647058824;0.470588235294118
Control.SRR15539824;44;40;0.568181818181818;19;25;0.0681818181818182;0.431818181818182
Control.SRR15539824;39;40;0.512820512820513;19;20;0.0128205128205128;0.487179487179487
Control.SRR15539824;39;40;0.487179487179487;20;19;0.0128205128205128;0.487179487179487
Control.SRR15539824;44;40;0.5;22;22;0;0.5
Control.SRR15539824;37;40;0.540540540540541;17;20;0.0405405405405406;0.459459459459459
Control.SRR15539824;38;40;0.473684210526316;20;18;0.0263157894736842;0.473684210526316
Control.SRR15539824;41;40;0.292682926829268;29;12;0.207317073170732;0.292682926829268
Control.SRR15539824;43;40;0.558139534883721;19;24;0.0581395348837209;0.441860465116279
Control.SRR15539824;37;40;0.540540540540541;17;20;0.0405405405405406;0.459459459459459
Control.SRR15539824;39;40;0.641025641025641;14;25;0.141025641025641;0.358974358974359
Control.SRR15539824;41;40;0.463414634146341;22;19;0.0365853658536585;0.463414634146341
Control.SRR15539824;39;40;0.487179487179487;20;19;0.0128205128205128;0.487179487179487
Control.SRR15539824;38;40;0.552631578947368;17;21;0.0526315789473685;0.447368421052632
Control.SRR15539824;42;40;0.5;21;21;0;0.5
Control.SRR15539824;44;40;0.5;22;22;0;0.5
Control.SRR15539824;39;40;0.564102564102564;17;22;0.0641025641025641;0.435897435897436
Control.SRR15539824;34;40;0.441176470588235;19;15;0.0588235294117647;0.441176470588235
Control.SRR15539824;40;40;0.375;25;15;0.125;0.375
Control.SRR15539824;43;40;0.511627906976744;21;22;0.0116279069767442;0.488372093023256
Control.SRR15539824;36;40;0.361111111111111;23;13;0.138888888888889;0.361111111111111
Control.SRR15539824;41;40;0.390243902439024;25;16;0.109756097560976;0.390243902439024
Control.SRR15539824;40;40;0.475;21;19;0.025;0.475
Control.SRR15539824;43;40;0.465116279069767;23;20;0.0348837209302326;0.465116279069767
Control.SRR15539824;39;40;0.538461538461538;18;21;0.0384615384615384;0.461538461538462
Control.SRR15539824;39;40;0.487179487179487;20;19;0.0128205128205128;0.487179487179487
Control.SRR15539824;40;40;0.425;23;17;0.075;0.425
Control.SRR15539824;37;40;0.621621621621622;14;23;0.121621621621622;0.378378378378378
Control.SRR15539824;39;40;0.615384615384615;15;24;0.115384615384615;0.384615384615385
Control.SRR15539824;39;40;0.435897435897436;22;17;0.0641025641025641;0.435897435897436
Control.SRR15539824;43;40;0.604651162790698;17;26;0.104651162790698;0.395348837209302
Control.SRR15539824;35;40;0.6;14;21;0.1;0.4
Control.SRR15539824;35;40;0.4;21;14;0.1;0.4
Control.SRR15539824;36;40;0.527777777777778;17;19;0.0277777777777778;0.472222222222222
Control.SRR15539824;34;40;0.529411764705882;16;18;0.0294117647058824;0.470588235294118
Control.SRR15539824;39;40;0.512820512820513;19;20;0.0128205128205128;0.487179487179487
Control.SRR15539824;35;40;0.514285714285714;17;18;0.0142857142857142;0.485714285714286
Control.SRR15539824;34;40;0.529411764705882;16;18;0.0294117647058824;0.470588235294118
Control.SRR15539824;34;40;0.529411764705882;16;18;0.0294117647058824;0.470588235294118
Control.SRR15539824;39;40;0.512820512820513;19;20;0.0128205128205128;0.487179487179487
Control.SRR15539824;35;40;0.514285714285714;17;18;0.0142857142857142;0.485714285714286
Control.SRR15539824;37;40;0.459459459459459;20;17;0.0405405405405405;0.459459459459459
Control.SRR15539824;37;40;0.459459459459459;20;17;0.0405405405405405;0.459459459459459
Control.SRR15539824;39;40;0.564102564102564;17;22;0.0641025641025641;0.435897435897436
Control.SRR15539824;39;40;0.512820512820513;19;20;0.0128205128205128;0.487179487179487
Control.SRR15539824;40;40;0.475;21;19;0.025;0.475
Control.SRR15539824;44;40;0.522727272727273;21;23;0.0227272727272727;0.477272727272727
Control.SRR15539824;42;40;0.619047619047619;16;26;0.119047619047619;0.380952380952381
Control.SRR15539824;39;40;0.641025641025641;14;25;0.141025641025641;0.358974358974359
Control.SRR15539824;39;40;0.564102564102564;17;22;0.0641025641025641;0.435897435897436
Control.SRR15539824;43;40;0.534883720930233;20;23;0.0348837209302325;0.465116279069767
Control.SRR15539824;40;40;0.625;15;25;0.125;0.375
Control.SRR15539824;35;40;0.485714285714286;18;17;0.0142857142857143;0.485714285714286
Control.SRR15539824;38;40;0.447368421052632;21;17;0.0526315789473684;0.447368421052632
Control.SRR15539824;35;40;0.657142857142857;12;23;0.157142857142857;0.342857142857143
Control.SRR15539824;38;40;0.421052631578947;22;16;0.0789473684210527;0.421052631578947
Control.SRR15539824;39;40;0.384615384615385;24;15;0.115384615384615;0.384615384615385
Control.SRR15539824;42;40;0.571428571428571;18;24;0.0714285714285714;0.428571428571429
Control.SRR15539824;34;40;0.558823529411765;15;19;0.0588235294117647;0.441176470588235
Control.SRR15539824;37;40;0.513513513513513;18;19;0.0135135135135135;0.486486486486487
Control.SRR15539824;36;40;0.5;18;18;0;0.5
Control.SRR15539824;41;40;0.439024390243902;23;18;0.0609756097560976;0.439024390243902
Control.SRR15539824;40;40;0.65;14;26;0.15;0.35
Control.SRR15539824;42;40;0.5;21;21;0;0.5
Control.SRR15539824;40;40;0.625;15;25;0.125;0.375
Control.SRR15539824;41;40;0.463414634146341;22;19;0.0365853658536585;0.463414634146341
Control.SRR15539824;39;40;0.461538461538462;21;18;0.0384615384615384;0.461538461538462
Control.SRR15539824;39;40;0.358974358974359;25;14;0.141025641025641;0.358974358974359
Control.SRR15539824;44;40;0.386363636363636;27;17;0.113636363636364;0.386363636363636
Control.SRR15539824;37;40;0.486486486486487;19;18;0.0135135135135135;0.486486486486487
Control.SRR15539824;34;40;0.558823529411765;15;19;0.0588235294117647;0.441176470588235
Control.SRR15539824;39;40;0.461538461538462;21;18;0.0384615384615384;0.461538461538462
Control.SRR15539824;36;40;0.388888888888889;22;14;0.111111111111111;0.388888888888889
Control.SRR15539824;44;40;0.545454545454545;20;24;0.0454545454545454;0.454545454545455
Control.SRR15539824;41;40;0.463414634146341;22;19;0.0365853658536585;0.463414634146341
Control.SRR15539824;38;40;0.526315789473684;18;20;0.0263157894736842;0.473684210526316
Control.SRR15539824;38;40;0.473684210526316;20;18;0.0263157894736842;0.473684210526316
Control.SRR15539824;36;40;0.444444444444444;20;16;0.0555555555555556;0.444444444444444
Control.SRR15539824;34;40;0.382352941176471;21;13;0.117647058823529;0.382352941176471
Control.SRR15539824;42;40;0.333333333333333;28;14;0.166666666666667;0.333333333333333
Control.SRR15539824;39;40;0.435897435897436;22;17;0.0641025641025641;0.435897435897436
Control.SRR15539824;41;40;0.48780487804878;21;20;0.0121951219512195;0.48780487804878
Control.SRR15539824;43;40;0.465116279069767;23;20;0.0348837209302326;0.465116279069767
Control.SRR15539824;35;40;0.485714285714286;18;17;0.0142857142857143;0.485714285714286
Control.SRR15539824;38;40;0.447368421052632;21;17;0.0526315789473684;0.447368421052632
Control.SRR15539824;41;40;0.51219512195122;20;21;0.0121951219512195;0.48780487804878
Control.SRR15539824;39;40;0.384615384615385;24;15;0.115384615384615;0.384615384615385
Control.SRR15539824;44;40;0.431818181818182;25;19;0.0681818181818182;0.431818181818182
Control.SRR15539824;36;40;0.361111111111111;23;13;0.138888888888889;0.361111111111111
Control.SRR15539824;39;40;0.58974358974359;16;23;0.0897435897435898;0.41025641025641
Control.SRR15539824;40;40;0.4;24;16;0.1;0.4
Control.SRR15539824;39;40;0.666666666666667;13;26;0.166666666666667;0.333333333333333
Control.SRR15539824;35;40;0.371428571428571;22;13;0.128571428571429;0.371428571428571
Control.SRR15539824;34;40;0.529411764705882;16;18;0.0294117647058824;0.470588235294118
Control.SRR15539824;41;40;0.341463414634146;27;14;0.158536585365854;0.341463414634146
Control.SRR15539824;40;40;0.5;20;20;0;0.5
Control.SRR15539824;34;40;0.411764705882353;20;14;0.0882352941176471;0.411764705882353
Control.SRR15539824;43;40;0.418604651162791;25;18;0.0813953488372093;0.418604651162791
Control.SRR15539824;42;40;0.357142857142857;27;15;0.142857142857143;0.357142857142857
Control.SRR15539824;34;40;0.5;17;17;0;0.5
Control.SRR15539824;44;40;0.590909090909091;18;26;0.0909090909090909;0.409090909090909
Control.SRR15539824;43;40;0.488372093023256;22;21;0.0116279069767442;0.488372093023256
Control.SRR15539824;43;40;0.604651162790698;17;26;0.104651162790698;0.395348837209302
Control.SRR15539824;34;40;0.382352941176471;21;13;0.117647058823529;0.382352941176471
Control.SRR15539824;40;40;0.325;27;13;0.175;0.325
Control.SRR15539824;43;40;0.488372093023256;22;21;0.0116279069767442;0.488372093023256
Control.SRR15539824;38;40;0.710526315789474;11;27;0.210526315789474;0.289473684210526
Control.SRR15539824;42;40;0.476190476190476;22;20;0.0238095238095238;0.476190476190476
Control.SRR15539824;42;40;0.452380952380952;23;19;0.0476190476190476;0.452380952380952
Control.SRR15539824;36;40;0.5;18;18;0;0.5
Control.SRR15539824;38;40;0.552631578947368;17;21;0.0526315789473685;0.447368421052632
Control.SRR15539824;34;40;0.529411764705882;16;18;0.0294117647058824;0.470588235294118
Control.SRR15539824;40;40;0.475;21;19;0.025;0.475
Control.SRR15539824;38;40;0.605263157894737;15;23;0.105263157894737;0.394736842105263
Control.SRR15539824;42;40;0.547619047619048;19;23;0.0476190476190477;0.452380952380952
Control.SRR15539824;34;40;0.382352941176471;21;13;0.117647058823529;0.382352941176471
Control.SRR15539824;34;40;0.647058823529412;12;22;0.147058823529412;0.352941176470588
Control.SRR15539824;35;40;0.571428571428571;15;20;0.0714285714285714;0.428571428571429
Control.SRR15539824;38;40;0.605263157894737;15;23;0.105263157894737;0.394736842105263
Control.SRR15539824;35;40;0.457142857142857;19;16;0.0428571428571429;0.457142857142857
Control.SRR15539824;42;40;0.428571428571429;24;18;0.0714285714285715;0.428571428571429
Control.SRR15539824;34;40;0.529411764705882;16;18;0.0294117647058824;0.470588235294118
Control.SRR15539824;37;40;0.324324324324324;25;12;0.175675675675676;0.324324324324324
Control.SRR15539824;35;40;0.6;14;21;0.1;0.4
Control.SRR15539824;34;40;0.441176470588235;19;15;0.0588235294117647;0.441176470588235
Control.SRR15539824;38;40;0.473684210526316;20;18;0.0263157894736842;0.473684210526316
Control.SRR15539824;42;40;0.452380952380952;23;19;0.0476190476190476;0.452380952380952
Control.SRR15539824;40;40;0.4;24;16;0.1;0.4
Control.SRR15539824;42;40;0.571428571428571;18;24;0.0714285714285714;0.428571428571429
Control.SRR15539824;41;40;0.414634146341463;24;17;0.0853658536585366;0.414634146341463
Control.SRR15539824;40;40;0.65;14;26;0.15;0.35
Control.SRR15539824;39;40;0.487179487179487;20;19;0.0128205128205128;0.487179487179487
Control.SRR15539824;39;40;0.41025641025641;23;16;0.0897435897435898;0.41025641025641
Control.SRR15539824;39;40;0.487179487179487;20;19;0.0128205128205128;0.487179487179487
Control.SRR15539824;42;40;0.571428571428571;18;24;0.0714285714285714;0.428571428571429
Control.SRR15539824;36;40;0.305555555555556;25;11;0.194444444444444;0.305555555555556
Control.SRR15539824;41;40;0.48780487804878;21;20;0.0121951219512195;0.48780487804878
Control.SRR15539824;39;40;0.615384615384615;15;24;0.115384615384615;0.384615384615385
Control.SRR15539824;43;40;0.511627906976744;21;22;0.0116279069767442;0.488372093023256
Control.SRR15539824;37;40;0.513513513513513;18;19;0.0135135135135135;0.486486486486487
Control.SRR15539824;34;40;0.441176470588235;19;15;0.0588235294117647;0.441176470588235
Control.SRR15539824;42;40;0.666666666666667;14;28;0.166666666666667;0.333333333333333
Control.SRR15539824;39;40;0.564102564102564;17;22;0.0641025641025641;0.435897435897436
Control.SRR15539824;34;40;0.382352941176471;21;13;0.117647058823529;0.382352941176471
Control.SRR15539824;37;40;0.540540540540541;17;20;0.0405405405405406;0.459459459459459
Control.SRR15539824;40;40;0.5;20;20;0;0.5
Control.SRR15539824;38;40;0.394736842105263;23;15;0.105263157894737;0.394736842105263
Control.SRR15539824;32;40;0.5625;14;18;0.0625;0.4375
Control.SRR15539824;37;40;0.486486486486487;19;18;0.0135135135135135;0.486486486486487
Control.SRR15539824;37;40;0.459459459459459;20;17;0.0405405405405405;0.459459459459459
Control.SRR15539824;34;40;0.617647058823529;13;21;0.117647058823529;0.382352941176471
Control.SRR15539824;36;40;0.555555555555556;16;20;0.0555555555555556;0.444444444444444
Control.SRR15539824;39;40;0.58974358974359;16;23;0.0897435897435898;0.41025641025641
Control.SRR15539824;36;40;0.583333333333333;15;21;0.0833333333333334;0.416666666666667
Control.SRR15539824;38;40;0.605263157894737;15;23;0.105263157894737;0.394736842105263
Control.SRR15539824;37;40;0.351351351351351;24;13;0.148648648648649;0.351351351351351
Control.SRR15539824;37;40;0.459459459459459;20;17;0.0405405405405405;0.459459459459459
Control.SRR15539824;39;40;0.461538461538462;21;18;0.0384615384615384;0.461538461538462
Control.SRR15539824;37;40;0.594594594594595;15;22;0.0945945945945946;0.405405405405405
Control.SRR15539824;37;40;0.486486486486487;19;18;0.0135135135135135;0.486486486486487
Control.SRR15539824;36;40;0.472222222222222;19;17;0.0277777777777778;0.472222222222222
Control.SRR15539824;33;40;0.484848484848485;17;16;0.0151515151515151;0.484848484848485
Control.SRR15539824;36;40;0.555555555555556;16;20;0.0555555555555556;0.444444444444444
Control.SRR15539824;37;40;0.513513513513513;18;19;0.0135135135135135;0.486486486486487
Control.SRR15539824;39;40;0.58974358974359;16;23;0.0897435897435898;0.41025641025641
Control.SRR15539824;35;40;0.571428571428571;15;20;0.0714285714285714;0.428571428571429
Control.SRR15539824;32;40;0.5;16;16;0;0.5
Control.SRR15539824;41;40;0.585365853658537;17;24;0.0853658536585366;0.414634146341463
Control.SRR15539824;40;40;0.525;19;21;0.025;0.475
Control.SRR15539824;38;40;0.473684210526316;20;18;0.0263157894736842;0.473684210526316
Control.SRR15539824;35;40;0.457142857142857;19;16;0.0428571428571429;0.457142857142857
Control.SRR15539824;42;40;0.404761904761905;25;17;0.0952380952380952;0.404761904761905
Control.SRR15539824;41;40;0.585365853658537;17;24;0.0853658536585366;0.414634146341463
Control.SRR15539824;40;40;0.55;18;22;0.05;0.45
Control.SRR15539824;40;40;0.5;20;20;0;0.5
Control.SRR15539824;39;40;0.435897435897436;22;17;0.0641025641025641;0.435897435897436
Control.SRR15539824;39;40;0.41025641025641;23;16;0.0897435897435898;0.41025641025641
Control.SRR15539824;38;40;0.552631578947368;17;21;0.0526315789473685;0.447368421052632
Control.SRR15539824;38;40;0.394736842105263;23;15;0.105263157894737;0.394736842105263
Control.SRR15539824;38;40;0.5;19;19;0;0.5
Control.SRR15539824;42;40;0.595238095238095;17;25;0.0952380952380952;0.404761904761905
Control.SRR15539824;34;40;0.352941176470588;22;12;0.147058823529412;0.352941176470588
Control.SRR15539824;37;40;0.513513513513513;18;19;0.0135135135135135;0.486486486486487
Control.SRR15539824;35;40;0.6;14;21;0.1;0.4
Control.SRR15539824;35;40;0.4;21;14;0.1;0.4
Control.SRR15539824;34;40;0.411764705882353;20;14;0.0882352941176471;0.411764705882353
Control.SRR15539824;35;40;0.542857142857143;16;19;0.0428571428571428;0.457142857142857
Control.SRR15539824;35;40;0.457142857142857;19;16;0.0428571428571429;0.457142857142857
Control.SRR15539824;40;40;0.675;13;27;0.175;0.325
Control.SRR15539824;36;40;0.638888888888889;13;23;0.138888888888889;0.361111111111111
Control.SRR15539824;38;40;0.552631578947368;17;21;0.0526315789473685;0.447368421052632
Control.SRR15539824;36;40;0.555555555555556;16;20;0.0555555555555556;0.444444444444444
Control.SRR15539824;39;40;0.564102564102564;17;22;0.0641025641025641;0.435897435897436
Control.SRR15539824;33;40;0.545454545454545;15;18;0.0454545454545454;0.454545454545455
Control.SRR15539824;37;40;0.513513513513513;18;19;0.0135135135135135;0.486486486486487
Control.SRR15539824;40;40;0.375;25;15;0.125;0.375
Control.SRR15539824;32;40;0.4375;18;14;0.0625;0.4375
Control.SRR15539824;38;40;0.526315789473684;18;20;0.0263157894736842;0.473684210526316
Control.SRR15539824;36;40;0.472222222222222;19;17;0.0277777777777778;0.472222222222222
Control.SRR15539824;33;40;0.515151515151515;16;17;0.0151515151515151;0.484848484848485
Control.SRR15539824;41;40;0.51219512195122;20;21;0.0121951219512195;0.48780487804878
Control.SRR15539824;37;40;0.432432432432432;21;16;0.0675675675675675;0.432432432432432
Control.SRR15539824;36;40;0.527777777777778;17;19;0.0277777777777778;0.472222222222222
Control.SRR15539824;36;40;0.5;18;18;0;0.5
Control.SRR15539824;35;40;0.685714285714286;11;24;0.185714285714286;0.314285714285714
Control.SRR15539824;39;40;0.435897435897436;22;17;0.0641025641025641;0.435897435897436
Control.SRR15539824;36;40;0.416666666666667;21;15;0.0833333333333333;0.416666666666667
Control.SRR15539824;35;40;0.542857142857143;16;19;0.0428571428571428;0.457142857142857
Control.SRR15539824;41;40;0.634146341463415;15;26;0.134146341463415;0.365853658536585
Control.SRR15539824;40;40;0.525;19;21;0.025;0.475
Control.SRR15539824;41;40;0.48780487804878;21;20;0.0121951219512195;0.48780487804878
Control.SRR15539824;33;40;0.575757575757576;14;19;0.0757575757575758;0.424242424242424
Control.SRR15539824;36;40;0.611111111111111;14;22;0.111111111111111;0.388888888888889
Control.SRR15539824;36;40;0.472222222222222;19;17;0.0277777777777778;0.472222222222222
Control.SRR15539824;39;40;0.512820512820513;19;20;0.0128205128205128;0.487179487179487
Control.SRR15539824;40;40;0.525;19;21;0.025;0.475
Control.SRR15539824;35;40;0.371428571428571;22;13;0.128571428571429;0.371428571428571
Control.SRR15539824;38;40;0.631578947368421;14;24;0.131578947368421;0.368421052631579
Control.SRR15539824;34;40;0.323529411764706;23;11;0.176470588235294;0.323529411764706
Control.SRR15539824;42;40;0.357142857142857;27;15;0.142857142857143;0.357142857142857
Control.SRR15539824;41;40;0.658536585365854;14;27;0.158536585365854;0.341463414634146
Control.SRR15539824;35;40;0.457142857142857;19;16;0.0428571428571429;0.457142857142857
Control.SRR15539824;39;40;0.641025641025641;14;25;0.141025641025641;0.358974358974359
Control.SRR15539824;39;40;0.41025641025641;23;16;0.0897435897435898;0.41025641025641
Control.SRR15539824;32;40;0.5;16;16;0;0.5
Control.SRR15539824;40;40;0.575;17;23;0.075;0.425
Control.SRR15539824;39;40;0.512820512820513;19;20;0.0128205128205128;0.487179487179487
Control.SRR15539824;40;40;0.425;23;17;0.075;0.425
Control.SRR15539824;40;40;0.5;20;20;0;0.5
Control.SRR15539824;40;40;0.5;20;20;0;0.5
Control.SRR15539824;33;40;0.515151515151515;16;17;0.0151515151515151;0.484848484848485
Control.SRR15539824;38;40;0.5;19;19;0;0.5
Control.SRR15539824;39;40;0.538461538461538;18;21;0.0384615384615384;0.461538461538462
Control.SRR15539824;37;40;0.486486486486487;19;18;0.0135135135135135;0.486486486486487
Control.SRR15539824;37;40;0.486486486486487;19;18;0.0135135135135135;0.486486486486487
Control.SRR15539824;35;40;0.485714285714286;18;17;0.0142857142857143;0.485714285714286
Control.SRR15539824;33;40;0.393939393939394;20;13;0.106060606060606;0.393939393939394
Control.SRR15539824;36;40;0.361111111111111;23;13;0.138888888888889;0.361111111111111
Control.SRR15539824;32;40;0.40625;19;13;0.09375;0.40625
Control.SRR15539824;36;40;0.472222222222222;19;17;0.0277777777777778;0.472222222222222
Control.SRR15539824;32;40;0.625;12;20;0.125;0.375
Control.SRR15539824;39;40;0.769230769230769;9;30;0.269230769230769;0.230769230769231
Control.SRR15539824;35;40;0.485714285714286;18;17;0.0142857142857143;0.485714285714286
Control.SRR15539824;36;40;0.388888888888889;22;14;0.111111111111111;0.388888888888889
Control.SRR15539824;32;40;0.53125;15;17;0.03125;0.46875
Control.SRR15539824;42;40;0.476190476190476;22;20;0.0238095238095238;0.476190476190476
Control.SRR15539824;42;40;0.571428571428571;18;24;0.0714285714285714;0.428571428571429
Control.SRR15539824;42;40;0.452380952380952;23;19;0.0476190476190476;0.452380952380952
Control.SRR15539824;42;40;0.452380952380952;23;19;0.0476190476190476;0.452380952380952
Control.SRR15539824;33;40;0.424242424242424;19;14;0.0757575757575757;0.424242424242424
Control.SRR15539824;38;40;0.526315789473684;18;20;0.0263157894736842;0.473684210526316
Control.SRR15539824;34;40;0.5;17;17;0;0.5
Control.SRR15539824;38;40;0.447368421052632;21;17;0.0526315789473684;0.447368421052632
Control.SRR15539824;39;40;0.512820512820513;19;20;0.0128205128205128;0.487179487179487
Control.SRR15539824;42;40;0.404761904761905;25;17;0.0952380952380952;0.404761904761905
Control.SRR15539824;41;40;0.439024390243902;23;18;0.0609756097560976;0.439024390243902
Control.SRR15539824;34;40;0.617647058823529;13;21;0.117647058823529;0.382352941176471
Control.SRR15539824;37;40;0.378378378378378;23;14;0.121621621621622;0.378378378378378
Control.SRR15539824;35;40;0.571428571428571;15;20;0.0714285714285714;0.428571428571429
Control.SRR15539824;35;40;0.514285714285714;17;18;0.0142857142857142;0.485714285714286
Control.SRR15539824;32;40;0.59375;13;19;0.09375;0.40625
Control.SRR15539824;42;40;0.476190476190476;22;20;0.0238095238095238;0.476190476190476
Control.SRR15539824;36;40;0.472222222222222;19;17;0.0277777777777778;0.472222222222222
Control.SRR15539824;39;40;0.41025641025641;23;16;0.0897435897435898;0.41025641025641
Control.SRR15539824;42;40;0.404761904761905;25;17;0.0952380952380952;0.404761904761905
Control.SRR15539824;35;40;0.428571428571429;20;15;0.0714285714285715;0.428571428571429
Control.SRR15539824;32;40;0.5;16;16;0;0.5
Control.SRR15539824;41;40;0.390243902439024;25;16;0.109756097560976;0.390243902439024
Control.SRR15539824;35;40;0.428571428571429;20;15;0.0714285714285715;0.428571428571429
Control.SRR15539824;33;40;0.515151515151515;16;17;0.0151515151515151;0.484848484848485
Control.SRR15539824;34;40;0.411764705882353;20;14;0.0882352941176471;0.411764705882353
Control.SRR15539824;37;40;0.513513513513513;18;19;0.0135135135135135;0.486486486486487
Control.SRR15539824;38;40;0.447368421052632;21;17;0.0526315789473684;0.447368421052632
Control.SRR15539824;32;40;0.65625;11;21;0.15625;0.34375
Control.SRR15539824;33;40;0.484848484848485;17;16;0.0151515151515151;0.484848484848485
Control.SRR15539824;36;40;0.611111111111111;14;22;0.111111111111111;0.388888888888889
Control.SRR15539824;32;40;0.46875;17;15;0.03125;0.46875
Control.SRR15539824;39;40;0.512820512820513;19;20;0.0128205128205128;0.487179487179487
Control.SRR15539824;42;40;0.5;21;21;0;0.5
Control.SRR15539824;35;40;0.457142857142857;19;16;0.0428571428571429;0.457142857142857
Control.SRR15539824;37;40;0.540540540540541;17;20;0.0405405405405406;0.459459459459459
Control.SRR15539824;37;40;0.378378378378378;23;14;0.121621621621622;0.378378378378378
Control.SRR15539824;39;40;0.58974358974359;16;23;0.0897435897435898;0.41025641025641
Control.SRR15539824;39;40;0.538461538461538;18;21;0.0384615384615384;0.461538461538462
Control.SRR15539824;36;40;0.444444444444444;20;16;0.0555555555555556;0.444444444444444
Control.SRR15539824;34;40;0.470588235294118;18;16;0.0294117647058824;0.470588235294118
Control.SRR15539824;41;40;0.48780487804878;21;20;0.0121951219512195;0.48780487804878
Control.SRR15539824;37;40;0.405405405405405;22;15;0.0945945945945946;0.405405405405405
Control.SRR15539824;35;40;0.542857142857143;16;19;0.0428571428571428;0.457142857142857
Control.SRR15539824;35;40;0.457142857142857;19;16;0.0428571428571429;0.457142857142857
Control.SRR15539824;39;40;0.461538461538462;21;18;0.0384615384615384;0.461538461538462
Control.SRR15539824;38;40;0.394736842105263;23;15;0.105263157894737;0.394736842105263
Control.SRR15539824;37;40;0.594594594594595;15;22;0.0945945945945946;0.405405405405405
Control.SRR15539824;35;40;0.485714285714286;18;17;0.0142857142857143;0.485714285714286
Control.SRR15539824;32;40;0.65625;11;21;0.15625;0.34375
Control.SRR15539824;42;40;0.380952380952381;26;16;0.119047619047619;0.380952380952381
Control.SRR15539824;32;40;0.5;16;16;0;0.5
Control.SRR15539824;34;40;0.382352941176471;21;13;0.117647058823529;0.382352941176471
Control.SRR15539824;39;40;0.538461538461538;18;21;0.0384615384615384;0.461538461538462
Control.SRR15539824;40;40;0.4;24;16;0.1;0.4
Control.SRR15539824;34;40;0.441176470588235;19;15;0.0588235294117647;0.441176470588235
Control.SRR15539824;36;40;0.444444444444444;20;16;0.0555555555555556;0.444444444444444
Control.SRR15539824;42;40;0.523809523809524;20;22;0.0238095238095238;0.476190476190476
Control.SRR15539824;38;40;0.447368421052632;21;17;0.0526315789473684;0.447368421052632
Control.SRR15539824;38;40;0.552631578947368;17;21;0.0526315789473685;0.447368421052632
Control.SRR15539824;42;40;0.333333333333333;28;14;0.166666666666667;0.333333333333333
Control.SRR15539824;37;40;0.486486486486487;19;18;0.0135135135135135;0.486486486486487
Control.SRR15539824;39;40;0.615384615384615;15;24;0.115384615384615;0.384615384615385
Control.SRR15539824;39;40;0.358974358974359;25;14;0.141025641025641;0.358974358974359
Control.SRR15539824;38;40;0.394736842105263;23;15;0.105263157894737;0.394736842105263
Control.SRR15539824;40;40;0.575;17;23;0.075;0.425
Control.SRR15539824;42;40;0.5;21;21;0;0.5
Control.SRR15539824;37;40;0.459459459459459;20;17;0.0405405405405405;0.459459459459459
Control.SRR15539824;39;40;0.435897435897436;22;17;0.0641025641025641;0.435897435897436
Control.SRR15539824;35;40;0.685714285714286;11;24;0.185714285714286;0.314285714285714
Control.SRR15539824;42;40;0.428571428571429;24;18;0.0714285714285715;0.428571428571429
Control.SRR15539824;34;40;0.352941176470588;22;12;0.147058823529412;0.352941176470588
Control.SRR15539824;32;40;0.5625;14;18;0.0625;0.4375
Control.SRR15539824;36;40;0.416666666666667;21;15;0.0833333333333333;0.416666666666667
Control.SRR15539824;38;40;0.552631578947368;17;21;0.0526315789473685;0.447368421052632
Control.SRR15539824;41;40;0.536585365853659;19;22;0.0365853658536586;0.463414634146341
Control.SRR15539824;41;40;0.634146341463415;15;26;0.134146341463415;0.365853658536585
Control.SRR15539824;39;40;0.487179487179487;20;19;0.0128205128205128;0.487179487179487
Control.SRR15539824;39;40;0.615384615384615;15;24;0.115384615384615;0.384615384615385
Control.SRR15539824;35;40;0.571428571428571;15;20;0.0714285714285714;0.428571428571429
Control.SRR15539824;42;40;0.428571428571429;24;18;0.0714285714285715;0.428571428571429
Control.SRR15539824;40;40;0.425;23;17;0.075;0.425
Control.SRR15539824;41;40;0.414634146341463;24;17;0.0853658536585366;0.414634146341463
Control.SRR15539824;42;40;0.547619047619048;19;23;0.0476190476190477;0.452380952380952
Control.SRR15539824;36;40;0.444444444444444;20;16;0.0555555555555556;0.444444444444444
Control.SRR15539824;38;40;0.421052631578947;22;16;0.0789473684210527;0.421052631578947
Control.SRR15539824;33;40;0.484848484848485;17;16;0.0151515151515151;0.484848484848485
Control.SRR15539824;40;40;0.525;19;21;0.025;0.475
Control.SRR15539824;38;40;0.421052631578947;22;16;0.0789473684210527;0.421052631578947
Control.SRR15539824;41;40;0.536585365853659;19;22;0.0365853658536586;0.463414634146341
Control.SRR15539824;35;40;0.542857142857143;16;19;0.0428571428571428;0.457142857142857
Control.SRR15539824;38;40;0.368421052631579;24;14;0.131578947368421;0.368421052631579
Control.SRR15539824;39;40;0.512820512820513;19;20;0.0128205128205128;0.487179487179487
Control.SRR15539824;33;40;0.515151515151515;16;17;0.0151515151515151;0.484848484848485
Control.SRR15539824;35;40;0.6;14;21;0.1;0.4
Control.SRR15539824;38;40;0.394736842105263;23;15;0.105263157894737;0.394736842105263
Control.SRR15539824;39;40;0.512820512820513;19;20;0.0128205128205128;0.487179487179487
Control.SRR15539824;39;40;0.435897435897436;22;17;0.0641025641025641;0.435897435897436
Control.SRR15539824;37;40;0.405405405405405;22;15;0.0945945945945946;0.405405405405405
Control.SRR15539824;38;40;0.5;19;19;0;0.5
Control.SRR15539824;37;40;0.594594594594595;15;22;0.0945945945945946;0.405405405405405
Control.SRR15539824;34;40;0.529411764705882;16;18;0.0294117647058824;0.470588235294118
Control.SRR15539824;35;40;0.6;14;21;0.1;0.4
Control.SRR15539824;36;40;0.5;18;18;0;0.5
Control.SRR15539824;42;40;0.428571428571429;24;18;0.0714285714285715;0.428571428571429
Control.SRR15539824;42;40;0.547619047619048;19;23;0.0476190476190477;0.452380952380952
Control.SRR15539824;38;40;0.447368421052632;21;17;0.0526315789473684;0.447368421052632
Control.SRR15539824;40;40;0.525;19;21;0.025;0.475
Control.SRR15539824;34;40;0.441176470588235;19;15;0.0588235294117647;0.441176470588235
Control.SRR15539824;39;40;0.564102564102564;17;22;0.0641025641025641;0.435897435897436
Control.SRR15539824;33;40;0.363636363636364;21;12;0.136363636363636;0.363636363636364
Control.SRR15539824;36;40;0.388888888888889;22;14;0.111111111111111;0.388888888888889
Control.SRR15539824;33;40;0.484848484848485;17;16;0.0151515151515151;0.484848484848485
Control.SRR15539824;38;40;0.447368421052632;21;17;0.0526315789473684;0.447368421052632
Control.SRR15539824;36;40;0.611111111111111;14;22;0.111111111111111;0.388888888888889
Control.SRR15539824;42;40;0.452380952380952;23;19;0.0476190476190476;0.452380952380952
Control.SRR15539824;34;40;0.323529411764706;23;11;0.176470588235294;0.323529411764706
Control.SRR15539824;33;40;0.424242424242424;19;14;0.0757575757575757;0.424242424242424
Control.SRR15539824;32;40;0.53125;15;17;0.03125;0.46875
Control.SRR15539824;35;40;0.485714285714286;18;17;0.0142857142857143;0.485714285714286
Control.SRR15539824;39;40;0.58974358974359;16;23;0.0897435897435898;0.41025641025641
Control.SRR15539824;36;40;0.5;18;18;0;0.5
Control.SRR15539824;34;40;0.588235294117647;14;20;0.0882352941176471;0.411764705882353
Control.SRR15539824;35;40;0.428571428571429;20;15;0.0714285714285715;0.428571428571429
Control.SRR15539824;37;40;0.513513513513513;18;19;0.0135135135135135;0.486486486486487
Control.SRR15539824;40;40;0.575;17;23;0.075;0.425
Control.SRR15539824;40;40;0.575;17;23;0.075;0.425
Control.SRR15539824;34;40;0.382352941176471;21;13;0.117647058823529;0.382352941176471
Control.SRR15539824;37;40;0.351351351351351;24;13;0.148648648648649;0.351351351351351
Control.SRR15539824;38;40;0.5;19;19;0;0.5
Control.SRR15539824;33;40;0.606060606060606;13;20;0.106060606060606;0.393939393939394
Control.SRR15539824;36;40;0.5;18;18;0;0.5
Control.SRR15539824;35;40;0.485714285714286;18;17;0.0142857142857143;0.485714285714286
Control.SRR15539824;37;40;0.567567567567568;16;21;0.0675675675675675;0.432432432432432
Control.SRR15539824;38;40;0.552631578947368;17;21;0.0526315789473685;0.447368421052632
Control.SRR15539824;38;40;0.5;19;19;0;0.5
Control.SRR15539824;38;40;0.526315789473684;18;20;0.0263157894736842;0.473684210526316
Control.SRR15539824;33;40;0.515151515151515;16;17;0.0151515151515151;0.484848484848485
Control.SRR15539824;39;40;0.41025641025641;23;16;0.0897435897435898;0.41025641025641
Control.SRR15539824;39;40;0.538461538461538;18;21;0.0384615384615384;0.461538461538462
Control.SRR15539824;35;40;0.457142857142857;19;16;0.0428571428571429;0.457142857142857
Control.SRR15539824;41;40;0.634146341463415;15;26;0.134146341463415;0.365853658536585
Control.SRR15539824;38;40;0.289473684210526;27;11;0.210526315789474;0.289473684210526
Control.SRR15539824;36;40;0.416666666666667;21;15;0.0833333333333333;0.416666666666667
Control.SRR15539824;38;40;0.552631578947368;17;21;0.0526315789473685;0.447368421052632
Control.SRR15539824;42;40;0.5;21;21;0;0.5
Control.SRR15539824;37;40;0.459459459459459;20;17;0.0405405405405405;0.459459459459459
Control.SRR15539824;38;40;0.578947368421053;16;22;0.0789473684210527;0.421052631578947
Control.SRR15539824;39;40;0.487179487179487;20;19;0.0128205128205128;0.487179487179487
Control.SRR15539824;42;40;0.523809523809524;20;22;0.0238095238095238;0.476190476190476
Control.SRR15539824;38;40;0.605263157894737;15;23;0.105263157894737;0.394736842105263
Control.SRR15539824;40;40;0.55;18;22;0.05;0.45
Control.SRR15539824;38;40;0.552631578947368;17;21;0.0526315789473685;0.447368421052632
Control.SRR15539824;35;40;0.542857142857143;16;19;0.0428571428571428;0.457142857142857
Control.SRR15539824;40;40;0.425;23;17;0.075;0.425
Control.SRR15539824;42;40;0.5;21;21;0;0.5
Control.SRR15539824;39;40;0.615384615384615;15;24;0.115384615384615;0.384615384615385
Control.SRR15539824;40;40;0.625;15;25;0.125;0.375
Control.SRR15539824;34;40;0.5;17;17;0;0.5
Control.SRR15539824;42;40;0.428571428571429;24;18;0.0714285714285715;0.428571428571429
Control.SRR15539824;39;40;0.461538461538462;21;18;0.0384615384615384;0.461538461538462
Control.SRR15539824;42;40;0.5;21;21;0;0.5
Control.SRR15539824;38;40;0.421052631578947;22;16;0.0789473684210527;0.421052631578947
Control.SRR15539824;41;40;0.560975609756098;18;23;0.0609756097560976;0.439024390243902
Control.SRR15539824;42;40;0.547619047619048;19;23;0.0476190476190477;0.452380952380952
Control.SRR15539824;32;40;0.40625;19;13;0.09375;0.40625
Control.SRR15539824;32;40;0.59375;13;19;0.09375;0.40625
Control.SRR15539824;35;40;0.514285714285714;17;18;0.0142857142857142;0.485714285714286
Control.SRR15539824;35;40;0.457142857142857;19;16;0.0428571428571429;0.457142857142857
Control.SRR15539824;40;40;0.675;13;27;0.175;0.325
Control.SRR15539824;42;40;0.404761904761905;25;17;0.0952380952380952;0.404761904761905
Control.SRR15539824;35;40;0.542857142857143;16;19;0.0428571428571428;0.457142857142857
Control.SRR15539824;34;40;0.529411764705882;16;18;0.0294117647058824;0.470588235294118
Control.SRR15539824;39;40;0.58974358974359;16;23;0.0897435897435898;0.41025641025641
Control.SRR15539824;38;40;0.605263157894737;15;23;0.105263157894737;0.394736842105263
Control.SRR15539824;34;40;0.5;17;17;0;0.5
Control.SRR15539824;39;40;0.564102564102564;17;22;0.0641025641025641;0.435897435897436
Control.SRR15539824;40;40;0.425;23;17;0.075;0.425
Control.SRR15539824;36;40;0.75;9;27;0.25;0.25
Control.SRR15539824;39;40;0.692307692307692;12;27;0.192307692307692;0.307692307692308
Control.SRR15539824;38;40;0.447368421052632;21;17;0.0526315789473684;0.447368421052632
Control.SRR15539824;35;40;0.571428571428571;15;20;0.0714285714285714;0.428571428571429
Control.SRR15539824;38;40;0.552631578947368;17;21;0.0526315789473685;0.447368421052632
Control.SRR15539824;32;40;0.46875;17;15;0.03125;0.46875
Control.SRR15539824;39;40;0.512820512820513;19;20;0.0128205128205128;0.487179487179487
Control.SRR15539824;33;40;0.484848484848485;17;16;0.0151515151515151;0.484848484848485
Control.SRR15539824;42;40;0.380952380952381;26;16;0.119047619047619;0.380952380952381
Control.SRR15539824;36;40;0.611111111111111;14;22;0.111111111111111;0.388888888888889
Control.SRR15539824;38;40;0.447368421052632;21;17;0.0526315789473684;0.447368421052632
Control.SRR15539824;38;40;0.368421052631579;24;14;0.131578947368421;0.368421052631579
Control.SRR15539824;33;40;0.606060606060606;13;20;0.106060606060606;0.393939393939394
Control.SRR15539824;33;40;0.424242424242424;19;14;0.0757575757575757;0.424242424242424
Control.SRR15539824;34;40;0.558823529411765;15;19;0.0588235294117647;0.441176470588235
Control.SRR15539824;35;40;0.485714285714286;18;17;0.0142857142857143;0.485714285714286
Control.SRR15539824;39;40;0.358974358974359;25;14;0.141025641025641;0.358974358974359
Control.SRR15539824;32;40;0.53125;15;17;0.03125;0.46875
Control.SRR15539824;41;40;0.609756097560976;16;25;0.109756097560976;0.390243902439024
Control.SRR15539824;41;40;0.48780487804878;21;20;0.0121951219512195;0.48780487804878
Control.SRR15539824;42;40;0.595238095238095;17;25;0.0952380952380952;0.404761904761905
Control.SRR15539824;42;40;0.571428571428571;18;24;0.0714285714285714;0.428571428571429
Control.SRR15539824;41;40;0.51219512195122;20;21;0.0121951219512195;0.48780487804878
Control.SRR15539824;37;40;0.648648648648649;13;24;0.148648648648649;0.351351351351351
Control.SRR15539824;35;40;0.542857142857143;16;19;0.0428571428571428;0.457142857142857
Control.SRR15539824;33;40;0.515151515151515;16;17;0.0151515151515151;0.484848484848485
Control.SRR15539824;36;40;0.611111111111111;14;22;0.111111111111111;0.388888888888889
Control.SRR15539824;38;40;0.578947368421053;16;22;0.0789473684210527;0.421052631578947
Control.SRR15539824;32;40;0.375;20;12;0.125;0.375
Control.SRR15539824;37;40;0.324324324324324;25;12;0.175675675675676;0.324324324324324
Control.SRR15539824;33;40;0.515151515151515;16;17;0.0151515151515151;0.484848484848485
Control.SRR15539824;33;40;0.545454545454545;15;18;0.0454545454545454;0.454545454545455
Control.SRR15539824;40;40;0.3;28;12;0.2;0.3
Control.SRR15539824;42;40;0.404761904761905;25;17;0.0952380952380952;0.404761904761905
Control.SRR15539824;39;40;0.487179487179487;20;19;0.0128205128205128;0.487179487179487
Control.SRR15539824;40;40;0.325;27;13;0.175;0.325
Control.SRR15539824;37;40;0.459459459459459;20;17;0.0405405405405405;0.459459459459459
Control.SRR15539824;34;40;0.352941176470588;22;12;0.147058823529412;0.352941176470588
Control.SRR15539824;38;40;0.473684210526316;20;18;0.0263157894736842;0.473684210526316
Control.SRR15539824;37;40;0.459459459459459;20;17;0.0405405405405405;0.459459459459459
Control.SRR15539824;38;40;0.526315789473684;18;20;0.0263157894736842;0.473684210526316
Control.SRR15539824;35;40;0.657142857142857;12;23;0.157142857142857;0.342857142857143
Control.SRR15539824;39;40;0.41025641025641;23;16;0.0897435897435898;0.41025641025641
Control.SRR15539824;35;40;0.371428571428571;22;13;0.128571428571429;0.371428571428571
Control.SRR15539824;40;40;0.35;26;14;0.15;0.35
Control.SRR15539824;37;40;0.27027027027027;27;10;0.22972972972973;0.27027027027027
Control.SRR15539824;37;40;0.378378378378378;23;14;0.121621621621622;0.378378378378378
Control.SRR15539824;37;40;0.432432432432432;21;16;0.0675675675675675;0.432432432432432
Control.SRR15539824;34;40;0.441176470588235;19;15;0.0588235294117647;0.441176470588235
Control.SRR15539824;33;40;0.484848484848485;17;16;0.0151515151515151;0.484848484848485
Control.SRR15539824;38;40;0.5;19;19;0;0.5
Control.SRR15539824;42;40;0.571428571428571;18;24;0.0714285714285714;0.428571428571429
Control.SRR15539824;40;40;0.475;21;19;0.025;0.475
Control.SRR15539824;35;40;0.457142857142857;19;16;0.0428571428571429;0.457142857142857
Control.SRR15539824;37;40;0.459459459459459;20;17;0.0405405405405405;0.459459459459459
Control.SRR15539824;35;40;0.685714285714286;11;24;0.185714285714286;0.314285714285714
Control.SRR15539824;37;40;0.540540540540541;17;20;0.0405405405405406;0.459459459459459
Control.SRR15539824;37;40;0.594594594594595;15;22;0.0945945945945946;0.405405405405405
Control.SRR15539824;36;40;0.611111111111111;14;22;0.111111111111111;0.388888888888889
Control.SRR15539824;39;40;0.487179487179487;20;19;0.0128205128205128;0.487179487179487
Control.SRR15539824;32;40;0.375;20;12;0.125;0.375
Control.SRR15539824;41;40;0.439024390243902;23;18;0.0609756097560976;0.439024390243902
Control.SRR15539824;41;40;0.414634146341463;24;17;0.0853658536585366;0.414634146341463
Control.SRR15539824;36;40;0.416666666666667;21;15;0.0833333333333333;0.416666666666667
Control.SRR15539824;37;40;0.540540540540541;17;20;0.0405405405405406;0.459459459459459
Control.SRR15539824;34;40;0.470588235294118;18;16;0.0294117647058824;0.470588235294118
Control.SRR15539824;42;40;0.571428571428571;18;24;0.0714285714285714;0.428571428571429
Control.SRR15539824;33;40;0.484848484848485;17;16;0.0151515151515151;0.484848484848485
Control.SRR15539824;41;40;0.48780487804878;21;20;0.0121951219512195;0.48780487804878
Control.SRR15539824;42;40;0.571428571428571;18;24;0.0714285714285714;0.428571428571429
Control.SRR15539824;36;40;0.472222222222222;19;17;0.0277777777777778;0.472222222222222
Control.SRR15539824;36;40;0.472222222222222;19;17;0.0277777777777778;0.472222222222222
Control.SRR15539824;37;40;0.378378378378378;23;14;0.121621621621622;0.378378378378378
Control.SRR15539824;33;40;0.424242424242424;19;14;0.0757575757575757;0.424242424242424
Control.SRR15539824;38;40;0.368421052631579;24;14;0.131578947368421;0.368421052631579
Control.SRR15539824;38;40;0.473684210526316;20;18;0.0263157894736842;0.473684210526316
Control.SRR15539824;33;40;0.545454545454545;15;18;0.0454545454545454;0.454545454545455
Control.SRR15539824;40;40;0.55;18;22;0.05;0.45
Control.SRR15539824;40;40;0.475;21;19;0.025;0.475
Control.SRR15539824;41;40;0.48780487804878;21;20;0.0121951219512195;0.48780487804878
Control.SRR15539824;40;40;0.5;20;20;0;0.5
Control.SRR15539824;39;40;0.487179487179487;20;19;0.0128205128205128;0.487179487179487
Control.SRR15539824;33;40;0.545454545454545;15;18;0.0454545454545454;0.454545454545455
Control.SRR15539824;39;40;0.487179487179487;20;19;0.0128205128205128;0.487179487179487
Control.SRR15539824;34;40;0.382352941176471;21;13;0.117647058823529;0.382352941176471
Control.SRR15539824;34;40;0.470588235294118;18;16;0.0294117647058824;0.470588235294118
Control.SRR15539824;35;40;0.542857142857143;16;19;0.0428571428571428;0.457142857142857
Control.SRR15539824;37;40;0.621621621621622;14;23;0.121621621621622;0.378378378378378
Control.SRR15539824;35;40;0.428571428571429;20;15;0.0714285714285715;0.428571428571429
Control.SRR15539824;38;40;0.447368421052632;21;17;0.0526315789473684;0.447368421052632
Control.SRR15539824;40;40;0.425;23;17;0.075;0.425
Control.SRR15539824;37;40;0.378378378378378;23;14;0.121621621621622;0.378378378378378
Control.SRR15539824;39;40;0.512820512820513;19;20;0.0128205128205128;0.487179487179487
Control.SRR15539824;37;40;0.432432432432432;21;16;0.0675675675675675;0.432432432432432
Control.SRR15539824;33;40;0.424242424242424;19;14;0.0757575757575757;0.424242424242424
Control.SRR15539824;40;40;0.55;18;22;0.05;0.45
Control.SRR15539824;36;40;0.472222222222222;19;17;0.0277777777777778;0.472222222222222
Control.SRR15539824;35;40;0.571428571428571;15;20;0.0714285714285714;0.428571428571429
Control.SRR15539824;32;40;0.40625;19;13;0.09375;0.40625
Control.SRR15539824;32;40;0.625;12;20;0.125;0.375
Control.SRR15539824;38;40;0.447368421052632;21;17;0.0526315789473684;0.447368421052632
Control.SRR15539824;35;40;0.6;14;21;0.1;0.4
Control.SRR15539824;39;40;0.512820512820513;19;20;0.0128205128205128;0.487179487179487
Control.SRR15539824;34;40;0.558823529411765;15;19;0.0588235294117647;0.441176470588235
Control.SRR15539824;35;40;0.485714285714286;18;17;0.0142857142857143;0.485714285714286
Control.SRR15539824;37;40;0.594594594594595;15;22;0.0945945945945946;0.405405405405405
Control.SRR15539824;33;40;0.484848484848485;17;16;0.0151515151515151;0.484848484848485
Control.SRR15539824;32;40;0.5;16;16;0;0.5
Control.SRR15539824;40;40;0.55;18;22;0.05;0.45
Control.SRR15539824;38;40;0.578947368421053;16;22;0.0789473684210527;0.421052631578947
Control.SRR15539824;37;40;0.405405405405405;22;15;0.0945945945945946;0.405405405405405
Control.SRR15539824;39;40;0.538461538461538;18;21;0.0384615384615384;0.461538461538462
Control.SRR15539824;40;40;0.525;19;21;0.025;0.475
Control.SRR15539824;33;40;0.515151515151515;16;17;0.0151515151515151;0.484848484848485
Control.SRR15539824;37;40;0.567567567567568;16;21;0.0675675675675675;0.432432432432432
Control.SRR15539824;42;40;0.547619047619048;19;23;0.0476190476190477;0.452380952380952
Control.SRR15539824;32;40;0.59375;13;19;0.09375;0.40625
Control.SRR15539824;35;40;0.428571428571429;20;15;0.0714285714285715;0.428571428571429
Control.SRR15539824;38;40;0.447368421052632;21;17;0.0526315789473684;0.447368421052632
Control.SRR15539824;41;40;0.365853658536585;26;15;0.134146341463415;0.365853658536585
Control.SRR15539824;39;40;0.538461538461538;18;21;0.0384615384615384;0.461538461538462
Control.SRR15539824;37;40;0.351351351351351;24;13;0.148648648648649;0.351351351351351
Control.SRR15539824;39;40;0.615384615384615;15;24;0.115384615384615;0.384615384615385
Control.SRR15539824;40;40;0.675;13;27;0.175;0.325
Control.SRR15539824;38;40;0.631578947368421;14;24;0.131578947368421;0.368421052631579
Control.SRR15539824;41;40;0.560975609756098;18;23;0.0609756097560976;0.439024390243902
Control.SRR15539824;34;40;0.529411764705882;16;18;0.0294117647058824;0.470588235294118
Control.SRR15539824;33;40;0.515151515151515;16;17;0.0151515151515151;0.484848484848485
Control.SRR15539824;37;40;0.297297297297297;26;11;0.202702702702703;0.297297297297297
Control.SRR15539824;38;40;0.473684210526316;20;18;0.0263157894736842;0.473684210526316
Control.SRR15539824;40;40;0.55;18;22;0.05;0.45
Control.SRR15539824;36;40;0.5;18;18;0;0.5
Control.SRR15539824;32;40;0.40625;19;13;0.09375;0.40625
Control.SRR15539824;37;40;0.594594594594595;15;22;0.0945945945945946;0.405405405405405
Control.SRR15539824;36;40;0.472222222222222;19;17;0.0277777777777778;0.472222222222222
Control.SRR15539824;36;40;0.583333333333333;15;21;0.0833333333333334;0.416666666666667
Control.SRR15539824;32;40;0.5;16;16;0;0.5
Control.SRR15539824;37;40;0.594594594594595;15;22;0.0945945945945946;0.405405405405405
Control.SRR15539824;33;40;0.606060606060606;13;20;0.106060606060606;0.393939393939394
Control.SRR15539824;33;40;0.333333333333333;22;11;0.166666666666667;0.333333333333333
Control.SRR15539824;41;40;0.634146341463415;15;26;0.134146341463415;0.365853658536585
Control.SRR15539824;36;40;0.444444444444444;20;16;0.0555555555555556;0.444444444444444
Control.SRR15539824;34;40;0.529411764705882;16;18;0.0294117647058824;0.470588235294118
Control.SRR15539824;38;40;0.473684210526316;20;18;0.0263157894736842;0.473684210526316
Control.SRR15539824;35;40;0.514285714285714;17;18;0.0142857142857142;0.485714285714286
Control.SRR15539824;36;40;0.694444444444444;11;25;0.194444444444444;0.305555555555556
Control.SRR15539824;40;40;0.575;17;23;0.075;0.425
Control.SRR15539824;33;40;0.515151515151515;16;17;0.0151515151515151;0.484848484848485
Control.SRR15539824;41;40;0.439024390243902;23;18;0.0609756097560976;0.439024390243902
Control.SRR15539824;36;40;0.472222222222222;19;17;0.0277777777777778;0.472222222222222
Control.SRR15539824;33;40;0.545454545454545;15;18;0.0454545454545454;0.454545454545455
Control.SRR15539824;34;40;0.264705882352941;25;9;0.235294117647059;0.264705882352941
Control.SRR15539824;36;40;0.416666666666667;21;15;0.0833333333333333;0.416666666666667
Control.SRR15539824;35;40;0.514285714285714;17;18;0.0142857142857142;0.485714285714286
Control.SRR15539824;35;40;0.514285714285714;17;18;0.0142857142857142;0.485714285714286
Control.SRR15539824;37;40;0.405405405405405;22;15;0.0945945945945946;0.405405405405405
Control.SRR15539824;38;40;0.5;19;19;0;0.5
Control.SRR15539824;32;40;0.625;12;20;0.125;0.375
Control.SRR15539824;37;40;0.594594594594595;15;22;0.0945945945945946;0.405405405405405
Control.SRR15539824;34;40;0.676470588235294;11;23;0.176470588235294;0.323529411764706
Control.SRR15539824;38;40;0.578947368421053;16;22;0.0789473684210527;0.421052631578947
Control.SRR15539824;38;40;0.578947368421053;16;22;0.0789473684210527;0.421052631578947
Control.SRR15539824;33;40;0.636363636363636;12;21;0.136363636363636;0.363636363636364
Control.SRR15539824;38;40;0.421052631578947;22;16;0.0789473684210527;0.421052631578947
Control.SRR15539824;35;40;0.628571428571429;13;22;0.128571428571429;0.371428571428571
Control.SRR15539824;42;40;0.642857142857143;15;27;0.142857142857143;0.357142857142857
Control.SRR15539824;37;40;0.675675675675676;12;25;0.175675675675676;0.324324324324324
Control.SRR15539824;34;40;0.5;17;17;0;0.5
Control.SRR15539824;42;40;0.428571428571429;24;18;0.0714285714285715;0.428571428571429
Control.SRR15539824;37;40;0.513513513513513;18;19;0.0135135135135135;0.486486486486487
Control.SRR15539824;37;40;0.486486486486487;19;18;0.0135135135135135;0.486486486486487
Control.SRR15539824;38;40;0.605263157894737;15;23;0.105263157894737;0.394736842105263
Control.SRR15539824;40;40;0.6;16;24;0.1;0.4
Control.SRR15539824;42;40;0.452380952380952;23;19;0.0476190476190476;0.452380952380952
Control.SRR15539824;39;40;0.461538461538462;21;18;0.0384615384615384;0.461538461538462
Control.SRR15539824;38;40;0.526315789473684;18;20;0.0263157894736842;0.473684210526316
Control.SRR15539824;37;40;0.432432432432432;21;16;0.0675675675675675;0.432432432432432
Control.SRR15539824;36;40;0.388888888888889;22;14;0.111111111111111;0.388888888888889
Control.SRR15539824;35;40;0.485714285714286;18;17;0.0142857142857143;0.485714285714286
Control.SRR15539824;34;40;0.588235294117647;14;20;0.0882352941176471;0.411764705882353
Control.SRR15539824;35;40;0.514285714285714;17;18;0.0142857142857142;0.485714285714286
Control.SRR15539824;36;40;0.527777777777778;17;19;0.0277777777777778;0.472222222222222
Control.SRR15539824;37;40;0.243243243243243;28;9;0.256756756756757;0.243243243243243
Control.SRR15539824;37;40;0.351351351351351;24;13;0.148648648648649;0.351351351351351
Control.SRR15539824;39;40;0.512820512820513;19;20;0.0128205128205128;0.487179487179487
Control.SRR15539824;32;40;0.5625;14;18;0.0625;0.4375
Control.SRR15539824;32;40;0.5;16;16;0;0.5
Control.SRR15539824;39;40;0.666666666666667;13;26;0.166666666666667;0.333333333333333
Control.SRR15539824;39;40;0.435897435897436;22;17;0.0641025641025641;0.435897435897436
Control.SRR15539824;33;40;0.454545454545455;18;15;0.0454545454545455;0.454545454545455
Control.SRR15539824;38;40;0.526315789473684;18;20;0.0263157894736842;0.473684210526316
Control.SRR15539824;36;40;0.583333333333333;15;21;0.0833333333333334;0.416666666666667
Control.SRR15539824;34;40;0.529411764705882;16;18;0.0294117647058824;0.470588235294118
Control.SRR15539824;39;40;0.487179487179487;20;19;0.0128205128205128;0.487179487179487
Control.SRR15539824;37;40;0.486486486486487;19;18;0.0135135135135135;0.486486486486487
Control.SRR15539824;41;40;0.48780487804878;21;20;0.0121951219512195;0.48780487804878
Control.SRR15539824;34;40;0.529411764705882;16;18;0.0294117647058824;0.470588235294118
Control.SRR15539824;37;40;0.513513513513513;18;19;0.0135135135135135;0.486486486486487
Control.SRR15539824;37;40;0.486486486486487;19;18;0.0135135135135135;0.486486486486487
Control.SRR15539824;38;40;0.289473684210526;27;11;0.210526315789474;0.289473684210526
Control.SRR15539824;35;40;0.628571428571429;13;22;0.128571428571429;0.371428571428571
Control.SRR15539824;36;40;0.361111111111111;23;13;0.138888888888889;0.361111111111111
Control.SRR15539824;39;40;0.564102564102564;17;22;0.0641025641025641;0.435897435897436
Control.SRR15539824;38;40;0.578947368421053;16;22;0.0789473684210527;0.421052631578947
Control.SRR15539824;33;40;0.545454545454545;15;18;0.0454545454545454;0.454545454545455
Control.SRR15539824;38;40;0.552631578947368;17;21;0.0526315789473685;0.447368421052632
Control.SRR15539824;33;40;0.484848484848485;17;16;0.0151515151515151;0.484848484848485
Control.SRR15539824;32;40;0.46875;17;15;0.03125;0.46875
Control.SRR15539824;37;40;0.540540540540541;17;20;0.0405405405405406;0.459459459459459
Control.SRR15539824;41;40;0.585365853658537;17;24;0.0853658536585366;0.414634146341463
Control.SRR15539824;40;40;0.575;17;23;0.075;0.425
Control.SRR15539824;39;40;0.435897435897436;22;17;0.0641025641025641;0.435897435897436
Control.SRR15539824;38;40;0.394736842105263;23;15;0.105263157894737;0.394736842105263
Control.SRR15539824;39;40;0.487179487179487;20;19;0.0128205128205128;0.487179487179487
Control.SRR15539824;39;40;0.41025641025641;23;16;0.0897435897435898;0.41025641025641
Control.SRR15539824;39;40;0.564102564102564;17;22;0.0641025641025641;0.435897435897436
Control.SRR15539824;34;40;0.558823529411765;15;19;0.0588235294117647;0.441176470588235
Control.SRR15539824;35;40;0.428571428571429;20;15;0.0714285714285715;0.428571428571429
Control.SRR15539824;32;40;0.40625;19;13;0.09375;0.40625
Control.SRR15539824;41;40;0.560975609756098;18;23;0.0609756097560976;0.439024390243902
Control.SRR15539824;38;40;0.526315789473684;18;20;0.0263157894736842;0.473684210526316
Control.SRR15539824;37;40;0.513513513513513;18;19;0.0135135135135135;0.486486486486487
Control.SRR15539824;40;40;0.325;27;13;0.175;0.325
Control.SRR15539824;38;40;0.447368421052632;21;17;0.0526315789473684;0.447368421052632
Control.SRR15539824;33;40;0.606060606060606;13;20;0.106060606060606;0.393939393939394
Control.SRR15539824;36;40;0.638888888888889;13;23;0.138888888888889;0.361111111111111
Control.SRR15539824;36;40;0.472222222222222;19;17;0.0277777777777778;0.472222222222222
Control.SRR15539824;38;40;0.447368421052632;21;17;0.0526315789473684;0.447368421052632
Control.SRR15539824;38;40;0.447368421052632;21;17;0.0526315789473684;0.447368421052632
Control.SRR15539824;39;40;0.41025641025641;23;16;0.0897435897435898;0.41025641025641
Control.SRR15539824;42;40;0.476190476190476;22;20;0.0238095238095238;0.476190476190476
Control.SRR15539824;33;40;0.666666666666667;11;22;0.166666666666667;0.333333333333333
Control.SRR15539824;42;40;0.476190476190476;22;20;0.0238095238095238;0.476190476190476
Control.SRR15539824;34;40;0.441176470588235;19;15;0.0588235294117647;0.441176470588235
Control.SRR15539824;32;40;0.6875;10;22;0.1875;0.3125
Control.SRR15539824;37;40;0.459459459459459;20;17;0.0405405405405405;0.459459459459459
Control.SRR15539824;37;40;0.567567567567568;16;21;0.0675675675675675;0.432432432432432
Control.SRR15539824;36;40;0.527777777777778;17;19;0.0277777777777778;0.472222222222222
Control.SRR15539824;33;40;0.454545454545455;18;15;0.0454545454545455;0.454545454545455
Control.SRR15539824;39;40;0.487179487179487;20;19;0.0128205128205128;0.487179487179487
Control.SRR15539824;35;40;0.485714285714286;18;17;0.0142857142857143;0.485714285714286
Control.SRR15539824;37;40;0.378378378378378;23;14;0.121621621621622;0.378378378378378
Control.SRR15539824;34;40;0.676470588235294;11;23;0.176470588235294;0.323529411764706
Control.SRR15539824;34;40;0.470588235294118;18;16;0.0294117647058824;0.470588235294118
Control.SRR15539824;33;40;0.484848484848485;17;16;0.0151515151515151;0.484848484848485
Control.SRR15539824;34;40;0.588235294117647;14;20;0.0882352941176471;0.411764705882353
Control.SRR15539824;39;40;0.512820512820513;19;20;0.0128205128205128;0.487179487179487
Control.SRR15539824;36;40;0.666666666666667;12;24;0.166666666666667;0.333333333333333
Control.SRR15539824;41;40;0.609756097560976;16;25;0.109756097560976;0.390243902439024
Control.SRR15539824;42;40;0.523809523809524;20;22;0.0238095238095238;0.476190476190476
Control.SRR15539824;41;40;0.439024390243902;23;18;0.0609756097560976;0.439024390243902
Control.SRR15539824;40;40;0.5;20;20;0;0.5
Control.SRR15539824;35;40;0.571428571428571;15;20;0.0714285714285714;0.428571428571429
Control.SRR15539824;32;40;0.5625;14;18;0.0625;0.4375
Control.SRR15539824;35;40;0.628571428571429;13;22;0.128571428571429;0.371428571428571
Control.SRR15539824;34;40;0.470588235294118;18;16;0.0294117647058824;0.470588235294118
Control.SRR15539824;38;40;0.526315789473684;18;20;0.0263157894736842;0.473684210526316
Control.SRR15539824;38;40;0.342105263157895;25;13;0.157894736842105;0.342105263157895
Control.SRR15539824;33;40;0.606060606060606;13;20;0.106060606060606;0.393939393939394
Control.SRR15539824;32;40;0.4375;18;14;0.0625;0.4375
Control.SRR15539824;36;40;0.416666666666667;21;15;0.0833333333333333;0.416666666666667
Control.SRR15539824;34;40;0.676470588235294;11;23;0.176470588235294;0.323529411764706
Control.SRR15539824;34;40;0.411764705882353;20;14;0.0882352941176471;0.411764705882353
Control.SRR15539824;37;40;0.486486486486487;19;18;0.0135135135135135;0.486486486486487
Control.SRR15539824;35;40;0.542857142857143;16;19;0.0428571428571428;0.457142857142857
Control.SRR15539824;40;40;0.475;21;19;0.025;0.475
Control.SRR15539824;42;40;0.452380952380952;23;19;0.0476190476190476;0.452380952380952
Control.SRR15539824;36;40;0.472222222222222;19;17;0.0277777777777778;0.472222222222222
Control.SRR15539824;36;40;0.638888888888889;13;23;0.138888888888889;0.361111111111111
Control.SRR15539824;33;40;0.575757575757576;14;19;0.0757575757575758;0.424242424242424
Control.SRR15539824;41;40;0.51219512195122;20;21;0.0121951219512195;0.48780487804878
Control.SRR15539824;32;40;0.53125;15;17;0.03125;0.46875
Control.SRR15539824;32;40;0.53125;15;17;0.03125;0.46875
Control.SRR15539824;35;40;0.514285714285714;17;18;0.0142857142857142;0.485714285714286
Control.SRR15539824;42;40;0.452380952380952;23;19;0.0476190476190476;0.452380952380952
Control.SRR15539824;34;40;0.470588235294118;18;16;0.0294117647058824;0.470588235294118
Control.SRR15539824;37;40;0.513513513513513;18;19;0.0135135135135135;0.486486486486487
Control.SRR15539824;34;40;0.558823529411765;15;19;0.0588235294117647;0.441176470588235
Control.SRR15539824;35;40;0.514285714285714;17;18;0.0142857142857142;0.485714285714286
Control.SRR15539824;36;40;0.638888888888889;13;23;0.138888888888889;0.361111111111111
Control.SRR15539824;34;40;0.5;17;17;0;0.5
Control.SRR15539824;35;40;0.514285714285714;17;18;0.0142857142857142;0.485714285714286
Control.SRR15539824;35;40;0.485714285714286;18;17;0.0142857142857143;0.485714285714286
Control.SRR15539824;34;40;0.470588235294118;18;16;0.0294117647058824;0.470588235294118
Control.SRR15539824;40;40;0.4;24;16;0.1;0.4
Control.SRR15539824;33;40;0.606060606060606;13;20;0.106060606060606;0.393939393939394
Control.SRR15539824;38;40;0.368421052631579;24;14;0.131578947368421;0.368421052631579
Control.SRR15539824;40;40;0.525;19;21;0.025;0.475
Control.SRR15539824;39;40;0.512820512820513;19;20;0.0128205128205128;0.487179487179487
Control.SRR15539824;39;40;0.58974358974359;16;23;0.0897435897435898;0.41025641025641
Control.SRR15539824;41;40;0.51219512195122;20;21;0.0121951219512195;0.48780487804878
Control.SRR15539824;35;40;0.571428571428571;15;20;0.0714285714285714;0.428571428571429
Control.SRR15539824;40;40;0.425;23;17;0.075;0.425
Control.SRR15539824;38;40;0.447368421052632;21;17;0.0526315789473684;0.447368421052632
Control.SRR15539824;33;40;0.515151515151515;16;17;0.0151515151515151;0.484848484848485
Control.SRR15539824;38;40;0.605263157894737;15;23;0.105263157894737;0.394736842105263
Control.SRR15539824;38;40;0.5;19;19;0;0.5
Control.SRR15539824;34;40;0.529411764705882;16;18;0.0294117647058824;0.470588235294118
Control.SRR15539824;33;40;0.515151515151515;16;17;0.0151515151515151;0.484848484848485
Control.SRR15539824;32;40;0.53125;15;17;0.03125;0.46875
Control.SRR15539824;34;40;0.5;17;17;0;0.5
Control.SRR15539824;36;40;0.416666666666667;21;15;0.0833333333333333;0.416666666666667
Control.SRR15539824;36;40;0.555555555555556;16;20;0.0555555555555556;0.444444444444444
Control.SRR15539824;36;40;0.5;18;18;0;0.5
Control.SRR15539824;33;40;0.606060606060606;13;20;0.106060606060606;0.393939393939394
Control.SRR15539824;40;40;0.5;20;20;0;0.5
Control.SRR15539824;32;40;0.5625;14;18;0.0625;0.4375
Control.SRR15539824;38;40;0.421052631578947;22;16;0.0789473684210527;0.421052631578947
Control.SRR15539824;39;40;0.538461538461538;18;21;0.0384615384615384;0.461538461538462
Control.SRR15539824;37;40;0.675675675675676;12;25;0.175675675675676;0.324324324324324
Control.SRR15539824;39;40;0.512820512820513;19;20;0.0128205128205128;0.487179487179487
Control.SRR15539824;32;40;0.53125;15;17;0.03125;0.46875
Control.SRR15539824;32;40;0.53125;15;17;0.03125;0.46875
Control.SRR15539824;33;40;0.484848484848485;17;16;0.0151515151515151;0.484848484848485
Control.SRR15539824;32;40;0.5625;14;18;0.0625;0.4375
Control.SRR15539824;34;40;0.617647058823529;13;21;0.117647058823529;0.382352941176471
Control.SRR15539824;34;40;0.411764705882353;20;14;0.0882352941176471;0.411764705882353
Control.SRR15539824;32;40;0.59375;13;19;0.09375;0.40625
Control.SRR15539824;42;40;0.571428571428571;18;24;0.0714285714285714;0.428571428571429
Control.SRR15539824;32;40;0.40625;19;13;0.09375;0.40625
Control.SRR15539824;37;40;0.432432432432432;21;16;0.0675675675675675;0.432432432432432
Control.SRR15539824;42;40;0.547619047619048;19;23;0.0476190476190477;0.452380952380952
Control.SRR15539824;34;40;0.382352941176471;21;13;0.117647058823529;0.382352941176471
Control.SRR15539824;34;40;0.588235294117647;14;20;0.0882352941176471;0.411764705882353
Control.SRR15539824;33;40;0.606060606060606;13;20;0.106060606060606;0.393939393939394
Control.SRR15539824;33;40;0.606060606060606;13;20;0.106060606060606;0.393939393939394
Control.SRR15539824;42;40;0.595238095238095;17;25;0.0952380952380952;0.404761904761905
Control.SRR15539824;35;40;0.342857142857143;23;12;0.157142857142857;0.342857142857143
Control.SRR15539824;41;40;0.48780487804878;21;20;0.0121951219512195;0.48780487804878
Control.SRR15539824;37;40;0.324324324324324;25;12;0.175675675675676;0.324324324324324
Control.SRR15539824;32;40;0.53125;15;17;0.03125;0.46875
Control.SRR15539824;41;40;0.536585365853659;19;22;0.0365853658536586;0.463414634146341
Control.SRR15539824;40;40;0.475;21;19;0.025;0.475
Control.SRR15539824;37;40;0.459459459459459;20;17;0.0405405405405405;0.459459459459459
Control.SRR15539824;33;40;0.363636363636364;21;12;0.136363636363636;0.363636363636364
Control.SRR15539824;36;40;0.5;18;18;0;0.5
Control.SRR15539824;38;40;0.526315789473684;18;20;0.0263157894736842;0.473684210526316
Control.SRR15539824;41;40;0.365853658536585;26;15;0.134146341463415;0.365853658536585
Control.SRR15539824;39;40;0.564102564102564;17;22;0.0641025641025641;0.435897435897436
Control.SRR15539824;34;40;0.470588235294118;18;16;0.0294117647058824;0.470588235294118
Control.SRR15539824;33;40;0.515151515151515;16;17;0.0151515151515151;0.484848484848485
Control.SRR15539824;37;40;0.540540540540541;17;20;0.0405405405405406;0.459459459459459
Control.SRR15539824;34;40;0.558823529411765;15;19;0.0588235294117647;0.441176470588235
Control.SRR15539824;39;40;0.512820512820513;19;20;0.0128205128205128;0.487179487179487
Control.SRR15539824;36;40;0.444444444444444;20;16;0.0555555555555556;0.444444444444444
Control.SRR15539824;36;40;0.555555555555556;16;20;0.0555555555555556;0.444444444444444
Control.SRR15539824;35;40;0.485714285714286;18;17;0.0142857142857143;0.485714285714286
Control.SRR15539824;42;40;0.428571428571429;24;18;0.0714285714285715;0.428571428571429
Control.SRR15539824;38;40;0.605263157894737;15;23;0.105263157894737;0.394736842105263
Control.SRR15539824;34;40;0.588235294117647;14;20;0.0882352941176471;0.411764705882353
Control.SRR15539824;40;40;0.475;21;19;0.025;0.475
Control.SRR15539824;38;40;0.421052631578947;22;16;0.0789473684210527;0.421052631578947
Control.SRR15539824;34;40;0.441176470588235;19;15;0.0588235294117647;0.441176470588235
Control.SRR15539824;39;40;0.435897435897436;22;17;0.0641025641025641;0.435897435897436
Control.SRR15539824;34;40;0.352941176470588;22;12;0.147058823529412;0.352941176470588
Control.SRR15539824;39;40;0.487179487179487;20;19;0.0128205128205128;0.487179487179487
Control.SRR15539824;39;40;0.461538461538462;21;18;0.0384615384615384;0.461538461538462
Control.SRR15539824;40;40;0.525;19;21;0.025;0.475
Control.SRR15539824;34;40;0.411764705882353;20;14;0.0882352941176471;0.411764705882353
Control.SRR15539824;39;40;0.58974358974359;16;23;0.0897435897435898;0.41025641025641
Control.SRR15539824;36;40;0.527777777777778;17;19;0.0277777777777778;0.472222222222222
Control.SRR15539824;40;40;0.6;16;24;0.1;0.4
Control.SRR15539824;33;40;0.454545454545455;18;15;0.0454545454545455;0.454545454545455
Control.SRR15539824;34;40;0.470588235294118;18;16;0.0294117647058824;0.470588235294118
Control.SRR15539824;39;40;0.435897435897436;22;17;0.0641025641025641;0.435897435897436
Control.SRR15539824;39;40;0.564102564102564;17;22;0.0641025641025641;0.435897435897436
Control.SRR15539824;36;40;0.416666666666667;21;15;0.0833333333333333;0.416666666666667
Control.SRR15539824;34;40;0.411764705882353;20;14;0.0882352941176471;0.411764705882353
Control.SRR15539824;39;40;0.538461538461538;18;21;0.0384615384615384;0.461538461538462
Control.SRR15539824;34;40;0.382352941176471;21;13;0.117647058823529;0.382352941176471
Control.SRR15539824;41;40;0.609756097560976;16;25;0.109756097560976;0.390243902439024
Control.SRR15539824;37;40;0.378378378378378;23;14;0.121621621621622;0.378378378378378
Control.SRR15539824;33;40;0.393939393939394;20;13;0.106060606060606;0.393939393939394
Control.SRR15539824;38;40;0.657894736842105;13;25;0.157894736842105;0.342105263157895
Control.SRR15539824;39;40;0.512820512820513;19;20;0.0128205128205128;0.487179487179487
Control.SRR15539824;35;40;0.514285714285714;17;18;0.0142857142857142;0.485714285714286
Control.SRR15539824;37;40;0.594594594594595;15;22;0.0945945945945946;0.405405405405405
Control.SRR15539824;40;40;0.675;13;27;0.175;0.325
Control.SRR15539824;42;40;0.595238095238095;17;25;0.0952380952380952;0.404761904761905
Control.SRR15539824;33;40;0.424242424242424;19;14;0.0757575757575757;0.424242424242424
Control.SRR15539824;32;40;0.5;16;16;0;0.5
Control.SRR15539824;37;40;0.486486486486487;19;18;0.0135135135135135;0.486486486486487
Control.SRR15539824;39;40;0.384615384615385;24;15;0.115384615384615;0.384615384615385
Control.SRR15539824;41;40;0.560975609756098;18;23;0.0609756097560976;0.439024390243902
Control.SRR15539824;40;40;0.45;22;18;0.05;0.45
Control.SRR15539824;33;40;0.545454545454545;15;18;0.0454545454545454;0.454545454545455
Control.SRR15539824;41;40;0.439024390243902;23;18;0.0609756097560976;0.439024390243902
Control.SRR15539824;35;40;0.457142857142857;19;16;0.0428571428571429;0.457142857142857
Control.SRR15539824;41;40;0.390243902439024;25;16;0.109756097560976;0.390243902439024
Control.SRR15539824;39;40;0.384615384615385;24;15;0.115384615384615;0.384615384615385
Control.SRR15539824;38;40;0.342105263157895;25;13;0.157894736842105;0.342105263157895
Control.SRR15539824;38;40;0.447368421052632;21;17;0.0526315789473684;0.447368421052632
Control.SRR15539824;38;40;0.447368421052632;21;17;0.0526315789473684;0.447368421052632
Control.SRR15539824;38;40;0.5;19;19;0;0.5
Control.SRR15539824;33;40;0.545454545454545;15;18;0.0454545454545454;0.454545454545455
Control.SRR15539824;42;40;0.428571428571429;24;18;0.0714285714285715;0.428571428571429
Control.SRR15539824;35;40;0.485714285714286;18;17;0.0142857142857143;0.485714285714286
Control.SRR15539824;33;40;0.454545454545455;18;15;0.0454545454545455;0.454545454545455
Control.SRR15539824;36;40;0.527777777777778;17;19;0.0277777777777778;0.472222222222222
Control.SRR15539824;36;40;0.444444444444444;20;16;0.0555555555555556;0.444444444444444
Control.SRR15539824;36;40;0.5;18;18;0;0.5
Control.SRR15539824;36;40;0.527777777777778;17;19;0.0277777777777778;0.472222222222222
Control.SRR15539824;42;40;0.571428571428571;18;24;0.0714285714285714;0.428571428571429
Control.SRR15539824;40;40;0.475;21;19;0.025;0.475
Control.SRR15539824;40;40;0.525;19;21;0.025;0.475
Control.SRR15539824;34;40;0.470588235294118;18;16;0.0294117647058824;0.470588235294118
Control.SRR15539824;41;40;0.609756097560976;16;25;0.109756097560976;0.390243902439024
Control.SRR15539824;41;40;0.609756097560976;16;25;0.109756097560976;0.390243902439024
Control.SRR15539824;36;40;0.444444444444444;20;16;0.0555555555555556;0.444444444444444
Control.SRR15539824;35;40;0.457142857142857;19;16;0.0428571428571429;0.457142857142857
Control.SRR15539824;32;40;0.4375;18;14;0.0625;0.4375
Control.SRR15539824;37;40;0.594594594594595;15;22;0.0945945945945946;0.405405405405405
Control.SRR15539824;42;40;0.476190476190476;22;20;0.0238095238095238;0.476190476190476
Control.SRR15539824;41;40;0.365853658536585;26;15;0.134146341463415;0.365853658536585
Control.SRR15539824;34;40;0.5;17;17;0;0.5
Control.SRR15539824;36;40;0.444444444444444;20;16;0.0555555555555556;0.444444444444444
Control.SRR15539824;37;40;0.675675675675676;12;25;0.175675675675676;0.324324324324324
Control.SRR15539824;35;40;0.6;14;21;0.1;0.4
Control.SRR15539824;32;40;0.5625;14;18;0.0625;0.4375
Control.SRR15539824;32;40;0.46875;17;15;0.03125;0.46875
Control.SRR15539824;37;40;0.513513513513513;18;19;0.0135135135135135;0.486486486486487
Control.SRR15539824;36;40;0.444444444444444;20;16;0.0555555555555556;0.444444444444444
Control.SRR15539824;35;40;0.485714285714286;18;17;0.0142857142857143;0.485714285714286
Control.SRR15539824;35;40;0.628571428571429;13;22;0.128571428571429;0.371428571428571
Control.SRR15539824;34;40;0.676470588235294;11;23;0.176470588235294;0.323529411764706
Control.SRR15539824;38;40;0.421052631578947;22;16;0.0789473684210527;0.421052631578947
Control.SRR15539824;41;40;0.585365853658537;17;24;0.0853658536585366;0.414634146341463
Control.SRR15539824;42;40;0.523809523809524;20;22;0.0238095238095238;0.476190476190476
Control.SRR15539824;42;40;0.476190476190476;22;20;0.0238095238095238;0.476190476190476
Control.SRR15539824;37;40;0.432432432432432;21;16;0.0675675675675675;0.432432432432432
Control.SRR15539824;40;40;0.475;21;19;0.025;0.475
Control.SRR15539824;37;40;0.432432432432432;21;16;0.0675675675675675;0.432432432432432
Control.SRR15539824;32;40;0.5;16;16;0;0.5
Control.SRR15539824;40;40;0.55;18;22;0.05;0.45
Control.SRR15539824;36;40;0.527777777777778;17;19;0.0277777777777778;0.472222222222222
Control.SRR15539824;33;40;0.636363636363636;12;21;0.136363636363636;0.363636363636364
Control.SRR15539824;35;40;0.571428571428571;15;20;0.0714285714285714;0.428571428571429
Control.SRR15539824;38;40;0.526315789473684;18;20;0.0263157894736842;0.473684210526316
Control.SRR15539824;38;40;0.552631578947368;17;21;0.0526315789473685;0.447368421052632
Control.SRR15539824;32;40;0.46875;17;15;0.03125;0.46875
Control.SRR15539824;36;40;0.555555555555556;16;20;0.0555555555555556;0.444444444444444
Control.SRR15539824;42;40;0.595238095238095;17;25;0.0952380952380952;0.404761904761905
Control.SRR15539824;38;40;0.394736842105263;23;15;0.105263157894737;0.394736842105263
Control.SRR15539824;41;40;0.560975609756098;18;23;0.0609756097560976;0.439024390243902
Control.SRR15539824;34;40;0.5;17;17;0;0.5
Control.SRR15539824;37;40;0.540540540540541;17;20;0.0405405405405406;0.459459459459459
Control.SRR15539824;39;40;0.461538461538462;21;18;0.0384615384615384;0.461538461538462
Control.SRR15539824;32;40;0.53125;15;17;0.03125;0.46875
Control.SRR15539824;38;40;0.526315789473684;18;20;0.0263157894736842;0.473684210526316
Control.SRR15539824;35;40;0.457142857142857;19;16;0.0428571428571429;0.457142857142857
Control.SRR15539824;32;40;0.5625;14;18;0.0625;0.4375
Control.SRR15539824;37;40;0.540540540540541;17;20;0.0405405405405406;0.459459459459459
Control.SRR15539824;42;40;0.523809523809524;20;22;0.0238095238095238;0.476190476190476
Control.SRR15539824;33;40;0.454545454545455;18;15;0.0454545454545455;0.454545454545455
Control.SRR15539824;33;40;0.424242424242424;19;14;0.0757575757575757;0.424242424242424
Control.SRR15539824;39;40;0.461538461538462;21;18;0.0384615384615384;0.461538461538462
Control.SRR15539824;38;40;0.447368421052632;21;17;0.0526315789473684;0.447368421052632
Control.SRR15539824;41;40;0.463414634146341;22;19;0.0365853658536585;0.463414634146341
Control.SRR15539824;39;40;0.58974358974359;16;23;0.0897435897435898;0.41025641025641
Control.SRR15539824;42;40;0.404761904761905;25;17;0.0952380952380952;0.404761904761905
Control.SRR15539824;32;40;0.46875;17;15;0.03125;0.46875
Control.SRR15539824;35;40;0.628571428571429;13;22;0.128571428571429;0.371428571428571
Control.SRR15539824;38;40;0.473684210526316;20;18;0.0263157894736842;0.473684210526316
Control.SRR15539824;38;40;0.421052631578947;22;16;0.0789473684210527;0.421052631578947
Control.SRR15539824;38;40;0.289473684210526;27;11;0.210526315789474;0.289473684210526
Control.SRR15539824;38;40;0.526315789473684;18;20;0.0263157894736842;0.473684210526316
Control.SRR15539824;42;40;0.5;21;21;0;0.5
Control.SRR15539824;42;40;0.428571428571429;24;18;0.0714285714285715;0.428571428571429
Control.SRR15539824;38;40;0.552631578947368;17;21;0.0526315789473685;0.447368421052632
Control.SRR15539824;36;40;0.472222222222222;19;17;0.0277777777777778;0.472222222222222
Control.SRR15539824;33;40;0.393939393939394;20;13;0.106060606060606;0.393939393939394
Control.SRR15539824;34;40;0.5;17;17;0;0.5
Control.SRR15539824;34;40;0.470588235294118;18;16;0.0294117647058824;0.470588235294118
Control.SRR15539824;34;40;0.470588235294118;18;16;0.0294117647058824;0.470588235294118
Control.SRR15539824;34;40;0.470588235294118;18;16;0.0294117647058824;0.470588235294118
Control.SRR15539824;33;40;0.515151515151515;16;17;0.0151515151515151;0.484848484848485
Control.SRR15539824;41;40;0.560975609756098;18;23;0.0609756097560976;0.439024390243902
Control.SRR15539824;41;40;0.414634146341463;24;17;0.0853658536585366;0.414634146341463
Control.SRR15539824;33;40;0.484848484848485;17;16;0.0151515151515151;0.484848484848485
Control.SRR15539824;38;40;0.605263157894737;15;23;0.105263157894737;0.394736842105263
Control.SRR15539824;34;40;0.588235294117647;14;20;0.0882352941176471;0.411764705882353
Control.SRR15539824;42;40;0.547619047619048;19;23;0.0476190476190477;0.452380952380952
Control.SRR15539824;40;40;0.475;21;19;0.025;0.475
Control.SRR15539824;35;40;0.4;21;14;0.1;0.4
Control.SRR15539824;38;40;0.473684210526316;20;18;0.0263157894736842;0.473684210526316
Control.SRR15539824;39;40;0.487179487179487;20;19;0.0128205128205128;0.487179487179487
Control.SRR15539824;36;40;0.472222222222222;19;17;0.0277777777777778;0.472222222222222
Control.SRR15539824;36;40;0.638888888888889;13;23;0.138888888888889;0.361111111111111
Control.SRR15539824;36;40;0.472222222222222;19;17;0.0277777777777778;0.472222222222222
Control.SRR15539824;40;40;0.425;23;17;0.075;0.425
Control.SRR15539824;41;40;0.536585365853659;19;22;0.0365853658536586;0.463414634146341
Control.SRR15539824;36;40;0.472222222222222;19;17;0.0277777777777778;0.472222222222222
Control.SRR15539824;38;40;0.473684210526316;20;18;0.0263157894736842;0.473684210526316
Control.SRR15539824;32;40;0.53125;15;17;0.03125;0.46875
Control.SRR15539824;40;40;0.425;23;17;0.075;0.425
Control.SRR15539824;35;40;0.4;21;14;0.1;0.4
Control.SRR15539824;36;40;0.527777777777778;17;19;0.0277777777777778;0.472222222222222
Control.SRR15539824;34;40;0.441176470588235;19;15;0.0588235294117647;0.441176470588235
Control.SRR15539824;41;40;0.463414634146341;22;19;0.0365853658536585;0.463414634146341
Control.SRR15539824;39;40;0.58974358974359;16;23;0.0897435897435898;0.41025641025641
Control.SRR15539824;32;40;0.46875;17;15;0.03125;0.46875
Control.SRR15539824;39;40;0.512820512820513;19;20;0.0128205128205128;0.487179487179487
Control.SRR15539824;42;40;0.523809523809524;20;22;0.0238095238095238;0.476190476190476
Control.SRR15539824;35;40;0.657142857142857;12;23;0.157142857142857;0.342857142857143
Control.SRR15539824;33;40;0.454545454545455;18;15;0.0454545454545455;0.454545454545455
Control.SRR15539824;36;40;0.583333333333333;15;21;0.0833333333333334;0.416666666666667
Control.SRR15539824;38;40;0.447368421052632;21;17;0.0526315789473684;0.447368421052632
Control.SRR15539824;39;40;0.435897435897436;22;17;0.0641025641025641;0.435897435897436
Control.SRR15539824;35;40;0.571428571428571;15;20;0.0714285714285714;0.428571428571429
Control.SRR15539824;42;40;0.5;21;21;0;0.5
Control.SRR15539824;37;40;0.540540540540541;17;20;0.0405405405405406;0.459459459459459
Control.SRR15539824;39;40;0.538461538461538;18;21;0.0384615384615384;0.461538461538462
Control.SRR15539824;42;40;0.357142857142857;27;15;0.142857142857143;0.357142857142857
Control.SRR15539824;40;40;0.625;15;25;0.125;0.375
Control.SRR15539824;39;40;0.435897435897436;22;17;0.0641025641025641;0.435897435897436
Control.SRR15539824;39;40;0.461538461538462;21;18;0.0384615384615384;0.461538461538462
Control.SRR15539824;35;40;0.571428571428571;15;20;0.0714285714285714;0.428571428571429
Control.SRR15539824;34;40;0.441176470588235;19;15;0.0588235294117647;0.441176470588235
Control.SRR15539824;35;40;0.514285714285714;17;18;0.0142857142857142;0.485714285714286
Control.SRR15539824;32;40;0.40625;19;13;0.09375;0.40625
Control.SRR15539824;37;40;0.459459459459459;20;17;0.0405405405405405;0.459459459459459
Control.SRR15539824;40;40;0.525;19;21;0.025;0.475
Control.SRR15539824;39;40;0.538461538461538;18;21;0.0384615384615384;0.461538461538462
Control.SRR15539824;36;40;0.5;18;18;0;0.5
Control.SRR15539824;37;40;0.486486486486487;19;18;0.0135135135135135;0.486486486486487
Control.SRR15539824;39;40;0.666666666666667;13;26;0.166666666666667;0.333333333333333
Control.SRR15539824;38;40;0.578947368421053;16;22;0.0789473684210527;0.421052631578947
Control.SRR15539824;34;40;0.588235294117647;14;20;0.0882352941176471;0.411764705882353
Control.SRR15539824;36;40;0.444444444444444;20;16;0.0555555555555556;0.444444444444444
Control.SRR15539824;39;40;0.512820512820513;19;20;0.0128205128205128;0.487179487179487
Control.SRR15539824;36;40;0.611111111111111;14;22;0.111111111111111;0.388888888888889
Control.SRR15539824;38;40;0.368421052631579;24;14;0.131578947368421;0.368421052631579
Control.SRR15539824;35;40;0.6;14;21;0.1;0.4
Control.SRR15539824;32;40;0.6875;10;22;0.1875;0.3125
Control.SRR15539824;38;40;0.578947368421053;16;22;0.0789473684210527;0.421052631578947
Control.SRR15539824;42;40;0.30952380952381;29;13;0.19047619047619;0.30952380952381
Control.SRR15539824;33;40;0.454545454545455;18;15;0.0454545454545455;0.454545454545455
Control.SRR15539824;35;40;0.457142857142857;19;16;0.0428571428571429;0.457142857142857
Control.SRR15539824;34;40;0.617647058823529;13;21;0.117647058823529;0.382352941176471
Control.SRR15539824;32;40;0.5625;14;18;0.0625;0.4375
Control.SRR15539824;38;40;0.5;19;19;0;0.5
Control.SRR15539824;41;40;0.560975609756098;18;23;0.0609756097560976;0.439024390243902
Control.SRR15539824;35;40;0.485714285714286;18;17;0.0142857142857143;0.485714285714286
Control.SRR15539824;41;40;0.48780487804878;21;20;0.0121951219512195;0.48780487804878
Control.SRR15539824;35;40;0.571428571428571;15;20;0.0714285714285714;0.428571428571429
Control.SRR15539824;35;40;0.428571428571429;20;15;0.0714285714285715;0.428571428571429
Control.SRR15539824;41;40;0.51219512195122;20;21;0.0121951219512195;0.48780487804878
Control.SRR15539824;34;40;0.735294117647059;9;25;0.235294117647059;0.264705882352941
Control.SRR15539824;39;40;0.41025641025641;23;16;0.0897435897435898;0.41025641025641
Control.SRR15539824;38;40;0.605263157894737;15;23;0.105263157894737;0.394736842105263
Control.SRR15539824;36;40;0.472222222222222;19;17;0.0277777777777778;0.472222222222222
Control.SRR15539824;40;40;0.625;15;25;0.125;0.375
Control.SRR15539824;38;40;0.447368421052632;21;17;0.0526315789473684;0.447368421052632
Control.SRR15539824;32;40;0.4375;18;14;0.0625;0.4375
Control.SRR15539824;36;40;0.555555555555556;16;20;0.0555555555555556;0.444444444444444
Control.SRR15539824;32;40;0.5;16;16;0;0.5
Control.SRR15539824;40;40;0.5;20;20;0;0.5
Control.SRR15539824;35;40;0.542857142857143;16;19;0.0428571428571428;0.457142857142857
Control.SRR15539824;39;40;0.435897435897436;22;17;0.0641025641025641;0.435897435897436
Control.SRR15539824;42;40;0.5;21;21;0;0.5
Control.SRR15539824;34;40;0.470588235294118;18;16;0.0294117647058824;0.470588235294118
Control.SRR15539824;42;40;0.404761904761905;25;17;0.0952380952380952;0.404761904761905
Control.SRR15539824;42;40;0.547619047619048;19;23;0.0476190476190477;0.452380952380952
Control.SRR15539824;41;40;0.48780487804878;21;20;0.0121951219512195;0.48780487804878
Control.SRR15539824;38;40;0.394736842105263;23;15;0.105263157894737;0.394736842105263
Control.SRR15539824;33;40;0.545454545454545;15;18;0.0454545454545454;0.454545454545455
Control.SRR15539824;41;40;0.536585365853659;19;22;0.0365853658536586;0.463414634146341
Control.SRR15539824;40;40;0.65;14;26;0.15;0.35
Control.SRR15539824;38;40;0.5;19;19;0;0.5
Control.SRR15539824;32;40;0.5;16;16;0;0.5
Control.SRR15539824;38;40;0.473684210526316;20;18;0.0263157894736842;0.473684210526316
Control.SRR15539824;34;40;0.558823529411765;15;19;0.0588235294117647;0.441176470588235
Control.SRR15539824;39;40;0.512820512820513;19;20;0.0128205128205128;0.487179487179487
Control.SRR15539824;32;40;0.59375;13;19;0.09375;0.40625
Control.SRR15539824;33;40;0.545454545454545;15;18;0.0454545454545454;0.454545454545455
Control.SRR15539824;37;40;0.675675675675676;12;25;0.175675675675676;0.324324324324324
Control.SRR15539824;37;40;0.621621621621622;14;23;0.121621621621622;0.378378378378378
Control.SRR15539824;37;40;0.432432432432432;21;16;0.0675675675675675;0.432432432432432
Control.SRR15539824;40;40;0.5;20;20;0;0.5
Control.SRR15539824;37;40;0.72972972972973;10;27;0.22972972972973;0.27027027027027
Control.SRR15539824;42;40;0.476190476190476;22;20;0.0238095238095238;0.476190476190476
Control.SRR15539824;38;40;0.657894736842105;13;25;0.157894736842105;0.342105263157895
Control.SRR15539824;41;40;0.682926829268293;13;28;0.182926829268293;0.317073170731707
Control.SRR15539824;36;40;0.472222222222222;19;17;0.0277777777777778;0.472222222222222
Control.SRR15539824;41;40;0.560975609756098;18;23;0.0609756097560976;0.439024390243902
Control.SRR15539824;34;40;0.588235294117647;14;20;0.0882352941176471;0.411764705882353
Control.SRR15539824;32;40;0.59375;13;19;0.09375;0.40625
Control.SRR15539824;36;40;0.555555555555556;16;20;0.0555555555555556;0.444444444444444
Control.SRR15539824;38;40;0.394736842105263;23;15;0.105263157894737;0.394736842105263
Control.SRR15539824;34;40;0.529411764705882;16;18;0.0294117647058824;0.470588235294118
Control.SRR15539824;36;40;0.5;18;18;0;0.5
Control.SRR15539824;39;40;0.538461538461538;18;21;0.0384615384615384;0.461538461538462
Control.SRR15539824;37;40;0.621621621621622;14;23;0.121621621621622;0.378378378378378
Control.SRR15539824;34;40;0.558823529411765;15;19;0.0588235294117647;0.441176470588235
Control.SRR15539824;42;40;0.523809523809524;20;22;0.0238095238095238;0.476190476190476
Control.SRR15539824;37;40;0.567567567567568;16;21;0.0675675675675675;0.432432432432432
Control.SRR15539824;38;40;0.447368421052632;21;17;0.0526315789473684;0.447368421052632
Control.SRR15539824;39;40;0.58974358974359;16;23;0.0897435897435898;0.41025641025641
Control.SRR15539824;36;40;0.527777777777778;17;19;0.0277777777777778;0.472222222222222
Control.SRR15539824;37;40;0.594594594594595;15;22;0.0945945945945946;0.405405405405405
Control.SRR15539824;42;40;0.428571428571429;24;18;0.0714285714285715;0.428571428571429
Control.SRR15539824;41;40;0.414634146341463;24;17;0.0853658536585366;0.414634146341463
Control.SRR15539824;40;40;0.4;24;16;0.1;0.4
Control.SRR15539824;36;40;0.527777777777778;17;19;0.0277777777777778;0.472222222222222
Control.SRR15539824;39;40;0.641025641025641;14;25;0.141025641025641;0.358974358974359
Control.SRR15539824;35;40;0.514285714285714;17;18;0.0142857142857142;0.485714285714286
Control.SRR15539824;39;40;0.435897435897436;22;17;0.0641025641025641;0.435897435897436
Control.SRR15539824;34;40;0.558823529411765;15;19;0.0588235294117647;0.441176470588235
Control.SRR15539824;35;40;0.457142857142857;19;16;0.0428571428571429;0.457142857142857
Control.SRR15539824;33;40;0.606060606060606;13;20;0.106060606060606;0.393939393939394
Control.SRR15539824;33;40;0.515151515151515;16;17;0.0151515151515151;0.484848484848485
Control.SRR15539824;35;40;0.457142857142857;19;16;0.0428571428571429;0.457142857142857
Control.SRR15539824;34;40;0.470588235294118;18;16;0.0294117647058824;0.470588235294118
Control.SRR15539824;41;40;0.48780487804878;21;20;0.0121951219512195;0.48780487804878
Control.SRR15539824;35;40;0.6;14;21;0.1;0.4
Control.SRR15539824;38;40;0.394736842105263;23;15;0.105263157894737;0.394736842105263
Control.SRR15539824;34;40;0.352941176470588;22;12;0.147058823529412;0.352941176470588
Control.SRR15539824;32;40;0.40625;19;13;0.09375;0.40625
Control.SRR15539824;39;40;0.58974358974359;16;23;0.0897435897435898;0.41025641025641
Control.SRR15539824;37;40;0.594594594594595;15;22;0.0945945945945946;0.405405405405405
Control.SRR15539824;35;40;0.514285714285714;17;18;0.0142857142857142;0.485714285714286
Control.SRR15539824;35;40;0.628571428571429;13;22;0.128571428571429;0.371428571428571
Control.SRR15539824;36;40;0.555555555555556;16;20;0.0555555555555556;0.444444444444444
Control.SRR15539824;34;40;0.5;17;17;0;0.5
Control.SRR15539824;37;40;0.540540540540541;17;20;0.0405405405405406;0.459459459459459
Control.SRR15539824;40;40;0.375;25;15;0.125;0.375
Control.SRR15539824;35;40;0.542857142857143;16;19;0.0428571428571428;0.457142857142857
Control.SRR15539824;40;40;0.475;21;19;0.025;0.475
Control.SRR15539824;41;40;0.536585365853659;19;22;0.0365853658536586;0.463414634146341
Control.SRR15539824;41;40;0.634146341463415;15;26;0.134146341463415;0.365853658536585
Control.SRR15539824;37;40;0.405405405405405;22;15;0.0945945945945946;0.405405405405405
Control.SRR15539824;36;40;0.5;18;18;0;0.5
Control.SRR15539824;33;40;0.484848484848485;17;16;0.0151515151515151;0.484848484848485
Control.SRR15539824;34;40;0.558823529411765;15;19;0.0588235294117647;0.441176470588235
Control.SRR15539824;40;40;0.7;12;28;0.2;0.3
Control.SRR15539824;37;40;0.405405405405405;22;15;0.0945945945945946;0.405405405405405
Control.SRR15539824;39;40;0.461538461538462;21;18;0.0384615384615384;0.461538461538462
Control.SRR15539824;36;40;0.5;18;18;0;0.5
Control.SRR15539824;34;40;0.558823529411765;15;19;0.0588235294117647;0.441176470588235
Control.SRR15539824;37;40;0.459459459459459;20;17;0.0405405405405405;0.459459459459459
Control.SRR15539824;35;40;0.542857142857143;16;19;0.0428571428571428;0.457142857142857
Control.SRR15539824;42;40;0.476190476190476;22;20;0.0238095238095238;0.476190476190476
Control.SRR15539824;40;40;0.525;19;21;0.025;0.475
Control.SRR15539824;34;40;0.470588235294118;18;16;0.0294117647058824;0.470588235294118
Control.SRR15539824;34;40;0.5;17;17;0;0.5
Control.SRR15539824;37;40;0.540540540540541;17;20;0.0405405405405406;0.459459459459459
Control.SRR15539824;39;40;0.435897435897436;22;17;0.0641025641025641;0.435897435897436
Control.SRR15539824;36;40;0.5;18;18;0;0.5
Control.SRR15539824;33;40;0.545454545454545;15;18;0.0454545454545454;0.454545454545455
Control.SRR15539824;40;40;0.55;18;22;0.05;0.45
Control.SRR15539824;34;40;0.558823529411765;15;19;0.0588235294117647;0.441176470588235
Control.SRR15539824;32;40;0.4375;18;14;0.0625;0.4375
Control.SRR15539824;39;40;0.461538461538462;21;18;0.0384615384615384;0.461538461538462
Control.SRR15539824;40;40;0.475;21;19;0.025;0.475
Control.SRR15539824;35;40;0.542857142857143;16;19;0.0428571428571428;0.457142857142857
Control.SRR15539824;37;40;0.594594594594595;15;22;0.0945945945945946;0.405405405405405
Control.SRR15539824;35;40;0.428571428571429;20;15;0.0714285714285715;0.428571428571429
Control.SRR15539824;35;40;0.542857142857143;16;19;0.0428571428571428;0.457142857142857
Control.SRR15539824;42;40;0.452380952380952;23;19;0.0476190476190476;0.452380952380952
Control.SRR15539824;33;40;0.424242424242424;19;14;0.0757575757575757;0.424242424242424
Control.SRR15539824;41;40;0.634146341463415;15;26;0.134146341463415;0.365853658536585
Control.SRR15539824;38;40;0.578947368421053;16;22;0.0789473684210527;0.421052631578947
Control.SRR15539824;40;40;0.45;22;18;0.05;0.45
Control.SRR15539824;32;40;0.59375;13;19;0.09375;0.40625
Control.SRR15539824;42;40;0.380952380952381;26;16;0.119047619047619;0.380952380952381
Control.SRR15539824;38;40;0.5;19;19;0;0.5
Control.SRR15539824;38;40;0.552631578947368;17;21;0.0526315789473685;0.447368421052632
Control.SRR15539824;37;40;0.486486486486487;19;18;0.0135135135135135;0.486486486486487
Control.SRR15539824;39;40;0.538461538461538;18;21;0.0384615384615384;0.461538461538462
Control.SRR15539824;35;40;0.4;21;14;0.1;0.4
Control.SRR15539824;34;40;0.382352941176471;21;13;0.117647058823529;0.382352941176471
Control.SRR15539824;38;40;0.552631578947368;17;21;0.0526315789473685;0.447368421052632
Control.SRR15539824;37;40;0.486486486486487;19;18;0.0135135135135135;0.486486486486487
Control.SRR15539824;37;40;0.459459459459459;20;17;0.0405405405405405;0.459459459459459
Control.SRR15539824;34;40;0.617647058823529;13;21;0.117647058823529;0.382352941176471
Control.SRR15539824;42;40;0.5;21;21;0;0.5
Control.SRR15539824;32;40;0.46875;17;15;0.03125;0.46875
Control.SRR15539824;34;40;0.529411764705882;16;18;0.0294117647058824;0.470588235294118
Control.SRR15539824;37;40;0.540540540540541;17;20;0.0405405405405406;0.459459459459459
Control.SRR15539824;39;40;0.564102564102564;17;22;0.0641025641025641;0.435897435897436
Control.SRR15539824;33;40;0.545454545454545;15;18;0.0454545454545454;0.454545454545455
Control.SRR15539824;38;40;0.473684210526316;20;18;0.0263157894736842;0.473684210526316
Control.SRR15539824;42;40;0.452380952380952;23;19;0.0476190476190476;0.452380952380952
Control.SRR15539824;39;40;0.538461538461538;18;21;0.0384615384615384;0.461538461538462
Control.SRR15539824;42;40;0.476190476190476;22;20;0.0238095238095238;0.476190476190476
Control.SRR15539824;37;40;0.621621621621622;14;23;0.121621621621622;0.378378378378378
Control.SRR15539824;38;40;0.552631578947368;17;21;0.0526315789473685;0.447368421052632
Control.SRR15539824;40;40;0.45;22;18;0.05;0.45
Control.SRR15539824;35;40;0.485714285714286;18;17;0.0142857142857143;0.485714285714286
Control.SRR15539824;34;40;0.588235294117647;14;20;0.0882352941176471;0.411764705882353
Control.SRR15539824;36;40;0.416666666666667;21;15;0.0833333333333333;0.416666666666667
Control.SRR15539824;40;40;0.5;20;20;0;0.5
Control.SRR15539824;36;40;0.527777777777778;17;19;0.0277777777777778;0.472222222222222
Control.SRR15539824;42;40;0.476190476190476;22;20;0.0238095238095238;0.476190476190476
Control.SRR15539824;33;40;0.515151515151515;16;17;0.0151515151515151;0.484848484848485
Control.SRR15539824;32;40;0.5625;14;18;0.0625;0.4375
Control.SRR15539824;36;40;0.444444444444444;20;16;0.0555555555555556;0.444444444444444
Control.SRR15539824;40;40;0.35;26;14;0.15;0.35
Control.SRR15539824;36;40;0.666666666666667;12;24;0.166666666666667;0.333333333333333
Control.SRR15539824;35;40;0.542857142857143;16;19;0.0428571428571428;0.457142857142857
Control.SRR15539824;35;40;0.371428571428571;22;13;0.128571428571429;0.371428571428571
Control.SRR15539824;39;40;0.58974358974359;16;23;0.0897435897435898;0.41025641025641
Control.SRR15539824;35;40;0.514285714285714;17;18;0.0142857142857142;0.485714285714286
Control.SRR15539824;34;40;0.470588235294118;18;16;0.0294117647058824;0.470588235294118
Control.SRR15539824;42;40;0.5;21;21;0;0.5
Control.SRR15539824;42;40;0.595238095238095;17;25;0.0952380952380952;0.404761904761905
Control.SRR15539824;36;40;0.416666666666667;21;15;0.0833333333333333;0.416666666666667
Control.SRR15539824;42;40;0.523809523809524;20;22;0.0238095238095238;0.476190476190476
Control.SRR15539824;39;40;0.487179487179487;20;19;0.0128205128205128;0.487179487179487
Control.SRR15539824;36;40;0.5;18;18;0;0.5
Control.SRR15539824;33;40;0.424242424242424;19;14;0.0757575757575757;0.424242424242424
Control.SRR15539824;37;40;0.567567567567568;16;21;0.0675675675675675;0.432432432432432
Control.SRR15539824;36;40;0.5;18;18;0;0.5
Control.SRR15539824;37;40;0.513513513513513;18;19;0.0135135135135135;0.486486486486487
Control.SRR15539824;38;40;0.631578947368421;14;24;0.131578947368421;0.368421052631579
Control.SRR15539824;38;40;0.526315789473684;18;20;0.0263157894736842;0.473684210526316
Control.SRR15539824;41;40;0.536585365853659;19;22;0.0365853658536586;0.463414634146341
Control.SRR15539824;39;40;0.512820512820513;19;20;0.0128205128205128;0.487179487179487
Control.SRR15539824;38;40;0.289473684210526;27;11;0.210526315789474;0.289473684210526
Control.SRR15539824;35;40;0.457142857142857;19;16;0.0428571428571429;0.457142857142857
Control.SRR15539824;35;40;0.485714285714286;18;17;0.0142857142857143;0.485714285714286
Control.SRR15539824;36;40;0.694444444444444;11;25;0.194444444444444;0.305555555555556
Control.SRR15539824;34;40;0.588235294117647;14;20;0.0882352941176471;0.411764705882353
Control.SRR15539824;32;40;0.53125;15;17;0.03125;0.46875
Control.SRR15539824;41;40;0.414634146341463;24;17;0.0853658536585366;0.414634146341463
Control.SRR15539824;35;40;0.485714285714286;18;17;0.0142857142857143;0.485714285714286
Control.SRR15539824;35;40;0.628571428571429;13;22;0.128571428571429;0.371428571428571
Control.SRR15539824;39;40;0.538461538461538;18;21;0.0384615384615384;0.461538461538462
Control.SRR15539824;35;40;0.542857142857143;16;19;0.0428571428571428;0.457142857142857
Control.SRR15539824;36;40;0.694444444444444;11;25;0.194444444444444;0.305555555555556
Control.SRR15539824;34;40;0.5;17;17;0;0.5
Control.SRR15539824;32;40;0.5;16;16;0;0.5
Control.SRR15539824;32;40;0.5;16;16;0;0.5
Control.SRR15539824;39;40;0.384615384615385;24;15;0.115384615384615;0.384615384615385
Control.SRR15539824;38;40;0.578947368421053;16;22;0.0789473684210527;0.421052631578947
Control.SRR15539824;37;40;0.567567567567568;16;21;0.0675675675675675;0.432432432432432
Control.SRR15539824;39;40;0.307692307692308;27;12;0.192307692307692;0.307692307692308
Control.SRR15539824;36;40;0.472222222222222;19;17;0.0277777777777778;0.472222222222222
Control.SRR15539824;36;40;0.416666666666667;21;15;0.0833333333333333;0.416666666666667
Control.SRR15539824;36;40;0.583333333333333;15;21;0.0833333333333334;0.416666666666667
Control.SRR15539824;36;40;0.527777777777778;17;19;0.0277777777777778;0.472222222222222
Control.SRR15539824;34;40;0.470588235294118;18;16;0.0294117647058824;0.470588235294118
Control.SRR15539824;39;40;0.487179487179487;20;19;0.0128205128205128;0.487179487179487
Control.SRR15539824;42;40;0.404761904761905;25;17;0.0952380952380952;0.404761904761905
Control.SRR15539824;39;40;0.41025641025641;23;16;0.0897435897435898;0.41025641025641
Control.SRR15539824;38;40;0.421052631578947;22;16;0.0789473684210527;0.421052631578947
Control.SRR15539824;32;40;0.5625;14;18;0.0625;0.4375
Control.SRR15539824;42;40;0.476190476190476;22;20;0.0238095238095238;0.476190476190476
Control.SRR15539824;34;40;0.5;17;17;0;0.5
Control.SRR15539824;36;40;0.472222222222222;19;17;0.0277777777777778;0.472222222222222
Control.SRR15539824;39;40;0.435897435897436;22;17;0.0641025641025641;0.435897435897436
Control.SRR15539824;33;40;0.454545454545455;18;15;0.0454545454545455;0.454545454545455
Control.SRR15539824;41;40;0.51219512195122;20;21;0.0121951219512195;0.48780487804878
Control.SRR15539824;38;40;0.526315789473684;18;20;0.0263157894736842;0.473684210526316
Control.SRR15539824;39;40;0.41025641025641;23;16;0.0897435897435898;0.41025641025641
Control.SRR15539824;35;40;0.628571428571429;13;22;0.128571428571429;0.371428571428571
Control.SRR15539824;36;40;0.527777777777778;17;19;0.0277777777777778;0.472222222222222
Control.SRR15539824;35;40;0.428571428571429;20;15;0.0714285714285715;0.428571428571429
Control.SRR15539824;39;40;0.641025641025641;14;25;0.141025641025641;0.358974358974359
Control.SRR15539824;42;40;0.5;21;21;0;0.5
Control.SRR15539824;40;40;0.65;14;26;0.15;0.35
Control.SRR15539824;33;40;0.484848484848485;17;16;0.0151515151515151;0.484848484848485
Control.SRR15539824;32;40;0.625;12;20;0.125;0.375
Control.SRR15539824;33;40;0.515151515151515;16;17;0.0151515151515151;0.484848484848485
Control.SRR15539824;39;40;0.384615384615385;24;15;0.115384615384615;0.384615384615385
Control.SRR15539824;34;40;0.382352941176471;21;13;0.117647058823529;0.382352941176471
Control.SRR15539824;32;40;0.4375;18;14;0.0625;0.4375
Control.SRR15539824;37;40;0.540540540540541;17;20;0.0405405405405406;0.459459459459459
Control.SRR15539824;37;40;0.405405405405405;22;15;0.0945945945945946;0.405405405405405
Control.SRR15539824;36;40;0.555555555555556;16;20;0.0555555555555556;0.444444444444444
Control.SRR15539824;42;40;0.476190476190476;22;20;0.0238095238095238;0.476190476190476
Control.SRR15539824;40;40;0.575;17;23;0.075;0.425
Control.SRR15539824;33;40;0.515151515151515;16;17;0.0151515151515151;0.484848484848485
Control.SRR15539824;38;40;0.526315789473684;18;20;0.0263157894736842;0.473684210526316
Control.SRR15539824;35;40;0.514285714285714;17;18;0.0142857142857142;0.485714285714286
Control.SRR15539824;33;40;0.575757575757576;14;19;0.0757575757575758;0.424242424242424
Control.SRR15539824;39;40;0.461538461538462;21;18;0.0384615384615384;0.461538461538462
Control.SRR15539824;39;40;0.615384615384615;15;24;0.115384615384615;0.384615384615385
Control.SRR15539824;41;40;0.51219512195122;20;21;0.0121951219512195;0.48780487804878
Control.SRR15539824;37;40;0.324324324324324;25;12;0.175675675675676;0.324324324324324
Control.SRR15539824;41;40;0.390243902439024;25;16;0.109756097560976;0.390243902439024
Control.SRR15539824;34;40;0.558823529411765;15;19;0.0588235294117647;0.441176470588235
Control.SRR15539824;39;40;0.615384615384615;15;24;0.115384615384615;0.384615384615385
Control.SRR15539824;32;40;0.375;20;12;0.125;0.375
Control.SRR15539824;32;40;0.59375;13;19;0.09375;0.40625
Control.SRR15539824;37;40;0.486486486486487;19;18;0.0135135135135135;0.486486486486487
Control.SRR15539824;33;40;0.484848484848485;17;16;0.0151515151515151;0.484848484848485
Control.SRR15539824;38;40;0.631578947368421;14;24;0.131578947368421;0.368421052631579
Control.SRR15539824;34;40;0.588235294117647;14;20;0.0882352941176471;0.411764705882353
Control.SRR15539824;35;40;0.457142857142857;19;16;0.0428571428571429;0.457142857142857
Control.SRR15539824;37;40;0.486486486486487;19;18;0.0135135135135135;0.486486486486487
Control.SRR15539824;34;40;0.441176470588235;19;15;0.0588235294117647;0.441176470588235
Control.SRR15539824;40;40;0.425;23;17;0.075;0.425
Control.SRR15539824;40;40;0.55;18;22;0.05;0.45
Control.SRR15539824;36;40;0.416666666666667;21;15;0.0833333333333333;0.416666666666667
Control.SRR15539824;36;40;0.611111111111111;14;22;0.111111111111111;0.388888888888889
Control.SRR15539824;40;40;0.625;15;25;0.125;0.375
Control.SRR15539824;40;40;0.5;20;20;0;0.5
Control.SRR15539824;40;40;0.525;19;21;0.025;0.475
Control.SRR15539824;35;40;0.485714285714286;18;17;0.0142857142857143;0.485714285714286
Control.SRR15539824;42;40;0.380952380952381;26;16;0.119047619047619;0.380952380952381
Control.SRR15539824;37;40;0.513513513513513;18;19;0.0135135135135135;0.486486486486487
Control.SRR15539824;33;40;0.575757575757576;14;19;0.0757575757575758;0.424242424242424
Control.SRR15539824;35;40;0.485714285714286;18;17;0.0142857142857143;0.485714285714286
Control.SRR15539824;36;40;0.583333333333333;15;21;0.0833333333333334;0.416666666666667
Control.SRR15539824;34;40;0.529411764705882;16;18;0.0294117647058824;0.470588235294118
Control.SRR15539824;41;40;0.48780487804878;21;20;0.0121951219512195;0.48780487804878
Control.SRR15539824;38;40;0.657894736842105;13;25;0.157894736842105;0.342105263157895
Control.SRR15539824;32;40;0.5625;14;18;0.0625;0.4375
Control.SRR15539824;33;40;0.424242424242424;19;14;0.0757575757575757;0.424242424242424
Control.SRR15539824;33;40;0.606060606060606;13;20;0.106060606060606;0.393939393939394
Control.SRR15539824;41;40;0.390243902439024;25;16;0.109756097560976;0.390243902439024
Control.SRR15539824;40;40;0.475;21;19;0.025;0.475
Control.SRR15539824;34;40;0.323529411764706;23;11;0.176470588235294;0.323529411764706
Control.SRR15539824;41;40;0.585365853658537;17;24;0.0853658536585366;0.414634146341463
Control.SRR15539824;42;40;0.357142857142857;27;15;0.142857142857143;0.357142857142857
Control.SRR15539824;37;40;0.540540540540541;17;20;0.0405405405405406;0.459459459459459
Control.SRR15539824;39;40;0.538461538461538;18;21;0.0384615384615384;0.461538461538462
Control.SRR15539824;35;40;0.514285714285714;17;18;0.0142857142857142;0.485714285714286
Control.SRR15539824;37;40;0.513513513513513;18;19;0.0135135135135135;0.486486486486487
Control.SRR15539824;35;40;0.485714285714286;18;17;0.0142857142857143;0.485714285714286
Control.SRR15539824;33;40;0.545454545454545;15;18;0.0454545454545454;0.454545454545455
Control.SRR15539824;39;40;0.615384615384615;15;24;0.115384615384615;0.384615384615385
Control.SRR15539824;38;40;0.421052631578947;22;16;0.0789473684210527;0.421052631578947
Control.SRR15539824;39;40;0.58974358974359;16;23;0.0897435897435898;0.41025641025641
Control.SRR15539824;40;40;0.5;20;20;0;0.5
Control.SRR15539824;36;40;0.555555555555556;16;20;0.0555555555555556;0.444444444444444
Control.SRR15539824;38;40;0.421052631578947;22;16;0.0789473684210527;0.421052631578947
Control.SRR15539824;34;40;0.5;17;17;0;0.5
Control.SRR15539824;38;40;0.447368421052632;21;17;0.0526315789473684;0.447368421052632
Control.SRR15539824;35;40;0.514285714285714;17;18;0.0142857142857142;0.485714285714286
Control.SRR15539824;41;40;0.414634146341463;24;17;0.0853658536585366;0.414634146341463
Control.SRR15539824;32;40;0.5625;14;18;0.0625;0.4375
Control.SRR15539824;42;40;0.285714285714286;30;12;0.214285714285714;0.285714285714286
Control.SRR15539824;33;40;0.484848484848485;17;16;0.0151515151515151;0.484848484848485
Control.SRR15539824;35;40;0.542857142857143;16;19;0.0428571428571428;0.457142857142857
Control.SRR15539824;36;40;0.472222222222222;19;17;0.0277777777777778;0.472222222222222
Control.SRR15539824;40;40;0.35;26;14;0.15;0.35
Control.SRR15539824;42;40;0.5;21;21;0;0.5
Control.SRR15539824;34;40;0.382352941176471;21;13;0.117647058823529;0.382352941176471
Control.SRR15539824;39;40;0.58974358974359;16;23;0.0897435897435898;0.41025641025641
Control.SRR15539824;41;40;0.682926829268293;13;28;0.182926829268293;0.317073170731707
Control.SRR15539824;34;40;0.676470588235294;11;23;0.176470588235294;0.323529411764706
Control.SRR15539824;35;40;0.428571428571429;20;15;0.0714285714285715;0.428571428571429
Control.SRR15539824;32;40;0.46875;17;15;0.03125;0.46875
Control.SRR15539824;40;40;0.525;19;21;0.025;0.475
Control.SRR15539824;37;40;0.513513513513513;18;19;0.0135135135135135;0.486486486486487
Control.SRR15539824;35;40;0.542857142857143;16;19;0.0428571428571428;0.457142857142857
Control.SRR15539824;38;40;0.605263157894737;15;23;0.105263157894737;0.394736842105263
Control.SRR15539824;42;40;0.523809523809524;20;22;0.0238095238095238;0.476190476190476
Control.SRR15539824;37;40;0.486486486486487;19;18;0.0135135135135135;0.486486486486487
Control.SRR15539824;34;40;0.647058823529412;12;22;0.147058823529412;0.352941176470588
Control.SRR15539824;35;40;0.457142857142857;19;16;0.0428571428571429;0.457142857142857
Control.SRR15539824;34;40;0.558823529411765;15;19;0.0588235294117647;0.441176470588235
Control.SRR15539824;42;40;0.380952380952381;26;16;0.119047619047619;0.380952380952381
Control.SRR15539824;38;40;0.552631578947368;17;21;0.0526315789473685;0.447368421052632
Control.SRR15539824;42;40;0.357142857142857;27;15;0.142857142857143;0.357142857142857
Control.SRR15539824;34;40;0.529411764705882;16;18;0.0294117647058824;0.470588235294118
Control.SRR15539824;38;40;0.315789473684211;26;12;0.184210526315789;0.315789473684211
Control.SRR15539824;36;40;0.444444444444444;20;16;0.0555555555555556;0.444444444444444
Control.SRR15539824;37;40;0.432432432432432;21;16;0.0675675675675675;0.432432432432432
Control.SRR15539824;33;40;0.484848484848485;17;16;0.0151515151515151;0.484848484848485
Control.SRR15539824;35;40;0.342857142857143;23;12;0.157142857142857;0.342857142857143
Control.SRR15539824;32;40;0.46875;17;15;0.03125;0.46875
Control.SRR15539824;36;40;0.472222222222222;19;17;0.0277777777777778;0.472222222222222
Control.SRR15539824;33;40;0.454545454545455;18;15;0.0454545454545455;0.454545454545455
Control.SRR15539824;38;40;0.526315789473684;18;20;0.0263157894736842;0.473684210526316
Control.SRR15539824;36;40;0.388888888888889;22;14;0.111111111111111;0.388888888888889
Control.SRR15539824;39;40;0.461538461538462;21;18;0.0384615384615384;0.461538461538462
Control.SRR15539824;41;40;0.390243902439024;25;16;0.109756097560976;0.390243902439024
Control.SRR15539824;33;40;0.242424242424242;25;8;0.257575757575758;0.242424242424242
Control.SRR15539824;34;40;0.647058823529412;12;22;0.147058823529412;0.352941176470588
Control.SRR15539824;38;40;0.473684210526316;20;18;0.0263157894736842;0.473684210526316
Control.SRR15539824;33;40;0.303030303030303;23;10;0.196969696969697;0.303030303030303
Control.SRR15539824;32;40;0.34375;21;11;0.15625;0.34375
Control.SRR15539824;40;40;0.35;26;14;0.15;0.35
Control.SRR15539824;38;40;0.315789473684211;26;12;0.184210526315789;0.315789473684211
Control.SRR15539824;42;40;0.571428571428571;18;24;0.0714285714285714;0.428571428571429
Control.SRR15539824;42;40;0.523809523809524;20;22;0.0238095238095238;0.476190476190476
Control.SRR15539824;42;40;0.595238095238095;17;25;0.0952380952380952;0.404761904761905
Control.SRR15539824;35;40;0.485714285714286;18;17;0.0142857142857143;0.485714285714286
Control.SRR15539824;37;40;0.405405405405405;22;15;0.0945945945945946;0.405405405405405
Control.SRR15539824;36;40;0.555555555555556;16;20;0.0555555555555556;0.444444444444444
Control.SRR15539824;42;40;0.619047619047619;16;26;0.119047619047619;0.380952380952381
Control.SRR15539824;36;40;0.555555555555556;16;20;0.0555555555555556;0.444444444444444
Control.SRR15539824;35;40;0.457142857142857;19;16;0.0428571428571429;0.457142857142857
Control.SRR15539824;37;40;0.513513513513513;18;19;0.0135135135135135;0.486486486486487
Control.SRR15539824;35;40;0.542857142857143;16;19;0.0428571428571428;0.457142857142857
Control.SRR15539824;34;40;0.5;17;17;0;0.5
Control.SRR15539824;35;40;0.485714285714286;18;17;0.0142857142857143;0.485714285714286
Control.SRR15539824;36;40;0.555555555555556;16;20;0.0555555555555556;0.444444444444444
Control.SRR15539824;37;40;0.378378378378378;23;14;0.121621621621622;0.378378378378378
Control.SRR15539824;40;40;0.525;19;21;0.025;0.475
Control.SRR15539824;37;40;0.405405405405405;22;15;0.0945945945945946;0.405405405405405
Control.SRR15539824;36;40;0.472222222222222;19;17;0.0277777777777778;0.472222222222222
Control.SRR15539824;41;40;0.658536585365854;14;27;0.158536585365854;0.341463414634146
Control.SRR15539824;38;40;0.578947368421053;16;22;0.0789473684210527;0.421052631578947
Control.SRR15539824;42;40;0.452380952380952;23;19;0.0476190476190476;0.452380952380952
Control.SRR15539824;42;40;0.5;21;21;0;0.5
Control.SRR15539824;37;40;0.432432432432432;21;16;0.0675675675675675;0.432432432432432
Control.SRR15539824;35;40;0.571428571428571;15;20;0.0714285714285714;0.428571428571429
Control.SRR15539824;37;40;0.567567567567568;16;21;0.0675675675675675;0.432432432432432
Control.SRR15539824;35;40;0.485714285714286;18;17;0.0142857142857143;0.485714285714286
Control.SRR15539824;37;40;0.513513513513513;18;19;0.0135135135135135;0.486486486486487
Control.SRR15539824;35;40;0.457142857142857;19;16;0.0428571428571429;0.457142857142857
Control.SRR15539824;40;40;0.5;20;20;0;0.5
Control.SRR15539824;33;40;0.484848484848485;17;16;0.0151515151515151;0.484848484848485
Control.SRR15539824;39;40;0.435897435897436;22;17;0.0641025641025641;0.435897435897436
Control.SRR15539824;42;40;0.547619047619048;19;23;0.0476190476190477;0.452380952380952
Control.SRR15539824;39;40;0.641025641025641;14;25;0.141025641025641;0.358974358974359
Control.SRR15539824;32;40;0.53125;15;17;0.03125;0.46875
Control.SRR15539824;34;40;0.411764705882353;20;14;0.0882352941176471;0.411764705882353
Control.SRR15539824;32;40;0.5;16;16;0;0.5
Control.SRR15539824;35;40;0.485714285714286;18;17;0.0142857142857143;0.485714285714286
Control.SRR15539824;37;40;0.513513513513513;18;19;0.0135135135135135;0.486486486486487
Control.SRR15539824;36;40;0.5;18;18;0;0.5
Control.SRR15539824;42;40;0.380952380952381;26;16;0.119047619047619;0.380952380952381
Control.SRR15539824;33;40;0.454545454545455;18;15;0.0454545454545455;0.454545454545455
Control.SRR15539824;42;40;0.523809523809524;20;22;0.0238095238095238;0.476190476190476
Control.SRR15539824;34;40;0.352941176470588;22;12;0.147058823529412;0.352941176470588
Control.SRR15539824;37;40;0.540540540540541;17;20;0.0405405405405406;0.459459459459459
Control.SRR15539824;35;40;0.4;21;14;0.1;0.4
Control.SRR15539824;35;40;0.457142857142857;19;16;0.0428571428571429;0.457142857142857
Control.SRR15539824;36;40;0.527777777777778;17;19;0.0277777777777778;0.472222222222222
Control.SRR15539824;37;40;0.351351351351351;24;13;0.148648648648649;0.351351351351351
Control.SRR15539824;41;40;0.48780487804878;21;20;0.0121951219512195;0.48780487804878
Control.SRR15539824;40;40;0.5;20;20;0;0.5
Control.SRR15539824;35;40;0.485714285714286;18;17;0.0142857142857143;0.485714285714286
Control.SRR15539824;40;40;0.475;21;19;0.025;0.475
Control.SRR15539824;41;40;0.560975609756098;18;23;0.0609756097560976;0.439024390243902
Control.SRR15539824;42;40;0.476190476190476;22;20;0.0238095238095238;0.476190476190476
Control.SRR15539824;35;40;0.285714285714286;25;10;0.214285714285714;0.285714285714286
Control.SRR15539824;34;40;0.529411764705882;16;18;0.0294117647058824;0.470588235294118
Control.SRR15539824;35;40;0.542857142857143;16;19;0.0428571428571428;0.457142857142857
Control.SRR15539824;40;40;0.575;17;23;0.075;0.425
Control.SRR15539824;38;40;0.394736842105263;23;15;0.105263157894737;0.394736842105263
Control.SRR15539824;37;40;0.459459459459459;20;17;0.0405405405405405;0.459459459459459
Control.SRR15539824;36;40;0.555555555555556;16;20;0.0555555555555556;0.444444444444444
Control.SRR15539824;37;40;0.621621621621622;14;23;0.121621621621622;0.378378378378378
Control.SRR15539824;38;40;0.447368421052632;21;17;0.0526315789473684;0.447368421052632
Control.SRR15539824;34;40;0.529411764705882;16;18;0.0294117647058824;0.470588235294118
Control.SRR15539824;40;40;0.575;17;23;0.075;0.425
Control.SRR15539824;36;40;0.5;18;18;0;0.5
Control.SRR15539824;42;40;0.547619047619048;19;23;0.0476190476190477;0.452380952380952
Control.SRR15539824;42;40;0.595238095238095;17;25;0.0952380952380952;0.404761904761905
Control.SRR15539824;37;40;0.594594594594595;15;22;0.0945945945945946;0.405405405405405
Control.SRR15539824;42;40;0.619047619047619;16;26;0.119047619047619;0.380952380952381
Control.SRR15539824;33;40;0.454545454545455;18;15;0.0454545454545455;0.454545454545455
Control.SRR15539824;37;40;0.432432432432432;21;16;0.0675675675675675;0.432432432432432
Control.SRR15539824;37;40;0.459459459459459;20;17;0.0405405405405405;0.459459459459459
Control.SRR15539824;40;40;0.5;20;20;0;0.5
Control.SRR15539824;33;40;0.666666666666667;11;22;0.166666666666667;0.333333333333333
Control.SRR15539824;37;40;0.621621621621622;14;23;0.121621621621622;0.378378378378378
Control.SRR15539824;36;40;0.527777777777778;17;19;0.0277777777777778;0.472222222222222
Control.SRR15539824;38;40;0.473684210526316;20;18;0.0263157894736842;0.473684210526316
Control.SRR15539824;36;40;0.5;18;18;0;0.5
Control.SRR15539824;33;40;0.454545454545455;18;15;0.0454545454545455;0.454545454545455
Control.SRR15539824;41;40;0.634146341463415;15;26;0.134146341463415;0.365853658536585
Control.SRR15539824;42;40;0.333333333333333;28;14;0.166666666666667;0.333333333333333
Control.SRR15539824;33;40;0.303030303030303;23;10;0.196969696969697;0.303030303030303
Control.SRR15539824;33;40;0.484848484848485;17;16;0.0151515151515151;0.484848484848485
Control.SRR15539824;39;40;0.487179487179487;20;19;0.0128205128205128;0.487179487179487
Control.SRR15539824;40;40;0.5;20;20;0;0.5
Control.SRR15539824;40;40;0.475;21;19;0.025;0.475
Control.SRR15539824;39;40;0.512820512820513;19;20;0.0128205128205128;0.487179487179487
Control.SRR15539824;37;40;0.513513513513513;18;19;0.0135135135135135;0.486486486486487
Control.SRR15539824;42;40;0.523809523809524;20;22;0.0238095238095238;0.476190476190476
Control.SRR15539824;39;40;0.512820512820513;19;20;0.0128205128205128;0.487179487179487
Control.SRR15539824;40;40;0.575;17;23;0.075;0.425
Control.SRR15539824;36;40;0.527777777777778;17;19;0.0277777777777778;0.472222222222222
Control.SRR15539824;38;40;0.447368421052632;21;17;0.0526315789473684;0.447368421052632
Control.SRR15539824;42;40;0.452380952380952;23;19;0.0476190476190476;0.452380952380952
Control.SRR15539824;34;40;0.558823529411765;15;19;0.0588235294117647;0.441176470588235
Control.SRR15539824;38;40;0.447368421052632;21;17;0.0526315789473684;0.447368421052632
Control.SRR15539824;35;40;0.428571428571429;20;15;0.0714285714285715;0.428571428571429
Control.SRR15539824;32;40;0.59375;13;19;0.09375;0.40625
Control.SRR15539824;38;40;0.421052631578947;22;16;0.0789473684210527;0.421052631578947
Control.SRR15539824;34;40;0.558823529411765;15;19;0.0588235294117647;0.441176470588235
Control.SRR15539824;41;40;0.390243902439024;25;16;0.109756097560976;0.390243902439024
Control.SRR15539824;42;40;0.476190476190476;22;20;0.0238095238095238;0.476190476190476
Control.SRR15539824;36;40;0.555555555555556;16;20;0.0555555555555556;0.444444444444444
Control.SRR15539824;36;40;0.555555555555556;16;20;0.0555555555555556;0.444444444444444
Control.SRR15539824;35;40;0.657142857142857;12;23;0.157142857142857;0.342857142857143
Control.SRR15539824;42;40;0.380952380952381;26;16;0.119047619047619;0.380952380952381
Control.SRR15539824;42;40;0.5;21;21;0;0.5
Control.SRR15539824;42;40;0.452380952380952;23;19;0.0476190476190476;0.452380952380952
Control.SRR15539824;42;40;0.404761904761905;25;17;0.0952380952380952;0.404761904761905
Control.SRR15539824;38;40;0.447368421052632;21;17;0.0526315789473684;0.447368421052632
Control.SRR15539824;41;40;0.634146341463415;15;26;0.134146341463415;0.365853658536585
Control.SRR15539824;37;40;0.567567567567568;16;21;0.0675675675675675;0.432432432432432
Control.SRR15539824;36;40;0.444444444444444;20;16;0.0555555555555556;0.444444444444444
Control.SRR15539824;35;40;0.542857142857143;16;19;0.0428571428571428;0.457142857142857
Control.SRR15539824;34;40;0.470588235294118;18;16;0.0294117647058824;0.470588235294118
Control.SRR15539824;34;40;0.529411764705882;16;18;0.0294117647058824;0.470588235294118
Control.SRR15539824;37;40;0.432432432432432;21;16;0.0675675675675675;0.432432432432432
Control.SRR15539824;42;40;0.571428571428571;18;24;0.0714285714285714;0.428571428571429
Control.SRR15539824;39;40;0.564102564102564;17;22;0.0641025641025641;0.435897435897436
Control.SRR15539824;32;40;0.5625;14;18;0.0625;0.4375
Control.SRR15539824;40;40;0.525;19;21;0.025;0.475
Control.SRR15539824;40;40;0.5;20;20;0;0.5
Control.SRR15539824;37;40;0.513513513513513;18;19;0.0135135135135135;0.486486486486487
Control.SRR15539824;38;40;0.421052631578947;22;16;0.0789473684210527;0.421052631578947
Control.SRR15539824;40;40;0.5;20;20;0;0.5
Control.SRR15539824;38;40;0.473684210526316;20;18;0.0263157894736842;0.473684210526316
Control.SRR15539824;33;40;0.606060606060606;13;20;0.106060606060606;0.393939393939394
Control.SRR15539824;32;40;0.5;16;16;0;0.5
Control.SRR15539824;40;40;0.475;21;19;0.025;0.475
Control.SRR15539824;35;40;0.542857142857143;16;19;0.0428571428571428;0.457142857142857
Control.SRR15539824;36;40;0.611111111111111;14;22;0.111111111111111;0.388888888888889
Control.SRR15539824;39;40;0.461538461538462;21;18;0.0384615384615384;0.461538461538462
Control.SRR15539824;35;40;0.457142857142857;19;16;0.0428571428571429;0.457142857142857
Control.SRR15539824;34;40;0.558823529411765;15;19;0.0588235294117647;0.441176470588235
Control.SRR15539824;34;40;0.411764705882353;20;14;0.0882352941176471;0.411764705882353
Control.SRR15539824;40;40;0.625;15;25;0.125;0.375
Control.SRR15539824;33;40;0.606060606060606;13;20;0.106060606060606;0.393939393939394
Control.SRR15539824;40;40;0.45;22;18;0.05;0.45
Control.SRR15539824;39;40;0.41025641025641;23;16;0.0897435897435898;0.41025641025641
Control.SRR15539824;39;40;0.58974358974359;16;23;0.0897435897435898;0.41025641025641
Control.SRR15539824;42;40;0.595238095238095;17;25;0.0952380952380952;0.404761904761905
Control.SRR15539824;32;40;0.53125;15;17;0.03125;0.46875
Control.SRR15539824;36;40;0.555555555555556;16;20;0.0555555555555556;0.444444444444444
Control.SRR15539824;36;40;0.444444444444444;20;16;0.0555555555555556;0.444444444444444
Control.SRR15539824;35;40;0.342857142857143;23;12;0.157142857142857;0.342857142857143
Control.SRR15539824;35;40;0.428571428571429;20;15;0.0714285714285715;0.428571428571429
Control.SRR15539824;32;40;0.40625;19;13;0.09375;0.40625
Control.SRR15539824;40;40;0.575;17;23;0.075;0.425
Control.SRR15539824;32;40;0.5625;14;18;0.0625;0.4375
Control.SRR15539824;36;40;0.388888888888889;22;14;0.111111111111111;0.388888888888889
Control.SRR15539824;35;40;0.4;21;14;0.1;0.4
Control.SRR15539824;34;40;0.617647058823529;13;21;0.117647058823529;0.382352941176471
Control.SRR15539824;34;40;0.558823529411765;15;19;0.0588235294117647;0.441176470588235
Control.SRR15539824;39;40;0.435897435897436;22;17;0.0641025641025641;0.435897435897436
Control.SRR15539824;40;40;0.625;15;25;0.125;0.375
Control.SRR15539824;38;40;0.5;19;19;0;0.5
Control.SRR15539824;38;40;0.447368421052632;21;17;0.0526315789473684;0.447368421052632
Control.SRR15539824;38;40;0.605263157894737;15;23;0.105263157894737;0.394736842105263
Control.SRR15539824;39;40;0.487179487179487;20;19;0.0128205128205128;0.487179487179487
Control.SRR15539824;39;40;0.487179487179487;20;19;0.0128205128205128;0.487179487179487
Control.SRR15539824;36;40;0.472222222222222;19;17;0.0277777777777778;0.472222222222222
Control.SRR15539824;40;40;0.45;22;18;0.05;0.45
Control.SRR15539824;40;40;0.5;20;20;0;0.5
Control.SRR15539824;40;40;0.5;20;20;0;0.5
Control.SRR15539824;32;40;0.375;20;12;0.125;0.375
Control.SRR15539824;41;40;0.609756097560976;16;25;0.109756097560976;0.390243902439024
Control.SRR15539824;32;40;0.46875;17;15;0.03125;0.46875
Control.SRR15539824;41;40;0.414634146341463;24;17;0.0853658536585366;0.414634146341463
Control.SRR15539824;33;40;0.575757575757576;14;19;0.0757575757575758;0.424242424242424
Control.SRR15539824;33;40;0.606060606060606;13;20;0.106060606060606;0.393939393939394
Control.SRR15539824;35;40;0.542857142857143;16;19;0.0428571428571428;0.457142857142857
Control.SRR15539824;34;40;0.5;17;17;0;0.5
Control.SRR15539824;40;40;0.55;18;22;0.05;0.45
Control.SRR15539824;36;40;0.416666666666667;21;15;0.0833333333333333;0.416666666666667
Control.SRR15539824;33;40;0.484848484848485;17;16;0.0151515151515151;0.484848484848485
Control.SRR15539824;36;40;0.694444444444444;11;25;0.194444444444444;0.305555555555556
Control.SRR15539824;42;40;0.5;21;21;0;0.5
Control.SRR15539824;33;40;0.606060606060606;13;20;0.106060606060606;0.393939393939394
Control.SRR15539824;36;40;0.611111111111111;14;22;0.111111111111111;0.388888888888889
Control.SRR15539824;36;40;0.555555555555556;16;20;0.0555555555555556;0.444444444444444
Control.SRR15539824;32;40;0.59375;13;19;0.09375;0.40625
Control.SRR15539824;40;40;0.425;23;17;0.075;0.425
Control.SRR15539824;40;40;0.55;18;22;0.05;0.45
Control.SRR15539824;38;40;0.526315789473684;18;20;0.0263157894736842;0.473684210526316
Control.SRR15539824;35;40;0.457142857142857;19;16;0.0428571428571429;0.457142857142857
Control.SRR15539824;37;40;0.486486486486487;19;18;0.0135135135135135;0.486486486486487
Control.SRR15539824;35;40;0.514285714285714;17;18;0.0142857142857142;0.485714285714286
Control.SRR15539824;32;40;0.375;20;12;0.125;0.375
Control.SRR15539824;34;40;0.441176470588235;19;15;0.0588235294117647;0.441176470588235
Control.SRR15539824;39;40;0.461538461538462;21;18;0.0384615384615384;0.461538461538462
Control.SRR15539824;36;40;0.527777777777778;17;19;0.0277777777777778;0.472222222222222
Control.SRR15539824;33;40;0.515151515151515;16;17;0.0151515151515151;0.484848484848485
Control.SRR15539824;35;40;0.542857142857143;16;19;0.0428571428571428;0.457142857142857
Control.SRR15539824;41;40;0.390243902439024;25;16;0.109756097560976;0.390243902439024
Control.SRR15539824;41;40;0.48780487804878;21;20;0.0121951219512195;0.48780487804878
Control.SRR15539824;41;40;0.463414634146341;22;19;0.0365853658536585;0.463414634146341
Control.SRR15539824;34;40;0.411764705882353;20;14;0.0882352941176471;0.411764705882353
Control.SRR15539824;34;40;0.5;17;17;0;0.5
Control.SRR15539824;32;40;0.5625;14;18;0.0625;0.4375
Control.SRR15539824;39;40;0.564102564102564;17;22;0.0641025641025641;0.435897435897436
Control.SRR15539824;41;40;0.560975609756098;18;23;0.0609756097560976;0.439024390243902
Control.SRR15539824;41;40;0.390243902439024;25;16;0.109756097560976;0.390243902439024
Control.SRR15539824;32;40;0.5;16;16;0;0.5
Control.SRR15539824;34;40;0.588235294117647;14;20;0.0882352941176471;0.411764705882353
Control.SRR15539824;36;40;0.555555555555556;16;20;0.0555555555555556;0.444444444444444
Control.SRR15539824;33;40;0.484848484848485;17;16;0.0151515151515151;0.484848484848485
Control.SRR15539824;36;40;0.444444444444444;20;16;0.0555555555555556;0.444444444444444
Control.SRR15539824;41;40;0.536585365853659;19;22;0.0365853658536586;0.463414634146341
Control.SRR15539824;37;40;0.648648648648649;13;24;0.148648648648649;0.351351351351351
Control.SRR15539824;35;40;0.6;14;21;0.1;0.4
Control.SRR15539824;34;40;0.470588235294118;18;16;0.0294117647058824;0.470588235294118
Control.SRR15539824;36;40;0.416666666666667;21;15;0.0833333333333333;0.416666666666667
Control.SRR15539824;33;40;0.636363636363636;12;21;0.136363636363636;0.363636363636364
Control.SRR15539824;42;40;0.619047619047619;16;26;0.119047619047619;0.380952380952381
Control.SRR15539824;37;40;0.513513513513513;18;19;0.0135135135135135;0.486486486486487
Control.SRR15539824;38;40;0.684210526315789;12;26;0.184210526315789;0.315789473684211
Control.SRR15539824;41;40;0.48780487804878;21;20;0.0121951219512195;0.48780487804878
Control.SRR15539824;37;40;0.567567567567568;16;21;0.0675675675675675;0.432432432432432
Control.SRR15539824;38;40;0.473684210526316;20;18;0.0263157894736842;0.473684210526316
Control.SRR15539824;42;40;0.452380952380952;23;19;0.0476190476190476;0.452380952380952
Control.SRR15539824;42;40;0.380952380952381;26;16;0.119047619047619;0.380952380952381
Control.SRR15539824;32;40;0.46875;17;15;0.03125;0.46875
Control.SRR15539824;37;40;0.513513513513513;18;19;0.0135135135135135;0.486486486486487
Control.SRR15539824;34;40;0.5;17;17;0;0.5
Control.SRR15539824;33;40;0.393939393939394;20;13;0.106060606060606;0.393939393939394
Control.SRR15539824;37;40;0.648648648648649;13;24;0.148648648648649;0.351351351351351
Control.SRR15539824;33;40;0.333333333333333;22;11;0.166666666666667;0.333333333333333
Control.SRR15539824;33;40;0.424242424242424;19;14;0.0757575757575757;0.424242424242424
Control.SRR15539824;38;40;0.394736842105263;23;15;0.105263157894737;0.394736842105263
Control.SRR15539824;40;40;0.525;19;21;0.025;0.475
Control.SRR15539824;40;40;0.625;15;25;0.125;0.375
Control.SRR15539824;34;40;0.617647058823529;13;21;0.117647058823529;0.382352941176471
Control.SRR15539824;42;40;0.452380952380952;23;19;0.0476190476190476;0.452380952380952
Control.SRR15539824;33;40;0.545454545454545;15;18;0.0454545454545454;0.454545454545455
Control.SRR15539824;33;40;0.636363636363636;12;21;0.136363636363636;0.363636363636364
Control.SRR15539824;39;40;0.58974358974359;16;23;0.0897435897435898;0.41025641025641
Control.SRR15539824;42;40;0.523809523809524;20;22;0.0238095238095238;0.476190476190476
Control.SRR15539824;38;40;0.368421052631579;24;14;0.131578947368421;0.368421052631579
Control.SRR15539824;35;40;0.542857142857143;16;19;0.0428571428571428;0.457142857142857
Control.SRR15539824;34;40;0.382352941176471;21;13;0.117647058823529;0.382352941176471
Control.SRR15539824;38;40;0.605263157894737;15;23;0.105263157894737;0.394736842105263
Control.SRR15539824;33;40;0.636363636363636;12;21;0.136363636363636;0.363636363636364
Control.SRR15539824;36;40;0.361111111111111;23;13;0.138888888888889;0.361111111111111
Control.SRR15539824;33;40;0.666666666666667;11;22;0.166666666666667;0.333333333333333
Control.SRR15539824;34;40;0.558823529411765;15;19;0.0588235294117647;0.441176470588235
Control.SRR15539824;42;40;0.476190476190476;22;20;0.0238095238095238;0.476190476190476
Control.SRR15539824;38;40;0.421052631578947;22;16;0.0789473684210527;0.421052631578947
Control.SRR15539824;38;40;0.473684210526316;20;18;0.0263157894736842;0.473684210526316
Control.SRR15539824;36;40;0.638888888888889;13;23;0.138888888888889;0.361111111111111
Control.SRR15539824;36;40;0.5;18;18;0;0.5
Control.SRR15539824;39;40;0.512820512820513;19;20;0.0128205128205128;0.487179487179487
Control.SRR15539824;33;40;0.575757575757576;14;19;0.0757575757575758;0.424242424242424
Control.SRR15539824;39;40;0.461538461538462;21;18;0.0384615384615384;0.461538461538462
Control.SRR15539824;42;40;0.476190476190476;22;20;0.0238095238095238;0.476190476190476
Control.SRR15539824;34;40;0.470588235294118;18;16;0.0294117647058824;0.470588235294118
Control.SRR15539824;40;40;0.5;20;20;0;0.5
Control.SRR15539824;39;40;0.538461538461538;18;21;0.0384615384615384;0.461538461538462
Control.SRR15539824;37;40;0.513513513513513;18;19;0.0135135135135135;0.486486486486487
Control.SRR15539824;35;40;0.457142857142857;19;16;0.0428571428571429;0.457142857142857
Control.SRR15539824;40;40;0.5;20;20;0;0.5
Control.SRR15539824;39;40;0.538461538461538;18;21;0.0384615384615384;0.461538461538462
Control.SRR15539824;40;40;0.425;23;17;0.075;0.425
Control.SRR15539824;32;40;0.40625;19;13;0.09375;0.40625
Control.SRR15539824;38;40;0.394736842105263;23;15;0.105263157894737;0.394736842105263
Control.SRR15539824;35;40;0.4;21;14;0.1;0.4
Control.SRR15539824;38;40;0.631578947368421;14;24;0.131578947368421;0.368421052631579
Control.SRR15539824;35;40;0.485714285714286;18;17;0.0142857142857143;0.485714285714286
Control.SRR15539824;41;40;0.439024390243902;23;18;0.0609756097560976;0.439024390243902
Control.SRR15539824;40;40;0.525;19;21;0.025;0.475
Control.SRR15539824;40;40;0.55;18;22;0.05;0.45
Control.SRR15539824;40;40;0.4;24;16;0.1;0.4
Control.SRR15539824;41;40;0.536585365853659;19;22;0.0365853658536586;0.463414634146341
Control.SRR15539824;36;40;0.555555555555556;16;20;0.0555555555555556;0.444444444444444
Control.SRR15539824;37;40;0.513513513513513;18;19;0.0135135135135135;0.486486486486487
Control.SRR15539824;35;40;0.457142857142857;19;16;0.0428571428571429;0.457142857142857
Control.SRR15539824;39;40;0.564102564102564;17;22;0.0641025641025641;0.435897435897436
Control.SRR15539824;37;40;0.486486486486487;19;18;0.0135135135135135;0.486486486486487
Control.SRR15539824;34;40;0.441176470588235;19;15;0.0588235294117647;0.441176470588235
Control.SRR15539824;33;40;0.575757575757576;14;19;0.0757575757575758;0.424242424242424
Control.SRR15539824;34;40;0.382352941176471;21;13;0.117647058823529;0.382352941176471
Control.SRR15539824;42;40;0.619047619047619;16;26;0.119047619047619;0.380952380952381
Control.SRR15539824;33;40;0.515151515151515;16;17;0.0151515151515151;0.484848484848485
Control.SRR15539824;33;40;0.424242424242424;19;14;0.0757575757575757;0.424242424242424
Control.SRR15539824;37;40;0.621621621621622;14;23;0.121621621621622;0.378378378378378
Control.SRR15539824;39;40;0.435897435897436;22;17;0.0641025641025641;0.435897435897436
Control.SRR15539824;41;40;0.463414634146341;22;19;0.0365853658536585;0.463414634146341
Control.SRR15539824;37;40;0.432432432432432;21;16;0.0675675675675675;0.432432432432432
Control.SRR15539824;33;40;0.575757575757576;14;19;0.0757575757575758;0.424242424242424
Control.SRR15539824;41;40;0.48780487804878;21;20;0.0121951219512195;0.48780487804878
Control.SRR15539824;34;40;0.441176470588235;19;15;0.0588235294117647;0.441176470588235
Control.SRR15539824;35;40;0.514285714285714;17;18;0.0142857142857142;0.485714285714286
Control.SRR15539824;38;40;0.578947368421053;16;22;0.0789473684210527;0.421052631578947
Control.SRR15539824;37;40;0.594594594594595;15;22;0.0945945945945946;0.405405405405405
Control.SRR15539824;38;40;0.5;19;19;0;0.5
Control.SRR15539824;34;40;0.411764705882353;20;14;0.0882352941176471;0.411764705882353
Control.SRR15539824;35;40;0.457142857142857;19;16;0.0428571428571429;0.457142857142857
Control.SRR15539824;38;40;0.289473684210526;27;11;0.210526315789474;0.289473684210526
Control.SRR15539824;36;40;0.555555555555556;16;20;0.0555555555555556;0.444444444444444
Control.SRR15539824;41;40;0.658536585365854;14;27;0.158536585365854;0.341463414634146
Control.SRR15539824;37;40;0.459459459459459;20;17;0.0405405405405405;0.459459459459459
Control.SRR15539824;34;40;0.411764705882353;20;14;0.0882352941176471;0.411764705882353
Control.SRR15539824;33;40;0.393939393939394;20;13;0.106060606060606;0.393939393939394
Control.SRR15539824;37;40;0.378378378378378;23;14;0.121621621621622;0.378378378378378
Control.SRR15539824;41;40;0.536585365853659;19;22;0.0365853658536586;0.463414634146341
Control.SRR15539824;41;40;0.48780487804878;21;20;0.0121951219512195;0.48780487804878
Control.SRR15539824;34;40;0.764705882352941;8;26;0.264705882352941;0.235294117647059
Control.SRR15539824;32;40;0.46875;17;15;0.03125;0.46875
Control.SRR15539824;40;40;0.5;20;20;0;0.5
Control.SRR15539824;40;40;0.525;19;21;0.025;0.475
Control.SRR15539824;39;40;0.512820512820513;19;20;0.0128205128205128;0.487179487179487
Control.SRR15539824;37;40;0.324324324324324;25;12;0.175675675675676;0.324324324324324
Control.SRR15539824;38;40;0.289473684210526;27;11;0.210526315789474;0.289473684210526
Control.SRR15539824;37;40;0.432432432432432;21;16;0.0675675675675675;0.432432432432432
Control.SRR15539824;34;40;0.588235294117647;14;20;0.0882352941176471;0.411764705882353
Control.SRR15539824;36;40;0.444444444444444;20;16;0.0555555555555556;0.444444444444444
Control.SRR15539824;39;40;0.512820512820513;19;20;0.0128205128205128;0.487179487179487
Control.SRR15539824;37;40;0.513513513513513;18;19;0.0135135135135135;0.486486486486487
Control.SRR15539824;41;40;0.536585365853659;19;22;0.0365853658536586;0.463414634146341
Control.SRR15539824;41;40;0.48780487804878;21;20;0.0121951219512195;0.48780487804878
Control.SRR15539824;42;40;0.452380952380952;23;19;0.0476190476190476;0.452380952380952
Control.SRR15539824;35;40;0.571428571428571;15;20;0.0714285714285714;0.428571428571429
Control.SRR15539824;41;40;0.48780487804878;21;20;0.0121951219512195;0.48780487804878
Control.SRR15539824;32;40;0.59375;13;19;0.09375;0.40625
Control.SRR15539824;37;40;0.432432432432432;21;16;0.0675675675675675;0.432432432432432
Control.SRR15539824;39;40;0.41025641025641;23;16;0.0897435897435898;0.41025641025641
Control.SRR15539824;34;40;0.617647058823529;13;21;0.117647058823529;0.382352941176471
Control.SRR15539824;34;40;0.470588235294118;18;16;0.0294117647058824;0.470588235294118
Control.SRR15539824;38;40;0.473684210526316;20;18;0.0263157894736842;0.473684210526316
Control.SRR15539824;36;40;0.527777777777778;17;19;0.0277777777777778;0.472222222222222
Control.SRR15539824;39;40;0.487179487179487;20;19;0.0128205128205128;0.487179487179487
Control.SRR15539824;39;40;0.538461538461538;18;21;0.0384615384615384;0.461538461538462
Control.SRR15539824;39;40;0.307692307692308;27;12;0.192307692307692;0.307692307692308
Control.SRR15539824;38;40;0.473684210526316;20;18;0.0263157894736842;0.473684210526316
Control.SRR15539824;42;40;0.69047619047619;13;29;0.19047619047619;0.30952380952381
Control.SRR15539824;32;40;0.4375;18;14;0.0625;0.4375
Control.SRR15539824;42;40;0.476190476190476;22;20;0.0238095238095238;0.476190476190476
Control.SRR15539824;35;40;0.371428571428571;22;13;0.128571428571429;0.371428571428571
Control.SRR15539824;37;40;0.432432432432432;21;16;0.0675675675675675;0.432432432432432
Control.SRR15539824;42;40;0.5;21;21;0;0.5
Control.SRR15539824;32;40;0.53125;15;17;0.03125;0.46875
Control.SRR15539824;37;40;0.675675675675676;12;25;0.175675675675676;0.324324324324324
Control.SRR15539824;38;40;0.578947368421053;16;22;0.0789473684210527;0.421052631578947
Control.SRR15539824;42;40;0.404761904761905;25;17;0.0952380952380952;0.404761904761905
Control.SRR15539824;37;40;0.405405405405405;22;15;0.0945945945945946;0.405405405405405
Control.SRR15539824;36;40;0.444444444444444;20;16;0.0555555555555556;0.444444444444444
Control.SRR15539824;36;40;0.527777777777778;17;19;0.0277777777777778;0.472222222222222
Control.SRR15539824;35;40;0.4;21;14;0.1;0.4
Control.SRR15539824;36;40;0.472222222222222;19;17;0.0277777777777778;0.472222222222222
Control.SRR15539824;39;40;0.512820512820513;19;20;0.0128205128205128;0.487179487179487
Control.SRR15539824;32;40;0.53125;15;17;0.03125;0.46875
Control.SRR15539824;33;40;0.515151515151515;16;17;0.0151515151515151;0.484848484848485
Control.SRR15539824;32;40;0.5;16;16;0;0.5
Control.SRR15539824;38;40;0.473684210526316;20;18;0.0263157894736842;0.473684210526316
Control.SRR15539824;40;40;0.45;22;18;0.05;0.45
Control.SRR15539824;37;40;0.405405405405405;22;15;0.0945945945945946;0.405405405405405
Control.SRR15539824;38;40;0.473684210526316;20;18;0.0263157894736842;0.473684210526316
Control.SRR15539824;40;40;0.525;19;21;0.025;0.475
Control.SRR15539824;36;40;0.5;18;18;0;0.5
Control.SRR15539824;34;40;0.441176470588235;19;15;0.0588235294117647;0.441176470588235
Control.SRR15539824;36;40;0.388888888888889;22;14;0.111111111111111;0.388888888888889
Control.SRR15539824;37;40;0.405405405405405;22;15;0.0945945945945946;0.405405405405405
Control.SRR15539824;37;40;0.567567567567568;16;21;0.0675675675675675;0.432432432432432
Control.SRR15539824;38;40;0.5;19;19;0;0.5
Control.SRR15539824;40;40;0.55;18;22;0.05;0.45
Control.SRR15539824;35;40;0.542857142857143;16;19;0.0428571428571428;0.457142857142857
Control.SRR15539824;36;40;0.361111111111111;23;13;0.138888888888889;0.361111111111111
Control.SRR15539824;40;40;0.275;29;11;0.225;0.275
Control.SRR15539824;38;40;0.552631578947368;17;21;0.0526315789473685;0.447368421052632
Control.SRR15539824;40;40;0.6;16;24;0.1;0.4
Control.SRR15539824;33;40;0.393939393939394;20;13;0.106060606060606;0.393939393939394
Control.SRR15539824;39;40;0.58974358974359;16;23;0.0897435897435898;0.41025641025641
Control.SRR15539824;42;40;0.476190476190476;22;20;0.0238095238095238;0.476190476190476
Control.SRR15539824;33;40;0.393939393939394;20;13;0.106060606060606;0.393939393939394
Control.SRR15539824;40;40;0.575;17;23;0.075;0.425
Control.SRR15539824;40;40;0.375;25;15;0.125;0.375
Control.SRR15539824;34;40;0.382352941176471;21;13;0.117647058823529;0.382352941176471
Control.SRR15539824;36;40;0.5;18;18;0;0.5
Control.SRR15539824;37;40;0.405405405405405;22;15;0.0945945945945946;0.405405405405405
Control.SRR15539824;36;40;0.527777777777778;17;19;0.0277777777777778;0.472222222222222
Control.SRR15539824;41;40;0.51219512195122;20;21;0.0121951219512195;0.48780487804878
Control.SRR15539824;33;40;0.696969696969697;10;23;0.196969696969697;0.303030303030303
Control.SRR15539824;40;40;0.475;21;19;0.025;0.475
Control.SRR15539824;38;40;0.473684210526316;20;18;0.0263157894736842;0.473684210526316
Control.SRR15539824;35;40;0.4;21;14;0.1;0.4
Control.SRR15539824;39;40;0.512820512820513;19;20;0.0128205128205128;0.487179487179487
Control.SRR15539824;39;40;0.41025641025641;23;16;0.0897435897435898;0.41025641025641
Control.SRR15539824;32;40;0.4375;18;14;0.0625;0.4375
Control.SRR15539824;42;40;0.547619047619048;19;23;0.0476190476190477;0.452380952380952
Control.SRR15539824;36;40;0.472222222222222;19;17;0.0277777777777778;0.472222222222222
Control.SRR15539824;38;40;0.605263157894737;15;23;0.105263157894737;0.394736842105263
Control.SRR15539824;40;40;0.625;15;25;0.125;0.375
Control.SRR15539824;36;40;0.416666666666667;21;15;0.0833333333333333;0.416666666666667
Control.SRR15539824;35;40;0.685714285714286;11;24;0.185714285714286;0.314285714285714
Control.SRR15539824;35;40;0.571428571428571;15;20;0.0714285714285714;0.428571428571429
Control.SRR15539824;38;40;0.578947368421053;16;22;0.0789473684210527;0.421052631578947
Control.SRR15539824;34;40;0.470588235294118;18;16;0.0294117647058824;0.470588235294118
Control.SRR15539824;33;40;0.515151515151515;16;17;0.0151515151515151;0.484848484848485
Control.SRR15539824;32;40;0.5625;14;18;0.0625;0.4375
Control.SRR15539824;33;40;0.545454545454545;15;18;0.0454545454545454;0.454545454545455
Control.SRR15539824;36;40;0.388888888888889;22;14;0.111111111111111;0.388888888888889
Control.SRR15539824;40;40;0.475;21;19;0.025;0.475
Control.SRR15539824;37;40;0.459459459459459;20;17;0.0405405405405405;0.459459459459459
Control.SRR15539824;33;40;0.393939393939394;20;13;0.106060606060606;0.393939393939394
Control.SRR15539824;33;40;0.363636363636364;21;12;0.136363636363636;0.363636363636364
Control.SRR15539824;42;40;0.523809523809524;20;22;0.0238095238095238;0.476190476190476
Control.SRR15539824;42;40;0.452380952380952;23;19;0.0476190476190476;0.452380952380952
Control.SRR15539824;33;40;0.424242424242424;19;14;0.0757575757575757;0.424242424242424
Control.SRR15539824;32;40;0.40625;19;13;0.09375;0.40625
Control.SRR15539824;36;40;0.5;18;18;0;0.5
Control.SRR15539824;34;40;0.441176470588235;19;15;0.0588235294117647;0.441176470588235
Control.SRR15539824;38;40;0.421052631578947;22;16;0.0789473684210527;0.421052631578947
Control.SRR15539824;37;40;0.405405405405405;22;15;0.0945945945945946;0.405405405405405
Control.SRR15539824;35;40;0.428571428571429;20;15;0.0714285714285715;0.428571428571429
Control.SRR15539824;37;40;0.594594594594595;15;22;0.0945945945945946;0.405405405405405
Control.SRR15539824;32;40;0.46875;17;15;0.03125;0.46875
Control.SRR15539824;42;40;0.428571428571429;24;18;0.0714285714285715;0.428571428571429
Control.SRR15539824;35;40;0.485714285714286;18;17;0.0142857142857143;0.485714285714286
Control.SRR15539824;41;40;0.414634146341463;24;17;0.0853658536585366;0.414634146341463
Control.SRR15539824;38;40;0.552631578947368;17;21;0.0526315789473685;0.447368421052632
Control.SRR15539824;39;40;0.564102564102564;17;22;0.0641025641025641;0.435897435897436
Control.SRR15539824;38;40;0.315789473684211;26;12;0.184210526315789;0.315789473684211
Control.SRR15539824;39;40;0.461538461538462;21;18;0.0384615384615384;0.461538461538462
Control.SRR15539824;41;40;0.609756097560976;16;25;0.109756097560976;0.390243902439024
Control.SRR15539824;41;40;0.439024390243902;23;18;0.0609756097560976;0.439024390243902
Control.SRR15539824;38;40;0.421052631578947;22;16;0.0789473684210527;0.421052631578947
Control.SRR15539824;42;40;0.380952380952381;26;16;0.119047619047619;0.380952380952381
Control.SRR15539824;39;40;0.538461538461538;18;21;0.0384615384615384;0.461538461538462
Control.SRR15539824;35;40;0.371428571428571;22;13;0.128571428571429;0.371428571428571
Control.SRR15539824;41;40;0.48780487804878;21;20;0.0121951219512195;0.48780487804878
Control.SRR15539824;40;40;0.575;17;23;0.075;0.425
Control.SRR15539824;37;40;0.567567567567568;16;21;0.0675675675675675;0.432432432432432
Control.SRR15539824;42;40;0.452380952380952;23;19;0.0476190476190476;0.452380952380952
Control.SRR15539824;37;40;0.513513513513513;18;19;0.0135135135135135;0.486486486486487
Control.SRR15539824;42;40;0.452380952380952;23;19;0.0476190476190476;0.452380952380952
Control.SRR15539824;36;40;0.277777777777778;26;10;0.222222222222222;0.277777777777778
Control.SRR15539824;33;40;0.454545454545455;18;15;0.0454545454545455;0.454545454545455
Control.SRR15539824;41;40;0.463414634146341;22;19;0.0365853658536585;0.463414634146341
Control.SRR15539824;36;40;0.611111111111111;14;22;0.111111111111111;0.388888888888889
Control.SRR15539824;38;40;0.5;19;19;0;0.5
Control.SRR15539824;33;40;0.606060606060606;13;20;0.106060606060606;0.393939393939394
Control.SRR15539824;37;40;0.432432432432432;21;16;0.0675675675675675;0.432432432432432
Control.SRR15539824;37;40;0.486486486486487;19;18;0.0135135135135135;0.486486486486487
Control.SRR15539824;32;40;0.5;16;16;0;0.5
Control.SRR15539824;37;40;0.459459459459459;20;17;0.0405405405405405;0.459459459459459
Control.SRR15539824;40;40;0.55;18;22;0.05;0.45
Control.SRR15539824;39;40;0.435897435897436;22;17;0.0641025641025641;0.435897435897436
Control.SRR15539824;41;40;0.463414634146341;22;19;0.0365853658536585;0.463414634146341
Control.SRR15539824;35;40;0.571428571428571;15;20;0.0714285714285714;0.428571428571429
Control.SRR15539824;38;40;0.526315789473684;18;20;0.0263157894736842;0.473684210526316
Control.SRR15539824;40;40;0.6;16;24;0.1;0.4
Control.SRR15539824;38;40;0.473684210526316;20;18;0.0263157894736842;0.473684210526316
Control.SRR15539824;41;40;0.585365853658537;17;24;0.0853658536585366;0.414634146341463
Control.SRR15539824;33;40;0.393939393939394;20;13;0.106060606060606;0.393939393939394
Control.SRR15539824;41;40;0.390243902439024;25;16;0.109756097560976;0.390243902439024
Control.SRR15539824;34;40;0.411764705882353;20;14;0.0882352941176471;0.411764705882353
Control.SRR15539824;34;40;0.558823529411765;15;19;0.0588235294117647;0.441176470588235
Control.SRR15539824;42;40;0.428571428571429;24;18;0.0714285714285715;0.428571428571429
Control.SRR15539824;37;40;0.513513513513513;18;19;0.0135135135135135;0.486486486486487
Control.SRR15539824;40;40;0.675;13;27;0.175;0.325
Control.SRR15539824;36;40;0.444444444444444;20;16;0.0555555555555556;0.444444444444444
Control.SRR15539824;41;40;0.658536585365854;14;27;0.158536585365854;0.341463414634146
Control.SRR15539824;36;40;0.555555555555556;16;20;0.0555555555555556;0.444444444444444
Control.SRR15539824;41;40;0.463414634146341;22;19;0.0365853658536585;0.463414634146341
Control.SRR15539824;42;40;0.428571428571429;24;18;0.0714285714285715;0.428571428571429
Control.SRR15539824;32;40;0.5625;14;18;0.0625;0.4375
Control.SRR15539824;34;40;0.5;17;17;0;0.5
Control.SRR15539824;37;40;0.594594594594595;15;22;0.0945945945945946;0.405405405405405
Control.SRR15539824;34;40;0.411764705882353;20;14;0.0882352941176471;0.411764705882353
Control.SRR15539824;32;40;0.5625;14;18;0.0625;0.4375
Control.SRR15539824;39;40;0.461538461538462;21;18;0.0384615384615384;0.461538461538462
Control.SRR15539824;42;40;0.452380952380952;23;19;0.0476190476190476;0.452380952380952
Control.SRR15539824;32;40;0.46875;17;15;0.03125;0.46875
Control.SRR15539824;37;40;0.459459459459459;20;17;0.0405405405405405;0.459459459459459
Control.SRR15539824;38;40;0.473684210526316;20;18;0.0263157894736842;0.473684210526316
Control.SRR15539824;41;40;0.48780487804878;21;20;0.0121951219512195;0.48780487804878
Control.SRR15539824;35;40;0.485714285714286;18;17;0.0142857142857143;0.485714285714286
Control.SRR15539824;39;40;0.538461538461538;18;21;0.0384615384615384;0.461538461538462
Control.SRR15539824;40;40;0.625;15;25;0.125;0.375
Control.SRR15539824;33;40;0.757575757575758;8;25;0.257575757575758;0.242424242424242
Control.SRR15539824;37;40;0.486486486486487;19;18;0.0135135135135135;0.486486486486487
Control.SRR15539824;42;40;0.619047619047619;16;26;0.119047619047619;0.380952380952381
Control.SRR15539824;38;40;0.421052631578947;22;16;0.0789473684210527;0.421052631578947
Control.SRR15539824;32;40;0.53125;15;17;0.03125;0.46875
Control.SRR15539824;37;40;0.432432432432432;21;16;0.0675675675675675;0.432432432432432
Control.SRR15539824;33;40;0.666666666666667;11;22;0.166666666666667;0.333333333333333
Control.SRR15539824;42;40;0.666666666666667;14;28;0.166666666666667;0.333333333333333
Control.SRR15539824;36;40;0.638888888888889;13;23;0.138888888888889;0.361111111111111
Control.SRR15539824;39;40;0.564102564102564;17;22;0.0641025641025641;0.435897435897436
Control.SRR15539824;40;40;0.55;18;22;0.05;0.45
Control.SRR15539824;32;40;0.5;16;16;0;0.5
Control.SRR15539824;34;40;0.323529411764706;23;11;0.176470588235294;0.323529411764706
Control.SRR15539824;40;40;0.5;20;20;0;0.5
Control.SRR15539824;38;40;0.473684210526316;20;18;0.0263157894736842;0.473684210526316
Control.SRR15539824;33;40;0.545454545454545;15;18;0.0454545454545454;0.454545454545455
Control.SRR15539824;37;40;0.648648648648649;13;24;0.148648648648649;0.351351351351351
Control.SRR15539824;39;40;0.564102564102564;17;22;0.0641025641025641;0.435897435897436
Control.SRR15539824;39;40;0.435897435897436;22;17;0.0641025641025641;0.435897435897436
Control.SRR15539824;35;40;0.571428571428571;15;20;0.0714285714285714;0.428571428571429
Control.SRR15539824;33;40;0.363636363636364;21;12;0.136363636363636;0.363636363636364
Control.SRR15539824;41;40;0.658536585365854;14;27;0.158536585365854;0.341463414634146
Control.SRR15539824;36;40;0.611111111111111;14;22;0.111111111111111;0.388888888888889
Control.SRR15539824;32;40;0.5;16;16;0;0.5
Control.SRR15539824;33;40;0.545454545454545;15;18;0.0454545454545454;0.454545454545455
Control.SRR15539824;34;40;0.647058823529412;12;22;0.147058823529412;0.352941176470588
Control.SRR15539824;36;40;0.5;18;18;0;0.5
Control.SRR15539824;33;40;0.454545454545455;18;15;0.0454545454545455;0.454545454545455
Control.SRR15539824;38;40;0.578947368421053;16;22;0.0789473684210527;0.421052631578947
Control.SRR15539824;40;40;0.45;22;18;0.05;0.45
Control.SRR15539824;33;40;0.424242424242424;19;14;0.0757575757575757;0.424242424242424
Control.SRR15539824;34;40;0.558823529411765;15;19;0.0588235294117647;0.441176470588235
Control.SRR15539824;38;40;0.605263157894737;15;23;0.105263157894737;0.394736842105263
Control.SRR15539824;41;40;0.463414634146341;22;19;0.0365853658536585;0.463414634146341
Control.SRR15539824;32;40;0.28125;23;9;0.21875;0.28125
Control.SRR15539824;37;40;0.378378378378378;23;14;0.121621621621622;0.378378378378378
Control.SRR15539824;37;40;0.459459459459459;20;17;0.0405405405405405;0.459459459459459
Control.SRR15539824;35;40;0.571428571428571;15;20;0.0714285714285714;0.428571428571429
Control.SRR15539824;37;40;0.297297297297297;26;11;0.202702702702703;0.297297297297297
Control.SRR15539824;35;40;0.485714285714286;18;17;0.0142857142857143;0.485714285714286
Control.SRR15539824;39;40;0.564102564102564;17;22;0.0641025641025641;0.435897435897436
Control.SRR15539824;38;40;0.552631578947368;17;21;0.0526315789473685;0.447368421052632
Control.SRR15539824;37;40;0.486486486486487;19;18;0.0135135135135135;0.486486486486487
Control.SRR15539824;38;40;0.421052631578947;22;16;0.0789473684210527;0.421052631578947
Control.SRR15539824;35;40;0.6;14;21;0.1;0.4
Control.SRR15539824;36;40;0.583333333333333;15;21;0.0833333333333334;0.416666666666667
Control.SRR15539824;39;40;0.692307692307692;12;27;0.192307692307692;0.307692307692308
Control.SRR15539824;34;40;0.647058823529412;12;22;0.147058823529412;0.352941176470588
Control.SRR15539824;41;40;0.707317073170732;12;29;0.207317073170732;0.292682926829268
Control.SRR15539824;40;40;0.525;19;21;0.025;0.475
Control.SRR15539824;40;40;0.425;23;17;0.075;0.425
Control.SRR15539824;37;40;0.513513513513513;18;19;0.0135135135135135;0.486486486486487
Control.SRR15539824;32;40;0.53125;15;17;0.03125;0.46875
Control.SRR15539824;39;40;0.487179487179487;20;19;0.0128205128205128;0.487179487179487
Control.SRR15539824;40;40;0.45;22;18;0.05;0.45
Control.SRR15539824;39;40;0.641025641025641;14;25;0.141025641025641;0.358974358974359
Control.SRR15539824;41;40;0.51219512195122;20;21;0.0121951219512195;0.48780487804878
Control.SRR15539824;32;40;0.5;16;16;0;0.5
Control.SRR15539824;32;40;0.46875;17;15;0.03125;0.46875
Control.SRR15539824;38;40;0.526315789473684;18;20;0.0263157894736842;0.473684210526316
Control.SRR15539824;41;40;0.365853658536585;26;15;0.134146341463415;0.365853658536585
Control.SRR15539824;40;40;0.6;16;24;0.1;0.4
Control.SRR15539824;40;40;0.475;21;19;0.025;0.475
Control.SRR15539824;38;40;0.657894736842105;13;25;0.157894736842105;0.342105263157895
Control.SRR15539824;36;40;0.583333333333333;15;21;0.0833333333333334;0.416666666666667
Control.SRR15539824;41;40;0.536585365853659;19;22;0.0365853658536586;0.463414634146341
Control.SRR15539824;33;40;0.454545454545455;18;15;0.0454545454545455;0.454545454545455
Control.SRR15539824;34;40;0.441176470588235;19;15;0.0588235294117647;0.441176470588235
Control.SRR15539824;37;40;0.540540540540541;17;20;0.0405405405405406;0.459459459459459
Control.SRR15539824;41;40;0.585365853658537;17;24;0.0853658536585366;0.414634146341463
Control.SRR15539824;35;40;0.514285714285714;17;18;0.0142857142857142;0.485714285714286
Control.SRR15539824;35;40;0.657142857142857;12;23;0.157142857142857;0.342857142857143
Control.SRR15539824;42;40;0.547619047619048;19;23;0.0476190476190477;0.452380952380952
Control.SRR15539824;41;40;0.658536585365854;14;27;0.158536585365854;0.341463414634146
Control.SRR15539824;42;40;0.380952380952381;26;16;0.119047619047619;0.380952380952381
Control.SRR15539824;42;40;0.452380952380952;23;19;0.0476190476190476;0.452380952380952
Control.SRR15539824;39;40;0.538461538461538;18;21;0.0384615384615384;0.461538461538462
Control.SRR15539824;41;40;0.463414634146341;22;19;0.0365853658536585;0.463414634146341
Control.SRR15539824;42;40;0.642857142857143;15;27;0.142857142857143;0.357142857142857
Control.SRR15539824;33;40;0.484848484848485;17;16;0.0151515151515151;0.484848484848485
Control.SRR15539824;42;40;0.547619047619048;19;23;0.0476190476190477;0.452380952380952
Control.SRR15539824;35;40;0.542857142857143;16;19;0.0428571428571428;0.457142857142857
Control.SRR15539824;32;40;0.375;20;12;0.125;0.375
Control.SRR15539824;32;40;0.5625;14;18;0.0625;0.4375
Control.SRR15539824;32;40;0.46875;17;15;0.03125;0.46875
Control.SRR15539824;37;40;0.621621621621622;14;23;0.121621621621622;0.378378378378378
Control.SRR15539824;36;40;0.555555555555556;16;20;0.0555555555555556;0.444444444444444
Control.SRR15539824;36;40;0.583333333333333;15;21;0.0833333333333334;0.416666666666667
Control.SRR15539824;32;40;0.625;12;20;0.125;0.375
Control.SRR15539824;35;40;0.485714285714286;18;17;0.0142857142857143;0.485714285714286
Control.SRR15539824;35;40;0.428571428571429;20;15;0.0714285714285715;0.428571428571429
Control.SRR15539824;40;40;0.65;14;26;0.15;0.35
Control.SRR15539824;40;40;0.475;21;19;0.025;0.475
Control.SRR15539824;41;40;0.536585365853659;19;22;0.0365853658536586;0.463414634146341
Control.SRR15539824;36;40;0.444444444444444;20;16;0.0555555555555556;0.444444444444444
Control.SRR15539824;42;40;0.5;21;21;0;0.5
Control.SRR15539824;37;40;0.432432432432432;21;16;0.0675675675675675;0.432432432432432
Control.SRR15539824;33;40;0.636363636363636;12;21;0.136363636363636;0.363636363636364
Control.SRR15539824;35;40;0.428571428571429;20;15;0.0714285714285715;0.428571428571429
Control.SRR15539824;39;40;0.58974358974359;16;23;0.0897435897435898;0.41025641025641
Control.SRR15539824;38;40;0.421052631578947;22;16;0.0789473684210527;0.421052631578947
Control.SRR15539824;42;40;0.547619047619048;19;23;0.0476190476190477;0.452380952380952
Control.SRR15539824;36;40;0.555555555555556;16;20;0.0555555555555556;0.444444444444444
Control.SRR15539824;40;40;0.7;12;28;0.2;0.3
Control.SRR15539824;40;40;0.4;24;16;0.1;0.4
Control.SRR15539824;41;40;0.341463414634146;27;14;0.158536585365854;0.341463414634146
Control.SRR15539824;38;40;0.473684210526316;20;18;0.0263157894736842;0.473684210526316
Control.SRR15539824;38;40;0.605263157894737;15;23;0.105263157894737;0.394736842105263
Control.SRR15539824;40;40;0.375;25;15;0.125;0.375
Control.SRR15539824;37;40;0.432432432432432;21;16;0.0675675675675675;0.432432432432432
Control.SRR15539824;37;40;0.594594594594595;15;22;0.0945945945945946;0.405405405405405
Control.SRR15539824;35;40;0.428571428571429;20;15;0.0714285714285715;0.428571428571429
Control.SRR15539824;34;40;0.558823529411765;15;19;0.0588235294117647;0.441176470588235
Control.SRR15539824;39;40;0.564102564102564;17;22;0.0641025641025641;0.435897435897436
Control.SRR15539824;40;40;0.4;24;16;0.1;0.4
Control.SRR15539824;35;40;0.6;14;21;0.1;0.4
Control.SRR15539824;36;40;0.694444444444444;11;25;0.194444444444444;0.305555555555556
Control.SRR15539824;38;40;0.394736842105263;23;15;0.105263157894737;0.394736842105263
Control.SRR15539824;41;40;0.439024390243902;23;18;0.0609756097560976;0.439024390243902
Control.SRR15539824;38;40;0.657894736842105;13;25;0.157894736842105;0.342105263157895
Control.SRR15539824;38;40;0.578947368421053;16;22;0.0789473684210527;0.421052631578947
Control.SRR15539824;42;40;0.619047619047619;16;26;0.119047619047619;0.380952380952381
Control.SRR15539824;33;40;0.424242424242424;19;14;0.0757575757575757;0.424242424242424
Control.SRR15539824;42;40;0.404761904761905;25;17;0.0952380952380952;0.404761904761905
Control.SRR15539824;41;40;0.463414634146341;22;19;0.0365853658536585;0.463414634146341
Control.SRR15539824;39;40;0.538461538461538;18;21;0.0384615384615384;0.461538461538462
Control.SRR15539824;33;40;0.484848484848485;17;16;0.0151515151515151;0.484848484848485
Control.SRR15539824;38;40;0.605263157894737;15;23;0.105263157894737;0.394736842105263
Control.SRR15539824;37;40;0.486486486486487;19;18;0.0135135135135135;0.486486486486487
Control.SRR15539824;42;40;0.547619047619048;19;23;0.0476190476190477;0.452380952380952
Control.SRR15539824;40;40;0.35;26;14;0.15;0.35
Control.SRR15539824;42;40;0.571428571428571;18;24;0.0714285714285714;0.428571428571429
Control.SRR15539824;35;40;0.485714285714286;18;17;0.0142857142857143;0.485714285714286
Control.SRR15539824;42;40;0.523809523809524;20;22;0.0238095238095238;0.476190476190476
Control.SRR15539824;40;40;0.375;25;15;0.125;0.375
Control.SRR15539824;36;40;0.5;18;18;0;0.5
Control.SRR15539824;42;40;0.5;21;21;0;0.5
Control.SRR15539824;36;40;0.388888888888889;22;14;0.111111111111111;0.388888888888889
Control.SRR15539824;34;40;0.617647058823529;13;21;0.117647058823529;0.382352941176471
Control.SRR15539824;42;40;0.5;21;21;0;0.5
Control.SRR15539824;35;40;0.457142857142857;19;16;0.0428571428571429;0.457142857142857
Control.SRR15539824;39;40;0.512820512820513;19;20;0.0128205128205128;0.487179487179487
Control.SRR15539824;32;40;0.53125;15;17;0.03125;0.46875
Control.SRR15539824;38;40;0.394736842105263;23;15;0.105263157894737;0.394736842105263
Control.SRR15539824;40;40;0.375;25;15;0.125;0.375
Control.SRR15539824;42;40;0.5;21;21;0;0.5
Control.SRR15539824;34;40;0.5;17;17;0;0.5
Control.SRR15539824;41;40;0.48780487804878;21;20;0.0121951219512195;0.48780487804878
Control.SRR15539824;39;40;0.461538461538462;21;18;0.0384615384615384;0.461538461538462
Control.SRR15539824;40;40;0.5;20;20;0;0.5
Control.SRR15539824;42;40;0.595238095238095;17;25;0.0952380952380952;0.404761904761905
Control.SRR15539824;39;40;0.435897435897436;22;17;0.0641025641025641;0.435897435897436
Control.SRR15539824;38;40;0.578947368421053;16;22;0.0789473684210527;0.421052631578947
Control.SRR15539824;33;40;0.606060606060606;13;20;0.106060606060606;0.393939393939394
Control.SRR15539824;38;40;0.342105263157895;25;13;0.157894736842105;0.342105263157895
Control.SRR15539824;41;40;0.48780487804878;21;20;0.0121951219512195;0.48780487804878
Control.SRR15539824;38;40;0.631578947368421;14;24;0.131578947368421;0.368421052631579
Control.SRR15539824;41;40;0.390243902439024;25;16;0.109756097560976;0.390243902439024
Control.SRR15539824;40;40;0.475;21;19;0.025;0.475
Control.SRR15539824;40;40;0.525;19;21;0.025;0.475
Control.SRR15539824;36;40;0.527777777777778;17;19;0.0277777777777778;0.472222222222222
Control.SRR15539824;38;40;0.473684210526316;20;18;0.0263157894736842;0.473684210526316
Control.SRR15539824;39;40;0.435897435897436;22;17;0.0641025641025641;0.435897435897436
Control.SRR15539824;41;40;0.414634146341463;24;17;0.0853658536585366;0.414634146341463
Control.SRR15539824;38;40;0.552631578947368;17;21;0.0526315789473685;0.447368421052632
Control.SRR15539824;34;40;0.352941176470588;22;12;0.147058823529412;0.352941176470588
Control.SRR15539824;36;40;0.416666666666667;21;15;0.0833333333333333;0.416666666666667
Control.SRR15539824;32;40;0.4375;18;14;0.0625;0.4375
Control.SRR15539824;41;40;0.439024390243902;23;18;0.0609756097560976;0.439024390243902
Control.SRR15539824;37;40;0.351351351351351;24;13;0.148648648648649;0.351351351351351
Control.SRR15539824;39;40;0.461538461538462;21;18;0.0384615384615384;0.461538461538462
Control.SRR15539824;38;40;0.342105263157895;25;13;0.157894736842105;0.342105263157895
Control.SRR15539824;41;40;0.463414634146341;22;19;0.0365853658536585;0.463414634146341
Control.SRR15539824;38;40;0.578947368421053;16;22;0.0789473684210527;0.421052631578947
Control.SRR15539824;34;40;0.411764705882353;20;14;0.0882352941176471;0.411764705882353
Control.SRR15539824;38;40;0.578947368421053;16;22;0.0789473684210527;0.421052631578947
Control.SRR15539824;39;40;0.487179487179487;20;19;0.0128205128205128;0.487179487179487
Control.SRR15539824;38;40;0.605263157894737;15;23;0.105263157894737;0.394736842105263
Control.SRR15539824;32;40;0.4375;18;14;0.0625;0.4375
Control.SRR15539824;38;40;0.526315789473684;18;20;0.0263157894736842;0.473684210526316
Control.SRR15539824;34;40;0.5;17;17;0;0.5
Control.SRR15539824;33;40;0.545454545454545;15;18;0.0454545454545454;0.454545454545455
Control.SRR15539824;42;40;0.476190476190476;22;20;0.0238095238095238;0.476190476190476
Control.SRR15539824;36;40;0.555555555555556;16;20;0.0555555555555556;0.444444444444444
Control.SRR15539824;40;40;0.65;14;26;0.15;0.35
Control.SRR15539824;40;40;0.425;23;17;0.075;0.425
Control.SRR15539824;37;40;0.594594594594595;15;22;0.0945945945945946;0.405405405405405
Control.SRR15539824;42;40;0.5;21;21;0;0.5
Control.SRR15539824;33;40;0.393939393939394;20;13;0.106060606060606;0.393939393939394
Control.SRR15539824;39;40;0.58974358974359;16;23;0.0897435897435898;0.41025641025641
Control.SRR15539824;36;40;0.583333333333333;15;21;0.0833333333333334;0.416666666666667
Control.SRR15539824;42;40;0.476190476190476;22;20;0.0238095238095238;0.476190476190476
Control.SRR15539824;38;40;0.421052631578947;22;16;0.0789473684210527;0.421052631578947
Control.SRR15539824;42;40;0.5;21;21;0;0.5
Control.SRR15539824;34;40;0.529411764705882;16;18;0.0294117647058824;0.470588235294118
Control.SRR15539824;36;40;0.611111111111111;14;22;0.111111111111111;0.388888888888889
Control.SRR15539824;40;40;0.575;17;23;0.075;0.425
Control.SRR15539824;39;40;0.564102564102564;17;22;0.0641025641025641;0.435897435897436
Control.SRR15539824;40;40;0.4;24;16;0.1;0.4
Control.SRR15539824;40;40;0.55;18;22;0.05;0.45
Control.SRR15539824;39;40;0.435897435897436;22;17;0.0641025641025641;0.435897435897436
Control.SRR15539824;41;40;0.439024390243902;23;18;0.0609756097560976;0.439024390243902
Control.SRR15539824;32;40;0.5625;14;18;0.0625;0.4375
Control.SRR15539824;41;40;0.560975609756098;18;23;0.0609756097560976;0.439024390243902
Control.SRR15539824;37;40;0.621621621621622;14;23;0.121621621621622;0.378378378378378
Control.SRR15539824;38;40;0.473684210526316;20;18;0.0263157894736842;0.473684210526316
Control.SRR15539824;38;40;0.368421052631579;24;14;0.131578947368421;0.368421052631579
Control.SRR15539824;41;40;0.51219512195122;20;21;0.0121951219512195;0.48780487804878
Control.SRR15539824;39;40;0.512820512820513;19;20;0.0128205128205128;0.487179487179487
Control.SRR15539824;41;40;0.390243902439024;25;16;0.109756097560976;0.390243902439024
Control.SRR15539824;36;40;0.5;18;18;0;0.5
Control.SRR15539824;36;40;0.666666666666667;12;24;0.166666666666667;0.333333333333333
Control.SRR15539824;42;40;0.476190476190476;22;20;0.0238095238095238;0.476190476190476
Control.SRR15539824;42;40;0.595238095238095;17;25;0.0952380952380952;0.404761904761905
Control.SRR15539824;38;40;0.447368421052632;21;17;0.0526315789473684;0.447368421052632
Control.SRR15539824;33;40;0.484848484848485;17;16;0.0151515151515151;0.484848484848485
Control.SRR15539824;35;40;0.428571428571429;20;15;0.0714285714285715;0.428571428571429
Control.SRR15539824;37;40;0.378378378378378;23;14;0.121621621621622;0.378378378378378
Control.SRR15539824;41;40;0.439024390243902;23;18;0.0609756097560976;0.439024390243902
Control.SRR15539824;38;40;0.552631578947368;17;21;0.0526315789473685;0.447368421052632
Control.SRR15539824;42;40;0.452380952380952;23;19;0.0476190476190476;0.452380952380952
Control.SRR15539824;35;40;0.542857142857143;16;19;0.0428571428571428;0.457142857142857
Control.SRR15539824;42;40;0.476190476190476;22;20;0.0238095238095238;0.476190476190476
Control.SRR15539824;39;40;0.487179487179487;20;19;0.0128205128205128;0.487179487179487
Control.SRR15539824;36;40;0.472222222222222;19;17;0.0277777777777778;0.472222222222222
Control.SRR15539824;36;40;0.527777777777778;17;19;0.0277777777777778;0.472222222222222
Control.SRR15539824;33;40;0.454545454545455;18;15;0.0454545454545455;0.454545454545455
Control.SRR15539824;39;40;0.435897435897436;22;17;0.0641025641025641;0.435897435897436
Control.SRR15539824;34;40;0.529411764705882;16;18;0.0294117647058824;0.470588235294118
Control.SRR15539824;40;40;0.45;22;18;0.05;0.45
Control.SRR15539824;42;40;0.428571428571429;24;18;0.0714285714285715;0.428571428571429
Control.SRR15539824;42;40;0.428571428571429;24;18;0.0714285714285715;0.428571428571429
Control.SRR15539824;37;40;0.513513513513513;18;19;0.0135135135135135;0.486486486486487
Control.SRR15539824;40;40;0.475;21;19;0.025;0.475
Control.SRR15539824;39;40;0.461538461538462;21;18;0.0384615384615384;0.461538461538462
Control.SRR15539824;41;40;0.609756097560976;16;25;0.109756097560976;0.390243902439024
Control.SRR15539824;40;40;0.55;18;22;0.05;0.45
Control.SRR15539824;40;40;0.55;18;22;0.05;0.45
Control.SRR15539824;39;40;0.615384615384615;15;24;0.115384615384615;0.384615384615385
Control.SRR15539824;37;40;0.594594594594595;15;22;0.0945945945945946;0.405405405405405
Control.SRR15539824;38;40;0.447368421052632;21;17;0.0526315789473684;0.447368421052632
Control.SRR15539824;40;40;0.675;13;27;0.175;0.325
Control.SRR15539824;38;40;0.447368421052632;21;17;0.0526315789473684;0.447368421052632
Control.SRR15539824;41;40;0.414634146341463;24;17;0.0853658536585366;0.414634146341463
Control.SRR15539824;41;40;0.365853658536585;26;15;0.134146341463415;0.365853658536585
Control.SRR15539824;40;40;0.625;15;25;0.125;0.375
Control.SRR15539824;38;40;0.421052631578947;22;16;0.0789473684210527;0.421052631578947
Control.SRR15539824;38;40;0.578947368421053;16;22;0.0789473684210527;0.421052631578947
Control.SRR15539824;35;40;0.457142857142857;19;16;0.0428571428571429;0.457142857142857
Control.SRR15539824;41;40;0.439024390243902;23;18;0.0609756097560976;0.439024390243902
Control.SRR15539824;35;40;0.371428571428571;22;13;0.128571428571429;0.371428571428571
Control.SRR15539824;37;40;0.648648648648649;13;24;0.148648648648649;0.351351351351351
Control.SRR15539824;37;40;0.594594594594595;15;22;0.0945945945945946;0.405405405405405
Control.SRR15539824;32;40;0.53125;15;17;0.03125;0.46875
Control.SRR15539824;42;40;0.5;21;21;0;0.5
Control.SRR15539824;42;40;0.547619047619048;19;23;0.0476190476190477;0.452380952380952
Control.SRR15539824;37;40;0.567567567567568;16;21;0.0675675675675675;0.432432432432432
Control.SRR15539824;41;40;0.292682926829268;29;12;0.207317073170732;0.292682926829268
Control.SRR15539824;40;40;0.45;22;18;0.05;0.45
Control.SRR15539824;35;40;0.6;14;21;0.1;0.4
Control.SRR15539824;33;40;0.454545454545455;18;15;0.0454545454545455;0.454545454545455
Control.SRR15539824;42;40;0.547619047619048;19;23;0.0476190476190477;0.452380952380952
Control.SRR15539824;35;40;0.485714285714286;18;17;0.0142857142857143;0.485714285714286
Control.SRR15539824;37;40;0.621621621621622;14;23;0.121621621621622;0.378378378378378
Control.SRR15539824;34;40;0.558823529411765;15;19;0.0588235294117647;0.441176470588235
Control.SRR15539824;35;40;0.485714285714286;18;17;0.0142857142857143;0.485714285714286
Control.SRR15539824;33;40;0.484848484848485;17;16;0.0151515151515151;0.484848484848485
Control.SRR15539824;42;40;0.547619047619048;19;23;0.0476190476190477;0.452380952380952
Control.SRR15539824;34;40;0.470588235294118;18;16;0.0294117647058824;0.470588235294118
Control.SRR15539824;36;40;0.527777777777778;17;19;0.0277777777777778;0.472222222222222
Control.SRR15539824;41;40;0.439024390243902;23;18;0.0609756097560976;0.439024390243902
Control.SRR15539824;40;40;0.575;17;23;0.075;0.425
Control.SRR15539824;34;40;0.411764705882353;20;14;0.0882352941176471;0.411764705882353
Control.SRR15539824;34;40;0.558823529411765;15;19;0.0588235294117647;0.441176470588235
Control.SRR15539824;40;40;0.525;19;21;0.025;0.475
Control.SRR15539824;39;40;0.384615384615385;24;15;0.115384615384615;0.384615384615385
Control.SRR15539824;34;40;0.411764705882353;20;14;0.0882352941176471;0.411764705882353
Control.SRR15539824;35;40;0.485714285714286;18;17;0.0142857142857143;0.485714285714286
Control.SRR15539824;42;40;0.428571428571429;24;18;0.0714285714285715;0.428571428571429
Control.SRR15539824;42;40;0.595238095238095;17;25;0.0952380952380952;0.404761904761905
Control.SRR15539824;32;40;0.5625;14;18;0.0625;0.4375
Control.SRR15539824;38;40;0.526315789473684;18;20;0.0263157894736842;0.473684210526316
Control.SRR15539824;34;40;0.529411764705882;16;18;0.0294117647058824;0.470588235294118
Control.SRR15539824;40;40;0.4;24;16;0.1;0.4
Control.SRR15539824;37;40;0.486486486486487;19;18;0.0135135135135135;0.486486486486487
Control.SRR15539824;36;40;0.388888888888889;22;14;0.111111111111111;0.388888888888889
Control.SRR15539824;41;40;0.439024390243902;23;18;0.0609756097560976;0.439024390243902
Control.SRR15539824;33;40;0.333333333333333;22;11;0.166666666666667;0.333333333333333
Control.SRR15539824;34;40;0.558823529411765;15;19;0.0588235294117647;0.441176470588235
Control.SRR15539824;36;40;0.416666666666667;21;15;0.0833333333333333;0.416666666666667
Control.SRR15539824;36;40;0.527777777777778;17;19;0.0277777777777778;0.472222222222222
Control.SRR15539824;41;40;0.51219512195122;20;21;0.0121951219512195;0.48780487804878
Control.SRR15539824;37;40;0.540540540540541;17;20;0.0405405405405406;0.459459459459459
Control.SRR15539824;42;40;0.452380952380952;23;19;0.0476190476190476;0.452380952380952
Control.SRR15539824;36;40;0.805555555555556;7;29;0.305555555555556;0.194444444444444
Control.SRR15539824;41;40;0.536585365853659;19;22;0.0365853658536586;0.463414634146341
Control.SRR15539824;39;40;0.487179487179487;20;19;0.0128205128205128;0.487179487179487
Control.SRR15539824;38;40;0.421052631578947;22;16;0.0789473684210527;0.421052631578947
Control.SRR15539824;38;40;0.605263157894737;15;23;0.105263157894737;0.394736842105263
Control.SRR15539824;38;40;0.552631578947368;17;21;0.0526315789473685;0.447368421052632
Control.SRR15539824;33;40;0.515151515151515;16;17;0.0151515151515151;0.484848484848485
Control.SRR15539824;34;40;0.558823529411765;15;19;0.0588235294117647;0.441176470588235
Control.SRR15539824;34;40;0.676470588235294;11;23;0.176470588235294;0.323529411764706
Control.SRR15539824;38;40;0.526315789473684;18;20;0.0263157894736842;0.473684210526316
Control.SRR15539824;38;40;0.447368421052632;21;17;0.0526315789473684;0.447368421052632
Control.SRR15539824;35;40;0.428571428571429;20;15;0.0714285714285715;0.428571428571429
Control.SRR15539824;38;40;0.421052631578947;22;16;0.0789473684210527;0.421052631578947
Control.SRR15539824;39;40;0.487179487179487;20;19;0.0128205128205128;0.487179487179487
Control.SRR15539824;40;40;0.6;16;24;0.1;0.4
Control.SRR15539824;37;40;0.513513513513513;18;19;0.0135135135135135;0.486486486486487
Control.SRR15539824;42;40;0.404761904761905;25;17;0.0952380952380952;0.404761904761905
Control.SRR15539824;36;40;0.388888888888889;22;14;0.111111111111111;0.388888888888889
Control.SRR15539824;34;40;0.5;17;17;0;0.5
Control.SRR15539824;34;40;0.588235294117647;14;20;0.0882352941176471;0.411764705882353
Control.SRR15539824;41;40;0.536585365853659;19;22;0.0365853658536586;0.463414634146341
Control.SRR15539824;41;40;0.414634146341463;24;17;0.0853658536585366;0.414634146341463
Control.SRR15539824;36;40;0.611111111111111;14;22;0.111111111111111;0.388888888888889
Control.SRR15539824;42;40;0.523809523809524;20;22;0.0238095238095238;0.476190476190476
Control.SRR15539824;36;40;0.611111111111111;14;22;0.111111111111111;0.388888888888889
Control.SRR15539824;36;40;0.527777777777778;17;19;0.0277777777777778;0.472222222222222
Control.SRR15539824;40;40;0.45;22;18;0.05;0.45
Control.SRR15539824;36;40;0.527777777777778;17;19;0.0277777777777778;0.472222222222222
Control.SRR15539824;38;40;0.526315789473684;18;20;0.0263157894736842;0.473684210526316
Control.SRR15539824;32;40;0.53125;15;17;0.03125;0.46875
Control.SRR15539824;37;40;0.486486486486487;19;18;0.0135135135135135;0.486486486486487
Control.SRR15539824;32;40;0.59375;13;19;0.09375;0.40625
Control.SRR15539824;34;40;0.411764705882353;20;14;0.0882352941176471;0.411764705882353
Control.SRR15539824;38;40;0.421052631578947;22;16;0.0789473684210527;0.421052631578947
Control.SRR15539824;35;40;0.485714285714286;18;17;0.0142857142857143;0.485714285714286
Control.SRR15539824;37;40;0.648648648648649;13;24;0.148648648648649;0.351351351351351
Control.SRR15539824;38;40;0.526315789473684;18;20;0.0263157894736842;0.473684210526316
Control.SRR15539824;36;40;0.361111111111111;23;13;0.138888888888889;0.361111111111111
Control.SRR15539824;41;40;0.292682926829268;29;12;0.207317073170732;0.292682926829268
Control.SRR15539824;32;40;0.5625;14;18;0.0625;0.4375
Control.SRR15539824;35;40;0.342857142857143;23;12;0.157142857142857;0.342857142857143
Control.SRR15539824;35;40;0.4;21;14;0.1;0.4
Control.SRR15539824;38;40;0.473684210526316;20;18;0.0263157894736842;0.473684210526316
Control.SRR15539824;41;40;0.48780487804878;21;20;0.0121951219512195;0.48780487804878
Control.SRR15539824;37;40;0.513513513513513;18;19;0.0135135135135135;0.486486486486487
Control.SRR15539824;33;40;0.363636363636364;21;12;0.136363636363636;0.363636363636364
Control.SRR15539824;32;40;0.59375;13;19;0.09375;0.40625
Control.SRR15539824;33;40;0.515151515151515;16;17;0.0151515151515151;0.484848484848485
Control.SRR15539824;35;40;0.428571428571429;20;15;0.0714285714285715;0.428571428571429
Control.SRR15539824;37;40;0.513513513513513;18;19;0.0135135135135135;0.486486486486487
Control.SRR15539824;34;40;0.411764705882353;20;14;0.0882352941176471;0.411764705882353
Control.SRR15539824;39;40;0.435897435897436;22;17;0.0641025641025641;0.435897435897436
Control.SRR15539824;35;40;0.571428571428571;15;20;0.0714285714285714;0.428571428571429
Control.SRR15539824;38;40;0.526315789473684;18;20;0.0263157894736842;0.473684210526316
Control.SRR15539824;37;40;0.567567567567568;16;21;0.0675675675675675;0.432432432432432
Control.SRR15539824;32;40;0.59375;13;19;0.09375;0.40625
Control.SRR15539824;40;40;0.5;20;20;0;0.5
Control.SRR15539824;34;40;0.441176470588235;19;15;0.0588235294117647;0.441176470588235
Control.SRR15539824;39;40;0.487179487179487;20;19;0.0128205128205128;0.487179487179487
Control.SRR15539824;36;40;0.638888888888889;13;23;0.138888888888889;0.361111111111111
Control.SRR15539824;35;40;0.342857142857143;23;12;0.157142857142857;0.342857142857143
Control.SRR15539824;37;40;0.459459459459459;20;17;0.0405405405405405;0.459459459459459
Control.SRR15539824;39;40;0.538461538461538;18;21;0.0384615384615384;0.461538461538462
Control.SRR15539824;36;40;0.611111111111111;14;22;0.111111111111111;0.388888888888889
Control.SRR15539824;32;40;0.5625;14;18;0.0625;0.4375
Control.SRR15539824;39;40;0.384615384615385;24;15;0.115384615384615;0.384615384615385
Control.SRR15539824;42;40;0.547619047619048;19;23;0.0476190476190477;0.452380952380952
Control.SRR15539824;42;40;0.523809523809524;20;22;0.0238095238095238;0.476190476190476
Control.SRR15539824;35;40;0.514285714285714;17;18;0.0142857142857142;0.485714285714286
Control.SRR15539824;42;40;0.571428571428571;18;24;0.0714285714285714;0.428571428571429
Control.SRR15539824;37;40;0.621621621621622;14;23;0.121621621621622;0.378378378378378
Control.SRR15539824;35;40;0.428571428571429;20;15;0.0714285714285715;0.428571428571429
Control.SRR15539824;37;40;0.567567567567568;16;21;0.0675675675675675;0.432432432432432
Control.SRR15539824;38;40;0.421052631578947;22;16;0.0789473684210527;0.421052631578947
Control.SRR15539824;39;40;0.384615384615385;24;15;0.115384615384615;0.384615384615385
Control.SRR15539824;35;40;0.628571428571429;13;22;0.128571428571429;0.371428571428571
Control.SRR15539824;35;40;0.428571428571429;20;15;0.0714285714285715;0.428571428571429
Control.SRR15539824;40;40;0.5;20;20;0;0.5
Control.SRR15539824;37;40;0.405405405405405;22;15;0.0945945945945946;0.405405405405405
Control.SRR15539824;42;40;0.404761904761905;25;17;0.0952380952380952;0.404761904761905
Control.SRR15539824;37;40;0.378378378378378;23;14;0.121621621621622;0.378378378378378
Control.SRR15539824;42;40;0.428571428571429;24;18;0.0714285714285715;0.428571428571429
Control.SRR15539824;41;40;0.414634146341463;24;17;0.0853658536585366;0.414634146341463
Control.SRR15539824;38;40;0.526315789473684;18;20;0.0263157894736842;0.473684210526316
Control.SRR15539824;42;40;0.595238095238095;17;25;0.0952380952380952;0.404761904761905
Control.SRR15539824;38;40;0.552631578947368;17;21;0.0526315789473685;0.447368421052632
Control.SRR15539824;40;40;0.45;22;18;0.05;0.45
Control.SRR15539824;39;40;0.435897435897436;22;17;0.0641025641025641;0.435897435897436
Control.SRR15539824;36;40;0.611111111111111;14;22;0.111111111111111;0.388888888888889
Control.SRR15539824;38;40;0.394736842105263;23;15;0.105263157894737;0.394736842105263
Control.SRR15539824;40;40;0.5;20;20;0;0.5
Control.SRR15539824;37;40;0.540540540540541;17;20;0.0405405405405406;0.459459459459459
Control.SRR15539824;41;40;0.463414634146341;22;19;0.0365853658536585;0.463414634146341
Control.SRR15539824;34;40;0.470588235294118;18;16;0.0294117647058824;0.470588235294118
Control.SRR15539824;37;40;0.432432432432432;21;16;0.0675675675675675;0.432432432432432
Control.SRR15539824;36;40;0.527777777777778;17;19;0.0277777777777778;0.472222222222222
Control.SRR15539824;38;40;0.368421052631579;24;14;0.131578947368421;0.368421052631579
Control.SRR15539824;41;40;0.51219512195122;20;21;0.0121951219512195;0.48780487804878
Control.SRR15539824;34;40;0.441176470588235;19;15;0.0588235294117647;0.441176470588235
Control.SRR15539824;34;40;0.617647058823529;13;21;0.117647058823529;0.382352941176471
Control.SRR15539824;43;40;0.511627906976744;21;22;0.0116279069767442;0.488372093023256
Control.SRR15539824;40;40;0.425;23;17;0.075;0.425
Control.SRR15539824;37;40;0.432432432432432;21;16;0.0675675675675675;0.432432432432432
Control.SRR15539824;36;40;0.388888888888889;22;14;0.111111111111111;0.388888888888889
Control.SRR15539824;36;40;0.472222222222222;19;17;0.0277777777777778;0.472222222222222
Control.SRR15539824;36;40;0.5;18;18;0;0.5
Control.SRR15539824;35;40;0.457142857142857;19;16;0.0428571428571429;0.457142857142857
Control.SRR15539824;35;40;0.542857142857143;16;19;0.0428571428571428;0.457142857142857
Control.SRR15539824;38;40;0.552631578947368;17;21;0.0526315789473685;0.447368421052632
Control.SRR15539824;41;40;0.560975609756098;18;23;0.0609756097560976;0.439024390243902
Control.SRR15539824;34;40;0.5;17;17;0;0.5
Control.SRR15539824;37;40;0.540540540540541;17;20;0.0405405405405406;0.459459459459459
Control.SRR15539824;39;40;0.564102564102564;17;22;0.0641025641025641;0.435897435897436
Control.SRR15539824;38;40;0.421052631578947;22;16;0.0789473684210527;0.421052631578947
Control.SRR15539824;40;40;0.5;20;20;0;0.5
Control.SRR15539824;36;40;0.388888888888889;22;14;0.111111111111111;0.388888888888889
Control.SRR15539824;43;40;0.534883720930233;20;23;0.0348837209302325;0.465116279069767
Control.SRR15539824;43;40;0.488372093023256;22;21;0.0116279069767442;0.488372093023256
Control.SRR15539824;38;40;0.315789473684211;26;12;0.184210526315789;0.315789473684211
Control.SRR15539824;44;40;0.454545454545455;24;20;0.0454545454545455;0.454545454545455
Control.SRR15539824;38;40;0.447368421052632;21;17;0.0526315789473684;0.447368421052632
Control.SRR15539824;40;40;0.675;13;27;0.175;0.325
Control.SRR15539824;40;40;0.525;19;21;0.025;0.475
Control.SRR15539824;38;40;0.605263157894737;15;23;0.105263157894737;0.394736842105263
Control.SRR15539824;38;40;0.473684210526316;20;18;0.0263157894736842;0.473684210526316
Control.SRR15539824;44;40;0.522727272727273;21;23;0.0227272727272727;0.477272727272727
Control.SRR15539824;36;40;0.555555555555556;16;20;0.0555555555555556;0.444444444444444
Control.SRR15539824;39;40;0.512820512820513;19;20;0.0128205128205128;0.487179487179487
Control.SRR15539824;39;40;0.512820512820513;19;20;0.0128205128205128;0.487179487179487
Control.SRR15539824;41;40;0.463414634146341;22;19;0.0365853658536585;0.463414634146341
Control.SRR15539824;39;40;0.512820512820513;19;20;0.0128205128205128;0.487179487179487
Control.SRR15539824;36;40;0.583333333333333;15;21;0.0833333333333334;0.416666666666667
Control.SRR15539824;38;40;0.342105263157895;25;13;0.157894736842105;0.342105263157895
Control.SRR15539824;41;40;0.48780487804878;21;20;0.0121951219512195;0.48780487804878
Control.SRR15539824;42;40;0.452380952380952;23;19;0.0476190476190476;0.452380952380952
Control.SRR15539824;42;40;0.333333333333333;28;14;0.166666666666667;0.333333333333333
Control.SRR15539824;42;40;0.380952380952381;26;16;0.119047619047619;0.380952380952381
Control.SRR15539824;41;40;0.51219512195122;20;21;0.0121951219512195;0.48780487804878
Control.SRR15539824;41;40;0.48780487804878;21;20;0.0121951219512195;0.48780487804878
Control.SRR15539824;39;40;0.564102564102564;17;22;0.0641025641025641;0.435897435897436
Control.SRR15539824;37;40;0.513513513513513;18;19;0.0135135135135135;0.486486486486487
Control.SRR15539824;37;40;0.378378378378378;23;14;0.121621621621622;0.378378378378378
Control.SRR15539824;35;40;0.571428571428571;15;20;0.0714285714285714;0.428571428571429
Control.SRR15539824;36;40;0.5;18;18;0;0.5
Control.SRR15539824;42;40;0.595238095238095;17;25;0.0952380952380952;0.404761904761905
Control.SRR15539824;40;40;0.5;20;20;0;0.5
Control.SRR15539824;38;40;0.526315789473684;18;20;0.0263157894736842;0.473684210526316
Control.SRR15539824;36;40;0.5;18;18;0;0.5
Control.SRR15539824;39;40;0.41025641025641;23;16;0.0897435897435898;0.41025641025641
Control.SRR15539824;34;40;0.294117647058824;24;10;0.205882352941176;0.294117647058824
Control.SRR15539824;42;40;0.595238095238095;17;25;0.0952380952380952;0.404761904761905
Control.SRR15539824;34;40;0.529411764705882;16;18;0.0294117647058824;0.470588235294118
Control.SRR15539824;40;40;0.55;18;22;0.05;0.45
Control.SRR15539824;35;40;0.428571428571429;20;15;0.0714285714285715;0.428571428571429
Control.SRR15539824;37;40;0.486486486486487;19;18;0.0135135135135135;0.486486486486487
Control.SRR15539824;34;40;0.588235294117647;14;20;0.0882352941176471;0.411764705882353
Control.SRR15539824;38;40;0.473684210526316;20;18;0.0263157894736842;0.473684210526316
Control.SRR15539824;42;40;0.523809523809524;20;22;0.0238095238095238;0.476190476190476
Control.SRR15539824;43;40;0.511627906976744;21;22;0.0116279069767442;0.488372093023256
Control.SRR15539824;38;40;0.552631578947368;17;21;0.0526315789473685;0.447368421052632
Control.SRR15539824;38;40;0.526315789473684;18;20;0.0263157894736842;0.473684210526316
Control.SRR15539824;37;40;0.459459459459459;20;17;0.0405405405405405;0.459459459459459
Control.SRR15539824;38;40;0.394736842105263;23;15;0.105263157894737;0.394736842105263
Control.SRR15539824;40;40;0.575;17;23;0.075;0.425
Control.SRR15539824;34;40;0.470588235294118;18;16;0.0294117647058824;0.470588235294118
Control.SRR15539824;43;40;0.418604651162791;25;18;0.0813953488372093;0.418604651162791
Control.SRR15539824;35;40;0.485714285714286;18;17;0.0142857142857143;0.485714285714286
Control.SRR15539824;37;40;0.594594594594595;15;22;0.0945945945945946;0.405405405405405
Control.SRR15539824;40;40;0.525;19;21;0.025;0.475
Control.SRR15539824;38;40;0.526315789473684;18;20;0.0263157894736842;0.473684210526316
Control.SRR15539824;36;40;0.638888888888889;13;23;0.138888888888889;0.361111111111111
Control.SRR15539824;35;40;0.628571428571429;13;22;0.128571428571429;0.371428571428571
Control.SRR15539824;37;40;0.567567567567568;16;21;0.0675675675675675;0.432432432432432
Control.SRR15539824;38;40;0.315789473684211;26;12;0.184210526315789;0.315789473684211
Control.SRR15539824;39;40;0.461538461538462;21;18;0.0384615384615384;0.461538461538462
Control.SRR15539824;37;40;0.486486486486487;19;18;0.0135135135135135;0.486486486486487
Control.SRR15539824;40;40;0.55;18;22;0.05;0.45
Control.SRR15539824;34;40;0.323529411764706;23;11;0.176470588235294;0.323529411764706
Control.SRR15539824;35;40;0.542857142857143;16;19;0.0428571428571428;0.457142857142857
Control.SRR15539824;34;40;0.441176470588235;19;15;0.0588235294117647;0.441176470588235
Control.SRR15539824;42;40;0.452380952380952;23;19;0.0476190476190476;0.452380952380952
Control.SRR15539824;40;40;0.45;22;18;0.05;0.45
Control.SRR15539824;42;40;0.452380952380952;23;19;0.0476190476190476;0.452380952380952
Control.SRR15539824;41;40;0.609756097560976;16;25;0.109756097560976;0.390243902439024
Control.SRR15539824;34;40;0.647058823529412;12;22;0.147058823529412;0.352941176470588
Control.SRR15539824;37;40;0.378378378378378;23;14;0.121621621621622;0.378378378378378
Control.SRR15539824;41;40;0.536585365853659;19;22;0.0365853658536586;0.463414634146341
Control.SRR15539824;41;40;0.609756097560976;16;25;0.109756097560976;0.390243902439024
Control.SRR15539824;39;40;0.538461538461538;18;21;0.0384615384615384;0.461538461538462
Control.SRR15539824;38;40;0.605263157894737;15;23;0.105263157894737;0.394736842105263
Control.SRR15539824;39;40;0.487179487179487;20;19;0.0128205128205128;0.487179487179487
Control.SRR15539824;44;40;0.477272727272727;23;21;0.0227272727272727;0.477272727272727
Control.SRR15539824;34;40;0.470588235294118;18;16;0.0294117647058824;0.470588235294118
Control.SRR15539824;35;40;0.457142857142857;19;16;0.0428571428571429;0.457142857142857
Control.SRR15539824;42;40;0.476190476190476;22;20;0.0238095238095238;0.476190476190476
Control.SRR15539824;34;40;0.294117647058824;24;10;0.205882352941176;0.294117647058824
Control.SRR15539824;44;40;0.5;22;22;0;0.5
Control.SRR15539824;43;40;0.372093023255814;27;16;0.127906976744186;0.372093023255814
Control.SRR15539824;41;40;0.414634146341463;24;17;0.0853658536585366;0.414634146341463
Control.SRR15539824;40;40;0.475;21;19;0.025;0.475
Control.SRR15539824;44;40;0.454545454545455;24;20;0.0454545454545455;0.454545454545455
Control.SRR15539824;37;40;0.459459459459459;20;17;0.0405405405405405;0.459459459459459
Control.SRR15539824;38;40;0.394736842105263;23;15;0.105263157894737;0.394736842105263
Control.SRR15539824;36;40;0.611111111111111;14;22;0.111111111111111;0.388888888888889
Control.SRR15539824;43;40;0.488372093023256;22;21;0.0116279069767442;0.488372093023256
Control.SRR15539824;40;40;0.425;23;17;0.075;0.425
Control.SRR15539824;40;40;0.525;19;21;0.025;0.475
Control.SRR15539824;36;40;0.444444444444444;20;16;0.0555555555555556;0.444444444444444
Control.SRR15539824;38;40;0.578947368421053;16;22;0.0789473684210527;0.421052631578947
Control.SRR15539824;38;40;0.289473684210526;27;11;0.210526315789474;0.289473684210526
Control.SRR15539824;36;40;0.416666666666667;21;15;0.0833333333333333;0.416666666666667
Control.SRR15539824;42;40;0.452380952380952;23;19;0.0476190476190476;0.452380952380952
Control.SRR15539824;35;40;0.4;21;14;0.1;0.4
Control.SRR15539824;42;40;0.404761904761905;25;17;0.0952380952380952;0.404761904761905
Control.SRR15539824;40;40;0.575;17;23;0.075;0.425
Control.SRR15539824;43;40;0.395348837209302;26;17;0.104651162790698;0.395348837209302
Control.SRR15539824;36;40;0.5;18;18;0;0.5
Control.SRR15539824;44;40;0.5;22;22;0;0.5
Control.SRR15539824;38;40;0.421052631578947;22;16;0.0789473684210527;0.421052631578947
Control.SRR15539824;44;40;0.477272727272727;23;21;0.0227272727272727;0.477272727272727
Control.SRR15539824;36;40;0.666666666666667;12;24;0.166666666666667;0.333333333333333
Control.SRR15539824;40;40;0.6;16;24;0.1;0.4
Control.SRR15539824;40;40;0.65;14;26;0.15;0.35
Control.SRR15539824;37;40;0.486486486486487;19;18;0.0135135135135135;0.486486486486487
Control.SRR15539824;40;40;0.45;22;18;0.05;0.45
Control.SRR15539824;34;40;0.382352941176471;21;13;0.117647058823529;0.382352941176471
Control.SRR15539824;39;40;0.487179487179487;20;19;0.0128205128205128;0.487179487179487
Control.SRR15539824;44;40;0.522727272727273;21;23;0.0227272727272727;0.477272727272727
Control.SRR15539824;35;40;0.628571428571429;13;22;0.128571428571429;0.371428571428571
Control.SRR15539824;35;40;0.4;21;14;0.1;0.4
Control.SRR15539824;40;40;0.525;19;21;0.025;0.475
Control.SRR15539824;38;40;0.605263157894737;15;23;0.105263157894737;0.394736842105263
Control.SRR15539824;38;40;0.526315789473684;18;20;0.0263157894736842;0.473684210526316
Control.SRR15539824;44;40;0.477272727272727;23;21;0.0227272727272727;0.477272727272727
Control.SRR15539824;38;40;0.552631578947368;17;21;0.0526315789473685;0.447368421052632
Control.SRR15539824;35;40;0.371428571428571;22;13;0.128571428571429;0.371428571428571
Control.SRR15539824;38;40;0.473684210526316;20;18;0.0263157894736842;0.473684210526316
Control.SRR15539824;36;40;0.472222222222222;19;17;0.0277777777777778;0.472222222222222
Control.SRR15539824;40;40;0.525;19;21;0.025;0.475
Control.SRR15539824;44;40;0.568181818181818;19;25;0.0681818181818182;0.431818181818182
Control.SRR15539824;42;40;0.547619047619048;19;23;0.0476190476190477;0.452380952380952
Control.SRR15539824;37;40;0.459459459459459;20;17;0.0405405405405405;0.459459459459459
Control.SRR15539824;41;40;0.536585365853659;19;22;0.0365853658536586;0.463414634146341
Control.SRR15539824;39;40;0.461538461538462;21;18;0.0384615384615384;0.461538461538462
Control.SRR15539824;39;40;0.384615384615385;24;15;0.115384615384615;0.384615384615385
Control.SRR15539824;36;40;0.5;18;18;0;0.5
Control.SRR15539824;42;40;0.595238095238095;17;25;0.0952380952380952;0.404761904761905
Control.SRR15539824;34;40;0.441176470588235;19;15;0.0588235294117647;0.441176470588235
Control.SRR15539824;35;40;0.542857142857143;16;19;0.0428571428571428;0.457142857142857
Control.SRR15539824;36;40;0.5;18;18;0;0.5
Control.SRR15539824;40;40;0.575;17;23;0.075;0.425
Control.SRR15539824;44;40;0.522727272727273;21;23;0.0227272727272727;0.477272727272727
Control.SRR15539824;40;40;0.625;15;25;0.125;0.375
Control.SRR15539824;36;40;0.555555555555556;16;20;0.0555555555555556;0.444444444444444
Control.SRR15539824;41;40;0.48780487804878;21;20;0.0121951219512195;0.48780487804878
Control.SRR15539824;34;40;0.470588235294118;18;16;0.0294117647058824;0.470588235294118
Control.SRR15539824;34;40;0.470588235294118;18;16;0.0294117647058824;0.470588235294118
Control.SRR15539824;42;40;0.523809523809524;20;22;0.0238095238095238;0.476190476190476
Control.SRR15539824;44;40;0.477272727272727;23;21;0.0227272727272727;0.477272727272727
Control.SRR15539824;36;40;0.5;18;18;0;0.5
Control.SRR15539824;39;40;0.58974358974359;16;23;0.0897435897435898;0.41025641025641
Control.SRR15539824;41;40;0.560975609756098;18;23;0.0609756097560976;0.439024390243902
Control.SRR15539824;43;40;0.534883720930233;20;23;0.0348837209302325;0.465116279069767
Control.SRR15539824;43;40;0.558139534883721;19;24;0.0581395348837209;0.441860465116279
Control.SRR15539824;35;40;0.485714285714286;18;17;0.0142857142857143;0.485714285714286
Control.SRR15539824;36;40;0.555555555555556;16;20;0.0555555555555556;0.444444444444444
Control.SRR15539824;39;40;0.461538461538462;21;18;0.0384615384615384;0.461538461538462
Control.SRR15539824;38;40;0.552631578947368;17;21;0.0526315789473685;0.447368421052632
Control.SRR15539824;42;40;0.666666666666667;14;28;0.166666666666667;0.333333333333333
Control.SRR15539824;36;40;0.472222222222222;19;17;0.0277777777777778;0.472222222222222
Control.SRR15539824;36;40;0.527777777777778;17;19;0.0277777777777778;0.472222222222222
Control.SRR15539824;40;40;0.45;22;18;0.05;0.45
Control.SRR15539824;36;40;0.5;18;18;0;0.5
Control.SRR15539824;36;40;0.472222222222222;19;17;0.0277777777777778;0.472222222222222
Control.SRR15539824;42;40;0.5;21;21;0;0.5
Control.SRR15539824;42;40;0.357142857142857;27;15;0.142857142857143;0.357142857142857
Control.SRR15539824;40;40;0.525;19;21;0.025;0.475
Control.SRR15539824;39;40;0.615384615384615;15;24;0.115384615384615;0.384615384615385
Control.SRR15539824;38;40;0.526315789473684;18;20;0.0263157894736842;0.473684210526316
Control.SRR15539824;43;40;0.465116279069767;23;20;0.0348837209302326;0.465116279069767
Control.SRR15539824;39;40;0.58974358974359;16;23;0.0897435897435898;0.41025641025641
Control.SRR15539824;44;40;0.431818181818182;25;19;0.0681818181818182;0.431818181818182
Control.SRR15539824;42;40;0.5;21;21;0;0.5
Control.SRR15539824;41;40;0.463414634146341;22;19;0.0365853658536585;0.463414634146341
Control.SRR15539824;35;40;0.571428571428571;15;20;0.0714285714285714;0.428571428571429
Control.SRR15539824;37;40;0.540540540540541;17;20;0.0405405405405406;0.459459459459459
Control.SRR15539824;34;40;0.382352941176471;21;13;0.117647058823529;0.382352941176471
Control.SRR15539824;39;40;0.461538461538462;21;18;0.0384615384615384;0.461538461538462
Control.SRR15539824;41;40;0.48780487804878;21;20;0.0121951219512195;0.48780487804878
Control.SRR15539824;44;40;0.431818181818182;25;19;0.0681818181818182;0.431818181818182
Control.SRR15539824;37;40;0.486486486486487;19;18;0.0135135135135135;0.486486486486487
Control.SRR15539824;34;40;0.441176470588235;19;15;0.0588235294117647;0.441176470588235
Control.SRR15539824;36;40;0.555555555555556;16;20;0.0555555555555556;0.444444444444444
Control.SRR15539824;34;40;0.470588235294118;18;16;0.0294117647058824;0.470588235294118
Control.SRR15539824;42;40;0.571428571428571;18;24;0.0714285714285714;0.428571428571429
Control.SRR15539824;42;40;0.595238095238095;17;25;0.0952380952380952;0.404761904761905
Control.SRR15539824;35;40;0.571428571428571;15;20;0.0714285714285714;0.428571428571429
Control.SRR15539824;36;40;0.416666666666667;21;15;0.0833333333333333;0.416666666666667
Control.SRR15539824;39;40;0.461538461538462;21;18;0.0384615384615384;0.461538461538462
Control.SRR15539824;37;40;0.324324324324324;25;12;0.175675675675676;0.324324324324324
Control.SRR15539824;44;40;0.431818181818182;25;19;0.0681818181818182;0.431818181818182
Control.SRR15539824;40;40;0.45;22;18;0.05;0.45
Control.SRR15539824;34;40;0.617647058823529;13;21;0.117647058823529;0.382352941176471
Control.SRR15539824;35;40;0.4;21;14;0.1;0.4
Control.SRR15539824;38;40;0.5;19;19;0;0.5
Control.SRR15539824;34;40;0.647058823529412;12;22;0.147058823529412;0.352941176470588
Control.SRR15539824;36;40;0.388888888888889;22;14;0.111111111111111;0.388888888888889
Control.SRR15539824;42;40;0.571428571428571;18;24;0.0714285714285714;0.428571428571429
Control.SRR15539824;40;40;0.525;19;21;0.025;0.475
Control.SRR15539824;43;40;0.511627906976744;21;22;0.0116279069767442;0.488372093023256
Control.SRR15539824;41;40;0.51219512195122;20;21;0.0121951219512195;0.48780487804878
Control.SRR15539824;42;40;0.452380952380952;23;19;0.0476190476190476;0.452380952380952
Control.SRR15539824;38;40;0.526315789473684;18;20;0.0263157894736842;0.473684210526316
Control.SRR15539824;35;40;0.4;21;14;0.1;0.4
Control.SRR15539824;41;40;0.609756097560976;16;25;0.109756097560976;0.390243902439024
Control.SRR15539824;41;40;0.585365853658537;17;24;0.0853658536585366;0.414634146341463
Control.SRR15539824;43;40;0.395348837209302;26;17;0.104651162790698;0.395348837209302
Control.SRR15539824;40;40;0.525;19;21;0.025;0.475
Control.SRR15539824;40;40;0.375;25;15;0.125;0.375
Control.SRR15539824;40;40;0.5;20;20;0;0.5
Control.SRR15539824;34;40;0.558823529411765;15;19;0.0588235294117647;0.441176470588235
Control.SRR15539824;41;40;0.48780487804878;21;20;0.0121951219512195;0.48780487804878
Control.SRR15539824;41;40;0.463414634146341;22;19;0.0365853658536585;0.463414634146341
Control.SRR15539824;38;40;0.552631578947368;17;21;0.0526315789473685;0.447368421052632
Control.SRR15539824;35;40;0.4;21;14;0.1;0.4
Control.SRR15539824;35;40;0.571428571428571;15;20;0.0714285714285714;0.428571428571429
Control.SRR15539824;39;40;0.641025641025641;14;25;0.141025641025641;0.358974358974359
Control.SRR15539824;41;40;0.707317073170732;12;29;0.207317073170732;0.292682926829268
Control.SRR15539824;44;40;0.613636363636364;17;27;0.113636363636364;0.386363636363636
Control.SRR15539824;35;40;0.657142857142857;12;23;0.157142857142857;0.342857142857143
Control.SRR15539824;40;40;0.575;17;23;0.075;0.425
Control.SRR15539824;36;40;0.444444444444444;20;16;0.0555555555555556;0.444444444444444
Control.SRR15539824;35;40;0.6;14;21;0.1;0.4
Control.SRR15539824;44;40;0.431818181818182;25;19;0.0681818181818182;0.431818181818182
Control.SRR15539824;38;40;0.5;19;19;0;0.5
Control.SRR15539824;41;40;0.51219512195122;20;21;0.0121951219512195;0.48780487804878
Control.SRR15539824;44;40;0.409090909090909;26;18;0.0909090909090909;0.409090909090909
Control.SRR15539824;39;40;0.564102564102564;17;22;0.0641025641025641;0.435897435897436
Control.SRR15539824;37;40;0.513513513513513;18;19;0.0135135135135135;0.486486486486487
Control.SRR15539824;38;40;0.447368421052632;21;17;0.0526315789473684;0.447368421052632
Control.SRR15539824;42;40;0.523809523809524;20;22;0.0238095238095238;0.476190476190476
Control.SRR15539824;37;40;0.459459459459459;20;17;0.0405405405405405;0.459459459459459
Control.SRR15539824;34;40;0.352941176470588;22;12;0.147058823529412;0.352941176470588
Control.SRR15539824;40;40;0.425;23;17;0.075;0.425
Control.SRR15539824;34;40;0.411764705882353;20;14;0.0882352941176471;0.411764705882353
Control.SRR15539824;37;40;0.540540540540541;17;20;0.0405405405405406;0.459459459459459
Control.SRR15539824;38;40;0.5;19;19;0;0.5
Control.SRR15539824;42;40;0.523809523809524;20;22;0.0238095238095238;0.476190476190476
Control.SRR15539824;35;40;0.371428571428571;22;13;0.128571428571429;0.371428571428571
Control.SRR15539824;38;40;0.5;19;19;0;0.5
Control.SRR15539824;43;40;0.651162790697674;15;28;0.151162790697674;0.348837209302326
Control.SRR15539824;40;40;0.55;18;22;0.05;0.45
Control.SRR15539824;43;40;0.395348837209302;26;17;0.104651162790698;0.395348837209302
Control.SRR15539824;36;40;0.527777777777778;17;19;0.0277777777777778;0.472222222222222
Control.SRR15539824;42;40;0.452380952380952;23;19;0.0476190476190476;0.452380952380952
Control.SRR15539824;35;40;0.485714285714286;18;17;0.0142857142857143;0.485714285714286
Control.SRR15539824;42;40;0.476190476190476;22;20;0.0238095238095238;0.476190476190476
Control.SRR15539824;36;40;0.416666666666667;21;15;0.0833333333333333;0.416666666666667
Control.SRR15539824;37;40;0.513513513513513;18;19;0.0135135135135135;0.486486486486487
Control.SRR15539824;37;40;0.567567567567568;16;21;0.0675675675675675;0.432432432432432
Control.SRR15539824;34;40;0.588235294117647;14;20;0.0882352941176471;0.411764705882353
Control.SRR15539824;39;40;0.512820512820513;19;20;0.0128205128205128;0.487179487179487
Control.SRR15539824;39;40;0.435897435897436;22;17;0.0641025641025641;0.435897435897436
Control.SRR15539824;36;40;0.444444444444444;20;16;0.0555555555555556;0.444444444444444
Control.SRR15539824;37;40;0.513513513513513;18;19;0.0135135135135135;0.486486486486487
Control.SRR15539824;36;40;0.555555555555556;16;20;0.0555555555555556;0.444444444444444
Control.SRR15539824;43;40;0.627906976744186;16;27;0.127906976744186;0.372093023255814
Control.SRR15539824;36;40;0.5;18;18;0;0.5
Control.SRR15539824;36;40;0.5;18;18;0;0.5
Control.SRR15539824;35;40;0.542857142857143;16;19;0.0428571428571428;0.457142857142857
Control.SRR15539824;34;40;0.676470588235294;11;23;0.176470588235294;0.323529411764706
Control.SRR15539824;36;40;0.388888888888889;22;14;0.111111111111111;0.388888888888889
Control.SRR15539824;34;40;0.5;17;17;0;0.5
Control.SRR15539824;39;40;0.487179487179487;20;19;0.0128205128205128;0.487179487179487
Control.SRR15539824;39;40;0.384615384615385;24;15;0.115384615384615;0.384615384615385
Control.SRR15539824;44;40;0.477272727272727;23;21;0.0227272727272727;0.477272727272727
Control.SRR15539824;43;40;0.604651162790698;17;26;0.104651162790698;0.395348837209302
Control.SRR15539824;37;40;0.513513513513513;18;19;0.0135135135135135;0.486486486486487
Control.SRR15539824;40;40;0.475;21;19;0.025;0.475
Control.SRR15539824;40;40;0.4;24;16;0.1;0.4
Control.SRR15539824;40;40;0.525;19;21;0.025;0.475
Control.SRR15539824;41;40;0.414634146341463;24;17;0.0853658536585366;0.414634146341463
Control.SRR15539824;39;40;0.615384615384615;15;24;0.115384615384615;0.384615384615385
Control.SRR15539824;42;40;0.333333333333333;28;14;0.166666666666667;0.333333333333333
Control.SRR15539824;35;40;0.314285714285714;24;11;0.185714285714286;0.314285714285714
Control.SRR15539824;34;40;0.441176470588235;19;15;0.0588235294117647;0.441176470588235
Control.SRR15539824;42;40;0.547619047619048;19;23;0.0476190476190477;0.452380952380952
Control.SRR15539824;41;40;0.414634146341463;24;17;0.0853658536585366;0.414634146341463
Control.SRR15539824;38;40;0.394736842105263;23;15;0.105263157894737;0.394736842105263
Control.SRR15539824;37;40;0.459459459459459;20;17;0.0405405405405405;0.459459459459459
Control.SRR15539824;39;40;0.538461538461538;18;21;0.0384615384615384;0.461538461538462
Control.SRR15539824;44;40;0.568181818181818;19;25;0.0681818181818182;0.431818181818182
Control.SRR15539824;43;40;0.558139534883721;19;24;0.0581395348837209;0.441860465116279
Control.SRR15539824;40;40;0.5;20;20;0;0.5
Control.SRR15539824;34;40;0.470588235294118;18;16;0.0294117647058824;0.470588235294118
Control.SRR15539824;43;40;0.511627906976744;21;22;0.0116279069767442;0.488372093023256
Control.SRR15539824;37;40;0.486486486486487;19;18;0.0135135135135135;0.486486486486487
Control.SRR15539824;37;40;0.486486486486487;19;18;0.0135135135135135;0.486486486486487
Control.SRR15539824;39;40;0.564102564102564;17;22;0.0641025641025641;0.435897435897436
Control.SRR15539824;44;40;0.454545454545455;24;20;0.0454545454545455;0.454545454545455
Control.SRR15539824;40;40;0.5;20;20;0;0.5
Control.SRR15539824;44;40;0.522727272727273;21;23;0.0227272727272727;0.477272727272727
Control.SRR15539824;40;40;0.5;20;20;0;0.5
Control.SRR15539824;34;40;0.5;17;17;0;0.5
Control.SRR15539824;37;40;0.567567567567568;16;21;0.0675675675675675;0.432432432432432
Control.SRR15539824;35;40;0.485714285714286;18;17;0.0142857142857143;0.485714285714286
Control.SRR15539824;39;40;0.333333333333333;26;13;0.166666666666667;0.333333333333333
Control.SRR15539824;38;40;0.473684210526316;20;18;0.0263157894736842;0.473684210526316
Control.SRR15539824;39;40;0.358974358974359;25;14;0.141025641025641;0.358974358974359
Control.SRR15539824;41;40;0.609756097560976;16;25;0.109756097560976;0.390243902439024
Control.SRR15539824;40;40;0.5;20;20;0;0.5
Control.SRR15539824;44;40;0.522727272727273;21;23;0.0227272727272727;0.477272727272727
Control.SRR15539824;43;40;0.627906976744186;16;27;0.127906976744186;0.372093023255814
Control.SRR15539824;44;40;0.522727272727273;21;23;0.0227272727272727;0.477272727272727
Control.SRR15539824;37;40;0.513513513513513;18;19;0.0135135135135135;0.486486486486487
Control.SRR15539824;43;40;0.558139534883721;19;24;0.0581395348837209;0.441860465116279
Control.SRR15539824;38;40;0.473684210526316;20;18;0.0263157894736842;0.473684210526316
Control.SRR15539824;38;40;0.473684210526316;20;18;0.0263157894736842;0.473684210526316
Control.SRR15539824;44;40;0.545454545454545;20;24;0.0454545454545454;0.454545454545455
Control.SRR15539824;43;40;0.488372093023256;22;21;0.0116279069767442;0.488372093023256
Control.SRR15539824;43;40;0.418604651162791;25;18;0.0813953488372093;0.418604651162791
Control.SRR15539824;42;40;0.30952380952381;29;13;0.19047619047619;0.30952380952381
Control.SRR15539824;39;40;0.461538461538462;21;18;0.0384615384615384;0.461538461538462
Control.SRR15539824;34;40;0.470588235294118;18;16;0.0294117647058824;0.470588235294118
Control.SRR15539824;42;40;0.571428571428571;18;24;0.0714285714285714;0.428571428571429
Control.SRR15539824;38;40;0.578947368421053;16;22;0.0789473684210527;0.421052631578947
Control.SRR15539824;35;40;0.342857142857143;23;12;0.157142857142857;0.342857142857143
Control.SRR15539824;35;40;0.485714285714286;18;17;0.0142857142857143;0.485714285714286
Control.SRR15539824;41;40;0.48780487804878;21;20;0.0121951219512195;0.48780487804878
Control.SRR15539824;38;40;0.526315789473684;18;20;0.0263157894736842;0.473684210526316
Control.SRR15539824;37;40;0.567567567567568;16;21;0.0675675675675675;0.432432432432432
Control.SRR15539824;43;40;0.441860465116279;24;19;0.0581395348837209;0.441860465116279
Control.SRR15539824;43;40;0.465116279069767;23;20;0.0348837209302326;0.465116279069767
Control.SRR15539824;44;40;0.386363636363636;27;17;0.113636363636364;0.386363636363636
Control.SRR15539824;43;40;0.418604651162791;25;18;0.0813953488372093;0.418604651162791
Control.SRR15539824;35;40;0.542857142857143;16;19;0.0428571428571428;0.457142857142857
Control.SRR15539824;43;40;0.511627906976744;21;22;0.0116279069767442;0.488372093023256
Control.SRR15539824;34;40;0.441176470588235;19;15;0.0588235294117647;0.441176470588235
Control.SRR15539824;38;40;0.552631578947368;17;21;0.0526315789473685;0.447368421052632
Control.SRR15539824;34;40;0.441176470588235;19;15;0.0588235294117647;0.441176470588235
Control.SRR15539824;39;40;0.461538461538462;21;18;0.0384615384615384;0.461538461538462
Control.SRR15539824;43;40;0.581395348837209;18;25;0.0813953488372093;0.418604651162791
Control.SRR15539824;38;40;0.5;19;19;0;0.5
Control.SRR15539824;41;40;0.439024390243902;23;18;0.0609756097560976;0.439024390243902
Control.SRR15539824;43;40;0.465116279069767;23;20;0.0348837209302326;0.465116279069767
Control.SRR15539824;43;40;0.488372093023256;22;21;0.0116279069767442;0.488372093023256
Control.SRR15539824;44;40;0.613636363636364;17;27;0.113636363636364;0.386363636363636
Control.SRR15539824;44;40;0.386363636363636;27;17;0.113636363636364;0.386363636363636
Control.SRR15539824;44;40;0.5;22;22;0;0.5
Control.SRR15539824;43;40;0.534883720930233;20;23;0.0348837209302325;0.465116279069767
Control.SRR15539824;35;40;0.4;21;14;0.1;0.4
Control.SRR15539824;38;40;0.552631578947368;17;21;0.0526315789473685;0.447368421052632
Control.SRR15539824;35;40;0.457142857142857;19;16;0.0428571428571429;0.457142857142857
Control.SRR15539824;43;40;0.441860465116279;24;19;0.0581395348837209;0.441860465116279
Control.SRR15539824;42;40;0.571428571428571;18;24;0.0714285714285714;0.428571428571429
Control.SRR15539824;41;40;0.560975609756098;18;23;0.0609756097560976;0.439024390243902
Control.SRR15539824;38;40;0.447368421052632;21;17;0.0526315789473684;0.447368421052632
Control.SRR15539824;38;40;0.552631578947368;17;21;0.0526315789473685;0.447368421052632
Control.SRR15539824;38;40;0.394736842105263;23;15;0.105263157894737;0.394736842105263
Control.SRR15539824;41;40;0.48780487804878;21;20;0.0121951219512195;0.48780487804878
Control.SRR15539824;37;40;0.486486486486487;19;18;0.0135135135135135;0.486486486486487
Control.SRR15539824;37;40;0.378378378378378;23;14;0.121621621621622;0.378378378378378
Control.SRR15539824;34;40;0.352941176470588;22;12;0.147058823529412;0.352941176470588
Control.SRR15539824;43;40;0.441860465116279;24;19;0.0581395348837209;0.441860465116279
Control.SRR15539824;41;40;0.51219512195122;20;21;0.0121951219512195;0.48780487804878
Control.SRR15539824;37;40;0.513513513513513;18;19;0.0135135135135135;0.486486486486487
Control.SRR15539824;35;40;0.542857142857143;16;19;0.0428571428571428;0.457142857142857
Control.SRR15539824;37;40;0.513513513513513;18;19;0.0135135135135135;0.486486486486487
Control.SRR15539824;43;40;0.511627906976744;21;22;0.0116279069767442;0.488372093023256
Control.SRR15539824;41;40;0.463414634146341;22;19;0.0365853658536585;0.463414634146341
Control.SRR15539824;42;40;0.595238095238095;17;25;0.0952380952380952;0.404761904761905
Control.SRR15539824;43;40;0.325581395348837;29;14;0.174418604651163;0.325581395348837
Control.SRR15539824;34;40;0.529411764705882;16;18;0.0294117647058824;0.470588235294118
Control.SRR15539824;34;40;0.382352941176471;21;13;0.117647058823529;0.382352941176471
Control.SRR15539824;42;40;0.547619047619048;19;23;0.0476190476190477;0.452380952380952
Control.SRR15539824;37;40;0.432432432432432;21;16;0.0675675675675675;0.432432432432432
Control.SRR15539824;44;40;0.659090909090909;15;29;0.159090909090909;0.340909090909091
Control.SRR15539824;38;40;0.578947368421053;16;22;0.0789473684210527;0.421052631578947
Control.SRR15539824;43;40;0.511627906976744;21;22;0.0116279069767442;0.488372093023256
Control.SRR15539824;40;40;0.525;19;21;0.025;0.475
Control.SRR15539824;35;40;0.571428571428571;15;20;0.0714285714285714;0.428571428571429
Control.SRR15539824;43;40;0.558139534883721;19;24;0.0581395348837209;0.441860465116279
Control.SRR15539824;37;40;0.594594594594595;15;22;0.0945945945945946;0.405405405405405
Control.SRR15539824;40;40;0.45;22;18;0.05;0.45
Control.SRR15539824;39;40;0.538461538461538;18;21;0.0384615384615384;0.461538461538462
Control.SRR15539824;42;40;0.642857142857143;15;27;0.142857142857143;0.357142857142857
Control.SRR15539824;35;40;0.628571428571429;13;22;0.128571428571429;0.371428571428571
Control.SRR15539824;40;40;0.525;19;21;0.025;0.475
Control.SRR15539824;39;40;0.538461538461538;18;21;0.0384615384615384;0.461538461538462
Control.SRR15539824;37;40;0.594594594594595;15;22;0.0945945945945946;0.405405405405405
Control.SRR15539824;42;40;0.5;21;21;0;0.5
Control.SRR15539824;43;40;0.395348837209302;26;17;0.104651162790698;0.395348837209302
Control.SRR15539824;44;40;0.454545454545455;24;20;0.0454545454545455;0.454545454545455
Control.SRR15539824;42;40;0.5;21;21;0;0.5
Control.SRR15539824;40;40;0.475;21;19;0.025;0.475
Control.SRR15539824;42;40;0.476190476190476;22;20;0.0238095238095238;0.476190476190476
Control.SRR15539824;43;40;0.372093023255814;27;16;0.127906976744186;0.372093023255814
Control.SRR15539824;40;40;0.55;18;22;0.05;0.45
Control.SRR15539824;42;40;0.5;21;21;0;0.5
Control.SRR15539824;41;40;0.463414634146341;22;19;0.0365853658536585;0.463414634146341
Control.SRR15539824;38;40;0.526315789473684;18;20;0.0263157894736842;0.473684210526316
Control.SRR15539824;36;40;0.527777777777778;17;19;0.0277777777777778;0.472222222222222
Control.SRR15539824;38;40;0.342105263157895;25;13;0.157894736842105;0.342105263157895
Control.SRR15539824;41;40;0.48780487804878;21;20;0.0121951219512195;0.48780487804878
Control.SRR15539824;36;40;0.555555555555556;16;20;0.0555555555555556;0.444444444444444
Control.SRR15539824;34;40;0.470588235294118;18;16;0.0294117647058824;0.470588235294118
Control.SRR15539824;39;40;0.384615384615385;24;15;0.115384615384615;0.384615384615385
Control.SRR15539824;41;40;0.414634146341463;24;17;0.0853658536585366;0.414634146341463
Control.SRR15539824;40;40;0.425;23;17;0.075;0.425
Control.SRR15539824;36;40;0.333333333333333;24;12;0.166666666666667;0.333333333333333
Control.SRR15539824;38;40;0.447368421052632;21;17;0.0526315789473684;0.447368421052632
Control.SRR15539824;35;40;0.4;21;14;0.1;0.4
Control.SRR15539824;43;40;0.511627906976744;21;22;0.0116279069767442;0.488372093023256
Control.SRR15539824;36;40;0.555555555555556;16;20;0.0555555555555556;0.444444444444444
Control.SRR15539824;37;40;0.513513513513513;18;19;0.0135135135135135;0.486486486486487
Control.SRR15539824;37;40;0.513513513513513;18;19;0.0135135135135135;0.486486486486487
Control.SRR15539824;36;40;0.361111111111111;23;13;0.138888888888889;0.361111111111111
Control.SRR15539824;43;40;0.534883720930233;20;23;0.0348837209302325;0.465116279069767
Control.SRR15539824;43;40;0.558139534883721;19;24;0.0581395348837209;0.441860465116279
Control.SRR15539824;43;40;0.558139534883721;19;24;0.0581395348837209;0.441860465116279
Control.SRR15539824;40;40;0.5;20;20;0;0.5
Control.SRR15539824;34;40;0.5;17;17;0;0.5
Control.SRR15539824;36;40;0.555555555555556;16;20;0.0555555555555556;0.444444444444444
Control.SRR15539824;44;40;0.545454545454545;20;24;0.0454545454545454;0.454545454545455
Control.SRR15539824;42;40;0.5;21;21;0;0.5
Control.SRR15539824;39;40;0.435897435897436;22;17;0.0641025641025641;0.435897435897436
Control.SRR15539824;36;40;0.583333333333333;15;21;0.0833333333333334;0.416666666666667
Control.SRR15539824;38;40;0.552631578947368;17;21;0.0526315789473685;0.447368421052632
Control.SRR15539824;42;40;0.595238095238095;17;25;0.0952380952380952;0.404761904761905
Control.SRR15539824;36;40;0.388888888888889;22;14;0.111111111111111;0.388888888888889
Control.SRR15539824;44;40;0.363636363636364;28;16;0.136363636363636;0.363636363636364
Control.SRR15539824;34;40;0.735294117647059;9;25;0.235294117647059;0.264705882352941
Control.SRR15539824;39;40;0.41025641025641;23;16;0.0897435897435898;0.41025641025641
Control.SRR15539824;38;40;0.394736842105263;23;15;0.105263157894737;0.394736842105263
Control.SRR15539824;44;40;0.477272727272727;23;21;0.0227272727272727;0.477272727272727
Control.SRR15539824;44;40;0.568181818181818;19;25;0.0681818181818182;0.431818181818182
Control.SRR15539824;40;40;0.425;23;17;0.075;0.425
Control.SRR15539824;37;40;0.378378378378378;23;14;0.121621621621622;0.378378378378378
Control.SRR15539824;37;40;0.540540540540541;17;20;0.0405405405405406;0.459459459459459
Control.SRR15539824;36;40;0.583333333333333;15;21;0.0833333333333334;0.416666666666667
Control.SRR15539824;40;40;0.575;17;23;0.075;0.425
Control.SRR15539824;38;40;0.631578947368421;14;24;0.131578947368421;0.368421052631579
Control.SRR15539824;35;40;0.428571428571429;20;15;0.0714285714285715;0.428571428571429
Control.SRR15539824;35;40;0.457142857142857;19;16;0.0428571428571429;0.457142857142857
Control.SRR15539824;34;40;0.5;17;17;0;0.5
Control.SRR15539824;43;40;0.395348837209302;26;17;0.104651162790698;0.395348837209302
Control.SRR15539824;38;40;0.315789473684211;26;12;0.184210526315789;0.315789473684211
Control.SRR15539824;37;40;0.486486486486487;19;18;0.0135135135135135;0.486486486486487
Control.SRR15539824;40;40;0.525;19;21;0.025;0.475
Control.SRR15539824;43;40;0.348837209302326;28;15;0.151162790697674;0.348837209302326
Control.SRR15539824;35;40;0.457142857142857;19;16;0.0428571428571429;0.457142857142857
Control.SRR15539824;37;40;0.567567567567568;16;21;0.0675675675675675;0.432432432432432
Control.SRR15539824;43;40;0.604651162790698;17;26;0.104651162790698;0.395348837209302
Control.SRR15539824;39;40;0.435897435897436;22;17;0.0641025641025641;0.435897435897436
Control.SRR15539824;44;40;0.568181818181818;19;25;0.0681818181818182;0.431818181818182
Control.SRR15539824;40;40;0.475;21;19;0.025;0.475
Control.SRR15539824;37;40;0.540540540540541;17;20;0.0405405405405406;0.459459459459459
Control.SRR15539824;35;40;0.571428571428571;15;20;0.0714285714285714;0.428571428571429
Control.SRR15539824;34;40;0.617647058823529;13;21;0.117647058823529;0.382352941176471
Control.SRR15539824;39;40;0.435897435897436;22;17;0.0641025641025641;0.435897435897436
Control.SRR15539824;35;40;0.514285714285714;17;18;0.0142857142857142;0.485714285714286
Control.SRR15539824;43;40;0.627906976744186;16;27;0.127906976744186;0.372093023255814
Control.SRR15539824;38;40;0.526315789473684;18;20;0.0263157894736842;0.473684210526316
Control.SRR15539824;35;40;0.657142857142857;12;23;0.157142857142857;0.342857142857143
Control.SRR15539824;38;40;0.447368421052632;21;17;0.0526315789473684;0.447368421052632
Control.SRR15539824;43;40;0.511627906976744;21;22;0.0116279069767442;0.488372093023256
Control.SRR15539824;44;40;0.704545454545455;13;31;0.204545454545455;0.295454545454545
Control.SRR15539824;36;40;0.5;18;18;0;0.5
Control.SRR15539824;41;40;0.463414634146341;22;19;0.0365853658536585;0.463414634146341
Control.SRR15539824;36;40;0.416666666666667;21;15;0.0833333333333333;0.416666666666667
Control.SRR15539824;36;40;0.472222222222222;19;17;0.0277777777777778;0.472222222222222
Control.SRR15539824;42;40;0.571428571428571;18;24;0.0714285714285714;0.428571428571429
Control.SRR15539824;38;40;0.631578947368421;14;24;0.131578947368421;0.368421052631579
Control.SRR15539824;42;40;0.380952380952381;26;16;0.119047619047619;0.380952380952381
Control.SRR15539824;41;40;0.48780487804878;21;20;0.0121951219512195;0.48780487804878
Control.SRR15539824;41;40;0.439024390243902;23;18;0.0609756097560976;0.439024390243902
Control.SRR15539824;41;40;0.51219512195122;20;21;0.0121951219512195;0.48780487804878
Control.SRR15539824;40;40;0.5;20;20;0;0.5
Control.SRR15539824;44;40;0.568181818181818;19;25;0.0681818181818182;0.431818181818182
Control.SRR15539824;37;40;0.648648648648649;13;24;0.148648648648649;0.351351351351351
Control.SRR15539824;43;40;0.488372093023256;22;21;0.0116279069767442;0.488372093023256
Control.SRR15539824;36;40;0.472222222222222;19;17;0.0277777777777778;0.472222222222222
Control.SRR15539824;35;40;0.428571428571429;20;15;0.0714285714285715;0.428571428571429
Control.SRR15539824;35;40;0.571428571428571;15;20;0.0714285714285714;0.428571428571429
Control.SRR15539824;42;40;0.571428571428571;18;24;0.0714285714285714;0.428571428571429
Control.SRR15539824;37;40;0.513513513513513;18;19;0.0135135135135135;0.486486486486487
Control.SRR15539824;38;40;0.526315789473684;18;20;0.0263157894736842;0.473684210526316
Control.SRR15539824;43;40;0.604651162790698;17;26;0.104651162790698;0.395348837209302
Control.SRR15539824;42;40;0.5;21;21;0;0.5
Control.SRR15539824;38;40;0.368421052631579;24;14;0.131578947368421;0.368421052631579
Control.SRR15539824;40;40;0.525;19;21;0.025;0.475
Control.SRR15539824;41;40;0.560975609756098;18;23;0.0609756097560976;0.439024390243902
Control.SRR15539824;39;40;0.384615384615385;24;15;0.115384615384615;0.384615384615385
Control.SRR15539824;43;40;0.697674418604651;13;30;0.197674418604651;0.302325581395349
Control.SRR15539824;41;40;0.365853658536585;26;15;0.134146341463415;0.365853658536585
Control.SRR15539824;36;40;0.333333333333333;24;12;0.166666666666667;0.333333333333333
Control.SRR15539824;34;40;0.352941176470588;22;12;0.147058823529412;0.352941176470588
Control.SRR15539824;37;40;0.567567567567568;16;21;0.0675675675675675;0.432432432432432
Control.SRR15539824;36;40;0.472222222222222;19;17;0.0277777777777778;0.472222222222222
Control.SRR15539824;41;40;0.463414634146341;22;19;0.0365853658536585;0.463414634146341
Control.SRR15539824;40;40;0.6;16;24;0.1;0.4
Control.SRR15539824;34;40;0.617647058823529;13;21;0.117647058823529;0.382352941176471
Control.SRR15539824;39;40;0.538461538461538;18;21;0.0384615384615384;0.461538461538462
Control.SRR15539824;44;40;0.431818181818182;25;19;0.0681818181818182;0.431818181818182
Control.SRR15539824;42;40;0.476190476190476;22;20;0.0238095238095238;0.476190476190476
Control.SRR15539824;41;40;0.536585365853659;19;22;0.0365853658536586;0.463414634146341
Control.SRR15539824;43;40;0.581395348837209;18;25;0.0813953488372093;0.418604651162791
Control.SRR15539824;39;40;0.538461538461538;18;21;0.0384615384615384;0.461538461538462
Control.SRR15539824;43;40;0.581395348837209;18;25;0.0813953488372093;0.418604651162791
Control.SRR15539824;35;40;0.571428571428571;15;20;0.0714285714285714;0.428571428571429
Control.SRR15539824;44;40;0.545454545454545;20;24;0.0454545454545454;0.454545454545455
Control.SRR15539824;40;40;0.375;25;15;0.125;0.375
Control.SRR15539824;37;40;0.459459459459459;20;17;0.0405405405405405;0.459459459459459
Control.SRR15539824;41;40;0.536585365853659;19;22;0.0365853658536586;0.463414634146341
Control.SRR15539824;44;40;0.5;22;22;0;0.5
Control.SRR15539824;36;40;0.555555555555556;16;20;0.0555555555555556;0.444444444444444
Control.SRR15539824;41;40;0.51219512195122;20;21;0.0121951219512195;0.48780487804878
Control.SRR15539824;42;40;0.428571428571429;24;18;0.0714285714285715;0.428571428571429
Control.SRR15539824;36;40;0.444444444444444;20;16;0.0555555555555556;0.444444444444444
Control.SRR15539824;43;40;0.558139534883721;19;24;0.0581395348837209;0.441860465116279
Control.SRR15539824;35;40;0.485714285714286;18;17;0.0142857142857143;0.485714285714286
Control.SRR15539824;40;40;0.375;25;15;0.125;0.375
Control.SRR15539824;43;40;0.418604651162791;25;18;0.0813953488372093;0.418604651162791
Control.SRR15539824;44;40;0.454545454545455;24;20;0.0454545454545455;0.454545454545455
Control.SRR15539824;37;40;0.567567567567568;16;21;0.0675675675675675;0.432432432432432
Control.SRR15539824;42;40;0.476190476190476;22;20;0.0238095238095238;0.476190476190476
Control.SRR15539824;36;40;0.5;18;18;0;0.5
Control.SRR15539824;35;40;0.542857142857143;16;19;0.0428571428571428;0.457142857142857
Control.SRR15539824;43;40;0.418604651162791;25;18;0.0813953488372093;0.418604651162791
Control.SRR15539824;34;40;0.529411764705882;16;18;0.0294117647058824;0.470588235294118
Control.SRR15539824;37;40;0.486486486486487;19;18;0.0135135135135135;0.486486486486487
Control.SRR15539824;33;40;0.545454545454545;15;18;0.0454545454545454;0.454545454545455
Control.SRR15539824;43;40;0.534883720930233;20;23;0.0348837209302325;0.465116279069767
Control.SRR15539824;41;40;0.585365853658537;17;24;0.0853658536585366;0.414634146341463
Control.SRR15539824;39;40;0.538461538461538;18;21;0.0384615384615384;0.461538461538462
Control.SRR15539824;38;40;0.447368421052632;21;17;0.0526315789473684;0.447368421052632
Control.SRR15539824;39;40;0.538461538461538;18;21;0.0384615384615384;0.461538461538462
Control.SRR15539824;38;40;0.5;19;19;0;0.5
Control.SRR15539824;41;40;0.51219512195122;20;21;0.0121951219512195;0.48780487804878
Control.SRR15539824;38;40;0.631578947368421;14;24;0.131578947368421;0.368421052631579
Control.SRR15539824;40;40;0.525;19;21;0.025;0.475
Control.SRR15539824;36;40;0.472222222222222;19;17;0.0277777777777778;0.472222222222222
Control.SRR15539824;33;40;0.515151515151515;16;17;0.0151515151515151;0.484848484848485
Control.SRR15539824;37;40;0.540540540540541;17;20;0.0405405405405406;0.459459459459459
Control.SRR15539824;35;40;0.514285714285714;17;18;0.0142857142857142;0.485714285714286
Control.SRR15539824;40;40;0.5;20;20;0;0.5
Control.SRR15539824;37;40;0.621621621621622;14;23;0.121621621621622;0.378378378378378
Control.SRR15539824;33;40;0.606060606060606;13;20;0.106060606060606;0.393939393939394
Control.SRR15539824;33;40;0.575757575757576;14;19;0.0757575757575758;0.424242424242424
Control.SRR15539824;34;40;0.470588235294118;18;16;0.0294117647058824;0.470588235294118
Control.SRR15539824;40;40;0.525;19;21;0.025;0.475
Control.SRR15539824;33;40;0.454545454545455;18;15;0.0454545454545455;0.454545454545455
Control.SRR15539824;38;40;0.473684210526316;20;18;0.0263157894736842;0.473684210526316
Control.SRR15539824;35;40;0.6;14;21;0.1;0.4
Control.SRR15539824;41;40;0.560975609756098;18;23;0.0609756097560976;0.439024390243902
Control.SRR15539824;35;40;0.514285714285714;17;18;0.0142857142857142;0.485714285714286
Control.SRR15539824;42;40;0.595238095238095;17;25;0.0952380952380952;0.404761904761905
Control.SRR15539824;37;40;0.27027027027027;27;10;0.22972972972973;0.27027027027027
Control.SRR15539824;40;40;0.45;22;18;0.05;0.45
Control.SRR15539824;43;40;0.348837209302326;28;15;0.151162790697674;0.348837209302326
Control.SRR15539824;43;40;0.534883720930233;20;23;0.0348837209302325;0.465116279069767
Control.SRR15539824;34;40;0.676470588235294;11;23;0.176470588235294;0.323529411764706
Control.SRR15539824;40;40;0.4;24;16;0.1;0.4
Control.SRR15539824;34;40;0.647058823529412;12;22;0.147058823529412;0.352941176470588
Control.SRR15539824;41;40;0.536585365853659;19;22;0.0365853658536586;0.463414634146341
Control.SRR15539824;35;40;0.485714285714286;18;17;0.0142857142857143;0.485714285714286
Control.SRR15539824;38;40;0.5;19;19;0;0.5
Control.SRR15539824;34;40;0.647058823529412;12;22;0.147058823529412;0.352941176470588
Control.SRR15539824;39;40;0.435897435897436;22;17;0.0641025641025641;0.435897435897436
Control.SRR15539824;36;40;0.444444444444444;20;16;0.0555555555555556;0.444444444444444
Control.SRR15539824;40;40;0.575;17;23;0.075;0.425
Control.SRR15539824;38;40;0.447368421052632;21;17;0.0526315789473684;0.447368421052632
Control.SRR15539824;40;40;0.325;27;13;0.175;0.325
Control.SRR15539824;33;40;0.575757575757576;14;19;0.0757575757575758;0.424242424242424
Control.SRR15539824;37;40;0.621621621621622;14;23;0.121621621621622;0.378378378378378
Control.SRR15539824;34;40;0.470588235294118;18;16;0.0294117647058824;0.470588235294118
Control.SRR15539824;34;40;0.558823529411765;15;19;0.0588235294117647;0.441176470588235
Control.SRR15539824;33;40;0.484848484848485;17;16;0.0151515151515151;0.484848484848485
Control.SRR15539824;39;40;0.564102564102564;17;22;0.0641025641025641;0.435897435897436
Control.SRR15539824;35;40;0.542857142857143;16;19;0.0428571428571428;0.457142857142857
Control.SRR15539824;41;40;0.48780487804878;21;20;0.0121951219512195;0.48780487804878
Control.SRR15539824;38;40;0.394736842105263;23;15;0.105263157894737;0.394736842105263
Control.SRR15539824;43;40;0.348837209302326;28;15;0.151162790697674;0.348837209302326
Control.SRR15539824;43;40;0.302325581395349;30;13;0.197674418604651;0.302325581395349
Control.SRR15539824;35;40;0.457142857142857;19;16;0.0428571428571429;0.457142857142857
Control.SRR15539824;42;40;0.5;21;21;0;0.5
Control.SRR15539824;35;40;0.457142857142857;19;16;0.0428571428571429;0.457142857142857
Control.SRR15539824;35;40;0.428571428571429;20;15;0.0714285714285715;0.428571428571429
Control.SRR15539824;43;40;0.581395348837209;18;25;0.0813953488372093;0.418604651162791
Control.SRR15539824;37;40;0.459459459459459;20;17;0.0405405405405405;0.459459459459459
Control.SRR15539824;36;40;0.527777777777778;17;19;0.0277777777777778;0.472222222222222
Control.SRR15539824;40;40;0.7;12;28;0.2;0.3
Control.SRR15539824;42;40;0.5;21;21;0;0.5
Control.SRR15539824;38;40;0.526315789473684;18;20;0.0263157894736842;0.473684210526316
Control.SRR15539824;41;40;0.439024390243902;23;18;0.0609756097560976;0.439024390243902
Control.SRR15539824;43;40;0.511627906976744;21;22;0.0116279069767442;0.488372093023256
Control.SRR15539824;34;40;0.617647058823529;13;21;0.117647058823529;0.382352941176471
Control.SRR15539824;40;40;0.475;21;19;0.025;0.475
Control.SRR15539824;42;40;0.595238095238095;17;25;0.0952380952380952;0.404761904761905
Control.SRR15539824;43;40;0.511627906976744;21;22;0.0116279069767442;0.488372093023256
Control.SRR15539824;37;40;0.513513513513513;18;19;0.0135135135135135;0.486486486486487
Control.SRR15539824;39;40;0.461538461538462;21;18;0.0384615384615384;0.461538461538462
Control.SRR15539824;36;40;0.722222222222222;10;26;0.222222222222222;0.277777777777778
Control.SRR15539824;33;40;0.696969696969697;10;23;0.196969696969697;0.303030303030303
Control.SRR15539824;37;40;0.594594594594595;15;22;0.0945945945945946;0.405405405405405
Control.SRR15539824;37;40;0.378378378378378;23;14;0.121621621621622;0.378378378378378
Control.SRR15539824;38;40;0.447368421052632;21;17;0.0526315789473684;0.447368421052632
Control.SRR15539824;34;40;0.470588235294118;18;16;0.0294117647058824;0.470588235294118
Control.SRR15539824;36;40;0.361111111111111;23;13;0.138888888888889;0.361111111111111
Control.SRR15539824;38;40;0.526315789473684;18;20;0.0263157894736842;0.473684210526316
Control.SRR15539824;35;40;0.571428571428571;15;20;0.0714285714285714;0.428571428571429
Control.SRR15539824;35;40;0.428571428571429;20;15;0.0714285714285715;0.428571428571429
Control.SRR15539824;37;40;0.432432432432432;21;16;0.0675675675675675;0.432432432432432
Control.SRR15539824;35;40;0.428571428571429;20;15;0.0714285714285715;0.428571428571429
Control.SRR15539824;43;40;0.604651162790698;17;26;0.104651162790698;0.395348837209302
Control.SRR15539824;43;40;0.534883720930233;20;23;0.0348837209302325;0.465116279069767
Control.SRR15539824;41;40;0.48780487804878;21;20;0.0121951219512195;0.48780487804878
Control.SRR15539824;41;40;0.414634146341463;24;17;0.0853658536585366;0.414634146341463
Control.SRR15539824;34;40;0.441176470588235;19;15;0.0588235294117647;0.441176470588235
Control.SRR15539824;39;40;0.564102564102564;17;22;0.0641025641025641;0.435897435897436
Control.SRR15539824;37;40;0.513513513513513;18;19;0.0135135135135135;0.486486486486487
Control.SRR15539824;37;40;0.459459459459459;20;17;0.0405405405405405;0.459459459459459
Control.SRR15539824;39;40;0.564102564102564;17;22;0.0641025641025641;0.435897435897436
Control.SRR15539824;41;40;0.51219512195122;20;21;0.0121951219512195;0.48780487804878
Control.SRR15539824;42;40;0.428571428571429;24;18;0.0714285714285715;0.428571428571429
Control.SRR15539824;38;40;0.421052631578947;22;16;0.0789473684210527;0.421052631578947
Control.SRR15539824;36;40;0.416666666666667;21;15;0.0833333333333333;0.416666666666667
Control.SRR15539824;41;40;0.536585365853659;19;22;0.0365853658536586;0.463414634146341
Control.SRR15539824;36;40;0.472222222222222;19;17;0.0277777777777778;0.472222222222222
Control.SRR15539824;42;40;0.571428571428571;18;24;0.0714285714285714;0.428571428571429
Control.SRR15539824;40;40;0.6;16;24;0.1;0.4
Control.SRR15539824;41;40;0.439024390243902;23;18;0.0609756097560976;0.439024390243902
Control.SRR15539824;33;40;0.484848484848485;17;16;0.0151515151515151;0.484848484848485
Control.SRR15539824;40;40;0.6;16;24;0.1;0.4
Control.SRR15539824;38;40;0.447368421052632;21;17;0.0526315789473684;0.447368421052632
Control.SRR15539824;39;40;0.358974358974359;25;14;0.141025641025641;0.358974358974359
Control.SRR15539824;35;40;0.6;14;21;0.1;0.4
Control.SRR15539824;42;40;0.452380952380952;23;19;0.0476190476190476;0.452380952380952
Control.SRR15539824;40;40;0.5;20;20;0;0.5
Control.SRR15539824;37;40;0.567567567567568;16;21;0.0675675675675675;0.432432432432432
Control.SRR15539824;37;40;0.486486486486487;19;18;0.0135135135135135;0.486486486486487
Control.SRR15539824;40;40;0.5;20;20;0;0.5
Control.SRR15539824;39;40;0.641025641025641;14;25;0.141025641025641;0.358974358974359
Control.SRR15539824;42;40;0.476190476190476;22;20;0.0238095238095238;0.476190476190476
Control.SRR15539824;35;40;0.428571428571429;20;15;0.0714285714285715;0.428571428571429
Control.SRR15539824;41;40;0.560975609756098;18;23;0.0609756097560976;0.439024390243902
Control.SRR15539824;38;40;0.526315789473684;18;20;0.0263157894736842;0.473684210526316
Control.SRR15539824;37;40;0.513513513513513;18;19;0.0135135135135135;0.486486486486487
Control.SRR15539824;41;40;0.463414634146341;22;19;0.0365853658536585;0.463414634146341
Control.SRR15539824;43;40;0.627906976744186;16;27;0.127906976744186;0.372093023255814
Control.SRR15539824;35;40;0.571428571428571;15;20;0.0714285714285714;0.428571428571429
Control.SRR15539824;39;40;0.435897435897436;22;17;0.0641025641025641;0.435897435897436
Control.SRR15539824;37;40;0.486486486486487;19;18;0.0135135135135135;0.486486486486487
Control.SRR15539824;36;40;0.416666666666667;21;15;0.0833333333333333;0.416666666666667
Control.SRR15539824;40;40;0.6;16;24;0.1;0.4
Control.SRR15539824;33;40;0.424242424242424;19;14;0.0757575757575757;0.424242424242424
Control.SRR15539824;36;40;0.472222222222222;19;17;0.0277777777777778;0.472222222222222
Control.SRR15539824;43;40;0.395348837209302;26;17;0.104651162790698;0.395348837209302
Control.SRR15539824;33;40;0.424242424242424;19;14;0.0757575757575757;0.424242424242424
Control.SRR15539824;38;40;0.526315789473684;18;20;0.0263157894736842;0.473684210526316
Control.SRR15539824;34;40;0.5;17;17;0;0.5
Control.SRR15539824;42;40;0.428571428571429;24;18;0.0714285714285715;0.428571428571429
Control.SRR15539824;34;40;0.441176470588235;19;15;0.0588235294117647;0.441176470588235
Control.SRR15539824;36;40;0.527777777777778;17;19;0.0277777777777778;0.472222222222222
Control.SRR15539824;35;40;0.542857142857143;16;19;0.0428571428571428;0.457142857142857
Control.SRR15539824;39;40;0.487179487179487;20;19;0.0128205128205128;0.487179487179487
Control.SRR15539824;37;40;0.567567567567568;16;21;0.0675675675675675;0.432432432432432
Control.SRR15539824;39;40;0.564102564102564;17;22;0.0641025641025641;0.435897435897436
Control.SRR15539824;37;40;0.459459459459459;20;17;0.0405405405405405;0.459459459459459
Control.SRR15539824;36;40;0.666666666666667;12;24;0.166666666666667;0.333333333333333
Control.SRR15539824;42;40;0.452380952380952;23;19;0.0476190476190476;0.452380952380952
Control.SRR15539824;41;40;0.658536585365854;14;27;0.158536585365854;0.341463414634146
Control.SRR15539824;41;40;0.560975609756098;18;23;0.0609756097560976;0.439024390243902
Control.SRR15539824;43;40;0.511627906976744;21;22;0.0116279069767442;0.488372093023256
Control.SRR15539824;39;40;0.615384615384615;15;24;0.115384615384615;0.384615384615385
Control.SRR15539824;37;40;0.486486486486487;19;18;0.0135135135135135;0.486486486486487
Control.SRR15539824;40;40;0.45;22;18;0.05;0.45
Control.SRR15539824;40;40;0.35;26;14;0.15;0.35
Control.SRR15539824;39;40;0.58974358974359;16;23;0.0897435897435898;0.41025641025641
Control.SRR15539824;33;40;0.363636363636364;21;12;0.136363636363636;0.363636363636364
Control.SRR15539824;34;40;0.441176470588235;19;15;0.0588235294117647;0.441176470588235
Control.SRR15539824;41;40;0.51219512195122;20;21;0.0121951219512195;0.48780487804878
Control.SRR15539824;36;40;0.638888888888889;13;23;0.138888888888889;0.361111111111111
Control.SRR15539824;36;40;0.583333333333333;15;21;0.0833333333333334;0.416666666666667
Control.SRR15539824;34;40;0.617647058823529;13;21;0.117647058823529;0.382352941176471
Control.SRR15539824;40;40;0.575;17;23;0.075;0.425
Control.SRR15539824;41;40;0.48780487804878;21;20;0.0121951219512195;0.48780487804878
Control.SRR15539824;33;40;0.545454545454545;15;18;0.0454545454545454;0.454545454545455
Control.SRR15539824;43;40;0.325581395348837;29;14;0.174418604651163;0.325581395348837
Control.SRR15539824;37;40;0.405405405405405;22;15;0.0945945945945946;0.405405405405405
Control.SRR15539824;33;40;0.606060606060606;13;20;0.106060606060606;0.393939393939394
Control.SRR15539824;41;40;0.463414634146341;22;19;0.0365853658536585;0.463414634146341
Control.SRR15539824;39;40;0.512820512820513;19;20;0.0128205128205128;0.487179487179487
Control.SRR15539824;35;40;0.457142857142857;19;16;0.0428571428571429;0.457142857142857
Control.SRR15539824;34;40;0.588235294117647;14;20;0.0882352941176471;0.411764705882353
Control.SRR15539824;41;40;0.536585365853659;19;22;0.0365853658536586;0.463414634146341
Control.SRR15539824;41;40;0.463414634146341;22;19;0.0365853658536585;0.463414634146341
Control.SRR15539824;37;40;0.594594594594595;15;22;0.0945945945945946;0.405405405405405
Control.SRR15539824;35;40;0.4;21;14;0.1;0.4
Control.SRR15539824;39;40;0.435897435897436;22;17;0.0641025641025641;0.435897435897436
Control.SRR15539824;40;40;0.475;21;19;0.025;0.475
Control.SRR15539824;37;40;0.621621621621622;14;23;0.121621621621622;0.378378378378378
Control.SRR15539824;35;40;0.628571428571429;13;22;0.128571428571429;0.371428571428571
Control.SRR15539824;35;40;0.571428571428571;15;20;0.0714285714285714;0.428571428571429
Control.SRR15539824;36;40;0.694444444444444;11;25;0.194444444444444;0.305555555555556
Control.SRR15539824;39;40;0.512820512820513;19;20;0.0128205128205128;0.487179487179487
Control.SRR15539824;40;40;0.5;20;20;0;0.5
Control.SRR15539824;42;40;0.452380952380952;23;19;0.0476190476190476;0.452380952380952
Control.SRR15539824;33;40;0.515151515151515;16;17;0.0151515151515151;0.484848484848485
Control.SRR15539824;33;40;0.424242424242424;19;14;0.0757575757575757;0.424242424242424
Control.SRR15539824;33;40;0.636363636363636;12;21;0.136363636363636;0.363636363636364
Control.SRR15539824;40;40;0.5;20;20;0;0.5
Control.SRR15539824;43;40;0.511627906976744;21;22;0.0116279069767442;0.488372093023256
Control.SRR15539824;36;40;0.444444444444444;20;16;0.0555555555555556;0.444444444444444
Control.SRR15539824;36;40;0.5;18;18;0;0.5
Control.SRR15539824;33;40;0.363636363636364;21;12;0.136363636363636;0.363636363636364
Control.SRR15539824;34;40;0.5;17;17;0;0.5
Control.SRR15539824;35;40;0.371428571428571;22;13;0.128571428571429;0.371428571428571
Control.SRR15539824;33;40;0.393939393939394;20;13;0.106060606060606;0.393939393939394
Control.SRR15539824;33;40;0.606060606060606;13;20;0.106060606060606;0.393939393939394
Control.SRR15539824;39;40;0.435897435897436;22;17;0.0641025641025641;0.435897435897436
Control.SRR15539824;33;40;0.515151515151515;16;17;0.0151515151515151;0.484848484848485
Control.SRR15539824;36;40;0.472222222222222;19;17;0.0277777777777778;0.472222222222222
Control.SRR15539824;39;40;0.564102564102564;17;22;0.0641025641025641;0.435897435897436
Control.SRR15539824;39;40;0.384615384615385;24;15;0.115384615384615;0.384615384615385
Control.SRR15539824;37;40;0.378378378378378;23;14;0.121621621621622;0.378378378378378
Control.SRR15539824;33;40;0.575757575757576;14;19;0.0757575757575758;0.424242424242424
Control.SRR15539824;35;40;0.485714285714286;18;17;0.0142857142857143;0.485714285714286
Control.SRR15539824;36;40;0.472222222222222;19;17;0.0277777777777778;0.472222222222222
Control.SRR15539824;36;40;0.472222222222222;19;17;0.0277777777777778;0.472222222222222
Control.SRR15539824;43;40;0.581395348837209;18;25;0.0813953488372093;0.418604651162791
Control.SRR15539824;42;40;0.595238095238095;17;25;0.0952380952380952;0.404761904761905
Control.SRR15539824;36;40;0.416666666666667;21;15;0.0833333333333333;0.416666666666667
Control.SRR15539824;36;40;0.5;18;18;0;0.5
Control.SRR15539824;34;40;0.411764705882353;20;14;0.0882352941176471;0.411764705882353
Control.SRR15539824;35;40;0.342857142857143;23;12;0.157142857142857;0.342857142857143
Control.SRR15539824;40;40;0.325;27;13;0.175;0.325
Control.SRR15539824;41;40;0.48780487804878;21;20;0.0121951219512195;0.48780487804878
Control.SRR15539824;41;40;0.560975609756098;18;23;0.0609756097560976;0.439024390243902
Control.SRR15539824;43;40;0.465116279069767;23;20;0.0348837209302326;0.465116279069767
Control.SRR15539824;40;40;0.6;16;24;0.1;0.4
Control.SRR15539824;39;40;0.58974358974359;16;23;0.0897435897435898;0.41025641025641
Control.SRR15539824;35;40;0.542857142857143;16;19;0.0428571428571428;0.457142857142857
Control.SRR15539824;33;40;0.393939393939394;20;13;0.106060606060606;0.393939393939394
Control.SRR15539824;37;40;0.594594594594595;15;22;0.0945945945945946;0.405405405405405
Control.SRR15539824;39;40;0.512820512820513;19;20;0.0128205128205128;0.487179487179487
Control.SRR15539824;38;40;0.473684210526316;20;18;0.0263157894736842;0.473684210526316
Control.SRR15539824;43;40;0.441860465116279;24;19;0.0581395348837209;0.441860465116279
Control.SRR15539824;35;40;0.6;14;21;0.1;0.4
Control.SRR15539824;36;40;0.361111111111111;23;13;0.138888888888889;0.361111111111111
Control.SRR15539824;39;40;0.435897435897436;22;17;0.0641025641025641;0.435897435897436
Control.SRR15539824;40;40;0.5;20;20;0;0.5
Control.SRR15539824;38;40;0.421052631578947;22;16;0.0789473684210527;0.421052631578947
Control.SRR15539824;42;40;0.452380952380952;23;19;0.0476190476190476;0.452380952380952
Control.SRR15539824;41;40;0.536585365853659;19;22;0.0365853658536586;0.463414634146341
Control.SRR15539824;35;40;0.542857142857143;16;19;0.0428571428571428;0.457142857142857
Control.SRR15539824;35;40;0.457142857142857;19;16;0.0428571428571429;0.457142857142857
Control.SRR15539824;37;40;0.486486486486487;19;18;0.0135135135135135;0.486486486486487
Control.SRR15539824;34;40;0.5;17;17;0;0.5
Control.SRR15539824;35;40;0.771428571428571;8;27;0.271428571428571;0.228571428571429
Control.SRR15539824;33;40;0.545454545454545;15;18;0.0454545454545454;0.454545454545455
Control.SRR15539824;42;40;0.476190476190476;22;20;0.0238095238095238;0.476190476190476
Control.SRR15539824;43;40;0.511627906976744;21;22;0.0116279069767442;0.488372093023256
Control.SRR15539824;34;40;0.529411764705882;16;18;0.0294117647058824;0.470588235294118
Control.SRR15539824;35;40;0.457142857142857;19;16;0.0428571428571429;0.457142857142857
Control.SRR15539824;37;40;0.567567567567568;16;21;0.0675675675675675;0.432432432432432
Control.SRR15539824;39;40;0.487179487179487;20;19;0.0128205128205128;0.487179487179487
Control.SRR15539824;42;40;0.571428571428571;18;24;0.0714285714285714;0.428571428571429
Control.SRR15539824;41;40;0.48780487804878;21;20;0.0121951219512195;0.48780487804878
Control.SRR15539824;38;40;0.473684210526316;20;18;0.0263157894736842;0.473684210526316
Control.SRR15539824;36;40;0.583333333333333;15;21;0.0833333333333334;0.416666666666667
Control.SRR15539824;38;40;0.578947368421053;16;22;0.0789473684210527;0.421052631578947
Control.SRR15539824;42;40;0.380952380952381;26;16;0.119047619047619;0.380952380952381
Control.SRR15539824;35;40;0.514285714285714;17;18;0.0142857142857142;0.485714285714286
Control.SRR15539824;39;40;0.58974358974359;16;23;0.0897435897435898;0.41025641025641
Control.SRR15539824;42;40;0.452380952380952;23;19;0.0476190476190476;0.452380952380952
Control.SRR15539824;36;40;0.444444444444444;20;16;0.0555555555555556;0.444444444444444
Control.SRR15539824;35;40;0.428571428571429;20;15;0.0714285714285715;0.428571428571429
Control.SRR15539824;35;40;0.6;14;21;0.1;0.4
Control.SRR15539824;43;40;0.651162790697674;15;28;0.151162790697674;0.348837209302326
Control.SRR15539824;38;40;0.657894736842105;13;25;0.157894736842105;0.342105263157895
Control.SRR15539824;35;40;0.571428571428571;15;20;0.0714285714285714;0.428571428571429
Control.SRR15539824;34;40;0.558823529411765;15;19;0.0588235294117647;0.441176470588235
Control.SRR15539824;35;40;0.657142857142857;12;23;0.157142857142857;0.342857142857143
Control.SRR15539824;34;40;0.588235294117647;14;20;0.0882352941176471;0.411764705882353
Control.SRR15539824;39;40;0.461538461538462;21;18;0.0384615384615384;0.461538461538462
Control.SRR15539824;38;40;0.526315789473684;18;20;0.0263157894736842;0.473684210526316
Control.SRR15539824;43;40;0.511627906976744;21;22;0.0116279069767442;0.488372093023256
Control.SRR15539824;42;40;0.547619047619048;19;23;0.0476190476190477;0.452380952380952
Control.SRR15539824;33;40;0.515151515151515;16;17;0.0151515151515151;0.484848484848485
Control.SRR15539824;36;40;0.5;18;18;0;0.5
Control.SRR15539824;40;40;0.65;14;26;0.15;0.35
Control.SRR15539824;41;40;0.536585365853659;19;22;0.0365853658536586;0.463414634146341
Control.SRR15539824;40;40;0.625;15;25;0.125;0.375
Control.SRR15539824;33;40;0.606060606060606;13;20;0.106060606060606;0.393939393939394
Control.SRR15539824;35;40;0.457142857142857;19;16;0.0428571428571429;0.457142857142857
Control.SRR15539824;40;40;0.525;19;21;0.025;0.475
Control.SRR15539824;40;40;0.525;19;21;0.025;0.475
Control.SRR15539824;38;40;0.421052631578947;22;16;0.0789473684210527;0.421052631578947
Control.SRR15539824;35;40;0.371428571428571;22;13;0.128571428571429;0.371428571428571
Control.SRR15539824;40;40;0.6;16;24;0.1;0.4
Control.SRR15539824;39;40;0.512820512820513;19;20;0.0128205128205128;0.487179487179487
Control.SRR15539824;39;40;0.538461538461538;18;21;0.0384615384615384;0.461538461538462
Control.SRR15539824;38;40;0.473684210526316;20;18;0.0263157894736842;0.473684210526316
Control.SRR15539824;34;40;0.558823529411765;15;19;0.0588235294117647;0.441176470588235
Control.SRR15539824;34;40;0.558823529411765;15;19;0.0588235294117647;0.441176470588235
Control.SRR15539824;37;40;0.459459459459459;20;17;0.0405405405405405;0.459459459459459
Control.SRR15539824;35;40;0.571428571428571;15;20;0.0714285714285714;0.428571428571429
Control.SRR15539824;38;40;0.473684210526316;20;18;0.0263157894736842;0.473684210526316
Control.SRR15539824;39;40;0.461538461538462;21;18;0.0384615384615384;0.461538461538462
Control.SRR15539824;43;40;0.558139534883721;19;24;0.0581395348837209;0.441860465116279
Control.SRR15539824;34;40;0.558823529411765;15;19;0.0588235294117647;0.441176470588235
Control.SRR15539824;40;40;0.475;21;19;0.025;0.475
Control.SRR15539824;35;40;0.542857142857143;16;19;0.0428571428571428;0.457142857142857
Control.SRR15539824;37;40;0.486486486486487;19;18;0.0135135135135135;0.486486486486487
Control.SRR15539824;38;40;0.526315789473684;18;20;0.0263157894736842;0.473684210526316
Control.SRR15539824;39;40;0.384615384615385;24;15;0.115384615384615;0.384615384615385
Control.SRR15539824;40;40;0.425;23;17;0.075;0.425
Control.SRR15539824;42;40;0.571428571428571;18;24;0.0714285714285714;0.428571428571429
Control.SRR15539824;41;40;0.341463414634146;27;14;0.158536585365854;0.341463414634146
Control.SRR15539824;34;40;0.529411764705882;16;18;0.0294117647058824;0.470588235294118
Control.SRR15539824;36;40;0.694444444444444;11;25;0.194444444444444;0.305555555555556
Control.SRR15539824;39;40;0.461538461538462;21;18;0.0384615384615384;0.461538461538462
Control.SRR15539824;37;40;0.432432432432432;21;16;0.0675675675675675;0.432432432432432
Control.SRR15539824;42;40;0.357142857142857;27;15;0.142857142857143;0.357142857142857
Control.SRR15539824;35;40;0.457142857142857;19;16;0.0428571428571429;0.457142857142857
Control.SRR15539824;37;40;0.594594594594595;15;22;0.0945945945945946;0.405405405405405
Control.SRR15539824;41;40;0.536585365853659;19;22;0.0365853658536586;0.463414634146341
Control.SRR15539824;33;40;0.696969696969697;10;23;0.196969696969697;0.303030303030303
Control.SRR15539824;35;40;0.6;14;21;0.1;0.4
Control.SRR15539824;37;40;0.648648648648649;13;24;0.148648648648649;0.351351351351351
Control.SRR15539824;39;40;0.384615384615385;24;15;0.115384615384615;0.384615384615385
Control.SRR15539824;43;40;0.511627906976744;21;22;0.0116279069767442;0.488372093023256
Control.SRR15539824;42;40;0.571428571428571;18;24;0.0714285714285714;0.428571428571429
Control.SRR15539824;34;40;0.588235294117647;14;20;0.0882352941176471;0.411764705882353
Control.SRR15539824;40;40;0.525;19;21;0.025;0.475
Control.SRR15539824;40;40;0.525;19;21;0.025;0.475
Control.SRR15539824;35;40;0.628571428571429;13;22;0.128571428571429;0.371428571428571
Control.SRR15539824;33;40;0.454545454545455;18;15;0.0454545454545455;0.454545454545455
Control.SRR15539824;36;40;0.527777777777778;17;19;0.0277777777777778;0.472222222222222
Control.SRR15539824;33;40;0.424242424242424;19;14;0.0757575757575757;0.424242424242424
Control.SRR15539824;38;40;0.473684210526316;20;18;0.0263157894736842;0.473684210526316
Control.SRR15539824;42;40;0.333333333333333;28;14;0.166666666666667;0.333333333333333
Control.SRR15539824;42;40;0.523809523809524;20;22;0.0238095238095238;0.476190476190476
Control.SRR15539824;35;40;0.571428571428571;15;20;0.0714285714285714;0.428571428571429
Control.SRR15539824;36;40;0.472222222222222;19;17;0.0277777777777778;0.472222222222222
Control.SRR15539824;40;40;0.375;25;15;0.125;0.375
Control.SRR15539824;34;40;0.647058823529412;12;22;0.147058823529412;0.352941176470588
Control.SRR15539824;39;40;0.487179487179487;20;19;0.0128205128205128;0.487179487179487
Control.SRR15539824;39;40;0.58974358974359;16;23;0.0897435897435898;0.41025641025641
Control.SRR15539824;36;40;0.444444444444444;20;16;0.0555555555555556;0.444444444444444
Control.SRR15539824;43;40;0.674418604651163;14;29;0.174418604651163;0.325581395348837
Control.SRR15539824;40;40;0.325;27;13;0.175;0.325
Control.SRR15539824;37;40;0.540540540540541;17;20;0.0405405405405406;0.459459459459459
Control.SRR15539824;43;40;0.604651162790698;17;26;0.104651162790698;0.395348837209302
Control.SRR15539824;37;40;0.594594594594595;15;22;0.0945945945945946;0.405405405405405
Control.SRR15539824;37;40;0.405405405405405;22;15;0.0945945945945946;0.405405405405405
Control.SRR15539824;40;40;0.5;20;20;0;0.5
Control.SRR15539824;42;40;0.523809523809524;20;22;0.0238095238095238;0.476190476190476
Control.SRR15539824;38;40;0.552631578947368;17;21;0.0526315789473685;0.447368421052632
Control.SRR15539824;37;40;0.513513513513513;18;19;0.0135135135135135;0.486486486486487
Control.SRR15539824;39;40;0.358974358974359;25;14;0.141025641025641;0.358974358974359
Control.SRR15539824;38;40;0.447368421052632;21;17;0.0526315789473684;0.447368421052632
Control.SRR15539824;42;40;0.5;21;21;0;0.5
Control.SRR15539824;38;40;0.526315789473684;18;20;0.0263157894736842;0.473684210526316
Control.SRR15539824;42;40;0.547619047619048;19;23;0.0476190476190477;0.452380952380952
Control.SRR15539824;39;40;0.461538461538462;21;18;0.0384615384615384;0.461538461538462
Control.SRR15539824;41;40;0.48780487804878;21;20;0.0121951219512195;0.48780487804878
Control.SRR15539824;34;40;0.647058823529412;12;22;0.147058823529412;0.352941176470588
Control.SRR15539824;37;40;0.594594594594595;15;22;0.0945945945945946;0.405405405405405
Control.SRR15539824;40;40;0.475;21;19;0.025;0.475
Control.SRR15539824;41;40;0.634146341463415;15;26;0.134146341463415;0.365853658536585
Control.SRR15539824;33;40;0.303030303030303;23;10;0.196969696969697;0.303030303030303
Control.SRR15539824;42;40;0.714285714285714;12;30;0.214285714285714;0.285714285714286
Control.SRR15539824;36;40;0.611111111111111;14;22;0.111111111111111;0.388888888888889
Control.SRR15539824;38;40;0.473684210526316;20;18;0.0263157894736842;0.473684210526316
Control.SRR15539824;41;40;0.48780487804878;21;20;0.0121951219512195;0.48780487804878
Control.SRR15539824;41;40;0.51219512195122;20;21;0.0121951219512195;0.48780487804878
Control.SRR15539824;43;40;0.395348837209302;26;17;0.104651162790698;0.395348837209302
Control.SRR15539824;41;40;0.51219512195122;20;21;0.0121951219512195;0.48780487804878
Control.SRR15539824;42;40;0.428571428571429;24;18;0.0714285714285715;0.428571428571429
Control.SRR15539824;41;40;0.560975609756098;18;23;0.0609756097560976;0.439024390243902
Control.SRR15539824;36;40;0.527777777777778;17;19;0.0277777777777778;0.472222222222222
Control.SRR15539824;43;40;0.441860465116279;24;19;0.0581395348837209;0.441860465116279
Control.SRR15539824;37;40;0.432432432432432;21;16;0.0675675675675675;0.432432432432432
Control.SRR15539824;43;40;0.488372093023256;22;21;0.0116279069767442;0.488372093023256
Control.SRR15539824;40;40;0.575;17;23;0.075;0.425
Control.SRR15539824;42;40;0.5;21;21;0;0.5
Control.SRR15539824;39;40;0.538461538461538;18;21;0.0384615384615384;0.461538461538462
Control.SRR15539824;35;40;0.485714285714286;18;17;0.0142857142857143;0.485714285714286
Control.SRR15539824;39;40;0.435897435897436;22;17;0.0641025641025641;0.435897435897436
Control.SRR15539824;40;40;0.425;23;17;0.075;0.425
Control.SRR15539824;41;40;0.414634146341463;24;17;0.0853658536585366;0.414634146341463
Control.SRR15539824;37;40;0.594594594594595;15;22;0.0945945945945946;0.405405405405405
Control.SRR15539824;38;40;0.552631578947368;17;21;0.0526315789473685;0.447368421052632
Control.SRR15539824;41;40;0.390243902439024;25;16;0.109756097560976;0.390243902439024
Control.SRR15539824;37;40;0.324324324324324;25;12;0.175675675675676;0.324324324324324
Control.SRR15539824;37;40;0.540540540540541;17;20;0.0405405405405406;0.459459459459459
Control.SRR15539824;39;40;0.538461538461538;18;21;0.0384615384615384;0.461538461538462
Control.SRR15539824;37;40;0.621621621621622;14;23;0.121621621621622;0.378378378378378
Control.SRR15539824;38;40;0.421052631578947;22;16;0.0789473684210527;0.421052631578947
Control.SRR15539824;41;40;0.48780487804878;21;20;0.0121951219512195;0.48780487804878
Control.SRR15539824;39;40;0.641025641025641;14;25;0.141025641025641;0.358974358974359
Control.SRR15539824;36;40;0.472222222222222;19;17;0.0277777777777778;0.472222222222222
Control.SRR15539824;35;40;0.457142857142857;19;16;0.0428571428571429;0.457142857142857
Control.SRR15539824;41;40;0.51219512195122;20;21;0.0121951219512195;0.48780487804878
Control.SRR15539824;40;40;0.55;18;22;0.05;0.45
Control.SRR15539824;38;40;0.578947368421053;16;22;0.0789473684210527;0.421052631578947
Control.SRR15539824;33;40;0.484848484848485;17;16;0.0151515151515151;0.484848484848485
Control.SRR15539824;35;40;0.371428571428571;22;13;0.128571428571429;0.371428571428571
Control.SRR15539824;41;40;0.463414634146341;22;19;0.0365853658536585;0.463414634146341
Control.SRR15539824;35;40;0.571428571428571;15;20;0.0714285714285714;0.428571428571429
Control.SRR15539824;36;40;0.333333333333333;24;12;0.166666666666667;0.333333333333333
Control.SRR15539824;39;40;0.58974358974359;16;23;0.0897435897435898;0.41025641025641
Control.SRR15539824;39;40;0.41025641025641;23;16;0.0897435897435898;0.41025641025641
Control.SRR15539824;36;40;0.611111111111111;14;22;0.111111111111111;0.388888888888889
Control.SRR15539824;40;40;0.425;23;17;0.075;0.425
Control.SRR15539824;43;40;0.488372093023256;22;21;0.0116279069767442;0.488372093023256
Control.SRR15539824;40;40;0.625;15;25;0.125;0.375
Control.SRR15539824;41;40;0.51219512195122;20;21;0.0121951219512195;0.48780487804878
Control.SRR15539824;42;40;0.547619047619048;19;23;0.0476190476190477;0.452380952380952
Control.SRR15539824;35;40;0.457142857142857;19;16;0.0428571428571429;0.457142857142857
Control.SRR15539824;39;40;0.435897435897436;22;17;0.0641025641025641;0.435897435897436
Control.SRR15539824;42;40;0.666666666666667;14;28;0.166666666666667;0.333333333333333
Control.SRR15539824;42;40;0.452380952380952;23;19;0.0476190476190476;0.452380952380952
Control.SRR15539824;39;40;0.384615384615385;24;15;0.115384615384615;0.384615384615385
Control.SRR15539824;42;40;0.5;21;21;0;0.5
Control.SRR15539824;37;40;0.540540540540541;17;20;0.0405405405405406;0.459459459459459
Control.SRR15539824;42;40;0.595238095238095;17;25;0.0952380952380952;0.404761904761905
Control.SRR15539824;41;40;0.341463414634146;27;14;0.158536585365854;0.341463414634146
Control.SRR15539824;33;40;0.515151515151515;16;17;0.0151515151515151;0.484848484848485
Control.SRR15539824;33;40;0.545454545454545;15;18;0.0454545454545454;0.454545454545455
Control.SRR15539824;35;40;0.542857142857143;16;19;0.0428571428571428;0.457142857142857
Control.SRR15539824;33;40;0.424242424242424;19;14;0.0757575757575757;0.424242424242424
Control.SRR15539824;38;40;0.421052631578947;22;16;0.0789473684210527;0.421052631578947
Control.SRR15539824;41;40;0.585365853658537;17;24;0.0853658536585366;0.414634146341463
Control.SRR15539824;35;40;0.514285714285714;17;18;0.0142857142857142;0.485714285714286
Control.SRR15539824;36;40;0.527777777777778;17;19;0.0277777777777778;0.472222222222222
Control.SRR15539824;43;40;0.348837209302326;28;15;0.151162790697674;0.348837209302326
Control.SRR15539824;38;40;0.657894736842105;13;25;0.157894736842105;0.342105263157895
Control.SRR15539824;34;40;0.441176470588235;19;15;0.0588235294117647;0.441176470588235
Control.SRR15539824;42;40;0.380952380952381;26;16;0.119047619047619;0.380952380952381
Control.SRR15539824;34;40;0.705882352941177;10;24;0.205882352941177;0.294117647058824
Control.SRR15539824;33;40;0.545454545454545;15;18;0.0454545454545454;0.454545454545455
Control.SRR15539824;42;40;0.476190476190476;22;20;0.0238095238095238;0.476190476190476
Control.SRR15539824;36;40;0.527777777777778;17;19;0.0277777777777778;0.472222222222222
Control.SRR15539824;37;40;0.513513513513513;18;19;0.0135135135135135;0.486486486486487
Control.SRR15539824;35;40;0.542857142857143;16;19;0.0428571428571428;0.457142857142857
Control.SRR15539824;38;40;0.447368421052632;21;17;0.0526315789473684;0.447368421052632
Control.SRR15539824;41;40;0.560975609756098;18;23;0.0609756097560976;0.439024390243902
Control.SRR15539824;42;40;0.452380952380952;23;19;0.0476190476190476;0.452380952380952
Control.SRR15539824;39;40;0.487179487179487;20;19;0.0128205128205128;0.487179487179487
Control.SRR15539824;41;40;0.463414634146341;22;19;0.0365853658536585;0.463414634146341
Control.SRR15539824;38;40;0.368421052631579;24;14;0.131578947368421;0.368421052631579
Control.SRR15539824;43;40;0.558139534883721;19;24;0.0581395348837209;0.441860465116279
Control.SRR15539824;42;40;0.547619047619048;19;23;0.0476190476190477;0.452380952380952
Control.SRR15539824;33;40;0.696969696969697;10;23;0.196969696969697;0.303030303030303
Control.SRR15539824;37;40;0.567567567567568;16;21;0.0675675675675675;0.432432432432432
Control.SRR15539824;36;40;0.444444444444444;20;16;0.0555555555555556;0.444444444444444
Control.SRR15539824;43;40;0.441860465116279;24;19;0.0581395348837209;0.441860465116279
Control.SRR15539824;43;40;0.488372093023256;22;21;0.0116279069767442;0.488372093023256
Control.SRR15539824;42;40;0.523809523809524;20;22;0.0238095238095238;0.476190476190476
Control.SRR15539824;41;40;0.658536585365854;14;27;0.158536585365854;0.341463414634146
Control.SRR15539824;43;40;0.511627906976744;21;22;0.0116279069767442;0.488372093023256
Control.SRR15539824;37;40;0.432432432432432;21;16;0.0675675675675675;0.432432432432432
Control.SRR15539824;39;40;0.435897435897436;22;17;0.0641025641025641;0.435897435897436
Control.SRR15539824;38;40;0.526315789473684;18;20;0.0263157894736842;0.473684210526316
Control.SRR15539824;37;40;0.351351351351351;24;13;0.148648648648649;0.351351351351351
Control.SRR15539824;38;40;0.447368421052632;21;17;0.0526315789473684;0.447368421052632
Control.SRR15539824;40;40;0.475;21;19;0.025;0.475
Control.SRR15539824;40;40;0.5;20;20;0;0.5
Control.SRR15539824;37;40;0.567567567567568;16;21;0.0675675675675675;0.432432432432432
Control.SRR15539824;36;40;0.611111111111111;14;22;0.111111111111111;0.388888888888889
Control.SRR15539824;41;40;0.585365853658537;17;24;0.0853658536585366;0.414634146341463
Control.SRR15539824;40;40;0.5;20;20;0;0.5
Control.SRR15539824;41;40;0.51219512195122;20;21;0.0121951219512195;0.48780487804878
Control.SRR15539824;41;40;0.48780487804878;21;20;0.0121951219512195;0.48780487804878
Control.SRR15539824;42;40;0.642857142857143;15;27;0.142857142857143;0.357142857142857
Control.SRR15539824;38;40;0.368421052631579;24;14;0.131578947368421;0.368421052631579
Control.SRR15539824;35;40;0.485714285714286;18;17;0.0142857142857143;0.485714285714286
Control.SRR15539824;39;40;0.461538461538462;21;18;0.0384615384615384;0.461538461538462
Control.SRR15539824;39;40;0.487179487179487;20;19;0.0128205128205128;0.487179487179487
Control.SRR15539824;42;40;0.428571428571429;24;18;0.0714285714285715;0.428571428571429
Control.SRR15539824;40;40;0.625;15;25;0.125;0.375
Control.SRR15539824;41;40;0.536585365853659;19;22;0.0365853658536586;0.463414634146341
Control.SRR15539824;35;40;0.714285714285714;10;25;0.214285714285714;0.285714285714286
Control.SRR15539824;33;40;0.545454545454545;15;18;0.0454545454545454;0.454545454545455
Control.SRR15539824;34;40;0.470588235294118;18;16;0.0294117647058824;0.470588235294118
Control.SRR15539824;34;40;0.617647058823529;13;21;0.117647058823529;0.382352941176471
Control.SRR15539824;37;40;0.540540540540541;17;20;0.0405405405405406;0.459459459459459
Control.SRR15539824;38;40;0.605263157894737;15;23;0.105263157894737;0.394736842105263
Control.SRR15539824;34;40;0.529411764705882;16;18;0.0294117647058824;0.470588235294118
Control.SRR15539824;39;40;0.512820512820513;19;20;0.0128205128205128;0.487179487179487
Control.SRR15539824;34;40;0.441176470588235;19;15;0.0588235294117647;0.441176470588235
Control.SRR15539824;39;40;0.641025641025641;14;25;0.141025641025641;0.358974358974359
Control.SRR15539824;42;40;0.619047619047619;16;26;0.119047619047619;0.380952380952381
Control.SRR15539824;34;40;0.558823529411765;15;19;0.0588235294117647;0.441176470588235
Control.SRR15539824;40;40;0.475;21;19;0.025;0.475
Control.SRR15539824;41;40;0.536585365853659;19;22;0.0365853658536586;0.463414634146341
Control.SRR15539824;38;40;0.526315789473684;18;20;0.0263157894736842;0.473684210526316
Control.SRR15539824;43;40;0.511627906976744;21;22;0.0116279069767442;0.488372093023256
Control.SRR15539824;39;40;0.384615384615385;24;15;0.115384615384615;0.384615384615385
Control.SRR15539824;36;40;0.388888888888889;22;14;0.111111111111111;0.388888888888889
Control.SRR15539824;43;40;0.441860465116279;24;19;0.0581395348837209;0.441860465116279
Control.SRR15539824;43;40;0.488372093023256;22;21;0.0116279069767442;0.488372093023256
Control.SRR15539824;41;40;0.560975609756098;18;23;0.0609756097560976;0.439024390243902
Control.SRR15539824;34;40;0.529411764705882;16;18;0.0294117647058824;0.470588235294118
Control.SRR15539824;38;40;0.552631578947368;17;21;0.0526315789473685;0.447368421052632
Control.SRR15539824;38;40;0.5;19;19;0;0.5
Control.SRR15539824;43;40;0.465116279069767;23;20;0.0348837209302326;0.465116279069767
Control.SRR15539824;42;40;0.666666666666667;14;28;0.166666666666667;0.333333333333333
Control.SRR15539824;38;40;0.605263157894737;15;23;0.105263157894737;0.394736842105263
Control.SRR15539824;42;40;0.571428571428571;18;24;0.0714285714285714;0.428571428571429
Control.SRR15539824;43;40;0.581395348837209;18;25;0.0813953488372093;0.418604651162791
Control.SRR15539824;37;40;0.378378378378378;23;14;0.121621621621622;0.378378378378378
Control.SRR15539824;33;40;0.575757575757576;14;19;0.0757575757575758;0.424242424242424
Control.SRR15539824;33;40;0.454545454545455;18;15;0.0454545454545455;0.454545454545455
Control.SRR15539824;43;40;0.441860465116279;24;19;0.0581395348837209;0.441860465116279
Control.SRR15539824;39;40;0.487179487179487;20;19;0.0128205128205128;0.487179487179487
Control.SRR15539824;36;40;0.5;18;18;0;0.5
Control.SRR15539824;37;40;0.459459459459459;20;17;0.0405405405405405;0.459459459459459
Control.SRR15539824;37;40;0.486486486486487;19;18;0.0135135135135135;0.486486486486487
Control.SRR15539824;35;40;0.571428571428571;15;20;0.0714285714285714;0.428571428571429
Control.SRR15539824;43;40;0.372093023255814;27;16;0.127906976744186;0.372093023255814
Control.SRR15539824;39;40;0.538461538461538;18;21;0.0384615384615384;0.461538461538462
Control.SRR15539824;39;40;0.461538461538462;21;18;0.0384615384615384;0.461538461538462
Control.SRR15539824;41;40;0.51219512195122;20;21;0.0121951219512195;0.48780487804878
Control.SRR15539824;42;40;0.5;21;21;0;0.5
Control.SRR15539824;38;40;0.526315789473684;18;20;0.0263157894736842;0.473684210526316
Control.SRR15539824;34;40;0.470588235294118;18;16;0.0294117647058824;0.470588235294118
Control.SRR15539824;34;40;0.323529411764706;23;11;0.176470588235294;0.323529411764706
Control.SRR15539824;43;40;0.418604651162791;25;18;0.0813953488372093;0.418604651162791
Control.SRR15539824;39;40;0.58974358974359;16;23;0.0897435897435898;0.41025641025641
Control.SRR15539824;43;40;0.511627906976744;21;22;0.0116279069767442;0.488372093023256
Control.SRR15539824;41;40;0.536585365853659;19;22;0.0365853658536586;0.463414634146341
Control.SRR15539824;38;40;0.526315789473684;18;20;0.0263157894736842;0.473684210526316
Control.SRR15539824;41;40;0.414634146341463;24;17;0.0853658536585366;0.414634146341463
Control.SRR15539824;37;40;0.459459459459459;20;17;0.0405405405405405;0.459459459459459
Control.SRR15539824;36;40;0.611111111111111;14;22;0.111111111111111;0.388888888888889
Control.SRR15539824;38;40;0.447368421052632;21;17;0.0526315789473684;0.447368421052632
Control.SRR15539824;41;40;0.365853658536585;26;15;0.134146341463415;0.365853658536585
Control.SRR15539824;36;40;0.416666666666667;21;15;0.0833333333333333;0.416666666666667
Control.SRR15539824;37;40;0.486486486486487;19;18;0.0135135135135135;0.486486486486487
Control.SRR15539824;43;40;0.372093023255814;27;16;0.127906976744186;0.372093023255814
Control.SRR15539824;41;40;0.560975609756098;18;23;0.0609756097560976;0.439024390243902
Control.SRR15539824;42;40;0.404761904761905;25;17;0.0952380952380952;0.404761904761905
Control.SRR15539824;39;40;0.512820512820513;19;20;0.0128205128205128;0.487179487179487
Control.SRR15539824;47;40;0.595744680851064;19;28;0.0957446808510638;0.404255319148936
Control.SRR15539824;35;40;0.428571428571429;20;15;0.0714285714285715;0.428571428571429
Control.SRR15539824;41;40;0.585365853658537;17;24;0.0853658536585366;0.414634146341463
Control.SRR15539824;44;40;0.477272727272727;23;21;0.0227272727272727;0.477272727272727
Control.SRR15539824;38;40;0.526315789473684;18;20;0.0263157894736842;0.473684210526316
Control.SRR15539824;39;40;0.487179487179487;20;19;0.0128205128205128;0.487179487179487
Control.SRR15539824;40;40;0.5;20;20;0;0.5
Control.SRR15539824;35;40;0.314285714285714;24;11;0.185714285714286;0.314285714285714
Control.SRR15539824;40;40;0.5;20;20;0;0.5
Control.SRR15539824;35;40;0.542857142857143;16;19;0.0428571428571428;0.457142857142857
Control.SRR15539824;44;40;0.5;22;22;0;0.5
Control.SRR15539824;37;40;0.432432432432432;21;16;0.0675675675675675;0.432432432432432
Control.SRR15539824;35;40;0.6;14;21;0.1;0.4
Control.SRR15539824;40;40;0.625;15;25;0.125;0.375
Control.SRR15539824;40;40;0.375;25;15;0.125;0.375
Control.SRR15539824;43;40;0.558139534883721;19;24;0.0581395348837209;0.441860465116279
Control.SRR15539824;38;40;0.605263157894737;15;23;0.105263157894737;0.394736842105263
Control.SRR15539824;35;40;0.571428571428571;15;20;0.0714285714285714;0.428571428571429
Control.SRR15539824;42;40;0.476190476190476;22;20;0.0238095238095238;0.476190476190476
Control.SRR15539824;36;40;0.527777777777778;17;19;0.0277777777777778;0.472222222222222
Control.SRR15539824;39;40;0.58974358974359;16;23;0.0897435897435898;0.41025641025641
Control.SRR15539824;41;40;0.414634146341463;24;17;0.0853658536585366;0.414634146341463
Control.SRR15539824;42;40;0.428571428571429;24;18;0.0714285714285715;0.428571428571429
Control.SRR15539824;40;40;0.475;21;19;0.025;0.475
Control.SRR15539824;47;40;0.468085106382979;25;22;0.0319148936170213;0.468085106382979
Control.SRR15539824;38;40;0.605263157894737;15;23;0.105263157894737;0.394736842105263
Control.SRR15539824;47;40;0.574468085106383;20;27;0.074468085106383;0.425531914893617
Control.SRR15539824;36;40;0.5;18;18;0;0.5
Control.SRR15539824;44;40;0.590909090909091;18;26;0.0909090909090909;0.409090909090909
Control.SRR15539824;43;40;0.511627906976744;21;22;0.0116279069767442;0.488372093023256
Control.SRR15539824;47;40;0.553191489361702;21;26;0.0531914893617021;0.446808510638298
Control.SRR15539824;46;40;0.5;23;23;0;0.5
Control.SRR15539824;47;40;0.659574468085106;16;31;0.159574468085106;0.340425531914894
Control.SRR15539824;47;40;0.446808510638298;26;21;0.0531914893617021;0.446808510638298
Control.SRR15539824;47;40;0.574468085106383;20;27;0.074468085106383;0.425531914893617
Control.SRR15539824;45;40;0.577777777777778;19;26;0.0777777777777777;0.422222222222222
Control.SRR15539824;42;40;0.523809523809524;20;22;0.0238095238095238;0.476190476190476
Control.SRR15539824;39;40;0.564102564102564;17;22;0.0641025641025641;0.435897435897436
Control.SRR15539824;43;40;0.534883720930233;20;23;0.0348837209302325;0.465116279069767
Control.SRR15539824;38;40;0.631578947368421;14;24;0.131578947368421;0.368421052631579
Control.SRR15539824;36;40;0.5;18;18;0;0.5
Control.SRR15539824;38;40;0.447368421052632;21;17;0.0526315789473684;0.447368421052632
Control.SRR15539824;35;40;0.514285714285714;17;18;0.0142857142857142;0.485714285714286
Control.SRR15539824;42;40;0.571428571428571;18;24;0.0714285714285714;0.428571428571429
Control.SRR15539824;36;40;0.388888888888889;22;14;0.111111111111111;0.388888888888889
Control.SRR15539824;46;40;0.478260869565217;24;22;0.0217391304347826;0.478260869565217
Control.SRR15539824;43;40;0.604651162790698;17;26;0.104651162790698;0.395348837209302
Control.SRR15539824;39;40;0.666666666666667;13;26;0.166666666666667;0.333333333333333
Control.SRR15539824;39;40;0.461538461538462;21;18;0.0384615384615384;0.461538461538462
Control.SRR15539824;35;40;0.6;14;21;0.1;0.4
Control.SRR15539824;39;40;0.461538461538462;21;18;0.0384615384615384;0.461538461538462
Control.SRR15539824;36;40;0.416666666666667;21;15;0.0833333333333333;0.416666666666667
Control.SRR15539824;42;40;0.428571428571429;24;18;0.0714285714285715;0.428571428571429
Control.SRR15539824;37;40;0.486486486486487;19;18;0.0135135135135135;0.486486486486487
Control.SRR15539824;39;40;0.358974358974359;25;14;0.141025641025641;0.358974358974359
Control.SRR15539824;36;40;0.472222222222222;19;17;0.0277777777777778;0.472222222222222
Control.SRR15539824;42;40;0.547619047619048;19;23;0.0476190476190477;0.452380952380952
Control.SRR15539824;38;40;0.631578947368421;14;24;0.131578947368421;0.368421052631579
Control.SRR15539824;35;40;0.485714285714286;18;17;0.0142857142857143;0.485714285714286
Control.SRR15539824;45;40;0.488888888888889;23;22;0.0111111111111111;0.488888888888889
Control.SRR15539824;38;40;0.473684210526316;20;18;0.0263157894736842;0.473684210526316
Control.SRR15539824;37;40;0.540540540540541;17;20;0.0405405405405406;0.459459459459459
Control.SRR15539824;39;40;0.487179487179487;20;19;0.0128205128205128;0.487179487179487
Control.SRR15539824;36;40;0.388888888888889;22;14;0.111111111111111;0.388888888888889
Control.SRR15539824;39;40;0.538461538461538;18;21;0.0384615384615384;0.461538461538462
Control.SRR15539824;47;40;0.425531914893617;27;20;0.074468085106383;0.425531914893617
Control.SRR15539824;37;40;0.486486486486487;19;18;0.0135135135135135;0.486486486486487
Control.SRR15539824;38;40;0.605263157894737;15;23;0.105263157894737;0.394736842105263
Control.SRR15539824;35;40;0.542857142857143;16;19;0.0428571428571428;0.457142857142857
Control.SRR15539824;45;40;0.644444444444444;16;29;0.144444444444444;0.355555555555556
Control.SRR15539824;37;40;0.567567567567568;16;21;0.0675675675675675;0.432432432432432
Control.SRR15539824;36;40;0.583333333333333;15;21;0.0833333333333334;0.416666666666667
Control.SRR15539824;37;40;0.486486486486487;19;18;0.0135135135135135;0.486486486486487
Control.SRR15539824;40;40;0.4;24;16;0.1;0.4
Control.SRR15539824;40;40;0.525;19;21;0.025;0.475
Control.SRR15539824;43;40;0.558139534883721;19;24;0.0581395348837209;0.441860465116279
Control.SRR15539824;41;40;0.390243902439024;25;16;0.109756097560976;0.390243902439024
Control.SRR15539824;36;40;0.472222222222222;19;17;0.0277777777777778;0.472222222222222
Control.SRR15539824;41;40;0.414634146341463;24;17;0.0853658536585366;0.414634146341463
Control.SRR15539824;38;40;0.526315789473684;18;20;0.0263157894736842;0.473684210526316
Control.SRR15539824;36;40;0.5;18;18;0;0.5
Control.SRR15539824;43;40;0.534883720930233;20;23;0.0348837209302325;0.465116279069767
Control.SRR15539824;43;40;0.395348837209302;26;17;0.104651162790698;0.395348837209302
Control.SRR15539824;37;40;0.486486486486487;19;18;0.0135135135135135;0.486486486486487
Control.SRR15539824;42;40;0.571428571428571;18;24;0.0714285714285714;0.428571428571429
Control.SRR15539824;46;40;0.456521739130435;25;21;0.0434782608695652;0.456521739130435
Control.SRR15539824;41;40;0.48780487804878;21;20;0.0121951219512195;0.48780487804878
Control.SRR15539824;40;40;0.45;22;18;0.05;0.45
Control.SRR15539824;37;40;0.513513513513513;18;19;0.0135135135135135;0.486486486486487
Control.SRR15539824;40;40;0.425;23;17;0.075;0.425
Control.SRR15539824;40;40;0.575;17;23;0.075;0.425
Control.SRR15539824;43;40;0.465116279069767;23;20;0.0348837209302326;0.465116279069767
Control.SRR15539824;41;40;0.707317073170732;12;29;0.207317073170732;0.292682926829268
Control.SRR15539824;38;40;0.473684210526316;20;18;0.0263157894736842;0.473684210526316
Control.SRR15539824;37;40;0.351351351351351;24;13;0.148648648648649;0.351351351351351
Control.SRR15539824;39;40;0.615384615384615;15;24;0.115384615384615;0.384615384615385
Control.SRR15539824;40;40;0.55;18;22;0.05;0.45
Control.SRR15539824;38;40;0.552631578947368;17;21;0.0526315789473685;0.447368421052632
Control.SRR15539824;41;40;0.463414634146341;22;19;0.0365853658536585;0.463414634146341
Control.SRR15539824;44;40;0.477272727272727;23;21;0.0227272727272727;0.477272727272727
Control.SRR15539824;40;40;0.525;19;21;0.025;0.475
Control.SRR15539824;42;40;0.5;21;21;0;0.5
Control.SRR15539824;44;40;0.522727272727273;21;23;0.0227272727272727;0.477272727272727
Control.SRR15539824;41;40;0.48780487804878;21;20;0.0121951219512195;0.48780487804878
Control.SRR15539824;42;40;0.428571428571429;24;18;0.0714285714285715;0.428571428571429
Control.SRR15539824;45;40;0.444444444444444;25;20;0.0555555555555556;0.444444444444444
Control.SRR15539824;42;40;0.476190476190476;22;20;0.0238095238095238;0.476190476190476
Control.SRR15539824;37;40;0.432432432432432;21;16;0.0675675675675675;0.432432432432432
Control.SRR15539824;41;40;0.536585365853659;19;22;0.0365853658536586;0.463414634146341
Control.SRR15539824;38;40;0.552631578947368;17;21;0.0526315789473685;0.447368421052632
Control.SRR15539824;39;40;0.461538461538462;21;18;0.0384615384615384;0.461538461538462
Control.SRR15539824;38;40;0.473684210526316;20;18;0.0263157894736842;0.473684210526316
Control.SRR15539824;38;40;0.5;19;19;0;0.5
Control.SRR15539824;40;40;0.375;25;15;0.125;0.375
Control.SRR15539824;39;40;0.564102564102564;17;22;0.0641025641025641;0.435897435897436
Control.SRR15539824;39;40;0.512820512820513;19;20;0.0128205128205128;0.487179487179487
Control.SRR15539824;38;40;0.526315789473684;18;20;0.0263157894736842;0.473684210526316
Control.SRR15539824;40;40;0.425;23;17;0.075;0.425
Control.SRR15539824;35;40;0.371428571428571;22;13;0.128571428571429;0.371428571428571
Control.SRR15539824;46;40;0.5;23;23;0;0.5
Control.SRR15539824;39;40;0.487179487179487;20;19;0.0128205128205128;0.487179487179487
Control.SRR15539824;35;40;0.4;21;14;0.1;0.4
Control.SRR15539824;42;40;0.5;21;21;0;0.5
Control.SRR15539824;35;40;0.514285714285714;17;18;0.0142857142857142;0.485714285714286
Control.SRR15539824;43;40;0.465116279069767;23;20;0.0348837209302326;0.465116279069767
Control.SRR15539824;44;40;0.545454545454545;20;24;0.0454545454545454;0.454545454545455
Control.SRR15539824;40;40;0.5;20;20;0;0.5
Control.SRR15539824;36;40;0.416666666666667;21;15;0.0833333333333333;0.416666666666667
Control.SRR15539824;46;40;0.347826086956522;30;16;0.152173913043478;0.347826086956522
Control.SRR15539824;36;40;0.388888888888889;22;14;0.111111111111111;0.388888888888889
Control.SRR15539824;39;40;0.564102564102564;17;22;0.0641025641025641;0.435897435897436
Control.SRR15539824;40;40;0.425;23;17;0.075;0.425
Control.SRR15539824;41;40;0.48780487804878;21;20;0.0121951219512195;0.48780487804878
Control.SRR15539824;39;40;0.58974358974359;16;23;0.0897435897435898;0.41025641025641
Control.SRR15539824;40;40;0.525;19;21;0.025;0.475
Control.SRR15539824;39;40;0.487179487179487;20;19;0.0128205128205128;0.487179487179487
Control.SRR15539824;46;40;0.456521739130435;25;21;0.0434782608695652;0.456521739130435
Control.SRR15539824;46;40;0.434782608695652;26;20;0.0652173913043478;0.434782608695652
Control.SRR15539824;43;40;0.465116279069767;23;20;0.0348837209302326;0.465116279069767
Control.SRR15539824;43;40;0.558139534883721;19;24;0.0581395348837209;0.441860465116279
Control.SRR15539824;46;40;0.434782608695652;26;20;0.0652173913043478;0.434782608695652
Control.SRR15539824;37;40;0.540540540540541;17;20;0.0405405405405406;0.459459459459459
Control.SRR15539824;35;40;0.542857142857143;16;19;0.0428571428571428;0.457142857142857
Control.SRR15539824;47;40;0.48936170212766;24;23;0.0106382978723404;0.48936170212766
Control.SRR15539824;44;40;0.340909090909091;29;15;0.159090909090909;0.340909090909091
Control.SRR15539824;35;40;0.457142857142857;19;16;0.0428571428571429;0.457142857142857
Control.SRR15539824;42;40;0.476190476190476;22;20;0.0238095238095238;0.476190476190476
Control.SRR15539824;37;40;0.432432432432432;21;16;0.0675675675675675;0.432432432432432
Control.SRR15539824;39;40;0.58974358974359;16;23;0.0897435897435898;0.41025641025641
Control.SRR15539824;44;40;0.522727272727273;21;23;0.0227272727272727;0.477272727272727
Control.SRR15539824;41;40;0.390243902439024;25;16;0.109756097560976;0.390243902439024
Control.SRR15539824;37;40;0.648648648648649;13;24;0.148648648648649;0.351351351351351
Control.SRR15539824;43;40;0.441860465116279;24;19;0.0581395348837209;0.441860465116279
Control.SRR15539824;40;40;0.5;20;20;0;0.5
Control.SRR15539824;45;40;0.577777777777778;19;26;0.0777777777777777;0.422222222222222
Control.SRR15539824;38;40;0.605263157894737;15;23;0.105263157894737;0.394736842105263
Control.SRR15539824;38;40;0.5;19;19;0;0.5
Control.SRR15539824;45;40;0.466666666666667;24;21;0.0333333333333333;0.466666666666667
Control.SRR15539824;42;40;0.428571428571429;24;18;0.0714285714285715;0.428571428571429
Control.SRR15539824;39;40;0.615384615384615;15;24;0.115384615384615;0.384615384615385
Control.SRR15539824;44;40;0.522727272727273;21;23;0.0227272727272727;0.477272727272727
Control.SRR15539824;45;40;0.533333333333333;21;24;0.0333333333333333;0.466666666666667
Control.SRR15539824;41;40;0.463414634146341;22;19;0.0365853658536585;0.463414634146341
Control.SRR15539824;41;40;0.341463414634146;27;14;0.158536585365854;0.341463414634146
Control.SRR15539824;43;40;0.418604651162791;25;18;0.0813953488372093;0.418604651162791
Control.SRR15539824;42;40;0.571428571428571;18;24;0.0714285714285714;0.428571428571429
Control.SRR15539824;43;40;0.627906976744186;16;27;0.127906976744186;0.372093023255814
Control.SRR15539824;39;40;0.487179487179487;20;19;0.0128205128205128;0.487179487179487
Control.SRR15539824;38;40;0.447368421052632;21;17;0.0526315789473684;0.447368421052632
Control.SRR15539824;40;40;0.6;16;24;0.1;0.4
Control.SRR15539824;46;40;0.630434782608696;17;29;0.130434782608696;0.369565217391304
Control.SRR15539824;47;40;0.48936170212766;24;23;0.0106382978723404;0.48936170212766
Control.SRR15539824;37;40;0.540540540540541;17;20;0.0405405405405406;0.459459459459459
Control.SRR15539824;45;40;0.488888888888889;23;22;0.0111111111111111;0.488888888888889
Control.SRR15539824;43;40;0.511627906976744;21;22;0.0116279069767442;0.488372093023256
Control.SRR15539824;43;40;0.674418604651163;14;29;0.174418604651163;0.325581395348837
Control.SRR15539824;42;40;0.30952380952381;29;13;0.19047619047619;0.30952380952381
Control.SRR15539824;40;40;0.575;17;23;0.075;0.425
Control.SRR15539824;44;40;0.454545454545455;24;20;0.0454545454545455;0.454545454545455
Control.SRR15539824;44;40;0.522727272727273;21;23;0.0227272727272727;0.477272727272727
Control.SRR15539824;40;40;0.325;27;13;0.175;0.325
Control.SRR15539824;43;40;0.348837209302326;28;15;0.151162790697674;0.348837209302326
Control.SRR15539824;46;40;0.5;23;23;0;0.5
Control.SRR15539824;43;40;0.534883720930233;20;23;0.0348837209302325;0.465116279069767
Control.SRR15539824;36;40;0.472222222222222;19;17;0.0277777777777778;0.472222222222222
Control.SRR15539824;41;40;0.536585365853659;19;22;0.0365853658536586;0.463414634146341
Control.SRR15539824;41;40;0.585365853658537;17;24;0.0853658536585366;0.414634146341463
Control.SRR15539824;39;40;0.41025641025641;23;16;0.0897435897435898;0.41025641025641
Control.SRR15539824;41;40;0.536585365853659;19;22;0.0365853658536586;0.463414634146341
Control.SRR15539824;42;40;0.595238095238095;17;25;0.0952380952380952;0.404761904761905
Control.SRR15539824;44;40;0.590909090909091;18;26;0.0909090909090909;0.409090909090909
Control.SRR15539824;42;40;0.571428571428571;18;24;0.0714285714285714;0.428571428571429
Control.SRR15539824;44;40;0.5;22;22;0;0.5
Control.SRR15539824;42;40;0.571428571428571;18;24;0.0714285714285714;0.428571428571429
Control.SRR15539824;46;40;0.369565217391304;29;17;0.130434782608696;0.369565217391304
Control.SRR15539824;37;40;0.405405405405405;22;15;0.0945945945945946;0.405405405405405
Control.SRR15539824;35;40;0.542857142857143;16;19;0.0428571428571428;0.457142857142857
Control.SRR15539824;42;40;0.428571428571429;24;18;0.0714285714285715;0.428571428571429
Control.SRR15539824;43;40;0.488372093023256;22;21;0.0116279069767442;0.488372093023256
Control.SRR15539824;43;40;0.465116279069767;23;20;0.0348837209302326;0.465116279069767
Control.SRR15539824;38;40;0.421052631578947;22;16;0.0789473684210527;0.421052631578947
Control.SRR15539824;38;40;0.394736842105263;23;15;0.105263157894737;0.394736842105263
Control.SRR15539824;42;40;0.547619047619048;19;23;0.0476190476190477;0.452380952380952
Control.SRR15539824;43;40;0.488372093023256;22;21;0.0116279069767442;0.488372093023256
Control.SRR15539824;41;40;0.414634146341463;24;17;0.0853658536585366;0.414634146341463
Control.SRR15539824;38;40;0.5;19;19;0;0.5
Control.SRR15539824;39;40;0.58974358974359;16;23;0.0897435897435898;0.41025641025641
Control.SRR15539824;40;40;0.575;17;23;0.075;0.425
Control.SRR15539824;44;40;0.545454545454545;20;24;0.0454545454545454;0.454545454545455
Control.SRR15539824;44;40;0.5;22;22;0;0.5
Control.SRR15539824;42;40;0.547619047619048;19;23;0.0476190476190477;0.452380952380952
Control.SRR15539824;40;40;0.45;22;18;0.05;0.45
Control.SRR15539824;43;40;0.511627906976744;21;22;0.0116279069767442;0.488372093023256
Control.SRR15539824;40;40;0.55;18;22;0.05;0.45
Control.SRR15539824;38;40;0.552631578947368;17;21;0.0526315789473685;0.447368421052632
Control.SRR15539824;42;40;0.642857142857143;15;27;0.142857142857143;0.357142857142857
Control.SRR15539824;46;40;0.565217391304348;20;26;0.0652173913043478;0.434782608695652
Control.SRR15539824;40;40;0.5;20;20;0;0.5
Control.SRR15539824;35;40;0.628571428571429;13;22;0.128571428571429;0.371428571428571
Control.SRR15539824;41;40;0.463414634146341;22;19;0.0365853658536585;0.463414634146341
Control.SRR15539824;43;40;0.534883720930233;20;23;0.0348837209302325;0.465116279069767
Control.SRR15539824;43;40;0.558139534883721;19;24;0.0581395348837209;0.441860465116279
Control.SRR15539824;40;40;0.375;25;15;0.125;0.375
Control.SRR15539824;39;40;0.538461538461538;18;21;0.0384615384615384;0.461538461538462
Control.SRR15539824;41;40;0.463414634146341;22;19;0.0365853658536585;0.463414634146341
Control.SRR15539824;36;40;0.333333333333333;24;12;0.166666666666667;0.333333333333333
Control.SRR15539824;38;40;0.578947368421053;16;22;0.0789473684210527;0.421052631578947
Control.SRR15539824;38;40;0.552631578947368;17;21;0.0526315789473685;0.447368421052632
Control.SRR15539824;47;40;0.425531914893617;27;20;0.074468085106383;0.425531914893617
Control.SRR15539824;41;40;0.585365853658537;17;24;0.0853658536585366;0.414634146341463
Control.SRR15539824;36;40;0.611111111111111;14;22;0.111111111111111;0.388888888888889
Control.SRR15539824;37;40;0.486486486486487;19;18;0.0135135135135135;0.486486486486487
Control.SRR15539824;36;40;0.527777777777778;17;19;0.0277777777777778;0.472222222222222
Control.SRR15539824;38;40;0.526315789473684;18;20;0.0263157894736842;0.473684210526316
Control.SRR15539824;41;40;0.439024390243902;23;18;0.0609756097560976;0.439024390243902
Control.SRR15539824;36;40;0.611111111111111;14;22;0.111111111111111;0.388888888888889
Control.SRR15539824;44;40;0.454545454545455;24;20;0.0454545454545455;0.454545454545455
Control.SRR15539824;35;40;0.371428571428571;22;13;0.128571428571429;0.371428571428571
Control.SRR15539824;36;40;0.666666666666667;12;24;0.166666666666667;0.333333333333333
Control.SRR15539824;40;40;0.5;20;20;0;0.5
Control.SRR15539824;41;40;0.390243902439024;25;16;0.109756097560976;0.390243902439024
Control.SRR15539824;46;40;0.5;23;23;0;0.5
Control.SRR15539824;46;40;0.478260869565217;24;22;0.0217391304347826;0.478260869565217
Control.SRR15539824;41;40;0.463414634146341;22;19;0.0365853658536585;0.463414634146341
Control.SRR15539824;40;40;0.6;16;24;0.1;0.4
Control.SRR15539824;46;40;0.5;23;23;0;0.5
Control.SRR15539824;46;40;0.41304347826087;27;19;0.0869565217391304;0.41304347826087
Control.SRR15539824;42;40;0.523809523809524;20;22;0.0238095238095238;0.476190476190476
Control.SRR15539824;38;40;0.473684210526316;20;18;0.0263157894736842;0.473684210526316
Control.SRR15539824;45;40;0.644444444444444;16;29;0.144444444444444;0.355555555555556
Control.SRR15539824;47;40;0.553191489361702;21;26;0.0531914893617021;0.446808510638298
Control.SRR15539824;42;40;0.523809523809524;20;22;0.0238095238095238;0.476190476190476
Control.SRR15539824;42;40;0.5;21;21;0;0.5
Control.SRR15539824;47;40;0.51063829787234;23;24;0.0106382978723404;0.48936170212766
Control.SRR15539824;39;40;0.487179487179487;20;19;0.0128205128205128;0.487179487179487
Control.SRR15539824;43;40;0.465116279069767;23;20;0.0348837209302326;0.465116279069767
Control.SRR15539824;36;40;0.444444444444444;20;16;0.0555555555555556;0.444444444444444
Control.SRR15539824;41;40;0.585365853658537;17;24;0.0853658536585366;0.414634146341463
Control.SRR15539824;46;40;0.565217391304348;20;26;0.0652173913043478;0.434782608695652
Control.SRR15539824;45;40;0.466666666666667;24;21;0.0333333333333333;0.466666666666667
Control.SRR15539824;36;40;0.388888888888889;22;14;0.111111111111111;0.388888888888889
Control.SRR15539824;39;40;0.41025641025641;23;16;0.0897435897435898;0.41025641025641
Control.SRR15539824;37;40;0.540540540540541;17;20;0.0405405405405406;0.459459459459459
Control.SRR15539824;35;40;0.571428571428571;15;20;0.0714285714285714;0.428571428571429
Control.SRR15539824;36;40;0.361111111111111;23;13;0.138888888888889;0.361111111111111
Control.SRR15539824;36;40;0.555555555555556;16;20;0.0555555555555556;0.444444444444444
Control.SRR15539824;36;40;0.583333333333333;15;21;0.0833333333333334;0.416666666666667
Control.SRR15539824;40;40;0.675;13;27;0.175;0.325
Control.SRR15539824;44;40;0.659090909090909;15;29;0.159090909090909;0.340909090909091
Control.SRR15539824;46;40;0.543478260869565;21;25;0.0434782608695652;0.456521739130435
Control.SRR15539824;44;40;0.295454545454545;31;13;0.204545454545455;0.295454545454545
Control.SRR15539824;40;40;0.55;18;22;0.05;0.45
Control.SRR15539824;36;40;0.527777777777778;17;19;0.0277777777777778;0.472222222222222
Control.SRR15539824;41;40;0.634146341463415;15;26;0.134146341463415;0.365853658536585
Control.SRR15539824;35;40;0.371428571428571;22;13;0.128571428571429;0.371428571428571
Control.SRR15539824;46;40;0.369565217391304;29;17;0.130434782608696;0.369565217391304
Control.SRR15539824;36;40;0.611111111111111;14;22;0.111111111111111;0.388888888888889
Control.SRR15539824;45;40;0.466666666666667;24;21;0.0333333333333333;0.466666666666667
Control.SRR15539824;44;40;0.5;22;22;0;0.5
Control.SRR15539824;40;40;0.325;27;13;0.175;0.325
Control.SRR15539824;45;40;0.466666666666667;24;21;0.0333333333333333;0.466666666666667
Control.SRR15539824;42;40;0.523809523809524;20;22;0.0238095238095238;0.476190476190476
Control.SRR15539824;44;40;0.568181818181818;19;25;0.0681818181818182;0.431818181818182
Control.SRR15539824;37;40;0.432432432432432;21;16;0.0675675675675675;0.432432432432432
Control.SRR15539824;47;40;0.425531914893617;27;20;0.074468085106383;0.425531914893617
Control.SRR15539824;42;40;0.619047619047619;16;26;0.119047619047619;0.380952380952381
Control.SRR15539824;39;40;0.487179487179487;20;19;0.0128205128205128;0.487179487179487
Control.SRR15539824;47;40;0.531914893617021;22;25;0.0319148936170213;0.468085106382979
Control.SRR15539824;37;40;0.540540540540541;17;20;0.0405405405405406;0.459459459459459
Control.SRR15539824;37;40;0.486486486486487;19;18;0.0135135135135135;0.486486486486487
Control.SRR15539824;46;40;0.565217391304348;20;26;0.0652173913043478;0.434782608695652
Control.SRR15539824;47;40;0.638297872340426;17;30;0.138297872340426;0.361702127659574
Control.SRR15539824;42;40;0.404761904761905;25;17;0.0952380952380952;0.404761904761905
Control.SRR15539824;43;40;0.581395348837209;18;25;0.0813953488372093;0.418604651162791
Control.SRR15539824;39;40;0.58974358974359;16;23;0.0897435897435898;0.41025641025641
Control.SRR15539824;36;40;0.416666666666667;21;15;0.0833333333333333;0.416666666666667
Control.SRR15539824;36;40;0.583333333333333;15;21;0.0833333333333334;0.416666666666667
Control.SRR15539824;45;40;0.555555555555556;20;25;0.0555555555555556;0.444444444444444
Control.SRR15539824;38;40;0.394736842105263;23;15;0.105263157894737;0.394736842105263
Control.SRR15539824;41;40;0.658536585365854;14;27;0.158536585365854;0.341463414634146
Control.SRR15539824;43;40;0.465116279069767;23;20;0.0348837209302326;0.465116279069767
Control.SRR15539824;35;40;0.514285714285714;17;18;0.0142857142857142;0.485714285714286
Control.SRR15539824;44;40;0.522727272727273;21;23;0.0227272727272727;0.477272727272727
Control.SRR15539824;45;40;0.577777777777778;19;26;0.0777777777777777;0.422222222222222
Control.SRR15539824;46;40;0.58695652173913;19;27;0.0869565217391305;0.41304347826087
Control.SRR15539824;43;40;0.488372093023256;22;21;0.0116279069767442;0.488372093023256
Control.SRR15539824;43;40;0.465116279069767;23;20;0.0348837209302326;0.465116279069767
Control.SRR15539824;40;40;0.475;21;19;0.025;0.475
Control.SRR15539824;39;40;0.358974358974359;25;14;0.141025641025641;0.358974358974359
Control.SRR15539824;41;40;0.48780487804878;21;20;0.0121951219512195;0.48780487804878
Control.SRR15539824;45;40;0.466666666666667;24;21;0.0333333333333333;0.466666666666667
Control.SRR15539824;41;40;0.48780487804878;21;20;0.0121951219512195;0.48780487804878
Control.SRR15539824;44;40;0.431818181818182;25;19;0.0681818181818182;0.431818181818182
Control.SRR15539824;40;40;0.45;22;18;0.05;0.45
Control.SRR15539824;36;40;0.472222222222222;19;17;0.0277777777777778;0.472222222222222
Control.SRR15539824;37;40;0.405405405405405;22;15;0.0945945945945946;0.405405405405405
Control.SRR15539824;42;40;0.642857142857143;15;27;0.142857142857143;0.357142857142857
Control.SRR15539824;35;40;0.542857142857143;16;19;0.0428571428571428;0.457142857142857
Control.SRR15539824;41;40;0.707317073170732;12;29;0.207317073170732;0.292682926829268
Control.SRR15539824;42;40;0.595238095238095;17;25;0.0952380952380952;0.404761904761905
Control.SRR15539824;42;40;0.619047619047619;16;26;0.119047619047619;0.380952380952381
Control.SRR15539824;37;40;0.459459459459459;20;17;0.0405405405405405;0.459459459459459
Control.SRR15539824;40;40;0.575;17;23;0.075;0.425
Control.SRR15539824;46;40;0.434782608695652;26;20;0.0652173913043478;0.434782608695652
Control.SRR15539824;45;40;0.466666666666667;24;21;0.0333333333333333;0.466666666666667
Control.SRR15539824;38;40;0.394736842105263;23;15;0.105263157894737;0.394736842105263
Control.SRR15539824;36;40;0.555555555555556;16;20;0.0555555555555556;0.444444444444444
Control.SRR15539824;40;40;0.6;16;24;0.1;0.4
Control.SRR15539824;43;40;0.395348837209302;26;17;0.104651162790698;0.395348837209302
Control.SRR15539824;37;40;0.621621621621622;14;23;0.121621621621622;0.378378378378378
Control.SRR15539824;39;40;0.615384615384615;15;24;0.115384615384615;0.384615384615385
Control.SRR15539824;45;40;0.644444444444444;16;29;0.144444444444444;0.355555555555556
Control.SRR15539824;36;40;0.5;18;18;0;0.5
Control.SRR15539824;41;40;0.560975609756098;18;23;0.0609756097560976;0.439024390243902
Control.SRR15539824;45;40;0.511111111111111;22;23;0.0111111111111111;0.488888888888889
Control.SRR15539824;46;40;0.521739130434783;22;24;0.0217391304347826;0.478260869565217
Control.SRR15539824;39;40;0.461538461538462;21;18;0.0384615384615384;0.461538461538462
Control.SRR15539824;39;40;0.538461538461538;18;21;0.0384615384615384;0.461538461538462
Control.SRR15539824;36;40;0.361111111111111;23;13;0.138888888888889;0.361111111111111
Control.SRR15539824;45;40;0.555555555555556;20;25;0.0555555555555556;0.444444444444444
Control.SRR15539824;41;40;0.390243902439024;25;16;0.109756097560976;0.390243902439024
Control.SRR15539824;39;40;0.538461538461538;18;21;0.0384615384615384;0.461538461538462
Control.SRR15539824;43;40;0.465116279069767;23;20;0.0348837209302326;0.465116279069767
Control.SRR15539824;37;40;0.432432432432432;21;16;0.0675675675675675;0.432432432432432
Control.SRR15539824;37;40;0.459459459459459;20;17;0.0405405405405405;0.459459459459459
Control.SRR15539824;44;40;0.363636363636364;28;16;0.136363636363636;0.363636363636364
Control.SRR15539824;37;40;0.648648648648649;13;24;0.148648648648649;0.351351351351351
Control.SRR15539824;41;40;0.414634146341463;24;17;0.0853658536585366;0.414634146341463
Control.SRR15539824;42;40;0.452380952380952;23;19;0.0476190476190476;0.452380952380952
Control.SRR15539824;47;40;0.468085106382979;25;22;0.0319148936170213;0.468085106382979
Control.SRR15539824;35;40;0.457142857142857;19;16;0.0428571428571429;0.457142857142857
Control.SRR15539824;47;40;0.468085106382979;25;22;0.0319148936170213;0.468085106382979
Control.SRR15539824;45;40;0.533333333333333;21;24;0.0333333333333333;0.466666666666667
Control.SRR15539824;45;40;0.6;18;27;0.1;0.4
Control.SRR15539824;46;40;0.521739130434783;22;24;0.0217391304347826;0.478260869565217
Control.SRR15539824;44;40;0.454545454545455;24;20;0.0454545454545455;0.454545454545455
Control.SRR15539824;47;40;0.468085106382979;25;22;0.0319148936170213;0.468085106382979
Control.SRR15539824;43;40;0.604651162790698;17;26;0.104651162790698;0.395348837209302
Control.SRR15539824;44;40;0.545454545454545;20;24;0.0454545454545454;0.454545454545455
Control.SRR15539824;38;40;0.421052631578947;22;16;0.0789473684210527;0.421052631578947
Control.SRR15539824;39;40;0.512820512820513;19;20;0.0128205128205128;0.487179487179487
Control.SRR15539824;41;40;0.48780487804878;21;20;0.0121951219512195;0.48780487804878
Control.SRR15539824;43;40;0.441860465116279;24;19;0.0581395348837209;0.441860465116279
Control.SRR15539824;42;40;0.547619047619048;19;23;0.0476190476190477;0.452380952380952
Control.SRR15539824;38;40;0.657894736842105;13;25;0.157894736842105;0.342105263157895
Control.SRR15539824;37;40;0.486486486486487;19;18;0.0135135135135135;0.486486486486487
Control.SRR15539824;39;40;0.41025641025641;23;16;0.0897435897435898;0.41025641025641
Control.SRR15539824;39;40;0.333333333333333;26;13;0.166666666666667;0.333333333333333
Control.SRR15539824;43;40;0.534883720930233;20;23;0.0348837209302325;0.465116279069767
Control.SRR15539824;43;40;0.27906976744186;31;12;0.22093023255814;0.27906976744186
Control.SRR15539824;43;40;0.534883720930233;20;23;0.0348837209302325;0.465116279069767
Control.SRR15539824;42;40;0.333333333333333;28;14;0.166666666666667;0.333333333333333
Control.SRR15539824;37;40;0.540540540540541;17;20;0.0405405405405406;0.459459459459459
Control.SRR15539824;46;40;0.58695652173913;19;27;0.0869565217391305;0.41304347826087
Control.SRR15539824;43;40;0.372093023255814;27;16;0.127906976744186;0.372093023255814
Control.SRR15539824;37;40;0.459459459459459;20;17;0.0405405405405405;0.459459459459459
Control.SRR15539824;42;40;0.357142857142857;27;15;0.142857142857143;0.357142857142857
Control.SRR15539824;40;40;0.45;22;18;0.05;0.45
Control.SRR15539824;44;40;0.545454545454545;20;24;0.0454545454545454;0.454545454545455
Control.SRR15539824;45;40;0.511111111111111;22;23;0.0111111111111111;0.488888888888889
Control.SRR15539824;39;40;0.615384615384615;15;24;0.115384615384615;0.384615384615385
Control.SRR15539824;39;40;0.461538461538462;21;18;0.0384615384615384;0.461538461538462
Control.SRR15539824;38;40;0.394736842105263;23;15;0.105263157894737;0.394736842105263
Control.SRR15539824;40;40;0.5;20;20;0;0.5
Control.SRR15539824;36;40;0.583333333333333;15;21;0.0833333333333334;0.416666666666667
Control.SRR15539824;36;40;0.416666666666667;21;15;0.0833333333333333;0.416666666666667
Control.SRR15539824;42;40;0.5;21;21;0;0.5
Control.SRR15539824;36;40;0.444444444444444;20;16;0.0555555555555556;0.444444444444444
Control.SRR15539824;45;40;0.577777777777778;19;26;0.0777777777777777;0.422222222222222
Control.SRR15539824;38;40;0.552631578947368;17;21;0.0526315789473685;0.447368421052632
Control.SRR15539824;37;40;0.648648648648649;13;24;0.148648648648649;0.351351351351351
Control.SRR15539824;40;40;0.55;18;22;0.05;0.45
Control.SRR15539824;46;40;0.456521739130435;25;21;0.0434782608695652;0.456521739130435
Control.SRR15539824;44;40;0.522727272727273;21;23;0.0227272727272727;0.477272727272727
Control.SRR15539824;47;40;0.361702127659574;30;17;0.138297872340426;0.361702127659574
Control.SRR15539824;43;40;0.465116279069767;23;20;0.0348837209302326;0.465116279069767
Control.SRR15539824;44;40;0.409090909090909;26;18;0.0909090909090909;0.409090909090909
Control.SRR15539824;45;40;0.422222222222222;26;19;0.0777777777777778;0.422222222222222
Control.SRR15539824;43;40;0.465116279069767;23;20;0.0348837209302326;0.465116279069767
Control.SRR15539824;36;40;0.472222222222222;19;17;0.0277777777777778;0.472222222222222
Control.SRR15539824;40;40;0.475;21;19;0.025;0.475
Control.SRR15539824;36;40;0.583333333333333;15;21;0.0833333333333334;0.416666666666667
Control.SRR15539824;35;40;0.257142857142857;26;9;0.242857142857143;0.257142857142857
Control.SRR15539824;35;40;0.514285714285714;17;18;0.0142857142857142;0.485714285714286
Control.SRR15539824;47;40;0.595744680851064;19;28;0.0957446808510638;0.404255319148936
Control.SRR15539824;43;40;0.511627906976744;21;22;0.0116279069767442;0.488372093023256
Control.SRR15539824;39;40;0.512820512820513;19;20;0.0128205128205128;0.487179487179487
Control.SRR15539824;36;40;0.361111111111111;23;13;0.138888888888889;0.361111111111111
Control.SRR15539824;41;40;0.634146341463415;15;26;0.134146341463415;0.365853658536585
Control.SRR15539824;39;40;0.487179487179487;20;19;0.0128205128205128;0.487179487179487
Control.SRR15539824;42;40;0.404761904761905;25;17;0.0952380952380952;0.404761904761905
Control.SRR15539824;43;40;0.581395348837209;18;25;0.0813953488372093;0.418604651162791
Control.SRR15539824;44;40;0.5;22;22;0;0.5
Control.SRR15539824;46;40;0.521739130434783;22;24;0.0217391304347826;0.478260869565217
Control.SRR15539824;43;40;0.488372093023256;22;21;0.0116279069767442;0.488372093023256
Control.SRR15539824;38;40;0.447368421052632;21;17;0.0526315789473684;0.447368421052632
Control.SRR15539824;37;40;0.405405405405405;22;15;0.0945945945945946;0.405405405405405
Control.SRR15539824;41;40;0.341463414634146;27;14;0.158536585365854;0.341463414634146
Control.SRR15539824;38;40;0.394736842105263;23;15;0.105263157894737;0.394736842105263
Control.SRR15539824;47;40;0.51063829787234;23;24;0.0106382978723404;0.48936170212766
Control.SRR15539824;45;40;0.6;18;27;0.1;0.4
Control.SRR15539824;40;40;0.55;18;22;0.05;0.45
Control.SRR15539824;44;40;0.409090909090909;26;18;0.0909090909090909;0.409090909090909
Control.SRR15539824;41;40;0.536585365853659;19;22;0.0365853658536586;0.463414634146341
Control.SRR15539824;41;40;0.609756097560976;16;25;0.109756097560976;0.390243902439024
Control.SRR15539824;47;40;0.574468085106383;20;27;0.074468085106383;0.425531914893617
Control.SRR15539824;43;40;0.348837209302326;28;15;0.151162790697674;0.348837209302326
Control.SRR15539824;37;40;0.513513513513513;18;19;0.0135135135135135;0.486486486486487
Control.SRR15539824;36;40;0.527777777777778;17;19;0.0277777777777778;0.472222222222222
Control.SRR15539824;36;40;0.416666666666667;21;15;0.0833333333333333;0.416666666666667
Control.SRR15539824;47;40;0.468085106382979;25;22;0.0319148936170213;0.468085106382979
Control.SRR15539824;42;40;0.452380952380952;23;19;0.0476190476190476;0.452380952380952
Control.SRR15539824;40;40;0.425;23;17;0.075;0.425
Control.SRR15539824;38;40;0.552631578947368;17;21;0.0526315789473685;0.447368421052632
Control.SRR15539824;41;40;0.560975609756098;18;23;0.0609756097560976;0.439024390243902
Control.SRR15539824;40;40;0.4;24;16;0.1;0.4
Control.SRR15539824;44;40;0.386363636363636;27;17;0.113636363636364;0.386363636363636
Control.SRR15539824;47;40;0.425531914893617;27;20;0.074468085106383;0.425531914893617
Control.SRR15539824;45;40;0.377777777777778;28;17;0.122222222222222;0.377777777777778
Control.SRR15539824;39;40;0.487179487179487;20;19;0.0128205128205128;0.487179487179487
Control.SRR15539824;42;40;0.547619047619048;19;23;0.0476190476190477;0.452380952380952
Control.SRR15539824;42;40;0.5;21;21;0;0.5
Control.SRR15539824;42;40;0.571428571428571;18;24;0.0714285714285714;0.428571428571429
Control.SRR15539824;47;40;0.404255319148936;28;19;0.0957446808510639;0.404255319148936
Control.SRR15539824;43;40;0.534883720930233;20;23;0.0348837209302325;0.465116279069767
Control.SRR15539824;35;40;0.514285714285714;17;18;0.0142857142857142;0.485714285714286
Control.SRR15539824;45;40;0.466666666666667;24;21;0.0333333333333333;0.466666666666667
Control.SRR15539824;42;40;0.595238095238095;17;25;0.0952380952380952;0.404761904761905
Control.SRR15539824;45;40;0.422222222222222;26;19;0.0777777777777778;0.422222222222222
Control.SRR15539824;45;40;0.533333333333333;21;24;0.0333333333333333;0.466666666666667
Control.SRR15539824;43;40;0.511627906976744;21;22;0.0116279069767442;0.488372093023256
Control.SRR15539824;36;40;0.638888888888889;13;23;0.138888888888889;0.361111111111111
Control.SRR15539824;47;40;0.446808510638298;26;21;0.0531914893617021;0.446808510638298
Control.SRR15539824;44;40;0.522727272727273;21;23;0.0227272727272727;0.477272727272727
Control.SRR15539824;40;40;0.625;15;25;0.125;0.375
Control.SRR15539824;45;40;0.577777777777778;19;26;0.0777777777777777;0.422222222222222
Control.SRR15539824;44;40;0.522727272727273;21;23;0.0227272727272727;0.477272727272727
Control.SRR15539824;44;40;0.545454545454545;20;24;0.0454545454545454;0.454545454545455
Control.SRR15539824;44;40;0.5;22;22;0;0.5
Control.SRR15539824;37;40;0.486486486486487;19;18;0.0135135135135135;0.486486486486487
Control.SRR15539824;40;40;0.475;21;19;0.025;0.475
Control.SRR15539824;38;40;0.473684210526316;20;18;0.0263157894736842;0.473684210526316
Control.SRR15539824;35;40;0.485714285714286;18;17;0.0142857142857143;0.485714285714286
Control.SRR15539824;39;40;0.512820512820513;19;20;0.0128205128205128;0.487179487179487
Control.SRR15539824;38;40;0.447368421052632;21;17;0.0526315789473684;0.447368421052632
Control.SRR15539824;40;40;0.425;23;17;0.075;0.425
Control.SRR15539824;39;40;0.487179487179487;20;19;0.0128205128205128;0.487179487179487
Control.SRR15539824;44;40;0.386363636363636;27;17;0.113636363636364;0.386363636363636
Control.SRR15539824;46;40;0.478260869565217;24;22;0.0217391304347826;0.478260869565217
Control.SRR15539824;37;40;0.513513513513513;18;19;0.0135135135135135;0.486486486486487
Control.SRR15539824;43;40;0.418604651162791;25;18;0.0813953488372093;0.418604651162791
Control.SRR15539824;43;40;0.465116279069767;23;20;0.0348837209302326;0.465116279069767
Control.SRR15539824;36;40;0.416666666666667;21;15;0.0833333333333333;0.416666666666667
Control.SRR15539824;42;40;0.666666666666667;14;28;0.166666666666667;0.333333333333333
Control.SRR15539824;39;40;0.538461538461538;18;21;0.0384615384615384;0.461538461538462
Control.SRR15539824;37;40;0.567567567567568;16;21;0.0675675675675675;0.432432432432432
Control.SRR15539824;41;40;0.48780487804878;21;20;0.0121951219512195;0.48780487804878
Control.SRR15539824;46;40;0.456521739130435;25;21;0.0434782608695652;0.456521739130435
Control.SRR15539824;35;40;0.428571428571429;20;15;0.0714285714285715;0.428571428571429
Control.SRR15539824;44;40;0.568181818181818;19;25;0.0681818181818182;0.431818181818182
Control.SRR15539824;45;40;0.466666666666667;24;21;0.0333333333333333;0.466666666666667
Control.SRR15539824;41;40;0.585365853658537;17;24;0.0853658536585366;0.414634146341463
Control.SRR15539824;44;40;0.613636363636364;17;27;0.113636363636364;0.386363636363636
Control.SRR15539824;47;40;0.531914893617021;22;25;0.0319148936170213;0.468085106382979
Control.SRR15539824;41;40;0.682926829268293;13;28;0.182926829268293;0.317073170731707
Control.SRR15539824;45;40;0.466666666666667;24;21;0.0333333333333333;0.466666666666667
Control.SRR15539824;40;40;0.5;20;20;0;0.5
Control.SRR15539824;36;40;0.472222222222222;19;17;0.0277777777777778;0.472222222222222
Control.SRR15539824;43;40;0.511627906976744;21;22;0.0116279069767442;0.488372093023256
Control.SRR15539824;42;40;0.5;21;21;0;0.5
Control.SRR15539824;45;40;0.444444444444444;25;20;0.0555555555555556;0.444444444444444
Control.SRR15539824;41;40;0.48780487804878;21;20;0.0121951219512195;0.48780487804878
Control.SRR15539824;37;40;0.432432432432432;21;16;0.0675675675675675;0.432432432432432
Control.SRR15539824;41;40;0.463414634146341;22;19;0.0365853658536585;0.463414634146341
Control.SRR15539824;40;40;0.45;22;18;0.05;0.45
Control.SRR15539824;47;40;0.425531914893617;27;20;0.074468085106383;0.425531914893617
Control.SRR15539824;44;40;0.454545454545455;24;20;0.0454545454545455;0.454545454545455
Control.SRR15539824;41;40;0.463414634146341;22;19;0.0365853658536585;0.463414634146341
Control.SRR15539824;42;40;0.5;21;21;0;0.5
Control.SRR15539824;37;40;0.594594594594595;15;22;0.0945945945945946;0.405405405405405
Control.SRR15539824;39;40;0.435897435897436;22;17;0.0641025641025641;0.435897435897436
Control.SRR15539824;43;40;0.627906976744186;16;27;0.127906976744186;0.372093023255814
Control.SRR15539824;45;40;0.577777777777778;19;26;0.0777777777777777;0.422222222222222
Control.SRR15539824;41;40;0.48780487804878;21;20;0.0121951219512195;0.48780487804878
Control.SRR15539824;46;40;0.5;23;23;0;0.5
Control.SRR15539824;47;40;0.617021276595745;18;29;0.117021276595745;0.382978723404255
Control.SRR15539824;44;40;0.613636363636364;17;27;0.113636363636364;0.386363636363636
Control.SRR15539824;45;40;0.511111111111111;22;23;0.0111111111111111;0.488888888888889
Control.SRR15539824;44;40;0.522727272727273;21;23;0.0227272727272727;0.477272727272727
Control.SRR15539824;39;40;0.461538461538462;21;18;0.0384615384615384;0.461538461538462
Control.SRR15539824;39;40;0.564102564102564;17;22;0.0641025641025641;0.435897435897436
Control.SRR15539824;42;40;0.404761904761905;25;17;0.0952380952380952;0.404761904761905
Control.SRR15539824;38;40;0.447368421052632;21;17;0.0526315789473684;0.447368421052632
Control.SRR15539824;44;40;0.477272727272727;23;21;0.0227272727272727;0.477272727272727
Control.SRR15539824;46;40;0.521739130434783;22;24;0.0217391304347826;0.478260869565217
Control.SRR15539824;37;40;0.459459459459459;20;17;0.0405405405405405;0.459459459459459
Control.SRR15539824;38;40;0.657894736842105;13;25;0.157894736842105;0.342105263157895
Control.SRR15539824;47;40;0.51063829787234;23;24;0.0106382978723404;0.48936170212766
Control.SRR15539824;41;40;0.51219512195122;20;21;0.0121951219512195;0.48780487804878
Control.SRR15539824;46;40;0.630434782608696;17;29;0.130434782608696;0.369565217391304
Control.SRR15539824;43;40;0.465116279069767;23;20;0.0348837209302326;0.465116279069767
Control.SRR15539824;44;40;0.5;22;22;0;0.5
Control.SRR15539824;35;40;0.514285714285714;17;18;0.0142857142857142;0.485714285714286
Control.SRR15539824;35;40;0.485714285714286;18;17;0.0142857142857143;0.485714285714286
Control.SRR15539824;43;40;0.465116279069767;23;20;0.0348837209302326;0.465116279069767
Control.SRR15539824;43;40;0.581395348837209;18;25;0.0813953488372093;0.418604651162791
Control.SRR15539824;46;40;0.456521739130435;25;21;0.0434782608695652;0.456521739130435
Control.SRR15539824;45;40;0.4;27;18;0.1;0.4
Control.SRR15539824;36;40;0.555555555555556;16;20;0.0555555555555556;0.444444444444444
Control.SRR15539824;46;40;0.456521739130435;25;21;0.0434782608695652;0.456521739130435
Control.SRR15539824;38;40;0.447368421052632;21;17;0.0526315789473684;0.447368421052632
Control.SRR15539824;43;40;0.674418604651163;14;29;0.174418604651163;0.325581395348837
Control.SRR15539824;39;40;0.435897435897436;22;17;0.0641025641025641;0.435897435897436
Control.SRR15539824;43;40;0.511627906976744;21;22;0.0116279069767442;0.488372093023256
Control.SRR15539824;43;40;0.465116279069767;23;20;0.0348837209302326;0.465116279069767
Control.SRR15539824;40;40;0.65;14;26;0.15;0.35
Control.SRR15539824;42;40;0.452380952380952;23;19;0.0476190476190476;0.452380952380952
Control.SRR15539824;36;40;0.555555555555556;16;20;0.0555555555555556;0.444444444444444
Control.SRR15539824;39;40;0.461538461538462;21;18;0.0384615384615384;0.461538461538462
Control.SRR15539824;37;40;0.540540540540541;17;20;0.0405405405405406;0.459459459459459
Control.SRR15539824;35;40;0.542857142857143;16;19;0.0428571428571428;0.457142857142857
Control.SRR15539824;44;40;0.386363636363636;27;17;0.113636363636364;0.386363636363636
Control.SRR15539824;45;40;0.511111111111111;22;23;0.0111111111111111;0.488888888888889
Control.SRR15539824;39;40;0.538461538461538;18;21;0.0384615384615384;0.461538461538462
Control.SRR15539824;45;40;0.488888888888889;23;22;0.0111111111111111;0.488888888888889
Control.SRR15539824;42;40;0.523809523809524;20;22;0.0238095238095238;0.476190476190476
Control.SRR15539824;43;40;0.488372093023256;22;21;0.0116279069767442;0.488372093023256
Control.SRR15539824;44;40;0.613636363636364;17;27;0.113636363636364;0.386363636363636
Control.SRR15539824;46;40;0.5;23;23;0;0.5
Control.SRR15539824;35;40;0.571428571428571;15;20;0.0714285714285714;0.428571428571429
Control.SRR15539824;45;40;0.333333333333333;30;15;0.166666666666667;0.333333333333333
Control.SRR15539824;36;40;0.611111111111111;14;22;0.111111111111111;0.388888888888889
Control.SRR15539824;39;40;0.615384615384615;15;24;0.115384615384615;0.384615384615385
Control.SRR15539824;41;40;0.585365853658537;17;24;0.0853658536585366;0.414634146341463
Control.SRR15539824;35;40;0.6;14;21;0.1;0.4
Control.SRR15539824;35;40;0.428571428571429;20;15;0.0714285714285715;0.428571428571429
Control.SRR15539824;45;40;0.577777777777778;19;26;0.0777777777777777;0.422222222222222
Control.SRR15539824;44;40;0.522727272727273;21;23;0.0227272727272727;0.477272727272727
Control.SRR15539824;41;40;0.48780487804878;21;20;0.0121951219512195;0.48780487804878
Control.SRR15539824;44;40;0.454545454545455;24;20;0.0454545454545455;0.454545454545455
Control.SRR15539824;44;40;0.545454545454545;20;24;0.0454545454545454;0.454545454545455
Control.SRR15539824;37;40;0.459459459459459;20;17;0.0405405405405405;0.459459459459459
Control.SRR15539824;45;40;0.511111111111111;22;23;0.0111111111111111;0.488888888888889
Control.SRR15539824;46;40;0.369565217391304;29;17;0.130434782608696;0.369565217391304
Control.SRR15539824;43;40;0.465116279069767;23;20;0.0348837209302326;0.465116279069767
Control.SRR15539824;44;40;0.590909090909091;18;26;0.0909090909090909;0.409090909090909
Control.SRR15539824;40;40;0.525;19;21;0.025;0.475
Control.SRR15539824;43;40;0.534883720930233;20;23;0.0348837209302325;0.465116279069767
Control.SRR15539824;38;40;0.421052631578947;22;16;0.0789473684210527;0.421052631578947
Control.SRR15539824;45;40;0.422222222222222;26;19;0.0777777777777778;0.422222222222222
Control.SRR15539824;39;40;0.538461538461538;18;21;0.0384615384615384;0.461538461538462
Control.SRR15539824;35;40;0.571428571428571;15;20;0.0714285714285714;0.428571428571429
Control.SRR15539824;36;40;0.555555555555556;16;20;0.0555555555555556;0.444444444444444
Control.SRR15539824;45;40;0.466666666666667;24;21;0.0333333333333333;0.466666666666667
Control.SRR15539824;40;40;0.575;17;23;0.075;0.425
Control.SRR15539824;41;40;0.536585365853659;19;22;0.0365853658536586;0.463414634146341
Control.SRR15539824;43;40;0.581395348837209;18;25;0.0813953488372093;0.418604651162791
Control.SRR15539824;43;40;0.744186046511628;11;32;0.244186046511628;0.255813953488372
Control.SRR15539824;44;40;0.5;22;22;0;0.5
Control.SRR15539824;37;40;0.405405405405405;22;15;0.0945945945945946;0.405405405405405
Control.SRR15539824;43;40;0.558139534883721;19;24;0.0581395348837209;0.441860465116279
Control.SRR15539824;42;40;0.523809523809524;20;22;0.0238095238095238;0.476190476190476
Control.SRR15539824;45;40;0.488888888888889;23;22;0.0111111111111111;0.488888888888889
Control.SRR15539824;46;40;0.630434782608696;17;29;0.130434782608696;0.369565217391304
Control.SRR15539824;40;40;0.55;18;22;0.05;0.45
Control.SRR15539824;43;40;0.488372093023256;22;21;0.0116279069767442;0.488372093023256
Control.SRR15539824;41;40;0.707317073170732;12;29;0.207317073170732;0.292682926829268
Control.SRR15539824;41;40;0.365853658536585;26;15;0.134146341463415;0.365853658536585
Control.SRR15539824;37;40;0.648648648648649;13;24;0.148648648648649;0.351351351351351
Control.SRR15539824;40;40;0.55;18;22;0.05;0.45
Control.SRR15539824;36;40;0.527777777777778;17;19;0.0277777777777778;0.472222222222222
Control.SRR15539824;47;40;0.51063829787234;23;24;0.0106382978723404;0.48936170212766
Control.SRR15539824;44;40;0.477272727272727;23;21;0.0227272727272727;0.477272727272727
Control.SRR15539824;41;40;0.439024390243902;23;18;0.0609756097560976;0.439024390243902
Control.SRR15539824;38;40;0.526315789473684;18;20;0.0263157894736842;0.473684210526316
Control.SRR15539824;39;40;0.538461538461538;18;21;0.0384615384615384;0.461538461538462
Control.SRR15539824;46;40;0.347826086956522;30;16;0.152173913043478;0.347826086956522
Control.SRR15539824;38;40;0.552631578947368;17;21;0.0526315789473685;0.447368421052632
Control.SRR15539824;44;40;0.5;22;22;0;0.5
Control.SRR15539824;38;40;0.473684210526316;20;18;0.0263157894736842;0.473684210526316
Control.SRR15539824;35;40;0.428571428571429;20;15;0.0714285714285715;0.428571428571429
Control.SRR15539824;37;40;0.621621621621622;14;23;0.121621621621622;0.378378378378378
Control.SRR15539824;43;40;0.511627906976744;21;22;0.0116279069767442;0.488372093023256
Control.SRR15539824;37;40;0.486486486486487;19;18;0.0135135135135135;0.486486486486487
Control.SRR15539824;37;40;0.540540540540541;17;20;0.0405405405405406;0.459459459459459
Control.SRR15539824;36;40;0.555555555555556;16;20;0.0555555555555556;0.444444444444444
Control.SRR15539824;45;40;0.4;27;18;0.1;0.4
Control.SRR15539824;37;40;0.540540540540541;17;20;0.0405405405405406;0.459459459459459
Control.SRR15539824;46;40;0.41304347826087;27;19;0.0869565217391304;0.41304347826087
Control.SRR15539824;36;40;0.527777777777778;17;19;0.0277777777777778;0.472222222222222
Control.SRR15539824;43;40;0.418604651162791;25;18;0.0813953488372093;0.418604651162791
Control.SRR15539824;42;40;0.523809523809524;20;22;0.0238095238095238;0.476190476190476
Control.SRR15539824;41;40;0.439024390243902;23;18;0.0609756097560976;0.439024390243902
Control.SRR15539824;44;40;0.636363636363636;16;28;0.136363636363636;0.363636363636364
Control.SRR15539824;42;40;0.452380952380952;23;19;0.0476190476190476;0.452380952380952
Control.SRR15539824;38;40;0.631578947368421;14;24;0.131578947368421;0.368421052631579
Control.SRR15539824;36;40;0.527777777777778;17;19;0.0277777777777778;0.472222222222222
Control.SRR15539824;35;40;0.6;14;21;0.1;0.4
Control.SRR15539824;38;40;0.552631578947368;17;21;0.0526315789473685;0.447368421052632
Control.SRR15539824;35;40;0.342857142857143;23;12;0.157142857142857;0.342857142857143
Control.SRR15539824;46;40;0.630434782608696;17;29;0.130434782608696;0.369565217391304
Control.SRR15539824;40;40;0.475;21;19;0.025;0.475
Control.SRR15539824;38;40;0.552631578947368;17;21;0.0526315789473685;0.447368421052632
Control.SRR15539824;43;40;0.372093023255814;27;16;0.127906976744186;0.372093023255814
Control.SRR15539824;47;40;0.48936170212766;24;23;0.0106382978723404;0.48936170212766
Control.SRR15539824;41;40;0.463414634146341;22;19;0.0365853658536585;0.463414634146341
Control.SRR15539824;46;40;0.543478260869565;21;25;0.0434782608695652;0.456521739130435
Control.SRR15539824;37;40;0.567567567567568;16;21;0.0675675675675675;0.432432432432432
Control.SRR15539824;39;40;0.41025641025641;23;16;0.0897435897435898;0.41025641025641
Control.SRR15539824;46;40;0.478260869565217;24;22;0.0217391304347826;0.478260869565217
Control.SRR15539824;37;40;0.459459459459459;20;17;0.0405405405405405;0.459459459459459
Control.SRR15539824;39;40;0.58974358974359;16;23;0.0897435897435898;0.41025641025641
Control.SRR15539824;42;40;0.452380952380952;23;19;0.0476190476190476;0.452380952380952
Control.SRR15539824;47;40;0.468085106382979;25;22;0.0319148936170213;0.468085106382979
Control.SRR15539824;44;40;0.409090909090909;26;18;0.0909090909090909;0.409090909090909
Control.SRR15539824;43;40;0.534883720930233;20;23;0.0348837209302325;0.465116279069767
Control.SRR15539824;46;40;0.5;23;23;0;0.5
Control.SRR15539824;45;40;0.555555555555556;20;25;0.0555555555555556;0.444444444444444
Control.SRR15539824;44;40;0.431818181818182;25;19;0.0681818181818182;0.431818181818182
Control.SRR15539824;43;40;0.418604651162791;25;18;0.0813953488372093;0.418604651162791
Control.SRR15539824;40;40;0.475;21;19;0.025;0.475
Control.SRR15539824;38;40;0.5;19;19;0;0.5
Control.SRR15539824;36;40;0.472222222222222;19;17;0.0277777777777778;0.472222222222222
Control.SRR15539824;42;40;0.547619047619048;19;23;0.0476190476190477;0.452380952380952
Control.SRR15539824;39;40;0.487179487179487;20;19;0.0128205128205128;0.487179487179487
Control.SRR15539824;39;40;0.538461538461538;18;21;0.0384615384615384;0.461538461538462
Control.SRR15539824;37;40;0.567567567567568;16;21;0.0675675675675675;0.432432432432432
Control.SRR15539824;40;40;0.525;19;21;0.025;0.475
Control.SRR15539824;40;40;0.575;17;23;0.075;0.425
Control.SRR15539824;36;40;0.555555555555556;16;20;0.0555555555555556;0.444444444444444
Control.SRR15539824;42;40;0.571428571428571;18;24;0.0714285714285714;0.428571428571429
Control.SRR15539824;38;40;0.526315789473684;18;20;0.0263157894736842;0.473684210526316
Control.SRR15539824;34;40;0.382352941176471;21;13;0.117647058823529;0.382352941176471
Control.SRR15539824;41;40;0.48780487804878;21;20;0.0121951219512195;0.48780487804878
Control.SRR15539824;35;40;0.571428571428571;15;20;0.0714285714285714;0.428571428571429
Control.SRR15539824;35;40;0.428571428571429;20;15;0.0714285714285715;0.428571428571429
Control.SRR15539824;35;40;0.457142857142857;19;16;0.0428571428571429;0.457142857142857
Control.SRR15539824;44;40;0.477272727272727;23;21;0.0227272727272727;0.477272727272727
Control.SRR15539824;43;40;0.604651162790698;17;26;0.104651162790698;0.395348837209302
Control.SRR15539824;39;40;0.435897435897436;22;17;0.0641025641025641;0.435897435897436
Control.SRR15539824;42;40;0.571428571428571;18;24;0.0714285714285714;0.428571428571429
Control.SRR15539824;40;40;0.4;24;16;0.1;0.4
Control.SRR15539824;40;40;0.35;26;14;0.15;0.35
Control.SRR15539824;42;40;0.5;21;21;0;0.5
Control.SRR15539824;39;40;0.538461538461538;18;21;0.0384615384615384;0.461538461538462
Control.SRR15539824;42;40;0.547619047619048;19;23;0.0476190476190477;0.452380952380952
Control.SRR15539824;36;40;0.416666666666667;21;15;0.0833333333333333;0.416666666666667
Control.SRR15539824;36;40;0.555555555555556;16;20;0.0555555555555556;0.444444444444444
Control.SRR15539824;39;40;0.564102564102564;17;22;0.0641025641025641;0.435897435897436
Control.SRR15539824;41;40;0.609756097560976;16;25;0.109756097560976;0.390243902439024
Control.SRR15539824;36;40;0.416666666666667;21;15;0.0833333333333333;0.416666666666667
Control.SRR15539824;41;40;0.439024390243902;23;18;0.0609756097560976;0.439024390243902
Control.SRR15539824;37;40;0.567567567567568;16;21;0.0675675675675675;0.432432432432432
Control.SRR15539824;35;40;0.514285714285714;17;18;0.0142857142857142;0.485714285714286
Control.SRR15539824;37;40;0.621621621621622;14;23;0.121621621621622;0.378378378378378
Control.SRR15539824;40;40;0.55;18;22;0.05;0.45
Control.SRR15539824;36;40;0.5;18;18;0;0.5
Control.SRR15539824;38;40;0.710526315789474;11;27;0.210526315789474;0.289473684210526
Control.SRR15539824;37;40;0.405405405405405;22;15;0.0945945945945946;0.405405405405405
Control.SRR15539824;36;40;0.472222222222222;19;17;0.0277777777777778;0.472222222222222
Control.SRR15539824;38;40;0.526315789473684;18;20;0.0263157894736842;0.473684210526316
Control.SRR15539824;37;40;0.486486486486487;19;18;0.0135135135135135;0.486486486486487
Control.SRR15539824;41;40;0.463414634146341;22;19;0.0365853658536585;0.463414634146341
Control.SRR15539824;39;40;0.538461538461538;18;21;0.0384615384615384;0.461538461538462
Control.SRR15539824;41;40;0.560975609756098;18;23;0.0609756097560976;0.439024390243902
Control.SRR15539824;41;40;0.414634146341463;24;17;0.0853658536585366;0.414634146341463
Control.SRR15539824;37;40;0.621621621621622;14;23;0.121621621621622;0.378378378378378
Control.SRR15539824;39;40;0.41025641025641;23;16;0.0897435897435898;0.41025641025641
Control.SRR15539824;38;40;0.394736842105263;23;15;0.105263157894737;0.394736842105263
Control.SRR15539824;37;40;0.432432432432432;21;16;0.0675675675675675;0.432432432432432
Control.SRR15539824;39;40;0.564102564102564;17;22;0.0641025641025641;0.435897435897436
Control.SRR15539824;37;40;0.621621621621622;14;23;0.121621621621622;0.378378378378378
Control.SRR15539824;41;40;0.51219512195122;20;21;0.0121951219512195;0.48780487804878
Control.SRR15539824;42;40;0.5;21;21;0;0.5
Control.SRR15539824;38;40;0.552631578947368;17;21;0.0526315789473685;0.447368421052632
Control.SRR15539824;36;40;0.527777777777778;17;19;0.0277777777777778;0.472222222222222
Control.SRR15539824;44;40;0.545454545454545;20;24;0.0454545454545454;0.454545454545455
Control.SRR15539824;42;40;0.5;21;21;0;0.5
Control.SRR15539824;37;40;0.567567567567568;16;21;0.0675675675675675;0.432432432432432
Control.SRR15539824;43;40;0.465116279069767;23;20;0.0348837209302326;0.465116279069767
Control.SRR15539824;38;40;0.5;19;19;0;0.5
Control.SRR15539824;44;40;0.568181818181818;19;25;0.0681818181818182;0.431818181818182
Control.SRR15539824;37;40;0.594594594594595;15;22;0.0945945945945946;0.405405405405405
Control.SRR15539824;37;40;0.486486486486487;19;18;0.0135135135135135;0.486486486486487
Control.SRR15539824;42;40;0.380952380952381;26;16;0.119047619047619;0.380952380952381
Control.SRR15539824;36;40;0.555555555555556;16;20;0.0555555555555556;0.444444444444444
Control.SRR15539824;37;40;0.621621621621622;14;23;0.121621621621622;0.378378378378378
Control.SRR15539824;41;40;0.560975609756098;18;23;0.0609756097560976;0.439024390243902
Control.SRR15539824;38;40;0.526315789473684;18;20;0.0263157894736842;0.473684210526316
Control.SRR15539824;44;40;0.522727272727273;21;23;0.0227272727272727;0.477272727272727
Control.SRR15539824;37;40;0.405405405405405;22;15;0.0945945945945946;0.405405405405405
Control.SRR15539824;34;40;0.441176470588235;19;15;0.0588235294117647;0.441176470588235
Control.SRR15539824;34;40;0.5;17;17;0;0.5
Control.SRR15539824;38;40;0.605263157894737;15;23;0.105263157894737;0.394736842105263
Control.SRR15539824;37;40;0.540540540540541;17;20;0.0405405405405406;0.459459459459459
Control.SRR15539824;41;40;0.658536585365854;14;27;0.158536585365854;0.341463414634146
Control.SRR15539824;37;40;0.594594594594595;15;22;0.0945945945945946;0.405405405405405
Control.SRR15539824;38;40;0.526315789473684;18;20;0.0263157894736842;0.473684210526316
Control.SRR15539824;34;40;0.647058823529412;12;22;0.147058823529412;0.352941176470588
Control.SRR15539824;40;40;0.475;21;19;0.025;0.475
Control.SRR15539824;40;40;0.55;18;22;0.05;0.45
Control.SRR15539824;39;40;0.487179487179487;20;19;0.0128205128205128;0.487179487179487
Control.SRR15539824;40;40;0.525;19;21;0.025;0.475
Control.SRR15539824;35;40;0.371428571428571;22;13;0.128571428571429;0.371428571428571
Control.SRR15539824;36;40;0.472222222222222;19;17;0.0277777777777778;0.472222222222222
Control.SRR15539824;40;40;0.475;21;19;0.025;0.475
Control.SRR15539824;41;40;0.585365853658537;17;24;0.0853658536585366;0.414634146341463
Control.SRR15539824;34;40;0.441176470588235;19;15;0.0588235294117647;0.441176470588235
Control.SRR15539824;34;40;0.441176470588235;19;15;0.0588235294117647;0.441176470588235
Control.SRR15539824;34;40;0.294117647058824;24;10;0.205882352941176;0.294117647058824
Control.SRR15539824;40;40;0.525;19;21;0.025;0.475
Control.SRR15539824;35;40;0.6;14;21;0.1;0.4
Control.SRR15539824;38;40;0.631578947368421;14;24;0.131578947368421;0.368421052631579
Control.SRR15539824;40;40;0.45;22;18;0.05;0.45
Control.SRR15539824;36;40;0.583333333333333;15;21;0.0833333333333334;0.416666666666667
Control.SRR15539824;37;40;0.351351351351351;24;13;0.148648648648649;0.351351351351351
Control.SRR15539824;36;40;0.583333333333333;15;21;0.0833333333333334;0.416666666666667
Control.SRR15539824;43;40;0.511627906976744;21;22;0.0116279069767442;0.488372093023256
Control.SRR15539824;43;40;0.558139534883721;19;24;0.0581395348837209;0.441860465116279
Control.SRR15539824;35;40;0.4;21;14;0.1;0.4
Control.SRR15539824;36;40;0.388888888888889;22;14;0.111111111111111;0.388888888888889
Control.SRR15539824;35;40;0.4;21;14;0.1;0.4
Control.SRR15539824;39;40;0.538461538461538;18;21;0.0384615384615384;0.461538461538462
Control.SRR15539824;41;40;0.414634146341463;24;17;0.0853658536585366;0.414634146341463
Control.SRR15539824;36;40;0.527777777777778;17;19;0.0277777777777778;0.472222222222222
Control.SRR15539824;43;40;0.558139534883721;19;24;0.0581395348837209;0.441860465116279
Control.SRR15539824;39;40;0.615384615384615;15;24;0.115384615384615;0.384615384615385
Control.SRR15539824;37;40;0.594594594594595;15;22;0.0945945945945946;0.405405405405405
Control.SRR15539824;37;40;0.432432432432432;21;16;0.0675675675675675;0.432432432432432
Control.SRR15539824;35;40;0.542857142857143;16;19;0.0428571428571428;0.457142857142857
Control.SRR15539824;38;40;0.578947368421053;16;22;0.0789473684210527;0.421052631578947
Control.SRR15539824;40;40;0.55;18;22;0.05;0.45
Control.SRR15539824;38;40;0.578947368421053;16;22;0.0789473684210527;0.421052631578947
Control.SRR15539824;35;40;0.457142857142857;19;16;0.0428571428571429;0.457142857142857
Control.SRR15539824;37;40;0.513513513513513;18;19;0.0135135135135135;0.486486486486487
Control.SRR15539824;39;40;0.538461538461538;18;21;0.0384615384615384;0.461538461538462
Control.SRR15539824;35;40;0.542857142857143;16;19;0.0428571428571428;0.457142857142857
Control.SRR15539824;36;40;0.333333333333333;24;12;0.166666666666667;0.333333333333333
Control.SRR15539824;35;40;0.685714285714286;11;24;0.185714285714286;0.314285714285714
Control.SRR15539824;36;40;0.527777777777778;17;19;0.0277777777777778;0.472222222222222
Control.SRR15539824;36;40;0.5;18;18;0;0.5
Control.SRR15539824;41;40;0.536585365853659;19;22;0.0365853658536586;0.463414634146341
Control.SRR15539824;38;40;0.394736842105263;23;15;0.105263157894737;0.394736842105263
Control.SRR15539824;44;40;0.454545454545455;24;20;0.0454545454545455;0.454545454545455
Control.SRR15539824;41;40;0.609756097560976;16;25;0.109756097560976;0.390243902439024
Control.SRR15539824;36;40;0.416666666666667;21;15;0.0833333333333333;0.416666666666667
Control.SRR15539824;38;40;0.526315789473684;18;20;0.0263157894736842;0.473684210526316
Control.SRR15539824;38;40;0.421052631578947;22;16;0.0789473684210527;0.421052631578947
Control.SRR15539824;38;40;0.421052631578947;22;16;0.0789473684210527;0.421052631578947
Control.SRR15539824;39;40;0.58974358974359;16;23;0.0897435897435898;0.41025641025641
Control.SRR15539824;39;40;0.58974358974359;16;23;0.0897435897435898;0.41025641025641
Control.SRR15539824;40;40;0.5;20;20;0;0.5
Control.SRR15539824;42;40;0.547619047619048;19;23;0.0476190476190477;0.452380952380952
Control.SRR15539824;42;40;0.452380952380952;23;19;0.0476190476190476;0.452380952380952
Control.SRR15539824;37;40;0.567567567567568;16;21;0.0675675675675675;0.432432432432432
Control.SRR15539824;42;40;0.452380952380952;23;19;0.0476190476190476;0.452380952380952
Control.SRR15539824;44;40;0.386363636363636;27;17;0.113636363636364;0.386363636363636
Control.SRR15539824;38;40;0.421052631578947;22;16;0.0789473684210527;0.421052631578947
Control.SRR15539824;36;40;0.527777777777778;17;19;0.0277777777777778;0.472222222222222
Control.SRR15539824;35;40;0.571428571428571;15;20;0.0714285714285714;0.428571428571429
Control.SRR15539824;41;40;0.463414634146341;22;19;0.0365853658536585;0.463414634146341
Control.SRR15539824;42;40;0.595238095238095;17;25;0.0952380952380952;0.404761904761905
Control.SRR15539824;34;40;0.588235294117647;14;20;0.0882352941176471;0.411764705882353
Control.SRR15539824;38;40;0.605263157894737;15;23;0.105263157894737;0.394736842105263
Control.SRR15539824;34;40;0.588235294117647;14;20;0.0882352941176471;0.411764705882353
Control.SRR15539824;44;40;0.568181818181818;19;25;0.0681818181818182;0.431818181818182
Control.SRR15539824;42;40;0.5;21;21;0;0.5
Control.SRR15539824;40;40;0.55;18;22;0.05;0.45
Control.SRR15539824;34;40;0.676470588235294;11;23;0.176470588235294;0.323529411764706
Control.SRR15539824;34;40;0.558823529411765;15;19;0.0588235294117647;0.441176470588235
Control.SRR15539824;38;40;0.552631578947368;17;21;0.0526315789473685;0.447368421052632
Control.SRR15539824;36;40;0.555555555555556;16;20;0.0555555555555556;0.444444444444444
Control.SRR15539824;39;40;0.538461538461538;18;21;0.0384615384615384;0.461538461538462
Control.SRR15539824;36;40;0.388888888888889;22;14;0.111111111111111;0.388888888888889
Control.SRR15539824;36;40;0.583333333333333;15;21;0.0833333333333334;0.416666666666667
Control.SRR15539824;41;40;0.414634146341463;24;17;0.0853658536585366;0.414634146341463
Control.SRR15539824;40;40;0.4;24;16;0.1;0.4
Control.SRR15539824;38;40;0.578947368421053;16;22;0.0789473684210527;0.421052631578947
Control.SRR15539824;36;40;0.611111111111111;14;22;0.111111111111111;0.388888888888889
Control.SRR15539824;38;40;0.421052631578947;22;16;0.0789473684210527;0.421052631578947
Control.SRR15539824;38;40;0.605263157894737;15;23;0.105263157894737;0.394736842105263
Control.SRR15539824;40;40;0.475;21;19;0.025;0.475
Control.SRR15539824;44;40;0.409090909090909;26;18;0.0909090909090909;0.409090909090909
Control.SRR15539824;39;40;0.615384615384615;15;24;0.115384615384615;0.384615384615385
Control.SRR15539824;43;40;0.720930232558139;12;31;0.220930232558139;0.27906976744186
Control.SRR15539824;42;40;0.404761904761905;25;17;0.0952380952380952;0.404761904761905
Control.SRR15539824;35;40;0.457142857142857;19;16;0.0428571428571429;0.457142857142857
Control.SRR15539824;34;40;0.411764705882353;20;14;0.0882352941176471;0.411764705882353
Control.SRR15539824;44;40;0.545454545454545;20;24;0.0454545454545454;0.454545454545455
Control.SRR15539824;44;40;0.477272727272727;23;21;0.0227272727272727;0.477272727272727
Control.SRR15539824;35;40;0.628571428571429;13;22;0.128571428571429;0.371428571428571
Control.SRR15539824;44;40;0.568181818181818;19;25;0.0681818181818182;0.431818181818182
Control.SRR15539824;41;40;0.560975609756098;18;23;0.0609756097560976;0.439024390243902
Control.SRR15539824;43;40;0.441860465116279;24;19;0.0581395348837209;0.441860465116279
Control.SRR15539824;37;40;0.567567567567568;16;21;0.0675675675675675;0.432432432432432
Control.SRR15539824;36;40;0.583333333333333;15;21;0.0833333333333334;0.416666666666667
Control.SRR15539824;35;40;0.485714285714286;18;17;0.0142857142857143;0.485714285714286
Control.SRR15539824;38;40;0.631578947368421;14;24;0.131578947368421;0.368421052631579
Control.SRR15539824;34;40;0.5;17;17;0;0.5
Control.SRR15539824;43;40;0.581395348837209;18;25;0.0813953488372093;0.418604651162791
Control.SRR15539824;37;40;0.486486486486487;19;18;0.0135135135135135;0.486486486486487
Control.SRR15539824;43;40;0.534883720930233;20;23;0.0348837209302325;0.465116279069767
Control.SRR15539824;41;40;0.341463414634146;27;14;0.158536585365854;0.341463414634146
Control.SRR15539824;43;40;0.511627906976744;21;22;0.0116279069767442;0.488372093023256
Control.SRR15539824;41;40;0.48780487804878;21;20;0.0121951219512195;0.48780487804878
Control.SRR15539824;44;40;0.5;22;22;0;0.5
Control.SRR15539824;37;40;0.567567567567568;16;21;0.0675675675675675;0.432432432432432
Control.SRR15539824;38;40;0.447368421052632;21;17;0.0526315789473684;0.447368421052632
Control.SRR15539824;43;40;0.558139534883721;19;24;0.0581395348837209;0.441860465116279
Control.SRR15539824;40;40;0.5;20;20;0;0.5
Control.SRR15539824;36;40;0.583333333333333;15;21;0.0833333333333334;0.416666666666667
Control.SRR15539824;37;40;0.567567567567568;16;21;0.0675675675675675;0.432432432432432
Control.SRR15539824;40;40;0.625;15;25;0.125;0.375
Control.SRR15539824;38;40;0.263157894736842;28;10;0.236842105263158;0.263157894736842
Control.SRR15539824;39;40;0.487179487179487;20;19;0.0128205128205128;0.487179487179487
Control.SRR15539824;44;40;0.431818181818182;25;19;0.0681818181818182;0.431818181818182
Control.SRR15539824;44;40;0.522727272727273;21;23;0.0227272727272727;0.477272727272727
Control.SRR15539824;40;40;0.475;21;19;0.025;0.475
Control.SRR15539824;38;40;0.526315789473684;18;20;0.0263157894736842;0.473684210526316
Control.SRR15539824;37;40;0.513513513513513;18;19;0.0135135135135135;0.486486486486487
Control.SRR15539824;39;40;0.435897435897436;22;17;0.0641025641025641;0.435897435897436
Control.SRR15539824;43;40;0.581395348837209;18;25;0.0813953488372093;0.418604651162791
Control.SRR15539824;40;40;0.45;22;18;0.05;0.45
Control.SRR15539824;35;40;0.6;14;21;0.1;0.4
Control.SRR15539824;42;40;0.666666666666667;14;28;0.166666666666667;0.333333333333333
Control.SRR15539824;41;40;0.585365853658537;17;24;0.0853658536585366;0.414634146341463
Control.SRR15539824;38;40;0.447368421052632;21;17;0.0526315789473684;0.447368421052632
Control.SRR15539824;36;40;0.527777777777778;17;19;0.0277777777777778;0.472222222222222
Control.SRR15539824;37;40;0.405405405405405;22;15;0.0945945945945946;0.405405405405405
Control.SRR15539824;43;40;0.465116279069767;23;20;0.0348837209302326;0.465116279069767
Control.SRR15539824;41;40;0.560975609756098;18;23;0.0609756097560976;0.439024390243902
Control.SRR15539824;43;40;0.488372093023256;22;21;0.0116279069767442;0.488372093023256
Control.SRR15539824;44;40;0.568181818181818;19;25;0.0681818181818182;0.431818181818182
Control.SRR15539824;37;40;0.540540540540541;17;20;0.0405405405405406;0.459459459459459
Control.SRR15539824;40;40;0.625;15;25;0.125;0.375
Control.SRR15539824;35;40;0.542857142857143;16;19;0.0428571428571428;0.457142857142857
Control.SRR15539824;34;40;0.558823529411765;15;19;0.0588235294117647;0.441176470588235
Control.SRR15539824;35;40;0.542857142857143;16;19;0.0428571428571428;0.457142857142857
Control.SRR15539824;38;40;0.605263157894737;15;23;0.105263157894737;0.394736842105263
Control.SRR15539824;39;40;0.435897435897436;22;17;0.0641025641025641;0.435897435897436
Control.SRR15539824;35;40;0.628571428571429;13;22;0.128571428571429;0.371428571428571
Control.SRR15539824;41;40;0.414634146341463;24;17;0.0853658536585366;0.414634146341463
Control.SRR15539824;37;40;0.351351351351351;24;13;0.148648648648649;0.351351351351351
Control.SRR15539824;34;40;0.470588235294118;18;16;0.0294117647058824;0.470588235294118
Control.SRR15539824;35;40;0.571428571428571;15;20;0.0714285714285714;0.428571428571429
Control.SRR15539824;40;40;0.5;20;20;0;0.5
Control.SRR15539824;44;40;0.454545454545455;24;20;0.0454545454545455;0.454545454545455
Control.SRR15539824;38;40;0.473684210526316;20;18;0.0263157894736842;0.473684210526316
Control.SRR15539824;34;40;0.529411764705882;16;18;0.0294117647058824;0.470588235294118
Control.SRR15539824;34;40;0.382352941176471;21;13;0.117647058823529;0.382352941176471
Control.SRR15539824;39;40;0.538461538461538;18;21;0.0384615384615384;0.461538461538462
Control.SRR15539824;40;40;0.65;14;26;0.15;0.35
Control.SRR15539824;38;40;0.5;19;19;0;0.5
Control.SRR15539824;44;40;0.568181818181818;19;25;0.0681818181818182;0.431818181818182
Control.SRR15539824;35;40;0.428571428571429;20;15;0.0714285714285715;0.428571428571429
Control.SRR15539824;43;40;0.651162790697674;15;28;0.151162790697674;0.348837209302326
Control.SRR15539824;43;40;0.604651162790698;17;26;0.104651162790698;0.395348837209302
Control.SRR15539824;42;40;0.5;21;21;0;0.5
Control.SRR15539824;44;40;0.613636363636364;17;27;0.113636363636364;0.386363636363636
Control.SRR15539824;38;40;0.526315789473684;18;20;0.0263157894736842;0.473684210526316
Control.SRR15539824;42;40;0.571428571428571;18;24;0.0714285714285714;0.428571428571429
Control.SRR15539824;40;40;0.425;23;17;0.075;0.425
Control.SRR15539824;38;40;0.5;19;19;0;0.5
Control.SRR15539824;37;40;0.540540540540541;17;20;0.0405405405405406;0.459459459459459
Control.SRR15539824;43;40;0.697674418604651;13;30;0.197674418604651;0.302325581395349
Control.SRR15539824;36;40;0.5;18;18;0;0.5
Control.SRR15539824;38;40;0.447368421052632;21;17;0.0526315789473684;0.447368421052632
Control.SRR15539824;43;40;0.488372093023256;22;21;0.0116279069767442;0.488372093023256
Control.SRR15539824;37;40;0.675675675675676;12;25;0.175675675675676;0.324324324324324
Control.SRR15539824;39;40;0.41025641025641;23;16;0.0897435897435898;0.41025641025641
Control.SRR15539824;42;40;0.523809523809524;20;22;0.0238095238095238;0.476190476190476
Control.SRR15539824;44;40;0.477272727272727;23;21;0.0227272727272727;0.477272727272727
Control.SRR15539824;43;40;0.534883720930233;20;23;0.0348837209302325;0.465116279069767
Control.SRR15539824;36;40;0.555555555555556;16;20;0.0555555555555556;0.444444444444444
Control.SRR15539824;39;40;0.538461538461538;18;21;0.0384615384615384;0.461538461538462
Control.SRR15539824;42;40;0.476190476190476;22;20;0.0238095238095238;0.476190476190476
Control.SRR15539824;43;40;0.558139534883721;19;24;0.0581395348837209;0.441860465116279
Control.SRR15539824;36;40;0.583333333333333;15;21;0.0833333333333334;0.416666666666667
Control.SRR15539824;44;40;0.454545454545455;24;20;0.0454545454545455;0.454545454545455
Control.SRR15539824;35;40;0.571428571428571;15;20;0.0714285714285714;0.428571428571429
Control.SRR15539824;34;40;0.558823529411765;15;19;0.0588235294117647;0.441176470588235
Control.SRR15539824;36;40;0.5;18;18;0;0.5
Control.SRR15539824;36;40;0.444444444444444;20;16;0.0555555555555556;0.444444444444444
Control.SRR15539824;41;40;0.414634146341463;24;17;0.0853658536585366;0.414634146341463
Control.SRR15539824;41;40;0.48780487804878;21;20;0.0121951219512195;0.48780487804878
Control.SRR15539824;40;40;0.675;13;27;0.175;0.325
Control.SRR15539824;38;40;0.552631578947368;17;21;0.0526315789473685;0.447368421052632
Control.SRR15539824;35;40;0.542857142857143;16;19;0.0428571428571428;0.457142857142857
Control.SRR15539824;37;40;0.675675675675676;12;25;0.175675675675676;0.324324324324324
Control.SRR15539824;38;40;0.631578947368421;14;24;0.131578947368421;0.368421052631579
Control.SRR15539824;36;40;0.583333333333333;15;21;0.0833333333333334;0.416666666666667
Control.SRR15539824;38;40;0.447368421052632;21;17;0.0526315789473684;0.447368421052632
Control.SRR15539824;39;40;0.435897435897436;22;17;0.0641025641025641;0.435897435897436
Control.SRR15539824;43;40;0.465116279069767;23;20;0.0348837209302326;0.465116279069767
Control.SRR15539824;37;40;0.594594594594595;15;22;0.0945945945945946;0.405405405405405
Control.SRR15539824;34;40;0.411764705882353;20;14;0.0882352941176471;0.411764705882353
Control.SRR15539824;37;40;0.540540540540541;17;20;0.0405405405405406;0.459459459459459
Control.SRR15539824;38;40;0.447368421052632;21;17;0.0526315789473684;0.447368421052632
Control.SRR15539824;43;40;0.488372093023256;22;21;0.0116279069767442;0.488372093023256
Control.SRR15539824;44;40;0.454545454545455;24;20;0.0454545454545455;0.454545454545455
Control.SRR15539824;37;40;0.594594594594595;15;22;0.0945945945945946;0.405405405405405
Control.SRR15539824;43;40;0.465116279069767;23;20;0.0348837209302326;0.465116279069767
Control.SRR15539824;37;40;0.459459459459459;20;17;0.0405405405405405;0.459459459459459
Control.SRR15539824;40;40;0.475;21;19;0.025;0.475
Control.SRR15539824;43;40;0.581395348837209;18;25;0.0813953488372093;0.418604651162791
Control.SRR15539824;43;40;0.488372093023256;22;21;0.0116279069767442;0.488372093023256
Control.SRR15539824;34;40;0.264705882352941;25;9;0.235294117647059;0.264705882352941
Control.SRR15539824;37;40;0.432432432432432;21;16;0.0675675675675675;0.432432432432432
Control.SRR15539824;42;40;0.476190476190476;22;20;0.0238095238095238;0.476190476190476
Control.SRR15539824;40;40;0.5;20;20;0;0.5
Control.SRR15539824;38;40;0.5;19;19;0;0.5
Control.SRR15539824;34;40;0.558823529411765;15;19;0.0588235294117647;0.441176470588235
Control.SRR15539824;37;40;0.459459459459459;20;17;0.0405405405405405;0.459459459459459
Control.SRR15539824;39;40;0.538461538461538;18;21;0.0384615384615384;0.461538461538462
Control.SRR15539824;43;40;0.488372093023256;22;21;0.0116279069767442;0.488372093023256
Control.SRR15539824;42;40;0.571428571428571;18;24;0.0714285714285714;0.428571428571429
Control.SRR15539824;36;40;0.527777777777778;17;19;0.0277777777777778;0.472222222222222
Control.SRR15539824;39;40;0.487179487179487;20;19;0.0128205128205128;0.487179487179487
Control.SRR15539824;40;40;0.375;25;15;0.125;0.375
Control.SRR15539824;40;40;0.55;18;22;0.05;0.45
Control.SRR15539824;39;40;0.487179487179487;20;19;0.0128205128205128;0.487179487179487
Control.SRR15539824;39;40;0.538461538461538;18;21;0.0384615384615384;0.461538461538462
Control.SRR15539824;43;40;0.372093023255814;27;16;0.127906976744186;0.372093023255814
Control.SRR15539824;38;40;0.5;19;19;0;0.5
Control.SRR15539824;37;40;0.675675675675676;12;25;0.175675675675676;0.324324324324324
Control.SRR15539824;41;40;0.463414634146341;22;19;0.0365853658536585;0.463414634146341
Control.SRR15539824;44;40;0.454545454545455;24;20;0.0454545454545455;0.454545454545455
Control.SRR15539824;35;40;0.542857142857143;16;19;0.0428571428571428;0.457142857142857
Control.SRR15539824;40;40;0.575;17;23;0.075;0.425
Control.SRR15539824;38;40;0.473684210526316;20;18;0.0263157894736842;0.473684210526316
Control.SRR15539824;43;40;0.395348837209302;26;17;0.104651162790698;0.395348837209302
Control.SRR15539824;40;40;0.55;18;22;0.05;0.45
Control.SRR15539824;39;40;0.615384615384615;15;24;0.115384615384615;0.384615384615385
Control.SRR15539824;43;40;0.488372093023256;22;21;0.0116279069767442;0.488372093023256
Control.SRR15539824;40;40;0.5;20;20;0;0.5
Control.SRR15539824;37;40;0.567567567567568;16;21;0.0675675675675675;0.432432432432432
Control.SRR15539824;34;40;0.558823529411765;15;19;0.0588235294117647;0.441176470588235
Control.SRR15539824;38;40;0.473684210526316;20;18;0.0263157894736842;0.473684210526316
Control.SRR15539824;40;40;0.45;22;18;0.05;0.45
Control.SRR15539824;40;40;0.4;24;16;0.1;0.4
Control.SRR15539824;42;40;0.357142857142857;27;15;0.142857142857143;0.357142857142857
Control.SRR15539824;36;40;0.5;18;18;0;0.5
Control.SRR15539824;41;40;0.609756097560976;16;25;0.109756097560976;0.390243902439024
Control.SRR15539824;40;40;0.325;27;13;0.175;0.325
Control.SRR15539824;36;40;0.5;18;18;0;0.5
Control.SRR15539824;41;40;0.585365853658537;17;24;0.0853658536585366;0.414634146341463
Control.SRR15539824;40;40;0.55;18;22;0.05;0.45
Control.SRR15539824;43;40;0.534883720930233;20;23;0.0348837209302325;0.465116279069767
Control.SRR15539824;41;40;0.682926829268293;13;28;0.182926829268293;0.317073170731707
Control.SRR15539824;43;40;0.418604651162791;25;18;0.0813953488372093;0.418604651162791
Control.SRR15539824;38;40;0.578947368421053;16;22;0.0789473684210527;0.421052631578947
Control.SRR15539824;39;40;0.41025641025641;23;16;0.0897435897435898;0.41025641025641
Control.SRR15539824;43;40;0.558139534883721;19;24;0.0581395348837209;0.441860465116279
Control.SRR15539824;43;40;0.465116279069767;23;20;0.0348837209302326;0.465116279069767
Control.SRR15539824;34;40;0.529411764705882;16;18;0.0294117647058824;0.470588235294118
Control.SRR15539824;34;40;0.352941176470588;22;12;0.147058823529412;0.352941176470588
Control.SRR15539824;36;40;0.5;18;18;0;0.5
Control.SRR15539824;39;40;0.512820512820513;19;20;0.0128205128205128;0.487179487179487
Control.SRR15539824;43;40;0.511627906976744;21;22;0.0116279069767442;0.488372093023256
Control.SRR15539824;38;40;0.394736842105263;23;15;0.105263157894737;0.394736842105263
Control.SRR15539824;42;40;0.595238095238095;17;25;0.0952380952380952;0.404761904761905
Control.SRR15539824;42;40;0.523809523809524;20;22;0.0238095238095238;0.476190476190476
Control.SRR15539824;41;40;0.48780487804878;21;20;0.0121951219512195;0.48780487804878
Control.SRR15539824;38;40;0.447368421052632;21;17;0.0526315789473684;0.447368421052632
Control.SRR15539824;38;40;0.315789473684211;26;12;0.184210526315789;0.315789473684211
Control.SRR15539824;39;40;0.358974358974359;25;14;0.141025641025641;0.358974358974359
Control.SRR15539824;34;40;0.470588235294118;18;16;0.0294117647058824;0.470588235294118
Control.SRR15539824;39;40;0.538461538461538;18;21;0.0384615384615384;0.461538461538462
Control.SRR15539824;42;40;0.547619047619048;19;23;0.0476190476190477;0.452380952380952
Control.SRR15539824;44;40;0.590909090909091;18;26;0.0909090909090909;0.409090909090909
Control.SRR15539824;42;40;0.523809523809524;20;22;0.0238095238095238;0.476190476190476
Control.SRR15539824;35;40;0.371428571428571;22;13;0.128571428571429;0.371428571428571
Control.SRR15539824;42;40;0.523809523809524;20;22;0.0238095238095238;0.476190476190476
Control.SRR15539824;40;40;0.6;16;24;0.1;0.4
Control.SRR15539824;44;40;0.5;22;22;0;0.5
Control.SRR15539824;40;40;0.525;19;21;0.025;0.475
Control.SRR15539824;43;40;0.604651162790698;17;26;0.104651162790698;0.395348837209302
Control.SRR15539824;37;40;0.621621621621622;14;23;0.121621621621622;0.378378378378378
Control.SRR15539824;41;40;0.51219512195122;20;21;0.0121951219512195;0.48780487804878
Control.SRR15539824;40;40;0.375;25;15;0.125;0.375
Control.SRR15539824;37;40;0.459459459459459;20;17;0.0405405405405405;0.459459459459459
Control.SRR15539824;41;40;0.536585365853659;19;22;0.0365853658536586;0.463414634146341
Control.SRR15539824;37;40;0.540540540540541;17;20;0.0405405405405406;0.459459459459459
Control.SRR15539824;34;40;0.470588235294118;18;16;0.0294117647058824;0.470588235294118
Control.SRR15539824;38;40;0.631578947368421;14;24;0.131578947368421;0.368421052631579
Control.SRR15539824;37;40;0.351351351351351;24;13;0.148648648648649;0.351351351351351
Control.SRR15539824;38;40;0.578947368421053;16;22;0.0789473684210527;0.421052631578947
Control.SRR15539824;36;40;0.5;18;18;0;0.5
Control.SRR15539824;44;40;0.545454545454545;20;24;0.0454545454545454;0.454545454545455
Control.SRR15539824;40;40;0.475;21;19;0.025;0.475
Control.SRR15539824;42;40;0.571428571428571;18;24;0.0714285714285714;0.428571428571429
Control.SRR15539824;42;40;0.547619047619048;19;23;0.0476190476190477;0.452380952380952
Control.SRR15539824;43;40;0.488372093023256;22;21;0.0116279069767442;0.488372093023256
Control.SRR15539824;38;40;0.684210526315789;12;26;0.184210526315789;0.315789473684211
Control.SRR15539824;36;40;0.388888888888889;22;14;0.111111111111111;0.388888888888889
Control.SRR15539824;36;40;0.555555555555556;16;20;0.0555555555555556;0.444444444444444
Control.SRR15539824;41;40;0.48780487804878;21;20;0.0121951219512195;0.48780487804878
Control.SRR15539824;43;40;0.604651162790698;17;26;0.104651162790698;0.395348837209302
Control.SRR15539824;43;40;0.558139534883721;19;24;0.0581395348837209;0.441860465116279
Control.SRR15539824;34;40;0.470588235294118;18;16;0.0294117647058824;0.470588235294118
Control.SRR15539824;42;40;0.5;21;21;0;0.5
Control.SRR15539824;37;40;0.567567567567568;16;21;0.0675675675675675;0.432432432432432
Control.SRR15539824;38;40;0.394736842105263;23;15;0.105263157894737;0.394736842105263
Control.SRR15539824;35;40;0.514285714285714;17;18;0.0142857142857142;0.485714285714286
Control.SRR15539824;42;40;0.69047619047619;13;29;0.19047619047619;0.30952380952381
Control.SRR15539824;36;40;0.416666666666667;21;15;0.0833333333333333;0.416666666666667
Control.SRR15539824;34;40;0.382352941176471;21;13;0.117647058823529;0.382352941176471
Control.SRR15539824;39;40;0.461538461538462;21;18;0.0384615384615384;0.461538461538462
Control.SRR15539824;35;40;0.542857142857143;16;19;0.0428571428571428;0.457142857142857
Control.SRR15539824;37;40;0.486486486486487;19;18;0.0135135135135135;0.486486486486487
Control.SRR15539824;41;40;0.536585365853659;19;22;0.0365853658536586;0.463414634146341
Control.SRR15539824;39;40;0.461538461538462;21;18;0.0384615384615384;0.461538461538462
Control.SRR15539824;41;40;0.51219512195122;20;21;0.0121951219512195;0.48780487804878
Control.SRR15539824;39;40;0.461538461538462;21;18;0.0384615384615384;0.461538461538462
Control.SRR15539824;42;40;0.476190476190476;22;20;0.0238095238095238;0.476190476190476
Control.SRR15539824;42;40;0.571428571428571;18;24;0.0714285714285714;0.428571428571429
Control.SRR15539824;39;40;0.564102564102564;17;22;0.0641025641025641;0.435897435897436
Control.SRR15539824;40;40;0.5;20;20;0;0.5
Control.SRR15539824;40;40;0.425;23;17;0.075;0.425
Control.SRR15539824;39;40;0.435897435897436;22;17;0.0641025641025641;0.435897435897436
Control.SRR15539824;41;40;0.390243902439024;25;16;0.109756097560976;0.390243902439024
Control.SRR15539824;38;40;0.447368421052632;21;17;0.0526315789473684;0.447368421052632
Control.SRR15539824;40;40;0.4;24;16;0.1;0.4
Control.SRR15539824;39;40;0.538461538461538;18;21;0.0384615384615384;0.461538461538462
Control.SRR15539824;37;40;0.621621621621622;14;23;0.121621621621622;0.378378378378378
Control.SRR15539824;35;40;0.457142857142857;19;16;0.0428571428571429;0.457142857142857
Control.SRR15539824;35;40;0.542857142857143;16;19;0.0428571428571428;0.457142857142857
Control.SRR15539824;42;40;0.357142857142857;27;15;0.142857142857143;0.357142857142857
Control.SRR15539824;44;40;0.5;22;22;0;0.5
Control.SRR15539824;43;40;0.372093023255814;27;16;0.127906976744186;0.372093023255814
Control.SRR15539824;41;40;0.560975609756098;18;23;0.0609756097560976;0.439024390243902
Control.SRR15539824;39;40;0.512820512820513;19;20;0.0128205128205128;0.487179487179487
Control.SRR15539824;40;40;0.5;20;20;0;0.5
Control.SRR15539824;36;40;0.305555555555556;25;11;0.194444444444444;0.305555555555556
Control.SRR15539824;37;40;0.567567567567568;16;21;0.0675675675675675;0.432432432432432
Control.SRR15539824;39;40;0.487179487179487;20;19;0.0128205128205128;0.487179487179487
Control.SRR15539824;39;40;0.384615384615385;24;15;0.115384615384615;0.384615384615385
Control.SRR15539824;35;40;0.514285714285714;17;18;0.0142857142857142;0.485714285714286
Control.SRR15539824;40;40;0.625;15;25;0.125;0.375
Control.SRR15539824;36;40;0.472222222222222;19;17;0.0277777777777778;0.472222222222222
Control.SRR15539824;42;40;0.547619047619048;19;23;0.0476190476190477;0.452380952380952
Control.SRR15539824;44;40;0.431818181818182;25;19;0.0681818181818182;0.431818181818182
Control.SRR15539824;36;40;0.416666666666667;21;15;0.0833333333333333;0.416666666666667
Control.SRR15539824;34;40;0.588235294117647;14;20;0.0882352941176471;0.411764705882353
Control.SRR15539824;40;40;0.55;18;22;0.05;0.45
Control.SRR15539824;44;40;0.5;22;22;0;0.5
Control.SRR15539824;41;40;0.585365853658537;17;24;0.0853658536585366;0.414634146341463
Control.SRR15539824;36;40;0.583333333333333;15;21;0.0833333333333334;0.416666666666667
Control.SRR15539824;40;40;0.425;23;17;0.075;0.425
Control.SRR15539824;38;40;0.421052631578947;22;16;0.0789473684210527;0.421052631578947
Control.SRR15539824;34;40;0.470588235294118;18;16;0.0294117647058824;0.470588235294118
Control.SRR15539824;37;40;0.432432432432432;21;16;0.0675675675675675;0.432432432432432
Control.SRR15539824;36;40;0.416666666666667;21;15;0.0833333333333333;0.416666666666667
Control.SRR15539824;35;40;0.628571428571429;13;22;0.128571428571429;0.371428571428571
Control.SRR15539824;37;40;0.486486486486487;19;18;0.0135135135135135;0.486486486486487
Control.SRR15539824;39;40;0.487179487179487;20;19;0.0128205128205128;0.487179487179487
Control.SRR15539824;44;40;0.477272727272727;23;21;0.0227272727272727;0.477272727272727
Control.SRR15539824;38;40;0.578947368421053;16;22;0.0789473684210527;0.421052631578947
Control.SRR15539824;37;40;0.540540540540541;17;20;0.0405405405405406;0.459459459459459
Control.SRR15539824;37;40;0.621621621621622;14;23;0.121621621621622;0.378378378378378
Control.SRR15539824;44;40;0.5;22;22;0;0.5
Control.SRR15539824;42;40;0.452380952380952;23;19;0.0476190476190476;0.452380952380952
Control.SRR15539824;39;40;0.58974358974359;16;23;0.0897435897435898;0.41025641025641
Control.SRR15539824;39;40;0.41025641025641;23;16;0.0897435897435898;0.41025641025641
Control.SRR15539824;40;40;0.425;23;17;0.075;0.425
Control.SRR15539824;41;40;0.585365853658537;17;24;0.0853658536585366;0.414634146341463
Control.SRR15539824;38;40;0.473684210526316;20;18;0.0263157894736842;0.473684210526316
Control.SRR15539824;41;40;0.634146341463415;15;26;0.134146341463415;0.365853658536585
Control.SRR15539824;44;40;0.545454545454545;20;24;0.0454545454545454;0.454545454545455
Control.SRR15539824;44;40;0.340909090909091;29;15;0.159090909090909;0.340909090909091
Control.SRR15539824;37;40;0.756756756756757;9;28;0.256756756756757;0.243243243243243
Control.SRR15539824;41;40;0.48780487804878;21;20;0.0121951219512195;0.48780487804878
Control.SRR15539824;34;40;0.558823529411765;15;19;0.0588235294117647;0.441176470588235
Control.SRR15539824;41;40;0.585365853658537;17;24;0.0853658536585366;0.414634146341463
Control.SRR15539824;40;40;0.45;22;18;0.05;0.45
Control.SRR15539824;42;40;0.523809523809524;20;22;0.0238095238095238;0.476190476190476
Control.SRR15539824;44;40;0.545454545454545;20;24;0.0454545454545454;0.454545454545455
Control.SRR15539824;34;40;0.441176470588235;19;15;0.0588235294117647;0.441176470588235
Control.SRR15539824;38;40;0.263157894736842;28;10;0.236842105263158;0.263157894736842
Control.SRR15539824;35;40;0.428571428571429;20;15;0.0714285714285715;0.428571428571429
Control.SRR15539824;36;40;0.472222222222222;19;17;0.0277777777777778;0.472222222222222
Control.SRR15539824;40;40;0.45;22;18;0.05;0.45
Control.SRR15539824;43;40;0.441860465116279;24;19;0.0581395348837209;0.441860465116279
Control.SRR15539824;42;40;0.523809523809524;20;22;0.0238095238095238;0.476190476190476
Control.SRR15539824;35;40;0.485714285714286;18;17;0.0142857142857143;0.485714285714286
Control.SRR15539824;37;40;0.486486486486487;19;18;0.0135135135135135;0.486486486486487
Control.SRR15539824;42;40;0.571428571428571;18;24;0.0714285714285714;0.428571428571429
Control.SRR15539824;42;40;0.404761904761905;25;17;0.0952380952380952;0.404761904761905
Control.SRR15539824;34;40;0.352941176470588;22;12;0.147058823529412;0.352941176470588
Control.SRR15539824;41;40;0.414634146341463;24;17;0.0853658536585366;0.414634146341463
Control.SRR15539824;39;40;0.615384615384615;15;24;0.115384615384615;0.384615384615385
Control.SRR15539824;43;40;0.558139534883721;19;24;0.0581395348837209;0.441860465116279
Control.SRR15539824;44;40;0.613636363636364;17;27;0.113636363636364;0.386363636363636
Control.SRR15539824;34;40;0.441176470588235;19;15;0.0588235294117647;0.441176470588235
Control.SRR15539824;39;40;0.512820512820513;19;20;0.0128205128205128;0.487179487179487
Control.SRR15539824;44;40;0.659090909090909;15;29;0.159090909090909;0.340909090909091
Control.SRR15539824;39;40;0.641025641025641;14;25;0.141025641025641;0.358974358974359
Control.SRR15539824;35;40;0.485714285714286;18;17;0.0142857142857143;0.485714285714286
Control.SRR15539824;38;40;0.526315789473684;18;20;0.0263157894736842;0.473684210526316
Control.SRR15539824;40;40;0.375;25;15;0.125;0.375
Control.SRR15539824;44;40;0.568181818181818;19;25;0.0681818181818182;0.431818181818182
Control.SRR15539824;34;40;0.529411764705882;16;18;0.0294117647058824;0.470588235294118
Control.SRR15539824;39;40;0.461538461538462;21;18;0.0384615384615384;0.461538461538462
Control.SRR15539824;42;40;0.404761904761905;25;17;0.0952380952380952;0.404761904761905
Control.SRR15539824;40;40;0.4;24;16;0.1;0.4
Control.SRR15539824;42;40;0.5;21;21;0;0.5
Control.SRR15539824;38;40;0.578947368421053;16;22;0.0789473684210527;0.421052631578947
Control.SRR15539824;39;40;0.538461538461538;18;21;0.0384615384615384;0.461538461538462
Control.SRR15539824;43;40;0.534883720930233;20;23;0.0348837209302325;0.465116279069767
Control.SRR15539824;44;40;0.409090909090909;26;18;0.0909090909090909;0.409090909090909
Control.SRR15539824;36;40;0.444444444444444;20;16;0.0555555555555556;0.444444444444444
Control.SRR15539824;39;40;0.538461538461538;18;21;0.0384615384615384;0.461538461538462
Control.SRR15539824;35;40;0.314285714285714;24;11;0.185714285714286;0.314285714285714
Control.SRR15539824;42;40;0.452380952380952;23;19;0.0476190476190476;0.452380952380952
Control.SRR15539824;38;40;0.473684210526316;20;18;0.0263157894736842;0.473684210526316
Control.SRR15539824;42;40;0.476190476190476;22;20;0.0238095238095238;0.476190476190476
Control.SRR15539824;42;40;0.523809523809524;20;22;0.0238095238095238;0.476190476190476
Control.SRR15539824;43;40;0.627906976744186;16;27;0.127906976744186;0.372093023255814
Control.SRR15539824;34;40;0.470588235294118;18;16;0.0294117647058824;0.470588235294118
Control.SRR15539824;43;40;0.511627906976744;21;22;0.0116279069767442;0.488372093023256
Control.SRR15539824;40;40;0.425;23;17;0.075;0.425
Control.SRR15539824;37;40;0.567567567567568;16;21;0.0675675675675675;0.432432432432432
Control.SRR15539824;34;40;0.470588235294118;18;16;0.0294117647058824;0.470588235294118
Control.SRR15539824;38;40;0.473684210526316;20;18;0.0263157894736842;0.473684210526316
Control.SRR15539824;42;40;0.595238095238095;17;25;0.0952380952380952;0.404761904761905
Control.SRR15539824;38;40;0.447368421052632;21;17;0.0526315789473684;0.447368421052632
Control.SRR15539824;37;40;0.675675675675676;12;25;0.175675675675676;0.324324324324324
Control.SRR15539824;36;40;0.472222222222222;19;17;0.0277777777777778;0.472222222222222
Control.SRR15539824;40;40;0.55;18;22;0.05;0.45
Control.SRR15539824;36;40;0.583333333333333;15;21;0.0833333333333334;0.416666666666667
Control.SRR15539824;42;40;0.619047619047619;16;26;0.119047619047619;0.380952380952381
Control.SRR15539824;41;40;0.439024390243902;23;18;0.0609756097560976;0.439024390243902
Control.SRR15539824;40;40;0.475;21;19;0.025;0.475
Control.SRR15539824;40;40;0.525;19;21;0.025;0.475
Control.SRR15539824;42;40;0.476190476190476;22;20;0.0238095238095238;0.476190476190476
Control.SRR15539824;36;40;0.583333333333333;15;21;0.0833333333333334;0.416666666666667
Control.SRR15539824;40;40;0.5;20;20;0;0.5
Control.SRR15539824;42;40;0.642857142857143;15;27;0.142857142857143;0.357142857142857
Control.SRR15539824;34;40;0.5;17;17;0;0.5
Control.SRR15539824;42;40;0.523809523809524;20;22;0.0238095238095238;0.476190476190476
Control.SRR15539824;36;40;0.527777777777778;17;19;0.0277777777777778;0.472222222222222
Control.SRR15539824;37;40;0.540540540540541;17;20;0.0405405405405406;0.459459459459459
Control.SRR15539824;39;40;0.512820512820513;19;20;0.0128205128205128;0.487179487179487
Control.SRR15539824;35;40;0.628571428571429;13;22;0.128571428571429;0.371428571428571
Control.SRR15539824;35;40;0.571428571428571;15;20;0.0714285714285714;0.428571428571429
Control.SRR15539824;44;40;0.454545454545455;24;20;0.0454545454545455;0.454545454545455
Control.SRR15539824;43;40;0.441860465116279;24;19;0.0581395348837209;0.441860465116279
Control.SRR15539824;35;40;0.514285714285714;17;18;0.0142857142857142;0.485714285714286
Control.SRR15539824;39;40;0.564102564102564;17;22;0.0641025641025641;0.435897435897436
Control.SRR15539824;43;40;0.604651162790698;17;26;0.104651162790698;0.395348837209302
Control.SRR15539824;40;40;0.55;18;22;0.05;0.45
Control.SRR15539824;35;40;0.514285714285714;17;18;0.0142857142857142;0.485714285714286
Control.SRR15539824;43;40;0.558139534883721;19;24;0.0581395348837209;0.441860465116279
Control.SRR15539824;36;40;0.666666666666667;12;24;0.166666666666667;0.333333333333333
Control.SRR15539824;41;40;0.51219512195122;20;21;0.0121951219512195;0.48780487804878
Control.SRR15539824;37;40;0.486486486486487;19;18;0.0135135135135135;0.486486486486487
Control.SRR15539824;38;40;0.526315789473684;18;20;0.0263157894736842;0.473684210526316
Control.SRR15539824;38;40;0.605263157894737;15;23;0.105263157894737;0.394736842105263
Control.SRR15539824;43;40;0.604651162790698;17;26;0.104651162790698;0.395348837209302
Control.SRR15539824;43;40;0.465116279069767;23;20;0.0348837209302326;0.465116279069767
Control.SRR15539824;40;40;0.475;21;19;0.025;0.475
Control.SRR15539824;44;40;0.5;22;22;0;0.5
Control.SRR15539824;43;40;0.581395348837209;18;25;0.0813953488372093;0.418604651162791
Control.SRR15539824;39;40;0.461538461538462;21;18;0.0384615384615384;0.461538461538462
Control.SRR15539824;36;40;0.694444444444444;11;25;0.194444444444444;0.305555555555556
Control.SRR15539824;41;40;0.48780487804878;21;20;0.0121951219512195;0.48780487804878
Control.SRR15539824;38;40;0.526315789473684;18;20;0.0263157894736842;0.473684210526316
Control.SRR15539824;38;40;0.526315789473684;18;20;0.0263157894736842;0.473684210526316
Control.SRR15539824;36;40;0.5;18;18;0;0.5
Control.SRR15539824;40;40;0.475;21;19;0.025;0.475
Control.SRR15539824;44;40;0.5;22;22;0;0.5
Control.SRR15539824;35;40;0.514285714285714;17;18;0.0142857142857142;0.485714285714286
Control.SRR15539824;36;40;0.305555555555556;25;11;0.194444444444444;0.305555555555556
Control.SRR15539824;44;40;0.454545454545455;24;20;0.0454545454545455;0.454545454545455
Control.SRR15539824;38;40;0.578947368421053;16;22;0.0789473684210527;0.421052631578947
Control.SRR15539824;39;40;0.461538461538462;21;18;0.0384615384615384;0.461538461538462
Control.SRR15539824;36;40;0.472222222222222;19;17;0.0277777777777778;0.472222222222222
Control.SRR15539824;44;40;0.681818181818182;14;30;0.181818181818182;0.318181818181818
Control.SRR15539824;42;40;0.523809523809524;20;22;0.0238095238095238;0.476190476190476
Control.SRR15539824;44;40;0.454545454545455;24;20;0.0454545454545455;0.454545454545455
Control.SRR15539824;39;40;0.41025641025641;23;16;0.0897435897435898;0.41025641025641
Control.SRR15539824;36;40;0.5;18;18;0;0.5
Control.SRR15539824;39;40;0.487179487179487;20;19;0.0128205128205128;0.487179487179487
Control.SRR15539824;39;40;0.461538461538462;21;18;0.0384615384615384;0.461538461538462
Control.SRR15539824;37;40;0.540540540540541;17;20;0.0405405405405406;0.459459459459459
Control.SRR15539824;38;40;0.578947368421053;16;22;0.0789473684210527;0.421052631578947
Control.SRR15539824;44;40;0.636363636363636;16;28;0.136363636363636;0.363636363636364
Control.SRR15539824;42;40;0.547619047619048;19;23;0.0476190476190477;0.452380952380952
Control.SRR15539824;41;40;0.634146341463415;15;26;0.134146341463415;0.365853658536585
Control.SRR15539824;34;40;0.470588235294118;18;16;0.0294117647058824;0.470588235294118
Control.SRR15539824;34;40;0.588235294117647;14;20;0.0882352941176471;0.411764705882353
Control.SRR15539824;38;40;0.526315789473684;18;20;0.0263157894736842;0.473684210526316
Control.SRR15539824;40;40;0.55;18;22;0.05;0.45
Control.SRR15539824;39;40;0.384615384615385;24;15;0.115384615384615;0.384615384615385
Control.SRR15539824;38;40;0.394736842105263;23;15;0.105263157894737;0.394736842105263
Control.SRR15539824;41;40;0.560975609756098;18;23;0.0609756097560976;0.439024390243902
Control.SRR15539824;42;40;0.642857142857143;15;27;0.142857142857143;0.357142857142857
Control.SRR15539824;42;40;0.5;21;21;0;0.5
Control.SRR15539824;44;40;0.5;22;22;0;0.5
Control.SRR15539824;43;40;0.488372093023256;22;21;0.0116279069767442;0.488372093023256
Control.SRR15539824;43;40;0.627906976744186;16;27;0.127906976744186;0.372093023255814
Control.SRR15539824;41;40;0.414634146341463;24;17;0.0853658536585366;0.414634146341463
Control.SRR15539824;34;40;0.5;17;17;0;0.5
Control.SRR15539824;37;40;0.405405405405405;22;15;0.0945945945945946;0.405405405405405
Control.SRR15539824;35;40;0.457142857142857;19;16;0.0428571428571429;0.457142857142857
Control.SRR15539824;34;40;0.529411764705882;16;18;0.0294117647058824;0.470588235294118
Control.SRR15539824;34;40;0.441176470588235;19;15;0.0588235294117647;0.441176470588235
Control.SRR15539824;42;40;0.476190476190476;22;20;0.0238095238095238;0.476190476190476
Control.SRR15539824;36;40;0.388888888888889;22;14;0.111111111111111;0.388888888888889
Control.SRR15539824;39;40;0.512820512820513;19;20;0.0128205128205128;0.487179487179487
Control.SRR15539824;40;40;0.6;16;24;0.1;0.4
Control.SRR15539824;36;40;0.583333333333333;15;21;0.0833333333333334;0.416666666666667
Control.SRR15539824;41;40;0.48780487804878;21;20;0.0121951219512195;0.48780487804878
Control.SRR15539824;38;40;0.421052631578947;22;16;0.0789473684210527;0.421052631578947
Control.SRR15539824;41;40;0.536585365853659;19;22;0.0365853658536586;0.463414634146341
Control.SRR15539824;43;40;0.534883720930233;20;23;0.0348837209302325;0.465116279069767
Control.SRR15539824;39;40;0.564102564102564;17;22;0.0641025641025641;0.435897435897436
Control.SRR15539824;42;40;0.357142857142857;27;15;0.142857142857143;0.357142857142857
Control.SRR15539824;34;40;0.588235294117647;14;20;0.0882352941176471;0.411764705882353
Control.SRR15539824;42;40;0.428571428571429;24;18;0.0714285714285715;0.428571428571429
Control.SRR15539824;41;40;0.51219512195122;20;21;0.0121951219512195;0.48780487804878
Control.SRR15539824;40;40;0.75;10;30;0.25;0.25
Control.SRR15539824;34;40;0.529411764705882;16;18;0.0294117647058824;0.470588235294118
Control.SRR15539824;44;40;0.522727272727273;21;23;0.0227272727272727;0.477272727272727
Control.SRR15539824;37;40;0.621621621621622;14;23;0.121621621621622;0.378378378378378
Control.SRR15539824;35;40;0.428571428571429;20;15;0.0714285714285715;0.428571428571429
Control.SRR15539824;43;40;0.534883720930233;20;23;0.0348837209302325;0.465116279069767
Control.SRR15539824;42;40;0.428571428571429;24;18;0.0714285714285715;0.428571428571429
Control.SRR15539824;39;40;0.512820512820513;19;20;0.0128205128205128;0.487179487179487
Control.SRR15539824;37;40;0.351351351351351;24;13;0.148648648648649;0.351351351351351
Control.SRR15539824;43;40;0.511627906976744;21;22;0.0116279069767442;0.488372093023256
Control.SRR15539824;37;40;0.486486486486487;19;18;0.0135135135135135;0.486486486486487
Control.SRR15539824;39;40;0.333333333333333;26;13;0.166666666666667;0.333333333333333
Control.SRR15539824;35;40;0.514285714285714;17;18;0.0142857142857142;0.485714285714286
Control.SRR15539824;41;40;0.585365853658537;17;24;0.0853658536585366;0.414634146341463
Control.SRR15539824;37;40;0.513513513513513;18;19;0.0135135135135135;0.486486486486487
Control.SRR15539824;36;40;0.444444444444444;20;16;0.0555555555555556;0.444444444444444
Control.SRR15539824;40;40;0.55;18;22;0.05;0.45
Control.SRR15539824;42;40;0.452380952380952;23;19;0.0476190476190476;0.452380952380952
Control.SRR15539824;41;40;0.439024390243902;23;18;0.0609756097560976;0.439024390243902
Control.SRR15539824;39;40;0.435897435897436;22;17;0.0641025641025641;0.435897435897436
Control.SRR15539824;42;40;0.5;21;21;0;0.5
Control.SRR15539824;42;40;0.69047619047619;13;29;0.19047619047619;0.30952380952381
Control.SRR15539824;43;40;0.558139534883721;19;24;0.0581395348837209;0.441860465116279
Control.SRR15539824;38;40;0.447368421052632;21;17;0.0526315789473684;0.447368421052632
Control.SRR15539824;41;40;0.634146341463415;15;26;0.134146341463415;0.365853658536585
Control.SRR15539824;37;40;0.540540540540541;17;20;0.0405405405405406;0.459459459459459
Control.SRR15539824;38;40;0.473684210526316;20;18;0.0263157894736842;0.473684210526316
Control.SRR15539824;37;40;0.486486486486487;19;18;0.0135135135135135;0.486486486486487
Control.SRR15539824;40;40;0.575;17;23;0.075;0.425
Control.SRR15539824;36;40;0.416666666666667;21;15;0.0833333333333333;0.416666666666667
Control.SRR15539824;39;40;0.333333333333333;26;13;0.166666666666667;0.333333333333333
Control.SRR15539824;38;40;0.552631578947368;17;21;0.0526315789473685;0.447368421052632
Control.SRR15539824;42;40;0.380952380952381;26;16;0.119047619047619;0.380952380952381
Control.SRR15539824;40;40;0.575;17;23;0.075;0.425
Control.SRR15539824;35;40;0.628571428571429;13;22;0.128571428571429;0.371428571428571
Control.SRR15539824;41;40;0.51219512195122;20;21;0.0121951219512195;0.48780487804878
Control.SRR15539824;35;40;0.542857142857143;16;19;0.0428571428571428;0.457142857142857
Control.SRR15539824;38;40;0.552631578947368;17;21;0.0526315789473685;0.447368421052632
Control.SRR15539824;42;40;0.666666666666667;14;28;0.166666666666667;0.333333333333333
Control.SRR15539824;38;40;0.5;19;19;0;0.5
Control.SRR15539824;38;40;0.5;19;19;0;0.5
Control.SRR15539824;41;40;0.341463414634146;27;14;0.158536585365854;0.341463414634146
Control.SRR15539824;44;40;0.522727272727273;21;23;0.0227272727272727;0.477272727272727
Control.SRR15539824;40;40;0.45;22;18;0.05;0.45
Control.SRR15539824;36;40;0.583333333333333;15;21;0.0833333333333334;0.416666666666667
Control.SRR15539824;43;40;0.465116279069767;23;20;0.0348837209302326;0.465116279069767
Control.SRR15539824;44;40;0.522727272727273;21;23;0.0227272727272727;0.477272727272727
Control.SRR15539824;42;40;0.428571428571429;24;18;0.0714285714285715;0.428571428571429
Control.SRR15539824;43;40;0.534883720930233;20;23;0.0348837209302325;0.465116279069767
Control.SRR15539824;34;40;0.441176470588235;19;15;0.0588235294117647;0.441176470588235
Control.SRR15539824;36;40;0.527777777777778;17;19;0.0277777777777778;0.472222222222222
Control.SRR15539824;34;40;0.470588235294118;18;16;0.0294117647058824;0.470588235294118
Control.SRR15539824;36;40;0.555555555555556;16;20;0.0555555555555556;0.444444444444444
Control.SRR15539824;44;40;0.5;22;22;0;0.5
Control.SRR15539824;44;40;0.409090909090909;26;18;0.0909090909090909;0.409090909090909
Control.SRR15539824;37;40;0.567567567567568;16;21;0.0675675675675675;0.432432432432432
Control.SRR15539824;35;40;0.4;21;14;0.1;0.4
Control.SRR15539824;43;40;0.465116279069767;23;20;0.0348837209302326;0.465116279069767
Control.SRR15539824;42;40;0.476190476190476;22;20;0.0238095238095238;0.476190476190476
Control.SRR15539824;34;40;0.470588235294118;18;16;0.0294117647058824;0.470588235294118
Control.SRR15539824;37;40;0.486486486486487;19;18;0.0135135135135135;0.486486486486487
Control.SRR15539824;36;40;0.722222222222222;10;26;0.222222222222222;0.277777777777778
Control.SRR15539824;39;40;0.564102564102564;17;22;0.0641025641025641;0.435897435897436
Control.SRR15539824;41;40;0.536585365853659;19;22;0.0365853658536586;0.463414634146341
Control.SRR15539824;37;40;0.540540540540541;17;20;0.0405405405405406;0.459459459459459
Control.SRR15539824;39;40;0.615384615384615;15;24;0.115384615384615;0.384615384615385
Control.SRR15539824;39;40;0.512820512820513;19;20;0.0128205128205128;0.487179487179487
Control.SRR15539824;39;40;0.435897435897436;22;17;0.0641025641025641;0.435897435897436
Control.SRR15539824;35;40;0.457142857142857;19;16;0.0428571428571429;0.457142857142857
Control.SRR15539824;43;40;0.558139534883721;19;24;0.0581395348837209;0.441860465116279
Control.SRR15539824;39;40;0.538461538461538;18;21;0.0384615384615384;0.461538461538462
Control.SRR15539824;40;40;0.425;23;17;0.075;0.425
Control.SRR15539824;37;40;0.567567567567568;16;21;0.0675675675675675;0.432432432432432
Control.SRR15539824;36;40;0.444444444444444;20;16;0.0555555555555556;0.444444444444444
Control.SRR15539824;39;40;0.461538461538462;21;18;0.0384615384615384;0.461538461538462
Control.SRR15539824;41;40;0.463414634146341;22;19;0.0365853658536585;0.463414634146341
Control.SRR15539824;41;40;0.414634146341463;24;17;0.0853658536585366;0.414634146341463
Control.SRR15539824;38;40;0.5;19;19;0;0.5
Control.SRR15539824;34;40;0.411764705882353;20;14;0.0882352941176471;0.411764705882353
Control.SRR15539824;39;40;0.487179487179487;20;19;0.0128205128205128;0.487179487179487
Control.SRR15539824;37;40;0.459459459459459;20;17;0.0405405405405405;0.459459459459459
Control.SRR15539824;34;40;0.470588235294118;18;16;0.0294117647058824;0.470588235294118
Control.SRR15539824;37;40;0.459459459459459;20;17;0.0405405405405405;0.459459459459459
Control.SRR15539824;43;40;0.465116279069767;23;20;0.0348837209302326;0.465116279069767
Control.SRR15539824;44;40;0.522727272727273;21;23;0.0227272727272727;0.477272727272727
Control.SRR15539824;42;40;0.357142857142857;27;15;0.142857142857143;0.357142857142857
Control.SRR15539824;42;40;0.523809523809524;20;22;0.0238095238095238;0.476190476190476
Control.SRR15539824;37;40;0.405405405405405;22;15;0.0945945945945946;0.405405405405405
Control.SRR15539824;40;40;0.55;18;22;0.05;0.45
Control.SRR15539824;39;40;0.487179487179487;20;19;0.0128205128205128;0.487179487179487
Control.SRR15539824;38;40;0.394736842105263;23;15;0.105263157894737;0.394736842105263
Control.SRR15539824;41;40;0.390243902439024;25;16;0.109756097560976;0.390243902439024
Control.SRR15539824;39;40;0.461538461538462;21;18;0.0384615384615384;0.461538461538462
Control.SRR15539824;42;40;0.5;21;21;0;0.5
Control.SRR15539824;34;40;0.558823529411765;15;19;0.0588235294117647;0.441176470588235
Control.SRR15539824;35;40;0.485714285714286;18;17;0.0142857142857143;0.485714285714286
Control.SRR15539824;38;40;0.473684210526316;20;18;0.0263157894736842;0.473684210526316
Control.SRR15539824;43;40;0.418604651162791;25;18;0.0813953488372093;0.418604651162791
Control.SRR15539824;44;40;0.5;22;22;0;0.5
Control.SRR15539824;42;40;0.428571428571429;24;18;0.0714285714285715;0.428571428571429
Control.SRR15539824;34;40;0.441176470588235;19;15;0.0588235294117647;0.441176470588235
Control.SRR15539824;43;40;0.488372093023256;22;21;0.0116279069767442;0.488372093023256
Control.SRR15539824;37;40;0.459459459459459;20;17;0.0405405405405405;0.459459459459459
Control.SRR15539824;40;40;0.425;23;17;0.075;0.425
Control.SRR15539824;39;40;0.435897435897436;22;17;0.0641025641025641;0.435897435897436
Control.SRR15539824;38;40;0.5;19;19;0;0.5
Control.SRR15539824;40;40;0.475;21;19;0.025;0.475
Control.SRR15539824;44;40;0.409090909090909;26;18;0.0909090909090909;0.409090909090909
Control.SRR15539824;40;40;0.6;16;24;0.1;0.4
Control.SRR15539824;34;40;0.470588235294118;18;16;0.0294117647058824;0.470588235294118
Control.SRR15539824;43;40;0.418604651162791;25;18;0.0813953488372093;0.418604651162791
Control.SRR15539824;34;40;0.676470588235294;11;23;0.176470588235294;0.323529411764706
Control.SRR15539824;41;40;0.463414634146341;22;19;0.0365853658536585;0.463414634146341
Control.SRR15539824;35;40;0.571428571428571;15;20;0.0714285714285714;0.428571428571429
Control.SRR15539824;38;40;0.552631578947368;17;21;0.0526315789473685;0.447368421052632
Control.SRR15539824;37;40;0.567567567567568;16;21;0.0675675675675675;0.432432432432432
Control.SRR15539824;41;40;0.51219512195122;20;21;0.0121951219512195;0.48780487804878
Control.SRR15539824;35;40;0.628571428571429;13;22;0.128571428571429;0.371428571428571
Control.SRR15539824;43;40;0.465116279069767;23;20;0.0348837209302326;0.465116279069767
Control.SRR15539824;35;40;0.457142857142857;19;16;0.0428571428571429;0.457142857142857
Control.SRR15539824;41;40;0.51219512195122;20;21;0.0121951219512195;0.48780487804878
Control.SRR15539824;40;40;0.45;22;18;0.05;0.45
Control.SRR15539824;39;40;0.487179487179487;20;19;0.0128205128205128;0.487179487179487
Control.SRR15539824;34;40;0.558823529411765;15;19;0.0588235294117647;0.441176470588235
Control.SRR15539824;38;40;0.552631578947368;17;21;0.0526315789473685;0.447368421052632
Control.SRR15539824;36;40;0.583333333333333;15;21;0.0833333333333334;0.416666666666667
Control.SRR15539824;38;40;0.263157894736842;28;10;0.236842105263158;0.263157894736842
Control.SRR15539824;39;40;0.538461538461538;18;21;0.0384615384615384;0.461538461538462
Control.SRR15539824;34;40;0.529411764705882;16;18;0.0294117647058824;0.470588235294118
Control.SRR15539824;39;40;0.564102564102564;17;22;0.0641025641025641;0.435897435897436
Control.SRR15539824;35;40;0.371428571428571;22;13;0.128571428571429;0.371428571428571
Control.SRR15539824;43;40;0.441860465116279;24;19;0.0581395348837209;0.441860465116279
Control.SRR15539824;43;40;0.372093023255814;27;16;0.127906976744186;0.372093023255814
Control.SRR15539824;42;40;0.452380952380952;23;19;0.0476190476190476;0.452380952380952
Control.SRR15539824;41;40;0.48780487804878;21;20;0.0121951219512195;0.48780487804878
Control.SRR15539824;42;40;0.547619047619048;19;23;0.0476190476190477;0.452380952380952
Control.SRR15539824;37;40;0.513513513513513;18;19;0.0135135135135135;0.486486486486487
Control.SRR15539824;38;40;0.473684210526316;20;18;0.0263157894736842;0.473684210526316
Control.SRR15539824;37;40;0.432432432432432;21;16;0.0675675675675675;0.432432432432432
Control.SRR15539824;40;40;0.525;19;21;0.025;0.475
Control.SRR15539824;41;40;0.634146341463415;15;26;0.134146341463415;0.365853658536585
Control.SRR15539824;38;40;0.578947368421053;16;22;0.0789473684210527;0.421052631578947
Control.SRR15539824;38;40;0.394736842105263;23;15;0.105263157894737;0.394736842105263
Control.SRR15539824;44;40;0.613636363636364;17;27;0.113636363636364;0.386363636363636
Control.SRR15539824;42;40;0.476190476190476;22;20;0.0238095238095238;0.476190476190476
Control.SRR15539824;44;40;0.409090909090909;26;18;0.0909090909090909;0.409090909090909
Control.SRR15539824;38;40;0.552631578947368;17;21;0.0526315789473685;0.447368421052632
Control.SRR15539824;35;40;0.571428571428571;15;20;0.0714285714285714;0.428571428571429
Control.SRR15539824;40;40;0.475;21;19;0.025;0.475
Control.SRR15539824;43;40;0.511627906976744;21;22;0.0116279069767442;0.488372093023256
Control.SRR15539824;36;40;0.388888888888889;22;14;0.111111111111111;0.388888888888889
Control.SRR15539824;39;40;0.435897435897436;22;17;0.0641025641025641;0.435897435897436
Control.SRR15539824;45;40;0.488888888888889;23;22;0.0111111111111111;0.488888888888889
Control.SRR15539824;40;40;0.525;19;21;0.025;0.475
Control.SRR15539824;41;40;0.48780487804878;21;20;0.0121951219512195;0.48780487804878
Control.SRR15539824;43;40;0.511627906976744;21;22;0.0116279069767442;0.488372093023256
Control.SRR15539824;38;40;0.552631578947368;17;21;0.0526315789473685;0.447368421052632
Control.SRR15539824;45;40;0.577777777777778;19;26;0.0777777777777777;0.422222222222222
Control.SRR15539824;45;40;0.466666666666667;24;21;0.0333333333333333;0.466666666666667
Control.SRR15539824;44;40;0.522727272727273;21;23;0.0227272727272727;0.477272727272727
Control.SRR15539824;45;40;0.333333333333333;30;15;0.166666666666667;0.333333333333333
Control.SRR15539824;43;40;0.441860465116279;24;19;0.0581395348837209;0.441860465116279
Control.SRR15539824;37;40;0.567567567567568;16;21;0.0675675675675675;0.432432432432432
Control.SRR15539824;44;40;0.477272727272727;23;21;0.0227272727272727;0.477272727272727
Control.SRR15539824;42;40;0.571428571428571;18;24;0.0714285714285714;0.428571428571429
Control.SRR15539824;40;40;0.575;17;23;0.075;0.425
Control.SRR15539824;39;40;0.564102564102564;17;22;0.0641025641025641;0.435897435897436
Control.SRR15539824;44;40;0.545454545454545;20;24;0.0454545454545454;0.454545454545455
Control.SRR15539824;42;40;0.5;21;21;0;0.5
Control.SRR15539824;40;40;0.65;14;26;0.15;0.35
Control.SRR15539824;45;40;0.555555555555556;20;25;0.0555555555555556;0.444444444444444
Control.SRR15539824;37;40;0.486486486486487;19;18;0.0135135135135135;0.486486486486487
Control.SRR15539824;37;40;0.486486486486487;19;18;0.0135135135135135;0.486486486486487
Control.SRR15539824;39;40;0.512820512820513;19;20;0.0128205128205128;0.487179487179487
Control.SRR15539824;39;40;0.58974358974359;16;23;0.0897435897435898;0.41025641025641
Control.SRR15539824;42;40;0.595238095238095;17;25;0.0952380952380952;0.404761904761905
Control.SRR15539824;40;40;0.625;15;25;0.125;0.375
Control.SRR15539824;43;40;0.511627906976744;21;22;0.0116279069767442;0.488372093023256
Control.SRR15539824;36;40;0.416666666666667;21;15;0.0833333333333333;0.416666666666667
Control.SRR15539824;38;40;0.5;19;19;0;0.5
Control.SRR15539824;38;40;0.447368421052632;21;17;0.0526315789473684;0.447368421052632
Control.SRR15539824;43;40;0.604651162790698;17;26;0.104651162790698;0.395348837209302
Control.SRR15539824;42;40;0.547619047619048;19;23;0.0476190476190477;0.452380952380952
Control.SRR15539824;35;40;0.571428571428571;15;20;0.0714285714285714;0.428571428571429
Control.SRR15539824;41;40;0.609756097560976;16;25;0.109756097560976;0.390243902439024
Control.SRR15539824;45;40;0.377777777777778;28;17;0.122222222222222;0.377777777777778
Control.SRR15539824;38;40;0.578947368421053;16;22;0.0789473684210527;0.421052631578947
Control.SRR15539824;36;40;0.555555555555556;16;20;0.0555555555555556;0.444444444444444
Control.SRR15539824;44;40;0.431818181818182;25;19;0.0681818181818182;0.431818181818182
Control.SRR15539824;42;40;0.595238095238095;17;25;0.0952380952380952;0.404761904761905
Control.SRR15539824;36;40;0.527777777777778;17;19;0.0277777777777778;0.472222222222222
Control.SRR15539824;39;40;0.487179487179487;20;19;0.0128205128205128;0.487179487179487
Control.SRR15539824;37;40;0.540540540540541;17;20;0.0405405405405406;0.459459459459459
Control.SRR15539824;40;40;0.55;18;22;0.05;0.45
Control.SRR15539824;41;40;0.536585365853659;19;22;0.0365853658536586;0.463414634146341
Control.SRR15539824;41;40;0.51219512195122;20;21;0.0121951219512195;0.48780487804878
Control.SRR15539824;38;40;0.657894736842105;13;25;0.157894736842105;0.342105263157895
Control.SRR15539824;39;40;0.615384615384615;15;24;0.115384615384615;0.384615384615385
Control.SRR15539824;39;40;0.461538461538462;21;18;0.0384615384615384;0.461538461538462
Control.SRR15539824;39;40;0.538461538461538;18;21;0.0384615384615384;0.461538461538462
Control.SRR15539824;38;40;0.368421052631579;24;14;0.131578947368421;0.368421052631579
Control.SRR15539824;42;40;0.452380952380952;23;19;0.0476190476190476;0.452380952380952
Control.SRR15539824;38;40;0.578947368421053;16;22;0.0789473684210527;0.421052631578947
Control.SRR15539824;35;40;0.571428571428571;15;20;0.0714285714285714;0.428571428571429
Control.SRR15539824;43;40;0.441860465116279;24;19;0.0581395348837209;0.441860465116279
Control.SRR15539824;37;40;0.486486486486487;19;18;0.0135135135135135;0.486486486486487
Control.SRR15539824;36;40;0.416666666666667;21;15;0.0833333333333333;0.416666666666667
Control.SRR15539824;36;40;0.527777777777778;17;19;0.0277777777777778;0.472222222222222
Control.SRR15539824;41;40;0.536585365853659;19;22;0.0365853658536586;0.463414634146341
Control.SRR15539824;43;40;0.581395348837209;18;25;0.0813953488372093;0.418604651162791
Control.SRR15539824;39;40;0.538461538461538;18;21;0.0384615384615384;0.461538461538462
Control.SRR15539824;40;40;0.6;16;24;0.1;0.4
Control.SRR15539824;43;40;0.418604651162791;25;18;0.0813953488372093;0.418604651162791
Control.SRR15539824;38;40;0.578947368421053;16;22;0.0789473684210527;0.421052631578947
Control.SRR15539824;35;40;0.628571428571429;13;22;0.128571428571429;0.371428571428571
Control.SRR15539824;41;40;0.51219512195122;20;21;0.0121951219512195;0.48780487804878
Control.SRR15539824;44;40;0.522727272727273;21;23;0.0227272727272727;0.477272727272727
Control.SRR15539824;35;40;0.542857142857143;16;19;0.0428571428571428;0.457142857142857
Control.SRR15539824;35;40;0.571428571428571;15;20;0.0714285714285714;0.428571428571429
Control.SRR15539824;38;40;0.605263157894737;15;23;0.105263157894737;0.394736842105263
Control.SRR15539824;38;40;0.526315789473684;18;20;0.0263157894736842;0.473684210526316
Control.SRR15539824;36;40;0.527777777777778;17;19;0.0277777777777778;0.472222222222222
Control.SRR15539824;38;40;0.473684210526316;20;18;0.0263157894736842;0.473684210526316
Control.SRR15539824;41;40;0.536585365853659;19;22;0.0365853658536586;0.463414634146341
Control.SRR15539824;42;40;0.452380952380952;23;19;0.0476190476190476;0.452380952380952
Control.SRR15539824;44;40;0.545454545454545;20;24;0.0454545454545454;0.454545454545455
Control.SRR15539824;45;40;0.422222222222222;26;19;0.0777777777777778;0.422222222222222
Control.SRR15539824;37;40;0.513513513513513;18;19;0.0135135135135135;0.486486486486487
Control.SRR15539824;35;40;0.371428571428571;22;13;0.128571428571429;0.371428571428571
Control.SRR15539824;36;40;0.333333333333333;24;12;0.166666666666667;0.333333333333333
Control.SRR15539824;38;40;0.5;19;19;0;0.5
Control.SRR15539824;36;40;0.361111111111111;23;13;0.138888888888889;0.361111111111111
Control.SRR15539824;39;40;0.58974358974359;16;23;0.0897435897435898;0.41025641025641
Control.SRR15539824;38;40;0.605263157894737;15;23;0.105263157894737;0.394736842105263
Control.SRR15539824;37;40;0.513513513513513;18;19;0.0135135135135135;0.486486486486487
Control.SRR15539824;44;40;0.454545454545455;24;20;0.0454545454545455;0.454545454545455
Control.SRR15539824;45;40;0.422222222222222;26;19;0.0777777777777778;0.422222222222222
Control.SRR15539824;42;40;0.5;21;21;0;0.5
Control.SRR15539824;38;40;0.526315789473684;18;20;0.0263157894736842;0.473684210526316
Control.SRR15539824;38;40;0.5;19;19;0;0.5
Control.SRR15539824;41;40;0.560975609756098;18;23;0.0609756097560976;0.439024390243902
Control.SRR15539824;35;40;0.514285714285714;17;18;0.0142857142857142;0.485714285714286
Control.SRR15539824;36;40;0.444444444444444;20;16;0.0555555555555556;0.444444444444444
Control.SRR15539824;40;40;0.425;23;17;0.075;0.425
Control.SRR15539824;39;40;0.512820512820513;19;20;0.0128205128205128;0.487179487179487
Control.SRR15539824;40;40;0.55;18;22;0.05;0.45
Control.SRR15539824;45;40;0.511111111111111;22;23;0.0111111111111111;0.488888888888889
Control.SRR15539824;36;40;0.416666666666667;21;15;0.0833333333333333;0.416666666666667
Control.SRR15539824;39;40;0.564102564102564;17;22;0.0641025641025641;0.435897435897436
Control.SRR15539824;35;40;0.428571428571429;20;15;0.0714285714285715;0.428571428571429
Control.SRR15539824;39;40;0.461538461538462;21;18;0.0384615384615384;0.461538461538462
Control.SRR15539824;40;40;0.475;21;19;0.025;0.475
Control.SRR15539824;41;40;0.536585365853659;19;22;0.0365853658536586;0.463414634146341
Control.SRR15539824;36;40;0.583333333333333;15;21;0.0833333333333334;0.416666666666667
Control.SRR15539824;36;40;0.666666666666667;12;24;0.166666666666667;0.333333333333333
Control.SRR15539824;38;40;0.5;19;19;0;0.5
Control.SRR15539824;40;40;0.5;20;20;0;0.5
Control.SRR15539824;40;40;0.525;19;21;0.025;0.475
Control.SRR15539824;44;40;0.431818181818182;25;19;0.0681818181818182;0.431818181818182
Control.SRR15539824;39;40;0.333333333333333;26;13;0.166666666666667;0.333333333333333
Control.SRR15539824;45;40;0.466666666666667;24;21;0.0333333333333333;0.466666666666667
Control.SRR15539824;36;40;0.361111111111111;23;13;0.138888888888889;0.361111111111111
Control.SRR15539824;36;40;0.5;18;18;0;0.5
Control.SRR15539824;35;40;0.4;21;14;0.1;0.4
Control.SRR15539824;38;40;0.473684210526316;20;18;0.0263157894736842;0.473684210526316
Control.SRR15539824;39;40;0.41025641025641;23;16;0.0897435897435898;0.41025641025641
Control.SRR15539824;39;40;0.487179487179487;20;19;0.0128205128205128;0.487179487179487
Control.SRR15539824;39;40;0.461538461538462;21;18;0.0384615384615384;0.461538461538462
Control.SRR15539824;39;40;0.384615384615385;24;15;0.115384615384615;0.384615384615385
Control.SRR15539824;42;40;0.523809523809524;20;22;0.0238095238095238;0.476190476190476
Control.SRR15539824;43;40;0.418604651162791;25;18;0.0813953488372093;0.418604651162791
Control.SRR15539824;39;40;0.666666666666667;13;26;0.166666666666667;0.333333333333333
Control.SRR15539824;39;40;0.41025641025641;23;16;0.0897435897435898;0.41025641025641
Control.SRR15539824;41;40;0.341463414634146;27;14;0.158536585365854;0.341463414634146
Control.SRR15539824;36;40;0.416666666666667;21;15;0.0833333333333333;0.416666666666667
Control.SRR15539824;38;40;0.552631578947368;17;21;0.0526315789473685;0.447368421052632
Control.SRR15539824;40;40;0.475;21;19;0.025;0.475
Control.SRR15539824;43;40;0.418604651162791;25;18;0.0813953488372093;0.418604651162791
Control.SRR15539824;39;40;0.41025641025641;23;16;0.0897435897435898;0.41025641025641
Control.SRR15539824;39;40;0.564102564102564;17;22;0.0641025641025641;0.435897435897436
Control.SRR15539824;44;40;0.522727272727273;21;23;0.0227272727272727;0.477272727272727
Control.SRR15539824;42;40;0.547619047619048;19;23;0.0476190476190477;0.452380952380952
Control.SRR15539824;43;40;0.465116279069767;23;20;0.0348837209302326;0.465116279069767
Control.SRR15539824;40;40;0.55;18;22;0.05;0.45
Control.SRR15539824;38;40;0.552631578947368;17;21;0.0526315789473685;0.447368421052632
Control.SRR15539824;38;40;0.5;19;19;0;0.5
Control.SRR15539824;40;40;0.4;24;16;0.1;0.4
Control.SRR15539824;45;40;0.6;18;27;0.1;0.4
Control.SRR15539824;38;40;0.5;19;19;0;0.5
Control.SRR15539824;42;40;0.5;21;21;0;0.5
Control.SRR15539824;37;40;0.567567567567568;16;21;0.0675675675675675;0.432432432432432
Control.SRR15539824;42;40;0.523809523809524;20;22;0.0238095238095238;0.476190476190476
Control.SRR15539824;37;40;0.432432432432432;21;16;0.0675675675675675;0.432432432432432
Control.SRR15539824;41;40;0.439024390243902;23;18;0.0609756097560976;0.439024390243902
Control.SRR15539824;42;40;0.547619047619048;19;23;0.0476190476190477;0.452380952380952
Control.SRR15539824;39;40;0.384615384615385;24;15;0.115384615384615;0.384615384615385
Control.SRR15539824;35;40;0.457142857142857;19;16;0.0428571428571429;0.457142857142857
Control.SRR15539824;41;40;0.634146341463415;15;26;0.134146341463415;0.365853658536585
Control.SRR15539824;44;40;0.636363636363636;16;28;0.136363636363636;0.363636363636364
Control.SRR15539824;42;40;0.547619047619048;19;23;0.0476190476190477;0.452380952380952
Control.SRR15539824;36;40;0.416666666666667;21;15;0.0833333333333333;0.416666666666667
Control.SRR15539824;39;40;0.487179487179487;20;19;0.0128205128205128;0.487179487179487
Control.SRR15539824;39;40;0.307692307692308;27;12;0.192307692307692;0.307692307692308
Control.SRR15539824;40;40;0.325;27;13;0.175;0.325
Control.SRR15539824;39;40;0.435897435897436;22;17;0.0641025641025641;0.435897435897436
Control.SRR15539824;36;40;0.527777777777778;17;19;0.0277777777777778;0.472222222222222
Control.SRR15539824;37;40;0.540540540540541;17;20;0.0405405405405406;0.459459459459459
Control.SRR15539824;45;40;0.577777777777778;19;26;0.0777777777777777;0.422222222222222
Control.SRR15539824;35;40;0.4;21;14;0.1;0.4
Control.SRR15539824;42;40;0.404761904761905;25;17;0.0952380952380952;0.404761904761905
Control.SRR15539824;44;40;0.590909090909091;18;26;0.0909090909090909;0.409090909090909
Control.SRR15539824;44;40;0.477272727272727;23;21;0.0227272727272727;0.477272727272727
Control.SRR15539824;36;40;0.583333333333333;15;21;0.0833333333333334;0.416666666666667
Control.SRR15539824;35;40;0.371428571428571;22;13;0.128571428571429;0.371428571428571
Control.SRR15539824;38;40;0.552631578947368;17;21;0.0526315789473685;0.447368421052632
Control.SRR15539824;39;40;0.487179487179487;20;19;0.0128205128205128;0.487179487179487
Control.SRR15539824;41;40;0.439024390243902;23;18;0.0609756097560976;0.439024390243902
Control.SRR15539824;40;40;0.625;15;25;0.125;0.375
Control.SRR15539824;42;40;0.571428571428571;18;24;0.0714285714285714;0.428571428571429
Control.SRR15539824;38;40;0.421052631578947;22;16;0.0789473684210527;0.421052631578947
Control.SRR15539824;43;40;0.465116279069767;23;20;0.0348837209302326;0.465116279069767
Control.SRR15539824;42;40;0.428571428571429;24;18;0.0714285714285715;0.428571428571429
Control.SRR15539824;37;40;0.594594594594595;15;22;0.0945945945945946;0.405405405405405
Control.SRR15539824;43;40;0.558139534883721;19;24;0.0581395348837209;0.441860465116279
Control.SRR15539824;44;40;0.5;22;22;0;0.5
Control.SRR15539824;38;40;0.526315789473684;18;20;0.0263157894736842;0.473684210526316
Control.SRR15539824;40;40;0.425;23;17;0.075;0.425
Control.SRR15539824;44;40;0.613636363636364;17;27;0.113636363636364;0.386363636363636
Control.SRR15539824;39;40;0.512820512820513;19;20;0.0128205128205128;0.487179487179487
Control.SRR15539824;43;40;0.511627906976744;21;22;0.0116279069767442;0.488372093023256
Control.SRR15539824;40;40;0.5;20;20;0;0.5
Control.SRR15539824;44;40;0.477272727272727;23;21;0.0227272727272727;0.477272727272727
Control.SRR15539824;35;40;0.571428571428571;15;20;0.0714285714285714;0.428571428571429
Control.SRR15539824;35;40;0.542857142857143;16;19;0.0428571428571428;0.457142857142857
Control.SRR15539824;39;40;0.564102564102564;17;22;0.0641025641025641;0.435897435897436
Control.SRR15539824;40;40;0.45;22;18;0.05;0.45
Control.SRR15539824;43;40;0.348837209302326;28;15;0.151162790697674;0.348837209302326
Control.SRR15539824;40;40;0.5;20;20;0;0.5
Control.SRR15539824;37;40;0.378378378378378;23;14;0.121621621621622;0.378378378378378
Control.SRR15539824;38;40;0.421052631578947;22;16;0.0789473684210527;0.421052631578947
Control.SRR15539824;39;40;0.58974358974359;16;23;0.0897435897435898;0.41025641025641
Control.SRR15539824;36;40;0.444444444444444;20;16;0.0555555555555556;0.444444444444444
Control.SRR15539824;38;40;0.578947368421053;16;22;0.0789473684210527;0.421052631578947
Control.SRR15539824;39;40;0.615384615384615;15;24;0.115384615384615;0.384615384615385
Control.SRR15539824;36;40;0.527777777777778;17;19;0.0277777777777778;0.472222222222222
Control.SRR15539824;40;40;0.525;19;21;0.025;0.475
Control.SRR15539824;39;40;0.615384615384615;15;24;0.115384615384615;0.384615384615385
Control.SRR15539824;37;40;0.405405405405405;22;15;0.0945945945945946;0.405405405405405
Control.SRR15539824;35;40;0.542857142857143;16;19;0.0428571428571428;0.457142857142857
Control.SRR15539824;42;40;0.523809523809524;20;22;0.0238095238095238;0.476190476190476
Control.SRR15539824;42;40;0.452380952380952;23;19;0.0476190476190476;0.452380952380952
Control.SRR15539824;41;40;0.48780487804878;21;20;0.0121951219512195;0.48780487804878
Control.SRR15539824;35;40;0.628571428571429;13;22;0.128571428571429;0.371428571428571
Control.SRR15539824;39;40;0.461538461538462;21;18;0.0384615384615384;0.461538461538462
Control.SRR15539824;37;40;0.567567567567568;16;21;0.0675675675675675;0.432432432432432
Control.SRR15539824;37;40;0.540540540540541;17;20;0.0405405405405406;0.459459459459459
Control.SRR15539824;42;40;0.547619047619048;19;23;0.0476190476190477;0.452380952380952
Control.SRR15539824;35;40;0.485714285714286;18;17;0.0142857142857143;0.485714285714286
Control.SRR15539824;39;40;0.58974358974359;16;23;0.0897435897435898;0.41025641025641
Control.SRR15539824;45;40;0.555555555555556;20;25;0.0555555555555556;0.444444444444444
Control.SRR15539824;35;40;0.542857142857143;16;19;0.0428571428571428;0.457142857142857
Control.SRR15539824;35;40;0.6;14;21;0.1;0.4
Control.SRR15539824;44;40;0.477272727272727;23;21;0.0227272727272727;0.477272727272727
Control.SRR15539824;36;40;0.527777777777778;17;19;0.0277777777777778;0.472222222222222
Control.SRR15539824;41;40;0.682926829268293;13;28;0.182926829268293;0.317073170731707
Control.SRR15539824;38;40;0.473684210526316;20;18;0.0263157894736842;0.473684210526316
Control.SRR15539824;38;40;0.526315789473684;18;20;0.0263157894736842;0.473684210526316
Control.SRR15539824;44;40;0.568181818181818;19;25;0.0681818181818182;0.431818181818182
Control.SRR15539824;41;40;0.536585365853659;19;22;0.0365853658536586;0.463414634146341
Control.SRR15539824;38;40;0.526315789473684;18;20;0.0263157894736842;0.473684210526316
Control.SRR15539824;43;40;0.534883720930233;20;23;0.0348837209302325;0.465116279069767
Control.SRR15539824;41;40;0.463414634146341;22;19;0.0365853658536585;0.463414634146341
Control.SRR15539824;40;40;0.575;17;23;0.075;0.425
Control.SRR15539824;36;40;0.527777777777778;17;19;0.0277777777777778;0.472222222222222
Control.SRR15539824;38;40;0.552631578947368;17;21;0.0526315789473685;0.447368421052632
Control.SRR15539824;45;40;0.577777777777778;19;26;0.0777777777777777;0.422222222222222
Control.SRR15539824;41;40;0.51219512195122;20;21;0.0121951219512195;0.48780487804878
Control.SRR15539824;44;40;0.545454545454545;20;24;0.0454545454545454;0.454545454545455
Control.SRR15539824;40;40;0.475;21;19;0.025;0.475
Control.SRR15539824;41;40;0.658536585365854;14;27;0.158536585365854;0.341463414634146
Control.SRR15539824;44;40;0.659090909090909;15;29;0.159090909090909;0.340909090909091
Control.SRR15539824;37;40;0.540540540540541;17;20;0.0405405405405406;0.459459459459459
Control.SRR15539824;41;40;0.439024390243902;23;18;0.0609756097560976;0.439024390243902
Control.SRR15539824;41;40;0.536585365853659;19;22;0.0365853658536586;0.463414634146341
Control.SRR15539824;43;40;0.604651162790698;17;26;0.104651162790698;0.395348837209302
Control.SRR15539824;41;40;0.463414634146341;22;19;0.0365853658536585;0.463414634146341
Control.SRR15539824;37;40;0.513513513513513;18;19;0.0135135135135135;0.486486486486487
Control.SRR15539824;37;40;0.459459459459459;20;17;0.0405405405405405;0.459459459459459
Control.SRR15539824;39;40;0.487179487179487;20;19;0.0128205128205128;0.487179487179487
Control.SRR15539824;37;40;0.540540540540541;17;20;0.0405405405405406;0.459459459459459
Control.SRR15539824;35;40;0.514285714285714;17;18;0.0142857142857142;0.485714285714286
Control.SRR15539824;37;40;0.324324324324324;25;12;0.175675675675676;0.324324324324324
Control.SRR15539824;38;40;0.5;19;19;0;0.5
Control.SRR15539824;35;40;0.485714285714286;18;17;0.0142857142857143;0.485714285714286
Control.SRR15539824;44;40;0.477272727272727;23;21;0.0227272727272727;0.477272727272727
Control.SRR15539824;37;40;0.621621621621622;14;23;0.121621621621622;0.378378378378378
Control.SRR15539824;38;40;0.5;19;19;0;0.5
Control.SRR15539824;45;40;0.488888888888889;23;22;0.0111111111111111;0.488888888888889
Control.SRR15539824;38;40;0.552631578947368;17;21;0.0526315789473685;0.447368421052632
Control.SRR15539824;36;40;0.583333333333333;15;21;0.0833333333333334;0.416666666666667
Control.SRR15539824;44;40;0.545454545454545;20;24;0.0454545454545454;0.454545454545455
Control.SRR15539824;36;40;0.361111111111111;23;13;0.138888888888889;0.361111111111111
Control.SRR15539824;40;40;0.625;15;25;0.125;0.375
Control.SRR15539824;41;40;0.439024390243902;23;18;0.0609756097560976;0.439024390243902
Control.SRR15539824;39;40;0.461538461538462;21;18;0.0384615384615384;0.461538461538462
Control.SRR15539824;41;40;0.463414634146341;22;19;0.0365853658536585;0.463414634146341
Control.SRR15539824;35;40;0.6;14;21;0.1;0.4
Control.SRR15539824;36;40;0.5;18;18;0;0.5
Control.SRR15539824;43;40;0.465116279069767;23;20;0.0348837209302326;0.465116279069767
Control.SRR15539824;44;40;0.5;22;22;0;0.5
Control.SRR15539824;36;40;0.388888888888889;22;14;0.111111111111111;0.388888888888889
Control.SRR15539824;45;40;0.488888888888889;23;22;0.0111111111111111;0.488888888888889
Control.SRR15539824;44;40;0.477272727272727;23;21;0.0227272727272727;0.477272727272727
Control.SRR15539824;40;40;0.45;22;18;0.05;0.45
Control.SRR15539824;42;40;0.476190476190476;22;20;0.0238095238095238;0.476190476190476
Control.SRR15539824;41;40;0.463414634146341;22;19;0.0365853658536585;0.463414634146341
Control.SRR15539824;43;40;0.465116279069767;23;20;0.0348837209302326;0.465116279069767
Control.SRR15539824;45;40;0.644444444444444;16;29;0.144444444444444;0.355555555555556
Control.SRR15539824;39;40;0.461538461538462;21;18;0.0384615384615384;0.461538461538462
Control.SRR15539824;40;40;0.3;28;12;0.2;0.3
Control.SRR15539824;44;40;0.545454545454545;20;24;0.0454545454545454;0.454545454545455
Control.SRR15539824;40;40;0.55;18;22;0.05;0.45
Control.SRR15539824;38;40;0.315789473684211;26;12;0.184210526315789;0.315789473684211
Control.SRR15539824;39;40;0.538461538461538;18;21;0.0384615384615384;0.461538461538462
Control.SRR15539824;38;40;0.394736842105263;23;15;0.105263157894737;0.394736842105263
Control.SRR15539824;35;40;0.457142857142857;19;16;0.0428571428571429;0.457142857142857
Control.SRR15539824;39;40;0.538461538461538;18;21;0.0384615384615384;0.461538461538462
Control.SRR15539824;35;40;0.542857142857143;16;19;0.0428571428571428;0.457142857142857
Control.SRR15539824;38;40;0.578947368421053;16;22;0.0789473684210527;0.421052631578947
Control.SRR15539824;41;40;0.51219512195122;20;21;0.0121951219512195;0.48780487804878
Control.SRR15539824;35;40;0.542857142857143;16;19;0.0428571428571428;0.457142857142857
Control.SRR15539824;39;40;0.41025641025641;23;16;0.0897435897435898;0.41025641025641
Control.SRR15539824;45;40;0.377777777777778;28;17;0.122222222222222;0.377777777777778
Control.SRR15539824;45;40;0.555555555555556;20;25;0.0555555555555556;0.444444444444444
Control.SRR15539824;35;40;0.571428571428571;15;20;0.0714285714285714;0.428571428571429
Control.SRR15539824;37;40;0.540540540540541;17;20;0.0405405405405406;0.459459459459459
Control.SRR15539824;36;40;0.555555555555556;16;20;0.0555555555555556;0.444444444444444
Control.SRR15539824;35;40;0.542857142857143;16;19;0.0428571428571428;0.457142857142857
Control.SRR15539824;36;40;0.638888888888889;13;23;0.138888888888889;0.361111111111111
Control.SRR15539824;36;40;0.527777777777778;17;19;0.0277777777777778;0.472222222222222
Control.SRR15539824;44;40;0.5;22;22;0;0.5
Control.SRR15539824;45;40;0.466666666666667;24;21;0.0333333333333333;0.466666666666667
Control.SRR15539824;45;40;0.422222222222222;26;19;0.0777777777777778;0.422222222222222
Control.SRR15539824;44;40;0.409090909090909;26;18;0.0909090909090909;0.409090909090909
Control.SRR15539824;40;40;0.475;21;19;0.025;0.475
Control.SRR15539824;42;40;0.452380952380952;23;19;0.0476190476190476;0.452380952380952
Control.SRR15539824;41;40;0.414634146341463;24;17;0.0853658536585366;0.414634146341463
Control.SRR15539824;44;40;0.5;22;22;0;0.5
Control.SRR15539824;36;40;0.416666666666667;21;15;0.0833333333333333;0.416666666666667
Control.SRR15539824;40;40;0.425;23;17;0.075;0.425
Control.SRR15539824;36;40;0.444444444444444;20;16;0.0555555555555556;0.444444444444444
Control.SRR15539824;38;40;0.473684210526316;20;18;0.0263157894736842;0.473684210526316
Control.SRR15539824;39;40;0.435897435897436;22;17;0.0641025641025641;0.435897435897436
Control.SRR15539824;40;40;0.475;21;19;0.025;0.475
Control.SRR15539824;36;40;0.416666666666667;21;15;0.0833333333333333;0.416666666666667
Control.SRR15539824;35;40;0.428571428571429;20;15;0.0714285714285715;0.428571428571429
Control.SRR15539824;39;40;0.358974358974359;25;14;0.141025641025641;0.358974358974359
Control.SRR15539824;35;40;0.571428571428571;15;20;0.0714285714285714;0.428571428571429
Control.SRR15539824;35;40;0.428571428571429;20;15;0.0714285714285715;0.428571428571429
Control.SRR15539824;43;40;0.581395348837209;18;25;0.0813953488372093;0.418604651162791
Control.SRR15539824;42;40;0.476190476190476;22;20;0.0238095238095238;0.476190476190476
Control.SRR15539824;43;40;0.465116279069767;23;20;0.0348837209302326;0.465116279069767
Control.SRR15539824;37;40;0.432432432432432;21;16;0.0675675675675675;0.432432432432432
Control.SRR15539824;36;40;0.555555555555556;16;20;0.0555555555555556;0.444444444444444
Control.SRR15539824;36;40;0.333333333333333;24;12;0.166666666666667;0.333333333333333
Control.SRR15539824;43;40;0.511627906976744;21;22;0.0116279069767442;0.488372093023256
Control.SRR15539824;41;40;0.341463414634146;27;14;0.158536585365854;0.341463414634146
Control.SRR15539824;45;40;0.6;18;27;0.1;0.4
Control.SRR15539824;44;40;0.545454545454545;20;24;0.0454545454545454;0.454545454545455
Control.SRR15539824;38;40;0.5;19;19;0;0.5
Control.SRR15539824;38;40;0.368421052631579;24;14;0.131578947368421;0.368421052631579
Control.SRR15539824;42;40;0.452380952380952;23;19;0.0476190476190476;0.452380952380952
Control.SRR15539824;45;40;0.488888888888889;23;22;0.0111111111111111;0.488888888888889
Control.SRR15539824;42;40;0.619047619047619;16;26;0.119047619047619;0.380952380952381
Control.SRR15539824;40;40;0.65;14;26;0.15;0.35
Control.SRR15539824;39;40;0.564102564102564;17;22;0.0641025641025641;0.435897435897436
Control.SRR15539824;45;40;0.488888888888889;23;22;0.0111111111111111;0.488888888888889
Control.SRR15539824;42;40;0.476190476190476;22;20;0.0238095238095238;0.476190476190476
Control.SRR15539824;43;40;0.511627906976744;21;22;0.0116279069767442;0.488372093023256
Control.SRR15539824;37;40;0.486486486486487;19;18;0.0135135135135135;0.486486486486487
Control.SRR15539824;35;40;0.571428571428571;15;20;0.0714285714285714;0.428571428571429
Control.SRR15539824;36;40;0.611111111111111;14;22;0.111111111111111;0.388888888888889
Control.SRR15539824;42;40;0.404761904761905;25;17;0.0952380952380952;0.404761904761905
Control.SRR15539824;35;40;0.457142857142857;19;16;0.0428571428571429;0.457142857142857
Control.SRR15539824;45;40;0.644444444444444;16;29;0.144444444444444;0.355555555555556
Control.SRR15539824;42;40;0.619047619047619;16;26;0.119047619047619;0.380952380952381
Control.SRR15539824;45;40;0.6;18;27;0.1;0.4
Control.SRR15539824;35;40;0.514285714285714;17;18;0.0142857142857142;0.485714285714286
Control.SRR15539824;36;40;0.527777777777778;17;19;0.0277777777777778;0.472222222222222
Control.SRR15539824;40;40;0.55;18;22;0.05;0.45
Control.SRR15539824;40;40;0.525;19;21;0.025;0.475
Control.SRR15539824;41;40;0.414634146341463;24;17;0.0853658536585366;0.414634146341463
Control.SRR15539824;40;40;0.475;21;19;0.025;0.475
Control.SRR15539824;38;40;0.605263157894737;15;23;0.105263157894737;0.394736842105263
Control.SRR15539824;42;40;0.523809523809524;20;22;0.0238095238095238;0.476190476190476
Control.SRR15539824;43;40;0.441860465116279;24;19;0.0581395348837209;0.441860465116279
Control.SRR15539824;45;40;0.666666666666667;15;30;0.166666666666667;0.333333333333333
Control.SRR15539824;35;40;0.6;14;21;0.1;0.4
Control.SRR15539824;45;40;0.377777777777778;28;17;0.122222222222222;0.377777777777778
Control.SRR15539824;39;40;0.41025641025641;23;16;0.0897435897435898;0.41025641025641
Control.SRR15539824;40;40;0.4;24;16;0.1;0.4
Control.SRR15539824;35;40;0.485714285714286;18;17;0.0142857142857143;0.485714285714286
Control.SRR15539824;39;40;0.435897435897436;22;17;0.0641025641025641;0.435897435897436
Control.SRR15539824;37;40;0.486486486486487;19;18;0.0135135135135135;0.486486486486487
Control.SRR15539824;38;40;0.368421052631579;24;14;0.131578947368421;0.368421052631579
Control.SRR15539824;43;40;0.395348837209302;26;17;0.104651162790698;0.395348837209302
Control.SRR15539824;43;40;0.511627906976744;21;22;0.0116279069767442;0.488372093023256
Control.SRR15539824;42;40;0.452380952380952;23;19;0.0476190476190476;0.452380952380952
Control.SRR15539824;37;40;0.405405405405405;22;15;0.0945945945945946;0.405405405405405
Control.SRR15539824;39;40;0.641025641025641;14;25;0.141025641025641;0.358974358974359
Control.SRR15539824;39;40;0.41025641025641;23;16;0.0897435897435898;0.41025641025641
Control.SRR15539824;38;40;0.421052631578947;22;16;0.0789473684210527;0.421052631578947
Control.SRR15539824;39;40;0.58974358974359;16;23;0.0897435897435898;0.41025641025641
Control.SRR15539824;40;40;0.6;16;24;0.1;0.4
Control.SRR15539824;36;40;0.388888888888889;22;14;0.111111111111111;0.388888888888889
Control.SRR15539824;40;40;0.5;20;20;0;0.5
Control.SRR15539824;38;40;0.526315789473684;18;20;0.0263157894736842;0.473684210526316
Control.SRR15539824;40;40;0.625;15;25;0.125;0.375
Control.SRR15539824;37;40;0.594594594594595;15;22;0.0945945945945946;0.405405405405405
Control.SRR15539824;43;40;0.488372093023256;22;21;0.0116279069767442;0.488372093023256
Control.SRR15539824;39;40;0.41025641025641;23;16;0.0897435897435898;0.41025641025641
Control.SRR15539824;42;40;0.619047619047619;16;26;0.119047619047619;0.380952380952381
Control.SRR15539824;36;40;0.638888888888889;13;23;0.138888888888889;0.361111111111111
Control.SRR15539824;44;40;0.545454545454545;20;24;0.0454545454545454;0.454545454545455
Control.SRR15539824;41;40;0.48780487804878;21;20;0.0121951219512195;0.48780487804878
Control.SRR15539824;40;40;0.625;15;25;0.125;0.375
Control.SRR15539824;40;40;0.55;18;22;0.05;0.45
Control.SRR15539824;35;40;0.457142857142857;19;16;0.0428571428571429;0.457142857142857
Control.SRR15539824;44;40;0.409090909090909;26;18;0.0909090909090909;0.409090909090909
Control.SRR15539824;39;40;0.487179487179487;20;19;0.0128205128205128;0.487179487179487
Control.SRR15539824;38;40;0.578947368421053;16;22;0.0789473684210527;0.421052631578947
Control.SRR15539824;45;40;0.444444444444444;25;20;0.0555555555555556;0.444444444444444
Control.SRR15539824;35;40;0.457142857142857;19;16;0.0428571428571429;0.457142857142857
Control.SRR15539824;36;40;0.444444444444444;20;16;0.0555555555555556;0.444444444444444
Control.SRR15539824;38;40;0.421052631578947;22;16;0.0789473684210527;0.421052631578947
Control.SRR15539824;43;40;0.627906976744186;16;27;0.127906976744186;0.372093023255814
Control.SRR15539824;36;40;0.361111111111111;23;13;0.138888888888889;0.361111111111111
Control.SRR15539824;36;40;0.472222222222222;19;17;0.0277777777777778;0.472222222222222
Control.SRR15539824;35;40;0.485714285714286;18;17;0.0142857142857143;0.485714285714286
Control.SRR15539824;38;40;0.421052631578947;22;16;0.0789473684210527;0.421052631578947
Control.SRR15539824;38;40;0.447368421052632;21;17;0.0526315789473684;0.447368421052632
Control.SRR15539824;42;40;0.547619047619048;19;23;0.0476190476190477;0.452380952380952
Control.SRR15539824;36;40;0.472222222222222;19;17;0.0277777777777778;0.472222222222222
Control.SRR15539824;37;40;0.513513513513513;18;19;0.0135135135135135;0.486486486486487
Control.SRR15539824;37;40;0.324324324324324;25;12;0.175675675675676;0.324324324324324
Control.SRR15539824;45;40;0.577777777777778;19;26;0.0777777777777777;0.422222222222222
Control.SRR15539824;38;40;0.657894736842105;13;25;0.157894736842105;0.342105263157895
Control.SRR15539824;35;40;0.628571428571429;13;22;0.128571428571429;0.371428571428571
Control.SRR15539824;41;40;0.390243902439024;25;16;0.109756097560976;0.390243902439024
Control.SRR15539824;43;40;0.581395348837209;18;25;0.0813953488372093;0.418604651162791
Control.SRR15539824;43;40;0.604651162790698;17;26;0.104651162790698;0.395348837209302
Control.SRR15539824;36;40;0.388888888888889;22;14;0.111111111111111;0.388888888888889
Control.SRR15539824;35;40;0.342857142857143;23;12;0.157142857142857;0.342857142857143
Control.SRR15539824;44;40;0.522727272727273;21;23;0.0227272727272727;0.477272727272727
Control.SRR15539824;45;40;0.577777777777778;19;26;0.0777777777777777;0.422222222222222
Control.SRR15539824;38;40;0.394736842105263;23;15;0.105263157894737;0.394736842105263
Control.SRR15539824;37;40;0.594594594594595;15;22;0.0945945945945946;0.405405405405405
Control.SRR15539824;41;40;0.585365853658537;17;24;0.0853658536585366;0.414634146341463
Control.SRR15539824;40;40;0.4;24;16;0.1;0.4
Control.SRR15539824;40;40;0.35;26;14;0.15;0.35
Control.SRR15539824;45;40;0.6;18;27;0.1;0.4
Control.SRR15539824;40;40;0.55;18;22;0.05;0.45
Control.SRR15539824;44;40;0.568181818181818;19;25;0.0681818181818182;0.431818181818182
Control.SRR15539824;43;40;0.488372093023256;22;21;0.0116279069767442;0.488372093023256
Control.SRR15539824;40;40;0.55;18;22;0.05;0.45
Control.SRR15539824;36;40;0.472222222222222;19;17;0.0277777777777778;0.472222222222222
Control.SRR15539824;36;40;0.527777777777778;17;19;0.0277777777777778;0.472222222222222
Control.SRR15539824;43;40;0.488372093023256;22;21;0.0116279069767442;0.488372093023256
Control.SRR15539824;41;40;0.707317073170732;12;29;0.207317073170732;0.292682926829268
Control.SRR15539824;41;40;0.51219512195122;20;21;0.0121951219512195;0.48780487804878
Control.SRR15539824;38;40;0.552631578947368;17;21;0.0526315789473685;0.447368421052632
Control.SRR15539824;36;40;0.416666666666667;21;15;0.0833333333333333;0.416666666666667
Control.SRR15539824;45;40;0.577777777777778;19;26;0.0777777777777777;0.422222222222222
Control.SRR15539824;35;40;0.457142857142857;19;16;0.0428571428571429;0.457142857142857
Control.SRR15539824;44;40;0.477272727272727;23;21;0.0227272727272727;0.477272727272727
Control.SRR15539824;43;40;0.581395348837209;18;25;0.0813953488372093;0.418604651162791
Control.SRR15539824;39;40;0.58974358974359;16;23;0.0897435897435898;0.41025641025641
Control.SRR15539824;36;40;0.472222222222222;19;17;0.0277777777777778;0.472222222222222
Control.SRR15539824;39;40;0.487179487179487;20;19;0.0128205128205128;0.487179487179487
Control.SRR15539824;42;40;0.476190476190476;22;20;0.0238095238095238;0.476190476190476
Control.SRR15539824;44;40;0.590909090909091;18;26;0.0909090909090909;0.409090909090909
Control.SRR15539824;44;40;0.431818181818182;25;19;0.0681818181818182;0.431818181818182
Control.SRR15539824;43;40;0.488372093023256;22;21;0.0116279069767442;0.488372093023256
Control.SRR15539824;45;40;0.6;18;27;0.1;0.4
Control.SRR15539824;38;40;0.552631578947368;17;21;0.0526315789473685;0.447368421052632
Control.SRR15539824;44;40;0.431818181818182;25;19;0.0681818181818182;0.431818181818182
Control.SRR15539824;45;40;0.466666666666667;24;21;0.0333333333333333;0.466666666666667
Control.SRR15539824;42;40;0.428571428571429;24;18;0.0714285714285715;0.428571428571429
Control.SRR15539824;40;40;0.45;22;18;0.05;0.45
Control.SRR15539824;41;40;0.560975609756098;18;23;0.0609756097560976;0.439024390243902
Control.SRR15539824;44;40;0.477272727272727;23;21;0.0227272727272727;0.477272727272727
Control.SRR15539824;45;40;0.466666666666667;24;21;0.0333333333333333;0.466666666666667
Control.SRR15539824;38;40;0.526315789473684;18;20;0.0263157894736842;0.473684210526316
Control.SRR15539824;36;40;0.388888888888889;22;14;0.111111111111111;0.388888888888889
Control.SRR15539824;45;40;0.511111111111111;22;23;0.0111111111111111;0.488888888888889
Control.SRR15539824;38;40;0.473684210526316;20;18;0.0263157894736842;0.473684210526316
Control.SRR15539824;45;40;0.422222222222222;26;19;0.0777777777777778;0.422222222222222
Control.SRR15539824;45;40;0.488888888888889;23;22;0.0111111111111111;0.488888888888889
Control.SRR15539824;43;40;0.488372093023256;22;21;0.0116279069767442;0.488372093023256
Control.SRR15539824;43;40;0.465116279069767;23;20;0.0348837209302326;0.465116279069767
Control.SRR15539824;37;40;0.513513513513513;18;19;0.0135135135135135;0.486486486486487
Control.SRR15539824;36;40;0.611111111111111;14;22;0.111111111111111;0.388888888888889
Control.SRR15539824;39;40;0.564102564102564;17;22;0.0641025641025641;0.435897435897436
Control.SRR15539824;37;40;0.405405405405405;22;15;0.0945945945945946;0.405405405405405
Control.SRR15539824;43;40;0.511627906976744;21;22;0.0116279069767442;0.488372093023256
Control.SRR15539824;44;40;0.431818181818182;25;19;0.0681818181818182;0.431818181818182
Control.SRR15539824;38;40;0.368421052631579;24;14;0.131578947368421;0.368421052631579
Control.SRR15539824;43;40;0.441860465116279;24;19;0.0581395348837209;0.441860465116279
Control.SRR15539824;39;40;0.461538461538462;21;18;0.0384615384615384;0.461538461538462
Control.SRR15539824;41;40;0.390243902439024;25;16;0.109756097560976;0.390243902439024
Control.SRR15539824;41;40;0.414634146341463;24;17;0.0853658536585366;0.414634146341463
Control.SRR15539824;41;40;0.560975609756098;18;23;0.0609756097560976;0.439024390243902
Control.SRR15539824;35;40;0.428571428571429;20;15;0.0714285714285715;0.428571428571429
Control.SRR15539824;37;40;0.567567567567568;16;21;0.0675675675675675;0.432432432432432
Control.SRR15539824;38;40;0.421052631578947;22;16;0.0789473684210527;0.421052631578947
Control.SRR15539824;41;40;0.609756097560976;16;25;0.109756097560976;0.390243902439024
Control.SRR15539824;38;40;0.526315789473684;18;20;0.0263157894736842;0.473684210526316
Control.SRR15539824;42;40;0.476190476190476;22;20;0.0238095238095238;0.476190476190476
Control.SRR15539824;45;40;0.466666666666667;24;21;0.0333333333333333;0.466666666666667
Control.SRR15539824;43;40;0.511627906976744;21;22;0.0116279069767442;0.488372093023256
Control.SRR15539824;38;40;0.447368421052632;21;17;0.0526315789473684;0.447368421052632
Control.SRR15539824;35;40;0.542857142857143;16;19;0.0428571428571428;0.457142857142857
Control.SRR15539824;43;40;0.511627906976744;21;22;0.0116279069767442;0.488372093023256
Control.SRR15539824;37;40;0.486486486486487;19;18;0.0135135135135135;0.486486486486487
Control.SRR15539824;40;40;0.375;25;15;0.125;0.375
Control.SRR15539824;43;40;0.558139534883721;19;24;0.0581395348837209;0.441860465116279
Control.SRR15539824;43;40;0.488372093023256;22;21;0.0116279069767442;0.488372093023256
Control.SRR15539824;42;40;0.5;21;21;0;0.5
Control.SRR15539824;36;40;0.583333333333333;15;21;0.0833333333333334;0.416666666666667
Control.SRR15539824;41;40;0.51219512195122;20;21;0.0121951219512195;0.48780487804878
Control.SRR15539824;40;40;0.525;19;21;0.025;0.475
Control.SRR15539824;42;40;0.452380952380952;23;19;0.0476190476190476;0.452380952380952
Control.SRR15539824;40;40;0.55;18;22;0.05;0.45
Control.SRR15539824;42;40;0.547619047619048;19;23;0.0476190476190477;0.452380952380952
Control.SRR15539824;43;40;0.325581395348837;29;14;0.174418604651163;0.325581395348837
Control.SRR15539824;45;40;0.577777777777778;19;26;0.0777777777777777;0.422222222222222
Control.SRR15539824;42;40;0.5;21;21;0;0.5
Control.SRR15539824;41;40;0.341463414634146;27;14;0.158536585365854;0.341463414634146
Control.SRR15539824;42;40;0.476190476190476;22;20;0.0238095238095238;0.476190476190476
Control.SRR15539824;39;40;0.461538461538462;21;18;0.0384615384615384;0.461538461538462
Control.SRR15539824;41;40;0.609756097560976;16;25;0.109756097560976;0.390243902439024
Control.SRR15539824;37;40;0.513513513513513;18;19;0.0135135135135135;0.486486486486487
Control.SRR15539824;38;40;0.421052631578947;22;16;0.0789473684210527;0.421052631578947
Control.SRR15539824;38;40;0.5;19;19;0;0.5
Control.SRR15539824;40;40;0.575;17;23;0.075;0.425
Control.SRR15539824;42;40;0.5;21;21;0;0.5
Control.SRR15539824;40;40;0.45;22;18;0.05;0.45
Control.SRR15539824;44;40;0.545454545454545;20;24;0.0454545454545454;0.454545454545455
Control.SRR15539824;39;40;0.487179487179487;20;19;0.0128205128205128;0.487179487179487
Control.SRR15539824;39;40;0.666666666666667;13;26;0.166666666666667;0.333333333333333
Control.SRR15539824;35;40;0.628571428571429;13;22;0.128571428571429;0.371428571428571
Control.SRR15539824;38;40;0.5;19;19;0;0.5
Control.SRR15539824;35;40;0.457142857142857;19;16;0.0428571428571429;0.457142857142857
Control.SRR15539824;44;40;0.522727272727273;21;23;0.0227272727272727;0.477272727272727
Control.SRR15539824;36;40;0.638888888888889;13;23;0.138888888888889;0.361111111111111
Control.SRR15539824;39;40;0.333333333333333;26;13;0.166666666666667;0.333333333333333
Control.SRR15539824;44;40;0.545454545454545;20;24;0.0454545454545454;0.454545454545455
Control.SRR15539824;36;40;0.444444444444444;20;16;0.0555555555555556;0.444444444444444
Control.SRR15539824;41;40;0.317073170731707;28;13;0.182926829268293;0.317073170731707
Control.SRR15539824;44;40;0.613636363636364;17;27;0.113636363636364;0.386363636363636
Control.SRR15539824;43;40;0.372093023255814;27;16;0.127906976744186;0.372093023255814
Control.SRR15539824;41;40;0.390243902439024;25;16;0.109756097560976;0.390243902439024
Control.SRR15539824;35;40;0.457142857142857;19;16;0.0428571428571429;0.457142857142857
Control.SRR15539824;35;40;0.571428571428571;15;20;0.0714285714285714;0.428571428571429
Control.SRR15539824;42;40;0.476190476190476;22;20;0.0238095238095238;0.476190476190476
Control.SRR15539824;37;40;0.621621621621622;14;23;0.121621621621622;0.378378378378378
Control.SRR15539824;39;40;0.538461538461538;18;21;0.0384615384615384;0.461538461538462
Control.SRR15539824;37;40;0.513513513513513;18;19;0.0135135135135135;0.486486486486487
Control.SRR15539824;35;40;0.457142857142857;19;16;0.0428571428571429;0.457142857142857
Control.SRR15539824;37;40;0.459459459459459;20;17;0.0405405405405405;0.459459459459459
Control.SRR15539824;35;40;0.628571428571429;13;22;0.128571428571429;0.371428571428571
Control.SRR15539824;45;40;0.533333333333333;21;24;0.0333333333333333;0.466666666666667
Control.SRR15539824;35;40;0.657142857142857;12;23;0.157142857142857;0.342857142857143
Control.SRR15539824;43;40;0.558139534883721;19;24;0.0581395348837209;0.441860465116279
Control.SRR15539824;43;40;0.372093023255814;27;16;0.127906976744186;0.372093023255814
Control.SRR15539824;45;40;0.555555555555556;20;25;0.0555555555555556;0.444444444444444
Control.SRR15539824;45;40;0.377777777777778;28;17;0.122222222222222;0.377777777777778
Control.SRR15539824;39;40;0.41025641025641;23;16;0.0897435897435898;0.41025641025641
Control.SRR15539824;39;40;0.435897435897436;22;17;0.0641025641025641;0.435897435897436
Control.SRR15539824;36;40;0.472222222222222;19;17;0.0277777777777778;0.472222222222222
Control.SRR15539824;42;40;0.5;21;21;0;0.5
Control.SRR15539824;35;40;0.6;14;21;0.1;0.4
Control.SRR15539824;42;40;0.547619047619048;19;23;0.0476190476190477;0.452380952380952
Control.SRR15539824;40;40;0.5;20;20;0;0.5
Control.SRR15539824;41;40;0.48780487804878;21;20;0.0121951219512195;0.48780487804878
Control.SRR15539824;36;40;0.416666666666667;21;15;0.0833333333333333;0.416666666666667
Control.SRR15539824;35;40;0.514285714285714;17;18;0.0142857142857142;0.485714285714286
Control.SRR15539824;44;40;0.613636363636364;17;27;0.113636363636364;0.386363636363636
Control.SRR15539824;40;40;0.55;18;22;0.05;0.45
Control.SRR15539824;40;40;0.525;19;21;0.025;0.475
Control.SRR15539824;35;40;0.571428571428571;15;20;0.0714285714285714;0.428571428571429
Control.SRR15539824;44;40;0.431818181818182;25;19;0.0681818181818182;0.431818181818182
Control.SRR15539824;38;40;0.421052631578947;22;16;0.0789473684210527;0.421052631578947
Control.SRR15539824;38;40;0.526315789473684;18;20;0.0263157894736842;0.473684210526316
Control.SRR15539824;36;40;0.5;18;18;0;0.5
Control.SRR15539824;42;40;0.547619047619048;19;23;0.0476190476190477;0.452380952380952
Control.SRR15539824;42;40;0.571428571428571;18;24;0.0714285714285714;0.428571428571429
Control.SRR15539824;45;40;0.288888888888889;32;13;0.211111111111111;0.288888888888889
Control.SRR15539824;42;40;0.476190476190476;22;20;0.0238095238095238;0.476190476190476
Control.SRR15539824;44;40;0.363636363636364;28;16;0.136363636363636;0.363636363636364
Control.SRR15539824;44;40;0.454545454545455;24;20;0.0454545454545455;0.454545454545455
Control.SRR15539824;43;40;0.465116279069767;23;20;0.0348837209302326;0.465116279069767
Control.SRR15539824;43;40;0.465116279069767;23;20;0.0348837209302326;0.465116279069767
Control.SRR15539824;42;40;0.5;21;21;0;0.5
Control.SRR15539824;41;40;0.609756097560976;16;25;0.109756097560976;0.390243902439024
Control.SRR15539824;40;40;0.45;22;18;0.05;0.45
Control.SRR15539824;36;40;0.555555555555556;16;20;0.0555555555555556;0.444444444444444
Control.SRR15539824;45;40;0.377777777777778;28;17;0.122222222222222;0.377777777777778
Control.SRR15539824;43;40;0.558139534883721;19;24;0.0581395348837209;0.441860465116279
Control.SRR15539824;38;40;0.552631578947368;17;21;0.0526315789473685;0.447368421052632
Control.SRR15539824;38;40;0.578947368421053;16;22;0.0789473684210527;0.421052631578947
Control.SRR15539824;39;40;0.512820512820513;19;20;0.0128205128205128;0.487179487179487
Control.SRR15539824;35;40;0.457142857142857;19;16;0.0428571428571429;0.457142857142857
Control.SRR15539824;40;40;0.35;26;14;0.15;0.35
Control.SRR15539824;42;40;0.523809523809524;20;22;0.0238095238095238;0.476190476190476
Control.SRR15539824;41;40;0.634146341463415;15;26;0.134146341463415;0.365853658536585
Control.SRR15539824;44;40;0.431818181818182;25;19;0.0681818181818182;0.431818181818182
Control.SRR15539824;37;40;0.594594594594595;15;22;0.0945945945945946;0.405405405405405
Control.SRR15539824;43;40;0.534883720930233;20;23;0.0348837209302325;0.465116279069767
Control.SRR15539824;36;40;0.444444444444444;20;16;0.0555555555555556;0.444444444444444
Control.SRR15539824;38;40;0.421052631578947;22;16;0.0789473684210527;0.421052631578947
Control.SRR15539824;38;40;0.5;19;19;0;0.5
Control.SRR15539824;38;40;0.5;19;19;0;0.5
Control.SRR15539824;45;40;0.422222222222222;26;19;0.0777777777777778;0.422222222222222
Control.SRR15539824;39;40;0.58974358974359;16;23;0.0897435897435898;0.41025641025641
Control.SRR15539824;36;40;0.583333333333333;15;21;0.0833333333333334;0.416666666666667
Control.SRR15539824;36;40;0.583333333333333;15;21;0.0833333333333334;0.416666666666667
Control.SRR15539824;43;40;0.418604651162791;25;18;0.0813953488372093;0.418604651162791
Control.SRR15539824;40;40;0.475;21;19;0.025;0.475
Control.SRR15539824;43;40;0.372093023255814;27;16;0.127906976744186;0.372093023255814
Control.SRR15539824;38;40;0.421052631578947;22;16;0.0789473684210527;0.421052631578947
Control.SRR15539824;36;40;0.472222222222222;19;17;0.0277777777777778;0.472222222222222
Control.SRR15539824;41;40;0.365853658536585;26;15;0.134146341463415;0.365853658536585
Control.SRR15539824;37;40;0.540540540540541;17;20;0.0405405405405406;0.459459459459459
Control.SRR15539824;40;40;0.475;21;19;0.025;0.475
Control.SRR15539824;39;40;0.512820512820513;19;20;0.0128205128205128;0.487179487179487
Control.SRR15539824;43;40;0.441860465116279;24;19;0.0581395348837209;0.441860465116279
Control.SRR15539824;37;40;0.486486486486487;19;18;0.0135135135135135;0.486486486486487
Control.SRR15539824;42;40;0.642857142857143;15;27;0.142857142857143;0.357142857142857
Control.SRR15539824;44;40;0.454545454545455;24;20;0.0454545454545455;0.454545454545455
Control.SRR15539824;45;40;0.511111111111111;22;23;0.0111111111111111;0.488888888888889
Control.SRR15539824;43;40;0.511627906976744;21;22;0.0116279069767442;0.488372093023256
Control.SRR15539824;41;40;0.560975609756098;18;23;0.0609756097560976;0.439024390243902
Control.SRR15539824;36;40;0.472222222222222;19;17;0.0277777777777778;0.472222222222222
Control.SRR15539824;37;40;0.351351351351351;24;13;0.148648648648649;0.351351351351351
Control.SRR15539824;40;40;0.425;23;17;0.075;0.425
Control.SRR15539824;40;40;0.65;14;26;0.15;0.35
Control.SRR15539824;45;40;0.466666666666667;24;21;0.0333333333333333;0.466666666666667
Control.SRR15539824;42;40;0.5;21;21;0;0.5
Control.SRR15539824;39;40;0.538461538461538;18;21;0.0384615384615384;0.461538461538462
Control.SRR15539824;38;40;0.473684210526316;20;18;0.0263157894736842;0.473684210526316
Control.SRR15539824;43;40;0.488372093023256;22;21;0.0116279069767442;0.488372093023256
Control.SRR15539824;40;40;0.475;21;19;0.025;0.475
Control.SRR15539824;38;40;0.473684210526316;20;18;0.0263157894736842;0.473684210526316
Control.SRR15539824;44;40;0.545454545454545;20;24;0.0454545454545454;0.454545454545455
Control.SRR15539824;39;40;0.461538461538462;21;18;0.0384615384615384;0.461538461538462
Control.SRR15539824;44;40;0.545454545454545;20;24;0.0454545454545454;0.454545454545455
Control.SRR15539824;43;40;0.325581395348837;29;14;0.174418604651163;0.325581395348837
Control.SRR15539824;43;40;0.534883720930233;20;23;0.0348837209302325;0.465116279069767
Control.SRR15539824;44;40;0.5;22;22;0;0.5
Control.SRR15539824;40;40;0.425;23;17;0.075;0.425
Control.SRR15539824;42;40;0.619047619047619;16;26;0.119047619047619;0.380952380952381
Control.SRR15539824;42;40;0.523809523809524;20;22;0.0238095238095238;0.476190476190476
Control.SRR15539824;40;40;0.575;17;23;0.075;0.425
Control.SRR15539824;38;40;0.578947368421053;16;22;0.0789473684210527;0.421052631578947
Control.SRR15539824;44;40;0.477272727272727;23;21;0.0227272727272727;0.477272727272727
Control.SRR15539824;42;40;0.476190476190476;22;20;0.0238095238095238;0.476190476190476
Control.SRR15539824;40;40;0.325;27;13;0.175;0.325
Control.SRR15539824;40;40;0.475;21;19;0.025;0.475
Control.SRR15539824;40;40;0.525;19;21;0.025;0.475
Control.SRR15539824;39;40;0.564102564102564;17;22;0.0641025641025641;0.435897435897436
Control.SRR15539824;40;40;0.425;23;17;0.075;0.425
Control.SRR15539824;36;40;0.527777777777778;17;19;0.0277777777777778;0.472222222222222
Control.SRR15539824;39;40;0.384615384615385;24;15;0.115384615384615;0.384615384615385
Control.SRR15539824;42;40;0.547619047619048;19;23;0.0476190476190477;0.452380952380952
Control.SRR15539824;43;40;0.325581395348837;29;14;0.174418604651163;0.325581395348837
Control.SRR15539824;41;40;0.439024390243902;23;18;0.0609756097560976;0.439024390243902
Control.SRR15539824;36;40;0.444444444444444;20;16;0.0555555555555556;0.444444444444444
Control.SRR15539824;41;40;0.439024390243902;23;18;0.0609756097560976;0.439024390243902
Control.SRR15539824;40;40;0.475;21;19;0.025;0.475
Control.SRR15539824;41;40;0.439024390243902;23;18;0.0609756097560976;0.439024390243902
Control.SRR15539824;41;40;0.463414634146341;22;19;0.0365853658536585;0.463414634146341
Control.SRR15539824;35;40;0.4;21;14;0.1;0.4
Control.SRR15539824;41;40;0.414634146341463;24;17;0.0853658536585366;0.414634146341463
Control.SRR15539824;37;40;0.459459459459459;20;17;0.0405405405405405;0.459459459459459
Control.SRR15539824;36;40;0.5;18;18;0;0.5
Control.SRR15539824;42;40;0.428571428571429;24;18;0.0714285714285715;0.428571428571429
Control.SRR15539824;35;40;0.4;21;14;0.1;0.4
Control.SRR15539824;38;40;0.578947368421053;16;22;0.0789473684210527;0.421052631578947
Control.SRR15539824;37;40;0.459459459459459;20;17;0.0405405405405405;0.459459459459459
Control.SRR15539824;36;40;0.472222222222222;19;17;0.0277777777777778;0.472222222222222
Control.SRR15539824;41;40;0.414634146341463;24;17;0.0853658536585366;0.414634146341463
Control.SRR15539824;35;40;0.4;21;14;0.1;0.4
Control.SRR15539824;40;40;0.425;23;17;0.075;0.425
Control.SRR15539824;37;40;0.567567567567568;16;21;0.0675675675675675;0.432432432432432
Control.SRR15539824;45;40;0.666666666666667;15;30;0.166666666666667;0.333333333333333
Control.SRR15539824;37;40;0.567567567567568;16;21;0.0675675675675675;0.432432432432432
Control.SRR15539824;44;40;0.363636363636364;28;16;0.136363636363636;0.363636363636364
Control.SRR15539824;43;40;0.465116279069767;23;20;0.0348837209302326;0.465116279069767
Control.SRR15539824;44;40;0.340909090909091;29;15;0.159090909090909;0.340909090909091
Control.SRR15539824;43;40;0.534883720930233;20;23;0.0348837209302325;0.465116279069767
Control.SRR15539824;38;40;0.578947368421053;16;22;0.0789473684210527;0.421052631578947
Control.SRR15539824;40;40;0.525;19;21;0.025;0.475
Control.SRR15539824;35;40;0.457142857142857;19;16;0.0428571428571429;0.457142857142857
Control.SRR15539824;40;40;0.475;21;19;0.025;0.475
Control.SRR15539824;36;40;0.416666666666667;21;15;0.0833333333333333;0.416666666666667
Control.SRR15539824;39;40;0.564102564102564;17;22;0.0641025641025641;0.435897435897436
Control.SRR15539824;41;40;0.51219512195122;20;21;0.0121951219512195;0.48780487804878
Control.SRR15539824;38;40;0.368421052631579;24;14;0.131578947368421;0.368421052631579
Control.SRR15539824;40;40;0.5;20;20;0;0.5
Control.SRR15539824;45;40;0.488888888888889;23;22;0.0111111111111111;0.488888888888889
Control.SRR15539824;42;40;0.642857142857143;15;27;0.142857142857143;0.357142857142857
Control.SRR15539824;40;40;0.55;18;22;0.05;0.45
Control.SRR15539824;40;40;0.675;13;27;0.175;0.325
Control.SRR15539824;36;40;0.444444444444444;20;16;0.0555555555555556;0.444444444444444
Control.SRR15539824;44;40;0.522727272727273;21;23;0.0227272727272727;0.477272727272727
Control.SRR15539824;45;40;0.577777777777778;19;26;0.0777777777777777;0.422222222222222
Control.SRR15539824;35;40;0.628571428571429;13;22;0.128571428571429;0.371428571428571
Control.SRR15539824;38;40;0.684210526315789;12;26;0.184210526315789;0.315789473684211
Control.SRR15539824;39;40;0.538461538461538;18;21;0.0384615384615384;0.461538461538462
Control.SRR15539824;41;40;0.414634146341463;24;17;0.0853658536585366;0.414634146341463
Control.SRR15539824;37;40;0.675675675675676;12;25;0.175675675675676;0.324324324324324
Control.SRR15539824;42;40;0.595238095238095;17;25;0.0952380952380952;0.404761904761905
Control.SRR15539824;40;40;0.575;17;23;0.075;0.425
Control.SRR15539824;40;40;0.575;17;23;0.075;0.425
Control.SRR15539824;36;40;0.527777777777778;17;19;0.0277777777777778;0.472222222222222
Control.SRR15539824;36;40;0.472222222222222;19;17;0.0277777777777778;0.472222222222222
Control.SRR15539824;36;40;0.5;18;18;0;0.5
Control.SRR15539824;37;40;0.567567567567568;16;21;0.0675675675675675;0.432432432432432
Control.SRR15539824;43;40;0.511627906976744;21;22;0.0116279069767442;0.488372093023256
Control.SRR15539824;44;40;0.386363636363636;27;17;0.113636363636364;0.386363636363636
Control.SRR15539824;37;40;0.486486486486487;19;18;0.0135135135135135;0.486486486486487
Control.SRR15539824;37;40;0.432432432432432;21;16;0.0675675675675675;0.432432432432432
Control.SRR15539824;37;40;0.432432432432432;21;16;0.0675675675675675;0.432432432432432
Control.SRR15539824;38;40;0.684210526315789;12;26;0.184210526315789;0.315789473684211
Control.SRR15539824;42;40;0.428571428571429;24;18;0.0714285714285715;0.428571428571429
Control.SRR15539824;41;40;0.536585365853659;19;22;0.0365853658536586;0.463414634146341
Control.SRR15539824;36;40;0.416666666666667;21;15;0.0833333333333333;0.416666666666667
Control.SRR15539824;42;40;0.428571428571429;24;18;0.0714285714285715;0.428571428571429
Control.SRR15539824;44;40;0.5;22;22;0;0.5
Control.SRR15539824;39;40;0.461538461538462;21;18;0.0384615384615384;0.461538461538462
Control.SRR15539824;39;40;0.641025641025641;14;25;0.141025641025641;0.358974358974359
Control.SRR15539824;36;40;0.388888888888889;22;14;0.111111111111111;0.388888888888889
Control.SRR15539824;40;40;0.475;21;19;0.025;0.475
Control.SRR15539824;39;40;0.384615384615385;24;15;0.115384615384615;0.384615384615385
Control.SRR15539824;43;40;0.465116279069767;23;20;0.0348837209302326;0.465116279069767
Control.SRR15539824;45;40;0.555555555555556;20;25;0.0555555555555556;0.444444444444444
Control.SRR15539824;38;40;0.631578947368421;14;24;0.131578947368421;0.368421052631579
Control.SRR15539824;40;40;0.575;17;23;0.075;0.425
Control.SRR15539824;42;40;0.642857142857143;15;27;0.142857142857143;0.357142857142857
Control.SRR15539824;35;40;0.342857142857143;23;12;0.157142857142857;0.342857142857143
Control.SRR15539824;42;40;0.595238095238095;17;25;0.0952380952380952;0.404761904761905
Control.SRR15539824;42;40;0.547619047619048;19;23;0.0476190476190477;0.452380952380952
Control.SRR15539824;36;40;0.611111111111111;14;22;0.111111111111111;0.388888888888889
Control.SRR15539824;38;40;0.342105263157895;25;13;0.157894736842105;0.342105263157895
Control.SRR15539824;45;40;0.511111111111111;22;23;0.0111111111111111;0.488888888888889
Control.SRR15539824;45;40;0.444444444444444;25;20;0.0555555555555556;0.444444444444444
Control.SRR15539824;38;40;0.526315789473684;18;20;0.0263157894736842;0.473684210526316
Control.SRR15539824;42;40;0.523809523809524;20;22;0.0238095238095238;0.476190476190476
Control.SRR15539824;44;40;0.318181818181818;30;14;0.181818181818182;0.318181818181818
Control.SRR15539824;40;40;0.475;21;19;0.025;0.475
Control.SRR15539824;40;40;0.475;21;19;0.025;0.475
Control.SRR15539824;42;40;0.666666666666667;14;28;0.166666666666667;0.333333333333333
Control.SRR15539824;39;40;0.461538461538462;21;18;0.0384615384615384;0.461538461538462
Control.SRR15539824;40;40;0.375;25;15;0.125;0.375
Control.SRR15539824;41;40;0.585365853658537;17;24;0.0853658536585366;0.414634146341463
Control.SRR15539824;42;40;0.523809523809524;20;22;0.0238095238095238;0.476190476190476
Control.SRR15539824;40;40;0.525;19;21;0.025;0.475
Control.SRR15539824;40;40;0.625;15;25;0.125;0.375
Control.SRR15539824;37;40;0.486486486486487;19;18;0.0135135135135135;0.486486486486487
Control.SRR15539824;42;40;0.333333333333333;28;14;0.166666666666667;0.333333333333333
Control.SRR15539824;38;40;0.631578947368421;14;24;0.131578947368421;0.368421052631579
Control.SRR15539824;40;40;0.45;22;18;0.05;0.45
Control.SRR15539824;36;40;0.583333333333333;15;21;0.0833333333333334;0.416666666666667
Control.SRR15539824;41;40;0.536585365853659;19;22;0.0365853658536586;0.463414634146341
Control.SRR15539824;37;40;0.459459459459459;20;17;0.0405405405405405;0.459459459459459
Control.SRR15539824;42;40;0.547619047619048;19;23;0.0476190476190477;0.452380952380952
Control.SRR15539824;45;40;0.4;27;18;0.1;0.4
Control.SRR15539824;45;40;0.577777777777778;19;26;0.0777777777777777;0.422222222222222
Control.SRR15539824;42;40;0.5;21;21;0;0.5
Control.SRR15539824;36;40;0.444444444444444;20;16;0.0555555555555556;0.444444444444444
Control.SRR15539824;35;40;0.514285714285714;17;18;0.0142857142857142;0.485714285714286
Control.SRR15539824;40;40;0.55;18;22;0.05;0.45
Control.SRR15539824;43;40;0.581395348837209;18;25;0.0813953488372093;0.418604651162791
Control.SRR15539824;44;40;0.454545454545455;24;20;0.0454545454545455;0.454545454545455
Control.SRR15539824;43;40;0.558139534883721;19;24;0.0581395348837209;0.441860465116279
Control.SRR15539824;39;40;0.538461538461538;18;21;0.0384615384615384;0.461538461538462
Control.SRR15539824;44;40;0.477272727272727;23;21;0.0227272727272727;0.477272727272727
Control.SRR15539824;44;40;0.5;22;22;0;0.5
Control.SRR15539824;38;40;0.473684210526316;20;18;0.0263157894736842;0.473684210526316
Control.SRR15539824;41;40;0.463414634146341;22;19;0.0365853658536585;0.463414634146341
Control.SRR15539824;40;40;0.425;23;17;0.075;0.425
Control.SRR15539824;37;40;0.594594594594595;15;22;0.0945945945945946;0.405405405405405
Control.SRR15539824;39;40;0.487179487179487;20;19;0.0128205128205128;0.487179487179487
Control.SRR15539824;38;40;0.447368421052632;21;17;0.0526315789473684;0.447368421052632
Control.SRR15539824;44;40;0.477272727272727;23;21;0.0227272727272727;0.477272727272727
Control.SRR15539824;36;40;0.527777777777778;17;19;0.0277777777777778;0.472222222222222
Control.SRR15539824;41;40;0.560975609756098;18;23;0.0609756097560976;0.439024390243902
Control.SRR15539824;42;40;0.5;21;21;0;0.5
Control.SRR15539824;44;40;0.454545454545455;24;20;0.0454545454545455;0.454545454545455
Control.SRR15539824;40;40;0.5;20;20;0;0.5
Control.SRR15539824;40;40;0.5;20;20;0;0.5
Control.SRR15539824;43;40;0.581395348837209;18;25;0.0813953488372093;0.418604651162791
Control.SRR15539824;40;40;0.625;15;25;0.125;0.375
Control.SRR15539824;43;40;0.465116279069767;23;20;0.0348837209302326;0.465116279069767
Control.SRR15539824;41;40;0.560975609756098;18;23;0.0609756097560976;0.439024390243902
Control.SRR15539824;41;40;0.536585365853659;19;22;0.0365853658536586;0.463414634146341
Control.SRR15539824;43;40;0.488372093023256;22;21;0.0116279069767442;0.488372093023256
Control.SRR15539824;40;40;0.525;19;21;0.025;0.475
Control.SRR15539824;40;40;0.45;22;18;0.05;0.45
Control.SRR15539824;39;40;0.538461538461538;18;21;0.0384615384615384;0.461538461538462
Control.SRR15539824;38;40;0.473684210526316;20;18;0.0263157894736842;0.473684210526316
Control.SRR15539824;37;40;0.405405405405405;22;15;0.0945945945945946;0.405405405405405
Control.SRR15539824;40;40;0.6;16;24;0.1;0.4
Control.SRR15539824;39;40;0.435897435897436;22;17;0.0641025641025641;0.435897435897436
Control.SRR15539824;43;40;0.488372093023256;22;21;0.0116279069767442;0.488372093023256
Control.SRR15539824;34;40;0.5;17;17;0;0.5
Control.SRR15539824;44;40;0.477272727272727;23;21;0.0227272727272727;0.477272727272727
Control.SRR15539824;40;40;0.4;24;16;0.1;0.4
Control.SRR15539824;37;40;0.432432432432432;21;16;0.0675675675675675;0.432432432432432
Control.SRR15539824;37;40;0.459459459459459;20;17;0.0405405405405405;0.459459459459459
Control.SRR15539824;35;40;0.542857142857143;16;19;0.0428571428571428;0.457142857142857
Control.SRR15539824;36;40;0.5;18;18;0;0.5
Control.SRR15539824;35;40;0.514285714285714;17;18;0.0142857142857142;0.485714285714286
Control.SRR15539824;36;40;0.555555555555556;16;20;0.0555555555555556;0.444444444444444
Control.SRR15539824;39;40;0.41025641025641;23;16;0.0897435897435898;0.41025641025641
Control.SRR15539824;38;40;0.473684210526316;20;18;0.0263157894736842;0.473684210526316
Control.SRR15539824;38;40;0.5;19;19;0;0.5
Control.SRR15539824;38;40;0.421052631578947;22;16;0.0789473684210527;0.421052631578947
Control.SRR15539824;34;40;0.411764705882353;20;14;0.0882352941176471;0.411764705882353
Control.SRR15539824;36;40;0.583333333333333;15;21;0.0833333333333334;0.416666666666667
Control.SRR15539824;37;40;0.459459459459459;20;17;0.0405405405405405;0.459459459459459
Control.SRR15539824;44;40;0.522727272727273;21;23;0.0227272727272727;0.477272727272727
Control.SRR15539824;37;40;0.486486486486487;19;18;0.0135135135135135;0.486486486486487
Control.SRR15539824;38;40;0.421052631578947;22;16;0.0789473684210527;0.421052631578947
Control.SRR15539824;35;40;0.657142857142857;12;23;0.157142857142857;0.342857142857143
Control.SRR15539824;40;40;0.5;20;20;0;0.5
Control.SRR15539824;36;40;0.638888888888889;13;23;0.138888888888889;0.361111111111111
Control.SRR15539824;40;40;0.5;20;20;0;0.5
Control.SRR15539824;35;40;0.628571428571429;13;22;0.128571428571429;0.371428571428571
Control.SRR15539824;39;40;0.538461538461538;18;21;0.0384615384615384;0.461538461538462
Control.SRR15539824;44;40;0.590909090909091;18;26;0.0909090909090909;0.409090909090909
Control.SRR15539824;39;40;0.461538461538462;21;18;0.0384615384615384;0.461538461538462
Control.SRR15539824;40;40;0.525;19;21;0.025;0.475
Control.SRR15539824;37;40;0.324324324324324;25;12;0.175675675675676;0.324324324324324
Control.SRR15539824;36;40;0.583333333333333;15;21;0.0833333333333334;0.416666666666667
Control.SRR15539824;44;40;0.363636363636364;28;16;0.136363636363636;0.363636363636364
Control.SRR15539824;34;40;0.411764705882353;20;14;0.0882352941176471;0.411764705882353
Control.SRR15539824;42;40;0.476190476190476;22;20;0.0238095238095238;0.476190476190476
Control.SRR15539824;35;40;0.6;14;21;0.1;0.4
Control.SRR15539824;34;40;0.411764705882353;20;14;0.0882352941176471;0.411764705882353
Control.SRR15539824;38;40;0.526315789473684;18;20;0.0263157894736842;0.473684210526316
Control.SRR15539824;37;40;0.594594594594595;15;22;0.0945945945945946;0.405405405405405
Control.SRR15539824;43;40;0.558139534883721;19;24;0.0581395348837209;0.441860465116279
Control.SRR15539824;42;40;0.428571428571429;24;18;0.0714285714285715;0.428571428571429
Control.SRR15539824;37;40;0.432432432432432;21;16;0.0675675675675675;0.432432432432432
Control.SRR15539824;35;40;0.457142857142857;19;16;0.0428571428571429;0.457142857142857
Control.SRR15539824;34;40;0.617647058823529;13;21;0.117647058823529;0.382352941176471
Control.SRR15539824;39;40;0.615384615384615;15;24;0.115384615384615;0.384615384615385
Control.SRR15539824;38;40;0.578947368421053;16;22;0.0789473684210527;0.421052631578947
Control.SRR15539824;41;40;0.634146341463415;15;26;0.134146341463415;0.365853658536585
Control.SRR15539824;34;40;0.529411764705882;16;18;0.0294117647058824;0.470588235294118
Control.SRR15539824;38;40;0.473684210526316;20;18;0.0263157894736842;0.473684210526316
Control.SRR15539824;42;40;0.547619047619048;19;23;0.0476190476190477;0.452380952380952
Control.SRR15539824;37;40;0.459459459459459;20;17;0.0405405405405405;0.459459459459459
Control.SRR15539824;35;40;0.457142857142857;19;16;0.0428571428571429;0.457142857142857
Control.SRR15539824;41;40;0.560975609756098;18;23;0.0609756097560976;0.439024390243902
Control.SRR15539824;34;40;0.558823529411765;15;19;0.0588235294117647;0.441176470588235
Control.SRR15539824;34;40;0.411764705882353;20;14;0.0882352941176471;0.411764705882353
Control.SRR15539824;35;40;0.371428571428571;22;13;0.128571428571429;0.371428571428571
Control.SRR15539824;34;40;0.470588235294118;18;16;0.0294117647058824;0.470588235294118
Control.SRR15539824;37;40;0.297297297297297;26;11;0.202702702702703;0.297297297297297
Control.SRR15539824;39;40;0.666666666666667;13;26;0.166666666666667;0.333333333333333
Control.SRR15539824;37;40;0.378378378378378;23;14;0.121621621621622;0.378378378378378
Control.SRR15539824;39;40;0.487179487179487;20;19;0.0128205128205128;0.487179487179487
Control.SRR15539824;35;40;0.571428571428571;15;20;0.0714285714285714;0.428571428571429
Control.SRR15539824;35;40;0.457142857142857;19;16;0.0428571428571429;0.457142857142857
Control.SRR15539824;42;40;0.428571428571429;24;18;0.0714285714285715;0.428571428571429
Control.SRR15539824;36;40;0.527777777777778;17;19;0.0277777777777778;0.472222222222222
Control.SRR15539824;44;40;0.590909090909091;18;26;0.0909090909090909;0.409090909090909
Control.SRR15539824;36;40;0.416666666666667;21;15;0.0833333333333333;0.416666666666667
Control.SRR15539824;40;40;0.35;26;14;0.15;0.35
Control.SRR15539824;42;40;0.5;21;21;0;0.5
Control.SRR15539824;39;40;0.41025641025641;23;16;0.0897435897435898;0.41025641025641
Control.SRR15539824;44;40;0.363636363636364;28;16;0.136363636363636;0.363636363636364
Control.SRR15539824;38;40;0.526315789473684;18;20;0.0263157894736842;0.473684210526316
Control.SRR15539824;40;40;0.65;14;26;0.15;0.35
Control.SRR15539824;36;40;0.472222222222222;19;17;0.0277777777777778;0.472222222222222
Control.SRR15539824;38;40;0.5;19;19;0;0.5
Control.SRR15539824;42;40;0.595238095238095;17;25;0.0952380952380952;0.404761904761905
Control.SRR15539824;39;40;0.58974358974359;16;23;0.0897435897435898;0.41025641025641
Control.SRR15539824;35;40;0.514285714285714;17;18;0.0142857142857142;0.485714285714286
Control.SRR15539824;35;40;0.628571428571429;13;22;0.128571428571429;0.371428571428571
Control.SRR15539824;39;40;0.41025641025641;23;16;0.0897435897435898;0.41025641025641
Control.SRR15539824;44;40;0.727272727272727;12;32;0.227272727272727;0.272727272727273
Control.SRR15539824;41;40;0.463414634146341;22;19;0.0365853658536585;0.463414634146341
Control.SRR15539824;39;40;0.461538461538462;21;18;0.0384615384615384;0.461538461538462
Control.SRR15539824;43;40;0.604651162790698;17;26;0.104651162790698;0.395348837209302
Control.SRR15539824;40;40;0.475;21;19;0.025;0.475
Control.SRR15539824;41;40;0.51219512195122;20;21;0.0121951219512195;0.48780487804878
Control.SRR15539824;38;40;0.447368421052632;21;17;0.0526315789473684;0.447368421052632
Control.SRR15539824;41;40;0.609756097560976;16;25;0.109756097560976;0.390243902439024
Control.SRR15539824;39;40;0.58974358974359;16;23;0.0897435897435898;0.41025641025641
Control.SRR15539824;36;40;0.416666666666667;21;15;0.0833333333333333;0.416666666666667
Control.SRR15539824;42;40;0.595238095238095;17;25;0.0952380952380952;0.404761904761905
Control.SRR15539824;38;40;0.526315789473684;18;20;0.0263157894736842;0.473684210526316
Control.SRR15539824;42;40;0.404761904761905;25;17;0.0952380952380952;0.404761904761905
Control.SRR15539824;41;40;0.48780487804878;21;20;0.0121951219512195;0.48780487804878
Control.SRR15539824;38;40;0.5;19;19;0;0.5
Control.SRR15539824;39;40;0.384615384615385;24;15;0.115384615384615;0.384615384615385
Control.SRR15539824;35;40;0.542857142857143;16;19;0.0428571428571428;0.457142857142857
Control.SRR15539824;42;40;0.5;21;21;0;0.5
Control.SRR15539824;42;40;0.619047619047619;16;26;0.119047619047619;0.380952380952381
Control.SRR15539824;36;40;0.361111111111111;23;13;0.138888888888889;0.361111111111111
Control.SRR15539824;42;40;0.595238095238095;17;25;0.0952380952380952;0.404761904761905
Control.SRR15539824;38;40;0.421052631578947;22;16;0.0789473684210527;0.421052631578947
Control.SRR15539824;40;40;0.45;22;18;0.05;0.45
Control.SRR15539824;38;40;0.5;19;19;0;0.5
Control.SRR15539824;34;40;0.441176470588235;19;15;0.0588235294117647;0.441176470588235
Control.SRR15539824;44;40;0.454545454545455;24;20;0.0454545454545455;0.454545454545455
Control.SRR15539824;43;40;0.465116279069767;23;20;0.0348837209302326;0.465116279069767
Control.SRR15539824;44;40;0.477272727272727;23;21;0.0227272727272727;0.477272727272727
Control.SRR15539824;40;40;0.45;22;18;0.05;0.45
Control.SRR15539824;40;40;0.425;23;17;0.075;0.425
Control.SRR15539824;40;40;0.675;13;27;0.175;0.325
Control.SRR15539824;35;40;0.514285714285714;17;18;0.0142857142857142;0.485714285714286
Control.SRR15539824;44;40;0.545454545454545;20;24;0.0454545454545454;0.454545454545455
Control.SRR15539824;41;40;0.51219512195122;20;21;0.0121951219512195;0.48780487804878
Control.SRR15539824;40;40;0.5;20;20;0;0.5
Control.SRR15539824;38;40;0.605263157894737;15;23;0.105263157894737;0.394736842105263
Control.SRR15539824;34;40;0.470588235294118;18;16;0.0294117647058824;0.470588235294118
Control.SRR15539824;41;40;0.463414634146341;22;19;0.0365853658536585;0.463414634146341
Control.SRR15539824;39;40;0.512820512820513;19;20;0.0128205128205128;0.487179487179487
Control.SRR15539824;37;40;0.405405405405405;22;15;0.0945945945945946;0.405405405405405
Control.SRR15539824;35;40;0.514285714285714;17;18;0.0142857142857142;0.485714285714286
Control.SRR15539824;43;40;0.418604651162791;25;18;0.0813953488372093;0.418604651162791
Control.SRR15539824;34;40;0.470588235294118;18;16;0.0294117647058824;0.470588235294118
Control.SRR15539824;41;40;0.536585365853659;19;22;0.0365853658536586;0.463414634146341
Control.SRR15539824;42;40;0.595238095238095;17;25;0.0952380952380952;0.404761904761905
Control.SRR15539824;36;40;0.555555555555556;16;20;0.0555555555555556;0.444444444444444
Control.SRR15539824;37;40;0.486486486486487;19;18;0.0135135135135135;0.486486486486487
Control.SRR15539824;35;40;0.428571428571429;20;15;0.0714285714285715;0.428571428571429
Control.SRR15539824;37;40;0.486486486486487;19;18;0.0135135135135135;0.486486486486487
Control.SRR15539824;35;40;0.457142857142857;19;16;0.0428571428571429;0.457142857142857
Control.SRR15539824;40;40;0.45;22;18;0.05;0.45
Control.SRR15539824;39;40;0.435897435897436;22;17;0.0641025641025641;0.435897435897436
Control.SRR15539824;34;40;0.558823529411765;15;19;0.0588235294117647;0.441176470588235
Control.SRR15539824;35;40;0.485714285714286;18;17;0.0142857142857143;0.485714285714286
Control.SRR15539824;36;40;0.416666666666667;21;15;0.0833333333333333;0.416666666666667
Control.SRR15539824;41;40;0.414634146341463;24;17;0.0853658536585366;0.414634146341463
Control.SRR15539824;42;40;0.523809523809524;20;22;0.0238095238095238;0.476190476190476
Control.SRR15539824;34;40;0.5;17;17;0;0.5
Control.SRR15539824;38;40;0.526315789473684;18;20;0.0263157894736842;0.473684210526316
Control.SRR15539824;35;40;0.571428571428571;15;20;0.0714285714285714;0.428571428571429
Control.SRR15539824;37;40;0.621621621621622;14;23;0.121621621621622;0.378378378378378
Control.SRR15539824;38;40;0.473684210526316;20;18;0.0263157894736842;0.473684210526316
Control.SRR15539824;40;40;0.4;24;16;0.1;0.4
Control.SRR15539824;44;40;0.522727272727273;21;23;0.0227272727272727;0.477272727272727
Control.SRR15539824;34;40;0.441176470588235;19;15;0.0588235294117647;0.441176470588235
Control.SRR15539824;39;40;0.564102564102564;17;22;0.0641025641025641;0.435897435897436
Control.SRR15539824;36;40;0.611111111111111;14;22;0.111111111111111;0.388888888888889
Control.SRR15539824;37;40;0.594594594594595;15;22;0.0945945945945946;0.405405405405405
Control.SRR15539824;37;40;0.405405405405405;22;15;0.0945945945945946;0.405405405405405
Control.SRR15539824;38;40;0.368421052631579;24;14;0.131578947368421;0.368421052631579
Control.SRR15539824;35;40;0.485714285714286;18;17;0.0142857142857143;0.485714285714286
Control.SRR15539824;38;40;0.421052631578947;22;16;0.0789473684210527;0.421052631578947
Control.SRR15539824;37;40;0.621621621621622;14;23;0.121621621621622;0.378378378378378
Control.SRR15539824;41;40;0.414634146341463;24;17;0.0853658536585366;0.414634146341463
Control.SRR15539824;35;40;0.485714285714286;18;17;0.0142857142857143;0.485714285714286
Control.SRR15539824;37;40;0.594594594594595;15;22;0.0945945945945946;0.405405405405405
Control.SRR15539824;34;40;0.441176470588235;19;15;0.0588235294117647;0.441176470588235
Control.SRR15539824;36;40;0.222222222222222;28;8;0.277777777777778;0.222222222222222
Control.SRR15539824;44;40;0.477272727272727;23;21;0.0227272727272727;0.477272727272727
Control.SRR15539824;35;40;0.542857142857143;16;19;0.0428571428571428;0.457142857142857
Control.SRR15539824;40;40;0.475;21;19;0.025;0.475
Control.SRR15539824;35;40;0.514285714285714;17;18;0.0142857142857142;0.485714285714286
Control.SRR15539824;38;40;0.5;19;19;0;0.5
Control.SRR15539824;40;40;0.525;19;21;0.025;0.475
Control.SRR15539824;37;40;0.405405405405405;22;15;0.0945945945945946;0.405405405405405
Control.SRR15539824;35;40;0.457142857142857;19;16;0.0428571428571429;0.457142857142857
Control.SRR15539824;38;40;0.552631578947368;17;21;0.0526315789473685;0.447368421052632
Control.SRR15539824;36;40;0.416666666666667;21;15;0.0833333333333333;0.416666666666667
Control.SRR15539824;44;40;0.5;22;22;0;0.5
Control.SRR15539824;39;40;0.666666666666667;13;26;0.166666666666667;0.333333333333333
Control.SRR15539824;37;40;0.351351351351351;24;13;0.148648648648649;0.351351351351351
Control.SRR15539824;40;40;0.45;22;18;0.05;0.45
Control.SRR15539824;43;40;0.441860465116279;24;19;0.0581395348837209;0.441860465116279
Control.SRR15539824;43;40;0.511627906976744;21;22;0.0116279069767442;0.488372093023256
Control.SRR15539824;34;40;0.411764705882353;20;14;0.0882352941176471;0.411764705882353
Control.SRR15539824;35;40;0.542857142857143;16;19;0.0428571428571428;0.457142857142857
Control.SRR15539824;44;40;0.590909090909091;18;26;0.0909090909090909;0.409090909090909
Control.SRR15539824;44;40;0.545454545454545;20;24;0.0454545454545454;0.454545454545455
Control.SRR15539824;44;40;0.431818181818182;25;19;0.0681818181818182;0.431818181818182
Control.SRR15539824;38;40;0.552631578947368;17;21;0.0526315789473685;0.447368421052632
Control.SRR15539824;41;40;0.48780487804878;21;20;0.0121951219512195;0.48780487804878
Control.SRR15539824;37;40;0.567567567567568;16;21;0.0675675675675675;0.432432432432432
Control.SRR15539824;37;40;0.432432432432432;21;16;0.0675675675675675;0.432432432432432
Control.SRR15539824;42;40;0.523809523809524;20;22;0.0238095238095238;0.476190476190476
Control.SRR15539824;34;40;0.411764705882353;20;14;0.0882352941176471;0.411764705882353
Control.SRR15539824;38;40;0.447368421052632;21;17;0.0526315789473684;0.447368421052632
Control.SRR15539824;35;40;0.371428571428571;22;13;0.128571428571429;0.371428571428571
Control.SRR15539824;37;40;0.459459459459459;20;17;0.0405405405405405;0.459459459459459
Control.SRR15539824;36;40;0.583333333333333;15;21;0.0833333333333334;0.416666666666667
Control.SRR15539824;41;40;0.390243902439024;25;16;0.109756097560976;0.390243902439024
Control.SRR15539824;39;40;0.461538461538462;21;18;0.0384615384615384;0.461538461538462
Control.SRR15539824;40;40;0.475;21;19;0.025;0.475
Control.SRR15539824;41;40;0.560975609756098;18;23;0.0609756097560976;0.439024390243902
Control.SRR15539824;37;40;0.378378378378378;23;14;0.121621621621622;0.378378378378378
Control.SRR15539824;35;40;0.428571428571429;20;15;0.0714285714285715;0.428571428571429
Control.SRR15539824;42;40;0.547619047619048;19;23;0.0476190476190477;0.452380952380952
Control.SRR15539824;44;40;0.545454545454545;20;24;0.0454545454545454;0.454545454545455
Control.SRR15539824;39;40;0.487179487179487;20;19;0.0128205128205128;0.487179487179487
Control.SRR15539824;39;40;0.461538461538462;21;18;0.0384615384615384;0.461538461538462
Control.SRR15539824;38;40;0.421052631578947;22;16;0.0789473684210527;0.421052631578947
Control.SRR15539824;34;40;0.529411764705882;16;18;0.0294117647058824;0.470588235294118
Control.SRR15539824;34;40;0.558823529411765;15;19;0.0588235294117647;0.441176470588235
Control.SRR15539824;40;40;0.65;14;26;0.15;0.35
Control.SRR15539824;40;40;0.6;16;24;0.1;0.4
Control.SRR15539824;44;40;0.409090909090909;26;18;0.0909090909090909;0.409090909090909
Control.SRR15539824;38;40;0.684210526315789;12;26;0.184210526315789;0.315789473684211
Control.SRR15539824;34;40;0.529411764705882;16;18;0.0294117647058824;0.470588235294118
Control.SRR15539824;35;40;0.485714285714286;18;17;0.0142857142857143;0.485714285714286
Control.SRR15539824;44;40;0.409090909090909;26;18;0.0909090909090909;0.409090909090909
Control.SRR15539824;36;40;0.416666666666667;21;15;0.0833333333333333;0.416666666666667
Control.SRR15539824;43;40;0.465116279069767;23;20;0.0348837209302326;0.465116279069767
Control.SRR15539824;42;40;0.523809523809524;20;22;0.0238095238095238;0.476190476190476
Control.SRR15539824;43;40;0.441860465116279;24;19;0.0581395348837209;0.441860465116279
Control.SRR15539824;43;40;0.465116279069767;23;20;0.0348837209302326;0.465116279069767
Control.SRR15539824;44;40;0.431818181818182;25;19;0.0681818181818182;0.431818181818182
Control.SRR15539824;38;40;0.447368421052632;21;17;0.0526315789473684;0.447368421052632
Control.SRR15539824;40;40;0.45;22;18;0.05;0.45
Control.SRR15539824;42;40;0.595238095238095;17;25;0.0952380952380952;0.404761904761905
Control.SRR15539824;35;40;0.542857142857143;16;19;0.0428571428571428;0.457142857142857
Control.SRR15539824;34;40;0.411764705882353;20;14;0.0882352941176471;0.411764705882353
Control.SRR15539824;36;40;0.527777777777778;17;19;0.0277777777777778;0.472222222222222
Control.SRR15539824;37;40;0.513513513513513;18;19;0.0135135135135135;0.486486486486487
Control.SRR15539824;34;40;0.588235294117647;14;20;0.0882352941176471;0.411764705882353
Control.SRR15539824;34;40;0.470588235294118;18;16;0.0294117647058824;0.470588235294118
Control.SRR15539824;35;40;0.571428571428571;15;20;0.0714285714285714;0.428571428571429
Control.SRR15539824;38;40;0.263157894736842;28;10;0.236842105263158;0.263157894736842
Control.SRR15539824;34;40;0.558823529411765;15;19;0.0588235294117647;0.441176470588235
Control.SRR15539824;42;40;0.452380952380952;23;19;0.0476190476190476;0.452380952380952
Control.SRR15539824;35;40;0.542857142857143;16;19;0.0428571428571428;0.457142857142857
Control.SRR15539824;40;40;0.45;22;18;0.05;0.45
Control.SRR15539824;38;40;0.526315789473684;18;20;0.0263157894736842;0.473684210526316
Control.SRR15539824;44;40;0.568181818181818;19;25;0.0681818181818182;0.431818181818182
Control.SRR15539824;39;40;0.538461538461538;18;21;0.0384615384615384;0.461538461538462
Control.SRR15539824;41;40;0.48780487804878;21;20;0.0121951219512195;0.48780487804878
Control.SRR15539824;36;40;0.527777777777778;17;19;0.0277777777777778;0.472222222222222
Control.SRR15539824;42;40;0.476190476190476;22;20;0.0238095238095238;0.476190476190476
Control.SRR15539824;40;40;0.575;17;23;0.075;0.425
Control.SRR15539824;36;40;0.416666666666667;21;15;0.0833333333333333;0.416666666666667
Control.SRR15539824;40;40;0.375;25;15;0.125;0.375
Control.SRR15539824;43;40;0.651162790697674;15;28;0.151162790697674;0.348837209302326
Control.SRR15539824;38;40;0.342105263157895;25;13;0.157894736842105;0.342105263157895
Control.SRR15539824;37;40;0.432432432432432;21;16;0.0675675675675675;0.432432432432432
Control.SRR15539824;43;40;0.581395348837209;18;25;0.0813953488372093;0.418604651162791
Control.SRR15539824;43;40;0.465116279069767;23;20;0.0348837209302326;0.465116279069767
Control.SRR15539824;44;40;0.545454545454545;20;24;0.0454545454545454;0.454545454545455
Control.SRR15539824;44;40;0.5;22;22;0;0.5
Control.SRR15539824;44;40;0.477272727272727;23;21;0.0227272727272727;0.477272727272727
Control.SRR15539824;38;40;0.394736842105263;23;15;0.105263157894737;0.394736842105263
Control.SRR15539824;38;40;0.5;19;19;0;0.5
Control.SRR15539824;41;40;0.560975609756098;18;23;0.0609756097560976;0.439024390243902
Control.SRR15539824;34;40;0.441176470588235;19;15;0.0588235294117647;0.441176470588235
Control.SRR15539824;37;40;0.540540540540541;17;20;0.0405405405405406;0.459459459459459
Control.SRR15539824;40;40;0.5;20;20;0;0.5
Control.SRR15539824;41;40;0.536585365853659;19;22;0.0365853658536586;0.463414634146341
Control.SRR15539824;40;40;0.475;21;19;0.025;0.475
Control.SRR15539824;43;40;0.558139534883721;19;24;0.0581395348837209;0.441860465116279
Control.SRR15539824;40;40;0.55;18;22;0.05;0.45
Control.SRR15539824;35;40;0.485714285714286;18;17;0.0142857142857143;0.485714285714286
Control.SRR15539824;42;40;0.571428571428571;18;24;0.0714285714285714;0.428571428571429
Control.SRR15539824;42;40;0.452380952380952;23;19;0.0476190476190476;0.452380952380952
Control.SRR15539824;40;40;0.5;20;20;0;0.5
Control.SRR15539824;39;40;0.512820512820513;19;20;0.0128205128205128;0.487179487179487
Control.SRR15539824;36;40;0.472222222222222;19;17;0.0277777777777778;0.472222222222222
Control.SRR15539824;41;40;0.48780487804878;21;20;0.0121951219512195;0.48780487804878
Control.SRR15539824;40;40;0.45;22;18;0.05;0.45
Control.SRR15539824;36;40;0.305555555555556;25;11;0.194444444444444;0.305555555555556
Control.SRR15539824;38;40;0.578947368421053;16;22;0.0789473684210527;0.421052631578947
Control.SRR15539824;38;40;0.421052631578947;22;16;0.0789473684210527;0.421052631578947
Control.SRR15539824;44;40;0.636363636363636;16;28;0.136363636363636;0.363636363636364
Control.SRR15539824;34;40;0.411764705882353;20;14;0.0882352941176471;0.411764705882353
Control.SRR15539824;35;40;0.371428571428571;22;13;0.128571428571429;0.371428571428571
Control.SRR15539824;34;40;0.588235294117647;14;20;0.0882352941176471;0.411764705882353
Control.SRR15539824;35;40;0.4;21;14;0.1;0.4
Control.SRR15539824;35;40;0.457142857142857;19;16;0.0428571428571429;0.457142857142857
Control.SRR15539824;43;40;0.418604651162791;25;18;0.0813953488372093;0.418604651162791
Control.SRR15539824;42;40;0.547619047619048;19;23;0.0476190476190477;0.452380952380952
Control.SRR15539824;38;40;0.578947368421053;16;22;0.0789473684210527;0.421052631578947
Control.SRR15539824;38;40;0.368421052631579;24;14;0.131578947368421;0.368421052631579
Control.SRR15539824;40;40;0.475;21;19;0.025;0.475
Control.SRR15539824;44;40;0.568181818181818;19;25;0.0681818181818182;0.431818181818182
Control.SRR15539824;39;40;0.615384615384615;15;24;0.115384615384615;0.384615384615385
Control.SRR15539824;34;40;0.529411764705882;16;18;0.0294117647058824;0.470588235294118
Control.SRR15539824;37;40;0.540540540540541;17;20;0.0405405405405406;0.459459459459459
Control.SRR15539824;39;40;0.512820512820513;19;20;0.0128205128205128;0.487179487179487
Control.SRR15539824;36;40;0.555555555555556;16;20;0.0555555555555556;0.444444444444444
Control.SRR15539824;37;40;0.486486486486487;19;18;0.0135135135135135;0.486486486486487
Control.SRR15539824;37;40;0.378378378378378;23;14;0.121621621621622;0.378378378378378
Control.SRR15539824;37;40;0.648648648648649;13;24;0.148648648648649;0.351351351351351
Control.SRR15539824;39;40;0.564102564102564;17;22;0.0641025641025641;0.435897435897436
Control.SRR15539824;44;40;0.5;22;22;0;0.5
Control.SRR15539824;41;40;0.560975609756098;18;23;0.0609756097560976;0.439024390243902
Control.SRR15539824;41;40;0.682926829268293;13;28;0.182926829268293;0.317073170731707
Control.SRR15539824;37;40;0.513513513513513;18;19;0.0135135135135135;0.486486486486487
Control.SRR15539824;41;40;0.536585365853659;19;22;0.0365853658536586;0.463414634146341
Control.SRR15539824;38;40;0.526315789473684;18;20;0.0263157894736842;0.473684210526316
Control.SRR15539824;39;40;0.564102564102564;17;22;0.0641025641025641;0.435897435897436
Control.SRR15539824;39;40;0.435897435897436;22;17;0.0641025641025641;0.435897435897436
Control.SRR15539824;38;40;0.578947368421053;16;22;0.0789473684210527;0.421052631578947
Control.SRR15539824;40;40;0.425;23;17;0.075;0.425
Control.SRR15539824;36;40;0.444444444444444;20;16;0.0555555555555556;0.444444444444444
Control.SRR15539824;34;40;0.558823529411765;15;19;0.0588235294117647;0.441176470588235
Control.SRR15539824;40;40;0.4;24;16;0.1;0.4
Control.SRR15539824;43;40;0.488372093023256;22;21;0.0116279069767442;0.488372093023256
Control.SRR15539824;39;40;0.58974358974359;16;23;0.0897435897435898;0.41025641025641
Control.SRR15539824;35;40;0.457142857142857;19;16;0.0428571428571429;0.457142857142857
Control.SRR15539824;37;40;0.432432432432432;21;16;0.0675675675675675;0.432432432432432
Control.SRR15539824;37;40;0.486486486486487;19;18;0.0135135135135135;0.486486486486487
Control.SRR15539824;37;40;0.405405405405405;22;15;0.0945945945945946;0.405405405405405
Control.SRR15539824;35;40;0.457142857142857;19;16;0.0428571428571429;0.457142857142857
Control.SRR15539824;44;40;0.431818181818182;25;19;0.0681818181818182;0.431818181818182
Control.SRR15539824;44;40;0.590909090909091;18;26;0.0909090909090909;0.409090909090909
Control.SRR15539824;43;40;0.511627906976744;21;22;0.0116279069767442;0.488372093023256
Control.SRR15539824;44;40;0.409090909090909;26;18;0.0909090909090909;0.409090909090909
Control.SRR15539824;43;40;0.441860465116279;24;19;0.0581395348837209;0.441860465116279
Control.SRR15539824;43;40;0.465116279069767;23;20;0.0348837209302326;0.465116279069767
Control.SRR15539824;44;40;0.454545454545455;24;20;0.0454545454545455;0.454545454545455
Control.SRR15539824;42;40;0.523809523809524;20;22;0.0238095238095238;0.476190476190476
Control.SRR15539824;37;40;0.675675675675676;12;25;0.175675675675676;0.324324324324324
Control.SRR15539824;39;40;0.538461538461538;18;21;0.0384615384615384;0.461538461538462
Control.SRR15539824;37;40;0.675675675675676;12;25;0.175675675675676;0.324324324324324
Control.SRR15539824;36;40;0.5;18;18;0;0.5
Control.SRR15539824;44;40;0.545454545454545;20;24;0.0454545454545454;0.454545454545455
Control.SRR15539824;36;40;0.555555555555556;16;20;0.0555555555555556;0.444444444444444
Control.SRR15539824;36;40;0.361111111111111;23;13;0.138888888888889;0.361111111111111
Control.SRR15539824;36;40;0.5;18;18;0;0.5
Control.SRR15539824;36;40;0.444444444444444;20;16;0.0555555555555556;0.444444444444444
Control.SRR15539824;44;40;0.545454545454545;20;24;0.0454545454545454;0.454545454545455
Control.SRR15539824;39;40;0.230769230769231;30;9;0.269230769230769;0.230769230769231
Control.SRR15539824;41;40;0.390243902439024;25;16;0.109756097560976;0.390243902439024
Control.SRR15539824;38;40;0.552631578947368;17;21;0.0526315789473685;0.447368421052632
Control.SRR15539824;35;40;0.457142857142857;19;16;0.0428571428571429;0.457142857142857
Control.SRR15539824;35;40;0.485714285714286;18;17;0.0142857142857143;0.485714285714286
Control.SRR15539824;35;40;0.542857142857143;16;19;0.0428571428571428;0.457142857142857
Control.SRR15539824;34;40;0.441176470588235;19;15;0.0588235294117647;0.441176470588235
Control.SRR15539824;34;40;0.411764705882353;20;14;0.0882352941176471;0.411764705882353
Control.SRR15539824;43;40;0.395348837209302;26;17;0.104651162790698;0.395348837209302
Control.SRR15539824;42;40;0.5;21;21;0;0.5
Control.SRR15539824;44;40;0.590909090909091;18;26;0.0909090909090909;0.409090909090909
Control.SRR15539824;39;40;0.538461538461538;18;21;0.0384615384615384;0.461538461538462
Control.SRR15539824;36;40;0.472222222222222;19;17;0.0277777777777778;0.472222222222222
Control.SRR15539824;36;40;0.472222222222222;19;17;0.0277777777777778;0.472222222222222
Control.SRR15539824;44;40;0.568181818181818;19;25;0.0681818181818182;0.431818181818182
Control.SRR15539824;36;40;0.444444444444444;20;16;0.0555555555555556;0.444444444444444
Control.SRR15539824;39;40;0.666666666666667;13;26;0.166666666666667;0.333333333333333
Control.SRR15539824;40;40;0.475;21;19;0.025;0.475
Control.SRR15539824;41;40;0.609756097560976;16;25;0.109756097560976;0.390243902439024
Control.SRR15539824;43;40;0.372093023255814;27;16;0.127906976744186;0.372093023255814
Control.SRR15539824;43;40;0.395348837209302;26;17;0.104651162790698;0.395348837209302
Control.SRR15539824;44;40;0.522727272727273;21;23;0.0227272727272727;0.477272727272727
Control.SRR15539824;36;40;0.527777777777778;17;19;0.0277777777777778;0.472222222222222
Control.SRR15539824;34;40;0.470588235294118;18;16;0.0294117647058824;0.470588235294118
Control.SRR15539824;38;40;0.421052631578947;22;16;0.0789473684210527;0.421052631578947
Control.SRR15539824;40;40;0.525;19;21;0.025;0.475
Control.SRR15539824;39;40;0.538461538461538;18;21;0.0384615384615384;0.461538461538462
Control.SRR15539824;41;40;0.536585365853659;19;22;0.0365853658536586;0.463414634146341
Control.SRR15539824;41;40;0.51219512195122;20;21;0.0121951219512195;0.48780487804878
Control.SRR15539824;39;40;0.41025641025641;23;16;0.0897435897435898;0.41025641025641
Control.SRR15539824;41;40;0.536585365853659;19;22;0.0365853658536586;0.463414634146341
Control.SRR15539824;37;40;0.594594594594595;15;22;0.0945945945945946;0.405405405405405
Control.SRR15539824;44;40;0.5;22;22;0;0.5
Control.SRR15539824;42;40;0.69047619047619;13;29;0.19047619047619;0.30952380952381
Control.SRR15539824;37;40;0.567567567567568;16;21;0.0675675675675675;0.432432432432432
Control.SRR15539824;35;40;0.314285714285714;24;11;0.185714285714286;0.314285714285714
Control.SRR15539824;42;40;0.619047619047619;16;26;0.119047619047619;0.380952380952381
Control.SRR15539824;42;40;0.5;21;21;0;0.5
Control.SRR15539824;44;40;0.568181818181818;19;25;0.0681818181818182;0.431818181818182
Control.SRR15539824;41;40;0.585365853658537;17;24;0.0853658536585366;0.414634146341463
Control.SRR15539824;37;40;0.540540540540541;17;20;0.0405405405405406;0.459459459459459
Control.SRR15539824;35;40;0.485714285714286;18;17;0.0142857142857143;0.485714285714286
Control.SRR15539824;35;40;0.542857142857143;16;19;0.0428571428571428;0.457142857142857
Control.SRR15539824;35;40;0.657142857142857;12;23;0.157142857142857;0.342857142857143
Control.SRR15539824;38;40;0.631578947368421;14;24;0.131578947368421;0.368421052631579
Control.SRR15539824;42;40;0.452380952380952;23;19;0.0476190476190476;0.452380952380952
Control.SRR15539824;44;40;0.522727272727273;21;23;0.0227272727272727;0.477272727272727
Control.SRR15539824;39;40;0.615384615384615;15;24;0.115384615384615;0.384615384615385
Control.SRR15539824;40;40;0.625;15;25;0.125;0.375
Control.SRR15539824;39;40;0.41025641025641;23;16;0.0897435897435898;0.41025641025641
Control.SRR15539824;41;40;0.463414634146341;22;19;0.0365853658536585;0.463414634146341
Control.SRR15539824;38;40;0.5;19;19;0;0.5
Control.SRR15539824;40;40;0.525;19;21;0.025;0.475
Control.SRR15539824;34;40;0.470588235294118;18;16;0.0294117647058824;0.470588235294118
Control.SRR15539824;35;40;0.485714285714286;18;17;0.0142857142857143;0.485714285714286
Control.SRR15539824;44;40;0.613636363636364;17;27;0.113636363636364;0.386363636363636
Control.SRR15539824;44;40;0.545454545454545;20;24;0.0454545454545454;0.454545454545455
Control.SRR15539824;40;40;0.475;21;19;0.025;0.475
Control.SRR15539824;40;40;0.45;22;18;0.05;0.45
Control.SRR15539824;42;40;0.428571428571429;24;18;0.0714285714285715;0.428571428571429
Control.SRR15539824;38;40;0.631578947368421;14;24;0.131578947368421;0.368421052631579
Control.SRR15539824;40;40;0.5;20;20;0;0.5
Control.SRR15539824;43;40;0.395348837209302;26;17;0.104651162790698;0.395348837209302
Control.SRR15539824;40;40;0.35;26;14;0.15;0.35
Control.SRR15539824;40;40;0.6;16;24;0.1;0.4
Control.SRR15539824;39;40;0.512820512820513;19;20;0.0128205128205128;0.487179487179487
Control.SRR15539824;44;40;0.522727272727273;21;23;0.0227272727272727;0.477272727272727
Control.SRR15539824;42;40;0.452380952380952;23;19;0.0476190476190476;0.452380952380952
Control.SRR15539824;37;40;0.513513513513513;18;19;0.0135135135135135;0.486486486486487
Control.SRR15539824;41;40;0.439024390243902;23;18;0.0609756097560976;0.439024390243902
Control.SRR15539824;43;40;0.418604651162791;25;18;0.0813953488372093;0.418604651162791
Control.SRR15539824;39;40;0.564102564102564;17;22;0.0641025641025641;0.435897435897436
Control.SRR15539824;37;40;0.432432432432432;21;16;0.0675675675675675;0.432432432432432
Control.SRR15539824;34;40;0.647058823529412;12;22;0.147058823529412;0.352941176470588
Control.SRR15539824;42;40;0.452380952380952;23;19;0.0476190476190476;0.452380952380952
Control.SRR15539824;39;40;0.538461538461538;18;21;0.0384615384615384;0.461538461538462
Control.SRR15539824;41;40;0.439024390243902;23;18;0.0609756097560976;0.439024390243902
Control.SRR15539824;35;40;0.371428571428571;22;13;0.128571428571429;0.371428571428571
Control.SRR15539824;42;40;0.404761904761905;25;17;0.0952380952380952;0.404761904761905
Control.SRR15539824;38;40;0.5;19;19;0;0.5
Control.SRR15539824;44;40;0.522727272727273;21;23;0.0227272727272727;0.477272727272727
Control.SRR15539824;41;40;0.463414634146341;22;19;0.0365853658536585;0.463414634146341
Control.SRR15539824;38;40;0.526315789473684;18;20;0.0263157894736842;0.473684210526316
Control.SRR15539824;40;40;0.5;20;20;0;0.5
Control.SRR15539824;41;40;0.463414634146341;22;19;0.0365853658536585;0.463414634146341
Control.SRR15539824;42;40;0.476190476190476;22;20;0.0238095238095238;0.476190476190476
Control.SRR15539824;40;40;0.45;22;18;0.05;0.45
Control.SRR15539824;44;40;0.568181818181818;19;25;0.0681818181818182;0.431818181818182
Control.SRR15539824;40;40;0.475;21;19;0.025;0.475
Control.SRR15539824;39;40;0.615384615384615;15;24;0.115384615384615;0.384615384615385
Control.SRR15539824;36;40;0.527777777777778;17;19;0.0277777777777778;0.472222222222222
Control.SRR15539824;39;40;0.615384615384615;15;24;0.115384615384615;0.384615384615385
Control.SRR15539824;39;40;0.435897435897436;22;17;0.0641025641025641;0.435897435897436
Control.SRR15539824;42;40;0.642857142857143;15;27;0.142857142857143;0.357142857142857
Control.SRR15539824;44;40;0.522727272727273;21;23;0.0227272727272727;0.477272727272727
Control.SRR15539824;40;40;0.3;28;12;0.2;0.3
Control.SRR15539824;38;40;0.552631578947368;17;21;0.0526315789473685;0.447368421052632
Control.SRR15539824;38;40;0.447368421052632;21;17;0.0526315789473684;0.447368421052632
Control.SRR15539824;42;40;0.571428571428571;18;24;0.0714285714285714;0.428571428571429
Control.SRR15539824;41;40;0.390243902439024;25;16;0.109756097560976;0.390243902439024
Control.SRR15539824;35;40;0.571428571428571;15;20;0.0714285714285714;0.428571428571429
Control.SRR15539824;36;40;0.555555555555556;16;20;0.0555555555555556;0.444444444444444
Control.SRR15539824;35;40;0.514285714285714;17;18;0.0142857142857142;0.485714285714286
Control.SRR15539824;41;40;0.390243902439024;25;16;0.109756097560976;0.390243902439024
Control.SRR15539824;36;40;0.75;9;27;0.25;0.25
Control.SRR15539824;41;40;0.609756097560976;16;25;0.109756097560976;0.390243902439024
Control.SRR15539824;36;40;0.694444444444444;11;25;0.194444444444444;0.305555555555556
Control.SRR15539824;43;40;0.511627906976744;21;22;0.0116279069767442;0.488372093023256
Control.SRR15539824;43;40;0.511627906976744;21;22;0.0116279069767442;0.488372093023256
Control.SRR15539824;37;40;0.540540540540541;17;20;0.0405405405405406;0.459459459459459
Control.SRR15539824;43;40;0.395348837209302;26;17;0.104651162790698;0.395348837209302
Control.SRR15539824;42;40;0.476190476190476;22;20;0.0238095238095238;0.476190476190476
Control.SRR15539824;42;40;0.619047619047619;16;26;0.119047619047619;0.380952380952381
Control.SRR15539824;44;40;0.5;22;22;0;0.5
Control.SRR15539824;38;40;0.526315789473684;18;20;0.0263157894736842;0.473684210526316
Control.SRR15539824;39;40;0.358974358974359;25;14;0.141025641025641;0.358974358974359
Control.SRR15539824;35;40;0.485714285714286;18;17;0.0142857142857143;0.485714285714286
Control.SRR15539824;38;40;0.5;19;19;0;0.5
Control.SRR15539824;36;40;0.527777777777778;17;19;0.0277777777777778;0.472222222222222
Control.SRR15539824;37;40;0.540540540540541;17;20;0.0405405405405406;0.459459459459459
Control.SRR15539824;42;40;0.380952380952381;26;16;0.119047619047619;0.380952380952381
Control.SRR15539824;35;40;0.571428571428571;15;20;0.0714285714285714;0.428571428571429
Control.SRR15539824;38;40;0.5;19;19;0;0.5
Control.SRR15539824;40;40;0.35;26;14;0.15;0.35
Control.SRR15539824;34;40;0.470588235294118;18;16;0.0294117647058824;0.470588235294118
Control.SRR15539824;44;40;0.522727272727273;21;23;0.0227272727272727;0.477272727272727
Control.SRR15539824;44;40;0.5;22;22;0;0.5
Control.SRR15539824;44;40;0.545454545454545;20;24;0.0454545454545454;0.454545454545455
Control.SRR15539824;43;40;0.418604651162791;25;18;0.0813953488372093;0.418604651162791
Control.SRR15539824;39;40;0.512820512820513;19;20;0.0128205128205128;0.487179487179487
Control.SRR15539824;39;40;0.512820512820513;19;20;0.0128205128205128;0.487179487179487
Control.SRR15539824;43;40;0.465116279069767;23;20;0.0348837209302326;0.465116279069767
Control.SRR15539824;35;40;0.485714285714286;18;17;0.0142857142857143;0.485714285714286
Control.SRR15539824;35;40;0.457142857142857;19;16;0.0428571428571429;0.457142857142857
Control.SRR15539824;35;40;0.628571428571429;13;22;0.128571428571429;0.371428571428571
Control.SRR15539824;37;40;0.432432432432432;21;16;0.0675675675675675;0.432432432432432
Control.SRR15539824;37;40;0.459459459459459;20;17;0.0405405405405405;0.459459459459459
Control.SRR15539824;40;40;0.525;19;21;0.025;0.475
Control.SRR15539824;41;40;0.439024390243902;23;18;0.0609756097560976;0.439024390243902
Control.SRR15539824;42;40;0.547619047619048;19;23;0.0476190476190477;0.452380952380952
Control.SRR15539824;37;40;0.648648648648649;13;24;0.148648648648649;0.351351351351351
Control.SRR15539824;40;40;0.475;21;19;0.025;0.475
Control.SRR15539824;44;40;0.386363636363636;27;17;0.113636363636364;0.386363636363636
Control.SRR15539824;43;40;0.441860465116279;24;19;0.0581395348837209;0.441860465116279
Control.SRR15539824;41;40;0.560975609756098;18;23;0.0609756097560976;0.439024390243902
Control.SRR15539824;44;40;0.477272727272727;23;21;0.0227272727272727;0.477272727272727
Control.SRR15539824;44;40;0.522727272727273;21;23;0.0227272727272727;0.477272727272727
Control.SRR15539824;44;40;0.431818181818182;25;19;0.0681818181818182;0.431818181818182
Control.SRR15539824;43;40;0.627906976744186;16;27;0.127906976744186;0.372093023255814
Control.SRR15539824;44;40;0.590909090909091;18;26;0.0909090909090909;0.409090909090909
Control.SRR15539824;42;40;0.333333333333333;28;14;0.166666666666667;0.333333333333333
Control.SRR15539824;44;40;0.522727272727273;21;23;0.0227272727272727;0.477272727272727
Control.SRR15539824;35;40;0.485714285714286;18;17;0.0142857142857143;0.485714285714286
Control.SRR15539824;42;40;0.5;21;21;0;0.5
Control.SRR15539824;39;40;0.512820512820513;19;20;0.0128205128205128;0.487179487179487
Control.SRR15539824;43;40;0.581395348837209;18;25;0.0813953488372093;0.418604651162791
Control.SRR15539824;40;40;0.65;14;26;0.15;0.35
Control.SRR15539824;44;40;0.636363636363636;16;28;0.136363636363636;0.363636363636364
Control.SRR15539824;41;40;0.439024390243902;23;18;0.0609756097560976;0.439024390243902
Control.SRR15539824;43;40;0.558139534883721;19;24;0.0581395348837209;0.441860465116279
Control.SRR15539824;42;40;0.380952380952381;26;16;0.119047619047619;0.380952380952381
Control.SRR15539824;43;40;0.581395348837209;18;25;0.0813953488372093;0.418604651162791
Control.SRR15539824;34;40;0.5;17;17;0;0.5
Control.SRR15539824;35;40;0.485714285714286;18;17;0.0142857142857143;0.485714285714286
Control.SRR15539824;40;40;0.475;21;19;0.025;0.475
Control.SRR15539824;37;40;0.540540540540541;17;20;0.0405405405405406;0.459459459459459
Control.SRR15539824;36;40;0.527777777777778;17;19;0.0277777777777778;0.472222222222222
Control.SRR15539824;40;40;0.425;23;17;0.075;0.425
Control.SRR15539824;42;40;0.619047619047619;16;26;0.119047619047619;0.380952380952381
Control.SRR15539824;40;40;0.5;20;20;0;0.5
Control.SRR15539824;44;40;0.545454545454545;20;24;0.0454545454545454;0.454545454545455
Control.SRR15539824;41;40;0.439024390243902;23;18;0.0609756097560976;0.439024390243902
Control.SRR15539824;40;40;0.275;29;11;0.225;0.275
Control.SRR15539824;37;40;0.513513513513513;18;19;0.0135135135135135;0.486486486486487
Control.SRR15539824;41;40;0.51219512195122;20;21;0.0121951219512195;0.48780487804878
Control.SRR15539824;34;40;0.5;17;17;0;0.5
Control.SRR15539824;39;40;0.641025641025641;14;25;0.141025641025641;0.358974358974359
Control.SRR15539824;36;40;0.5;18;18;0;0.5
Control.SRR15539824;37;40;0.432432432432432;21;16;0.0675675675675675;0.432432432432432
Control.SRR15539824;43;40;0.511627906976744;21;22;0.0116279069767442;0.488372093023256
Control.SRR15539824;39;40;0.41025641025641;23;16;0.0897435897435898;0.41025641025641
Control.SRR15539824;34;40;0.441176470588235;19;15;0.0588235294117647;0.441176470588235
Control.SRR15539824;39;40;0.564102564102564;17;22;0.0641025641025641;0.435897435897436
Control.SRR15539824;44;40;0.431818181818182;25;19;0.0681818181818182;0.431818181818182
Control.SRR15539824;40;40;0.35;26;14;0.15;0.35
Control.SRR15539824;39;40;0.461538461538462;21;18;0.0384615384615384;0.461538461538462
Control.SRR15539824;35;40;0.542857142857143;16;19;0.0428571428571428;0.457142857142857
Control.SRR15539824;35;40;0.542857142857143;16;19;0.0428571428571428;0.457142857142857
Control.SRR15539824;36;40;0.472222222222222;19;17;0.0277777777777778;0.472222222222222
Control.SRR15539824;39;40;0.538461538461538;18;21;0.0384615384615384;0.461538461538462
Control.SRR15539824;37;40;0.594594594594595;15;22;0.0945945945945946;0.405405405405405
Control.SRR15539824;43;40;0.441860465116279;24;19;0.0581395348837209;0.441860465116279
Control.SRR15539824;40;40;0.375;25;15;0.125;0.375
Control.SRR15539824;39;40;0.512820512820513;19;20;0.0128205128205128;0.487179487179487
Control.SRR15539824;39;40;0.487179487179487;20;19;0.0128205128205128;0.487179487179487
Control.SRR15539824;39;40;0.538461538461538;18;21;0.0384615384615384;0.461538461538462
Control.SRR15539824;38;40;0.526315789473684;18;20;0.0263157894736842;0.473684210526316
Control.SRR15539824;34;40;0.735294117647059;9;25;0.235294117647059;0.264705882352941
Control.SRR15539824;36;40;0.638888888888889;13;23;0.138888888888889;0.361111111111111
Control.SRR15539824;44;40;0.477272727272727;23;21;0.0227272727272727;0.477272727272727
Control.SRR15539824;37;40;0.459459459459459;20;17;0.0405405405405405;0.459459459459459
Control.SRR15539824;37;40;0.648648648648649;13;24;0.148648648648649;0.351351351351351
Control.SRR15539824;39;40;0.512820512820513;19;20;0.0128205128205128;0.487179487179487
Control.SRR15539824;38;40;0.447368421052632;21;17;0.0526315789473684;0.447368421052632
Control.SRR15539824;40;40;0.475;21;19;0.025;0.475
Control.SRR15539824;43;40;0.627906976744186;16;27;0.127906976744186;0.372093023255814
Control.SRR15539824;41;40;0.51219512195122;20;21;0.0121951219512195;0.48780487804878
Control.SRR15539824;42;40;0.428571428571429;24;18;0.0714285714285715;0.428571428571429
Control.SRR15539824;42;40;0.523809523809524;20;22;0.0238095238095238;0.476190476190476
Control.SRR15539824;42;40;0.476190476190476;22;20;0.0238095238095238;0.476190476190476
Control.SRR15539824;38;40;0.605263157894737;15;23;0.105263157894737;0.394736842105263
Control.SRR15539824;34;40;0.529411764705882;16;18;0.0294117647058824;0.470588235294118
Control.SRR15539824;35;40;0.314285714285714;24;11;0.185714285714286;0.314285714285714
Control.SRR15539824;44;40;0.409090909090909;26;18;0.0909090909090909;0.409090909090909
Control.SRR15539824;36;40;0.472222222222222;19;17;0.0277777777777778;0.472222222222222
Control.SRR15539824;35;40;0.514285714285714;17;18;0.0142857142857142;0.485714285714286
Control.SRR15539824;34;40;0.617647058823529;13;21;0.117647058823529;0.382352941176471
Control.SRR15539824;35;40;0.514285714285714;17;18;0.0142857142857142;0.485714285714286
Control.SRR15539824;44;40;0.522727272727273;21;23;0.0227272727272727;0.477272727272727
Control.SRR15539824;44;40;0.431818181818182;25;19;0.0681818181818182;0.431818181818182
Control.SRR15539824;38;40;0.368421052631579;24;14;0.131578947368421;0.368421052631579
Control.SRR15539824;40;40;0.475;21;19;0.025;0.475
Control.SRR15539824;43;40;0.441860465116279;24;19;0.0581395348837209;0.441860465116279
Control.SRR15539824;42;40;0.595238095238095;17;25;0.0952380952380952;0.404761904761905
Control.SRR15539824;44;40;0.318181818181818;30;14;0.181818181818182;0.318181818181818
Control.SRR15539824;42;40;0.285714285714286;30;12;0.214285714285714;0.285714285714286
Control.SRR15539824;40;40;0.55;18;22;0.05;0.45
Control.SRR15539824;35;40;0.514285714285714;17;18;0.0142857142857142;0.485714285714286
Control.SRR15539824;35;40;0.514285714285714;17;18;0.0142857142857142;0.485714285714286
Control.SRR15539824;39;40;0.564102564102564;17;22;0.0641025641025641;0.435897435897436
Control.SRR15539824;43;40;0.465116279069767;23;20;0.0348837209302326;0.465116279069767
Control.SRR15539824;40;40;0.575;17;23;0.075;0.425
Control.SRR15539824;42;40;0.571428571428571;18;24;0.0714285714285714;0.428571428571429
Control.SRR15539824;37;40;0.432432432432432;21;16;0.0675675675675675;0.432432432432432
Control.SRR15539824;37;40;0.378378378378378;23;14;0.121621621621622;0.378378378378378
Control.SRR15539824;35;40;0.571428571428571;15;20;0.0714285714285714;0.428571428571429
Control.SRR15539824;36;40;0.555555555555556;16;20;0.0555555555555556;0.444444444444444
Control.SRR15539824;41;40;0.463414634146341;22;19;0.0365853658536585;0.463414634146341
Control.SRR15539824;34;40;0.411764705882353;20;14;0.0882352941176471;0.411764705882353
Control.SRR15539824;34;40;0.323529411764706;23;11;0.176470588235294;0.323529411764706
Control.SRR15539824;43;40;0.488372093023256;22;21;0.0116279069767442;0.488372093023256
Control.SRR15539824;34;40;0.441176470588235;19;15;0.0588235294117647;0.441176470588235
Control.SRR15539824;36;40;0.333333333333333;24;12;0.166666666666667;0.333333333333333
Control.SRR15539824;39;40;0.615384615384615;15;24;0.115384615384615;0.384615384615385
Control.SRR15539824;42;40;0.5;21;21;0;0.5
Control.SRR15539824;43;40;0.488372093023256;22;21;0.0116279069767442;0.488372093023256
Control.SRR15539824;35;40;0.542857142857143;16;19;0.0428571428571428;0.457142857142857
Control.SRR15539824;44;40;0.409090909090909;26;18;0.0909090909090909;0.409090909090909
Control.SRR15539824;39;40;0.564102564102564;17;22;0.0641025641025641;0.435897435897436
Control.SRR15539824;38;40;0.394736842105263;23;15;0.105263157894737;0.394736842105263
Control.SRR15539824;39;40;0.641025641025641;14;25;0.141025641025641;0.358974358974359
Control.SRR15539824;38;40;0.552631578947368;17;21;0.0526315789473685;0.447368421052632
Control.SRR15539824;39;40;0.564102564102564;17;22;0.0641025641025641;0.435897435897436
Control.SRR15539824;35;40;0.314285714285714;24;11;0.185714285714286;0.314285714285714
Control.SRR15539824;44;40;0.545454545454545;20;24;0.0454545454545454;0.454545454545455
Control.SRR15539824;44;40;0.5;22;22;0;0.5
Control.SRR15539824;34;40;0.5;17;17;0;0.5
Control.SRR15539824;37;40;0.486486486486487;19;18;0.0135135135135135;0.486486486486487
Control.SRR15539824;39;40;0.461538461538462;21;18;0.0384615384615384;0.461538461538462
Control.SRR15539824;39;40;0.435897435897436;22;17;0.0641025641025641;0.435897435897436
Control.SRR15539824;41;40;0.48780487804878;21;20;0.0121951219512195;0.48780487804878
Control.SRR15539824;34;40;0.558823529411765;15;19;0.0588235294117647;0.441176470588235
Control.SRR15539824;34;40;0.529411764705882;16;18;0.0294117647058824;0.470588235294118
Control.SRR15539824;41;40;0.292682926829268;29;12;0.207317073170732;0.292682926829268
Control.SRR15539824;37;40;0.540540540540541;17;20;0.0405405405405406;0.459459459459459
Control.SRR15539824;36;40;0.5;18;18;0;0.5
Control.SRR15539824;34;40;0.470588235294118;18;16;0.0294117647058824;0.470588235294118
Control.SRR15539824;41;40;0.390243902439024;25;16;0.109756097560976;0.390243902439024
Control.SRR15539824;38;40;0.578947368421053;16;22;0.0789473684210527;0.421052631578947
Control.SRR15539824;35;40;0.6;14;21;0.1;0.4
Control.SRR15539824;36;40;0.388888888888889;22;14;0.111111111111111;0.388888888888889
Control.SRR15539824;44;40;0.5;22;22;0;0.5
Control.SRR15539824;39;40;0.435897435897436;22;17;0.0641025641025641;0.435897435897436
Control.SRR15539824;36;40;0.416666666666667;21;15;0.0833333333333333;0.416666666666667
Control.SRR15539824;42;40;0.404761904761905;25;17;0.0952380952380952;0.404761904761905
Control.SRR15539824;40;40;0.55;18;22;0.05;0.45
Control.SRR15539824;43;40;0.534883720930233;20;23;0.0348837209302325;0.465116279069767
Control.SRR15539824;38;40;0.526315789473684;18;20;0.0263157894736842;0.473684210526316
Control.SRR15539824;35;40;0.4;21;14;0.1;0.4
Control.SRR15539824;37;40;0.486486486486487;19;18;0.0135135135135135;0.486486486486487
Control.SRR15539824;39;40;0.461538461538462;21;18;0.0384615384615384;0.461538461538462
Control.SRR15539824;42;40;0.523809523809524;20;22;0.0238095238095238;0.476190476190476
Control.SRR15539824;36;40;0.472222222222222;19;17;0.0277777777777778;0.472222222222222
Control.SRR15539824;36;40;0.472222222222222;19;17;0.0277777777777778;0.472222222222222
Control.SRR15539824;38;40;0.578947368421053;16;22;0.0789473684210527;0.421052631578947
Control.SRR15539824;36;40;0.472222222222222;19;17;0.0277777777777778;0.472222222222222
Control.SRR15539824;39;40;0.487179487179487;20;19;0.0128205128205128;0.487179487179487
Control.SRR15539824;43;40;0.348837209302326;28;15;0.151162790697674;0.348837209302326
Control.SRR15539824;40;40;0.5;20;20;0;0.5
Control.SRR15539824;41;40;0.48780487804878;21;20;0.0121951219512195;0.48780487804878
Control.SRR15539824;40;40;0.55;18;22;0.05;0.45
Control.SRR15539824;41;40;0.48780487804878;21;20;0.0121951219512195;0.48780487804878
Control.SRR15539824;36;40;0.555555555555556;16;20;0.0555555555555556;0.444444444444444
Control.SRR15539824;39;40;0.435897435897436;22;17;0.0641025641025641;0.435897435897436
Control.SRR15539824;39;40;0.487179487179487;20;19;0.0128205128205128;0.487179487179487
Control.SRR15539824;39;40;0.41025641025641;23;16;0.0897435897435898;0.41025641025641
Control.SRR15539824;40;40;0.525;19;21;0.025;0.475
Control.SRR15539824;39;40;0.58974358974359;16;23;0.0897435897435898;0.41025641025641
Control.SRR15539824;42;40;0.380952380952381;26;16;0.119047619047619;0.380952380952381
Control.SRR15539824;41;40;0.48780487804878;21;20;0.0121951219512195;0.48780487804878
Control.SRR15539824;40;40;0.5;20;20;0;0.5
Control.SRR15539824;40;40;0.45;22;18;0.05;0.45
Control.SRR15539824;36;40;0.555555555555556;16;20;0.0555555555555556;0.444444444444444
Control.SRR15539824;42;40;0.476190476190476;22;20;0.0238095238095238;0.476190476190476
Control.SRR15539824;43;40;0.558139534883721;19;24;0.0581395348837209;0.441860465116279
Control.SRR15539824;41;40;0.585365853658537;17;24;0.0853658536585366;0.414634146341463
Control.SRR15539824;44;40;0.522727272727273;21;23;0.0227272727272727;0.477272727272727
Control.SRR15539824;38;40;0.447368421052632;21;17;0.0526315789473684;0.447368421052632
Control.SRR15539824;38;40;0.473684210526316;20;18;0.0263157894736842;0.473684210526316
Control.SRR15539824;36;40;0.444444444444444;20;16;0.0555555555555556;0.444444444444444
Control.SRR15539824;42;40;0.5;21;21;0;0.5
Control.SRR15539824;40;40;0.55;18;22;0.05;0.45
Control.SRR15539824;43;40;0.511627906976744;21;22;0.0116279069767442;0.488372093023256
Control.SRR15539824;43;40;0.325581395348837;29;14;0.174418604651163;0.325581395348837
Control.SRR15539824;34;40;0.470588235294118;18;16;0.0294117647058824;0.470588235294118
Control.SRR15539824;43;40;0.604651162790698;17;26;0.104651162790698;0.395348837209302
Control.SRR15539824;43;40;0.395348837209302;26;17;0.104651162790698;0.395348837209302
Control.SRR15539824;38;40;0.631578947368421;14;24;0.131578947368421;0.368421052631579
Control.SRR15539824;42;40;0.547619047619048;19;23;0.0476190476190477;0.452380952380952
Control.SRR15539824;38;40;0.552631578947368;17;21;0.0526315789473685;0.447368421052632
Control.SRR15539824;34;40;0.529411764705882;16;18;0.0294117647058824;0.470588235294118
Control.SRR15539824;38;40;0.5;19;19;0;0.5
Control.SRR15539824;43;40;0.511627906976744;21;22;0.0116279069767442;0.488372093023256
Control.SRR15539824;37;40;0.567567567567568;16;21;0.0675675675675675;0.432432432432432
Control.SRR15539824;43;40;0.627906976744186;16;27;0.127906976744186;0.372093023255814
Control.SRR15539824;41;40;0.414634146341463;24;17;0.0853658536585366;0.414634146341463
Control.SRR15539824;41;40;0.51219512195122;20;21;0.0121951219512195;0.48780487804878
Control.SRR15539824;38;40;0.526315789473684;18;20;0.0263157894736842;0.473684210526316
Control.SRR15539824;41;40;0.414634146341463;24;17;0.0853658536585366;0.414634146341463
Control.SRR15539824;42;40;0.523809523809524;20;22;0.0238095238095238;0.476190476190476
Control.SRR15539824;35;40;0.657142857142857;12;23;0.157142857142857;0.342857142857143
Control.SRR15539824;37;40;0.513513513513513;18;19;0.0135135135135135;0.486486486486487
Control.SRR15539824;42;40;0.428571428571429;24;18;0.0714285714285715;0.428571428571429
Control.SRR15539824;38;40;0.578947368421053;16;22;0.0789473684210527;0.421052631578947
Control.SRR15539824;44;40;0.522727272727273;21;23;0.0227272727272727;0.477272727272727
Control.SRR15539824;40;40;0.45;22;18;0.05;0.45
Control.SRR15539824;40;40;0.375;25;15;0.125;0.375
Control.SRR15539824;42;40;0.452380952380952;23;19;0.0476190476190476;0.452380952380952
Control.SRR15539824;35;40;0.542857142857143;16;19;0.0428571428571428;0.457142857142857
Control.SRR15539824;42;40;0.428571428571429;24;18;0.0714285714285715;0.428571428571429
Control.SRR15539824;39;40;0.538461538461538;18;21;0.0384615384615384;0.461538461538462
Control.SRR15539824;41;40;0.439024390243902;23;18;0.0609756097560976;0.439024390243902
Control.SRR15539824;38;40;0.473684210526316;20;18;0.0263157894736842;0.473684210526316
Control.SRR15539824;38;40;0.473684210526316;20;18;0.0263157894736842;0.473684210526316
Control.SRR15539824;39;40;0.58974358974359;16;23;0.0897435897435898;0.41025641025641
Control.SRR15539824;44;40;0.431818181818182;25;19;0.0681818181818182;0.431818181818182
Control.SRR15539824;35;40;0.514285714285714;17;18;0.0142857142857142;0.485714285714286
Control.SRR15539824;39;40;0.487179487179487;20;19;0.0128205128205128;0.487179487179487
Control.SRR15539824;35;40;0.457142857142857;19;16;0.0428571428571429;0.457142857142857
Control.SRR15539824;40;40;0.5;20;20;0;0.5
Control.SRR15539824;39;40;0.461538461538462;21;18;0.0384615384615384;0.461538461538462
Control.SRR15539824;34;40;0.529411764705882;16;18;0.0294117647058824;0.470588235294118
Control.SRR15539824;39;40;0.512820512820513;19;20;0.0128205128205128;0.487179487179487
Control.SRR15539824;39;40;0.307692307692308;27;12;0.192307692307692;0.307692307692308
Control.SRR15539824;41;40;0.439024390243902;23;18;0.0609756097560976;0.439024390243902
Control.SRR15539824;38;40;0.473684210526316;20;18;0.0263157894736842;0.473684210526316
Control.SRR15539824;40;40;0.45;22;18;0.05;0.45
Control.SRR15539824;37;40;0.459459459459459;20;17;0.0405405405405405;0.459459459459459
Control.SRR15539824;41;40;0.390243902439024;25;16;0.109756097560976;0.390243902439024
Control.SRR15539824;43;40;0.674418604651163;14;29;0.174418604651163;0.325581395348837
Control.SRR15539824;35;40;0.571428571428571;15;20;0.0714285714285714;0.428571428571429
Control.SRR15539824;34;40;0.5;17;17;0;0.5
Control.SRR15539824;41;40;0.463414634146341;22;19;0.0365853658536585;0.463414634146341
Control.SRR15539824;36;40;0.416666666666667;21;15;0.0833333333333333;0.416666666666667
Control.SRR15539824;39;40;0.58974358974359;16;23;0.0897435897435898;0.41025641025641
Control.SRR15539824;36;40;0.444444444444444;20;16;0.0555555555555556;0.444444444444444
Control.SRR15539824;40;40;0.525;19;21;0.025;0.475
Control.SRR15539824;40;40;0.525;19;21;0.025;0.475
Control.SRR15539824;41;40;0.609756097560976;16;25;0.109756097560976;0.390243902439024
Control.SRR15539824;43;40;0.534883720930233;20;23;0.0348837209302325;0.465116279069767
Control.SRR15539824;42;40;0.571428571428571;18;24;0.0714285714285714;0.428571428571429
Control.SRR15539824;37;40;0.432432432432432;21;16;0.0675675675675675;0.432432432432432
Control.SRR15539824;40;40;0.575;17;23;0.075;0.425
Control.SRR15539824;35;40;0.514285714285714;17;18;0.0142857142857142;0.485714285714286
Control.SRR15539824;42;40;0.523809523809524;20;22;0.0238095238095238;0.476190476190476
Control.SRR15539824;44;40;0.568181818181818;19;25;0.0681818181818182;0.431818181818182
Control.SRR15539824;42;40;0.5;21;21;0;0.5
Control.SRR15539824;37;40;0.567567567567568;16;21;0.0675675675675675;0.432432432432432
Control.SRR15539824;40;40;0.325;27;13;0.175;0.325
Control.SRR15539824;35;40;0.6;14;21;0.1;0.4
Control.SRR15539824;36;40;0.5;18;18;0;0.5
Control.SRR15539824;39;40;0.564102564102564;17;22;0.0641025641025641;0.435897435897436
Control.SRR15539824;34;40;0.5;17;17;0;0.5
Control.SRR15539824;39;40;0.512820512820513;19;20;0.0128205128205128;0.487179487179487
Control.SRR15539824;35;40;0.457142857142857;19;16;0.0428571428571429;0.457142857142857
Control.SRR15539824;38;40;0.552631578947368;17;21;0.0526315789473685;0.447368421052632
Control.SRR15539824;43;40;0.488372093023256;22;21;0.0116279069767442;0.488372093023256
Control.SRR15539824;37;40;0.378378378378378;23;14;0.121621621621622;0.378378378378378
Control.SRR15539824;40;40;0.475;21;19;0.025;0.475
Control.SRR15539824;42;40;0.404761904761905;25;17;0.0952380952380952;0.404761904761905
Control.SRR15539824;38;40;0.5;19;19;0;0.5
Control.SRR15539824;37;40;0.324324324324324;25;12;0.175675675675676;0.324324324324324
Control.SRR15539824;34;40;0.529411764705882;16;18;0.0294117647058824;0.470588235294118
Control.SRR15539824;38;40;0.5;19;19;0;0.5
Control.SRR15539824;37;40;0.648648648648649;13;24;0.148648648648649;0.351351351351351
Control.SRR15539824;40;40;0.375;25;15;0.125;0.375
Control.SRR15539824;41;40;0.439024390243902;23;18;0.0609756097560976;0.439024390243902
Control.SRR15539824;39;40;0.58974358974359;16;23;0.0897435897435898;0.41025641025641
Control.SRR15539824;42;40;0.333333333333333;28;14;0.166666666666667;0.333333333333333
Control.SRR15539824;41;40;0.48780487804878;21;20;0.0121951219512195;0.48780487804878
Control.SRR15539824;40;40;0.525;19;21;0.025;0.475
Control.SRR15539824;40;40;0.525;19;21;0.025;0.475
Control.SRR15539824;38;40;0.526315789473684;18;20;0.0263157894736842;0.473684210526316
Control.SRR15539824;36;40;0.611111111111111;14;22;0.111111111111111;0.388888888888889
Control.SRR15539824;40;40;0.6;16;24;0.1;0.4
Control.SRR15539824;40;40;0.475;21;19;0.025;0.475
Control.SRR15539824;41;40;0.48780487804878;21;20;0.0121951219512195;0.48780487804878
Control.SRR15539824;39;40;0.512820512820513;19;20;0.0128205128205128;0.487179487179487
Control.SRR15539824;44;40;0.431818181818182;25;19;0.0681818181818182;0.431818181818182
Control.SRR15539824;39;40;0.487179487179487;20;19;0.0128205128205128;0.487179487179487
Control.SRR15539824;39;40;0.641025641025641;14;25;0.141025641025641;0.358974358974359
Control.SRR15539824;37;40;0.405405405405405;22;15;0.0945945945945946;0.405405405405405
Control.SRR15539824;41;40;0.51219512195122;20;21;0.0121951219512195;0.48780487804878
Control.SRR15539824;38;40;0.394736842105263;23;15;0.105263157894737;0.394736842105263
Control.SRR15539824;40;40;0.375;25;15;0.125;0.375
Control.SRR15539824;44;40;0.363636363636364;28;16;0.136363636363636;0.363636363636364
Control.SRR15539824;36;40;0.611111111111111;14;22;0.111111111111111;0.388888888888889
Control.SRR15539824;42;40;0.428571428571429;24;18;0.0714285714285715;0.428571428571429
Control.SRR15539824;38;40;0.447368421052632;21;17;0.0526315789473684;0.447368421052632
Control.SRR15539824;34;40;0.5;17;17;0;0.5
Control.SRR15539824;42;40;0.452380952380952;23;19;0.0476190476190476;0.452380952380952
Control.SRR15539824;43;40;0.465116279069767;23;20;0.0348837209302326;0.465116279069767
Control.SRR15539824;35;40;0.485714285714286;18;17;0.0142857142857143;0.485714285714286
Control.SRR15539824;34;40;0.352941176470588;22;12;0.147058823529412;0.352941176470588
Control.SRR15539824;40;40;0.55;18;22;0.05;0.45
Control.SRR15539824;36;40;0.416666666666667;21;15;0.0833333333333333;0.416666666666667
Control.SRR15539824;35;40;0.714285714285714;10;25;0.214285714285714;0.285714285714286
Control.SRR15539824;43;40;0.534883720930233;20;23;0.0348837209302325;0.465116279069767
Control.SRR15539824;44;40;0.409090909090909;26;18;0.0909090909090909;0.409090909090909
Control.SRR15539824;38;40;0.447368421052632;21;17;0.0526315789473684;0.447368421052632
Control.SRR15539824;43;40;0.465116279069767;23;20;0.0348837209302326;0.465116279069767
Control.SRR15539824;37;40;0.351351351351351;24;13;0.148648648648649;0.351351351351351
Control.SRR15539824;36;40;0.472222222222222;19;17;0.0277777777777778;0.472222222222222
Control.SRR15539824;44;40;0.545454545454545;20;24;0.0454545454545454;0.454545454545455
Control.SRR15539824;43;40;0.488372093023256;22;21;0.0116279069767442;0.488372093023256
Control.SRR15539824;38;40;0.473684210526316;20;18;0.0263157894736842;0.473684210526316
Control.SRR15539824;37;40;0.378378378378378;23;14;0.121621621621622;0.378378378378378
Control.SRR15539824;42;40;0.428571428571429;24;18;0.0714285714285715;0.428571428571429
Control.SRR15539824;36;40;0.416666666666667;21;15;0.0833333333333333;0.416666666666667
Control.SRR15539824;40;40;0.4;24;16;0.1;0.4
Control.SRR15539824;39;40;0.333333333333333;26;13;0.166666666666667;0.333333333333333
Control.SRR15539824;42;40;0.5;21;21;0;0.5
Control.SRR15539824;38;40;0.447368421052632;21;17;0.0526315789473684;0.447368421052632
Control.SRR15539824;37;40;0.486486486486487;19;18;0.0135135135135135;0.486486486486487
Control.SRR15539824;35;40;0.342857142857143;23;12;0.157142857142857;0.342857142857143
Control.SRR15539824;42;40;0.404761904761905;25;17;0.0952380952380952;0.404761904761905
Control.SRR15539824;39;40;0.41025641025641;23;16;0.0897435897435898;0.41025641025641
Control.SRR15539824;43;40;0.534883720930233;20;23;0.0348837209302325;0.465116279069767
Control.SRR15539824;34;40;0.558823529411765;15;19;0.0588235294117647;0.441176470588235
Control.SRR15539824;44;40;0.454545454545455;24;20;0.0454545454545455;0.454545454545455
Control.SRR15539824;35;40;0.542857142857143;16;19;0.0428571428571428;0.457142857142857
Control.SRR15539824;38;40;0.368421052631579;24;14;0.131578947368421;0.368421052631579
Control.SRR15539824;39;40;0.487179487179487;20;19;0.0128205128205128;0.487179487179487
Control.SRR15539824;42;40;0.476190476190476;22;20;0.0238095238095238;0.476190476190476
Control.SRR15539824;40;40;0.45;22;18;0.05;0.45
Control.SRR15539824;40;40;0.6;16;24;0.1;0.4
Control.SRR15539824;35;40;0.542857142857143;16;19;0.0428571428571428;0.457142857142857
Control.SRR15539824;41;40;0.536585365853659;19;22;0.0365853658536586;0.463414634146341
Control.SRR15539824;34;40;0.588235294117647;14;20;0.0882352941176471;0.411764705882353
Control.SRR15539824;38;40;0.421052631578947;22;16;0.0789473684210527;0.421052631578947
Control.SRR15539824;44;40;0.477272727272727;23;21;0.0227272727272727;0.477272727272727
Control.SRR15539824;38;40;0.578947368421053;16;22;0.0789473684210527;0.421052631578947
Control.SRR15539824;44;40;0.545454545454545;20;24;0.0454545454545454;0.454545454545455
Control.SRR15539824;42;40;0.595238095238095;17;25;0.0952380952380952;0.404761904761905
Control.SRR15539824;44;40;0.545454545454545;20;24;0.0454545454545454;0.454545454545455
Control.SRR15539824;35;40;0.571428571428571;15;20;0.0714285714285714;0.428571428571429
Control.SRR15539824;44;40;0.5;22;22;0;0.5
Control.SRR15539824;38;40;0.447368421052632;21;17;0.0526315789473684;0.447368421052632
Control.SRR15539824;40;40;0.4;24;16;0.1;0.4
Control.SRR15539824;40;40;0.525;19;21;0.025;0.475
Control.SRR15539824;36;40;0.444444444444444;20;16;0.0555555555555556;0.444444444444444
Control.SRR15539824;40;40;0.275;29;11;0.225;0.275
Control.SRR15539824;40;40;0.525;19;21;0.025;0.475
Control.SRR15539824;37;40;0.594594594594595;15;22;0.0945945945945946;0.405405405405405
Control.SRR15539824;35;40;0.457142857142857;19;16;0.0428571428571429;0.457142857142857
Control.SRR15539824;42;40;0.547619047619048;19;23;0.0476190476190477;0.452380952380952
Control.SRR15539824;40;40;0.5;20;20;0;0.5
Control.SRR15539824;38;40;0.710526315789474;11;27;0.210526315789474;0.289473684210526
Control.SRR15539824;39;40;0.58974358974359;16;23;0.0897435897435898;0.41025641025641
Control.SRR15539824;43;40;0.581395348837209;18;25;0.0813953488372093;0.418604651162791
Control.SRR15539824;40;40;0.425;23;17;0.075;0.425
Control.SRR15539824;37;40;0.540540540540541;17;20;0.0405405405405406;0.459459459459459
Control.SRR15539824;35;40;0.485714285714286;18;17;0.0142857142857143;0.485714285714286
Control.SRR15539824;43;40;0.511627906976744;21;22;0.0116279069767442;0.488372093023256
Control.SRR15539824;37;40;0.486486486486487;19;18;0.0135135135135135;0.486486486486487
Control.SRR15539824;38;40;0.447368421052632;21;17;0.0526315789473684;0.447368421052632
Control.SRR15539824;42;40;0.476190476190476;22;20;0.0238095238095238;0.476190476190476
Control.SRR15539824;36;40;0.444444444444444;20;16;0.0555555555555556;0.444444444444444
Control.SRR15539824;34;40;0.705882352941177;10;24;0.205882352941177;0.294117647058824
Control.SRR15539824;44;40;0.545454545454545;20;24;0.0454545454545454;0.454545454545455
Control.SRR15539824;42;40;0.5;21;21;0;0.5
Control.SRR15539824;41;40;0.463414634146341;22;19;0.0365853658536585;0.463414634146341
Control.SRR15539824;42;40;0.404761904761905;25;17;0.0952380952380952;0.404761904761905
Control.SRR15539824;42;40;0.547619047619048;19;23;0.0476190476190477;0.452380952380952
Control.SRR15539824;38;40;0.526315789473684;18;20;0.0263157894736842;0.473684210526316
Control.SRR15539824;34;40;0.529411764705882;16;18;0.0294117647058824;0.470588235294118
Control.SRR15539824;38;40;0.526315789473684;18;20;0.0263157894736842;0.473684210526316
Control.SRR15539824;40;40;0.625;15;25;0.125;0.375
Control.SRR15539824;42;40;0.476190476190476;22;20;0.0238095238095238;0.476190476190476
Control.SRR15539824;43;40;0.558139534883721;19;24;0.0581395348837209;0.441860465116279
Control.SRR15539824;37;40;0.486486486486487;19;18;0.0135135135135135;0.486486486486487
Control.SRR15539824;40;40;0.525;19;21;0.025;0.475
Control.SRR15539824;41;40;0.536585365853659;19;22;0.0365853658536586;0.463414634146341
Control.SRR15539824;42;40;0.428571428571429;24;18;0.0714285714285715;0.428571428571429
Control.SRR15539824;34;40;0.5;17;17;0;0.5
Control.SRR15539824;43;40;0.372093023255814;27;16;0.127906976744186;0.372093023255814
Control.SRR15539824;42;40;0.523809523809524;20;22;0.0238095238095238;0.476190476190476
Control.SRR15539824;43;40;0.534883720930233;20;23;0.0348837209302325;0.465116279069767
Control.SRR15539824;35;40;0.571428571428571;15;20;0.0714285714285714;0.428571428571429
Control.SRR15539824;41;40;0.414634146341463;24;17;0.0853658536585366;0.414634146341463
Control.SRR15539824;43;40;0.534883720930233;20;23;0.0348837209302325;0.465116279069767
Control.SRR15539824;35;40;0.428571428571429;20;15;0.0714285714285715;0.428571428571429
Control.SRR15539824;43;40;0.395348837209302;26;17;0.104651162790698;0.395348837209302
Control.SRR15539824;36;40;0.444444444444444;20;16;0.0555555555555556;0.444444444444444
Control.SRR15539824;42;40;0.428571428571429;24;18;0.0714285714285715;0.428571428571429
Control.SRR15539824;39;40;0.487179487179487;20;19;0.0128205128205128;0.487179487179487
Control.SRR15539824;35;40;0.6;14;21;0.1;0.4
Control.SRR15539824;38;40;0.473684210526316;20;18;0.0263157894736842;0.473684210526316
Control.SRR15539824;39;40;0.538461538461538;18;21;0.0384615384615384;0.461538461538462
Control.SRR15539824;38;40;0.473684210526316;20;18;0.0263157894736842;0.473684210526316
Control.SRR15539824;40;40;0.575;17;23;0.075;0.425
Control.SRR15539824;41;40;0.414634146341463;24;17;0.0853658536585366;0.414634146341463
Control.SRR15539824;39;40;0.538461538461538;18;21;0.0384615384615384;0.461538461538462
Control.SRR15539824;39;40;0.538461538461538;18;21;0.0384615384615384;0.461538461538462
Control.SRR15539824;43;40;0.558139534883721;19;24;0.0581395348837209;0.441860465116279
Control.SRR15539824;36;40;0.5;18;18;0;0.5
Control.SRR15539824;40;40;0.575;17;23;0.075;0.425
Control.SRR15539824;42;40;0.428571428571429;24;18;0.0714285714285715;0.428571428571429
Control.SRR15539824;40;40;0.45;22;18;0.05;0.45
Control.SRR15539824;43;40;0.604651162790698;17;26;0.104651162790698;0.395348837209302
Control.SRR15539824;42;40;0.523809523809524;20;22;0.0238095238095238;0.476190476190476
Control.SRR15539824;44;40;0.568181818181818;19;25;0.0681818181818182;0.431818181818182
Control.SRR15539824;41;40;0.48780487804878;21;20;0.0121951219512195;0.48780487804878
Control.SRR15539824;35;40;0.457142857142857;19;16;0.0428571428571429;0.457142857142857
Control.SRR15539824;42;40;0.5;21;21;0;0.5
Control.SRR15539824;42;40;0.571428571428571;18;24;0.0714285714285714;0.428571428571429
Control.SRR15539824;37;40;0.702702702702703;11;26;0.202702702702703;0.297297297297297
Control.SRR15539824;41;40;0.414634146341463;24;17;0.0853658536585366;0.414634146341463
Control.SRR15539824;43;40;0.651162790697674;15;28;0.151162790697674;0.348837209302326
Control.SRR15539824;40;40;0.55;18;22;0.05;0.45
Control.SRR15539824;42;40;0.761904761904762;10;32;0.261904761904762;0.238095238095238
Control.SRR15539824;43;40;0.558139534883721;19;24;0.0581395348837209;0.441860465116279
Control.SRR15539824;44;40;0.5;22;22;0;0.5
Control.SRR15539824;35;40;0.6;14;21;0.1;0.4
Control.SRR15539824;37;40;0.405405405405405;22;15;0.0945945945945946;0.405405405405405
Control.SRR15539824;35;40;0.542857142857143;16;19;0.0428571428571428;0.457142857142857
Control.SRR15539824;38;40;0.526315789473684;18;20;0.0263157894736842;0.473684210526316
Control.SRR15539824;37;40;0.648648648648649;13;24;0.148648648648649;0.351351351351351
Control.SRR15539824;38;40;0.631578947368421;14;24;0.131578947368421;0.368421052631579
Control.SRR15539824;35;40;0.485714285714286;18;17;0.0142857142857143;0.485714285714286
Control.SRR15539824;44;40;0.409090909090909;26;18;0.0909090909090909;0.409090909090909
Control.SRR15539824;38;40;0.473684210526316;20;18;0.0263157894736842;0.473684210526316
Control.SRR15539824;39;40;0.487179487179487;20;19;0.0128205128205128;0.487179487179487
Control.SRR15539824;41;40;0.536585365853659;19;22;0.0365853658536586;0.463414634146341
Control.SRR15539824;43;40;0.395348837209302;26;17;0.104651162790698;0.395348837209302
Control.SRR15539824;43;40;0.395348837209302;26;17;0.104651162790698;0.395348837209302
Control.SRR15539824;39;40;0.512820512820513;19;20;0.0128205128205128;0.487179487179487
Control.SRR15539824;34;40;0.294117647058824;24;10;0.205882352941176;0.294117647058824
Control.SRR15539824;40;40;0.4;24;16;0.1;0.4
Control.SRR15539824;40;40;0.4;24;16;0.1;0.4
Control.SRR15539824;39;40;0.487179487179487;20;19;0.0128205128205128;0.487179487179487
Control.SRR15539824;44;40;0.522727272727273;21;23;0.0227272727272727;0.477272727272727
Control.SRR15539824;34;40;0.470588235294118;18;16;0.0294117647058824;0.470588235294118
Control.SRR15539824;41;40;0.463414634146341;22;19;0.0365853658536585;0.463414634146341
Control.SRR15539824;34;40;0.411764705882353;20;14;0.0882352941176471;0.411764705882353
Control.SRR15539824;39;40;0.564102564102564;17;22;0.0641025641025641;0.435897435897436
Control.SRR15539824;39;40;0.564102564102564;17;22;0.0641025641025641;0.435897435897436
Control.SRR15539824;34;40;0.529411764705882;16;18;0.0294117647058824;0.470588235294118
Control.SRR15539824;42;40;0.357142857142857;27;15;0.142857142857143;0.357142857142857
Control.SRR15539824;35;40;0.628571428571429;13;22;0.128571428571429;0.371428571428571
Control.SRR15539824;37;40;0.594594594594595;15;22;0.0945945945945946;0.405405405405405
Control.SRR15539824;40;40;0.475;21;19;0.025;0.475
Control.SRR15539824;43;40;0.488372093023256;22;21;0.0116279069767442;0.488372093023256
Control.SRR15539824;36;40;0.638888888888889;13;23;0.138888888888889;0.361111111111111
Control.SRR15539824;37;40;0.486486486486487;19;18;0.0135135135135135;0.486486486486487
Control.SRR15539824;44;40;0.522727272727273;21;23;0.0227272727272727;0.477272727272727
Control.SRR15539824;43;40;0.534883720930233;20;23;0.0348837209302325;0.465116279069767
Control.SRR15539824;40;40;0.55;18;22;0.05;0.45
Control.SRR15539824;43;40;0.418604651162791;25;18;0.0813953488372093;0.418604651162791
Control.SRR15539824;44;40;0.409090909090909;26;18;0.0909090909090909;0.409090909090909
Control.SRR15539824;41;40;0.48780487804878;21;20;0.0121951219512195;0.48780487804878
Control.SRR15539824;41;40;0.585365853658537;17;24;0.0853658536585366;0.414634146341463
Control.SRR15539824;38;40;0.710526315789474;11;27;0.210526315789474;0.289473684210526
Control.SRR15539824;41;40;0.585365853658537;17;24;0.0853658536585366;0.414634146341463
Control.SRR15539824;41;40;0.48780487804878;21;20;0.0121951219512195;0.48780487804878
Control.SRR15539824;39;40;0.461538461538462;21;18;0.0384615384615384;0.461538461538462
Control.SRR15539824;44;40;0.409090909090909;26;18;0.0909090909090909;0.409090909090909
Control.SRR15539824;35;40;0.685714285714286;11;24;0.185714285714286;0.314285714285714
Control.SRR15539824;34;40;0.588235294117647;14;20;0.0882352941176471;0.411764705882353
Control.SRR15539824;44;40;0.590909090909091;18;26;0.0909090909090909;0.409090909090909
Control.SRR15539824;39;40;0.641025641025641;14;25;0.141025641025641;0.358974358974359
Control.SRR15539824;40;40;0.425;23;17;0.075;0.425
Control.SRR15539824;35;40;0.514285714285714;17;18;0.0142857142857142;0.485714285714286
Control.SRR15539824;40;40;0.5;20;20;0;0.5
Control.SRR15539824;40;40;0.425;23;17;0.075;0.425
Control.SRR15539824;41;40;0.536585365853659;19;22;0.0365853658536586;0.463414634146341
Control.SRR15539824;38;40;0.394736842105263;23;15;0.105263157894737;0.394736842105263
Control.SRR15539824;36;40;0.666666666666667;12;24;0.166666666666667;0.333333333333333
Control.SRR15539824;40;40;0.425;23;17;0.075;0.425
Control.SRR15539824;37;40;0.432432432432432;21;16;0.0675675675675675;0.432432432432432
Control.SRR15539824;41;40;0.463414634146341;22;19;0.0365853658536585;0.463414634146341
Control.SRR15539824;35;40;0.571428571428571;15;20;0.0714285714285714;0.428571428571429
Control.SRR15539824;37;40;0.486486486486487;19;18;0.0135135135135135;0.486486486486487
Control.SRR15539824;40;40;0.5;20;20;0;0.5
Control.SRR15539824;37;40;0.459459459459459;20;17;0.0405405405405405;0.459459459459459
Control.SRR15539824;40;40;0.625;15;25;0.125;0.375
Control.SRR15539824;38;40;0.421052631578947;22;16;0.0789473684210527;0.421052631578947
Control.SRR15539824;41;40;0.536585365853659;19;22;0.0365853658536586;0.463414634146341
Control.SRR15539824;34;40;0.617647058823529;13;21;0.117647058823529;0.382352941176471
Control.SRR15539824;44;40;0.5;22;22;0;0.5
Control.SRR15539824;41;40;0.536585365853659;19;22;0.0365853658536586;0.463414634146341
Control.SRR15539824;40;40;0.45;22;18;0.05;0.45
Control.SRR15539824;38;40;0.447368421052632;21;17;0.0526315789473684;0.447368421052632
Control.SRR15539824;36;40;0.5;18;18;0;0.5
Control.SRR15539824;43;40;0.465116279069767;23;20;0.0348837209302326;0.465116279069767
Control.SRR15539824;40;40;0.4;24;16;0.1;0.4
Control.SRR15539824;43;40;0.418604651162791;25;18;0.0813953488372093;0.418604651162791
Control.SRR15539824;44;40;0.590909090909091;18;26;0.0909090909090909;0.409090909090909
Control.SRR15539824;41;40;0.439024390243902;23;18;0.0609756097560976;0.439024390243902
Control.SRR15539824;37;40;0.378378378378378;23;14;0.121621621621622;0.378378378378378
Control.SRR15539824;43;40;0.604651162790698;17;26;0.104651162790698;0.395348837209302
Control.SRR15539824;39;40;0.358974358974359;25;14;0.141025641025641;0.358974358974359
Control.SRR15539824;34;40;0.558823529411765;15;19;0.0588235294117647;0.441176470588235
Control.SRR15539824;40;40;0.475;21;19;0.025;0.475
Control.SRR15539824;41;40;0.585365853658537;17;24;0.0853658536585366;0.414634146341463
Control.SRR15539824;38;40;0.552631578947368;17;21;0.0526315789473685;0.447368421052632
Control.SRR15539824;34;40;0.5;17;17;0;0.5
Control.SRR15539824;35;40;0.485714285714286;18;17;0.0142857142857143;0.485714285714286
Control.SRR15539824;36;40;0.444444444444444;20;16;0.0555555555555556;0.444444444444444
Control.SRR15539824;36;40;0.361111111111111;23;13;0.138888888888889;0.361111111111111
Control.SRR15539824;41;40;0.341463414634146;27;14;0.158536585365854;0.341463414634146
Control.SRR15539824;36;40;0.444444444444444;20;16;0.0555555555555556;0.444444444444444
Control.SRR15539824;34;40;0.529411764705882;16;18;0.0294117647058824;0.470588235294118
Control.SRR15539824;37;40;0.513513513513513;18;19;0.0135135135135135;0.486486486486487
Control.SRR15539824;42;40;0.476190476190476;22;20;0.0238095238095238;0.476190476190476
Control.SRR15539824;42;40;0.428571428571429;24;18;0.0714285714285715;0.428571428571429
Control.SRR15539824;35;40;0.514285714285714;17;18;0.0142857142857142;0.485714285714286
Control.SRR15539824;42;40;0.452380952380952;23;19;0.0476190476190476;0.452380952380952
Control.SRR15539824;35;40;0.628571428571429;13;22;0.128571428571429;0.371428571428571
Control.SRR15539824;44;40;0.409090909090909;26;18;0.0909090909090909;0.409090909090909
Control.SRR15539824;41;40;0.585365853658537;17;24;0.0853658536585366;0.414634146341463
Control.SRR15539824;42;40;0.69047619047619;13;29;0.19047619047619;0.30952380952381
Control.SRR15539824;42;40;0.5;21;21;0;0.5
Control.SRR15539824;41;40;0.463414634146341;22;19;0.0365853658536585;0.463414634146341
Control.SRR15539824;35;40;0.485714285714286;18;17;0.0142857142857143;0.485714285714286
Control.SRR15539824;35;40;0.485714285714286;18;17;0.0142857142857143;0.485714285714286
Control.SRR15539824;35;40;0.628571428571429;13;22;0.128571428571429;0.371428571428571
Control.SRR15539824;35;40;0.657142857142857;12;23;0.157142857142857;0.342857142857143
Control.SRR15539824;44;40;0.431818181818182;25;19;0.0681818181818182;0.431818181818182
Control.SRR15539824;35;40;0.428571428571429;20;15;0.0714285714285715;0.428571428571429
Control.SRR15539824;39;40;0.615384615384615;15;24;0.115384615384615;0.384615384615385
Control.SRR15539824;38;40;0.526315789473684;18;20;0.0263157894736842;0.473684210526316
Control.SRR15539824;39;40;0.564102564102564;17;22;0.0641025641025641;0.435897435897436
Control.SRR15539824;41;40;0.536585365853659;19;22;0.0365853658536586;0.463414634146341
Control.SRR15539824;34;40;0.5;17;17;0;0.5
Control.SRR15539824;38;40;0.631578947368421;14;24;0.131578947368421;0.368421052631579
Control.SRR15539824;44;40;0.5;22;22;0;0.5
Control.SRR15539824;35;40;0.514285714285714;17;18;0.0142857142857142;0.485714285714286
Control.SRR15539824;39;40;0.538461538461538;18;21;0.0384615384615384;0.461538461538462
Control.SRR15539824;35;40;0.514285714285714;17;18;0.0142857142857142;0.485714285714286
Control.SRR15539824;42;40;0.547619047619048;19;23;0.0476190476190477;0.452380952380952
Control.SRR15539824;40;40;0.55;18;22;0.05;0.45
Control.SRR15539824;44;40;0.409090909090909;26;18;0.0909090909090909;0.409090909090909
Control.SRR15539824;41;40;0.536585365853659;19;22;0.0365853658536586;0.463414634146341
Control.SRR15539824;38;40;0.342105263157895;25;13;0.157894736842105;0.342105263157895
Control.SRR15539824;39;40;0.435897435897436;22;17;0.0641025641025641;0.435897435897436
Control.SRR15539824;43;40;0.581395348837209;18;25;0.0813953488372093;0.418604651162791
Control.SRR15539824;37;40;0.594594594594595;15;22;0.0945945945945946;0.405405405405405
Control.SRR15539824;41;40;0.317073170731707;28;13;0.182926829268293;0.317073170731707
Control.SRR15539824;36;40;0.416666666666667;21;15;0.0833333333333333;0.416666666666667
Control.SRR15539824;44;40;0.431818181818182;25;19;0.0681818181818182;0.431818181818182
Control.SRR15539824;44;40;0.522727272727273;21;23;0.0227272727272727;0.477272727272727
Control.SRR15539824;35;40;0.542857142857143;16;19;0.0428571428571428;0.457142857142857
Control.SRR15539824;37;40;0.378378378378378;23;14;0.121621621621622;0.378378378378378
Control.SRR15539824;43;40;0.488372093023256;22;21;0.0116279069767442;0.488372093023256
Control.SRR15539824;37;40;0.405405405405405;22;15;0.0945945945945946;0.405405405405405
Control.SRR15539824;42;40;0.547619047619048;19;23;0.0476190476190477;0.452380952380952
Control.SRR15539824;39;40;0.41025641025641;23;16;0.0897435897435898;0.41025641025641
Control.SRR15539824;43;40;0.441860465116279;24;19;0.0581395348837209;0.441860465116279
Control.SRR15539824;44;40;0.454545454545455;24;20;0.0454545454545455;0.454545454545455
Control.SRR15539824;36;40;0.527777777777778;17;19;0.0277777777777778;0.472222222222222
Control.SRR15539824;35;40;0.428571428571429;20;15;0.0714285714285715;0.428571428571429
Control.SRR15539824;38;40;0.5;19;19;0;0.5
Control.SRR15539824;43;40;0.465116279069767;23;20;0.0348837209302326;0.465116279069767
Control.SRR15539824;38;40;0.578947368421053;16;22;0.0789473684210527;0.421052631578947
Control.SRR15539824;42;40;0.595238095238095;17;25;0.0952380952380952;0.404761904761905
Control.SRR15539824;42;40;0.571428571428571;18;24;0.0714285714285714;0.428571428571429
Control.SRR15539824;37;40;0.648648648648649;13;24;0.148648648648649;0.351351351351351
Control.SRR15539824;35;40;0.571428571428571;15;20;0.0714285714285714;0.428571428571429
Control.SRR15539824;38;40;0.526315789473684;18;20;0.0263157894736842;0.473684210526316
Control.SRR15539824;41;40;0.560975609756098;18;23;0.0609756097560976;0.439024390243902
Control.SRR15539824;34;40;0.588235294117647;14;20;0.0882352941176471;0.411764705882353
Control.SRR15539824;37;40;0.432432432432432;21;16;0.0675675675675675;0.432432432432432
Control.SRR15539824;43;40;0.558139534883721;19;24;0.0581395348837209;0.441860465116279
Control.SRR15539824;38;40;0.5;19;19;0;0.5
Control.SRR15539824;40;40;0.275;29;11;0.225;0.275
Control.SRR15539824;38;40;0.5;19;19;0;0.5
Control.SRR15539824;41;40;0.51219512195122;20;21;0.0121951219512195;0.48780487804878
Control.SRR15539824;43;40;0.488372093023256;22;21;0.0116279069767442;0.488372093023256
Control.SRR15539824;35;40;0.514285714285714;17;18;0.0142857142857142;0.485714285714286
Control.SRR15539824;36;40;0.527777777777778;17;19;0.0277777777777778;0.472222222222222
Control.SRR15539824;39;40;0.487179487179487;20;19;0.0128205128205128;0.487179487179487
Control.SRR15539824;40;40;0.7;12;28;0.2;0.3
Control.SRR15539824;44;40;0.477272727272727;23;21;0.0227272727272727;0.477272727272727
Control.SRR15539824;37;40;0.513513513513513;18;19;0.0135135135135135;0.486486486486487
Control.SRR15539824;35;40;0.457142857142857;19;16;0.0428571428571429;0.457142857142857
Control.SRR15539824;36;40;0.472222222222222;19;17;0.0277777777777778;0.472222222222222
Control.SRR15539824;43;40;0.488372093023256;22;21;0.0116279069767442;0.488372093023256
Control.SRR15539824;37;40;0.513513513513513;18;19;0.0135135135135135;0.486486486486487
Control.SRR15539824;41;40;0.48780487804878;21;20;0.0121951219512195;0.48780487804878
Control.SRR15539824;38;40;0.315789473684211;26;12;0.184210526315789;0.315789473684211
Control.SRR15539824;37;40;0.540540540540541;17;20;0.0405405405405406;0.459459459459459
Control.SRR15539824;35;40;0.628571428571429;13;22;0.128571428571429;0.371428571428571
Control.SRR15539824;35;40;0.542857142857143;16;19;0.0428571428571428;0.457142857142857
Control.SRR15539824;43;40;0.488372093023256;22;21;0.0116279069767442;0.488372093023256
Control.SRR15539824;35;40;0.485714285714286;18;17;0.0142857142857143;0.485714285714286
Control.SRR15539824;43;40;0.511627906976744;21;22;0.0116279069767442;0.488372093023256
Control.SRR15539824;43;40;0.441860465116279;24;19;0.0581395348837209;0.441860465116279
Control.SRR15539824;44;40;0.545454545454545;20;24;0.0454545454545454;0.454545454545455
Control.SRR15539824;43;40;0.604651162790698;17;26;0.104651162790698;0.395348837209302
Control.SRR15539824;36;40;0.527777777777778;17;19;0.0277777777777778;0.472222222222222
Control.SRR15539824;43;40;0.465116279069767;23;20;0.0348837209302326;0.465116279069767
Control.SRR15539824;36;40;0.416666666666667;21;15;0.0833333333333333;0.416666666666667
Control.SRR15539824;41;40;0.585365853658537;17;24;0.0853658536585366;0.414634146341463
Control.SRR15539824;42;40;0.523809523809524;20;22;0.0238095238095238;0.476190476190476
Control.SRR15539824;41;40;0.463414634146341;22;19;0.0365853658536585;0.463414634146341
Control.SRR15539824;44;40;0.431818181818182;25;19;0.0681818181818182;0.431818181818182
Control.SRR15539824;41;40;0.536585365853659;19;22;0.0365853658536586;0.463414634146341
Control.SRR15539824;39;40;0.384615384615385;24;15;0.115384615384615;0.384615384615385
Control.SRR15539824;42;40;0.476190476190476;22;20;0.0238095238095238;0.476190476190476
Control.SRR15539824;40;40;0.375;25;15;0.125;0.375
Control.SRR15539824;36;40;0.444444444444444;20;16;0.0555555555555556;0.444444444444444
Control.SRR15539824;43;40;0.604651162790698;17;26;0.104651162790698;0.395348837209302
Control.SRR15539824;38;40;0.578947368421053;16;22;0.0789473684210527;0.421052631578947
Control.SRR15539824;34;40;0.647058823529412;12;22;0.147058823529412;0.352941176470588
Control.SRR15539824;36;40;0.666666666666667;12;24;0.166666666666667;0.333333333333333
Control.SRR15539824;39;40;0.41025641025641;23;16;0.0897435897435898;0.41025641025641
Control.SRR15539824;37;40;0.540540540540541;17;20;0.0405405405405406;0.459459459459459
Control.SRR15539824;35;40;0.485714285714286;18;17;0.0142857142857143;0.485714285714286
Control.SRR15539824;35;40;0.485714285714286;18;17;0.0142857142857143;0.485714285714286
Control.SRR15539824;34;40;0.617647058823529;13;21;0.117647058823529;0.382352941176471
Control.SRR15539824;34;40;0.441176470588235;19;15;0.0588235294117647;0.441176470588235
Control.SRR15539824;39;40;0.41025641025641;23;16;0.0897435897435898;0.41025641025641
Control.SRR15539824;38;40;0.526315789473684;18;20;0.0263157894736842;0.473684210526316
Control.SRR15539824;40;40;0.35;26;14;0.15;0.35
Control.SRR15539824;41;40;0.414634146341463;24;17;0.0853658536585366;0.414634146341463
Control.SRR15539824;41;40;0.560975609756098;18;23;0.0609756097560976;0.439024390243902
Control.SRR15539824;39;40;0.435897435897436;22;17;0.0641025641025641;0.435897435897436
Control.SRR15539824;37;40;0.378378378378378;23;14;0.121621621621622;0.378378378378378
Control.SRR15539824;41;40;0.585365853658537;17;24;0.0853658536585366;0.414634146341463
Control.SRR15539824;42;40;0.476190476190476;22;20;0.0238095238095238;0.476190476190476
Control.SRR15539824;42;40;0.5;21;21;0;0.5
Control.SRR15539824;40;40;0.55;18;22;0.05;0.45
Control.SRR15539824;35;40;0.514285714285714;17;18;0.0142857142857142;0.485714285714286
Control.SRR15539824;41;40;0.51219512195122;20;21;0.0121951219512195;0.48780487804878
Control.SRR15539824;40;40;0.425;23;17;0.075;0.425
Control.SRR15539824;40;40;0.7;12;28;0.2;0.3
Control.SRR15539824;36;40;0.527777777777778;17;19;0.0277777777777778;0.472222222222222
Control.SRR15539824;40;40;0.55;18;22;0.05;0.45
Control.SRR15539824;38;40;0.526315789473684;18;20;0.0263157894736842;0.473684210526316
Control.SRR15539824;35;40;0.457142857142857;19;16;0.0428571428571429;0.457142857142857
Control.SRR15539824;34;40;0.588235294117647;14;20;0.0882352941176471;0.411764705882353
Control.SRR15539824;42;40;0.523809523809524;20;22;0.0238095238095238;0.476190476190476
Control.SRR15539824;35;40;0.428571428571429;20;15;0.0714285714285715;0.428571428571429
Control.SRR15539824;39;40;0.564102564102564;17;22;0.0641025641025641;0.435897435897436
Control.SRR15539824;43;40;0.465116279069767;23;20;0.0348837209302326;0.465116279069767
Control.SRR15539824;43;40;0.418604651162791;25;18;0.0813953488372093;0.418604651162791
Control.SRR15539824;43;40;0.534883720930233;20;23;0.0348837209302325;0.465116279069767
Control.SRR15539824;43;40;0.488372093023256;22;21;0.0116279069767442;0.488372093023256
Control.SRR15539824;42;40;0.476190476190476;22;20;0.0238095238095238;0.476190476190476
Control.SRR15539824;42;40;0.571428571428571;18;24;0.0714285714285714;0.428571428571429
Control.SRR15539824;38;40;0.5;19;19;0;0.5
Control.SRR15539824;36;40;0.472222222222222;19;17;0.0277777777777778;0.472222222222222
Control.SRR15539824;37;40;0.459459459459459;20;17;0.0405405405405405;0.459459459459459
Control.SRR15539824;35;40;0.457142857142857;19;16;0.0428571428571429;0.457142857142857
Control.SRR15539824;40;40;0.375;25;15;0.125;0.375
Control.SRR15539824;44;40;0.545454545454545;20;24;0.0454545454545454;0.454545454545455
Control.SRR15539824;34;40;0.558823529411765;15;19;0.0588235294117647;0.441176470588235
Control.SRR15539824;37;40;0.513513513513513;18;19;0.0135135135135135;0.486486486486487
Control.SRR15539824;38;40;0.578947368421053;16;22;0.0789473684210527;0.421052631578947
Control.SRR15539824;35;40;0.514285714285714;17;18;0.0142857142857142;0.485714285714286
Control.SRR15539824;42;40;0.452380952380952;23;19;0.0476190476190476;0.452380952380952
Control.SRR15539824;40;40;0.4;24;16;0.1;0.4
Control.SRR15539824;44;40;0.590909090909091;18;26;0.0909090909090909;0.409090909090909
Control.SRR15539824;34;40;0.441176470588235;19;15;0.0588235294117647;0.441176470588235
Control.SRR15539824;36;40;0.555555555555556;16;20;0.0555555555555556;0.444444444444444
Control.SRR15539824;42;40;0.476190476190476;22;20;0.0238095238095238;0.476190476190476
Control.SRR15539824;44;40;0.568181818181818;19;25;0.0681818181818182;0.431818181818182
Control.SRR15539824;42;40;0.523809523809524;20;22;0.0238095238095238;0.476190476190476
Control.SRR15539824;35;40;0.571428571428571;15;20;0.0714285714285714;0.428571428571429
Control.SRR15539824;36;40;0.388888888888889;22;14;0.111111111111111;0.388888888888889
Control.SRR15539824;44;40;0.431818181818182;25;19;0.0681818181818182;0.431818181818182
Control.SRR15539824;39;40;0.435897435897436;22;17;0.0641025641025641;0.435897435897436
Control.SRR15539824;38;40;0.552631578947368;17;21;0.0526315789473685;0.447368421052632
Control.SRR15539824;39;40;0.58974358974359;16;23;0.0897435897435898;0.41025641025641
Control.SRR15539824;35;40;0.485714285714286;18;17;0.0142857142857143;0.485714285714286
Control.SRR15539824;44;40;0.477272727272727;23;21;0.0227272727272727;0.477272727272727
Control.SRR15539824;43;40;0.441860465116279;24;19;0.0581395348837209;0.441860465116279
Control.SRR15539824;38;40;0.605263157894737;15;23;0.105263157894737;0.394736842105263
Control.SRR15539824;36;40;0.444444444444444;20;16;0.0555555555555556;0.444444444444444
Control.SRR15539824;44;40;0.522727272727273;21;23;0.0227272727272727;0.477272727272727
Control.SRR15539824;38;40;0.552631578947368;17;21;0.0526315789473685;0.447368421052632
Control.SRR15539824;37;40;0.513513513513513;18;19;0.0135135135135135;0.486486486486487
Control.SRR15539824;35;40;0.428571428571429;20;15;0.0714285714285715;0.428571428571429
Control.SRR15539824;40;40;0.475;21;19;0.025;0.475
Control.SRR15539824;37;40;0.486486486486487;19;18;0.0135135135135135;0.486486486486487
Control.SRR15539824;34;40;0.647058823529412;12;22;0.147058823529412;0.352941176470588
Control.SRR15539824;41;40;0.634146341463415;15;26;0.134146341463415;0.365853658536585
Control.SRR15539824;40;40;0.575;17;23;0.075;0.425
Control.SRR15539824;40;40;0.4;24;16;0.1;0.4
Control.SRR15539824;42;40;0.547619047619048;19;23;0.0476190476190477;0.452380952380952
Control.SRR15539824;38;40;0.5;19;19;0;0.5
Control.SRR15539824;40;40;0.45;22;18;0.05;0.45
Control.SRR15539824;34;40;0.470588235294118;18;16;0.0294117647058824;0.470588235294118
Control.SRR15539824;37;40;0.459459459459459;20;17;0.0405405405405405;0.459459459459459
Control.SRR15539824;36;40;0.444444444444444;20;16;0.0555555555555556;0.444444444444444
Control.SRR15539824;35;40;0.685714285714286;11;24;0.185714285714286;0.314285714285714
Control.SRR15539824;42;40;0.523809523809524;20;22;0.0238095238095238;0.476190476190476
Control.SRR15539824;39;40;0.538461538461538;18;21;0.0384615384615384;0.461538461538462
Control.SRR15539824;39;40;0.435897435897436;22;17;0.0641025641025641;0.435897435897436
Control.SRR15539824;38;40;0.473684210526316;20;18;0.0263157894736842;0.473684210526316
Control.SRR15539824;38;40;0.552631578947368;17;21;0.0526315789473685;0.447368421052632
Control.SRR15539824;36;40;0.472222222222222;19;17;0.0277777777777778;0.472222222222222
Control.SRR15539824;37;40;0.351351351351351;24;13;0.148648648648649;0.351351351351351
Control.SRR15539824;42;40;0.476190476190476;22;20;0.0238095238095238;0.476190476190476
Control.SRR15539824;38;40;0.578947368421053;16;22;0.0789473684210527;0.421052631578947
Control.SRR15539824;35;40;0.314285714285714;24;11;0.185714285714286;0.314285714285714
Control.SRR15539824;34;40;0.647058823529412;12;22;0.147058823529412;0.352941176470588
Control.SRR15539824;44;40;0.431818181818182;25;19;0.0681818181818182;0.431818181818182
Control.SRR15539824;36;40;0.444444444444444;20;16;0.0555555555555556;0.444444444444444
Control.SRR15539824;37;40;0.432432432432432;21;16;0.0675675675675675;0.432432432432432
Control.SRR15539824;36;40;0.416666666666667;21;15;0.0833333333333333;0.416666666666667
Control.SRR15539824;38;40;0.421052631578947;22;16;0.0789473684210527;0.421052631578947
Control.SRR15539824;35;40;0.371428571428571;22;13;0.128571428571429;0.371428571428571
Control.SRR15539824;37;40;0.378378378378378;23;14;0.121621621621622;0.378378378378378
Control.SRR15539824;38;40;0.5;19;19;0;0.5
Control.SRR15539824;42;40;0.523809523809524;20;22;0.0238095238095238;0.476190476190476
Control.SRR15539824;39;40;0.564102564102564;17;22;0.0641025641025641;0.435897435897436
Control.SRR15539824;39;40;0.538461538461538;18;21;0.0384615384615384;0.461538461538462
Control.SRR15539824;38;40;0.394736842105263;23;15;0.105263157894737;0.394736842105263
Control.SRR15539824;39;40;0.58974358974359;16;23;0.0897435897435898;0.41025641025641
Control.SRR15539824;38;40;0.5;19;19;0;0.5
Control.SRR15539824;36;40;0.638888888888889;13;23;0.138888888888889;0.361111111111111
Control.SRR15539824;41;40;0.51219512195122;20;21;0.0121951219512195;0.48780487804878
Control.SRR15539824;39;40;0.41025641025641;23;16;0.0897435897435898;0.41025641025641
Control.SRR15539824;37;40;0.459459459459459;20;17;0.0405405405405405;0.459459459459459
Control.SRR15539824;38;40;0.394736842105263;23;15;0.105263157894737;0.394736842105263
Control.SRR15539824;36;40;0.472222222222222;19;17;0.0277777777777778;0.472222222222222
Control.SRR15539824;37;40;0.513513513513513;18;19;0.0135135135135135;0.486486486486487
Control.SRR15539824;42;40;0.523809523809524;20;22;0.0238095238095238;0.476190476190476
Control.SRR15539824;43;40;0.302325581395349;30;13;0.197674418604651;0.302325581395349
Control.SRR15539824;43;40;0.441860465116279;24;19;0.0581395348837209;0.441860465116279
Control.SRR15539824;35;40;0.514285714285714;17;18;0.0142857142857142;0.485714285714286
Control.SRR15539824;41;40;0.439024390243902;23;18;0.0609756097560976;0.439024390243902
Control.SRR15539824;38;40;0.526315789473684;18;20;0.0263157894736842;0.473684210526316
Control.SRR15539824;40;40;0.5;20;20;0;0.5
Control.SRR15539824;44;40;0.545454545454545;20;24;0.0454545454545454;0.454545454545455
Control.SRR15539824;43;40;0.465116279069767;23;20;0.0348837209302326;0.465116279069767
Control.SRR15539824;39;40;0.641025641025641;14;25;0.141025641025641;0.358974358974359
Control.SRR15539824;37;40;0.351351351351351;24;13;0.148648648648649;0.351351351351351
Control.SRR15539824;38;40;0.605263157894737;15;23;0.105263157894737;0.394736842105263
Control.SRR15539824;38;40;0.5;19;19;0;0.5
Control.SRR15539824;44;40;0.522727272727273;21;23;0.0227272727272727;0.477272727272727
Control.SRR15539824;34;40;0.617647058823529;13;21;0.117647058823529;0.382352941176471
Control.SRR15539824;36;40;0.555555555555556;16;20;0.0555555555555556;0.444444444444444
Control.SRR15539824;35;40;0.342857142857143;23;12;0.157142857142857;0.342857142857143
Control.SRR15539824;38;40;0.578947368421053;16;22;0.0789473684210527;0.421052631578947
Control.SRR15539824;38;40;0.5;19;19;0;0.5
Control.SRR15539824;36;40;0.666666666666667;12;24;0.166666666666667;0.333333333333333
Control.SRR15539824;39;40;0.512820512820513;19;20;0.0128205128205128;0.487179487179487
Control.SRR15539824;43;40;0.534883720930233;20;23;0.0348837209302325;0.465116279069767
Control.SRR15539824;36;40;0.555555555555556;16;20;0.0555555555555556;0.444444444444444
Control.SRR15539824;41;40;0.463414634146341;22;19;0.0365853658536585;0.463414634146341
Control.SRR15539824;39;40;0.41025641025641;23;16;0.0897435897435898;0.41025641025641
Control.SRR15539824;43;40;0.534883720930233;20;23;0.0348837209302325;0.465116279069767
Control.SRR15539824;39;40;0.512820512820513;19;20;0.0128205128205128;0.487179487179487
Control.SRR15539824;35;40;0.428571428571429;20;15;0.0714285714285715;0.428571428571429
Control.SRR15539824;34;40;0.617647058823529;13;21;0.117647058823529;0.382352941176471
Control.SRR15539824;39;40;0.461538461538462;21;18;0.0384615384615384;0.461538461538462
Control.SRR15539824;36;40;0.388888888888889;22;14;0.111111111111111;0.388888888888889
Control.SRR15539824;38;40;0.473684210526316;20;18;0.0263157894736842;0.473684210526316
Control.SRR15539824;37;40;0.432432432432432;21;16;0.0675675675675675;0.432432432432432
Control.SRR15539824;34;40;0.441176470588235;19;15;0.0588235294117647;0.441176470588235
Control.SRR15539824;43;40;0.418604651162791;25;18;0.0813953488372093;0.418604651162791
Control.SRR15539824;42;40;0.714285714285714;12;30;0.214285714285714;0.285714285714286
Control.SRR15539824;38;40;0.447368421052632;21;17;0.0526315789473684;0.447368421052632
Control.SRR15539824;38;40;0.342105263157895;25;13;0.157894736842105;0.342105263157895
Control.SRR15539824;37;40;0.594594594594595;15;22;0.0945945945945946;0.405405405405405
Control.SRR15539824;39;40;0.564102564102564;17;22;0.0641025641025641;0.435897435897436
Control.SRR15539824;39;40;0.564102564102564;17;22;0.0641025641025641;0.435897435897436
Control.SRR15539824;36;40;0.583333333333333;15;21;0.0833333333333334;0.416666666666667
Control.SRR15539824;41;40;0.51219512195122;20;21;0.0121951219512195;0.48780487804878
Control.SRR15539824;38;40;0.578947368421053;16;22;0.0789473684210527;0.421052631578947
Control.SRR15539824;40;40;0.4;24;16;0.1;0.4
Control.SRR15539824;44;40;0.454545454545455;24;20;0.0454545454545455;0.454545454545455
Control.SRR15539824;38;40;0.605263157894737;15;23;0.105263157894737;0.394736842105263
Control.SRR15539824;40;40;0.525;19;21;0.025;0.475
Control.SRR15539824;36;40;0.583333333333333;15;21;0.0833333333333334;0.416666666666667
Control.SRR15539824;34;40;0.588235294117647;14;20;0.0882352941176471;0.411764705882353
Control.SRR15539824;34;40;0.5;17;17;0;0.5
Control.SRR15539824;40;40;0.35;26;14;0.15;0.35
Control.SRR15539824;41;40;0.439024390243902;23;18;0.0609756097560976;0.439024390243902
Control.SRR15539824;44;40;0.431818181818182;25;19;0.0681818181818182;0.431818181818182
Control.SRR15539824;36;40;0.444444444444444;20;16;0.0555555555555556;0.444444444444444
Control.SRR15539824;39;40;0.666666666666667;13;26;0.166666666666667;0.333333333333333
Control.SRR15539824;36;40;0.444444444444444;20;16;0.0555555555555556;0.444444444444444
Control.SRR15539824;35;40;0.657142857142857;12;23;0.157142857142857;0.342857142857143
Control.SRR15539824;34;40;0.382352941176471;21;13;0.117647058823529;0.382352941176471
Control.SRR15539824;40;40;0.525;19;21;0.025;0.475
Control.SRR15539824;34;40;0.5;17;17;0;0.5
Control.SRR15539824;40;40;0.475;21;19;0.025;0.475
Control.SRR15539824;42;40;0.571428571428571;18;24;0.0714285714285714;0.428571428571429
Control.SRR15539824;36;40;0.5;18;18;0;0.5
Control.SRR15539824;37;40;0.540540540540541;17;20;0.0405405405405406;0.459459459459459
Control.SRR15539824;35;40;0.4;21;14;0.1;0.4
Control.SRR15539824;41;40;0.536585365853659;19;22;0.0365853658536586;0.463414634146341
Control.SRR15539824;35;40;0.4;21;14;0.1;0.4
Control.SRR15539824;43;40;0.488372093023256;22;21;0.0116279069767442;0.488372093023256
Control.SRR15539824;39;40;0.58974358974359;16;23;0.0897435897435898;0.41025641025641
Control.SRR15539824;42;40;0.619047619047619;16;26;0.119047619047619;0.380952380952381
Control.SRR15539824;41;40;0.463414634146341;22;19;0.0365853658536585;0.463414634146341
Control.SRR15539824;44;40;0.409090909090909;26;18;0.0909090909090909;0.409090909090909
Control.SRR15539824;34;40;0.588235294117647;14;20;0.0882352941176471;0.411764705882353
Control.SRR15539824;41;40;0.439024390243902;23;18;0.0609756097560976;0.439024390243902
Control.SRR15539824;36;40;0.5;18;18;0;0.5
Control.SRR15539824;40;40;0.45;22;18;0.05;0.45
Control.SRR15539824;41;40;0.560975609756098;18;23;0.0609756097560976;0.439024390243902
Control.SRR15539824;44;40;0.522727272727273;21;23;0.0227272727272727;0.477272727272727
Control.SRR15539824;38;40;0.552631578947368;17;21;0.0526315789473685;0.447368421052632
Control.SRR15539824;42;40;0.404761904761905;25;17;0.0952380952380952;0.404761904761905
Control.SRR15539824;41;40;0.463414634146341;22;19;0.0365853658536585;0.463414634146341
Control.SRR15539824;34;40;0.558823529411765;15;19;0.0588235294117647;0.441176470588235
Control.SRR15539824;38;40;0.447368421052632;21;17;0.0526315789473684;0.447368421052632
Control.SRR15539824;35;40;0.485714285714286;18;17;0.0142857142857143;0.485714285714286
Control.SRR15539824;37;40;0.540540540540541;17;20;0.0405405405405406;0.459459459459459
Control.SRR15539824;44;40;0.522727272727273;21;23;0.0227272727272727;0.477272727272727
Control.SRR15539824;43;40;0.395348837209302;26;17;0.104651162790698;0.395348837209302
Control.SRR15539824;40;40;0.375;25;15;0.125;0.375
Control.SRR15539824;34;40;0.382352941176471;21;13;0.117647058823529;0.382352941176471
Control.SRR15539824;38;40;0.5;19;19;0;0.5
Control.SRR15539824;36;40;0.361111111111111;23;13;0.138888888888889;0.361111111111111
Control.SRR15539824;40;40;0.525;19;21;0.025;0.475
Control.SRR15539824;39;40;0.538461538461538;18;21;0.0384615384615384;0.461538461538462
Control.SRR15539824;41;40;0.439024390243902;23;18;0.0609756097560976;0.439024390243902
Control.SRR15539824;38;40;0.473684210526316;20;18;0.0263157894736842;0.473684210526316
Control.SRR15539824;37;40;0.432432432432432;21;16;0.0675675675675675;0.432432432432432
Control.SRR15539824;38;40;0.447368421052632;21;17;0.0526315789473684;0.447368421052632
Control.SRR15539824;35;40;0.514285714285714;17;18;0.0142857142857142;0.485714285714286
Control.SRR15539824;41;40;0.463414634146341;22;19;0.0365853658536585;0.463414634146341
Control.SRR15539824;36;40;0.416666666666667;21;15;0.0833333333333333;0.416666666666667
Control.SRR15539824;34;40;0.5;17;17;0;0.5
Control.SRR15539824;35;40;0.542857142857143;16;19;0.0428571428571428;0.457142857142857
Control.SRR15539824;34;40;0.470588235294118;18;16;0.0294117647058824;0.470588235294118
Control.SRR15539824;37;40;0.567567567567568;16;21;0.0675675675675675;0.432432432432432
Control.SRR15539824;35;40;0.371428571428571;22;13;0.128571428571429;0.371428571428571
Control.SRR15539824;34;40;0.529411764705882;16;18;0.0294117647058824;0.470588235294118
Control.SRR15539824;34;40;0.558823529411765;15;19;0.0588235294117647;0.441176470588235
Control.SRR15539824;37;40;0.567567567567568;16;21;0.0675675675675675;0.432432432432432
Control.SRR15539824;34;40;0.529411764705882;16;18;0.0294117647058824;0.470588235294118
Control.SRR15539824;39;40;0.692307692307692;12;27;0.192307692307692;0.307692307692308
Control.SRR15539824;40;40;0.475;21;19;0.025;0.475
Control.SRR15539824;40;40;0.525;19;21;0.025;0.475
Control.SRR15539824;42;40;0.476190476190476;22;20;0.0238095238095238;0.476190476190476
Control.SRR15539824;39;40;0.512820512820513;19;20;0.0128205128205128;0.487179487179487
Control.SRR15539824;40;40;0.425;23;17;0.075;0.425
Control.SRR15539824;35;40;0.542857142857143;16;19;0.0428571428571428;0.457142857142857
Control.SRR15539824;34;40;0.352941176470588;22;12;0.147058823529412;0.352941176470588
Control.SRR15539824;37;40;0.486486486486487;19;18;0.0135135135135135;0.486486486486487
Control.SRR15539824;39;40;0.435897435897436;22;17;0.0641025641025641;0.435897435897436
Control.SRR15539824;42;40;0.404761904761905;25;17;0.0952380952380952;0.404761904761905
Control.SRR15539824;42;40;0.452380952380952;23;19;0.0476190476190476;0.452380952380952
Control.SRR15539824;36;40;0.416666666666667;21;15;0.0833333333333333;0.416666666666667
Control.SRR15539824;35;40;0.457142857142857;19;16;0.0428571428571429;0.457142857142857
Control.SRR15539824;42;40;0.619047619047619;16;26;0.119047619047619;0.380952380952381
Control.SRR15539824;37;40;0.513513513513513;18;19;0.0135135135135135;0.486486486486487
Control.SRR15539824;36;40;0.555555555555556;16;20;0.0555555555555556;0.444444444444444
Control.SRR15539824;40;40;0.475;21;19;0.025;0.475
Control.SRR15539824;43;40;0.372093023255814;27;16;0.127906976744186;0.372093023255814
Control.SRR15539824;41;40;0.439024390243902;23;18;0.0609756097560976;0.439024390243902
Control.SRR15539824;43;40;0.488372093023256;22;21;0.0116279069767442;0.488372093023256
Control.SRR15539824;40;40;0.625;15;25;0.125;0.375
Control.SRR15539824;43;40;0.418604651162791;25;18;0.0813953488372093;0.418604651162791
Control.SRR15539824;35;40;0.542857142857143;16;19;0.0428571428571428;0.457142857142857
Control.SRR15539824;35;40;0.485714285714286;18;17;0.0142857142857143;0.485714285714286
Control.SRR15539824;38;40;0.421052631578947;22;16;0.0789473684210527;0.421052631578947
Control.SRR15539824;43;40;0.441860465116279;24;19;0.0581395348837209;0.441860465116279
Control.SRR15539824;44;40;0.477272727272727;23;21;0.0227272727272727;0.477272727272727
Control.SRR15539824;42;40;0.476190476190476;22;20;0.0238095238095238;0.476190476190476
Control.SRR15539824;40;40;0.625;15;25;0.125;0.375
Control.SRR15539824;43;40;0.325581395348837;29;14;0.174418604651163;0.325581395348837
Control.SRR15539824;39;40;0.358974358974359;25;14;0.141025641025641;0.358974358974359
Control.SRR15539824;42;40;0.476190476190476;22;20;0.0238095238095238;0.476190476190476
Control.SRR15539824;39;40;0.538461538461538;18;21;0.0384615384615384;0.461538461538462
Control.SRR15539824;39;40;0.461538461538462;21;18;0.0384615384615384;0.461538461538462
Control.SRR15539824;38;40;0.394736842105263;23;15;0.105263157894737;0.394736842105263
Control.SRR15539824;39;40;0.461538461538462;21;18;0.0384615384615384;0.461538461538462
Control.SRR15539824;36;40;0.416666666666667;21;15;0.0833333333333333;0.416666666666667
Control.SRR15539824;39;40;0.358974358974359;25;14;0.141025641025641;0.358974358974359
Control.SRR15539824;41;40;0.48780487804878;21;20;0.0121951219512195;0.48780487804878
Control.SRR15539824;37;40;0.567567567567568;16;21;0.0675675675675675;0.432432432432432
Control.SRR15539824;39;40;0.641025641025641;14;25;0.141025641025641;0.358974358974359
Control.SRR15539824;36;40;0.638888888888889;13;23;0.138888888888889;0.361111111111111
Control.SRR15539824;34;40;0.411764705882353;20;14;0.0882352941176471;0.411764705882353
Control.SRR15539824;37;40;0.459459459459459;20;17;0.0405405405405405;0.459459459459459
Control.SRR15539824;37;40;0.540540540540541;17;20;0.0405405405405406;0.459459459459459
Control.SRR15539824;41;40;0.585365853658537;17;24;0.0853658536585366;0.414634146341463
Control.SRR15539824;43;40;0.465116279069767;23;20;0.0348837209302326;0.465116279069767
Control.SRR15539824;42;40;0.428571428571429;24;18;0.0714285714285715;0.428571428571429
Control.SRR15539824;35;40;0.457142857142857;19;16;0.0428571428571429;0.457142857142857
Control.SRR15539824;37;40;0.459459459459459;20;17;0.0405405405405405;0.459459459459459
Control.SRR15539824;41;40;0.536585365853659;19;22;0.0365853658536586;0.463414634146341
Control.SRR15539824;43;40;0.604651162790698;17;26;0.104651162790698;0.395348837209302
Control.SRR15539824;40;40;0.55;18;22;0.05;0.45
Control.SRR15539824;37;40;0.486486486486487;19;18;0.0135135135135135;0.486486486486487
Control.SRR15539824;42;40;0.619047619047619;16;26;0.119047619047619;0.380952380952381
Control.SRR15539824;43;40;0.604651162790698;17;26;0.104651162790698;0.395348837209302
Control.SRR15539824;41;40;0.707317073170732;12;29;0.207317073170732;0.292682926829268
Control.SRR15539824;35;40;0.485714285714286;18;17;0.0142857142857143;0.485714285714286
Control.SRR15539824;44;40;0.5;22;22;0;0.5
Control.SRR15539824;43;40;0.348837209302326;28;15;0.151162790697674;0.348837209302326
Control.SRR15539824;40;40;0.5;20;20;0;0.5
Control.SRR15539824;37;40;0.648648648648649;13;24;0.148648648648649;0.351351351351351
Control.SRR15539824;36;40;0.5;18;18;0;0.5
Control.SRR15539824;41;40;0.341463414634146;27;14;0.158536585365854;0.341463414634146
Control.SRR15539824;35;40;0.371428571428571;22;13;0.128571428571429;0.371428571428571
Control.SRR15539824;38;40;0.447368421052632;21;17;0.0526315789473684;0.447368421052632
Control.SRR15539824;40;40;0.475;21;19;0.025;0.475
Control.SRR15539824;40;40;0.375;25;15;0.125;0.375
Control.SRR15539824;35;40;0.571428571428571;15;20;0.0714285714285714;0.428571428571429
Control.SRR15539824;34;40;0.617647058823529;13;21;0.117647058823529;0.382352941176471
Control.SRR15539824;34;40;0.470588235294118;18;16;0.0294117647058824;0.470588235294118
Control.SRR15539824;34;40;0.352941176470588;22;12;0.147058823529412;0.352941176470588
Control.SRR15539824;44;40;0.454545454545455;24;20;0.0454545454545455;0.454545454545455
Control.SRR15539824;42;40;0.547619047619048;19;23;0.0476190476190477;0.452380952380952
Control.SRR15539824;40;40;0.575;17;23;0.075;0.425
Control.SRR15539824;39;40;0.435897435897436;22;17;0.0641025641025641;0.435897435897436
Control.SRR15539824;36;40;0.5;18;18;0;0.5
Control.SRR15539824;38;40;0.578947368421053;16;22;0.0789473684210527;0.421052631578947
Control.SRR15539824;43;40;0.534883720930233;20;23;0.0348837209302325;0.465116279069767
Control.SRR15539824;36;40;0.388888888888889;22;14;0.111111111111111;0.388888888888889
Control.SRR15539824;39;40;0.564102564102564;17;22;0.0641025641025641;0.435897435897436
Control.SRR15539824;35;40;0.542857142857143;16;19;0.0428571428571428;0.457142857142857
Control.SRR15539824;37;40;0.432432432432432;21;16;0.0675675675675675;0.432432432432432
Control.SRR15539824;41;40;0.439024390243902;23;18;0.0609756097560976;0.439024390243902
Control.SRR15539824;42;40;0.452380952380952;23;19;0.0476190476190476;0.452380952380952
Control.SRR15539824;40;40;0.4;24;16;0.1;0.4
Control.SRR15539824;34;40;0.5;17;17;0;0.5
Control.SRR15539824;39;40;0.41025641025641;23;16;0.0897435897435898;0.41025641025641
Control.SRR15539824;42;40;0.380952380952381;26;16;0.119047619047619;0.380952380952381
Control.SRR15539824;35;40;0.685714285714286;11;24;0.185714285714286;0.314285714285714
Control.SRR15539824;38;40;0.552631578947368;17;21;0.0526315789473685;0.447368421052632
Control.SRR15539824;39;40;0.487179487179487;20;19;0.0128205128205128;0.487179487179487
Control.SRR15539824;37;40;0.459459459459459;20;17;0.0405405405405405;0.459459459459459
Control.SRR15539824;40;40;0.7;12;28;0.2;0.3
Control.SRR15539824;34;40;0.5;17;17;0;0.5
Control.SRR15539824;42;40;0.238095238095238;32;10;0.261904761904762;0.238095238095238
Control.SRR15539824;36;40;0.5;18;18;0;0.5
Control.SRR15539824;36;40;0.5;18;18;0;0.5
Control.SRR15539824;41;40;0.463414634146341;22;19;0.0365853658536585;0.463414634146341
Control.SRR15539824;39;40;0.512820512820513;19;20;0.0128205128205128;0.487179487179487
Control.SRR15539824;44;40;0.590909090909091;18;26;0.0909090909090909;0.409090909090909
Control.SRR15539824;43;40;0.465116279069767;23;20;0.0348837209302326;0.465116279069767
Control.SRR15539824;42;40;0.523809523809524;20;22;0.0238095238095238;0.476190476190476
Control.SRR15539824;35;40;0.514285714285714;17;18;0.0142857142857142;0.485714285714286
Control.SRR15539824;40;40;0.55;18;22;0.05;0.45
Control.SRR15539824;35;40;0.514285714285714;17;18;0.0142857142857142;0.485714285714286
Control.SRR15539824;37;40;0.594594594594595;15;22;0.0945945945945946;0.405405405405405
Control.SRR15539824;34;40;0.647058823529412;12;22;0.147058823529412;0.352941176470588
Control.SRR15539824;35;40;0.571428571428571;15;20;0.0714285714285714;0.428571428571429
Control.SRR15539824;41;40;0.536585365853659;19;22;0.0365853658536586;0.463414634146341
Control.SRR15539824;42;40;0.571428571428571;18;24;0.0714285714285714;0.428571428571429
Control.SRR15539824;44;40;0.431818181818182;25;19;0.0681818181818182;0.431818181818182
Control.SRR15539824;38;40;0.394736842105263;23;15;0.105263157894737;0.394736842105263
Control.SRR15539824;34;40;0.470588235294118;18;16;0.0294117647058824;0.470588235294118
Control.SRR15539824;41;40;0.609756097560976;16;25;0.109756097560976;0.390243902439024
Control.SRR15539824;34;40;0.441176470588235;19;15;0.0588235294117647;0.441176470588235
Control.SRR15539824;38;40;0.473684210526316;20;18;0.0263157894736842;0.473684210526316
Control.SRR15539824;39;40;0.358974358974359;25;14;0.141025641025641;0.358974358974359
Control.SRR15539824;35;40;0.6;14;21;0.1;0.4
Control.SRR15539824;36;40;0.361111111111111;23;13;0.138888888888889;0.361111111111111
Control.SRR15539824;41;40;0.536585365853659;19;22;0.0365853658536586;0.463414634146341
Control.SRR15539824;34;40;0.617647058823529;13;21;0.117647058823529;0.382352941176471
Control.SRR15539824;40;40;0.45;22;18;0.05;0.45
Control.SRR15539824;39;40;0.512820512820513;19;20;0.0128205128205128;0.487179487179487
Control.SRR15539824;43;40;0.488372093023256;22;21;0.0116279069767442;0.488372093023256
Control.SRR15539824;37;40;0.675675675675676;12;25;0.175675675675676;0.324324324324324
Control.SRR15539824;39;40;0.461538461538462;21;18;0.0384615384615384;0.461538461538462
Control.SRR15539824;42;40;0.571428571428571;18;24;0.0714285714285714;0.428571428571429
Control.SRR15539824;36;40;0.611111111111111;14;22;0.111111111111111;0.388888888888889
Control.SRR15539824;38;40;0.447368421052632;21;17;0.0526315789473684;0.447368421052632
Control.SRR15539824;44;40;0.431818181818182;25;19;0.0681818181818182;0.431818181818182
Control.SRR15539824;36;40;0.361111111111111;23;13;0.138888888888889;0.361111111111111
Control.SRR15539824;34;40;0.411764705882353;20;14;0.0882352941176471;0.411764705882353
Control.SRR15539824;40;40;0.525;19;21;0.025;0.475
Control.SRR15539824;39;40;0.333333333333333;26;13;0.166666666666667;0.333333333333333
Control.SRR15539824;34;40;0.529411764705882;16;18;0.0294117647058824;0.470588235294118
Control.SRR15539824;35;40;0.657142857142857;12;23;0.157142857142857;0.342857142857143
Control.SRR15539824;35;40;0.457142857142857;19;16;0.0428571428571429;0.457142857142857
Control.SRR15539824;36;40;0.416666666666667;21;15;0.0833333333333333;0.416666666666667
Control.SRR15539824;34;40;0.529411764705882;16;18;0.0294117647058824;0.470588235294118
Control.SRR15539824;34;40;0.441176470588235;19;15;0.0588235294117647;0.441176470588235
Control.SRR15539824;43;40;0.604651162790698;17;26;0.104651162790698;0.395348837209302
Control.SRR15539824;40;40;0.475;21;19;0.025;0.475
Control.SRR15539824;39;40;0.58974358974359;16;23;0.0897435897435898;0.41025641025641
Control.SRR15539824;44;40;0.295454545454545;31;13;0.204545454545455;0.295454545454545
Control.SRR15539824;41;40;0.51219512195122;20;21;0.0121951219512195;0.48780487804878
Control.SRR15539824;42;40;0.452380952380952;23;19;0.0476190476190476;0.452380952380952
Control.SRR15539824;42;40;0.571428571428571;18;24;0.0714285714285714;0.428571428571429
Control.SRR15539824;38;40;0.315789473684211;26;12;0.184210526315789;0.315789473684211
Control.SRR15539824;38;40;0.421052631578947;22;16;0.0789473684210527;0.421052631578947
Control.SRR15539824;43;40;0.604651162790698;17;26;0.104651162790698;0.395348837209302
Control.SRR15539824;34;40;0.294117647058824;24;10;0.205882352941176;0.294117647058824
Control.SRR15539824;42;40;0.428571428571429;24;18;0.0714285714285715;0.428571428571429
Control.SRR15539824;37;40;0.405405405405405;22;15;0.0945945945945946;0.405405405405405
Control.SRR15539824;36;40;0.555555555555556;16;20;0.0555555555555556;0.444444444444444
Control.SRR15539824;42;40;0.523809523809524;20;22;0.0238095238095238;0.476190476190476
Control.SRR15539824;41;40;0.560975609756098;18;23;0.0609756097560976;0.439024390243902
Control.SRR15539824;35;40;0.485714285714286;18;17;0.0142857142857143;0.485714285714286
Control.SRR15539824;36;40;0.555555555555556;16;20;0.0555555555555556;0.444444444444444
Control.SRR15539824;40;40;0.5;20;20;0;0.5
Control.SRR15539824;42;40;0.547619047619048;19;23;0.0476190476190477;0.452380952380952
Control.SRR15539824;43;40;0.418604651162791;25;18;0.0813953488372093;0.418604651162791
Control.SRR15539824;43;40;0.395348837209302;26;17;0.104651162790698;0.395348837209302
Control.SRR15539824;43;40;0.441860465116279;24;19;0.0581395348837209;0.441860465116279
Control.SRR15539824;44;40;0.386363636363636;27;17;0.113636363636364;0.386363636363636
Control.SRR15539824;41;40;0.414634146341463;24;17;0.0853658536585366;0.414634146341463
Control.SRR15539824;43;40;0.558139534883721;19;24;0.0581395348837209;0.441860465116279
Control.SRR15539824;39;40;0.384615384615385;24;15;0.115384615384615;0.384615384615385
Control.SRR15539824;37;40;0.540540540540541;17;20;0.0405405405405406;0.459459459459459
Control.SRR15539824;40;40;0.45;22;18;0.05;0.45
Control.SRR15539824;37;40;0.621621621621622;14;23;0.121621621621622;0.378378378378378
Control.SRR15539824;40;40;0.45;22;18;0.05;0.45
Control.SRR15539824;34;40;0.529411764705882;16;18;0.0294117647058824;0.470588235294118
Control.SRR15539824;42;40;0.452380952380952;23;19;0.0476190476190476;0.452380952380952
Control.SRR15539824;42;40;0.571428571428571;18;24;0.0714285714285714;0.428571428571429
Control.SRR15539824;41;40;0.463414634146341;22;19;0.0365853658536585;0.463414634146341
Control.SRR15539824;41;40;0.439024390243902;23;18;0.0609756097560976;0.439024390243902
Control.SRR15539824;43;40;0.418604651162791;25;18;0.0813953488372093;0.418604651162791
Control.SRR15539824;38;40;0.473684210526316;20;18;0.0263157894736842;0.473684210526316
Control.SRR15539824;34;40;0.558823529411765;15;19;0.0588235294117647;0.441176470588235
Control.SRR15539824;34;40;0.5;17;17;0;0.5
Control.SRR15539824;43;40;0.581395348837209;18;25;0.0813953488372093;0.418604651162791
Control.SRR15539824;40;40;0.525;19;21;0.025;0.475
Control.SRR15539824;38;40;0.394736842105263;23;15;0.105263157894737;0.394736842105263
Control.SRR15539824;41;40;0.48780487804878;21;20;0.0121951219512195;0.48780487804878
Control.SRR15539824;44;40;0.454545454545455;24;20;0.0454545454545455;0.454545454545455
Control.SRR15539824;37;40;0.432432432432432;21;16;0.0675675675675675;0.432432432432432
Control.SRR15539824;34;40;0.470588235294118;18;16;0.0294117647058824;0.470588235294118
Control.SRR15539824;34;40;0.441176470588235;19;15;0.0588235294117647;0.441176470588235
Control.SRR15539824;35;40;0.485714285714286;18;17;0.0142857142857143;0.485714285714286
Control.SRR15539824;44;40;0.522727272727273;21;23;0.0227272727272727;0.477272727272727
Control.SRR15539824;39;40;0.564102564102564;17;22;0.0641025641025641;0.435897435897436
Control.SRR15539824;39;40;0.615384615384615;15;24;0.115384615384615;0.384615384615385
Control.SRR15539824;37;40;0.378378378378378;23;14;0.121621621621622;0.378378378378378
Control.SRR15539824;42;40;0.571428571428571;18;24;0.0714285714285714;0.428571428571429
Control.SRR15539824;37;40;0.513513513513513;18;19;0.0135135135135135;0.486486486486487
Control.SRR15539824;35;40;0.4;21;14;0.1;0.4
Control.SRR15539824;35;40;0.457142857142857;19;16;0.0428571428571429;0.457142857142857
Control.SRR15539824;35;40;0.485714285714286;18;17;0.0142857142857143;0.485714285714286
Control.SRR15539824;36;40;0.527777777777778;17;19;0.0277777777777778;0.472222222222222
Control.SRR15539824;38;40;0.526315789473684;18;20;0.0263157894736842;0.473684210526316
Control.SRR15539824;43;40;0.488372093023256;22;21;0.0116279069767442;0.488372093023256
Control.SRR15539824;35;40;0.542857142857143;16;19;0.0428571428571428;0.457142857142857
Control.SRR15539824;40;40;0.45;22;18;0.05;0.45
Control.SRR15539824;38;40;0.657894736842105;13;25;0.157894736842105;0.342105263157895
Control.SRR15539824;41;40;0.292682926829268;29;12;0.207317073170732;0.292682926829268
Control.SRR15539824;43;40;0.511627906976744;21;22;0.0116279069767442;0.488372093023256
Control.SRR15539824;42;40;0.357142857142857;27;15;0.142857142857143;0.357142857142857
Control.SRR15539824;42;40;0.619047619047619;16;26;0.119047619047619;0.380952380952381
Control.SRR15539824;39;40;0.41025641025641;23;16;0.0897435897435898;0.41025641025641
Control.SRR15539824;39;40;0.384615384615385;24;15;0.115384615384615;0.384615384615385
Control.SRR15539824;40;40;0.425;23;17;0.075;0.425
Control.SRR15539824;37;40;0.513513513513513;18;19;0.0135135135135135;0.486486486486487
Control.SRR15539824;43;40;0.627906976744186;16;27;0.127906976744186;0.372093023255814
Control.SRR15539824;42;40;0.452380952380952;23;19;0.0476190476190476;0.452380952380952
Control.SRR15539824;34;40;0.529411764705882;16;18;0.0294117647058824;0.470588235294118
Control.SRR15539824;41;40;0.48780487804878;21;20;0.0121951219512195;0.48780487804878
Control.SRR15539824;42;40;0.30952380952381;29;13;0.19047619047619;0.30952380952381
Control.SRR15539824;44;40;0.568181818181818;19;25;0.0681818181818182;0.431818181818182
Control.SRR15539824;35;40;0.457142857142857;19;16;0.0428571428571429;0.457142857142857
Control.SRR15539824;39;40;0.538461538461538;18;21;0.0384615384615384;0.461538461538462
Control.SRR15539824;35;40;0.428571428571429;20;15;0.0714285714285715;0.428571428571429
Control.SRR15539824;37;40;0.351351351351351;24;13;0.148648648648649;0.351351351351351
Control.SRR15539824;37;40;0.513513513513513;18;19;0.0135135135135135;0.486486486486487
Control.SRR15539824;38;40;0.368421052631579;24;14;0.131578947368421;0.368421052631579
Control.SRR15539824;38;40;0.736842105263158;10;28;0.236842105263158;0.263157894736842
Control.SRR15539824;40;40;0.525;19;21;0.025;0.475
Control.SRR15539824;37;40;0.594594594594595;15;22;0.0945945945945946;0.405405405405405
Control.SRR15539824;34;40;0.411764705882353;20;14;0.0882352941176471;0.411764705882353
Control.SRR15539824;43;40;0.418604651162791;25;18;0.0813953488372093;0.418604651162791
Control.SRR15539824;41;40;0.439024390243902;23;18;0.0609756097560976;0.439024390243902
Control.SRR15539824;39;40;0.512820512820513;19;20;0.0128205128205128;0.487179487179487
Control.SRR15539824;38;40;0.684210526315789;12;26;0.184210526315789;0.315789473684211
Control.SRR15539824;43;40;0.372093023255814;27;16;0.127906976744186;0.372093023255814
Control.SRR15539824;42;40;0.428571428571429;24;18;0.0714285714285715;0.428571428571429
Control.SRR15539824;35;40;0.542857142857143;16;19;0.0428571428571428;0.457142857142857
Control.SRR15539824;43;40;0.465116279069767;23;20;0.0348837209302326;0.465116279069767
Control.SRR15539824;39;40;0.461538461538462;21;18;0.0384615384615384;0.461538461538462
Control.SRR15539824;41;40;0.536585365853659;19;22;0.0365853658536586;0.463414634146341
Control.SRR15539824;35;40;0.514285714285714;17;18;0.0142857142857142;0.485714285714286
Control.SRR15539824;37;40;0.621621621621622;14;23;0.121621621621622;0.378378378378378
Control.SRR15539824;42;40;0.30952380952381;29;13;0.19047619047619;0.30952380952381
Control.SRR15539824;36;40;0.527777777777778;17;19;0.0277777777777778;0.472222222222222
Control.SRR15539824;39;40;0.564102564102564;17;22;0.0641025641025641;0.435897435897436
Control.SRR15539824;35;40;0.628571428571429;13;22;0.128571428571429;0.371428571428571
Control.SRR15539824;39;40;0.58974358974359;16;23;0.0897435897435898;0.41025641025641
Control.SRR15539824;44;40;0.386363636363636;27;17;0.113636363636364;0.386363636363636
Control.SRR15539824;39;40;0.487179487179487;20;19;0.0128205128205128;0.487179487179487
Control.SRR15539824;35;40;0.542857142857143;16;19;0.0428571428571428;0.457142857142857
Control.SRR15539824;35;40;0.371428571428571;22;13;0.128571428571429;0.371428571428571
Control.SRR15539824;37;40;0.540540540540541;17;20;0.0405405405405406;0.459459459459459
Control.SRR15539824;40;40;0.525;19;21;0.025;0.475
Control.SRR15539824;42;40;0.5;21;21;0;0.5
Control.SRR15539824;44;40;0.590909090909091;18;26;0.0909090909090909;0.409090909090909
Control.SRR15539824;42;40;0.380952380952381;26;16;0.119047619047619;0.380952380952381
Control.SRR15539824;35;40;0.571428571428571;15;20;0.0714285714285714;0.428571428571429
Control.SRR15539824;34;40;0.647058823529412;12;22;0.147058823529412;0.352941176470588
Control.SRR15539824;44;40;0.545454545454545;20;24;0.0454545454545454;0.454545454545455
Control.SRR15539824;41;40;0.609756097560976;16;25;0.109756097560976;0.390243902439024
Control.SRR15539824;38;40;0.421052631578947;22;16;0.0789473684210527;0.421052631578947
Control.SRR15539824;34;40;0.558823529411765;15;19;0.0588235294117647;0.441176470588235
Control.SRR15539824;40;40;0.55;18;22;0.05;0.45
Control.SRR15539824;43;40;0.511627906976744;21;22;0.0116279069767442;0.488372093023256
Control.SRR15539824;35;40;0.485714285714286;18;17;0.0142857142857143;0.485714285714286
Control.SRR15539824;36;40;0.472222222222222;19;17;0.0277777777777778;0.472222222222222
Control.SRR15539824;36;40;0.472222222222222;19;17;0.0277777777777778;0.472222222222222
Control.SRR15539824;35;40;0.485714285714286;18;17;0.0142857142857143;0.485714285714286
Control.SRR15539824;34;40;0.441176470588235;19;15;0.0588235294117647;0.441176470588235
Control.SRR15539824;39;40;0.641025641025641;14;25;0.141025641025641;0.358974358974359
Control.SRR15539824;40;40;0.575;17;23;0.075;0.425
Control.SRR15539824;41;40;0.536585365853659;19;22;0.0365853658536586;0.463414634146341
Control.SRR15539824;40;40;0.5;20;20;0;0.5
Control.SRR15539824;44;40;0.409090909090909;26;18;0.0909090909090909;0.409090909090909
Control.SRR15539824;43;40;0.441860465116279;24;19;0.0581395348837209;0.441860465116279
Control.SRR15539824;40;40;0.6;16;24;0.1;0.4
Control.SRR15539824;40;40;0.55;18;22;0.05;0.45
Control.SRR15539824;41;40;0.585365853658537;17;24;0.0853658536585366;0.414634146341463
Control.SRR15539824;35;40;0.457142857142857;19;16;0.0428571428571429;0.457142857142857
Control.SRR15539824;34;40;0.294117647058824;24;10;0.205882352941176;0.294117647058824
Control.SRR15539824;38;40;0.421052631578947;22;16;0.0789473684210527;0.421052631578947
Control.SRR15539824;40;40;0.55;18;22;0.05;0.45
Control.SRR15539824;36;40;0.527777777777778;17;19;0.0277777777777778;0.472222222222222
Control.SRR15539824;43;40;0.534883720930233;20;23;0.0348837209302325;0.465116279069767
Control.SRR15539824;36;40;0.611111111111111;14;22;0.111111111111111;0.388888888888889
Control.SRR15539824;42;40;0.380952380952381;26;16;0.119047619047619;0.380952380952381
Control.SRR15539824;43;40;0.558139534883721;19;24;0.0581395348837209;0.441860465116279
Control.SRR15539824;42;40;0.404761904761905;25;17;0.0952380952380952;0.404761904761905
Control.SRR15539824;36;40;0.361111111111111;23;13;0.138888888888889;0.361111111111111
Control.SRR15539824;42;40;0.428571428571429;24;18;0.0714285714285715;0.428571428571429
Control.SRR15539824;37;40;0.567567567567568;16;21;0.0675675675675675;0.432432432432432
Control.SRR15539824;37;40;0.486486486486487;19;18;0.0135135135135135;0.486486486486487
Control.SRR15539824;44;40;0.568181818181818;19;25;0.0681818181818182;0.431818181818182
Control.SRR15539824;41;40;0.609756097560976;16;25;0.109756097560976;0.390243902439024
Control.SRR15539824;40;40;0.5;20;20;0;0.5
Control.SRR15539824;35;40;0.514285714285714;17;18;0.0142857142857142;0.485714285714286
Control.SRR15539824;41;40;0.390243902439024;25;16;0.109756097560976;0.390243902439024
Control.SRR15539824;37;40;0.378378378378378;23;14;0.121621621621622;0.378378378378378
Control.SRR15539824;44;40;0.454545454545455;24;20;0.0454545454545455;0.454545454545455
Control.SRR15539824;38;40;0.605263157894737;15;23;0.105263157894737;0.394736842105263
Control.SRR15539824;40;40;0.575;17;23;0.075;0.425
Control.SRR15539824;39;40;0.435897435897436;22;17;0.0641025641025641;0.435897435897436
Control.SRR15539824;38;40;0.368421052631579;24;14;0.131578947368421;0.368421052631579
Control.SRR15539824;40;40;0.575;17;23;0.075;0.425
Control.SRR15539824;40;40;0.525;19;21;0.025;0.475
Control.SRR15539824;42;40;0.404761904761905;25;17;0.0952380952380952;0.404761904761905
Control.SRR15539824;38;40;0.394736842105263;23;15;0.105263157894737;0.394736842105263
Control.SRR15539824;38;40;0.526315789473684;18;20;0.0263157894736842;0.473684210526316
Control.SRR15539824;38;40;0.394736842105263;23;15;0.105263157894737;0.394736842105263
Control.SRR15539824;36;40;0.472222222222222;19;17;0.0277777777777778;0.472222222222222
Control.SRR15539824;34;40;0.441176470588235;19;15;0.0588235294117647;0.441176470588235
Control.SRR15539824;34;40;0.617647058823529;13;21;0.117647058823529;0.382352941176471
Control.SRR15539824;39;40;0.615384615384615;15;24;0.115384615384615;0.384615384615385
Control.SRR15539824;43;40;0.534883720930233;20;23;0.0348837209302325;0.465116279069767
Control.SRR15539824;38;40;0.578947368421053;16;22;0.0789473684210527;0.421052631578947
Control.SRR15539824;35;40;0.457142857142857;19;16;0.0428571428571429;0.457142857142857
Control.SRR15539824;43;40;0.465116279069767;23;20;0.0348837209302326;0.465116279069767
Control.SRR15539824;40;40;0.4;24;16;0.1;0.4
Control.SRR15539824;39;40;0.461538461538462;21;18;0.0384615384615384;0.461538461538462
Control.SRR15539824;39;40;0.538461538461538;18;21;0.0384615384615384;0.461538461538462
Control.SRR15539824;42;40;0.5;21;21;0;0.5
Control.SRR15539824;39;40;0.487179487179487;20;19;0.0128205128205128;0.487179487179487
Control.SRR15539824;35;40;0.514285714285714;17;18;0.0142857142857142;0.485714285714286
Control.SRR15539824;44;40;0.454545454545455;24;20;0.0454545454545455;0.454545454545455
Control.SRR15539824;39;40;0.538461538461538;18;21;0.0384615384615384;0.461538461538462
Control.SRR15539824;38;40;0.526315789473684;18;20;0.0263157894736842;0.473684210526316
Control.SRR15539824;37;40;0.513513513513513;18;19;0.0135135135135135;0.486486486486487
Control.SRR15539824;37;40;0.567567567567568;16;21;0.0675675675675675;0.432432432432432
Control.SRR15539824;40;40;0.5;20;20;0;0.5
Control.SRR15539824;35;40;0.542857142857143;16;19;0.0428571428571428;0.457142857142857
Control.SRR15539824;36;40;0.527777777777778;17;19;0.0277777777777778;0.472222222222222
Control.SRR15539824;35;40;0.428571428571429;20;15;0.0714285714285715;0.428571428571429
Control.SRR15539824;36;40;0.416666666666667;21;15;0.0833333333333333;0.416666666666667
Control.SRR15539824;40;40;0.425;23;17;0.075;0.425
Control.SRR15539824;36;40;0.5;18;18;0;0.5
Control.SRR15539824;35;40;0.314285714285714;24;11;0.185714285714286;0.314285714285714
Control.SRR15539824;41;40;0.634146341463415;15;26;0.134146341463415;0.365853658536585
Control.SRR15539824;44;40;0.545454545454545;20;24;0.0454545454545454;0.454545454545455
Control.SRR15539824;40;40;0.475;21;19;0.025;0.475
Control.SRR15539824;38;40;0.342105263157895;25;13;0.157894736842105;0.342105263157895
Control.SRR15539824;35;40;0.457142857142857;19;16;0.0428571428571429;0.457142857142857
Control.SRR15539824;42;40;0.5;21;21;0;0.5
Control.SRR15539824;38;40;0.473684210526316;20;18;0.0263157894736842;0.473684210526316
Control.SRR15539824;39;40;0.487179487179487;20;19;0.0128205128205128;0.487179487179487
Control.SRR15539824;37;40;0.540540540540541;17;20;0.0405405405405406;0.459459459459459
Control.SRR15539824;34;40;0.382352941176471;21;13;0.117647058823529;0.382352941176471
Control.SRR15539824;41;40;0.439024390243902;23;18;0.0609756097560976;0.439024390243902
Control.SRR15539824;44;40;0.431818181818182;25;19;0.0681818181818182;0.431818181818182
Control.SRR15539824;39;40;0.435897435897436;22;17;0.0641025641025641;0.435897435897436
Control.SRR15539824;41;40;0.439024390243902;23;18;0.0609756097560976;0.439024390243902
Control.SRR15539824;36;40;0.611111111111111;14;22;0.111111111111111;0.388888888888889
Control.SRR15539824;36;40;0.472222222222222;19;17;0.0277777777777778;0.472222222222222
Control.SRR15539824;37;40;0.648648648648649;13;24;0.148648648648649;0.351351351351351
Control.SRR15539824;40;40;0.425;23;17;0.075;0.425
Control.SRR15539824;37;40;0.648648648648649;13;24;0.148648648648649;0.351351351351351
Control.SRR15539824;41;40;0.48780487804878;21;20;0.0121951219512195;0.48780487804878
Control.SRR15539824;43;40;0.511627906976744;21;22;0.0116279069767442;0.488372093023256
Control.SRR15539824;42;40;0.595238095238095;17;25;0.0952380952380952;0.404761904761905
Control.SRR15539824;37;40;0.486486486486487;19;18;0.0135135135135135;0.486486486486487
Control.SRR15539824;35;40;0.628571428571429;13;22;0.128571428571429;0.371428571428571
Control.SRR15539824;34;40;0.411764705882353;20;14;0.0882352941176471;0.411764705882353
Control.SRR15539824;36;40;0.444444444444444;20;16;0.0555555555555556;0.444444444444444
Control.SRR15539824;37;40;0.459459459459459;20;17;0.0405405405405405;0.459459459459459
Control.SRR15539824;35;40;0.485714285714286;18;17;0.0142857142857143;0.485714285714286
Control.SRR15539824;35;40;0.485714285714286;18;17;0.0142857142857143;0.485714285714286
Control.SRR15539824;37;40;0.513513513513513;18;19;0.0135135135135135;0.486486486486487
Control.SRR15539824;41;40;0.414634146341463;24;17;0.0853658536585366;0.414634146341463
Control.SRR15539824;44;40;0.5;22;22;0;0.5
Control.SRR15539824;39;40;0.564102564102564;17;22;0.0641025641025641;0.435897435897436
Control.SRR15539824;34;40;0.411764705882353;20;14;0.0882352941176471;0.411764705882353
Control.SRR15539824;36;40;0.527777777777778;17;19;0.0277777777777778;0.472222222222222
Control.SRR15539824;44;40;0.5;22;22;0;0.5
Control.SRR15539824;41;40;0.341463414634146;27;14;0.158536585365854;0.341463414634146
Control.SRR15539824;40;40;0.35;26;14;0.15;0.35
Control.SRR15539824;43;40;0.511627906976744;21;22;0.0116279069767442;0.488372093023256
Control.SRR15539824;42;40;0.523809523809524;20;22;0.0238095238095238;0.476190476190476
Control.SRR15539824;41;40;0.51219512195122;20;21;0.0121951219512195;0.48780487804878
Control.SRR15539824;42;40;0.595238095238095;17;25;0.0952380952380952;0.404761904761905
Control.SRR15539824;42;40;0.428571428571429;24;18;0.0714285714285715;0.428571428571429
Control.SRR15539824;44;40;0.613636363636364;17;27;0.113636363636364;0.386363636363636
Control.SRR15539824;43;40;0.465116279069767;23;20;0.0348837209302326;0.465116279069767
Control.SRR15539824;43;40;0.418604651162791;25;18;0.0813953488372093;0.418604651162791
Control.SRR15539824;44;40;0.431818181818182;25;19;0.0681818181818182;0.431818181818182
Control.SRR15539824;42;40;0.404761904761905;25;17;0.0952380952380952;0.404761904761905
Control.SRR15539824;44;40;0.477272727272727;23;21;0.0227272727272727;0.477272727272727
Control.SRR15539824;44;40;0.431818181818182;25;19;0.0681818181818182;0.431818181818182
Control.SRR15539824;42;40;0.476190476190476;22;20;0.0238095238095238;0.476190476190476
Control.SRR15539824;36;40;0.361111111111111;23;13;0.138888888888889;0.361111111111111
Control.SRR15539824;37;40;0.486486486486487;19;18;0.0135135135135135;0.486486486486487
Control.SRR15539824;36;40;0.472222222222222;19;17;0.0277777777777778;0.472222222222222
Control.SRR15539824;38;40;0.368421052631579;24;14;0.131578947368421;0.368421052631579
Control.SRR15539824;40;40;0.275;29;11;0.225;0.275
Control.SRR15539824;44;40;0.477272727272727;23;21;0.0227272727272727;0.477272727272727
Control.SRR15539824;37;40;0.513513513513513;18;19;0.0135135135135135;0.486486486486487
Control.SRR15539824;40;40;0.5;20;20;0;0.5
Control.SRR15539824;38;40;0.394736842105263;23;15;0.105263157894737;0.394736842105263
Control.SRR15539824;43;40;0.627906976744186;16;27;0.127906976744186;0.372093023255814
Control.SRR15539824;40;40;0.6;16;24;0.1;0.4
Control.SRR15539824;40;40;0.475;21;19;0.025;0.475
Control.SRR15539824;43;40;0.325581395348837;29;14;0.174418604651163;0.325581395348837
Control.SRR15539824;44;40;0.590909090909091;18;26;0.0909090909090909;0.409090909090909
Control.SRR15539824;42;40;0.571428571428571;18;24;0.0714285714285714;0.428571428571429
Control.SRR15539824;41;40;0.463414634146341;22;19;0.0365853658536585;0.463414634146341
Control.SRR15539824;44;40;0.386363636363636;27;17;0.113636363636364;0.386363636363636
Control.SRR15539824;34;40;0.441176470588235;19;15;0.0588235294117647;0.441176470588235
Control.SRR15539824;34;40;0.558823529411765;15;19;0.0588235294117647;0.441176470588235
Control.SRR15539824;43;40;0.465116279069767;23;20;0.0348837209302326;0.465116279069767
Control.SRR15539824;42;40;0.571428571428571;18;24;0.0714285714285714;0.428571428571429
Control.SRR15539824;38;40;0.552631578947368;17;21;0.0526315789473685;0.447368421052632
Control.SRR15539824;39;40;0.538461538461538;18;21;0.0384615384615384;0.461538461538462
Control.SRR15539824;41;40;0.463414634146341;22;19;0.0365853658536585;0.463414634146341
Control.SRR15539824;43;40;0.465116279069767;23;20;0.0348837209302326;0.465116279069767
Control.SRR15539824;37;40;0.486486486486487;19;18;0.0135135135135135;0.486486486486487
Control.SRR15539824;37;40;0.594594594594595;15;22;0.0945945945945946;0.405405405405405
Control.SRR15539824;34;40;0.323529411764706;23;11;0.176470588235294;0.323529411764706
Control.SRR15539824;35;40;0.657142857142857;12;23;0.157142857142857;0.342857142857143
Control.SRR15539824;37;40;0.405405405405405;22;15;0.0945945945945946;0.405405405405405
Control.SRR15539824;38;40;0.526315789473684;18;20;0.0263157894736842;0.473684210526316
Control.SRR15539824;42;40;0.333333333333333;28;14;0.166666666666667;0.333333333333333
Control.SRR15539824;41;40;0.365853658536585;26;15;0.134146341463415;0.365853658536585
Control.SRR15539824;35;40;0.4;21;14;0.1;0.4
Control.SRR15539824;42;40;0.404761904761905;25;17;0.0952380952380952;0.404761904761905
Control.SRR15539824;37;40;0.540540540540541;17;20;0.0405405405405406;0.459459459459459
Control.SRR15539824;44;40;0.454545454545455;24;20;0.0454545454545455;0.454545454545455
Control.SRR15539824;44;40;0.386363636363636;27;17;0.113636363636364;0.386363636363636
Control.SRR15539824;36;40;0.5;18;18;0;0.5
Control.SRR15539824;43;40;0.534883720930233;20;23;0.0348837209302325;0.465116279069767
Control.SRR15539824;35;40;0.685714285714286;11;24;0.185714285714286;0.314285714285714
Control.SRR15539824;40;40;0.625;15;25;0.125;0.375
Control.SRR15539824;39;40;0.512820512820513;19;20;0.0128205128205128;0.487179487179487
Control.SRR15539824;42;40;0.452380952380952;23;19;0.0476190476190476;0.452380952380952
Control.SRR15539824;40;40;0.725;11;29;0.225;0.275
Control.SRR15539824;40;40;0.475;21;19;0.025;0.475
Control.SRR15539824;44;40;0.545454545454545;20;24;0.0454545454545454;0.454545454545455
Control.SRR15539824;43;40;0.441860465116279;24;19;0.0581395348837209;0.441860465116279
Control.SRR15539824;42;40;0.5;21;21;0;0.5
Control.SRR15539824;43;40;0.488372093023256;22;21;0.0116279069767442;0.488372093023256
Control.SRR15539824;40;40;0.45;22;18;0.05;0.45
Control.SRR15539824;38;40;0.447368421052632;21;17;0.0526315789473684;0.447368421052632
Control.SRR15539824;43;40;0.395348837209302;26;17;0.104651162790698;0.395348837209302
Control.SRR15539824;38;40;0.421052631578947;22;16;0.0789473684210527;0.421052631578947
Control.SRR15539824;44;40;0.409090909090909;26;18;0.0909090909090909;0.409090909090909
Control.SRR15539824;36;40;0.5;18;18;0;0.5
Control.SRR15539824;38;40;0.552631578947368;17;21;0.0526315789473685;0.447368421052632
Control.SRR15539824;42;40;0.476190476190476;22;20;0.0238095238095238;0.476190476190476
Control.SRR15539824;34;40;0.558823529411765;15;19;0.0588235294117647;0.441176470588235
Control.SRR15539824;41;40;0.609756097560976;16;25;0.109756097560976;0.390243902439024
Control.SRR15539824;41;40;0.48780487804878;21;20;0.0121951219512195;0.48780487804878
Control.SRR15539824;43;40;0.604651162790698;17;26;0.104651162790698;0.395348837209302
Control.SRR15539824;43;40;0.534883720930233;20;23;0.0348837209302325;0.465116279069767
Control.SRR15539824;42;40;0.595238095238095;17;25;0.0952380952380952;0.404761904761905
Control.SRR15539824;43;40;0.534883720930233;20;23;0.0348837209302325;0.465116279069767
Control.SRR15539824;38;40;0.552631578947368;17;21;0.0526315789473685;0.447368421052632
Control.SRR15539824;35;40;0.6;14;21;0.1;0.4
Control.SRR15539824;34;40;0.411764705882353;20;14;0.0882352941176471;0.411764705882353
Control.SRR15539824;44;40;0.5;22;22;0;0.5
Control.SRR15539824;39;40;0.564102564102564;17;22;0.0641025641025641;0.435897435897436
Control.SRR15539824;38;40;0.631578947368421;14;24;0.131578947368421;0.368421052631579
Control.SRR15539824;44;40;0.681818181818182;14;30;0.181818181818182;0.318181818181818
Control.SRR15539824;34;40;0.617647058823529;13;21;0.117647058823529;0.382352941176471
Control.SRR15539824;36;40;0.583333333333333;15;21;0.0833333333333334;0.416666666666667
Control.SRR15539824;44;40;0.477272727272727;23;21;0.0227272727272727;0.477272727272727
Control.SRR15539824;38;40;0.605263157894737;15;23;0.105263157894737;0.394736842105263
Control.SRR15539824;40;40;0.55;18;22;0.05;0.45
Control.SRR15539824;39;40;0.461538461538462;21;18;0.0384615384615384;0.461538461538462
Control.SRR15539824;43;40;0.558139534883721;19;24;0.0581395348837209;0.441860465116279
Control.SRR15539824;40;40;0.475;21;19;0.025;0.475
Control.SRR15539824;39;40;0.435897435897436;22;17;0.0641025641025641;0.435897435897436
Control.SRR15539824;42;40;0.428571428571429;24;18;0.0714285714285715;0.428571428571429
Control.SRR15539824;38;40;0.605263157894737;15;23;0.105263157894737;0.394736842105263
Control.SRR15539824;39;40;0.641025641025641;14;25;0.141025641025641;0.358974358974359
Control.SRR15539824;36;40;0.527777777777778;17;19;0.0277777777777778;0.472222222222222
Control.SRR15539824;40;40;0.375;25;15;0.125;0.375
Control.SRR15539824;41;40;0.609756097560976;16;25;0.109756097560976;0.390243902439024
Control.SRR15539824;42;40;0.571428571428571;18;24;0.0714285714285714;0.428571428571429
Control.SRR15539824;41;40;0.536585365853659;19;22;0.0365853658536586;0.463414634146341
Control.SRR15539824;41;40;0.609756097560976;16;25;0.109756097560976;0.390243902439024
Control.SRR15539824;43;40;0.465116279069767;23;20;0.0348837209302326;0.465116279069767
Control.SRR15539824;44;40;0.5;22;22;0;0.5
Control.SRR15539824;36;40;0.472222222222222;19;17;0.0277777777777778;0.472222222222222
Control.SRR15539824;39;40;0.435897435897436;22;17;0.0641025641025641;0.435897435897436
Control.SRR15539824;35;40;0.485714285714286;18;17;0.0142857142857143;0.485714285714286
Control.SRR15539824;39;40;0.41025641025641;23;16;0.0897435897435898;0.41025641025641
Control.SRR15539824;39;40;0.538461538461538;18;21;0.0384615384615384;0.461538461538462
Control.SRR15539824;41;40;0.51219512195122;20;21;0.0121951219512195;0.48780487804878
Control.SRR15539824;39;40;0.435897435897436;22;17;0.0641025641025641;0.435897435897436
Control.SRR15539824;41;40;0.48780487804878;21;20;0.0121951219512195;0.48780487804878
Control.SRR15539824;42;40;0.357142857142857;27;15;0.142857142857143;0.357142857142857
Control.SRR15539824;42;40;0.452380952380952;23;19;0.0476190476190476;0.452380952380952
Control.SRR15539824;37;40;0.486486486486487;19;18;0.0135135135135135;0.486486486486487
Control.SRR15539824;39;40;0.487179487179487;20;19;0.0128205128205128;0.487179487179487
Control.SRR15539824;39;40;0.564102564102564;17;22;0.0641025641025641;0.435897435897436
Control.SRR15539824;44;40;0.454545454545455;24;20;0.0454545454545455;0.454545454545455
Control.SRR15539824;41;40;0.414634146341463;24;17;0.0853658536585366;0.414634146341463
Control.SRR15539824;42;40;0.595238095238095;17;25;0.0952380952380952;0.404761904761905
Control.SRR15539824;41;40;0.585365853658537;17;24;0.0853658536585366;0.414634146341463
Control.SRR15539824;41;40;0.463414634146341;22;19;0.0365853658536585;0.463414634146341
Control.SRR15539824;44;40;0.477272727272727;23;21;0.0227272727272727;0.477272727272727
Control.SRR15539824;42;40;0.571428571428571;18;24;0.0714285714285714;0.428571428571429
Control.SRR15539824;37;40;0.378378378378378;23;14;0.121621621621622;0.378378378378378
Control.SRR15539824;34;40;0.5;17;17;0;0.5
Control.SRR15539824;38;40;0.657894736842105;13;25;0.157894736842105;0.342105263157895
Control.SRR15539824;39;40;0.58974358974359;16;23;0.0897435897435898;0.41025641025641
Control.SRR15539824;37;40;0.459459459459459;20;17;0.0405405405405405;0.459459459459459
Control.SRR15539824;43;40;0.627906976744186;16;27;0.127906976744186;0.372093023255814
Control.SRR15539824;37;40;0.486486486486487;19;18;0.0135135135135135;0.486486486486487
Control.SRR15539824;41;40;0.414634146341463;24;17;0.0853658536585366;0.414634146341463
Control.SRR15539824;38;40;0.605263157894737;15;23;0.105263157894737;0.394736842105263
Control.SRR15539824;39;40;0.666666666666667;13;26;0.166666666666667;0.333333333333333
Control.SRR15539824;34;40;0.382352941176471;21;13;0.117647058823529;0.382352941176471
Control.SRR15539824;44;40;0.522727272727273;21;23;0.0227272727272727;0.477272727272727
Control.SRR15539824;35;40;0.4;21;14;0.1;0.4
Control.SRR15539824;34;40;0.529411764705882;16;18;0.0294117647058824;0.470588235294118
Control.SRR15539824;34;40;0.588235294117647;14;20;0.0882352941176471;0.411764705882353
Control.SRR15539824;41;40;0.463414634146341;22;19;0.0365853658536585;0.463414634146341
Control.SRR15539824;37;40;0.351351351351351;24;13;0.148648648648649;0.351351351351351
Control.SRR15539824;40;40;0.4;24;16;0.1;0.4
Control.SRR15539824;38;40;0.552631578947368;17;21;0.0526315789473685;0.447368421052632
Control.SRR15539824;38;40;0.526315789473684;18;20;0.0263157894736842;0.473684210526316
Control.SRR15539824;34;40;0.617647058823529;13;21;0.117647058823529;0.382352941176471
Control.SRR15539824;41;40;0.536585365853659;19;22;0.0365853658536586;0.463414634146341
Control.SRR15539824;40;40;0.6;16;24;0.1;0.4
Control.SRR15539824;37;40;0.594594594594595;15;22;0.0945945945945946;0.405405405405405
Control.SRR15539824;37;40;0.540540540540541;17;20;0.0405405405405406;0.459459459459459
Control.SRR15539824;41;40;0.560975609756098;18;23;0.0609756097560976;0.439024390243902
Control.SRR15539824;39;40;0.435897435897436;22;17;0.0641025641025641;0.435897435897436
Control.SRR15539824;41;40;0.634146341463415;15;26;0.134146341463415;0.365853658536585
Control.SRR15539824;42;40;0.428571428571429;24;18;0.0714285714285715;0.428571428571429
Control.SRR15539824;43;40;0.534883720930233;20;23;0.0348837209302325;0.465116279069767
Control.SRR15539824;43;40;0.534883720930233;20;23;0.0348837209302325;0.465116279069767
Control.SRR15539824;44;40;0.590909090909091;18;26;0.0909090909090909;0.409090909090909
Control.SRR15539824;39;40;0.692307692307692;12;27;0.192307692307692;0.307692307692308
Control.SRR15539824;35;40;0.657142857142857;12;23;0.157142857142857;0.342857142857143
Control.SRR15539824;39;40;0.461538461538462;21;18;0.0384615384615384;0.461538461538462
Control.SRR15539824;39;40;0.564102564102564;17;22;0.0641025641025641;0.435897435897436
Control.SRR15539824;42;40;0.452380952380952;23;19;0.0476190476190476;0.452380952380952
Control.SRR15539824;40;40;0.575;17;23;0.075;0.425
Control.SRR15539824;44;40;0.545454545454545;20;24;0.0454545454545454;0.454545454545455
Control.SRR15539824;41;40;0.585365853658537;17;24;0.0853658536585366;0.414634146341463
Control.SRR15539824;42;40;0.666666666666667;14;28;0.166666666666667;0.333333333333333
Control.SRR15539824;35;40;0.514285714285714;17;18;0.0142857142857142;0.485714285714286
Control.SRR15539824;35;40;0.428571428571429;20;15;0.0714285714285715;0.428571428571429
Control.SRR15539824;43;40;0.558139534883721;19;24;0.0581395348837209;0.441860465116279
Control.SRR15539824;39;40;0.512820512820513;19;20;0.0128205128205128;0.487179487179487
Control.SRR15539824;41;40;0.463414634146341;22;19;0.0365853658536585;0.463414634146341
Control.SRR15539824;36;40;0.611111111111111;14;22;0.111111111111111;0.388888888888889
Control.SRR15539824;40;40;0.65;14;26;0.15;0.35
Control.SRR15539824;40;40;0.5;20;20;0;0.5
Control.SRR15539824;38;40;0.421052631578947;22;16;0.0789473684210527;0.421052631578947
Control.SRR15539824;35;40;0.6;14;21;0.1;0.4
Control.SRR15539824;43;40;0.488372093023256;22;21;0.0116279069767442;0.488372093023256
Control.SRR15539824;37;40;0.405405405405405;22;15;0.0945945945945946;0.405405405405405
Control.SRR15539824;43;40;0.534883720930233;20;23;0.0348837209302325;0.465116279069767
Control.SRR15539824;40;40;0.375;25;15;0.125;0.375
Control.SRR15539824;44;40;0.431818181818182;25;19;0.0681818181818182;0.431818181818182
Control.SRR15539824;36;40;0.388888888888889;22;14;0.111111111111111;0.388888888888889
Control.SRR15539824;34;40;0.529411764705882;16;18;0.0294117647058824;0.470588235294118
Control.SRR15539824;41;40;0.48780487804878;21;20;0.0121951219512195;0.48780487804878
Control.SRR15539824;37;40;0.540540540540541;17;20;0.0405405405405406;0.459459459459459
Control.SRR15539824;35;40;0.542857142857143;16;19;0.0428571428571428;0.457142857142857
Control.SRR15539824;43;40;0.627906976744186;16;27;0.127906976744186;0.372093023255814
Control.SRR15539824;38;40;0.526315789473684;18;20;0.0263157894736842;0.473684210526316
Control.SRR15539824;42;40;0.523809523809524;20;22;0.0238095238095238;0.476190476190476
Control.SRR15539824;42;40;0.547619047619048;19;23;0.0476190476190477;0.452380952380952
Control.SRR15539824;39;40;0.538461538461538;18;21;0.0384615384615384;0.461538461538462
Control.SRR15539824;42;40;0.523809523809524;20;22;0.0238095238095238;0.476190476190476
Control.SRR15539824;37;40;0.513513513513513;18;19;0.0135135135135135;0.486486486486487
Control.SRR15539824;39;40;0.41025641025641;23;16;0.0897435897435898;0.41025641025641
Control.SRR15539824;34;40;0.558823529411765;15;19;0.0588235294117647;0.441176470588235
Control.SRR15539824;41;40;0.560975609756098;18;23;0.0609756097560976;0.439024390243902
Control.SRR15539824;43;40;0.534883720930233;20;23;0.0348837209302325;0.465116279069767
Control.SRR15539824;40;40;0.45;22;18;0.05;0.45
Control.SRR15539824;37;40;0.594594594594595;15;22;0.0945945945945946;0.405405405405405
Control.SRR15539824;41;40;0.463414634146341;22;19;0.0365853658536585;0.463414634146341
Control.SRR15539824;44;40;0.5;22;22;0;0.5
Control.SRR15539824;43;40;0.441860465116279;24;19;0.0581395348837209;0.441860465116279
Control.SRR15539824;40;40;0.5;20;20;0;0.5
Control.SRR15539824;41;40;0.341463414634146;27;14;0.158536585365854;0.341463414634146
Control.SRR15539824;44;40;0.454545454545455;24;20;0.0454545454545455;0.454545454545455
Control.SRR15539824;34;40;0.558823529411765;15;19;0.0588235294117647;0.441176470588235
Control.SRR15539824;43;40;0.767441860465116;10;33;0.267441860465116;0.232558139534884
Control.SRR15539824;44;40;0.477272727272727;23;21;0.0227272727272727;0.477272727272727
Control.SRR15539824;42;40;0.380952380952381;26;16;0.119047619047619;0.380952380952381
Control.SRR15539824;40;40;0.525;19;21;0.025;0.475
Control.SRR15539824;41;40;0.439024390243902;23;18;0.0609756097560976;0.439024390243902
Control.SRR15539824;36;40;0.472222222222222;19;17;0.0277777777777778;0.472222222222222
Control.SRR15539824;40;40;0.425;23;17;0.075;0.425
Control.SRR15539824;35;40;0.428571428571429;20;15;0.0714285714285715;0.428571428571429
Control.SRR15539824;37;40;0.648648648648649;13;24;0.148648648648649;0.351351351351351
Control.SRR15539824;41;40;0.414634146341463;24;17;0.0853658536585366;0.414634146341463
Control.SRR15539824;41;40;0.365853658536585;26;15;0.134146341463415;0.365853658536585
Control.SRR15539824;36;40;0.444444444444444;20;16;0.0555555555555556;0.444444444444444
Control.SRR15539824;34;40;0.323529411764706;23;11;0.176470588235294;0.323529411764706
Control.SRR15539824;40;40;0.6;16;24;0.1;0.4
Control.SRR15539824;38;40;0.552631578947368;17;21;0.0526315789473685;0.447368421052632
Control.SRR15539824;42;40;0.476190476190476;22;20;0.0238095238095238;0.476190476190476
Control.SRR15539824;38;40;0.421052631578947;22;16;0.0789473684210527;0.421052631578947
Control.SRR15539824;37;40;0.702702702702703;11;26;0.202702702702703;0.297297297297297
Control.SRR15539824;35;40;0.514285714285714;17;18;0.0142857142857142;0.485714285714286
Control.SRR15539824;41;40;0.585365853658537;17;24;0.0853658536585366;0.414634146341463
Control.SRR15539824;43;40;0.418604651162791;25;18;0.0813953488372093;0.418604651162791
Control.SRR15539824;43;40;0.441860465116279;24;19;0.0581395348837209;0.441860465116279
Control.SRR15539824;36;40;0.5;18;18;0;0.5
Control.SRR15539824;42;40;0.523809523809524;20;22;0.0238095238095238;0.476190476190476
Control.SRR15539824;42;40;0.571428571428571;18;24;0.0714285714285714;0.428571428571429
Control.SRR15539824;43;40;0.558139534883721;19;24;0.0581395348837209;0.441860465116279
Control.SRR15539824;40;40;0.575;17;23;0.075;0.425
Control.SRR15539824;43;40;0.511627906976744;21;22;0.0116279069767442;0.488372093023256
Control.SRR15539824;41;40;0.51219512195122;20;21;0.0121951219512195;0.48780487804878
Control.SRR15539824;36;40;0.527777777777778;17;19;0.0277777777777778;0.472222222222222
Control.SRR15539824;41;40;0.48780487804878;21;20;0.0121951219512195;0.48780487804878
Control.SRR15539824;41;40;0.414634146341463;24;17;0.0853658536585366;0.414634146341463
Control.SRR15539824;42;40;0.642857142857143;15;27;0.142857142857143;0.357142857142857
Control.SRR15539824;36;40;0.5;18;18;0;0.5
Control.SRR15539824;43;40;0.627906976744186;16;27;0.127906976744186;0.372093023255814
Control.SRR15539824;40;40;0.55;18;22;0.05;0.45
Control.SRR15539824;37;40;0.432432432432432;21;16;0.0675675675675675;0.432432432432432
Control.SRR15539824;40;40;0.575;17;23;0.075;0.425
Control.SRR15539824;34;40;0.705882352941177;10;24;0.205882352941177;0.294117647058824
Control.SRR15539824;34;40;0.529411764705882;16;18;0.0294117647058824;0.470588235294118
Control.SRR15539824;37;40;0.513513513513513;18;19;0.0135135135135135;0.486486486486487
Control.SRR15539824;40;40;0.425;23;17;0.075;0.425
Control.SRR15539824;42;40;0.523809523809524;20;22;0.0238095238095238;0.476190476190476
Control.SRR15539824;42;40;0.404761904761905;25;17;0.0952380952380952;0.404761904761905
Control.SRR15539824;41;40;0.585365853658537;17;24;0.0853658536585366;0.414634146341463
Control.SRR15539824;44;40;0.545454545454545;20;24;0.0454545454545454;0.454545454545455
Control.SRR15539824;41;40;0.634146341463415;15;26;0.134146341463415;0.365853658536585
Control.SRR15539824;38;40;0.473684210526316;20;18;0.0263157894736842;0.473684210526316
Control.SRR15539824;39;40;0.641025641025641;14;25;0.141025641025641;0.358974358974359
Control.SRR15539824;44;40;0.477272727272727;23;21;0.0227272727272727;0.477272727272727
Control.SRR15539824;42;40;0.547619047619048;19;23;0.0476190476190477;0.452380952380952
Control.SRR15539824;44;40;0.431818181818182;25;19;0.0681818181818182;0.431818181818182
Control.SRR15539824;44;40;0.659090909090909;15;29;0.159090909090909;0.340909090909091
Control.SRR15539824;43;40;0.465116279069767;23;20;0.0348837209302326;0.465116279069767
Control.SRR15539824;34;40;0.5;17;17;0;0.5
Control.SRR15539824;39;40;0.435897435897436;22;17;0.0641025641025641;0.435897435897436
Control.SRR15539824;38;40;0.552631578947368;17;21;0.0526315789473685;0.447368421052632
Control.SRR15539824;42;40;0.357142857142857;27;15;0.142857142857143;0.357142857142857
Control.SRR15539824;39;40;0.564102564102564;17;22;0.0641025641025641;0.435897435897436
Control.SRR15539824;40;40;0.6;16;24;0.1;0.4
Control.SRR15539824;37;40;0.540540540540541;17;20;0.0405405405405406;0.459459459459459
Control.SRR15539824;44;40;0.431818181818182;25;19;0.0681818181818182;0.431818181818182
Control.SRR15539824;39;40;0.487179487179487;20;19;0.0128205128205128;0.487179487179487
Control.SRR15539824;36;40;0.583333333333333;15;21;0.0833333333333334;0.416666666666667
Control.SRR15539824;40;40;0.45;22;18;0.05;0.45
Control.SRR15539824;43;40;0.372093023255814;27;16;0.127906976744186;0.372093023255814
Control.SRR15539824;36;40;0.416666666666667;21;15;0.0833333333333333;0.416666666666667
Control.SRR15539824;44;40;0.454545454545455;24;20;0.0454545454545455;0.454545454545455
Control.SRR15539824;40;40;0.475;21;19;0.025;0.475
Control.SRR15539824;43;40;0.534883720930233;20;23;0.0348837209302325;0.465116279069767
Control.SRR15539824;41;40;0.48780487804878;21;20;0.0121951219512195;0.48780487804878
Control.SRR15539824;42;40;0.476190476190476;22;20;0.0238095238095238;0.476190476190476
Control.SRR15539824;35;40;0.485714285714286;18;17;0.0142857142857143;0.485714285714286
Control.SRR15539824;37;40;0.513513513513513;18;19;0.0135135135135135;0.486486486486487
Control.SRR15539824;40;40;0.425;23;17;0.075;0.425
Control.SRR15539824;44;40;0.409090909090909;26;18;0.0909090909090909;0.409090909090909
Control.SRR15539824;39;40;0.538461538461538;18;21;0.0384615384615384;0.461538461538462
Control.SRR15539824;37;40;0.567567567567568;16;21;0.0675675675675675;0.432432432432432
Control.SRR15539824;36;40;0.555555555555556;16;20;0.0555555555555556;0.444444444444444
Control.SRR15539824;44;40;0.363636363636364;28;16;0.136363636363636;0.363636363636364
Control.SRR15539824;36;40;0.5;18;18;0;0.5
Control.SRR15539824;41;40;0.439024390243902;23;18;0.0609756097560976;0.439024390243902
Control.SRR15539824;41;40;0.414634146341463;24;17;0.0853658536585366;0.414634146341463
Control.SRR15539824;37;40;0.513513513513513;18;19;0.0135135135135135;0.486486486486487
Control.SRR15539824;36;40;0.555555555555556;16;20;0.0555555555555556;0.444444444444444
Control.SRR15539824;40;40;0.6;16;24;0.1;0.4
Control.SRR15539824;43;40;0.488372093023256;22;21;0.0116279069767442;0.488372093023256
Control.SRR15539824;39;40;0.538461538461538;18;21;0.0384615384615384;0.461538461538462
Control.SRR15539824;41;40;0.51219512195122;20;21;0.0121951219512195;0.48780487804878
Control.SRR15539824;38;40;0.552631578947368;17;21;0.0526315789473685;0.447368421052632
Control.SRR15539824;39;40;0.538461538461538;18;21;0.0384615384615384;0.461538461538462
Control.SRR15539824;43;40;0.395348837209302;26;17;0.104651162790698;0.395348837209302
Control.SRR15539824;36;40;0.555555555555556;16;20;0.0555555555555556;0.444444444444444
Control.SRR15539824;36;40;0.388888888888889;22;14;0.111111111111111;0.388888888888889
Control.SRR15539824;36;40;0.583333333333333;15;21;0.0833333333333334;0.416666666666667
Control.SRR15539824;39;40;0.435897435897436;22;17;0.0641025641025641;0.435897435897436
Control.SRR15539824;44;40;0.409090909090909;26;18;0.0909090909090909;0.409090909090909
Control.SRR15539824;34;40;0.441176470588235;19;15;0.0588235294117647;0.441176470588235
Control.SRR15539824;43;40;0.511627906976744;21;22;0.0116279069767442;0.488372093023256
Control.SRR15539824;37;40;0.540540540540541;17;20;0.0405405405405406;0.459459459459459
Control.SRR15539824;34;40;0.617647058823529;13;21;0.117647058823529;0.382352941176471
Control.SRR15539824;37;40;0.594594594594595;15;22;0.0945945945945946;0.405405405405405
Control.SRR15539824;44;40;0.454545454545455;24;20;0.0454545454545455;0.454545454545455
Control.SRR15539824;38;40;0.552631578947368;17;21;0.0526315789473685;0.447368421052632
Control.SRR15539824;35;40;0.428571428571429;20;15;0.0714285714285715;0.428571428571429
Control.SRR15539824;43;40;0.511627906976744;21;22;0.0116279069767442;0.488372093023256
Control.SRR15539824;36;40;0.416666666666667;21;15;0.0833333333333333;0.416666666666667
Control.SRR15539824;39;40;0.564102564102564;17;22;0.0641025641025641;0.435897435897436
Control.SRR15539824;35;40;0.457142857142857;19;16;0.0428571428571429;0.457142857142857
Control.SRR15539824;34;40;0.382352941176471;21;13;0.117647058823529;0.382352941176471
Control.SRR15539824;38;40;0.526315789473684;18;20;0.0263157894736842;0.473684210526316
Control.SRR15539824;38;40;0.421052631578947;22;16;0.0789473684210527;0.421052631578947
Control.SRR15539824;37;40;0.648648648648649;13;24;0.148648648648649;0.351351351351351
Control.SRR15539824;34;40;0.441176470588235;19;15;0.0588235294117647;0.441176470588235
Control.SRR15539824;39;40;0.512820512820513;19;20;0.0128205128205128;0.487179487179487
Control.SRR15539824;35;40;0.514285714285714;17;18;0.0142857142857142;0.485714285714286
Control.SRR15539824;39;40;0.512820512820513;19;20;0.0128205128205128;0.487179487179487
Control.SRR15539824;43;40;0.604651162790698;17;26;0.104651162790698;0.395348837209302
Control.SRR15539824;38;40;0.552631578947368;17;21;0.0526315789473685;0.447368421052632
Control.SRR15539824;37;40;0.405405405405405;22;15;0.0945945945945946;0.405405405405405
Control.SRR15539824;41;40;0.463414634146341;22;19;0.0365853658536585;0.463414634146341
Control.SRR15539824;41;40;0.560975609756098;18;23;0.0609756097560976;0.439024390243902
Control.SRR15539824;37;40;0.486486486486487;19;18;0.0135135135135135;0.486486486486487
Control.SRR15539824;39;40;0.58974358974359;16;23;0.0897435897435898;0.41025641025641
Control.SRR15539824;44;40;0.5;22;22;0;0.5
Control.SRR15539824;36;40;0.472222222222222;19;17;0.0277777777777778;0.472222222222222
Control.SRR15539824;35;40;0.542857142857143;16;19;0.0428571428571428;0.457142857142857
Control.SRR15539824;40;40;0.575;17;23;0.075;0.425
Control.SRR15539824;43;40;0.674418604651163;14;29;0.174418604651163;0.325581395348837
Control.SRR15539824;38;40;0.473684210526316;20;18;0.0263157894736842;0.473684210526316
Control.SRR15539824;39;40;0.512820512820513;19;20;0.0128205128205128;0.487179487179487
Control.SRR15539824;39;40;0.512820512820513;19;20;0.0128205128205128;0.487179487179487
Control.SRR15539824;40;40;0.4;24;16;0.1;0.4
Control.SRR15539824;40;40;0.5;20;20;0;0.5
Control.SRR15539824;36;40;0.416666666666667;21;15;0.0833333333333333;0.416666666666667
Control.SRR15539824;39;40;0.461538461538462;21;18;0.0384615384615384;0.461538461538462
Control.SRR15539824;42;40;0.666666666666667;14;28;0.166666666666667;0.333333333333333
Control.SRR15539824;38;40;0.552631578947368;17;21;0.0526315789473685;0.447368421052632
Control.SRR15539824;38;40;0.578947368421053;16;22;0.0789473684210527;0.421052631578947
Control.SRR15539824;43;40;0.558139534883721;19;24;0.0581395348837209;0.441860465116279
Control.SRR15539824;35;40;0.428571428571429;20;15;0.0714285714285715;0.428571428571429
Control.SRR15539824;39;40;0.461538461538462;21;18;0.0384615384615384;0.461538461538462
Control.SRR15539824;34;40;0.529411764705882;16;18;0.0294117647058824;0.470588235294118
Control.SRR15539824;40;40;0.4;24;16;0.1;0.4
Control.SRR15539824;34;40;0.441176470588235;19;15;0.0588235294117647;0.441176470588235
Control.SRR15539824;34;40;0.470588235294118;18;16;0.0294117647058824;0.470588235294118
Control.SRR15539824;40;40;0.55;18;22;0.05;0.45
Control.SRR15539824;38;40;0.578947368421053;16;22;0.0789473684210527;0.421052631578947
Control.SRR15539824;35;40;0.371428571428571;22;13;0.128571428571429;0.371428571428571
Control.SRR15539824;42;40;0.523809523809524;20;22;0.0238095238095238;0.476190476190476
Control.SRR15539824;42;40;0.380952380952381;26;16;0.119047619047619;0.380952380952381
Control.SRR15539824;40;40;0.525;19;21;0.025;0.475
Control.SRR15539824;41;40;0.463414634146341;22;19;0.0365853658536585;0.463414634146341
Control.SRR15539824;38;40;0.473684210526316;20;18;0.0263157894736842;0.473684210526316
Control.SRR15539824;42;40;0.476190476190476;22;20;0.0238095238095238;0.476190476190476
Control.SRR15539824;44;40;0.545454545454545;20;24;0.0454545454545454;0.454545454545455
Control.SRR15539824;41;40;0.51219512195122;20;21;0.0121951219512195;0.48780487804878
Control.SRR15539824;40;40;0.55;18;22;0.05;0.45
Control.SRR15539824;37;40;0.432432432432432;21;16;0.0675675675675675;0.432432432432432
Control.SRR15539824;38;40;0.526315789473684;18;20;0.0263157894736842;0.473684210526316
Control.SRR15539824;38;40;0.5;19;19;0;0.5
Control.SRR15539824;44;40;0.545454545454545;20;24;0.0454545454545454;0.454545454545455
Control.SRR15539824;43;40;0.325581395348837;29;14;0.174418604651163;0.325581395348837
Control.SRR15539824;44;40;0.522727272727273;21;23;0.0227272727272727;0.477272727272727
Control.SRR15539824;34;40;0.352941176470588;22;12;0.147058823529412;0.352941176470588
Control.SRR15539824;37;40;0.567567567567568;16;21;0.0675675675675675;0.432432432432432
Control.SRR15539824;38;40;0.421052631578947;22;16;0.0789473684210527;0.421052631578947
Control.SRR15539824;38;40;0.5;19;19;0;0.5
Control.SRR15539824;38;40;0.631578947368421;14;24;0.131578947368421;0.368421052631579
Control.SRR15539824;44;40;0.431818181818182;25;19;0.0681818181818182;0.431818181818182
Control.SRR15539824;35;40;0.514285714285714;17;18;0.0142857142857142;0.485714285714286
Control.SRR15539824;44;40;0.5;22;22;0;0.5
Control.SRR15539824;36;40;0.527777777777778;17;19;0.0277777777777778;0.472222222222222
Control.SRR15539824;35;40;0.485714285714286;18;17;0.0142857142857143;0.485714285714286
Control.SRR15539824;37;40;0.540540540540541;17;20;0.0405405405405406;0.459459459459459
Control.SRR15539824;34;40;0.529411764705882;16;18;0.0294117647058824;0.470588235294118
Control.SRR15539824;38;40;0.447368421052632;21;17;0.0526315789473684;0.447368421052632
Control.SRR15539824;35;40;0.514285714285714;17;18;0.0142857142857142;0.485714285714286
Control.SRR15539824;35;40;0.457142857142857;19;16;0.0428571428571429;0.457142857142857
Control.SRR15539824;36;40;0.388888888888889;22;14;0.111111111111111;0.388888888888889
Control.SRR15539824;36;40;0.472222222222222;19;17;0.0277777777777778;0.472222222222222
Control.SRR15539824;39;40;0.487179487179487;20;19;0.0128205128205128;0.487179487179487
Control.SRR15539824;38;40;0.5;19;19;0;0.5
Control.SRR15539824;39;40;0.435897435897436;22;17;0.0641025641025641;0.435897435897436
Control.SRR15539824;44;40;0.454545454545455;24;20;0.0454545454545455;0.454545454545455
Control.SRR15539824;42;40;0.452380952380952;23;19;0.0476190476190476;0.452380952380952
Control.SRR15539824;35;40;0.428571428571429;20;15;0.0714285714285715;0.428571428571429
Control.SRR15539824;40;40;0.45;22;18;0.05;0.45
Control.SRR15539824;34;40;0.441176470588235;19;15;0.0588235294117647;0.441176470588235
Control.SRR15539824;38;40;0.394736842105263;23;15;0.105263157894737;0.394736842105263
Control.SRR15539824;37;40;0.513513513513513;18;19;0.0135135135135135;0.486486486486487
Control.SRR15539824;42;40;0.404761904761905;25;17;0.0952380952380952;0.404761904761905
Control.SRR15539824;34;40;0.558823529411765;15;19;0.0588235294117647;0.441176470588235
Control.SRR15539824;36;40;0.444444444444444;20;16;0.0555555555555556;0.444444444444444
Control.SRR15539824;43;40;0.441860465116279;24;19;0.0581395348837209;0.441860465116279
Control.SRR15539824;38;40;0.368421052631579;24;14;0.131578947368421;0.368421052631579
Control.SRR15539824;35;40;0.457142857142857;19;16;0.0428571428571429;0.457142857142857
Control.SRR15539824;36;40;0.555555555555556;16;20;0.0555555555555556;0.444444444444444
Control.SRR15539824;40;40;0.425;23;17;0.075;0.425
Control.SRR15539824;42;40;0.404761904761905;25;17;0.0952380952380952;0.404761904761905
Control.SRR15539824;38;40;0.5;19;19;0;0.5
Control.SRR15539824;34;40;0.5;17;17;0;0.5
Control.SRR15539824;34;40;0.5;17;17;0;0.5
Control.SRR15539824;35;40;0.714285714285714;10;25;0.214285714285714;0.285714285714286
Control.SRR15539824;43;40;0.441860465116279;24;19;0.0581395348837209;0.441860465116279
Control.SRR15539824;38;40;0.526315789473684;18;20;0.0263157894736842;0.473684210526316
Control.SRR15539824;37;40;0.594594594594595;15;22;0.0945945945945946;0.405405405405405
Control.SRR15539824;34;40;0.5;17;17;0;0.5
Control.SRR15539824;44;40;0.522727272727273;21;23;0.0227272727272727;0.477272727272727
Control.SRR15539824;35;40;0.485714285714286;18;17;0.0142857142857143;0.485714285714286
Control.SRR15539824;38;40;0.5;19;19;0;0.5
Control.SRR15539824;36;40;0.444444444444444;20;16;0.0555555555555556;0.444444444444444
Control.SRR15539824;38;40;0.578947368421053;16;22;0.0789473684210527;0.421052631578947
Control.SRR15539824;36;40;0.555555555555556;16;20;0.0555555555555556;0.444444444444444
Control.SRR15539824;35;40;0.457142857142857;19;16;0.0428571428571429;0.457142857142857
Control.SRR15539824;38;40;0.5;19;19;0;0.5
Control.SRR15539824;34;40;0.441176470588235;19;15;0.0588235294117647;0.441176470588235
Control.SRR15539824;42;40;0.571428571428571;18;24;0.0714285714285714;0.428571428571429
Control.SRR15539824;39;40;0.564102564102564;17;22;0.0641025641025641;0.435897435897436
Control.SRR15539824;44;40;0.409090909090909;26;18;0.0909090909090909;0.409090909090909
Control.SRR15539824;42;40;0.547619047619048;19;23;0.0476190476190477;0.452380952380952
Control.SRR15539824;40;40;0.325;27;13;0.175;0.325
Control.SRR15539824;39;40;0.461538461538462;21;18;0.0384615384615384;0.461538461538462
Control.SRR15539824;36;40;0.472222222222222;19;17;0.0277777777777778;0.472222222222222
Control.SRR15539824;37;40;0.351351351351351;24;13;0.148648648648649;0.351351351351351
Control.SRR15539824;35;40;0.457142857142857;19;16;0.0428571428571429;0.457142857142857
Control.SRR15539824;35;40;0.457142857142857;19;16;0.0428571428571429;0.457142857142857
Control.SRR15539824;34;40;0.352941176470588;22;12;0.147058823529412;0.352941176470588
Control.SRR15539824;40;40;0.575;17;23;0.075;0.425
Control.SRR15539824;44;40;0.568181818181818;19;25;0.0681818181818182;0.431818181818182
Control.SRR15539824;36;40;0.472222222222222;19;17;0.0277777777777778;0.472222222222222
Control.SRR15539824;36;40;0.444444444444444;20;16;0.0555555555555556;0.444444444444444
Control.SRR15539824;39;40;0.41025641025641;23;16;0.0897435897435898;0.41025641025641
Control.SRR15539824;39;40;0.487179487179487;20;19;0.0128205128205128;0.487179487179487
Control.SRR15539824;37;40;0.756756756756757;9;28;0.256756756756757;0.243243243243243
Control.SRR15539824;35;40;0.514285714285714;17;18;0.0142857142857142;0.485714285714286
Control.SRR15539824;37;40;0.378378378378378;23;14;0.121621621621622;0.378378378378378
Control.SRR15539824;43;40;0.558139534883721;19;24;0.0581395348837209;0.441860465116279
Control.SRR15539824;37;40;0.486486486486487;19;18;0.0135135135135135;0.486486486486487
Control.SRR15539824;37;40;0.567567567567568;16;21;0.0675675675675675;0.432432432432432
Control.SRR15539824;36;40;0.555555555555556;16;20;0.0555555555555556;0.444444444444444
Control.SRR15539824;38;40;0.552631578947368;17;21;0.0526315789473685;0.447368421052632
Control.SRR15539824;36;40;0.611111111111111;14;22;0.111111111111111;0.388888888888889
Control.SRR15539824;43;40;0.534883720930233;20;23;0.0348837209302325;0.465116279069767
Control.SRR15539824;35;40;0.4;21;14;0.1;0.4
Control.SRR15539824;36;40;0.444444444444444;20;16;0.0555555555555556;0.444444444444444
Control.SRR15539824;37;40;0.540540540540541;17;20;0.0405405405405406;0.459459459459459
Control.SRR15539824;34;40;0.441176470588235;19;15;0.0588235294117647;0.441176470588235
Control.SRR15539824;36;40;0.666666666666667;12;24;0.166666666666667;0.333333333333333
Control.SRR15539824;42;40;0.547619047619048;19;23;0.0476190476190477;0.452380952380952
Control.SRR15539824;39;40;0.564102564102564;17;22;0.0641025641025641;0.435897435897436
Control.SRR15539824;39;40;0.384615384615385;24;15;0.115384615384615;0.384615384615385
Control.SRR15539824;36;40;0.555555555555556;16;20;0.0555555555555556;0.444444444444444
Control.SRR15539824;37;40;0.405405405405405;22;15;0.0945945945945946;0.405405405405405
Control.SRR15539824;36;40;0.583333333333333;15;21;0.0833333333333334;0.416666666666667
Control.SRR15539824;40;40;0.6;16;24;0.1;0.4
Control.SRR15539824;39;40;0.487179487179487;20;19;0.0128205128205128;0.487179487179487
Control.SRR15539824;36;40;0.361111111111111;23;13;0.138888888888889;0.361111111111111
Control.SRR15539824;34;40;0.5;17;17;0;0.5
Control.SRR15539824;39;40;0.538461538461538;18;21;0.0384615384615384;0.461538461538462
Control.SRR15539824;40;40;0.575;17;23;0.075;0.425
Control.SRR15539824;43;40;0.465116279069767;23;20;0.0348837209302326;0.465116279069767
Control.SRR15539824;37;40;0.486486486486487;19;18;0.0135135135135135;0.486486486486487
Control.SRR15539824;39;40;0.538461538461538;18;21;0.0384615384615384;0.461538461538462
Control.SRR15539824;40;40;0.55;18;22;0.05;0.45
Control.SRR15539824;36;40;0.472222222222222;19;17;0.0277777777777778;0.472222222222222
Control.SRR15539824;35;40;0.4;21;14;0.1;0.4
Control.SRR15539824;40;40;0.475;21;19;0.025;0.475
Control.SRR15539824;38;40;0.552631578947368;17;21;0.0526315789473685;0.447368421052632
Control.SRR15539824;36;40;0.555555555555556;16;20;0.0555555555555556;0.444444444444444
Control.SRR15539824;36;40;0.444444444444444;20;16;0.0555555555555556;0.444444444444444
Control.SRR15539824;35;40;0.428571428571429;20;15;0.0714285714285715;0.428571428571429
Control.SRR15539824;36;40;0.416666666666667;21;15;0.0833333333333333;0.416666666666667
Control.SRR15539824;37;40;0.540540540540541;17;20;0.0405405405405406;0.459459459459459
Control.SRR15539824;43;40;0.488372093023256;22;21;0.0116279069767442;0.488372093023256
Control.SRR15539824;43;40;0.441860465116279;24;19;0.0581395348837209;0.441860465116279
Control.SRR15539824;42;40;0.404761904761905;25;17;0.0952380952380952;0.404761904761905
Control.SRR15539824;42;40;0.452380952380952;23;19;0.0476190476190476;0.452380952380952
Control.SRR15539824;36;40;0.444444444444444;20;16;0.0555555555555556;0.444444444444444
Control.SRR15539824;41;40;0.560975609756098;18;23;0.0609756097560976;0.439024390243902
Control.SRR15539824;39;40;0.461538461538462;21;18;0.0384615384615384;0.461538461538462
Control.SRR15539824;41;40;0.536585365853659;19;22;0.0365853658536586;0.463414634146341
Control.SRR15539824;40;40;0.425;23;17;0.075;0.425
Control.SRR15539824;38;40;0.447368421052632;21;17;0.0526315789473684;0.447368421052632
Control.SRR15539824;36;40;0.555555555555556;16;20;0.0555555555555556;0.444444444444444
Control.SRR15539824;39;40;0.538461538461538;18;21;0.0384615384615384;0.461538461538462
Control.SRR15539824;38;40;0.421052631578947;22;16;0.0789473684210527;0.421052631578947
Control.SRR15539824;34;40;0.441176470588235;19;15;0.0588235294117647;0.441176470588235
Control.SRR15539824;35;40;0.514285714285714;17;18;0.0142857142857142;0.485714285714286
Control.SRR15539824;41;40;0.536585365853659;19;22;0.0365853658536586;0.463414634146341
Control.SRR15539824;41;40;0.51219512195122;20;21;0.0121951219512195;0.48780487804878
Control.SRR15539824;41;40;0.48780487804878;21;20;0.0121951219512195;0.48780487804878
Control.SRR15539824;41;40;0.560975609756098;18;23;0.0609756097560976;0.439024390243902
Control.SRR15539824;37;40;0.432432432432432;21;16;0.0675675675675675;0.432432432432432
Control.SRR15539824;44;40;0.431818181818182;25;19;0.0681818181818182;0.431818181818182
Control.SRR15539824;43;40;0.441860465116279;24;19;0.0581395348837209;0.441860465116279
Control.SRR15539824;40;40;0.55;18;22;0.05;0.45
Control.SRR15539824;41;40;0.585365853658537;17;24;0.0853658536585366;0.414634146341463
Control.SRR15539824;40;40;0.425;23;17;0.075;0.425
Control.SRR15539824;41;40;0.439024390243902;23;18;0.0609756097560976;0.439024390243902
Control.SRR15539824;36;40;0.583333333333333;15;21;0.0833333333333334;0.416666666666667
Control.SRR15539824;41;40;0.560975609756098;18;23;0.0609756097560976;0.439024390243902
Control.SRR15539824;43;40;0.488372093023256;22;21;0.0116279069767442;0.488372093023256
Control.SRR15539824;37;40;0.351351351351351;24;13;0.148648648648649;0.351351351351351
Control.SRR15539824;36;40;0.305555555555556;25;11;0.194444444444444;0.305555555555556
Control.SRR15539824;41;40;0.48780487804878;21;20;0.0121951219512195;0.48780487804878
Control.SRR15539824;36;40;0.527777777777778;17;19;0.0277777777777778;0.472222222222222
Control.SRR15539824;35;40;0.428571428571429;20;15;0.0714285714285715;0.428571428571429
Control.SRR15539824;44;40;0.409090909090909;26;18;0.0909090909090909;0.409090909090909
Control.SRR15539824;37;40;0.513513513513513;18;19;0.0135135135135135;0.486486486486487
Control.SRR15539824;36;40;0.583333333333333;15;21;0.0833333333333334;0.416666666666667
Control.SRR15539824;36;40;0.5;18;18;0;0.5
Control.SRR15539824;42;40;0.5;21;21;0;0.5
Control.SRR15539824;41;40;0.560975609756098;18;23;0.0609756097560976;0.439024390243902
Control.SRR15539824;44;40;0.454545454545455;24;20;0.0454545454545455;0.454545454545455
Control.SRR15539824;34;40;0.470588235294118;18;16;0.0294117647058824;0.470588235294118
Control.SRR15539824;37;40;0.513513513513513;18;19;0.0135135135135135;0.486486486486487
Control.SRR15539824;44;40;0.431818181818182;25;19;0.0681818181818182;0.431818181818182
Control.SRR15539824;41;40;0.414634146341463;24;17;0.0853658536585366;0.414634146341463
Control.SRR15539824;38;40;0.421052631578947;22;16;0.0789473684210527;0.421052631578947
Control.SRR15539824;42;40;0.523809523809524;20;22;0.0238095238095238;0.476190476190476
Control.SRR15539824;39;40;0.58974358974359;16;23;0.0897435897435898;0.41025641025641
Control.SRR15539824;35;40;0.571428571428571;15;20;0.0714285714285714;0.428571428571429
Control.SRR15539824;35;40;0.457142857142857;19;16;0.0428571428571429;0.457142857142857
Control.SRR15539824;37;40;0.594594594594595;15;22;0.0945945945945946;0.405405405405405
Control.SRR15539824;38;40;0.421052631578947;22;16;0.0789473684210527;0.421052631578947
Control.SRR15539824;35;40;0.457142857142857;19;16;0.0428571428571429;0.457142857142857
Control.SRR15539824;37;40;0.540540540540541;17;20;0.0405405405405406;0.459459459459459
Control.SRR15539824;39;40;0.461538461538462;21;18;0.0384615384615384;0.461538461538462
Control.SRR15539824;39;40;0.487179487179487;20;19;0.0128205128205128;0.487179487179487
Control.SRR15539824;38;40;0.368421052631579;24;14;0.131578947368421;0.368421052631579
Control.SRR15539824;37;40;0.513513513513513;18;19;0.0135135135135135;0.486486486486487
Control.SRR15539824;35;40;0.4;21;14;0.1;0.4
Control.SRR15539824;40;40;0.625;15;25;0.125;0.375
Control.SRR15539824;43;40;0.534883720930233;20;23;0.0348837209302325;0.465116279069767
Control.SRR15539824;39;40;0.461538461538462;21;18;0.0384615384615384;0.461538461538462
Control.SRR15539824;38;40;0.447368421052632;21;17;0.0526315789473684;0.447368421052632
Control.SRR15539824;44;40;0.613636363636364;17;27;0.113636363636364;0.386363636363636
Control.SRR15539824;34;40;0.470588235294118;18;16;0.0294117647058824;0.470588235294118
Control.SRR15539824;41;40;0.390243902439024;25;16;0.109756097560976;0.390243902439024
Control.SRR15539824;37;40;0.621621621621622;14;23;0.121621621621622;0.378378378378378
Control.SRR15539824;40;40;0.425;23;17;0.075;0.425
Control.SRR15539824;44;40;0.477272727272727;23;21;0.0227272727272727;0.477272727272727
Control.SRR15539824;36;40;0.527777777777778;17;19;0.0277777777777778;0.472222222222222
Control.SRR15539824;42;40;0.571428571428571;18;24;0.0714285714285714;0.428571428571429
Control.SRR15539824;39;40;0.461538461538462;21;18;0.0384615384615384;0.461538461538462
Control.SRR15539824;37;40;0.513513513513513;18;19;0.0135135135135135;0.486486486486487
Control.SRR15539824;35;40;0.485714285714286;18;17;0.0142857142857143;0.485714285714286
Control.SRR15539824;40;40;0.6;16;24;0.1;0.4
Control.SRR15539824;38;40;0.552631578947368;17;21;0.0526315789473685;0.447368421052632
Control.SRR15539824;40;40;0.45;22;18;0.05;0.45
Control.SRR15539824;41;40;0.536585365853659;19;22;0.0365853658536586;0.463414634146341
Control.SRR15539824;42;40;0.476190476190476;22;20;0.0238095238095238;0.476190476190476
Control.SRR15539824;40;40;0.475;21;19;0.025;0.475
Control.SRR15539824;44;40;0.454545454545455;24;20;0.0454545454545455;0.454545454545455
Control.SRR15539824;40;40;0.525;19;21;0.025;0.475
Control.SRR15539824;36;40;0.388888888888889;22;14;0.111111111111111;0.388888888888889
Control.SRR15539824;38;40;0.578947368421053;16;22;0.0789473684210527;0.421052631578947
Control.SRR15539824;37;40;0.486486486486487;19;18;0.0135135135135135;0.486486486486487
Control.SRR15539824;43;40;0.581395348837209;18;25;0.0813953488372093;0.418604651162791
Control.SRR15539824;37;40;0.513513513513513;18;19;0.0135135135135135;0.486486486486487
Control.SRR15539824;37;40;0.486486486486487;19;18;0.0135135135135135;0.486486486486487
Control.SRR15539824;34;40;0.5;17;17;0;0.5
Control.SRR15539824;42;40;0.595238095238095;17;25;0.0952380952380952;0.404761904761905
Control.SRR15539824;34;40;0.441176470588235;19;15;0.0588235294117647;0.441176470588235
Control.SRR15539824;36;40;0.5;18;18;0;0.5
Control.SRR15539824;41;40;0.463414634146341;22;19;0.0365853658536585;0.463414634146341
Control.SRR15539824;35;40;0.4;21;14;0.1;0.4
Control.SRR15539824;42;40;0.5;21;21;0;0.5
Control.SRR15539824;44;40;0.454545454545455;24;20;0.0454545454545455;0.454545454545455
Control.SRR15539824;37;40;0.513513513513513;18;19;0.0135135135135135;0.486486486486487
Control.SRR15539824;37;40;0.351351351351351;24;13;0.148648648648649;0.351351351351351
Control.SRR15539824;35;40;0.428571428571429;20;15;0.0714285714285715;0.428571428571429
Control.SRR15539824;34;40;0.352941176470588;22;12;0.147058823529412;0.352941176470588
Control.SRR15539824;40;40;0.475;21;19;0.025;0.475
Control.SRR15539824;40;40;0.325;27;13;0.175;0.325
Control.SRR15539824;42;40;0.476190476190476;22;20;0.0238095238095238;0.476190476190476
Control.SRR15539824;44;40;0.454545454545455;24;20;0.0454545454545455;0.454545454545455
Control.SRR15539824;42;40;0.595238095238095;17;25;0.0952380952380952;0.404761904761905
Control.SRR15539824;40;40;0.525;19;21;0.025;0.475
Control.SRR15539824;43;40;0.488372093023256;22;21;0.0116279069767442;0.488372093023256
Control.SRR15539824;35;40;0.457142857142857;19;16;0.0428571428571429;0.457142857142857
Control.SRR15539824;40;40;0.5;20;20;0;0.5
Control.SRR15539824;40;40;0.55;18;22;0.05;0.45
Control.SRR15539824;38;40;0.526315789473684;18;20;0.0263157894736842;0.473684210526316
Control.SRR15539824;39;40;0.487179487179487;20;19;0.0128205128205128;0.487179487179487
Control.SRR15539824;39;40;0.384615384615385;24;15;0.115384615384615;0.384615384615385
Control.SRR15539824;34;40;0.5;17;17;0;0.5
Control.SRR15539824;36;40;0.583333333333333;15;21;0.0833333333333334;0.416666666666667
Control.SRR15539824;36;40;0.583333333333333;15;21;0.0833333333333334;0.416666666666667
Control.SRR15539824;38;40;0.368421052631579;24;14;0.131578947368421;0.368421052631579
Control.SRR15539824;37;40;0.513513513513513;18;19;0.0135135135135135;0.486486486486487
Control.SRR15539824;39;40;0.538461538461538;18;21;0.0384615384615384;0.461538461538462
Control.SRR15539824;42;40;0.571428571428571;18;24;0.0714285714285714;0.428571428571429
Control.SRR15539824;40;40;0.45;22;18;0.05;0.45
Control.SRR15539824;35;40;0.571428571428571;15;20;0.0714285714285714;0.428571428571429
Control.SRR15539824;36;40;0.416666666666667;21;15;0.0833333333333333;0.416666666666667
Control.SRR15539824;41;40;0.51219512195122;20;21;0.0121951219512195;0.48780487804878
Control.SRR15539824;38;40;0.447368421052632;21;17;0.0526315789473684;0.447368421052632
Control.SRR15539824;34;40;0.470588235294118;18;16;0.0294117647058824;0.470588235294118
Control.SRR15539824;44;40;0.545454545454545;20;24;0.0454545454545454;0.454545454545455
Control.SRR15539824;42;40;0.523809523809524;20;22;0.0238095238095238;0.476190476190476
Control.SRR15539824;40;40;0.525;19;21;0.025;0.475
Control.SRR15539824;36;40;0.611111111111111;14;22;0.111111111111111;0.388888888888889
Control.SRR15539824;43;40;0.604651162790698;17;26;0.104651162790698;0.395348837209302
Control.SRR15539824;41;40;0.341463414634146;27;14;0.158536585365854;0.341463414634146
Control.SRR15539824;42;40;0.452380952380952;23;19;0.0476190476190476;0.452380952380952
Control.SRR15539824;43;40;0.534883720930233;20;23;0.0348837209302325;0.465116279069767
Control.SRR15539824;35;40;0.571428571428571;15;20;0.0714285714285714;0.428571428571429
Control.SRR15539824;40;40;0.55;18;22;0.05;0.45
Control.SRR15539824;38;40;0.5;19;19;0;0.5
Control.SRR15539824;36;40;0.472222222222222;19;17;0.0277777777777778;0.472222222222222
Control.SRR15539824;44;40;0.5;22;22;0;0.5
Control.SRR15539824;34;40;0.529411764705882;16;18;0.0294117647058824;0.470588235294118
Control.SRR15539824;34;40;0.470588235294118;18;16;0.0294117647058824;0.470588235294118
Control.SRR15539824;36;40;0.472222222222222;19;17;0.0277777777777778;0.472222222222222
Control.SRR15539824;34;40;0.352941176470588;22;12;0.147058823529412;0.352941176470588
Control.SRR15539824;41;40;0.51219512195122;20;21;0.0121951219512195;0.48780487804878
Control.SRR15539824;35;40;0.685714285714286;11;24;0.185714285714286;0.314285714285714
Control.SRR15539824;39;40;0.487179487179487;20;19;0.0128205128205128;0.487179487179487
Control.SRR15539824;38;40;0.447368421052632;21;17;0.0526315789473684;0.447368421052632
Control.SRR15539824;37;40;0.486486486486487;19;18;0.0135135135135135;0.486486486486487
Control.SRR15539824;37;40;0.540540540540541;17;20;0.0405405405405406;0.459459459459459
Control.SRR15539824;39;40;0.641025641025641;14;25;0.141025641025641;0.358974358974359
Control.SRR15539824;38;40;0.657894736842105;13;25;0.157894736842105;0.342105263157895
Control.SRR15539824;41;40;0.560975609756098;18;23;0.0609756097560976;0.439024390243902
Control.SRR15539824;37;40;0.567567567567568;16;21;0.0675675675675675;0.432432432432432
Control.SRR15539824;38;40;0.447368421052632;21;17;0.0526315789473684;0.447368421052632
Control.SRR15539824;44;40;0.522727272727273;21;23;0.0227272727272727;0.477272727272727
Control.SRR15539824;37;40;0.459459459459459;20;17;0.0405405405405405;0.459459459459459
Control.SRR15539824;38;40;0.578947368421053;16;22;0.0789473684210527;0.421052631578947
Control.SRR15539824;35;40;0.514285714285714;17;18;0.0142857142857142;0.485714285714286
Control.SRR15539824;38;40;0.394736842105263;23;15;0.105263157894737;0.394736842105263
Control.SRR15539824;34;40;0.558823529411765;15;19;0.0588235294117647;0.441176470588235
Control.SRR15539824;37;40;0.486486486486487;19;18;0.0135135135135135;0.486486486486487
Control.SRR15539824;40;40;0.5;20;20;0;0.5
Control.SRR15539824;38;40;0.684210526315789;12;26;0.184210526315789;0.315789473684211
Control.SRR15539824;38;40;0.421052631578947;22;16;0.0789473684210527;0.421052631578947
Control.SRR15539824;39;40;0.41025641025641;23;16;0.0897435897435898;0.41025641025641
Control.SRR15539824;41;40;0.585365853658537;17;24;0.0853658536585366;0.414634146341463
Control.SRR15539824;39;40;0.487179487179487;20;19;0.0128205128205128;0.487179487179487
Control.SRR15539824;34;40;0.647058823529412;12;22;0.147058823529412;0.352941176470588
Control.SRR15539824;34;40;0.5;17;17;0;0.5
Control.SRR15539824;35;40;0.371428571428571;22;13;0.128571428571429;0.371428571428571
Control.SRR15539824;40;40;0.575;17;23;0.075;0.425
Control.SRR15539824;38;40;0.631578947368421;14;24;0.131578947368421;0.368421052631579
Control.SRR15539824;34;40;0.529411764705882;16;18;0.0294117647058824;0.470588235294118
Control.SRR15539824;40;40;0.55;18;22;0.05;0.45
Control.SRR15539824;40;40;0.55;18;22;0.05;0.45
Control.SRR15539824;41;40;0.51219512195122;20;21;0.0121951219512195;0.48780487804878
Control.SRR15539824;42;40;0.547619047619048;19;23;0.0476190476190477;0.452380952380952
Control.SRR15539824;41;40;0.560975609756098;18;23;0.0609756097560976;0.439024390243902
Control.SRR15539824;38;40;0.473684210526316;20;18;0.0263157894736842;0.473684210526316
Control.SRR15539824;36;40;0.444444444444444;20;16;0.0555555555555556;0.444444444444444
Control.SRR15539824;34;40;0.558823529411765;15;19;0.0588235294117647;0.441176470588235
Control.SRR15539824;42;40;0.428571428571429;24;18;0.0714285714285715;0.428571428571429
Control.SRR15539824;39;40;0.512820512820513;19;20;0.0128205128205128;0.487179487179487
Control.SRR15539824;38;40;0.578947368421053;16;22;0.0789473684210527;0.421052631578947
Control.SRR15539824;36;40;0.555555555555556;16;20;0.0555555555555556;0.444444444444444
Control.SRR15539824;40;40;0.475;21;19;0.025;0.475
Control.SRR15539824;43;40;0.534883720930233;20;23;0.0348837209302325;0.465116279069767
Control.SRR15539824;42;40;0.5;21;21;0;0.5
Control.SRR15539824;37;40;0.567567567567568;16;21;0.0675675675675675;0.432432432432432
Control.SRR15539824;36;40;0.416666666666667;21;15;0.0833333333333333;0.416666666666667
Control.SRR15539824;39;40;0.615384615384615;15;24;0.115384615384615;0.384615384615385
Control.SRR15539824;38;40;0.236842105263158;29;9;0.263157894736842;0.236842105263158
Control.SRR15539824;42;40;0.619047619047619;16;26;0.119047619047619;0.380952380952381
Control.SRR15539824;40;40;0.525;19;21;0.025;0.475
Control.SRR15539824;38;40;0.552631578947368;17;21;0.0526315789473685;0.447368421052632
Control.SRR15539824;40;40;0.425;23;17;0.075;0.425
Control.SRR15539824;43;40;0.511627906976744;21;22;0.0116279069767442;0.488372093023256
Control.SRR15539824;35;40;0.457142857142857;19;16;0.0428571428571429;0.457142857142857
Control.SRR15539824;42;40;0.595238095238095;17;25;0.0952380952380952;0.404761904761905
Control.SRR15539824;44;40;0.409090909090909;26;18;0.0909090909090909;0.409090909090909
Control.SRR15539824;43;40;0.488372093023256;22;21;0.0116279069767442;0.488372093023256
Control.SRR15539824;38;40;0.473684210526316;20;18;0.0263157894736842;0.473684210526316
Control.SRR15539824;38;40;0.5;19;19;0;0.5
Control.SRR15539824;40;40;0.575;17;23;0.075;0.425
Control.SRR15539824;42;40;0.523809523809524;20;22;0.0238095238095238;0.476190476190476
Control.SRR15539824;40;40;0.7;12;28;0.2;0.3
Control.SRR15539824;44;40;0.477272727272727;23;21;0.0227272727272727;0.477272727272727
Control.SRR15539824;40;40;0.325;27;13;0.175;0.325
Control.SRR15539824;41;40;0.585365853658537;17;24;0.0853658536585366;0.414634146341463
Control.SRR15539824;41;40;0.414634146341463;24;17;0.0853658536585366;0.414634146341463
Control.SRR15539824;36;40;0.611111111111111;14;22;0.111111111111111;0.388888888888889
Control.SRR15539824;43;40;0.511627906976744;21;22;0.0116279069767442;0.488372093023256
Control.SRR15539824;43;40;0.348837209302326;28;15;0.151162790697674;0.348837209302326
Control.SRR15539824;41;40;0.51219512195122;20;21;0.0121951219512195;0.48780487804878
Control.SRR15539824;37;40;0.432432432432432;21;16;0.0675675675675675;0.432432432432432
Control.SRR15539824;38;40;0.5;19;19;0;0.5
Control.SRR15539824;43;40;0.651162790697674;15;28;0.151162790697674;0.348837209302326
Control.SRR15539824;43;40;0.558139534883721;19;24;0.0581395348837209;0.441860465116279
Control.SRR15539824;36;40;0.666666666666667;12;24;0.166666666666667;0.333333333333333
Control.SRR15539824;35;40;0.542857142857143;16;19;0.0428571428571428;0.457142857142857
Control.SRR15539824;37;40;0.594594594594595;15;22;0.0945945945945946;0.405405405405405
Control.SRR15539824;42;40;0.452380952380952;23;19;0.0476190476190476;0.452380952380952
Control.SRR15539824;34;40;0.5;17;17;0;0.5
Control.SRR15539824;38;40;0.605263157894737;15;23;0.105263157894737;0.394736842105263
Control.SRR15539824;37;40;0.405405405405405;22;15;0.0945945945945946;0.405405405405405
Control.SRR15539824;39;40;0.41025641025641;23;16;0.0897435897435898;0.41025641025641
Control.SRR15539824;37;40;0.459459459459459;20;17;0.0405405405405405;0.459459459459459
Control.SRR15539824;40;40;0.625;15;25;0.125;0.375
Control.SRR15539824;44;40;0.568181818181818;19;25;0.0681818181818182;0.431818181818182
Control.SRR15539824;38;40;0.447368421052632;21;17;0.0526315789473684;0.447368421052632
Control.SRR15539824;39;40;0.58974358974359;16;23;0.0897435897435898;0.41025641025641
Control.SRR15539824;43;40;0.441860465116279;24;19;0.0581395348837209;0.441860465116279
Control.SRR15539824;43;40;0.534883720930233;20;23;0.0348837209302325;0.465116279069767
Control.SRR15539824;36;40;0.444444444444444;20;16;0.0555555555555556;0.444444444444444
Control.SRR15539824;37;40;0.432432432432432;21;16;0.0675675675675675;0.432432432432432
Control.SRR15539824;41;40;0.51219512195122;20;21;0.0121951219512195;0.48780487804878
Control.SRR15539824;42;40;0.642857142857143;15;27;0.142857142857143;0.357142857142857
Control.SRR15539824;44;40;0.545454545454545;20;24;0.0454545454545454;0.454545454545455
Control.SRR15539824;42;40;0.69047619047619;13;29;0.19047619047619;0.30952380952381
Control.SRR15539824;43;40;0.604651162790698;17;26;0.104651162790698;0.395348837209302
Control.SRR15539824;44;40;0.431818181818182;25;19;0.0681818181818182;0.431818181818182
Control.SRR15539824;43;40;0.488372093023256;22;21;0.0116279069767442;0.488372093023256
Control.SRR15539824;42;40;0.595238095238095;17;25;0.0952380952380952;0.404761904761905
Control.SRR15539824;42;40;0.380952380952381;26;16;0.119047619047619;0.380952380952381
Control.SRR15539824;43;40;0.534883720930233;20;23;0.0348837209302325;0.465116279069767
Control.SRR15539824;36;40;0.5;18;18;0;0.5
Control.SRR15539824;35;40;0.485714285714286;18;17;0.0142857142857143;0.485714285714286
Control.SRR15539824;44;40;0.363636363636364;28;16;0.136363636363636;0.363636363636364
Control.SRR15539824;42;40;0.571428571428571;18;24;0.0714285714285714;0.428571428571429
Control.SRR15539824;39;40;0.435897435897436;22;17;0.0641025641025641;0.435897435897436
Control.SRR15539824;35;40;0.542857142857143;16;19;0.0428571428571428;0.457142857142857
Control.SRR15539824;37;40;0.459459459459459;20;17;0.0405405405405405;0.459459459459459
Control.SRR15539824;37;40;0.567567567567568;16;21;0.0675675675675675;0.432432432432432
Control.SRR15539824;36;40;0.611111111111111;14;22;0.111111111111111;0.388888888888889
Control.SRR15539824;41;40;0.51219512195122;20;21;0.0121951219512195;0.48780487804878
Control.SRR15539824;43;40;0.372093023255814;27;16;0.127906976744186;0.372093023255814
Control.SRR15539824;44;40;0.522727272727273;21;23;0.0227272727272727;0.477272727272727
Control.SRR15539824;41;40;0.536585365853659;19;22;0.0365853658536586;0.463414634146341
Control.SRR15539824;38;40;0.447368421052632;21;17;0.0526315789473684;0.447368421052632
Control.SRR15539824;35;40;0.428571428571429;20;15;0.0714285714285715;0.428571428571429
Control.SRR15539824;36;40;0.666666666666667;12;24;0.166666666666667;0.333333333333333
Control.SRR15539824;36;40;0.416666666666667;21;15;0.0833333333333333;0.416666666666667
Control.SRR15539824;37;40;0.621621621621622;14;23;0.121621621621622;0.378378378378378
Control.SRR15539824;37;40;0.459459459459459;20;17;0.0405405405405405;0.459459459459459
Control.SRR15539824;38;40;0.5;19;19;0;0.5
Control.SRR15539824;37;40;0.432432432432432;21;16;0.0675675675675675;0.432432432432432
Control.SRR15539824;44;40;0.454545454545455;24;20;0.0454545454545455;0.454545454545455
Control.SRR15539824;39;40;0.461538461538462;21;18;0.0384615384615384;0.461538461538462
Control.SRR15539824;41;40;0.51219512195122;20;21;0.0121951219512195;0.48780487804878
Control.SRR15539824;40;40;0.55;18;22;0.05;0.45
Control.SRR15539824;38;40;0.447368421052632;21;17;0.0526315789473684;0.447368421052632
Control.SRR15539824;43;40;0.488372093023256;22;21;0.0116279069767442;0.488372093023256
Control.SRR15539824;35;40;0.542857142857143;16;19;0.0428571428571428;0.457142857142857
Control.SRR15539824;39;40;0.435897435897436;22;17;0.0641025641025641;0.435897435897436
Control.SRR15539824;38;40;0.342105263157895;25;13;0.157894736842105;0.342105263157895
Control.SRR15539824;41;40;0.317073170731707;28;13;0.182926829268293;0.317073170731707
Control.SRR15539824;37;40;0.459459459459459;20;17;0.0405405405405405;0.459459459459459
Control.SRR15539824;34;40;0.529411764705882;16;18;0.0294117647058824;0.470588235294118
Control.SRR15539824;39;40;0.58974358974359;16;23;0.0897435897435898;0.41025641025641
Control.SRR15539824;41;40;0.51219512195122;20;21;0.0121951219512195;0.48780487804878
Control.SRR15539824;44;40;0.568181818181818;19;25;0.0681818181818182;0.431818181818182
Control.SRR15539824;38;40;0.368421052631579;24;14;0.131578947368421;0.368421052631579
Control.SRR15539824;35;40;0.6;14;21;0.1;0.4
Control.SRR15539824;38;40;0.526315789473684;18;20;0.0263157894736842;0.473684210526316
Control.SRR15539824;36;40;0.361111111111111;23;13;0.138888888888889;0.361111111111111
Control.SRR15539824;40;40;0.625;15;25;0.125;0.375
Control.SRR15539824;40;40;0.45;22;18;0.05;0.45
Control.SRR15539824;43;40;0.325581395348837;29;14;0.174418604651163;0.325581395348837
Control.SRR15539824;43;40;0.534883720930233;20;23;0.0348837209302325;0.465116279069767
Control.SRR15539824;37;40;0.513513513513513;18;19;0.0135135135135135;0.486486486486487
Control.SRR15539824;39;40;0.333333333333333;26;13;0.166666666666667;0.333333333333333
Control.SRR15539824;42;40;0.476190476190476;22;20;0.0238095238095238;0.476190476190476
Control.SRR15539824;40;40;0.5;20;20;0;0.5
Control.SRR15539824;41;40;0.48780487804878;21;20;0.0121951219512195;0.48780487804878
Control.SRR15539824;36;40;0.388888888888889;22;14;0.111111111111111;0.388888888888889
Control.SRR15539824;42;40;0.452380952380952;23;19;0.0476190476190476;0.452380952380952
Control.SRR15539824;42;40;0.547619047619048;19;23;0.0476190476190477;0.452380952380952
Control.SRR15539824;40;40;0.5;20;20;0;0.5
Control.SRR15539824;42;40;0.523809523809524;20;22;0.0238095238095238;0.476190476190476
Control.SRR15539824;34;40;0.382352941176471;21;13;0.117647058823529;0.382352941176471
Control.SRR15539824;41;40;0.463414634146341;22;19;0.0365853658536585;0.463414634146341
Control.SRR15539824;40;40;0.35;26;14;0.15;0.35
Control.SRR15539824;34;40;0.558823529411765;15;19;0.0588235294117647;0.441176470588235
Control.SRR15539824;37;40;0.675675675675676;12;25;0.175675675675676;0.324324324324324
Control.SRR15539824;41;40;0.51219512195122;20;21;0.0121951219512195;0.48780487804878
Control.SRR15539824;36;40;0.527777777777778;17;19;0.0277777777777778;0.472222222222222
Control.SRR15539824;36;40;0.666666666666667;12;24;0.166666666666667;0.333333333333333
Control.SRR15539824;36;40;0.388888888888889;22;14;0.111111111111111;0.388888888888889
Control.SRR15539824;38;40;0.473684210526316;20;18;0.0263157894736842;0.473684210526316
Control.SRR15539824;35;40;0.428571428571429;20;15;0.0714285714285715;0.428571428571429
Control.SRR15539824;35;40;0.542857142857143;16;19;0.0428571428571428;0.457142857142857
Control.SRR15539824;42;40;0.476190476190476;22;20;0.0238095238095238;0.476190476190476
Control.SRR15539824;37;40;0.486486486486487;19;18;0.0135135135135135;0.486486486486487
Control.SRR15539824;38;40;0.605263157894737;15;23;0.105263157894737;0.394736842105263
Control.SRR15539824;41;40;0.414634146341463;24;17;0.0853658536585366;0.414634146341463
Control.SRR15539824;40;40;0.5;20;20;0;0.5
Control.SRR15539824;40;40;0.5;20;20;0;0.5
Control.SRR15539824;39;40;0.487179487179487;20;19;0.0128205128205128;0.487179487179487
Control.SRR15539824;39;40;0.487179487179487;20;19;0.0128205128205128;0.487179487179487
Control.SRR15539824;36;40;0.416666666666667;21;15;0.0833333333333333;0.416666666666667
Control.SRR15539824;40;40;0.525;19;21;0.025;0.475
Control.SRR15539824;37;40;0.486486486486487;19;18;0.0135135135135135;0.486486486486487
Control.SRR15539824;37;40;0.513513513513513;18;19;0.0135135135135135;0.486486486486487
Control.SRR15539824;35;40;0.371428571428571;22;13;0.128571428571429;0.371428571428571
Control.SRR15539824;35;40;0.542857142857143;16;19;0.0428571428571428;0.457142857142857
Control.SRR15539824;36;40;0.388888888888889;22;14;0.111111111111111;0.388888888888889
Control.SRR15539824;37;40;0.567567567567568;16;21;0.0675675675675675;0.432432432432432
Control.SRR15539824;44;40;0.477272727272727;23;21;0.0227272727272727;0.477272727272727
Control.SRR15539824;39;40;0.461538461538462;21;18;0.0384615384615384;0.461538461538462
Control.SRR15539824;40;40;0.425;23;17;0.075;0.425
Control.SRR15539824;34;40;0.382352941176471;21;13;0.117647058823529;0.382352941176471
Control.SRR15539824;44;40;0.386363636363636;27;17;0.113636363636364;0.386363636363636
Control.SRR15539824;35;40;0.457142857142857;19;16;0.0428571428571429;0.457142857142857
Control.SRR15539824;44;40;0.363636363636364;28;16;0.136363636363636;0.363636363636364
Control.SRR15539824;34;40;0.617647058823529;13;21;0.117647058823529;0.382352941176471
Control.SRR15539824;36;40;0.416666666666667;21;15;0.0833333333333333;0.416666666666667
Control.SRR15539824;36;40;0.5;18;18;0;0.5
Control.SRR15539824;44;40;0.681818181818182;14;30;0.181818181818182;0.318181818181818
Control.SRR15539824;37;40;0.594594594594595;15;22;0.0945945945945946;0.405405405405405
Control.SRR15539824;42;40;0.523809523809524;20;22;0.0238095238095238;0.476190476190476
Control.SRR15539824;40;40;0.55;18;22;0.05;0.45
Control.SRR15539824;38;40;0.552631578947368;17;21;0.0526315789473685;0.447368421052632
Control.SRR15539824;40;40;0.55;18;22;0.05;0.45
Control.SRR15539824;43;40;0.534883720930233;20;23;0.0348837209302325;0.465116279069767
Control.SRR15539824;38;40;0.473684210526316;20;18;0.0263157894736842;0.473684210526316
Control.SRR15539824;37;40;0.621621621621622;14;23;0.121621621621622;0.378378378378378
Control.SRR15539824;38;40;0.736842105263158;10;28;0.236842105263158;0.263157894736842
Control.SRR15539824;35;40;0.4;21;14;0.1;0.4
Control.SRR15539824;36;40;0.527777777777778;17;19;0.0277777777777778;0.472222222222222
Control.SRR15539824;40;40;0.65;14;26;0.15;0.35
Control.SRR15539824;42;40;0.595238095238095;17;25;0.0952380952380952;0.404761904761905
Control.SRR15539824;44;40;0.409090909090909;26;18;0.0909090909090909;0.409090909090909
Control.SRR15539824;34;40;0.617647058823529;13;21;0.117647058823529;0.382352941176471
Control.SRR15539824;42;40;0.595238095238095;17;25;0.0952380952380952;0.404761904761905
Control.SRR15539824;41;40;0.536585365853659;19;22;0.0365853658536586;0.463414634146341
Control.SRR15539824;44;40;0.431818181818182;25;19;0.0681818181818182;0.431818181818182
Control.SRR15539824;40;40;0.65;14;26;0.15;0.35
Control.SRR15539824;34;40;0.411764705882353;20;14;0.0882352941176471;0.411764705882353
Control.SRR15539824;36;40;0.305555555555556;25;11;0.194444444444444;0.305555555555556
Control.SRR15539824;40;40;0.35;26;14;0.15;0.35
Control.SRR15539824;37;40;0.432432432432432;21;16;0.0675675675675675;0.432432432432432
Control.SRR15539824;43;40;0.604651162790698;17;26;0.104651162790698;0.395348837209302
Control.SRR15539824;41;40;0.439024390243902;23;18;0.0609756097560976;0.439024390243902
Control.SRR15539824;34;40;0.470588235294118;18;16;0.0294117647058824;0.470588235294118
Control.SRR15539824;40;40;0.625;15;25;0.125;0.375
Control.SRR15539824;42;40;0.642857142857143;15;27;0.142857142857143;0.357142857142857
Control.SRR15539824;44;40;0.5;22;22;0;0.5
Control.SRR15539824;41;40;0.536585365853659;19;22;0.0365853658536586;0.463414634146341
Control.SRR15539824;36;40;0.583333333333333;15;21;0.0833333333333334;0.416666666666667
Control.SRR15539824;43;40;0.511627906976744;21;22;0.0116279069767442;0.488372093023256
Control.SRR15539824;36;40;0.444444444444444;20;16;0.0555555555555556;0.444444444444444
Control.SRR15539824;43;40;0.441860465116279;24;19;0.0581395348837209;0.441860465116279
Control.SRR15539824;43;40;0.348837209302326;28;15;0.151162790697674;0.348837209302326
Control.SRR15539824;39;40;0.58974358974359;16;23;0.0897435897435898;0.41025641025641
Control.SRR15539824;42;40;0.523809523809524;20;22;0.0238095238095238;0.476190476190476
Control.SRR15539824;38;40;0.342105263157895;25;13;0.157894736842105;0.342105263157895
Control.SRR15539824;42;40;0.476190476190476;22;20;0.0238095238095238;0.476190476190476
Control.SRR15539824;44;40;0.636363636363636;16;28;0.136363636363636;0.363636363636364
Control.SRR15539824;40;40;0.525;19;21;0.025;0.475
Control.SRR15539824;37;40;0.567567567567568;16;21;0.0675675675675675;0.432432432432432
Control.SRR15539824;39;40;0.487179487179487;20;19;0.0128205128205128;0.487179487179487
Control.SRR15539824;42;40;0.642857142857143;15;27;0.142857142857143;0.357142857142857
Control.SRR15539824;41;40;0.51219512195122;20;21;0.0121951219512195;0.48780487804878
Control.SRR15539824;39;40;0.641025641025641;14;25;0.141025641025641;0.358974358974359
Control.SRR15539824;42;40;0.547619047619048;19;23;0.0476190476190477;0.452380952380952
Control.SRR15539824;37;40;0.513513513513513;18;19;0.0135135135135135;0.486486486486487
Control.SRR15539824;38;40;0.473684210526316;20;18;0.0263157894736842;0.473684210526316
Control.SRR15539824;36;40;0.666666666666667;12;24;0.166666666666667;0.333333333333333
Control.SRR15539824;38;40;0.526315789473684;18;20;0.0263157894736842;0.473684210526316
Control.SRR15539824;40;40;0.55;18;22;0.05;0.45
Control.SRR15539824;37;40;0.567567567567568;16;21;0.0675675675675675;0.432432432432432
Control.SRR15539824;39;40;0.512820512820513;19;20;0.0128205128205128;0.487179487179487
Control.SRR15539824;36;40;0.583333333333333;15;21;0.0833333333333334;0.416666666666667
Control.SRR15539824;39;40;0.538461538461538;18;21;0.0384615384615384;0.461538461538462
Control.SRR15539824;38;40;0.342105263157895;25;13;0.157894736842105;0.342105263157895
Control.SRR15539824;39;40;0.41025641025641;23;16;0.0897435897435898;0.41025641025641
Control.SRR15539824;36;40;0.527777777777778;17;19;0.0277777777777778;0.472222222222222
Control.SRR15539824;44;40;0.568181818181818;19;25;0.0681818181818182;0.431818181818182
Control.SRR15539824;44;40;0.409090909090909;26;18;0.0909090909090909;0.409090909090909
Control.SRR15539824;44;40;0.568181818181818;19;25;0.0681818181818182;0.431818181818182
Control.SRR15539824;44;40;0.636363636363636;16;28;0.136363636363636;0.363636363636364
Control.SRR15539824;43;40;0.627906976744186;16;27;0.127906976744186;0.372093023255814
Control.SRR15539824;39;40;0.487179487179487;20;19;0.0128205128205128;0.487179487179487
Control.SRR15539824;42;40;0.595238095238095;17;25;0.0952380952380952;0.404761904761905
Control.SRR15539824;38;40;0.631578947368421;14;24;0.131578947368421;0.368421052631579
Control.SRR15539824;37;40;0.594594594594595;15;22;0.0945945945945946;0.405405405405405
Control.SRR15539824;39;40;0.435897435897436;22;17;0.0641025641025641;0.435897435897436
Control.SRR15539824;36;40;0.472222222222222;19;17;0.0277777777777778;0.472222222222222
Control.SRR15539824;41;40;0.317073170731707;28;13;0.182926829268293;0.317073170731707
Control.SRR15539824;44;40;0.522727272727273;21;23;0.0227272727272727;0.477272727272727
Control.SRR15539824;36;40;0.472222222222222;19;17;0.0277777777777778;0.472222222222222
Control.SRR15539824;39;40;0.564102564102564;17;22;0.0641025641025641;0.435897435897436
Control.SRR15539824;39;40;0.487179487179487;20;19;0.0128205128205128;0.487179487179487
Control.SRR15539824;34;40;0.470588235294118;18;16;0.0294117647058824;0.470588235294118
Control.SRR15539824;43;40;0.581395348837209;18;25;0.0813953488372093;0.418604651162791
Control.SRR15539824;36;40;0.472222222222222;19;17;0.0277777777777778;0.472222222222222
Control.SRR15539824;39;40;0.564102564102564;17;22;0.0641025641025641;0.435897435897436
Control.SRR15539824;35;40;0.485714285714286;18;17;0.0142857142857143;0.485714285714286
Control.SRR15539824;40;40;0.525;19;21;0.025;0.475
Control.SRR15539824;38;40;0.5;19;19;0;0.5
Control.SRR15539824;34;40;0.411764705882353;20;14;0.0882352941176471;0.411764705882353
Control.SRR15539824;40;40;0.425;23;17;0.075;0.425
Control.SRR15539824;43;40;0.558139534883721;19;24;0.0581395348837209;0.441860465116279
Control.SRR15539824;37;40;0.486486486486487;19;18;0.0135135135135135;0.486486486486487
Control.SRR15539824;42;40;0.571428571428571;18;24;0.0714285714285714;0.428571428571429
Control.SRR15539824;44;40;0.545454545454545;20;24;0.0454545454545454;0.454545454545455
Control.SRR15539824;43;40;0.558139534883721;19;24;0.0581395348837209;0.441860465116279
Control.SRR15539824;37;40;0.459459459459459;20;17;0.0405405405405405;0.459459459459459
Control.SRR15539824;35;40;0.485714285714286;18;17;0.0142857142857143;0.485714285714286
Control.SRR15539824;34;40;0.529411764705882;16;18;0.0294117647058824;0.470588235294118
Control.SRR15539824;37;40;0.567567567567568;16;21;0.0675675675675675;0.432432432432432
Control.SRR15539824;39;40;0.435897435897436;22;17;0.0641025641025641;0.435897435897436
Control.SRR15539824;35;40;0.485714285714286;18;17;0.0142857142857143;0.485714285714286
Control.SRR15539824;40;40;0.325;27;13;0.175;0.325
Control.SRR15539824;43;40;0.511627906976744;21;22;0.0116279069767442;0.488372093023256
Control.SRR15539824;44;40;0.522727272727273;21;23;0.0227272727272727;0.477272727272727
Control.SRR15539824;40;40;0.5;20;20;0;0.5
Control.SRR15539824;38;40;0.394736842105263;23;15;0.105263157894737;0.394736842105263
Control.SRR15539824;35;40;0.514285714285714;17;18;0.0142857142857142;0.485714285714286
Control.SRR15539824;34;40;0.470588235294118;18;16;0.0294117647058824;0.470588235294118
Control.SRR15539824;43;40;0.558139534883721;19;24;0.0581395348837209;0.441860465116279
Control.SRR15539824;43;40;0.465116279069767;23;20;0.0348837209302326;0.465116279069767
Control.SRR15539824;41;40;0.536585365853659;19;22;0.0365853658536586;0.463414634146341
Control.SRR15539824;41;40;0.560975609756098;18;23;0.0609756097560976;0.439024390243902
Control.SRR15539824;39;40;0.487179487179487;20;19;0.0128205128205128;0.487179487179487
Control.SRR15539824;38;40;0.447368421052632;21;17;0.0526315789473684;0.447368421052632
Control.SRR15539824;41;40;0.48780487804878;21;20;0.0121951219512195;0.48780487804878
Control.SRR15539824;40;40;0.625;15;25;0.125;0.375
Control.SRR15539824;34;40;0.529411764705882;16;18;0.0294117647058824;0.470588235294118
Control.SRR15539824;39;40;0.435897435897436;22;17;0.0641025641025641;0.435897435897436
Control.SRR15539824;43;40;0.441860465116279;24;19;0.0581395348837209;0.441860465116279
Control.SRR15539824;34;40;0.558823529411765;15;19;0.0588235294117647;0.441176470588235
Control.SRR15539824;39;40;0.615384615384615;15;24;0.115384615384615;0.384615384615385
Control.SRR15539824;41;40;0.341463414634146;27;14;0.158536585365854;0.341463414634146
Control.SRR15539824;39;40;0.512820512820513;19;20;0.0128205128205128;0.487179487179487
Control.SRR15539824;39;40;0.58974358974359;16;23;0.0897435897435898;0.41025641025641
Control.SRR15539824;40;40;0.5;20;20;0;0.5
Control.SRR15539824;38;40;0.526315789473684;18;20;0.0263157894736842;0.473684210526316
Control.SRR15539824;38;40;0.578947368421053;16;22;0.0789473684210527;0.421052631578947
Control.SRR15539824;41;40;0.634146341463415;15;26;0.134146341463415;0.365853658536585
Control.SRR15539824;40;40;0.575;17;23;0.075;0.425
Control.SRR15539824;38;40;0.605263157894737;15;23;0.105263157894737;0.394736842105263
Control.SRR15539824;40;40;0.575;17;23;0.075;0.425
Control.SRR15539824;42;40;0.523809523809524;20;22;0.0238095238095238;0.476190476190476
Control.SRR15539824;40;40;0.475;21;19;0.025;0.475
Control.SRR15539824;38;40;0.421052631578947;22;16;0.0789473684210527;0.421052631578947
Control.SRR15539824;44;40;0.522727272727273;21;23;0.0227272727272727;0.477272727272727
Control.SRR15539824;43;40;0.441860465116279;24;19;0.0581395348837209;0.441860465116279
Control.SRR15539824;37;40;0.459459459459459;20;17;0.0405405405405405;0.459459459459459
Control.SRR15539824;38;40;0.342105263157895;25;13;0.157894736842105;0.342105263157895
Control.SRR15539824;40;40;0.325;27;13;0.175;0.325
Control.SRR15539824;40;40;0.6;16;24;0.1;0.4
Control.SRR15539824;39;40;0.538461538461538;18;21;0.0384615384615384;0.461538461538462
Control.SRR15539824;38;40;0.526315789473684;18;20;0.0263157894736842;0.473684210526316
Control.SRR15539824;41;40;0.51219512195122;20;21;0.0121951219512195;0.48780487804878
Control.SRR15539824;42;40;0.5;21;21;0;0.5
Control.SRR15539824;36;40;0.5;18;18;0;0.5
Control.SRR15539824;40;40;0.35;26;14;0.15;0.35
Control.SRR15539824;36;40;0.472222222222222;19;17;0.0277777777777778;0.472222222222222
Control.SRR15539824;44;40;0.568181818181818;19;25;0.0681818181818182;0.431818181818182
Control.SRR15539824;35;40;0.542857142857143;16;19;0.0428571428571428;0.457142857142857
Control.SRR15539824;36;40;0.416666666666667;21;15;0.0833333333333333;0.416666666666667
Control.SRR15539824;35;40;0.428571428571429;20;15;0.0714285714285715;0.428571428571429
Control.SRR15539824;42;40;0.571428571428571;18;24;0.0714285714285714;0.428571428571429
Control.SRR15539824;44;40;0.590909090909091;18;26;0.0909090909090909;0.409090909090909
Control.SRR15539824;42;40;0.452380952380952;23;19;0.0476190476190476;0.452380952380952
Control.SRR15539824;39;40;0.564102564102564;17;22;0.0641025641025641;0.435897435897436
Control.SRR15539824;41;40;0.48780487804878;21;20;0.0121951219512195;0.48780487804878
Control.SRR15539824;42;40;0.523809523809524;20;22;0.0238095238095238;0.476190476190476
Control.SRR15539824;38;40;0.473684210526316;20;18;0.0263157894736842;0.473684210526316
Control.SRR15539824;37;40;0.432432432432432;21;16;0.0675675675675675;0.432432432432432
Control.SRR15539824;41;40;0.560975609756098;18;23;0.0609756097560976;0.439024390243902
Control.SRR15539824;35;40;0.457142857142857;19;16;0.0428571428571429;0.457142857142857
Control.SRR15539824;35;40;0.457142857142857;19;16;0.0428571428571429;0.457142857142857
Control.SRR15539824;39;40;0.256410256410256;29;10;0.243589743589744;0.256410256410256
Control.SRR15539824;39;40;0.41025641025641;23;16;0.0897435897435898;0.41025641025641
Control.SRR15539824;38;40;0.5;19;19;0;0.5
Control.SRR15539824;35;40;0.571428571428571;15;20;0.0714285714285714;0.428571428571429
Control.SRR15539824;36;40;0.611111111111111;14;22;0.111111111111111;0.388888888888889
Control.SRR15539824;44;40;0.522727272727273;21;23;0.0227272727272727;0.477272727272727
Control.SRR15539824;41;40;0.439024390243902;23;18;0.0609756097560976;0.439024390243902
Control.SRR15539824;36;40;0.416666666666667;21;15;0.0833333333333333;0.416666666666667
Control.SRR15539824;40;40;0.6;16;24;0.1;0.4
Control.SRR15539824;38;40;0.5;19;19;0;0.5
Control.SRR15539824;40;40;0.5;20;20;0;0.5
Control.SRR15539824;37;40;0.513513513513513;18;19;0.0135135135135135;0.486486486486487
Control.SRR15539824;34;40;0.441176470588235;19;15;0.0588235294117647;0.441176470588235
Control.SRR15539824;39;40;0.564102564102564;17;22;0.0641025641025641;0.435897435897436
Control.SRR15539824;43;40;0.581395348837209;18;25;0.0813953488372093;0.418604651162791
Control.SRR15539824;42;40;0.571428571428571;18;24;0.0714285714285714;0.428571428571429
Control.SRR15539824;42;40;0.357142857142857;27;15;0.142857142857143;0.357142857142857
Control.SRR15539824;44;40;0.613636363636364;17;27;0.113636363636364;0.386363636363636
Control.SRR15539824;44;40;0.590909090909091;18;26;0.0909090909090909;0.409090909090909
Control.SRR15539824;42;40;0.523809523809524;20;22;0.0238095238095238;0.476190476190476
Control.SRR15539824;41;40;0.51219512195122;20;21;0.0121951219512195;0.48780487804878
Control.SRR15539824;37;40;0.486486486486487;19;18;0.0135135135135135;0.486486486486487
Control.SRR15539824;40;40;0.45;22;18;0.05;0.45
Control.SRR15539824;40;40;0.675;13;27;0.175;0.325
Control.SRR15539824;41;40;0.414634146341463;24;17;0.0853658536585366;0.414634146341463
Control.SRR15539824;39;40;0.461538461538462;21;18;0.0384615384615384;0.461538461538462
Control.SRR15539824;43;40;0.651162790697674;15;28;0.151162790697674;0.348837209302326
Control.SRR15539824;38;40;0.447368421052632;21;17;0.0526315789473684;0.447368421052632
Control.SRR15539824;34;40;0.352941176470588;22;12;0.147058823529412;0.352941176470588
Control.SRR15539824;35;40;0.571428571428571;15;20;0.0714285714285714;0.428571428571429
Control.SRR15539824;40;40;0.425;23;17;0.075;0.425
Control.SRR15539824;39;40;0.512820512820513;19;20;0.0128205128205128;0.487179487179487
Control.SRR15539824;38;40;0.578947368421053;16;22;0.0789473684210527;0.421052631578947
Control.SRR15539824;34;40;0.411764705882353;20;14;0.0882352941176471;0.411764705882353
Control.SRR15539824;38;40;0.5;19;19;0;0.5
Control.SRR15539824;35;40;0.6;14;21;0.1;0.4
Control.SRR15539824;39;40;0.435897435897436;22;17;0.0641025641025641;0.435897435897436
Control.SRR15539824;37;40;0.513513513513513;18;19;0.0135135135135135;0.486486486486487
Control.SRR15539824;39;40;0.461538461538462;21;18;0.0384615384615384;0.461538461538462
Control.SRR15539824;39;40;0.538461538461538;18;21;0.0384615384615384;0.461538461538462
Control.SRR15539824;43;40;0.441860465116279;24;19;0.0581395348837209;0.441860465116279
Control.SRR15539824;40;40;0.5;20;20;0;0.5
Control.SRR15539824;37;40;0.540540540540541;17;20;0.0405405405405406;0.459459459459459
Control.SRR15539824;37;40;0.594594594594595;15;22;0.0945945945945946;0.405405405405405
Control.SRR15539824;37;40;0.405405405405405;22;15;0.0945945945945946;0.405405405405405
Control.SRR15539824;44;40;0.545454545454545;20;24;0.0454545454545454;0.454545454545455
Control.SRR15539824;37;40;0.540540540540541;17;20;0.0405405405405406;0.459459459459459
Control.SRR15539824;44;40;0.545454545454545;20;24;0.0454545454545454;0.454545454545455
Control.SRR15539824;36;40;0.527777777777778;17;19;0.0277777777777778;0.472222222222222
Control.SRR15539824;38;40;0.657894736842105;13;25;0.157894736842105;0.342105263157895
Control.SRR15539824;41;40;0.341463414634146;27;14;0.158536585365854;0.341463414634146
Control.SRR15539824;37;40;0.513513513513513;18;19;0.0135135135135135;0.486486486486487
Control.SRR15539824;43;40;0.488372093023256;22;21;0.0116279069767442;0.488372093023256
Control.SRR15539824;35;40;0.6;14;21;0.1;0.4
Control.SRR15539824;42;40;0.404761904761905;25;17;0.0952380952380952;0.404761904761905
Control.SRR15539824;41;40;0.317073170731707;28;13;0.182926829268293;0.317073170731707
Control.SRR15539824;38;40;0.447368421052632;21;17;0.0526315789473684;0.447368421052632
Control.SRR15539824;34;40;0.5;17;17;0;0.5
Control.SRR15539824;39;40;0.666666666666667;13;26;0.166666666666667;0.333333333333333
Control.SRR15539824;40;40;0.6;16;24;0.1;0.4
Control.SRR15539824;35;40;0.514285714285714;17;18;0.0142857142857142;0.485714285714286
Control.SRR15539824;37;40;0.432432432432432;21;16;0.0675675675675675;0.432432432432432
Control.SRR15539824;40;40;0.45;22;18;0.05;0.45
Control.SRR15539824;38;40;0.526315789473684;18;20;0.0263157894736842;0.473684210526316
Control.SRR15539824;40;40;0.575;17;23;0.075;0.425
Control.SRR15539824;43;40;0.534883720930233;20;23;0.0348837209302325;0.465116279069767
Control.SRR15539824;43;40;0.534883720930233;20;23;0.0348837209302325;0.465116279069767
Control.SRR15539824;38;40;0.368421052631579;24;14;0.131578947368421;0.368421052631579
Control.SRR15539824;35;40;0.571428571428571;15;20;0.0714285714285714;0.428571428571429
Control.SRR15539824;41;40;0.536585365853659;19;22;0.0365853658536586;0.463414634146341
Control.SRR15539824;44;40;0.431818181818182;25;19;0.0681818181818182;0.431818181818182
Control.SRR15539824;43;40;0.465116279069767;23;20;0.0348837209302326;0.465116279069767
Control.SRR15539824;42;40;0.404761904761905;25;17;0.0952380952380952;0.404761904761905
Control.SRR15539824;34;40;0.676470588235294;11;23;0.176470588235294;0.323529411764706
Control.SRR15539824;36;40;0.444444444444444;20;16;0.0555555555555556;0.444444444444444
Control.SRR15539824;41;40;0.341463414634146;27;14;0.158536585365854;0.341463414634146
Control.SRR15539824;40;40;0.5;20;20;0;0.5
Control.SRR15539824;44;40;0.409090909090909;26;18;0.0909090909090909;0.409090909090909
Control.SRR15539824;39;40;0.58974358974359;16;23;0.0897435897435898;0.41025641025641
Control.SRR15539824;37;40;0.540540540540541;17;20;0.0405405405405406;0.459459459459459
Control.SRR15539824;36;40;0.472222222222222;19;17;0.0277777777777778;0.472222222222222
Control.SRR15539824;44;40;0.386363636363636;27;17;0.113636363636364;0.386363636363636
Control.SRR15539824;40;40;0.6;16;24;0.1;0.4
Control.SRR15539824;42;40;0.428571428571429;24;18;0.0714285714285715;0.428571428571429
Control.SRR15539824;44;40;0.545454545454545;20;24;0.0454545454545454;0.454545454545455
Control.SRR15539824;35;40;0.542857142857143;16;19;0.0428571428571428;0.457142857142857
Control.SRR15539824;37;40;0.594594594594595;15;22;0.0945945945945946;0.405405405405405
Control.SRR15539824;44;40;0.545454545454545;20;24;0.0454545454545454;0.454545454545455
Control.SRR15539824;42;40;0.523809523809524;20;22;0.0238095238095238;0.476190476190476
Control.SRR15539824;39;40;0.538461538461538;18;21;0.0384615384615384;0.461538461538462
Control.SRR15539824;38;40;0.605263157894737;15;23;0.105263157894737;0.394736842105263
Control.SRR15539824;41;40;0.609756097560976;16;25;0.109756097560976;0.390243902439024
Control.SRR15539824;39;40;0.538461538461538;18;21;0.0384615384615384;0.461538461538462
Control.SRR15539824;38;40;0.5;19;19;0;0.5
Control.SRR15539824;43;40;0.441860465116279;24;19;0.0581395348837209;0.441860465116279
Control.SRR15539824;39;40;0.564102564102564;17;22;0.0641025641025641;0.435897435897436
Control.SRR15539824;36;40;0.555555555555556;16;20;0.0555555555555556;0.444444444444444
Control.SRR15539824;43;40;0.511627906976744;21;22;0.0116279069767442;0.488372093023256
Control.SRR15539824;44;40;0.545454545454545;20;24;0.0454545454545454;0.454545454545455
Control.SRR15539824;42;40;0.476190476190476;22;20;0.0238095238095238;0.476190476190476
Control.SRR15539824;35;40;0.485714285714286;18;17;0.0142857142857143;0.485714285714286
Control.SRR15539824;38;40;0.473684210526316;20;18;0.0263157894736842;0.473684210526316
Control.SRR15539824;39;40;0.461538461538462;21;18;0.0384615384615384;0.461538461538462
Control.SRR15539824;42;40;0.476190476190476;22;20;0.0238095238095238;0.476190476190476
Control.SRR15539824;44;40;0.522727272727273;21;23;0.0227272727272727;0.477272727272727
Control.SRR15539824;43;40;0.418604651162791;25;18;0.0813953488372093;0.418604651162791
Control.SRR15539824;40;40;0.45;22;18;0.05;0.45
Control.SRR15539824;36;40;0.555555555555556;16;20;0.0555555555555556;0.444444444444444
Control.SRR15539824;41;40;0.609756097560976;16;25;0.109756097560976;0.390243902439024
Control.SRR15539824;41;40;0.390243902439024;25;16;0.109756097560976;0.390243902439024
Control.SRR15539824;38;40;0.5;19;19;0;0.5
Control.SRR15539824;39;40;0.487179487179487;20;19;0.0128205128205128;0.487179487179487
Control.SRR15539824;35;40;0.428571428571429;20;15;0.0714285714285715;0.428571428571429
Control.SRR15539824;35;40;0.371428571428571;22;13;0.128571428571429;0.371428571428571
Control.SRR15539824;39;40;0.512820512820513;19;20;0.0128205128205128;0.487179487179487
Control.SRR15539824;41;40;0.658536585365854;14;27;0.158536585365854;0.341463414634146
Control.SRR15539824;39;40;0.512820512820513;19;20;0.0128205128205128;0.487179487179487
Control.SRR15539824;37;40;0.432432432432432;21;16;0.0675675675675675;0.432432432432432
Control.SRR15539824;36;40;0.416666666666667;21;15;0.0833333333333333;0.416666666666667
Control.SRR15539824;36;40;0.611111111111111;14;22;0.111111111111111;0.388888888888889
Control.SRR15539824;42;40;0.5;21;21;0;0.5
Control.SRR15539824;38;40;0.5;19;19;0;0.5
Control.SRR15539824;43;40;0.604651162790698;17;26;0.104651162790698;0.395348837209302
Control.SRR15539824;40;40;0.3;28;12;0.2;0.3
Control.SRR15539824;35;40;0.628571428571429;13;22;0.128571428571429;0.371428571428571
Control.SRR15539824;35;40;0.542857142857143;16;19;0.0428571428571428;0.457142857142857
Control.SRR15539824;36;40;0.527777777777778;17;19;0.0277777777777778;0.472222222222222
Control.SRR15539824;38;40;0.447368421052632;21;17;0.0526315789473684;0.447368421052632
Control.SRR15539824;43;40;0.488372093023256;22;21;0.0116279069767442;0.488372093023256
Control.SRR15539824;34;40;0.5;17;17;0;0.5
Control.SRR15539824;34;40;0.352941176470588;22;12;0.147058823529412;0.352941176470588
Control.SRR15539824;37;40;0.513513513513513;18;19;0.0135135135135135;0.486486486486487
Control.SRR15539824;41;40;0.365853658536585;26;15;0.134146341463415;0.365853658536585
Control.SRR15539824;44;40;0.613636363636364;17;27;0.113636363636364;0.386363636363636
Control.SRR15539824;36;40;0.444444444444444;20;16;0.0555555555555556;0.444444444444444
Control.SRR15539824;38;40;0.5;19;19;0;0.5
Control.SRR15539824;34;40;0.323529411764706;23;11;0.176470588235294;0.323529411764706
Control.SRR15539824;34;40;0.5;17;17;0;0.5
Control.SRR15539824;39;40;0.41025641025641;23;16;0.0897435897435898;0.41025641025641
Control.SRR15539824;39;40;0.538461538461538;18;21;0.0384615384615384;0.461538461538462
Control.SRR15539824;37;40;0.486486486486487;19;18;0.0135135135135135;0.486486486486487
Control.SRR15539824;36;40;0.5;18;18;0;0.5
Control.SRR15539824;37;40;0.567567567567568;16;21;0.0675675675675675;0.432432432432432
Control.SRR15539824;35;40;0.457142857142857;19;16;0.0428571428571429;0.457142857142857
Control.SRR15539824;36;40;0.5;18;18;0;0.5
Control.SRR15539824;37;40;0.378378378378378;23;14;0.121621621621622;0.378378378378378
Control.SRR15539824;40;40;0.65;14;26;0.15;0.35
Control.SRR15539824;38;40;0.526315789473684;18;20;0.0263157894736842;0.473684210526316
Control.SRR15539824;38;40;0.526315789473684;18;20;0.0263157894736842;0.473684210526316
Control.SRR15539824;43;40;0.558139534883721;19;24;0.0581395348837209;0.441860465116279
Control.SRR15539824;42;40;0.30952380952381;29;13;0.19047619047619;0.30952380952381
Control.SRR15539824;40;40;0.5;20;20;0;0.5
Control.SRR15539824;38;40;0.657894736842105;13;25;0.157894736842105;0.342105263157895
Control.SRR15539824;41;40;0.365853658536585;26;15;0.134146341463415;0.365853658536585
Control.SRR15539824;35;40;0.542857142857143;16;19;0.0428571428571428;0.457142857142857
Control.SRR15539824;42;40;0.452380952380952;23;19;0.0476190476190476;0.452380952380952
Control.SRR15539824;44;40;0.5;22;22;0;0.5
Control.SRR15539824;39;40;0.461538461538462;21;18;0.0384615384615384;0.461538461538462
Control.SRR15539824;38;40;0.473684210526316;20;18;0.0263157894736842;0.473684210526316
Control.SRR15539824;43;40;0.581395348837209;18;25;0.0813953488372093;0.418604651162791
Control.SRR15539824;36;40;0.583333333333333;15;21;0.0833333333333334;0.416666666666667
Control.SRR15539824;39;40;0.461538461538462;21;18;0.0384615384615384;0.461538461538462
Control.SRR15539824;39;40;0.564102564102564;17;22;0.0641025641025641;0.435897435897436
Control.SRR15539824;35;40;0.485714285714286;18;17;0.0142857142857143;0.485714285714286
Control.SRR15539824;36;40;0.444444444444444;20;16;0.0555555555555556;0.444444444444444
Control.SRR15539824;42;40;0.452380952380952;23;19;0.0476190476190476;0.452380952380952
Control.SRR15539824;35;40;0.485714285714286;18;17;0.0142857142857143;0.485714285714286
Control.SRR15539824;39;40;0.564102564102564;17;22;0.0641025641025641;0.435897435897436
Control.SRR15539824;40;40;0.325;27;13;0.175;0.325
Control.SRR15539824;43;40;0.395348837209302;26;17;0.104651162790698;0.395348837209302
Control.SRR15539824;43;40;0.534883720930233;20;23;0.0348837209302325;0.465116279069767
Control.SRR15539824;39;40;0.538461538461538;18;21;0.0384615384615384;0.461538461538462
Control.SRR15539824;40;40;0.4;24;16;0.1;0.4
Control.SRR15539824;42;40;0.523809523809524;20;22;0.0238095238095238;0.476190476190476
Control.SRR15539824;40;40;0.375;25;15;0.125;0.375
Control.SRR15539824;44;40;0.318181818181818;30;14;0.181818181818182;0.318181818181818
Control.SRR15539824;35;40;0.571428571428571;15;20;0.0714285714285714;0.428571428571429
Control.SRR15539824;40;40;0.35;26;14;0.15;0.35
Control.SRR15539824;41;40;0.463414634146341;22;19;0.0365853658536585;0.463414634146341
Control.SRR15539824;39;40;0.487179487179487;20;19;0.0128205128205128;0.487179487179487
Control.SRR15539824;38;40;0.473684210526316;20;18;0.0263157894736842;0.473684210526316
Control.SRR15539824;36;40;0.527777777777778;17;19;0.0277777777777778;0.472222222222222
Control.SRR15539824;37;40;0.459459459459459;20;17;0.0405405405405405;0.459459459459459
Control.SRR15539824;43;40;0.465116279069767;23;20;0.0348837209302326;0.465116279069767
Control.SRR15539824;39;40;0.512820512820513;19;20;0.0128205128205128;0.487179487179487
Control.SRR15539824;43;40;0.558139534883721;19;24;0.0581395348837209;0.441860465116279
Control.SRR15539824;34;40;0.5;17;17;0;0.5
Control.SRR15539824;43;40;0.558139534883721;19;24;0.0581395348837209;0.441860465116279
Control.SRR15539824;36;40;0.472222222222222;19;17;0.0277777777777778;0.472222222222222
Control.SRR15539824;40;40;0.525;19;21;0.025;0.475
Control.SRR15539824;43;40;0.558139534883721;19;24;0.0581395348837209;0.441860465116279
Control.SRR15539824;36;40;0.5;18;18;0;0.5
Control.SRR15539824;43;40;0.534883720930233;20;23;0.0348837209302325;0.465116279069767
Control.SRR15539824;40;40;0.525;19;21;0.025;0.475
Control.SRR15539824;43;40;0.395348837209302;26;17;0.104651162790698;0.395348837209302
Control.SRR15539824;38;40;0.5;19;19;0;0.5
Control.SRR15539824;38;40;0.578947368421053;16;22;0.0789473684210527;0.421052631578947
Control.SRR15539824;44;40;0.545454545454545;20;24;0.0454545454545454;0.454545454545455
Control.SRR15539824;40;40;0.475;21;19;0.025;0.475
Control.SRR15539824;39;40;0.41025641025641;23;16;0.0897435897435898;0.41025641025641
Control.SRR15539824;41;40;0.51219512195122;20;21;0.0121951219512195;0.48780487804878
Control.SRR15539824;39;40;0.564102564102564;17;22;0.0641025641025641;0.435897435897436
Control.SRR15539824;39;40;0.487179487179487;20;19;0.0128205128205128;0.487179487179487
Control.SRR15539824;43;40;0.441860465116279;24;19;0.0581395348837209;0.441860465116279
Control.SRR15539824;40;40;0.4;24;16;0.1;0.4
Control.SRR15539824;42;40;0.523809523809524;20;22;0.0238095238095238;0.476190476190476
Control.SRR15539824;40;40;0.45;22;18;0.05;0.45
Control.SRR15539824;42;40;0.333333333333333;28;14;0.166666666666667;0.333333333333333
Control.SRR15539824;43;40;0.488372093023256;22;21;0.0116279069767442;0.488372093023256
Control.SRR15539824;38;40;0.526315789473684;18;20;0.0263157894736842;0.473684210526316
Control.SRR15539824;42;40;0.30952380952381;29;13;0.19047619047619;0.30952380952381
Control.SRR15539824;41;40;0.463414634146341;22;19;0.0365853658536585;0.463414634146341
Control.SRR15539824;37;40;0.432432432432432;21;16;0.0675675675675675;0.432432432432432
Control.SRR15539824;35;40;0.628571428571429;13;22;0.128571428571429;0.371428571428571
Control.SRR15539824;39;40;0.461538461538462;21;18;0.0384615384615384;0.461538461538462
Control.SRR15539824;43;40;0.511627906976744;21;22;0.0116279069767442;0.488372093023256
Control.SRR15539824;41;40;0.634146341463415;15;26;0.134146341463415;0.365853658536585
Control.SRR15539824;41;40;0.560975609756098;18;23;0.0609756097560976;0.439024390243902
Control.SRR15539824;41;40;0.51219512195122;20;21;0.0121951219512195;0.48780487804878
Control.SRR15539824;35;40;0.428571428571429;20;15;0.0714285714285715;0.428571428571429
Control.SRR15539824;44;40;0.5;22;22;0;0.5
Control.SRR15539824;39;40;0.461538461538462;21;18;0.0384615384615384;0.461538461538462
Control.SRR15539824;39;40;0.538461538461538;18;21;0.0384615384615384;0.461538461538462
Control.SRR15539824;40;40;0.475;21;19;0.025;0.475
Control.SRR15539824;44;40;0.613636363636364;17;27;0.113636363636364;0.386363636363636
Control.SRR15539824;39;40;0.358974358974359;25;14;0.141025641025641;0.358974358974359
Control.SRR15539824;40;40;0.575;17;23;0.075;0.425
Control.SRR15539824;42;40;0.571428571428571;18;24;0.0714285714285714;0.428571428571429
Control.SRR15539824;34;40;0.441176470588235;19;15;0.0588235294117647;0.441176470588235
Control.SRR15539824;36;40;0.416666666666667;21;15;0.0833333333333333;0.416666666666667
Control.SRR15539824;35;40;0.342857142857143;23;12;0.157142857142857;0.342857142857143
Control.SRR15539824;44;40;0.454545454545455;24;20;0.0454545454545455;0.454545454545455
Control.SRR15539824;42;40;0.428571428571429;24;18;0.0714285714285715;0.428571428571429
Control.SRR15539824;35;40;0.685714285714286;11;24;0.185714285714286;0.314285714285714
Control.SRR15539824;36;40;0.527777777777778;17;19;0.0277777777777778;0.472222222222222
Control.SRR15539824;37;40;0.513513513513513;18;19;0.0135135135135135;0.486486486486487
Control.SRR15539824;40;40;0.625;15;25;0.125;0.375
Control.SRR15539824;42;40;0.571428571428571;18;24;0.0714285714285714;0.428571428571429
Control.SRR15539824;40;40;0.55;18;22;0.05;0.45
Control.SRR15539824;38;40;0.526315789473684;18;20;0.0263157894736842;0.473684210526316
Control.SRR15539824;44;40;0.477272727272727;23;21;0.0227272727272727;0.477272727272727
Control.SRR15539824;36;40;0.583333333333333;15;21;0.0833333333333334;0.416666666666667
Control.SRR15539824;39;40;0.461538461538462;21;18;0.0384615384615384;0.461538461538462
Control.SRR15539824;40;40;0.55;18;22;0.05;0.45
Control.SRR15539824;41;40;0.439024390243902;23;18;0.0609756097560976;0.439024390243902
Control.SRR15539824;43;40;0.441860465116279;24;19;0.0581395348837209;0.441860465116279
Control.SRR15539824;34;40;0.411764705882353;20;14;0.0882352941176471;0.411764705882353
Control.SRR15539824;39;40;0.615384615384615;15;24;0.115384615384615;0.384615384615385
Control.SRR15539824;39;40;0.666666666666667;13;26;0.166666666666667;0.333333333333333
Control.SRR15539824;38;40;0.473684210526316;20;18;0.0263157894736842;0.473684210526316
Control.SRR15539824;38;40;0.552631578947368;17;21;0.0526315789473685;0.447368421052632
Control.SRR15539824;42;40;0.5;21;21;0;0.5
Control.SRR15539824;35;40;0.428571428571429;20;15;0.0714285714285715;0.428571428571429
Control.SRR15539824;36;40;0.555555555555556;16;20;0.0555555555555556;0.444444444444444
Control.SRR15539824;36;40;0.611111111111111;14;22;0.111111111111111;0.388888888888889
Control.SRR15539824;43;40;0.674418604651163;14;29;0.174418604651163;0.325581395348837
Control.SRR15539824;38;40;0.421052631578947;22;16;0.0789473684210527;0.421052631578947
Control.SRR15539824;37;40;0.621621621621622;14;23;0.121621621621622;0.378378378378378
Control.SRR15539824;41;40;0.463414634146341;22;19;0.0365853658536585;0.463414634146341
Control.SRR15539824;36;40;0.444444444444444;20;16;0.0555555555555556;0.444444444444444
Control.SRR15539824;38;40;0.578947368421053;16;22;0.0789473684210527;0.421052631578947
Control.SRR15539824;38;40;0.578947368421053;16;22;0.0789473684210527;0.421052631578947
Control.SRR15539824;36;40;0.527777777777778;17;19;0.0277777777777778;0.472222222222222
Control.SRR15539824;35;40;0.514285714285714;17;18;0.0142857142857142;0.485714285714286
Control.SRR15539824;36;40;0.527777777777778;17;19;0.0277777777777778;0.472222222222222
Control.SRR15539824;44;40;0.431818181818182;25;19;0.0681818181818182;0.431818181818182
Control.SRR15539824;38;40;0.421052631578947;22;16;0.0789473684210527;0.421052631578947
Control.SRR15539824;36;40;0.611111111111111;14;22;0.111111111111111;0.388888888888889
Control.SRR15539824;35;40;0.514285714285714;17;18;0.0142857142857142;0.485714285714286
Control.SRR15539824;44;40;0.545454545454545;20;24;0.0454545454545454;0.454545454545455
Control.SRR15539824;38;40;0.657894736842105;13;25;0.157894736842105;0.342105263157895
Control.SRR15539824;38;40;0.447368421052632;21;17;0.0526315789473684;0.447368421052632
Control.SRR15539824;43;40;0.418604651162791;25;18;0.0813953488372093;0.418604651162791
Control.SRR15539824;34;40;0.441176470588235;19;15;0.0588235294117647;0.441176470588235
Control.SRR15539824;40;40;0.625;15;25;0.125;0.375
Control.SRR15539824;43;40;0.488372093023256;22;21;0.0116279069767442;0.488372093023256
Control.SRR15539824;35;40;0.542857142857143;16;19;0.0428571428571428;0.457142857142857
Control.SRR15539824;38;40;0.578947368421053;16;22;0.0789473684210527;0.421052631578947
Control.SRR15539824;34;40;0.441176470588235;19;15;0.0588235294117647;0.441176470588235
Control.SRR15539824;40;40;0.575;17;23;0.075;0.425
Control.SRR15539824;38;40;0.578947368421053;16;22;0.0789473684210527;0.421052631578947
Control.SRR15539824;37;40;0.567567567567568;16;21;0.0675675675675675;0.432432432432432
Control.SRR15539824;37;40;0.567567567567568;16;21;0.0675675675675675;0.432432432432432
Control.SRR15539824;42;40;0.523809523809524;20;22;0.0238095238095238;0.476190476190476
Control.SRR15539824;38;40;0.526315789473684;18;20;0.0263157894736842;0.473684210526316
Control.SRR15539824;40;40;0.5;20;20;0;0.5
Control.SRR15539824;36;40;0.5;18;18;0;0.5
Control.SRR15539824;35;40;0.571428571428571;15;20;0.0714285714285714;0.428571428571429
Control.SRR15539824;37;40;0.459459459459459;20;17;0.0405405405405405;0.459459459459459
Control.SRR15539824;37;40;0.513513513513513;18;19;0.0135135135135135;0.486486486486487
Control.SRR15539824;37;40;0.621621621621622;14;23;0.121621621621622;0.378378378378378
Control.SRR15539824;39;40;0.358974358974359;25;14;0.141025641025641;0.358974358974359
Control.SRR15539824;43;40;0.558139534883721;19;24;0.0581395348837209;0.441860465116279
Control.SRR15539824;40;40;0.45;22;18;0.05;0.45
Control.SRR15539824;46;40;0.478260869565217;24;22;0.0217391304347826;0.478260869565217
Control.SRR15539824;49;40;0.408163265306122;29;20;0.0918367346938775;0.408163265306122
Control.SRR15539824;44;40;0.409090909090909;26;18;0.0909090909090909;0.409090909090909
Control.SRR15539824;40;40;0.475;21;19;0.025;0.475
Control.SRR15539824;39;40;0.41025641025641;23;16;0.0897435897435898;0.41025641025641
Control.SRR15539824;41;40;0.463414634146341;22;19;0.0365853658536585;0.463414634146341
Control.SRR15539824;43;40;0.534883720930233;20;23;0.0348837209302325;0.465116279069767
Control.SRR15539824;38;40;0.552631578947368;17;21;0.0526315789473685;0.447368421052632
Control.SRR15539824;46;40;0.369565217391304;29;17;0.130434782608696;0.369565217391304
Control.SRR15539824;46;40;0.565217391304348;20;26;0.0652173913043478;0.434782608695652
Control.SRR15539824;43;40;0.627906976744186;16;27;0.127906976744186;0.372093023255814
Control.SRR15539824;40;40;0.6;16;24;0.1;0.4
Control.SRR15539824;50;40;0.56;22;28;0.0600000000000001;0.44
Control.SRR15539824;41;40;0.536585365853659;19;22;0.0365853658536586;0.463414634146341
Control.SRR15539824;39;40;0.58974358974359;16;23;0.0897435897435898;0.41025641025641
Control.SRR15539824;44;40;0.409090909090909;26;18;0.0909090909090909;0.409090909090909
Control.SRR15539824;42;40;0.476190476190476;22;20;0.0238095238095238;0.476190476190476
Control.SRR15539824;41;40;0.560975609756098;18;23;0.0609756097560976;0.439024390243902
Control.SRR15539824;39;40;0.487179487179487;20;19;0.0128205128205128;0.487179487179487
Control.SRR15539824;43;40;0.488372093023256;22;21;0.0116279069767442;0.488372093023256
Control.SRR15539824;43;40;0.441860465116279;24;19;0.0581395348837209;0.441860465116279
Control.SRR15539824;42;40;0.523809523809524;20;22;0.0238095238095238;0.476190476190476
Control.SRR15539824;46;40;0.434782608695652;26;20;0.0652173913043478;0.434782608695652
Control.SRR15539824;40;40;0.6;16;24;0.1;0.4
Control.SRR15539824;45;40;0.688888888888889;14;31;0.188888888888889;0.311111111111111
Control.SRR15539824;44;40;0.522727272727273;21;23;0.0227272727272727;0.477272727272727
Control.SRR15539824;45;40;0.422222222222222;26;19;0.0777777777777778;0.422222222222222
Control.SRR15539824;45;40;0.466666666666667;24;21;0.0333333333333333;0.466666666666667
Control.SRR15539824;50;40;0.46;27;23;0.04;0.46
Control.SRR15539824;42;40;0.523809523809524;20;22;0.0238095238095238;0.476190476190476
Control.SRR15539824;44;40;0.5;22;22;0;0.5
Control.SRR15539824;43;40;0.395348837209302;26;17;0.104651162790698;0.395348837209302
Control.SRR15539824;39;40;0.461538461538462;21;18;0.0384615384615384;0.461538461538462
Control.SRR15539824;46;40;0.521739130434783;22;24;0.0217391304347826;0.478260869565217
Control.SRR15539824;44;40;0.522727272727273;21;23;0.0227272727272727;0.477272727272727
Control.SRR15539824;42;40;0.595238095238095;17;25;0.0952380952380952;0.404761904761905
Control.SRR15539824;39;40;0.461538461538462;21;18;0.0384615384615384;0.461538461538462
Control.SRR15539824;48;40;0.541666666666667;22;26;0.0416666666666666;0.458333333333333
Control.SRR15539824;46;40;0.565217391304348;20;26;0.0652173913043478;0.434782608695652
Control.SRR15539824;50;40;0.42;29;21;0.08;0.42
Control.SRR15539824;40;40;0.5;20;20;0;0.5
Control.SRR15539824;40;40;0.425;23;17;0.075;0.425
Control.SRR15539824;40;40;0.45;22;18;0.05;0.45
Control.SRR15539824;49;40;0.285714285714286;35;14;0.214285714285714;0.285714285714286
Control.SRR15539824;41;40;0.439024390243902;23;18;0.0609756097560976;0.439024390243902
Control.SRR15539824;49;40;0.571428571428571;21;28;0.0714285714285714;0.428571428571429
Control.SRR15539824;39;40;0.641025641025641;14;25;0.141025641025641;0.358974358974359
Control.SRR15539824;49;40;0.408163265306122;29;20;0.0918367346938775;0.408163265306122
Control.SRR15539824;46;40;0.58695652173913;19;27;0.0869565217391305;0.41304347826087
Control.SRR15539824;46;40;0.521739130434783;22;24;0.0217391304347826;0.478260869565217
Control.SRR15539824;41;40;0.51219512195122;20;21;0.0121951219512195;0.48780487804878
Control.SRR15539824;40;40;0.475;21;19;0.025;0.475
Control.SRR15539824;48;40;0.354166666666667;31;17;0.145833333333333;0.354166666666667
Control.SRR15539824;41;40;0.560975609756098;18;23;0.0609756097560976;0.439024390243902
Control.SRR15539824;42;40;0.619047619047619;16;26;0.119047619047619;0.380952380952381
Control.SRR15539824;45;40;0.466666666666667;24;21;0.0333333333333333;0.466666666666667
Control.SRR15539824;41;40;0.658536585365854;14;27;0.158536585365854;0.341463414634146
Control.SRR15539824;38;40;0.631578947368421;14;24;0.131578947368421;0.368421052631579
Control.SRR15539824;38;40;0.657894736842105;13;25;0.157894736842105;0.342105263157895
Control.SRR15539824;42;40;0.547619047619048;19;23;0.0476190476190477;0.452380952380952
Control.SRR15539824;38;40;0.552631578947368;17;21;0.0526315789473685;0.447368421052632
Control.SRR15539824;40;40;0.525;19;21;0.025;0.475
Control.SRR15539824;38;40;0.421052631578947;22;16;0.0789473684210527;0.421052631578947
Control.SRR15539824;44;40;0.409090909090909;26;18;0.0909090909090909;0.409090909090909
Control.SRR15539824;45;40;0.577777777777778;19;26;0.0777777777777777;0.422222222222222
Control.SRR15539824;45;40;0.466666666666667;24;21;0.0333333333333333;0.466666666666667
Control.SRR15539824;45;40;0.555555555555556;20;25;0.0555555555555556;0.444444444444444
Control.SRR15539824;49;40;0.551020408163265;22;27;0.0510204081632653;0.448979591836735
Control.SRR15539824;47;40;0.553191489361702;21;26;0.0531914893617021;0.446808510638298
Control.SRR15539824;46;40;0.434782608695652;26;20;0.0652173913043478;0.434782608695652
Control.SRR15539824;38;40;0.394736842105263;23;15;0.105263157894737;0.394736842105263
Control.SRR15539824;39;40;0.615384615384615;15;24;0.115384615384615;0.384615384615385
Control.SRR15539824;41;40;0.24390243902439;31;10;0.25609756097561;0.24390243902439
Control.SRR15539824;47;40;0.468085106382979;25;22;0.0319148936170213;0.468085106382979
Control.SRR15539824;40;40;0.45;22;18;0.05;0.45
Control.SRR15539824;47;40;0.468085106382979;25;22;0.0319148936170213;0.468085106382979
Control.SRR15539824;40;40;0.5;20;20;0;0.5
Control.SRR15539824;42;40;0.595238095238095;17;25;0.0952380952380952;0.404761904761905
Control.SRR15539824;43;40;0.418604651162791;25;18;0.0813953488372093;0.418604651162791
Control.SRR15539824;48;40;0.458333333333333;26;22;0.0416666666666667;0.458333333333333
Control.SRR15539824;42;40;0.476190476190476;22;20;0.0238095238095238;0.476190476190476
Control.SRR15539824;44;40;0.363636363636364;28;16;0.136363636363636;0.363636363636364
Control.SRR15539824;50;40;0.42;29;21;0.08;0.42
Control.SRR15539824;38;40;0.473684210526316;20;18;0.0263157894736842;0.473684210526316
Control.SRR15539824;45;40;0.466666666666667;24;21;0.0333333333333333;0.466666666666667
Control.SRR15539824;38;40;0.605263157894737;15;23;0.105263157894737;0.394736842105263
Control.SRR15539824;45;40;0.422222222222222;26;19;0.0777777777777778;0.422222222222222
Control.SRR15539824;39;40;0.538461538461538;18;21;0.0384615384615384;0.461538461538462
Control.SRR15539824;38;40;0.447368421052632;21;17;0.0526315789473684;0.447368421052632
Control.SRR15539824;45;40;0.444444444444444;25;20;0.0555555555555556;0.444444444444444
Control.SRR15539824;40;40;0.45;22;18;0.05;0.45
Control.SRR15539824;38;40;0.447368421052632;21;17;0.0526315789473684;0.447368421052632
Control.SRR15539824;50;40;0.48;26;24;0.02;0.48
Control.SRR15539824;38;40;0.526315789473684;18;20;0.0263157894736842;0.473684210526316
Control.SRR15539824;39;40;0.41025641025641;23;16;0.0897435897435898;0.41025641025641
Control.SRR15539824;40;40;0.6;16;24;0.1;0.4
Control.SRR15539824;48;40;0.4375;27;21;0.0625;0.4375
Control.SRR15539824;44;40;0.545454545454545;20;24;0.0454545454545454;0.454545454545455
Control.SRR15539824;47;40;0.468085106382979;25;22;0.0319148936170213;0.468085106382979
Control.SRR15539824;38;40;0.552631578947368;17;21;0.0526315789473685;0.447368421052632
Control.SRR15539824;47;40;0.361702127659574;30;17;0.138297872340426;0.361702127659574
Control.SRR15539824;47;40;0.553191489361702;21;26;0.0531914893617021;0.446808510638298
Control.SRR15539824;44;40;0.545454545454545;20;24;0.0454545454545454;0.454545454545455
Control.SRR15539824;50;40;0.5;25;25;0;0.5
Control.SRR15539824;39;40;0.384615384615385;24;15;0.115384615384615;0.384615384615385
Control.SRR15539824;45;40;0.488888888888889;23;22;0.0111111111111111;0.488888888888889
Control.SRR15539824;43;40;0.604651162790698;17;26;0.104651162790698;0.395348837209302
Control.SRR15539824;41;40;0.51219512195122;20;21;0.0121951219512195;0.48780487804878
Control.SRR15539824;45;40;0.533333333333333;21;24;0.0333333333333333;0.466666666666667
Control.SRR15539824;44;40;0.5;22;22;0;0.5
Control.SRR15539824;50;40;0.52;24;26;0.02;0.48
Control.SRR15539824;48;40;0.5;24;24;0;0.5
Control.SRR15539824;44;40;0.363636363636364;28;16;0.136363636363636;0.363636363636364
Control.SRR15539824;45;40;0.488888888888889;23;22;0.0111111111111111;0.488888888888889
Control.SRR15539824;43;40;0.511627906976744;21;22;0.0116279069767442;0.488372093023256
Control.SRR15539824;41;40;0.585365853658537;17;24;0.0853658536585366;0.414634146341463
Control.SRR15539824;40;40;0.475;21;19;0.025;0.475
Control.SRR15539824;47;40;0.574468085106383;20;27;0.074468085106383;0.425531914893617
Control.SRR15539824;41;40;0.48780487804878;21;20;0.0121951219512195;0.48780487804878
Control.SRR15539824;50;40;0.66;17;33;0.16;0.34
Control.SRR15539824;49;40;0.551020408163265;22;27;0.0510204081632653;0.448979591836735
Control.SRR15539824;43;40;0.511627906976744;21;22;0.0116279069767442;0.488372093023256
Control.SRR15539824;47;40;0.425531914893617;27;20;0.074468085106383;0.425531914893617
Control.SRR15539824;44;40;0.5;22;22;0;0.5
Control.SRR15539824;42;40;0.571428571428571;18;24;0.0714285714285714;0.428571428571429
Control.SRR15539824;49;40;0.448979591836735;27;22;0.0510204081632653;0.448979591836735
Control.SRR15539824;50;40;0.52;24;26;0.02;0.48
Control.SRR15539824;39;40;0.435897435897436;22;17;0.0641025641025641;0.435897435897436
Control.SRR15539824;46;40;0.434782608695652;26;20;0.0652173913043478;0.434782608695652
Control.SRR15539824;50;40;0.44;28;22;0.06;0.44
Control.SRR15539824;41;40;0.51219512195122;20;21;0.0121951219512195;0.48780487804878
Control.SRR15539824;41;40;0.536585365853659;19;22;0.0365853658536586;0.463414634146341
Control.SRR15539824;49;40;0.510204081632653;24;25;0.0102040816326531;0.489795918367347
Control.SRR15539824;49;40;0.489795918367347;25;24;0.0102040816326531;0.489795918367347
Control.SRR15539824;41;40;0.585365853658537;17;24;0.0853658536585366;0.414634146341463
Control.SRR15539824;40;40;0.575;17;23;0.075;0.425
Control.SRR15539824;40;40;0.5;20;20;0;0.5
Control.SRR15539824;43;40;0.465116279069767;23;20;0.0348837209302326;0.465116279069767
Control.SRR15539824;44;40;0.431818181818182;25;19;0.0681818181818182;0.431818181818182
Control.SRR15539824;43;40;0.534883720930233;20;23;0.0348837209302325;0.465116279069767
Control.SRR15539824;48;40;0.479166666666667;25;23;0.0208333333333333;0.479166666666667
Control.SRR15539824;49;40;0.530612244897959;23;26;0.0306122448979592;0.469387755102041
Control.SRR15539824;47;40;0.638297872340426;17;30;0.138297872340426;0.361702127659574
Control.SRR15539824;43;40;0.465116279069767;23;20;0.0348837209302326;0.465116279069767
Control.SRR15539824;40;40;0.6;16;24;0.1;0.4
Control.SRR15539824;44;40;0.590909090909091;18;26;0.0909090909090909;0.409090909090909
Control.SRR15539824;46;40;0.521739130434783;22;24;0.0217391304347826;0.478260869565217
Control.SRR15539824;44;40;0.5;22;22;0;0.5
Control.SRR15539824;48;40;0.583333333333333;20;28;0.0833333333333334;0.416666666666667
Control.SRR15539824;50;40;0.58;21;29;0.08;0.42
Control.SRR15539824;50;40;0.42;29;21;0.08;0.42
Control.SRR15539824;47;40;0.553191489361702;21;26;0.0531914893617021;0.446808510638298
Control.SRR15539824;48;40;0.520833333333333;23;25;0.0208333333333334;0.479166666666667
Control.SRR15539824;47;40;0.48936170212766;24;23;0.0106382978723404;0.48936170212766
Control.SRR15539824;46;40;0.543478260869565;21;25;0.0434782608695652;0.456521739130435
Control.SRR15539824;43;40;0.488372093023256;22;21;0.0116279069767442;0.488372093023256
Control.SRR15539824;41;40;0.536585365853659;19;22;0.0365853658536586;0.463414634146341
Control.SRR15539824;45;40;0.555555555555556;20;25;0.0555555555555556;0.444444444444444
Control.SRR15539824;47;40;0.51063829787234;23;24;0.0106382978723404;0.48936170212766
Control.SRR15539824;48;40;0.458333333333333;26;22;0.0416666666666667;0.458333333333333
Control.SRR15539824;43;40;0.534883720930233;20;23;0.0348837209302325;0.465116279069767
Control.SRR15539824;48;40;0.541666666666667;22;26;0.0416666666666666;0.458333333333333
Control.SRR15539824;49;40;0.36734693877551;31;18;0.13265306122449;0.36734693877551
Control.SRR15539824;49;40;0.408163265306122;29;20;0.0918367346938775;0.408163265306122
Control.SRR15539824;48;40;0.604166666666667;19;29;0.104166666666667;0.395833333333333
Control.SRR15539824;49;40;0.428571428571429;28;21;0.0714285714285715;0.428571428571429
Control.SRR15539824;43;40;0.651162790697674;15;28;0.151162790697674;0.348837209302326
Control.SRR15539824;49;40;0.489795918367347;25;24;0.0102040816326531;0.489795918367347
Control.SRR15539824;46;40;0.41304347826087;27;19;0.0869565217391304;0.41304347826087
Control.SRR15539824;41;40;0.48780487804878;21;20;0.0121951219512195;0.48780487804878
Control.SRR15539824;44;40;0.5;22;22;0;0.5
Control.SRR15539824;43;40;0.558139534883721;19;24;0.0581395348837209;0.441860465116279
Control.SRR15539824;44;40;0.477272727272727;23;21;0.0227272727272727;0.477272727272727
Control.SRR15539824;47;40;0.361702127659574;30;17;0.138297872340426;0.361702127659574
Control.SRR15539824;50;40;0.54;23;27;0.04;0.46
Control.SRR15539824;39;40;0.487179487179487;20;19;0.0128205128205128;0.487179487179487
Control.SRR15539824;38;40;0.526315789473684;18;20;0.0263157894736842;0.473684210526316
Control.SRR15539824;44;40;0.545454545454545;20;24;0.0454545454545454;0.454545454545455
Control.SRR15539824;38;40;0.5;19;19;0;0.5
Control.SRR15539824;44;40;0.409090909090909;26;18;0.0909090909090909;0.409090909090909
Control.SRR15539824;49;40;0.510204081632653;24;25;0.0102040816326531;0.489795918367347
Control.SRR15539824;50;40;0.34;33;17;0.16;0.34
Control.SRR15539824;50;40;0.46;27;23;0.04;0.46
Control.SRR15539824;43;40;0.604651162790698;17;26;0.104651162790698;0.395348837209302
Control.SRR15539824;40;40;0.55;18;22;0.05;0.45
Control.SRR15539824;40;40;0.6;16;24;0.1;0.4
Control.SRR15539824;46;40;0.369565217391304;29;17;0.130434782608696;0.369565217391304
Control.SRR15539824;48;40;0.5;24;24;0;0.5
Control.SRR15539824;41;40;0.585365853658537;17;24;0.0853658536585366;0.414634146341463
Control.SRR15539824;42;40;0.595238095238095;17;25;0.0952380952380952;0.404761904761905
Control.SRR15539824;43;40;0.558139534883721;19;24;0.0581395348837209;0.441860465116279
Control.SRR15539824;42;40;0.547619047619048;19;23;0.0476190476190477;0.452380952380952
Control.SRR15539824;47;40;0.425531914893617;27;20;0.074468085106383;0.425531914893617
Control.SRR15539824;49;40;0.510204081632653;24;25;0.0102040816326531;0.489795918367347
Control.SRR15539824;40;40;0.6;16;24;0.1;0.4
Control.SRR15539824;47;40;0.531914893617021;22;25;0.0319148936170213;0.468085106382979
Control.SRR15539824;39;40;0.41025641025641;23;16;0.0897435897435898;0.41025641025641
Control.SRR15539824;39;40;0.307692307692308;27;12;0.192307692307692;0.307692307692308
Control.SRR15539824;45;40;0.466666666666667;24;21;0.0333333333333333;0.466666666666667
Control.SRR15539824;49;40;0.591836734693878;20;29;0.0918367346938775;0.408163265306122
Control.SRR15539824;44;40;0.590909090909091;18;26;0.0909090909090909;0.409090909090909
Control.SRR15539824;45;40;0.444444444444444;25;20;0.0555555555555556;0.444444444444444
Control.SRR15539824;45;40;0.6;18;27;0.1;0.4
Control.SRR15539824;41;40;0.634146341463415;15;26;0.134146341463415;0.365853658536585
Control.SRR15539824;45;40;0.622222222222222;17;28;0.122222222222222;0.377777777777778
Control.SRR15539824;41;40;0.390243902439024;25;16;0.109756097560976;0.390243902439024
Control.SRR15539824;47;40;0.425531914893617;27;20;0.074468085106383;0.425531914893617
Control.SRR15539824;46;40;0.58695652173913;19;27;0.0869565217391305;0.41304347826087
Control.SRR15539824;46;40;0.434782608695652;26;20;0.0652173913043478;0.434782608695652
Control.SRR15539824;44;40;0.409090909090909;26;18;0.0909090909090909;0.409090909090909
Control.SRR15539824;43;40;0.488372093023256;22;21;0.0116279069767442;0.488372093023256
Control.SRR15539824;42;40;0.476190476190476;22;20;0.0238095238095238;0.476190476190476
Control.SRR15539824;49;40;0.428571428571429;28;21;0.0714285714285715;0.428571428571429
Control.SRR15539824;48;40;0.479166666666667;25;23;0.0208333333333333;0.479166666666667
Control.SRR15539824;49;40;0.489795918367347;25;24;0.0102040816326531;0.489795918367347
Control.SRR15539824;42;40;0.595238095238095;17;25;0.0952380952380952;0.404761904761905
Control.SRR15539824;47;40;0.574468085106383;20;27;0.074468085106383;0.425531914893617
Control.SRR15539824;50;40;0.54;23;27;0.04;0.46
Control.SRR15539824;40;40;0.625;15;25;0.125;0.375
Control.SRR15539824;40;40;0.5;20;20;0;0.5
Control.SRR15539824;40;40;0.475;21;19;0.025;0.475
Control.SRR15539824;38;40;0.526315789473684;18;20;0.0263157894736842;0.473684210526316
Control.SRR15539824;45;40;0.444444444444444;25;20;0.0555555555555556;0.444444444444444
Control.SRR15539824;49;40;0.571428571428571;21;28;0.0714285714285714;0.428571428571429
Control.SRR15539824;45;40;0.644444444444444;16;29;0.144444444444444;0.355555555555556
Control.SRR15539824;48;40;0.541666666666667;22;26;0.0416666666666666;0.458333333333333
Control.SRR15539824;49;40;0.510204081632653;24;25;0.0102040816326531;0.489795918367347
Control.SRR15539824;50;40;0.52;24;26;0.02;0.48
Control.SRR15539824;40;40;0.65;14;26;0.15;0.35
Control.SRR15539824;41;40;0.51219512195122;20;21;0.0121951219512195;0.48780487804878
Control.SRR15539824;44;40;0.522727272727273;21;23;0.0227272727272727;0.477272727272727
Control.SRR15539824;40;40;0.4;24;16;0.1;0.4
Control.SRR15539824;47;40;0.553191489361702;21;26;0.0531914893617021;0.446808510638298
Control.SRR15539824;46;40;0.58695652173913;19;27;0.0869565217391305;0.41304347826087
Control.SRR15539824;46;40;0.543478260869565;21;25;0.0434782608695652;0.456521739130435
Control.SRR15539824;45;40;0.577777777777778;19;26;0.0777777777777777;0.422222222222222
Control.SRR15539824;39;40;0.487179487179487;20;19;0.0128205128205128;0.487179487179487
Control.SRR15539824;39;40;0.512820512820513;19;20;0.0128205128205128;0.487179487179487
Control.SRR15539824;39;40;0.461538461538462;21;18;0.0384615384615384;0.461538461538462
Control.SRR15539824;40;40;0.525;19;21;0.025;0.475
Control.SRR15539824;45;40;0.422222222222222;26;19;0.0777777777777778;0.422222222222222
Control.SRR15539824;47;40;0.51063829787234;23;24;0.0106382978723404;0.48936170212766
Control.SRR15539824;47;40;0.574468085106383;20;27;0.074468085106383;0.425531914893617
Control.SRR15539824;50;40;0.6;20;30;0.1;0.4
Control.SRR15539824;47;40;0.468085106382979;25;22;0.0319148936170213;0.468085106382979
Control.SRR15539824;46;40;0.478260869565217;24;22;0.0217391304347826;0.478260869565217
Control.SRR15539824;49;40;0.530612244897959;23;26;0.0306122448979592;0.469387755102041
Control.SRR15539824;48;40;0.520833333333333;23;25;0.0208333333333334;0.479166666666667
Control.SRR15539824;38;40;0.526315789473684;18;20;0.0263157894736842;0.473684210526316
Control.SRR15539824;47;40;0.553191489361702;21;26;0.0531914893617021;0.446808510638298
Control.SRR15539824;48;40;0.5;24;24;0;0.5
Control.SRR15539824;50;40;0.56;22;28;0.0600000000000001;0.44
Control.SRR15539824;50;40;0.62;19;31;0.12;0.38
Control.SRR15539824;44;40;0.477272727272727;23;21;0.0227272727272727;0.477272727272727
Control.SRR15539824;41;40;0.536585365853659;19;22;0.0365853658536586;0.463414634146341
Control.SRR15539824;44;40;0.636363636363636;16;28;0.136363636363636;0.363636363636364
Control.SRR15539824;44;40;0.522727272727273;21;23;0.0227272727272727;0.477272727272727
Control.SRR15539824;44;40;0.431818181818182;25;19;0.0681818181818182;0.431818181818182
Control.SRR15539824;38;40;0.526315789473684;18;20;0.0263157894736842;0.473684210526316
Control.SRR15539824;44;40;0.5;22;22;0;0.5
Control.SRR15539824;44;40;0.477272727272727;23;21;0.0227272727272727;0.477272727272727
Control.SRR15539824;44;40;0.568181818181818;19;25;0.0681818181818182;0.431818181818182
Control.SRR15539824;39;40;0.41025641025641;23;16;0.0897435897435898;0.41025641025641
Control.SRR15539824;49;40;0.530612244897959;23;26;0.0306122448979592;0.469387755102041
Control.SRR15539824;40;40;0.425;23;17;0.075;0.425
Control.SRR15539824;49;40;0.489795918367347;25;24;0.0102040816326531;0.489795918367347
Control.SRR15539824;45;40;0.533333333333333;21;24;0.0333333333333333;0.466666666666667
Control.SRR15539824;44;40;0.454545454545455;24;20;0.0454545454545455;0.454545454545455
Control.SRR15539824;50;40;0.44;28;22;0.06;0.44
Control.SRR15539824;50;40;0.48;26;24;0.02;0.48
Control.SRR15539824;45;40;0.4;27;18;0.1;0.4
Control.SRR15539824;43;40;0.395348837209302;26;17;0.104651162790698;0.395348837209302
Control.SRR15539824;45;40;0.444444444444444;25;20;0.0555555555555556;0.444444444444444
Control.SRR15539824;39;40;0.487179487179487;20;19;0.0128205128205128;0.487179487179487
Control.SRR15539824;44;40;0.477272727272727;23;21;0.0227272727272727;0.477272727272727
Control.SRR15539824;50;40;0.4;30;20;0.1;0.4
Control.SRR15539824;48;40;0.5625;21;27;0.0625;0.4375
Control.SRR15539824;44;40;0.5;22;22;0;0.5
Control.SRR15539824;39;40;0.487179487179487;20;19;0.0128205128205128;0.487179487179487
Control.SRR15539824;39;40;0.461538461538462;21;18;0.0384615384615384;0.461538461538462
Control.SRR15539824;46;40;0.478260869565217;24;22;0.0217391304347826;0.478260869565217
Control.SRR15539824;42;40;0.428571428571429;24;18;0.0714285714285715;0.428571428571429
Control.SRR15539824;47;40;0.446808510638298;26;21;0.0531914893617021;0.446808510638298
Control.SRR15539824;43;40;0.534883720930233;20;23;0.0348837209302325;0.465116279069767
Control.SRR15539824;47;40;0.617021276595745;18;29;0.117021276595745;0.382978723404255
Control.SRR15539824;48;40;0.416666666666667;28;20;0.0833333333333333;0.416666666666667
Control.SRR15539824;39;40;0.487179487179487;20;19;0.0128205128205128;0.487179487179487
Control.SRR15539824;43;40;0.488372093023256;22;21;0.0116279069767442;0.488372093023256
Control.SRR15539824;42;40;0.571428571428571;18;24;0.0714285714285714;0.428571428571429
Control.SRR15539824;41;40;0.536585365853659;19;22;0.0365853658536586;0.463414634146341
Control.SRR15539824;50;40;0.48;26;24;0.02;0.48
Control.SRR15539824;44;40;0.522727272727273;21;23;0.0227272727272727;0.477272727272727
Control.SRR15539824;44;40;0.568181818181818;19;25;0.0681818181818182;0.431818181818182
Control.SRR15539824;44;40;0.545454545454545;20;24;0.0454545454545454;0.454545454545455
Control.SRR15539824;43;40;0.604651162790698;17;26;0.104651162790698;0.395348837209302
Control.SRR15539824;47;40;0.574468085106383;20;27;0.074468085106383;0.425531914893617
Control.SRR15539824;48;40;0.479166666666667;25;23;0.0208333333333333;0.479166666666667
Control.SRR15539824;48;40;0.333333333333333;32;16;0.166666666666667;0.333333333333333
Control.SRR15539824;47;40;0.553191489361702;21;26;0.0531914893617021;0.446808510638298
Control.SRR15539824;40;40;0.525;19;21;0.025;0.475
Control.SRR15539824;42;40;0.571428571428571;18;24;0.0714285714285714;0.428571428571429
Control.SRR15539824;49;40;0.469387755102041;26;23;0.0306122448979592;0.469387755102041
Control.SRR15539824;50;40;0.56;22;28;0.0600000000000001;0.44
Control.SRR15539824;43;40;0.558139534883721;19;24;0.0581395348837209;0.441860465116279
Control.SRR15539824;42;40;0.476190476190476;22;20;0.0238095238095238;0.476190476190476
Control.SRR15539824;46;40;0.5;23;23;0;0.5
Control.SRR15539824;44;40;0.454545454545455;24;20;0.0454545454545455;0.454545454545455
Control.SRR15539824;45;40;0.488888888888889;23;22;0.0111111111111111;0.488888888888889
Control.SRR15539824;42;40;0.642857142857143;15;27;0.142857142857143;0.357142857142857
Control.SRR15539824;43;40;0.534883720930233;20;23;0.0348837209302325;0.465116279069767
Control.SRR15539824;41;40;0.609756097560976;16;25;0.109756097560976;0.390243902439024
Control.SRR15539824;39;40;0.641025641025641;14;25;0.141025641025641;0.358974358974359
Control.SRR15539824;39;40;0.564102564102564;17;22;0.0641025641025641;0.435897435897436
Control.SRR15539824;40;40;0.525;19;21;0.025;0.475
Control.SRR15539824;50;40;0.48;26;24;0.02;0.48
Control.SRR15539824;47;40;0.638297872340426;17;30;0.138297872340426;0.361702127659574
Control.SRR15539824;46;40;0.434782608695652;26;20;0.0652173913043478;0.434782608695652
Control.SRR15539824;41;40;0.439024390243902;23;18;0.0609756097560976;0.439024390243902
Control.SRR15539824;47;40;0.51063829787234;23;24;0.0106382978723404;0.48936170212766
Control.SRR15539824;45;40;0.555555555555556;20;25;0.0555555555555556;0.444444444444444
Control.SRR15539824;40;40;0.5;20;20;0;0.5
Control.SRR15539824;45;40;0.377777777777778;28;17;0.122222222222222;0.377777777777778
Control.SRR15539824;42;40;0.571428571428571;18;24;0.0714285714285714;0.428571428571429
Control.SRR15539824;38;40;0.473684210526316;20;18;0.0263157894736842;0.473684210526316
Control.SRR15539824;48;40;0.5625;21;27;0.0625;0.4375
Control.SRR15539824;48;40;0.375;30;18;0.125;0.375
Control.SRR15539824;44;40;0.636363636363636;16;28;0.136363636363636;0.363636363636364
Control.SRR15539824;43;40;0.441860465116279;24;19;0.0581395348837209;0.441860465116279
Control.SRR15539824;46;40;0.543478260869565;21;25;0.0434782608695652;0.456521739130435
Control.SRR15539824;42;40;0.380952380952381;26;16;0.119047619047619;0.380952380952381
Control.SRR15539824;46;40;0.652173913043478;16;30;0.152173913043478;0.347826086956522
Control.SRR15539824;44;40;0.545454545454545;20;24;0.0454545454545454;0.454545454545455
Control.SRR15539824;49;40;0.530612244897959;23;26;0.0306122448979592;0.469387755102041
Control.SRR15539824;38;40;0.552631578947368;17;21;0.0526315789473685;0.447368421052632
Control.SRR15539824;44;40;0.363636363636364;28;16;0.136363636363636;0.363636363636364
Control.SRR15539824;41;40;0.439024390243902;23;18;0.0609756097560976;0.439024390243902
Control.SRR15539824;48;40;0.479166666666667;25;23;0.0208333333333333;0.479166666666667
Control.SRR15539824;42;40;0.547619047619048;19;23;0.0476190476190477;0.452380952380952
Control.SRR15539824;43;40;0.441860465116279;24;19;0.0581395348837209;0.441860465116279
Control.SRR15539824;47;40;0.48936170212766;24;23;0.0106382978723404;0.48936170212766
Control.SRR15539824;43;40;0.534883720930233;20;23;0.0348837209302325;0.465116279069767
Control.SRR15539824;48;40;0.479166666666667;25;23;0.0208333333333333;0.479166666666667
Control.SRR15539824;43;40;0.418604651162791;25;18;0.0813953488372093;0.418604651162791
Control.SRR15539824;44;40;0.454545454545455;24;20;0.0454545454545455;0.454545454545455
Control.SRR15539824;50;40;0.4;30;20;0.1;0.4
Control.SRR15539824;39;40;0.58974358974359;16;23;0.0897435897435898;0.41025641025641
Control.SRR15539824;48;40;0.4375;27;21;0.0625;0.4375
Control.SRR15539824;42;40;0.523809523809524;20;22;0.0238095238095238;0.476190476190476
Control.SRR15539824;47;40;0.48936170212766;24;23;0.0106382978723404;0.48936170212766
Control.SRR15539824;46;40;0.456521739130435;25;21;0.0434782608695652;0.456521739130435
Control.SRR15539824;46;40;0.521739130434783;22;24;0.0217391304347826;0.478260869565217
Control.SRR15539824;48;40;0.520833333333333;23;25;0.0208333333333334;0.479166666666667
Control.SRR15539824;47;40;0.425531914893617;27;20;0.074468085106383;0.425531914893617
Control.SRR15539824;48;40;0.395833333333333;29;19;0.104166666666667;0.395833333333333
Control.SRR15539824;47;40;0.468085106382979;25;22;0.0319148936170213;0.468085106382979
Control.SRR15539824;47;40;0.446808510638298;26;21;0.0531914893617021;0.446808510638298
Control.SRR15539824;46;40;0.608695652173913;18;28;0.108695652173913;0.391304347826087
Control.SRR15539824;50;40;0.46;27;23;0.04;0.46
Control.SRR15539824;43;40;0.511627906976744;21;22;0.0116279069767442;0.488372093023256
Control.SRR15539824;47;40;0.425531914893617;27;20;0.074468085106383;0.425531914893617
Control.SRR15539824;50;40;0.62;19;31;0.12;0.38
Control.SRR15539824;39;40;0.615384615384615;15;24;0.115384615384615;0.384615384615385
Control.SRR15539824;46;40;0.521739130434783;22;24;0.0217391304347826;0.478260869565217
Control.SRR15539824;41;40;0.268292682926829;30;11;0.231707317073171;0.268292682926829
Control.SRR15539824;48;40;0.520833333333333;23;25;0.0208333333333334;0.479166666666667
Control.SRR15539824;49;40;0.510204081632653;24;25;0.0102040816326531;0.489795918367347
Control.SRR15539824;46;40;0.5;23;23;0;0.5
Control.SRR15539824;39;40;0.564102564102564;17;22;0.0641025641025641;0.435897435897436
Control.SRR15539824;38;40;0.473684210526316;20;18;0.0263157894736842;0.473684210526316
Control.SRR15539824;49;40;0.387755102040816;30;19;0.112244897959184;0.387755102040816
Control.SRR15539824;45;40;0.466666666666667;24;21;0.0333333333333333;0.466666666666667
Control.SRR15539824;39;40;0.564102564102564;17;22;0.0641025641025641;0.435897435897436
Control.SRR15539824;50;40;0.6;20;30;0.1;0.4
Control.SRR15539824;50;40;0.52;24;26;0.02;0.48
Control.SRR15539824;47;40;0.531914893617021;22;25;0.0319148936170213;0.468085106382979
Control.SRR15539824;47;40;0.659574468085106;16;31;0.159574468085106;0.340425531914894
Control.SRR15539824;48;40;0.520833333333333;23;25;0.0208333333333334;0.479166666666667
Control.SRR15539824;44;40;0.454545454545455;24;20;0.0454545454545455;0.454545454545455
Control.SRR15539824;38;40;0.552631578947368;17;21;0.0526315789473685;0.447368421052632
Control.SRR15539824;43;40;0.558139534883721;19;24;0.0581395348837209;0.441860465116279
Control.SRR15539824;45;40;0.466666666666667;24;21;0.0333333333333333;0.466666666666667
Control.SRR15539824;40;40;0.6;16;24;0.1;0.4
Control.SRR15539824;39;40;0.41025641025641;23;16;0.0897435897435898;0.41025641025641
Control.SRR15539824;49;40;0.448979591836735;27;22;0.0510204081632653;0.448979591836735
Control.SRR15539824;48;40;0.541666666666667;22;26;0.0416666666666666;0.458333333333333
Control.SRR15539824;48;40;0.604166666666667;19;29;0.104166666666667;0.395833333333333
Control.SRR15539824;50;40;0.58;21;29;0.08;0.42
Control.SRR15539824;45;40;0.355555555555556;29;16;0.144444444444444;0.355555555555556
Control.SRR15539824;43;40;0.697674418604651;13;30;0.197674418604651;0.302325581395349
Control.SRR15539824;40;40;0.575;17;23;0.075;0.425
Control.SRR15539824;43;40;0.558139534883721;19;24;0.0581395348837209;0.441860465116279
Control.SRR15539824;50;40;0.62;19;31;0.12;0.38
Control.SRR15539824;50;40;0.52;24;26;0.02;0.48
Control.SRR15539824;40;40;0.45;22;18;0.05;0.45
Control.SRR15539824;43;40;0.441860465116279;24;19;0.0581395348837209;0.441860465116279
Control.SRR15539824;41;40;0.536585365853659;19;22;0.0365853658536586;0.463414634146341
Control.SRR15539824;40;40;0.575;17;23;0.075;0.425
Control.SRR15539824;41;40;0.560975609756098;18;23;0.0609756097560976;0.439024390243902
Control.SRR15539824;43;40;0.418604651162791;25;18;0.0813953488372093;0.418604651162791
Control.SRR15539824;46;40;0.630434782608696;17;29;0.130434782608696;0.369565217391304
Control.SRR15539824;46;40;0.565217391304348;20;26;0.0652173913043478;0.434782608695652
Control.SRR15539824;41;40;0.51219512195122;20;21;0.0121951219512195;0.48780487804878
Control.SRR15539824;40;40;0.525;19;21;0.025;0.475
Control.SRR15539824;44;40;0.545454545454545;20;24;0.0454545454545454;0.454545454545455
Control.SRR15539824;43;40;0.511627906976744;21;22;0.0116279069767442;0.488372093023256
Control.SRR15539824;40;40;0.5;20;20;0;0.5
Control.SRR15539824;40;40;0.5;20;20;0;0.5
Control.SRR15539824;45;40;0.488888888888889;23;22;0.0111111111111111;0.488888888888889
Control.SRR15539824;48;40;0.458333333333333;26;22;0.0416666666666667;0.458333333333333
Control.SRR15539824;48;40;0.458333333333333;26;22;0.0416666666666667;0.458333333333333
Control.SRR15539824;50;40;0.48;26;24;0.02;0.48
Control.SRR15539824;49;40;0.408163265306122;29;20;0.0918367346938775;0.408163265306122
Control.SRR15539824;41;40;0.536585365853659;19;22;0.0365853658536586;0.463414634146341
Control.SRR15539824;40;40;0.5;20;20;0;0.5
Control.SRR15539824;49;40;0.612244897959184;19;30;0.112244897959184;0.387755102040816
Control.SRR15539824;46;40;0.326086956521739;31;15;0.173913043478261;0.326086956521739
Control.SRR15539824;43;40;0.488372093023256;22;21;0.0116279069767442;0.488372093023256
Control.SRR15539824;50;40;0.5;25;25;0;0.5
Control.SRR15539824;39;40;0.487179487179487;20;19;0.0128205128205128;0.487179487179487
Control.SRR15539824;50;40;0.46;27;23;0.04;0.46
Control.SRR15539824;43;40;0.558139534883721;19;24;0.0581395348837209;0.441860465116279
Control.SRR15539824;49;40;0.591836734693878;20;29;0.0918367346938775;0.408163265306122
Control.SRR15539824;38;40;0.289473684210526;27;11;0.210526315789474;0.289473684210526
Control.SRR15539824;42;40;0.5;21;21;0;0.5
Control.SRR15539824;44;40;0.545454545454545;20;24;0.0454545454545454;0.454545454545455
Control.SRR15539824;43;40;0.558139534883721;19;24;0.0581395348837209;0.441860465116279
Control.SRR15539824;42;40;0.5;21;21;0;0.5
Control.SRR15539824;47;40;0.468085106382979;25;22;0.0319148936170213;0.468085106382979
Control.SRR15539824;44;40;0.522727272727273;21;23;0.0227272727272727;0.477272727272727
Control.SRR15539824;41;40;0.463414634146341;22;19;0.0365853658536585;0.463414634146341
Control.SRR15539824;42;40;0.642857142857143;15;27;0.142857142857143;0.357142857142857
Control.SRR15539824;41;40;0.48780487804878;21;20;0.0121951219512195;0.48780487804878
Control.SRR15539824;50;40;0.5;25;25;0;0.5
Control.SRR15539824;44;40;0.545454545454545;20;24;0.0454545454545454;0.454545454545455
Control.SRR15539824;42;40;0.380952380952381;26;16;0.119047619047619;0.380952380952381
Control.SRR15539824;46;40;0.565217391304348;20;26;0.0652173913043478;0.434782608695652
Control.SRR15539824;41;40;0.48780487804878;21;20;0.0121951219512195;0.48780487804878
Control.SRR15539824;43;40;0.511627906976744;21;22;0.0116279069767442;0.488372093023256
Control.SRR15539824;41;40;0.414634146341463;24;17;0.0853658536585366;0.414634146341463
Control.SRR15539824;42;40;0.476190476190476;22;20;0.0238095238095238;0.476190476190476
Control.SRR15539824;42;40;0.404761904761905;25;17;0.0952380952380952;0.404761904761905
Control.SRR15539824;42;40;0.619047619047619;16;26;0.119047619047619;0.380952380952381
Control.SRR15539824;49;40;0.571428571428571;21;28;0.0714285714285714;0.428571428571429
Control.SRR15539824;43;40;0.534883720930233;20;23;0.0348837209302325;0.465116279069767
Control.SRR15539824;44;40;0.409090909090909;26;18;0.0909090909090909;0.409090909090909
Control.SRR15539824;49;40;0.551020408163265;22;27;0.0510204081632653;0.448979591836735
Control.SRR15539824;38;40;0.447368421052632;21;17;0.0526315789473684;0.447368421052632
Control.SRR15539824;40;40;0.475;21;19;0.025;0.475
Control.SRR15539824;44;40;0.386363636363636;27;17;0.113636363636364;0.386363636363636
Control.SRR15539824;41;40;0.560975609756098;18;23;0.0609756097560976;0.439024390243902
Control.SRR15539824;45;40;0.511111111111111;22;23;0.0111111111111111;0.488888888888889
Control.SRR15539824;42;40;0.404761904761905;25;17;0.0952380952380952;0.404761904761905
Control.SRR15539824;44;40;0.522727272727273;21;23;0.0227272727272727;0.477272727272727
Control.SRR15539824;39;40;0.512820512820513;19;20;0.0128205128205128;0.487179487179487
Control.SRR15539824;41;40;0.560975609756098;18;23;0.0609756097560976;0.439024390243902
Control.SRR15539824;48;40;0.5625;21;27;0.0625;0.4375
Control.SRR15539824;49;40;0.326530612244898;33;16;0.173469387755102;0.326530612244898
Control.SRR15539824;42;40;0.5;21;21;0;0.5
Control.SRR15539824;41;40;0.51219512195122;20;21;0.0121951219512195;0.48780487804878
Control.SRR15539824;40;40;0.4;24;16;0.1;0.4
Control.SRR15539824;44;40;0.431818181818182;25;19;0.0681818181818182;0.431818181818182
Control.SRR15539824;49;40;0.469387755102041;26;23;0.0306122448979592;0.469387755102041
Control.SRR15539824;47;40;0.531914893617021;22;25;0.0319148936170213;0.468085106382979
Control.SRR15539824;44;40;0.454545454545455;24;20;0.0454545454545455;0.454545454545455
Control.SRR15539824;40;40;0.6;16;24;0.1;0.4
Control.SRR15539824;43;40;0.465116279069767;23;20;0.0348837209302326;0.465116279069767
Control.SRR15539824;48;40;0.395833333333333;29;19;0.104166666666667;0.395833333333333
Control.SRR15539824;48;40;0.5625;21;27;0.0625;0.4375
Control.SRR15539824;43;40;0.395348837209302;26;17;0.104651162790698;0.395348837209302
Control.SRR15539824;48;40;0.479166666666667;25;23;0.0208333333333333;0.479166666666667
Control.SRR15539824;47;40;0.595744680851064;19;28;0.0957446808510638;0.404255319148936
Control.SRR15539824;47;40;0.553191489361702;21;26;0.0531914893617021;0.446808510638298
Control.SRR15539824;46;40;0.478260869565217;24;22;0.0217391304347826;0.478260869565217
Control.SRR15539824;40;40;0.35;26;14;0.15;0.35
Control.SRR15539824;40;40;0.5;20;20;0;0.5
Control.SRR15539824;38;40;0.552631578947368;17;21;0.0526315789473685;0.447368421052632
Control.SRR15539824;40;40;0.5;20;20;0;0.5
Control.SRR15539824;45;40;0.377777777777778;28;17;0.122222222222222;0.377777777777778
Control.SRR15539824;39;40;0.435897435897436;22;17;0.0641025641025641;0.435897435897436
Control.SRR15539824;42;40;0.452380952380952;23;19;0.0476190476190476;0.452380952380952
Control.SRR15539824;38;40;0.421052631578947;22;16;0.0789473684210527;0.421052631578947
Control.SRR15539824;47;40;0.531914893617021;22;25;0.0319148936170213;0.468085106382979
Control.SRR15539824;48;40;0.3125;33;15;0.1875;0.3125
Control.SRR15539824;45;40;0.577777777777778;19;26;0.0777777777777777;0.422222222222222
Control.SRR15539824;49;40;0.571428571428571;21;28;0.0714285714285714;0.428571428571429
Control.SRR15539824;43;40;0.511627906976744;21;22;0.0116279069767442;0.488372093023256
Control.SRR15539824;41;40;0.609756097560976;16;25;0.109756097560976;0.390243902439024
Control.SRR15539824;42;40;0.5;21;21;0;0.5
Control.SRR15539824;48;40;0.5;24;24;0;0.5
Control.SRR15539824;44;40;0.454545454545455;24;20;0.0454545454545455;0.454545454545455
Control.SRR15539824;46;40;0.521739130434783;22;24;0.0217391304347826;0.478260869565217
Control.SRR15539824;45;40;0.577777777777778;19;26;0.0777777777777777;0.422222222222222
Control.SRR15539824;45;40;0.444444444444444;25;20;0.0555555555555556;0.444444444444444
Control.SRR15539824;48;40;0.4375;27;21;0.0625;0.4375
Control.SRR15539824;46;40;0.543478260869565;21;25;0.0434782608695652;0.456521739130435
Control.SRR15539824;42;40;0.452380952380952;23;19;0.0476190476190476;0.452380952380952
Control.SRR15539824;47;40;0.51063829787234;23;24;0.0106382978723404;0.48936170212766
Control.SRR15539824;43;40;0.418604651162791;25;18;0.0813953488372093;0.418604651162791
Control.SRR15539824;46;40;0.565217391304348;20;26;0.0652173913043478;0.434782608695652
Control.SRR15539824;47;40;0.446808510638298;26;21;0.0531914893617021;0.446808510638298
Control.SRR15539824;39;40;0.58974358974359;16;23;0.0897435897435898;0.41025641025641
Control.SRR15539824;42;40;0.452380952380952;23;19;0.0476190476190476;0.452380952380952
Control.SRR15539824;42;40;0.357142857142857;27;15;0.142857142857143;0.357142857142857
Control.SRR15539824;43;40;0.441860465116279;24;19;0.0581395348837209;0.441860465116279
Control.SRR15539824;45;40;0.533333333333333;21;24;0.0333333333333333;0.466666666666667
Control.SRR15539824;49;40;0.469387755102041;26;23;0.0306122448979592;0.469387755102041
Control.SRR15539824;48;40;0.645833333333333;17;31;0.145833333333333;0.354166666666667
Control.SRR15539824;43;40;0.627906976744186;16;27;0.127906976744186;0.372093023255814
Control.SRR15539824;46;40;0.543478260869565;21;25;0.0434782608695652;0.456521739130435
Control.SRR15539824;43;40;0.441860465116279;24;19;0.0581395348837209;0.441860465116279
Control.SRR15539824;44;40;0.386363636363636;27;17;0.113636363636364;0.386363636363636
Control.SRR15539824;46;40;0.543478260869565;21;25;0.0434782608695652;0.456521739130435
Control.SRR15539824;48;40;0.541666666666667;22;26;0.0416666666666666;0.458333333333333
Control.SRR15539824;46;40;0.5;23;23;0;0.5
Control.SRR15539824;42;40;0.476190476190476;22;20;0.0238095238095238;0.476190476190476
Control.SRR15539824;42;40;0.5;21;21;0;0.5
Control.SRR15539824;42;40;0.571428571428571;18;24;0.0714285714285714;0.428571428571429
Control.SRR15539824;38;40;0.631578947368421;14;24;0.131578947368421;0.368421052631579
Control.SRR15539824;39;40;0.384615384615385;24;15;0.115384615384615;0.384615384615385
Control.SRR15539824;38;40;0.473684210526316;20;18;0.0263157894736842;0.473684210526316
Control.SRR15539824;46;40;0.456521739130435;25;21;0.0434782608695652;0.456521739130435
Control.SRR15539824;46;40;0.456521739130435;25;21;0.0434782608695652;0.456521739130435
Control.SRR15539824;44;40;0.386363636363636;27;17;0.113636363636364;0.386363636363636
Control.SRR15539824;49;40;0.489795918367347;25;24;0.0102040816326531;0.489795918367347
Control.SRR15539824;45;40;0.622222222222222;17;28;0.122222222222222;0.377777777777778
Control.SRR15539824;47;40;0.48936170212766;24;23;0.0106382978723404;0.48936170212766
Control.SRR15539824;49;40;0.530612244897959;23;26;0.0306122448979592;0.469387755102041
Control.SRR15539824;45;40;0.444444444444444;25;20;0.0555555555555556;0.444444444444444
Control.SRR15539824;42;40;0.523809523809524;20;22;0.0238095238095238;0.476190476190476
Control.SRR15539824;47;40;0.446808510638298;26;21;0.0531914893617021;0.446808510638298
Control.SRR15539824;39;40;0.512820512820513;19;20;0.0128205128205128;0.487179487179487
Control.SRR15539824;38;40;0.421052631578947;22;16;0.0789473684210527;0.421052631578947
Control.SRR15539824;38;40;0.526315789473684;18;20;0.0263157894736842;0.473684210526316
Control.SRR15539824;39;40;0.41025641025641;23;16;0.0897435897435898;0.41025641025641
Control.SRR15539824;45;40;0.488888888888889;23;22;0.0111111111111111;0.488888888888889
Control.SRR15539824;47;40;0.425531914893617;27;20;0.074468085106383;0.425531914893617
Control.SRR15539824;42;40;0.261904761904762;31;11;0.238095238095238;0.261904761904762
Control.SRR15539824;47;40;0.446808510638298;26;21;0.0531914893617021;0.446808510638298
Control.SRR15539824;48;40;0.4375;27;21;0.0625;0.4375
Control.SRR15539824;41;40;0.51219512195122;20;21;0.0121951219512195;0.48780487804878
Control.SRR15539824;48;40;0.5;24;24;0;0.5
Control.SRR15539824;48;40;0.479166666666667;25;23;0.0208333333333333;0.479166666666667
Control.SRR15539824;40;40;0.55;18;22;0.05;0.45
Control.SRR15539824;42;40;0.452380952380952;23;19;0.0476190476190476;0.452380952380952
Control.SRR15539824;46;40;0.369565217391304;29;17;0.130434782608696;0.369565217391304
Control.SRR15539824;47;40;0.553191489361702;21;26;0.0531914893617021;0.446808510638298
Control.SRR15539824;49;40;0.469387755102041;26;23;0.0306122448979592;0.469387755102041
Control.SRR15539824;48;40;0.520833333333333;23;25;0.0208333333333334;0.479166666666667
Control.SRR15539824;49;40;0.551020408163265;22;27;0.0510204081632653;0.448979591836735
Control.SRR15539824;49;40;0.571428571428571;21;28;0.0714285714285714;0.428571428571429
Control.SRR15539824;48;40;0.583333333333333;20;28;0.0833333333333334;0.416666666666667
Control.SRR15539824;45;40;0.333333333333333;30;15;0.166666666666667;0.333333333333333
Control.SRR15539824;47;40;0.361702127659574;30;17;0.138297872340426;0.361702127659574
Control.SRR15539824;49;40;0.408163265306122;29;20;0.0918367346938775;0.408163265306122
Control.SRR15539824;40;40;0.425;23;17;0.075;0.425
Control.SRR15539824;49;40;0.612244897959184;19;30;0.112244897959184;0.387755102040816
Control.SRR15539824;44;40;0.613636363636364;17;27;0.113636363636364;0.386363636363636
Control.SRR15539824;45;40;0.577777777777778;19;26;0.0777777777777777;0.422222222222222
Control.SRR15539824;46;40;0.478260869565217;24;22;0.0217391304347826;0.478260869565217
Control.SRR15539824;44;40;0.545454545454545;20;24;0.0454545454545454;0.454545454545455
Control.SRR15539824;41;40;0.463414634146341;22;19;0.0365853658536585;0.463414634146341
Control.SRR15539824;40;40;0.575;17;23;0.075;0.425
Control.SRR15539824;48;40;0.5625;21;27;0.0625;0.4375
Control.SRR15539824;45;40;0.577777777777778;19;26;0.0777777777777777;0.422222222222222
Control.SRR15539824;48;40;0.520833333333333;23;25;0.0208333333333334;0.479166666666667
Control.SRR15539824;49;40;0.469387755102041;26;23;0.0306122448979592;0.469387755102041
Control.SRR15539824;43;40;0.488372093023256;22;21;0.0116279069767442;0.488372093023256
Control.SRR15539824;50;40;0.52;24;26;0.02;0.48
Control.SRR15539824;44;40;0.477272727272727;23;21;0.0227272727272727;0.477272727272727
Control.SRR15539824;46;40;0.565217391304348;20;26;0.0652173913043478;0.434782608695652
Control.SRR15539824;44;40;0.386363636363636;27;17;0.113636363636364;0.386363636363636
Control.SRR15539824;44;40;0.659090909090909;15;29;0.159090909090909;0.340909090909091
Control.SRR15539824;45;40;0.555555555555556;20;25;0.0555555555555556;0.444444444444444
Control.SRR15539824;44;40;0.5;22;22;0;0.5
Control.SRR15539824;46;40;0.456521739130435;25;21;0.0434782608695652;0.456521739130435
Control.SRR15539824;48;40;0.458333333333333;26;22;0.0416666666666667;0.458333333333333
Control.SRR15539824;45;40;0.555555555555556;20;25;0.0555555555555556;0.444444444444444
Control.SRR15539824;49;40;0.489795918367347;25;24;0.0102040816326531;0.489795918367347
Control.SRR15539824;42;40;0.571428571428571;18;24;0.0714285714285714;0.428571428571429
Control.SRR15539824;46;40;0.58695652173913;19;27;0.0869565217391305;0.41304347826087
Control.SRR15539824;44;40;0.545454545454545;20;24;0.0454545454545454;0.454545454545455
Control.SRR15539824;49;40;0.36734693877551;31;18;0.13265306122449;0.36734693877551
Control.SRR15539824;40;40;0.675;13;27;0.175;0.325
Control.SRR15539824;49;40;0.551020408163265;22;27;0.0510204081632653;0.448979591836735
Control.SRR15539824;41;40;0.439024390243902;23;18;0.0609756097560976;0.439024390243902
Control.SRR15539824;38;40;0.421052631578947;22;16;0.0789473684210527;0.421052631578947
Control.SRR15539824;50;40;0.48;26;24;0.02;0.48
Control.SRR15539824;43;40;0.348837209302326;28;15;0.151162790697674;0.348837209302326
Control.SRR15539824;46;40;0.456521739130435;25;21;0.0434782608695652;0.456521739130435
Control.SRR15539824;42;40;0.428571428571429;24;18;0.0714285714285715;0.428571428571429
Control.SRR15539824;45;40;0.577777777777778;19;26;0.0777777777777777;0.422222222222222
Control.SRR15539824;42;40;0.571428571428571;18;24;0.0714285714285714;0.428571428571429
Control.SRR15539824;39;40;0.512820512820513;19;20;0.0128205128205128;0.487179487179487
Control.SRR15539824;40;40;0.4;24;16;0.1;0.4
Control.SRR15539824;43;40;0.651162790697674;15;28;0.151162790697674;0.348837209302326
Control.SRR15539824;38;40;0.526315789473684;18;20;0.0263157894736842;0.473684210526316
Control.SRR15539824;40;40;0.425;23;17;0.075;0.425
Control.SRR15539824;40;40;0.45;22;18;0.05;0.45
Control.SRR15539824;44;40;0.409090909090909;26;18;0.0909090909090909;0.409090909090909
Control.SRR15539824;44;40;0.454545454545455;24;20;0.0454545454545455;0.454545454545455
Control.SRR15539824;48;40;0.458333333333333;26;22;0.0416666666666667;0.458333333333333
Control.SRR15539824;47;40;0.48936170212766;24;23;0.0106382978723404;0.48936170212766
Control.SRR15539824;38;40;0.5;19;19;0;0.5
Control.SRR15539824;43;40;0.418604651162791;25;18;0.0813953488372093;0.418604651162791
Control.SRR15539824;50;40;0.38;31;19;0.12;0.38
Control.SRR15539824;49;40;0.551020408163265;22;27;0.0510204081632653;0.448979591836735
Control.SRR15539824;46;40;0.630434782608696;17;29;0.130434782608696;0.369565217391304
Control.SRR15539824;39;40;0.358974358974359;25;14;0.141025641025641;0.358974358974359
Control.SRR15539824;43;40;0.627906976744186;16;27;0.127906976744186;0.372093023255814
Control.SRR15539824;43;40;0.534883720930233;20;23;0.0348837209302325;0.465116279069767
Control.SRR15539824;44;40;0.545454545454545;20;24;0.0454545454545454;0.454545454545455
Control.SRR15539824;41;40;0.560975609756098;18;23;0.0609756097560976;0.439024390243902
Control.SRR15539824;44;40;0.431818181818182;25;19;0.0681818181818182;0.431818181818182
Control.SRR15539824;46;40;0.456521739130435;25;21;0.0434782608695652;0.456521739130435
Control.SRR15539824;49;40;0.510204081632653;24;25;0.0102040816326531;0.489795918367347
Control.SRR15539824;47;40;0.531914893617021;22;25;0.0319148936170213;0.468085106382979
Control.SRR15539824;45;40;0.488888888888889;23;22;0.0111111111111111;0.488888888888889
Control.SRR15539824;48;40;0.583333333333333;20;28;0.0833333333333334;0.416666666666667
Control.SRR15539824;49;40;0.510204081632653;24;25;0.0102040816326531;0.489795918367347
Control.SRR15539824;40;40;0.475;21;19;0.025;0.475
Control.SRR15539824;41;40;0.341463414634146;27;14;0.158536585365854;0.341463414634146
Control.SRR15539824;40;40;0.5;20;20;0;0.5
Control.SRR15539824;43;40;0.534883720930233;20;23;0.0348837209302325;0.465116279069767
Control.SRR15539824;38;40;0.421052631578947;22;16;0.0789473684210527;0.421052631578947
Control.SRR15539824;43;40;0.558139534883721;19;24;0.0581395348837209;0.441860465116279
Control.SRR15539824;46;40;0.5;23;23;0;0.5
Control.SRR15539824;50;40;0.52;24;26;0.02;0.48
Control.SRR15539824;47;40;0.468085106382979;25;22;0.0319148936170213;0.468085106382979
Control.SRR15539824;45;40;0.333333333333333;30;15;0.166666666666667;0.333333333333333
Control.SRR15539824;40;40;0.4;24;16;0.1;0.4
Control.SRR15539824;42;40;0.380952380952381;26;16;0.119047619047619;0.380952380952381
Control.SRR15539824;47;40;0.574468085106383;20;27;0.074468085106383;0.425531914893617
Control.SRR15539824;43;40;0.418604651162791;25;18;0.0813953488372093;0.418604651162791
Control.SRR15539824;44;40;0.590909090909091;18;26;0.0909090909090909;0.409090909090909
Control.SRR15539824;49;40;0.387755102040816;30;19;0.112244897959184;0.387755102040816
Control.SRR15539824;39;40;0.41025641025641;23;16;0.0897435897435898;0.41025641025641
Control.SRR15539824;38;40;0.526315789473684;18;20;0.0263157894736842;0.473684210526316
Control.SRR15539824;42;40;0.595238095238095;17;25;0.0952380952380952;0.404761904761905
Control.SRR15539824;48;40;0.458333333333333;26;22;0.0416666666666667;0.458333333333333
Control.SRR15539824;44;40;0.5;22;22;0;0.5
Control.SRR15539824;49;40;0.448979591836735;27;22;0.0510204081632653;0.448979591836735
Control.SRR15539824;49;40;0.489795918367347;25;24;0.0102040816326531;0.489795918367347
Control.SRR15539824;44;40;0.5;22;22;0;0.5
Control.SRR15539824;46;40;0.521739130434783;22;24;0.0217391304347826;0.478260869565217
Control.SRR15539824;45;40;0.555555555555556;20;25;0.0555555555555556;0.444444444444444
Control.SRR15539824;45;40;0.444444444444444;25;20;0.0555555555555556;0.444444444444444
Control.SRR15539824;46;40;0.391304347826087;28;18;0.108695652173913;0.391304347826087
Control.SRR15539824;44;40;0.5;22;22;0;0.5
Control.SRR15539824;42;40;0.619047619047619;16;26;0.119047619047619;0.380952380952381
Control.SRR15539824;44;40;0.340909090909091;29;15;0.159090909090909;0.340909090909091
Control.SRR15539824;43;40;0.511627906976744;21;22;0.0116279069767442;0.488372093023256
Control.SRR15539824;48;40;0.520833333333333;23;25;0.0208333333333334;0.479166666666667
Control.SRR15539824;47;40;0.51063829787234;23;24;0.0106382978723404;0.48936170212766
Control.SRR15539824;38;40;0.368421052631579;24;14;0.131578947368421;0.368421052631579
Control.SRR15539824;40;40;0.35;26;14;0.15;0.35
Control.SRR15539824;42;40;0.380952380952381;26;16;0.119047619047619;0.380952380952381
Control.SRR15539824;45;40;0.422222222222222;26;19;0.0777777777777778;0.422222222222222
Control.SRR15539824;43;40;0.441860465116279;24;19;0.0581395348837209;0.441860465116279
Control.SRR15539824;41;40;0.48780487804878;21;20;0.0121951219512195;0.48780487804878
Control.SRR15539824;50;40;0.5;25;25;0;0.5
Control.SRR15539824;46;40;0.41304347826087;27;19;0.0869565217391304;0.41304347826087
Control.SRR15539824;48;40;0.333333333333333;32;16;0.166666666666667;0.333333333333333
Control.SRR15539824;45;40;0.444444444444444;25;20;0.0555555555555556;0.444444444444444
Control.SRR15539824;43;40;0.558139534883721;19;24;0.0581395348837209;0.441860465116279
Control.SRR15539824;49;40;0.571428571428571;21;28;0.0714285714285714;0.428571428571429
Control.SRR15539824;46;40;0.456521739130435;25;21;0.0434782608695652;0.456521739130435
Control.SRR15539824;48;40;0.479166666666667;25;23;0.0208333333333333;0.479166666666667
Control.SRR15539824;48;40;0.5625;21;27;0.0625;0.4375
Control.SRR15539824;50;40;0.42;29;21;0.08;0.42
Control.SRR15539824;44;40;0.477272727272727;23;21;0.0227272727272727;0.477272727272727
Control.SRR15539824;39;40;0.487179487179487;20;19;0.0128205128205128;0.487179487179487
Control.SRR15539824;38;40;0.631578947368421;14;24;0.131578947368421;0.368421052631579
Control.SRR15539824;44;40;0.522727272727273;21;23;0.0227272727272727;0.477272727272727
Control.SRR15539824;50;40;0.44;28;22;0.06;0.44
Control.SRR15539824;43;40;0.465116279069767;23;20;0.0348837209302326;0.465116279069767
Control.SRR15539824;45;40;0.533333333333333;21;24;0.0333333333333333;0.466666666666667
Control.SRR15539824;39;40;0.41025641025641;23;16;0.0897435897435898;0.41025641025641
Control.SRR15539824;38;40;0.578947368421053;16;22;0.0789473684210527;0.421052631578947
Control.SRR15539824;45;40;0.622222222222222;17;28;0.122222222222222;0.377777777777778
Control.SRR15539824;39;40;0.41025641025641;23;16;0.0897435897435898;0.41025641025641
Control.SRR15539824;45;40;0.577777777777778;19;26;0.0777777777777777;0.422222222222222
Control.SRR15539824;45;40;0.555555555555556;20;25;0.0555555555555556;0.444444444444444
Control.SRR15539824;44;40;0.477272727272727;23;21;0.0227272727272727;0.477272727272727
Control.SRR15539824;39;40;0.512820512820513;19;20;0.0128205128205128;0.487179487179487
Control.SRR15539824;49;40;0.591836734693878;20;29;0.0918367346938775;0.408163265306122
Control.SRR15539824;39;40;0.512820512820513;19;20;0.0128205128205128;0.487179487179487
Control.SRR15539824;49;40;0.489795918367347;25;24;0.0102040816326531;0.489795918367347
Control.SRR15539824;43;40;0.418604651162791;25;18;0.0813953488372093;0.418604651162791
Control.SRR15539824;47;40;0.531914893617021;22;25;0.0319148936170213;0.468085106382979
Control.SRR15539824;46;40;0.434782608695652;26;20;0.0652173913043478;0.434782608695652
Control.SRR15539824;46;40;0.5;23;23;0;0.5
Control.SRR15539824;41;40;0.463414634146341;22;19;0.0365853658536585;0.463414634146341
Control.SRR15539824;41;40;0.634146341463415;15;26;0.134146341463415;0.365853658536585
Control.SRR15539824;43;40;0.581395348837209;18;25;0.0813953488372093;0.418604651162791
Control.SRR15539824;45;40;0.466666666666667;24;21;0.0333333333333333;0.466666666666667
Control.SRR15539824;48;40;0.458333333333333;26;22;0.0416666666666667;0.458333333333333
Control.SRR15539824;49;40;0.591836734693878;20;29;0.0918367346938775;0.408163265306122
Control.SRR15539824;50;40;0.58;21;29;0.08;0.42
Control.SRR15539824;39;40;0.538461538461538;18;21;0.0384615384615384;0.461538461538462
Control.SRR15539824;42;40;0.404761904761905;25;17;0.0952380952380952;0.404761904761905
Control.SRR15539824;49;40;0.510204081632653;24;25;0.0102040816326531;0.489795918367347
Control.SRR15539824;47;40;0.382978723404255;29;18;0.117021276595745;0.382978723404255
Control.SRR15539824;39;40;0.307692307692308;27;12;0.192307692307692;0.307692307692308
Control.SRR15539824;43;40;0.348837209302326;28;15;0.151162790697674;0.348837209302326
Control.SRR15539824;41;40;0.560975609756098;18;23;0.0609756097560976;0.439024390243902
Control.SRR15539824;46;40;0.478260869565217;24;22;0.0217391304347826;0.478260869565217
Control.SRR15539824;48;40;0.541666666666667;22;26;0.0416666666666666;0.458333333333333
Control.SRR15539824;39;40;0.487179487179487;20;19;0.0128205128205128;0.487179487179487
Control.SRR15539824;45;40;0.466666666666667;24;21;0.0333333333333333;0.466666666666667
Control.SRR15539824;47;40;0.574468085106383;20;27;0.074468085106383;0.425531914893617
Control.SRR15539824;38;40;0.368421052631579;24;14;0.131578947368421;0.368421052631579
Control.SRR15539824;38;40;0.447368421052632;21;17;0.0526315789473684;0.447368421052632
Control.SRR15539824;41;40;0.48780487804878;21;20;0.0121951219512195;0.48780487804878
Control.SRR15539824;42;40;0.476190476190476;22;20;0.0238095238095238;0.476190476190476
Control.SRR15539824;47;40;0.531914893617021;22;25;0.0319148936170213;0.468085106382979
Control.SRR15539824;49;40;0.489795918367347;25;24;0.0102040816326531;0.489795918367347
Control.SRR15539824;40;40;0.55;18;22;0.05;0.45
Control.SRR15539824;41;40;0.365853658536585;26;15;0.134146341463415;0.365853658536585
Control.SRR15539824;42;40;0.452380952380952;23;19;0.0476190476190476;0.452380952380952
Control.SRR15539824;45;40;0.533333333333333;21;24;0.0333333333333333;0.466666666666667
Control.SRR15539824;39;40;0.435897435897436;22;17;0.0641025641025641;0.435897435897436
Control.SRR15539824;39;40;0.435897435897436;22;17;0.0641025641025641;0.435897435897436
Control.SRR15539824;42;40;0.404761904761905;25;17;0.0952380952380952;0.404761904761905
Control.SRR15539824;42;40;0.619047619047619;16;26;0.119047619047619;0.380952380952381
Control.SRR15539824;46;40;0.521739130434783;22;24;0.0217391304347826;0.478260869565217
Control.SRR15539824;48;40;0.583333333333333;20;28;0.0833333333333334;0.416666666666667
Control.SRR15539824;44;40;0.454545454545455;24;20;0.0454545454545455;0.454545454545455
Control.SRR15539824;40;40;0.5;20;20;0;0.5
Control.SRR15539824;44;40;0.522727272727273;21;23;0.0227272727272727;0.477272727272727
Control.SRR15539824;49;40;0.489795918367347;25;24;0.0102040816326531;0.489795918367347
Control.SRR15539824;43;40;0.604651162790698;17;26;0.104651162790698;0.395348837209302
Control.SRR15539824;43;40;0.488372093023256;22;21;0.0116279069767442;0.488372093023256
Control.SRR15539824;46;40;0.456521739130435;25;21;0.0434782608695652;0.456521739130435
Control.SRR15539824;38;40;0.605263157894737;15;23;0.105263157894737;0.394736842105263
Control.SRR15539824;49;40;0.510204081632653;24;25;0.0102040816326531;0.489795918367347
Control.SRR15539824;48;40;0.458333333333333;26;22;0.0416666666666667;0.458333333333333
Control.SRR15539824;39;40;0.358974358974359;25;14;0.141025641025641;0.358974358974359
Control.SRR15539824;41;40;0.414634146341463;24;17;0.0853658536585366;0.414634146341463
Control.SRR15539824;42;40;0.5;21;21;0;0.5
Control.SRR15539824;45;40;0.444444444444444;25;20;0.0555555555555556;0.444444444444444
Control.SRR15539824;46;40;0.456521739130435;25;21;0.0434782608695652;0.456521739130435
Control.SRR15539824;47;40;0.531914893617021;22;25;0.0319148936170213;0.468085106382979
Control.SRR15539824;46;40;0.565217391304348;20;26;0.0652173913043478;0.434782608695652
Control.SRR15539824;48;40;0.625;18;30;0.125;0.375
Control.SRR15539824;45;40;0.4;27;18;0.1;0.4
Control.SRR15539824;49;40;0.551020408163265;22;27;0.0510204081632653;0.448979591836735
Control.SRR15539824;39;40;0.41025641025641;23;16;0.0897435897435898;0.41025641025641
Control.SRR15539824;40;40;0.65;14;26;0.15;0.35
Control.SRR15539824;44;40;0.477272727272727;23;21;0.0227272727272727;0.477272727272727
Control.SRR15539824;38;40;0.394736842105263;23;15;0.105263157894737;0.394736842105263
Control.SRR15539824;46;40;0.543478260869565;21;25;0.0434782608695652;0.456521739130435
Control.SRR15539824;48;40;0.5625;21;27;0.0625;0.4375
Control.SRR15539824;42;40;0.547619047619048;19;23;0.0476190476190477;0.452380952380952
Control.SRR15539824;50;40;0.58;21;29;0.08;0.42
Control.SRR15539824;44;40;0.5;22;22;0;0.5
Control.SRR15539824;43;40;0.581395348837209;18;25;0.0813953488372093;0.418604651162791
Control.SRR15539824;43;40;0.372093023255814;27;16;0.127906976744186;0.372093023255814
Control.SRR15539824;44;40;0.545454545454545;20;24;0.0454545454545454;0.454545454545455
Control.SRR15539824;49;40;0.693877551020408;15;34;0.193877551020408;0.306122448979592
Control.SRR15539824;49;40;0.469387755102041;26;23;0.0306122448979592;0.469387755102041
Control.SRR15539824;42;40;0.452380952380952;23;19;0.0476190476190476;0.452380952380952
Control.SRR15539824;41;40;0.585365853658537;17;24;0.0853658536585366;0.414634146341463
Control.SRR15539824;40;40;0.55;18;22;0.05;0.45
Control.SRR15539824;40;40;0.55;18;22;0.05;0.45
Control.SRR15539824;42;40;0.547619047619048;19;23;0.0476190476190477;0.452380952380952
Control.SRR15539824;42;40;0.523809523809524;20;22;0.0238095238095238;0.476190476190476
Control.SRR15539824;49;40;0.551020408163265;22;27;0.0510204081632653;0.448979591836735
Control.SRR15539824;49;40;0.428571428571429;28;21;0.0714285714285715;0.428571428571429
Control.SRR15539824;50;40;0.5;25;25;0;0.5
Control.SRR15539824;39;40;0.564102564102564;17;22;0.0641025641025641;0.435897435897436
Control.SRR15539824;39;40;0.615384615384615;15;24;0.115384615384615;0.384615384615385
Control.SRR15539824;42;40;0.619047619047619;16;26;0.119047619047619;0.380952380952381
Control.SRR15539824;38;40;0.473684210526316;20;18;0.0263157894736842;0.473684210526316
Control.SRR15539824;48;40;0.375;30;18;0.125;0.375
Control.SRR15539824;44;40;0.5;22;22;0;0.5
Control.SRR15539824;48;40;0.583333333333333;20;28;0.0833333333333334;0.416666666666667
Control.SRR15539824;45;40;0.577777777777778;19;26;0.0777777777777777;0.422222222222222
Control.SRR15539824;40;40;0.525;19;21;0.025;0.475
Control.SRR15539824;49;40;0.469387755102041;26;23;0.0306122448979592;0.469387755102041
Control.SRR15539824;38;40;0.447368421052632;21;17;0.0526315789473684;0.447368421052632
Control.SRR15539824;41;40;0.48780487804878;21;20;0.0121951219512195;0.48780487804878
Control.SRR15539824;42;40;0.595238095238095;17;25;0.0952380952380952;0.404761904761905
Control.SRR15539824;41;40;0.463414634146341;22;19;0.0365853658536585;0.463414634146341
Control.SRR15539824;41;40;0.609756097560976;16;25;0.109756097560976;0.390243902439024
Control.SRR15539824;39;40;0.512820512820513;19;20;0.0128205128205128;0.487179487179487
Control.SRR15539824;43;40;0.395348837209302;26;17;0.104651162790698;0.395348837209302
Control.SRR15539824;50;40;0.5;25;25;0;0.5
Control.SRR15539824;49;40;0.408163265306122;29;20;0.0918367346938775;0.408163265306122
Control.SRR15539824;48;40;0.541666666666667;22;26;0.0416666666666666;0.458333333333333
Control.SRR15539824;42;40;0.523809523809524;20;22;0.0238095238095238;0.476190476190476
Control.SRR15539824;40;40;0.6;16;24;0.1;0.4
Control.SRR15539824;39;40;0.58974358974359;16;23;0.0897435897435898;0.41025641025641
Control.SRR15539824;44;40;0.431818181818182;25;19;0.0681818181818182;0.431818181818182
Control.SRR15539824;44;40;0.659090909090909;15;29;0.159090909090909;0.340909090909091
Control.SRR15539824;44;40;0.431818181818182;25;19;0.0681818181818182;0.431818181818182
Control.SRR15539824;40;40;0.45;22;18;0.05;0.45
Control.SRR15539824;40;40;0.425;23;17;0.075;0.425
Control.SRR15539824;47;40;0.553191489361702;21;26;0.0531914893617021;0.446808510638298
Control.SRR15539824;43;40;0.511627906976744;21;22;0.0116279069767442;0.488372093023256
Control.SRR15539824;50;40;0.34;33;17;0.16;0.34
Control.SRR15539824;48;40;0.479166666666667;25;23;0.0208333333333333;0.479166666666667
Control.SRR15539824;39;40;0.461538461538462;21;18;0.0384615384615384;0.461538461538462
Control.SRR15539824;39;40;0.512820512820513;19;20;0.0128205128205128;0.487179487179487
Control.SRR15539824;45;40;0.444444444444444;25;20;0.0555555555555556;0.444444444444444
Control.SRR15539824;39;40;0.615384615384615;15;24;0.115384615384615;0.384615384615385
Control.SRR15539824;45;40;0.511111111111111;22;23;0.0111111111111111;0.488888888888889
Control.SRR15539824;38;40;0.5;19;19;0;0.5
Control.SRR15539824;45;40;0.422222222222222;26;19;0.0777777777777778;0.422222222222222
Control.SRR15539824;45;40;0.466666666666667;24;21;0.0333333333333333;0.466666666666667
Control.SRR15539824;43;40;0.534883720930233;20;23;0.0348837209302325;0.465116279069767
Control.SRR15539824;42;40;0.5;21;21;0;0.5
Control.SRR15539824;38;40;0.473684210526316;20;18;0.0263157894736842;0.473684210526316
Control.SRR15539824;44;40;0.5;22;22;0;0.5
Control.SRR15539824;42;40;0.619047619047619;16;26;0.119047619047619;0.380952380952381
Control.SRR15539824;50;40;0.54;23;27;0.04;0.46
Control.SRR15539824;46;40;0.369565217391304;29;17;0.130434782608696;0.369565217391304
Control.SRR15539824;39;40;0.512820512820513;19;20;0.0128205128205128;0.487179487179487
Control.SRR15539824;47;40;0.51063829787234;23;24;0.0106382978723404;0.48936170212766
Control.SRR15539824;48;40;0.479166666666667;25;23;0.0208333333333333;0.479166666666667
Control.SRR15539824;49;40;0.428571428571429;28;21;0.0714285714285715;0.428571428571429
Control.SRR15539824;49;40;0.591836734693878;20;29;0.0918367346938775;0.408163265306122
Control.SRR15539824;39;40;0.564102564102564;17;22;0.0641025641025641;0.435897435897436
Control.SRR15539824;41;40;0.536585365853659;19;22;0.0365853658536586;0.463414634146341
Control.SRR15539824;38;40;0.526315789473684;18;20;0.0263157894736842;0.473684210526316
Control.SRR15539824;46;40;0.369565217391304;29;17;0.130434782608696;0.369565217391304
Control.SRR15539824;42;40;0.642857142857143;15;27;0.142857142857143;0.357142857142857
Control.SRR15539824;40;40;0.45;22;18;0.05;0.45
Control.SRR15539824;44;40;0.5;22;22;0;0.5
Control.SRR15539824;46;40;0.521739130434783;22;24;0.0217391304347826;0.478260869565217
Control.SRR15539824;47;40;0.48936170212766;24;23;0.0106382978723404;0.48936170212766
Control.SRR15539824;38;40;0.605263157894737;15;23;0.105263157894737;0.394736842105263
Control.SRR15539824;45;40;0.422222222222222;26;19;0.0777777777777778;0.422222222222222
Control.SRR15539824;50;40;0.42;29;21;0.08;0.42
Control.SRR15539824;42;40;0.619047619047619;16;26;0.119047619047619;0.380952380952381
Control.SRR15539824;39;40;0.461538461538462;21;18;0.0384615384615384;0.461538461538462
Control.SRR15539824;42;40;0.380952380952381;26;16;0.119047619047619;0.380952380952381
Control.SRR15539824;46;40;0.521739130434783;22;24;0.0217391304347826;0.478260869565217
Control.SRR15539824;38;40;0.473684210526316;20;18;0.0263157894736842;0.473684210526316
Control.SRR15539824;47;40;0.595744680851064;19;28;0.0957446808510638;0.404255319148936
Control.SRR15539824;47;40;0.446808510638298;26;21;0.0531914893617021;0.446808510638298
Control.SRR15539824;48;40;0.541666666666667;22;26;0.0416666666666666;0.458333333333333
Control.SRR15539824;47;40;0.595744680851064;19;28;0.0957446808510638;0.404255319148936
Control.SRR15539824;49;40;0.510204081632653;24;25;0.0102040816326531;0.489795918367347
Control.SRR15539824;41;40;0.536585365853659;19;22;0.0365853658536586;0.463414634146341
Control.SRR15539824;39;40;0.641025641025641;14;25;0.141025641025641;0.358974358974359
Control.SRR15539824;49;40;0.469387755102041;26;23;0.0306122448979592;0.469387755102041
Control.SRR15539824;38;40;0.447368421052632;21;17;0.0526315789473684;0.447368421052632
Control.SRR15539824;44;40;0.5;22;22;0;0.5
Control.SRR15539824;49;40;0.510204081632653;24;25;0.0102040816326531;0.489795918367347
Control.SRR15539824;44;40;0.568181818181818;19;25;0.0681818181818182;0.431818181818182
Control.SRR15539824;47;40;0.48936170212766;24;23;0.0106382978723404;0.48936170212766
Control.SRR15539824;47;40;0.468085106382979;25;22;0.0319148936170213;0.468085106382979
Control.SRR15539824;47;40;0.468085106382979;25;22;0.0319148936170213;0.468085106382979
Control.SRR15539824;44;40;0.590909090909091;18;26;0.0909090909090909;0.409090909090909
Control.SRR15539824;43;40;0.488372093023256;22;21;0.0116279069767442;0.488372093023256
Control.SRR15539824;41;40;0.536585365853659;19;22;0.0365853658536586;0.463414634146341
Control.SRR15539824;48;40;0.583333333333333;20;28;0.0833333333333334;0.416666666666667
Control.SRR15539824;44;40;0.590909090909091;18;26;0.0909090909090909;0.409090909090909
Control.SRR15539824;48;40;0.479166666666667;25;23;0.0208333333333333;0.479166666666667
Control.SRR15539824;38;40;0.684210526315789;12;26;0.184210526315789;0.315789473684211
Control.SRR15539824;40;40;0.35;26;14;0.15;0.35
Control.SRR15539824;46;40;0.478260869565217;24;22;0.0217391304347826;0.478260869565217
Control.SRR15539824;45;40;0.488888888888889;23;22;0.0111111111111111;0.488888888888889
Control.SRR15539824;48;40;0.479166666666667;25;23;0.0208333333333333;0.479166666666667
Control.SRR15539824;43;40;0.651162790697674;15;28;0.151162790697674;0.348837209302326
Control.SRR15539824;39;40;0.538461538461538;18;21;0.0384615384615384;0.461538461538462
Control.SRR15539824;46;40;0.434782608695652;26;20;0.0652173913043478;0.434782608695652
Control.SRR15539824;45;40;0.466666666666667;24;21;0.0333333333333333;0.466666666666667
Control.SRR15539824;49;40;0.346938775510204;32;17;0.153061224489796;0.346938775510204
Control.SRR15539824;47;40;0.553191489361702;21;26;0.0531914893617021;0.446808510638298
Control.SRR15539824;46;40;0.5;23;23;0;0.5
Control.SRR15539824;45;40;0.6;18;27;0.1;0.4
Control.SRR15539824;45;40;0.422222222222222;26;19;0.0777777777777778;0.422222222222222
Control.SRR15539824;39;40;0.615384615384615;15;24;0.115384615384615;0.384615384615385
Control.SRR15539824;44;40;0.477272727272727;23;21;0.0227272727272727;0.477272727272727
Control.SRR15539824;43;40;0.511627906976744;21;22;0.0116279069767442;0.488372093023256
Control.SRR15539824;42;40;0.452380952380952;23;19;0.0476190476190476;0.452380952380952
Control.SRR15539824;39;40;0.435897435897436;22;17;0.0641025641025641;0.435897435897436
Control.SRR15539824;44;40;0.431818181818182;25;19;0.0681818181818182;0.431818181818182
Control.SRR15539824;45;40;0.466666666666667;24;21;0.0333333333333333;0.466666666666667
Control.SRR15539824;46;40;0.434782608695652;26;20;0.0652173913043478;0.434782608695652
Control.SRR15539824;38;40;0.473684210526316;20;18;0.0263157894736842;0.473684210526316
Control.SRR15539824;41;40;0.390243902439024;25;16;0.109756097560976;0.390243902439024
Control.SRR15539824;42;40;0.476190476190476;22;20;0.0238095238095238;0.476190476190476
Control.SRR15539824;49;40;0.489795918367347;25;24;0.0102040816326531;0.489795918367347
Control.SRR15539824;42;40;0.523809523809524;20;22;0.0238095238095238;0.476190476190476
Control.SRR15539824;42;40;0.523809523809524;20;22;0.0238095238095238;0.476190476190476
Control.SRR15539824;41;40;0.463414634146341;22;19;0.0365853658536585;0.463414634146341
Control.SRR15539824;40;40;0.55;18;22;0.05;0.45
Control.SRR15539824;40;40;0.45;22;18;0.05;0.45
Control.SRR15539824;43;40;0.372093023255814;27;16;0.127906976744186;0.372093023255814
Control.SRR15539824;46;40;0.717391304347826;13;33;0.217391304347826;0.282608695652174
Control.SRR15539824;42;40;0.595238095238095;17;25;0.0952380952380952;0.404761904761905
Control.SRR15539824;46;40;0.608695652173913;18;28;0.108695652173913;0.391304347826087
Control.SRR15539824;48;40;0.416666666666667;28;20;0.0833333333333333;0.416666666666667
Control.SRR15539824;47;40;0.531914893617021;22;25;0.0319148936170213;0.468085106382979
Control.SRR15539824;43;40;0.511627906976744;21;22;0.0116279069767442;0.488372093023256
Control.SRR15539824;46;40;0.608695652173913;18;28;0.108695652173913;0.391304347826087
Control.SRR15539824;50;40;0.54;23;27;0.04;0.46
Control.SRR15539824;38;40;0.447368421052632;21;17;0.0526315789473684;0.447368421052632
Control.SRR15539824;50;40;0.48;26;24;0.02;0.48
Control.SRR15539824;40;40;0.525;19;21;0.025;0.475
Control.SRR15539824;43;40;0.488372093023256;22;21;0.0116279069767442;0.488372093023256
Control.SRR15539824;39;40;0.487179487179487;20;19;0.0128205128205128;0.487179487179487
Control.SRR15539824;38;40;0.578947368421053;16;22;0.0789473684210527;0.421052631578947
Control.SRR15539824;47;40;0.51063829787234;23;24;0.0106382978723404;0.48936170212766
Control.SRR15539824;47;40;0.48936170212766;24;23;0.0106382978723404;0.48936170212766
Control.SRR15539824;39;40;0.538461538461538;18;21;0.0384615384615384;0.461538461538462
Control.SRR15539824;39;40;0.487179487179487;20;19;0.0128205128205128;0.487179487179487
Control.SRR15539824;44;40;0.431818181818182;25;19;0.0681818181818182;0.431818181818182
Control.SRR15539824;46;40;0.478260869565217;24;22;0.0217391304347826;0.478260869565217
Control.SRR15539824;38;40;0.473684210526316;20;18;0.0263157894736842;0.473684210526316
Control.SRR15539824;47;40;0.51063829787234;23;24;0.0106382978723404;0.48936170212766
Control.SRR15539824;46;40;0.456521739130435;25;21;0.0434782608695652;0.456521739130435
Control.SRR15539824;41;40;0.48780487804878;21;20;0.0121951219512195;0.48780487804878
Control.SRR15539824;38;40;0.552631578947368;17;21;0.0526315789473685;0.447368421052632
Control.SRR15539824;41;40;0.48780487804878;21;20;0.0121951219512195;0.48780487804878
Control.SRR15539824;41;40;0.560975609756098;18;23;0.0609756097560976;0.439024390243902
Control.SRR15539824;42;40;0.452380952380952;23;19;0.0476190476190476;0.452380952380952
Control.SRR15539824;44;40;0.522727272727273;21;23;0.0227272727272727;0.477272727272727
Control.SRR15539824;43;40;0.488372093023256;22;21;0.0116279069767442;0.488372093023256
Control.SRR15539824;47;40;0.595744680851064;19;28;0.0957446808510638;0.404255319148936
Control.SRR15539824;50;40;0.6;20;30;0.1;0.4
Control.SRR15539824;45;40;0.355555555555556;29;16;0.144444444444444;0.355555555555556
Control.SRR15539824;50;40;0.48;26;24;0.02;0.48
Control.SRR15539824;49;40;0.530612244897959;23;26;0.0306122448979592;0.469387755102041
Control.SRR15539824;40;40;0.525;19;21;0.025;0.475
Control.SRR15539824;46;40;0.521739130434783;22;24;0.0217391304347826;0.478260869565217
Control.SRR15539824;47;40;0.425531914893617;27;20;0.074468085106383;0.425531914893617
Control.SRR15539824;38;40;0.263157894736842;28;10;0.236842105263158;0.263157894736842
Control.SRR15539824;41;40;0.536585365853659;19;22;0.0365853658536586;0.463414634146341
Control.SRR15539824;48;40;0.541666666666667;22;26;0.0416666666666666;0.458333333333333
Control.SRR15539824;40;40;0.5;20;20;0;0.5
Control.SRR15539824;45;40;0.488888888888889;23;22;0.0111111111111111;0.488888888888889
Control.SRR15539824;46;40;0.478260869565217;24;22;0.0217391304347826;0.478260869565217
Control.SRR15539824;42;40;0.380952380952381;26;16;0.119047619047619;0.380952380952381
Control.SRR15539824;48;40;0.5625;21;27;0.0625;0.4375
Control.SRR15539824;39;40;0.666666666666667;13;26;0.166666666666667;0.333333333333333
Control.SRR15539824;46;40;0.456521739130435;25;21;0.0434782608695652;0.456521739130435
Control.SRR15539824;48;40;0.479166666666667;25;23;0.0208333333333333;0.479166666666667
Control.SRR15539824;44;40;0.636363636363636;16;28;0.136363636363636;0.363636363636364
Control.SRR15539824;38;40;0.5;19;19;0;0.5
Control.SRR15539824;41;40;0.463414634146341;22;19;0.0365853658536585;0.463414634146341
Control.SRR15539824;41;40;0.463414634146341;22;19;0.0365853658536585;0.463414634146341
Control.SRR15539824;47;40;0.446808510638298;26;21;0.0531914893617021;0.446808510638298
Control.SRR15539824;41;40;0.439024390243902;23;18;0.0609756097560976;0.439024390243902
Control.SRR15539824;40;40;0.525;19;21;0.025;0.475
Control.SRR15539824;48;40;0.645833333333333;17;31;0.145833333333333;0.354166666666667
Control.SRR15539824;43;40;0.27906976744186;31;12;0.22093023255814;0.27906976744186
Control.SRR15539824;45;40;0.555555555555556;20;25;0.0555555555555556;0.444444444444444
Control.SRR15539824;41;40;0.609756097560976;16;25;0.109756097560976;0.390243902439024
Control.SRR15539824;49;40;0.510204081632653;24;25;0.0102040816326531;0.489795918367347
Control.SRR15539824;43;40;0.604651162790698;17;26;0.104651162790698;0.395348837209302
Control.SRR15539824;45;40;0.422222222222222;26;19;0.0777777777777778;0.422222222222222
Control.SRR15539824;41;40;0.439024390243902;23;18;0.0609756097560976;0.439024390243902
Control.SRR15539824;42;40;0.666666666666667;14;28;0.166666666666667;0.333333333333333
Control.SRR15539824;38;40;0.526315789473684;18;20;0.0263157894736842;0.473684210526316
Control.SRR15539824;45;40;0.488888888888889;23;22;0.0111111111111111;0.488888888888889
Control.SRR15539824;45;40;0.666666666666667;15;30;0.166666666666667;0.333333333333333
Control.SRR15539824;39;40;0.564102564102564;17;22;0.0641025641025641;0.435897435897436
Control.SRR15539824;41;40;0.560975609756098;18;23;0.0609756097560976;0.439024390243902
Control.SRR15539824;43;40;0.651162790697674;15;28;0.151162790697674;0.348837209302326
Control.SRR15539824;46;40;0.434782608695652;26;20;0.0652173913043478;0.434782608695652
Control.SRR15539824;39;40;0.461538461538462;21;18;0.0384615384615384;0.461538461538462
Control.SRR15539824;41;40;0.585365853658537;17;24;0.0853658536585366;0.414634146341463
Control.SRR15539824;40;40;0.675;13;27;0.175;0.325
Control.SRR15539824;41;40;0.634146341463415;15;26;0.134146341463415;0.365853658536585
Control.SRR15539824;40;40;0.475;21;19;0.025;0.475
Control.SRR15539824;44;40;0.318181818181818;30;14;0.181818181818182;0.318181818181818
Control.SRR15539824;47;40;0.51063829787234;23;24;0.0106382978723404;0.48936170212766
Control.SRR15539824;47;40;0.553191489361702;21;26;0.0531914893617021;0.446808510638298
Control.SRR15539824;39;40;0.538461538461538;18;21;0.0384615384615384;0.461538461538462
Control.SRR15539824;49;40;0.551020408163265;22;27;0.0510204081632653;0.448979591836735
Control.SRR15539824;38;40;0.552631578947368;17;21;0.0526315789473685;0.447368421052632
Control.SRR15539824;40;40;0.6;16;24;0.1;0.4
Control.SRR15539824;43;40;0.465116279069767;23;20;0.0348837209302326;0.465116279069767
Control.SRR15539824;42;40;0.428571428571429;24;18;0.0714285714285715;0.428571428571429
Control.SRR15539824;50;40;0.52;24;26;0.02;0.48
Control.SRR15539824;46;40;0.521739130434783;22;24;0.0217391304347826;0.478260869565217
Control.SRR15539824;45;40;0.555555555555556;20;25;0.0555555555555556;0.444444444444444
Control.SRR15539824;47;40;0.48936170212766;24;23;0.0106382978723404;0.48936170212766
Control.SRR15539824;45;40;0.466666666666667;24;21;0.0333333333333333;0.466666666666667
Control.SRR15539824;39;40;0.538461538461538;18;21;0.0384615384615384;0.461538461538462
Control.SRR15539824;43;40;0.627906976744186;16;27;0.127906976744186;0.372093023255814
Control.SRR15539824;48;40;0.520833333333333;23;25;0.0208333333333334;0.479166666666667
Control.SRR15539824;36;40;0.5;18;18;0;0.5
Control.SRR15539824;36;40;0.388888888888889;22;14;0.111111111111111;0.388888888888889
Control.SRR15539824;42;40;0.571428571428571;18;24;0.0714285714285714;0.428571428571429
Control.SRR15539824;40;40;0.475;21;19;0.025;0.475
Control.SRR15539824;36;40;0.416666666666667;21;15;0.0833333333333333;0.416666666666667
Control.SRR15539824;42;40;0.642857142857143;15;27;0.142857142857143;0.357142857142857
Control.SRR15539824;41;40;0.48780487804878;21;20;0.0121951219512195;0.48780487804878
Control.SRR15539824;38;40;0.657894736842105;13;25;0.157894736842105;0.342105263157895
Control.SRR15539824;40;40;0.325;27;13;0.175;0.325
Control.SRR15539824;40;40;0.6;16;24;0.1;0.4
Control.SRR15539824;43;40;0.465116279069767;23;20;0.0348837209302326;0.465116279069767
Control.SRR15539824;34;40;0.529411764705882;16;18;0.0294117647058824;0.470588235294118
Control.SRR15539824;33;40;0.484848484848485;17;16;0.0151515151515151;0.484848484848485
Control.SRR15539824;40;40;0.45;22;18;0.05;0.45
Control.SRR15539824;39;40;0.538461538461538;18;21;0.0384615384615384;0.461538461538462
Control.SRR15539824;34;40;0.647058823529412;12;22;0.147058823529412;0.352941176470588
Control.SRR15539824;36;40;0.444444444444444;20;16;0.0555555555555556;0.444444444444444
Control.SRR15539824;42;40;0.571428571428571;18;24;0.0714285714285714;0.428571428571429
Control.SRR15539824;38;40;0.657894736842105;13;25;0.157894736842105;0.342105263157895
Control.SRR15539824;40;40;0.325;27;13;0.175;0.325
Control.SRR15539824;34;40;0.441176470588235;19;15;0.0588235294117647;0.441176470588235
Control.SRR15539824;36;40;0.444444444444444;20;16;0.0555555555555556;0.444444444444444
Control.SRR15539824;36;40;0.361111111111111;23;13;0.138888888888889;0.361111111111111
Control.SRR15539824;35;40;0.6;14;21;0.1;0.4
Control.SRR15539824;39;40;0.41025641025641;23;16;0.0897435897435898;0.41025641025641
Control.SRR15539824;34;40;0.382352941176471;21;13;0.117647058823529;0.382352941176471
Control.SRR15539824;43;40;0.534883720930233;20;23;0.0348837209302325;0.465116279069767
Control.SRR15539824;42;40;0.571428571428571;18;24;0.0714285714285714;0.428571428571429
Control.SRR15539824;37;40;0.540540540540541;17;20;0.0405405405405406;0.459459459459459
Control.SRR15539824;43;40;0.604651162790698;17;26;0.104651162790698;0.395348837209302
Control.SRR15539824;41;40;0.463414634146341;22;19;0.0365853658536585;0.463414634146341
Control.SRR15539824;43;40;0.511627906976744;21;22;0.0116279069767442;0.488372093023256
Control.SRR15539824;36;40;0.555555555555556;16;20;0.0555555555555556;0.444444444444444
Control.SRR15539824;37;40;0.594594594594595;15;22;0.0945945945945946;0.405405405405405
Control.SRR15539824;43;40;0.372093023255814;27;16;0.127906976744186;0.372093023255814
Control.SRR15539824;39;40;0.58974358974359;16;23;0.0897435897435898;0.41025641025641
Control.SRR15539824;33;40;0.636363636363636;12;21;0.136363636363636;0.363636363636364
Control.SRR15539824;38;40;0.447368421052632;21;17;0.0526315789473684;0.447368421052632
Control.SRR15539824;43;40;0.441860465116279;24;19;0.0581395348837209;0.441860465116279
Control.SRR15539824;43;40;0.511627906976744;21;22;0.0116279069767442;0.488372093023256
Control.SRR15539824;39;40;0.512820512820513;19;20;0.0128205128205128;0.487179487179487
Control.SRR15539824;43;40;0.418604651162791;25;18;0.0813953488372093;0.418604651162791
Control.SRR15539824;38;40;0.473684210526316;20;18;0.0263157894736842;0.473684210526316
Control.SRR15539824;40;40;0.55;18;22;0.05;0.45
Control.SRR15539824;33;40;0.454545454545455;18;15;0.0454545454545455;0.454545454545455
Control.SRR15539824;35;40;0.4;21;14;0.1;0.4
Control.SRR15539824;37;40;0.594594594594595;15;22;0.0945945945945946;0.405405405405405
Control.SRR15539824;37;40;0.459459459459459;20;17;0.0405405405405405;0.459459459459459
Control.SRR15539824;36;40;0.5;18;18;0;0.5
Control.SRR15539824;33;40;0.575757575757576;14;19;0.0757575757575758;0.424242424242424
Control.SRR15539824;40;40;0.55;18;22;0.05;0.45
Control.SRR15539824;42;40;0.523809523809524;20;22;0.0238095238095238;0.476190476190476
Control.SRR15539824;36;40;0.361111111111111;23;13;0.138888888888889;0.361111111111111
Control.SRR15539824;36;40;0.416666666666667;21;15;0.0833333333333333;0.416666666666667
Control.SRR15539824;42;40;0.595238095238095;17;25;0.0952380952380952;0.404761904761905
Control.SRR15539824;43;40;0.465116279069767;23;20;0.0348837209302326;0.465116279069767
Control.SRR15539824;40;40;0.55;18;22;0.05;0.45
Control.SRR15539824;36;40;0.472222222222222;19;17;0.0277777777777778;0.472222222222222
Control.SRR15539824;41;40;0.463414634146341;22;19;0.0365853658536585;0.463414634146341
Control.SRR15539824;41;40;0.536585365853659;19;22;0.0365853658536586;0.463414634146341
Control.SRR15539824;39;40;0.461538461538462;21;18;0.0384615384615384;0.461538461538462
Control.SRR15539824;35;40;0.485714285714286;18;17;0.0142857142857143;0.485714285714286
Control.SRR15539824;35;40;0.514285714285714;17;18;0.0142857142857142;0.485714285714286
Control.SRR15539824;37;40;0.648648648648649;13;24;0.148648648648649;0.351351351351351
Control.SRR15539824;43;40;0.395348837209302;26;17;0.104651162790698;0.395348837209302
Control.SRR15539824;34;40;0.441176470588235;19;15;0.0588235294117647;0.441176470588235
Control.SRR15539824;38;40;0.473684210526316;20;18;0.0263157894736842;0.473684210526316
Control.SRR15539824;38;40;0.421052631578947;22;16;0.0789473684210527;0.421052631578947
Control.SRR15539824;37;40;0.594594594594595;15;22;0.0945945945945946;0.405405405405405
Control.SRR15539824;35;40;0.6;14;21;0.1;0.4
Control.SRR15539824;34;40;0.647058823529412;12;22;0.147058823529412;0.352941176470588
Control.SRR15539824;41;40;0.51219512195122;20;21;0.0121951219512195;0.48780487804878
Control.SRR15539824;42;40;0.476190476190476;22;20;0.0238095238095238;0.476190476190476
Control.SRR15539824;42;40;0.380952380952381;26;16;0.119047619047619;0.380952380952381
Control.SRR15539824;38;40;0.5;19;19;0;0.5
Control.SRR15539824;34;40;0.470588235294118;18;16;0.0294117647058824;0.470588235294118
Control.SRR15539824;34;40;0.411764705882353;20;14;0.0882352941176471;0.411764705882353
Control.SRR15539824;38;40;0.5;19;19;0;0.5
Control.SRR15539824;43;40;0.465116279069767;23;20;0.0348837209302326;0.465116279069767
Control.SRR15539824;42;40;0.404761904761905;25;17;0.0952380952380952;0.404761904761905
Control.SRR15539824;35;40;0.4;21;14;0.1;0.4
Control.SRR15539824;34;40;0.647058823529412;12;22;0.147058823529412;0.352941176470588
Control.SRR15539824;33;40;0.515151515151515;16;17;0.0151515151515151;0.484848484848485
Control.SRR15539824;40;40;0.475;21;19;0.025;0.475
Control.SRR15539824;35;40;0.371428571428571;22;13;0.128571428571429;0.371428571428571
Control.SRR15539824;40;40;0.425;23;17;0.075;0.425
Control.SRR15539824;38;40;0.421052631578947;22;16;0.0789473684210527;0.421052631578947
Control.SRR15539824;40;40;0.475;21;19;0.025;0.475
Control.SRR15539824;43;40;0.348837209302326;28;15;0.151162790697674;0.348837209302326
Control.SRR15539824;36;40;0.611111111111111;14;22;0.111111111111111;0.388888888888889
Control.SRR15539824;39;40;0.435897435897436;22;17;0.0641025641025641;0.435897435897436
Control.SRR15539824;36;40;0.416666666666667;21;15;0.0833333333333333;0.416666666666667
Control.SRR15539824;36;40;0.444444444444444;20;16;0.0555555555555556;0.444444444444444
Control.SRR15539824;37;40;0.432432432432432;21;16;0.0675675675675675;0.432432432432432
Control.SRR15539824;36;40;0.555555555555556;16;20;0.0555555555555556;0.444444444444444
Control.SRR15539824;40;40;0.425;23;17;0.075;0.425
Control.SRR15539824;40;40;0.55;18;22;0.05;0.45
Control.SRR15539824;36;40;0.472222222222222;19;17;0.0277777777777778;0.472222222222222
Control.SRR15539824;39;40;0.58974358974359;16;23;0.0897435897435898;0.41025641025641
Control.SRR15539824;40;40;0.45;22;18;0.05;0.45
Control.SRR15539824;40;40;0.475;21;19;0.025;0.475
Control.SRR15539824;36;40;0.5;18;18;0;0.5
Control.SRR15539824;36;40;0.444444444444444;20;16;0.0555555555555556;0.444444444444444
Control.SRR15539824;36;40;0.333333333333333;24;12;0.166666666666667;0.333333333333333
Control.SRR15539824;36;40;0.555555555555556;16;20;0.0555555555555556;0.444444444444444
Control.SRR15539824;40;40;0.475;21;19;0.025;0.475
Control.SRR15539824;33;40;0.424242424242424;19;14;0.0757575757575757;0.424242424242424
Control.SRR15539824;34;40;0.382352941176471;21;13;0.117647058823529;0.382352941176471
Control.SRR15539824;37;40;0.486486486486487;19;18;0.0135135135135135;0.486486486486487
Control.SRR15539824;35;40;0.657142857142857;12;23;0.157142857142857;0.342857142857143
Control.SRR15539824;37;40;0.405405405405405;22;15;0.0945945945945946;0.405405405405405
Control.SRR15539824;39;40;0.435897435897436;22;17;0.0641025641025641;0.435897435897436
Control.SRR15539824;35;40;0.485714285714286;18;17;0.0142857142857143;0.485714285714286
Control.SRR15539824;35;40;0.4;21;14;0.1;0.4
Control.SRR15539824;37;40;0.540540540540541;17;20;0.0405405405405406;0.459459459459459
Control.SRR15539824;34;40;0.647058823529412;12;22;0.147058823529412;0.352941176470588
Control.SRR15539824;34;40;0.529411764705882;16;18;0.0294117647058824;0.470588235294118
Control.SRR15539824;35;40;0.542857142857143;16;19;0.0428571428571428;0.457142857142857
Control.SRR15539824;39;40;0.538461538461538;18;21;0.0384615384615384;0.461538461538462
Control.SRR15539824;35;40;0.428571428571429;20;15;0.0714285714285715;0.428571428571429
Control.SRR15539824;34;40;0.588235294117647;14;20;0.0882352941176471;0.411764705882353
Control.SRR15539824;35;40;0.428571428571429;20;15;0.0714285714285715;0.428571428571429
Control.SRR15539824;38;40;0.526315789473684;18;20;0.0263157894736842;0.473684210526316
Control.SRR15539824;38;40;0.5;19;19;0;0.5
Control.SRR15539824;36;40;0.555555555555556;16;20;0.0555555555555556;0.444444444444444
Control.SRR15539824;36;40;0.472222222222222;19;17;0.0277777777777778;0.472222222222222
Control.SRR15539824;41;40;0.585365853658537;17;24;0.0853658536585366;0.414634146341463
Control.SRR15539824;42;40;0.714285714285714;12;30;0.214285714285714;0.285714285714286
Control.SRR15539824;43;40;0.558139534883721;19;24;0.0581395348837209;0.441860465116279
Control.SRR15539824;33;40;0.484848484848485;17;16;0.0151515151515151;0.484848484848485
Control.SRR15539824;41;40;0.341463414634146;27;14;0.158536585365854;0.341463414634146
Control.SRR15539824;41;40;0.609756097560976;16;25;0.109756097560976;0.390243902439024
Control.SRR15539824;37;40;0.513513513513513;18;19;0.0135135135135135;0.486486486486487
Control.SRR15539824;43;40;0.604651162790698;17;26;0.104651162790698;0.395348837209302
Control.SRR15539824;40;40;0.275;29;11;0.225;0.275
Control.SRR15539824;34;40;0.588235294117647;14;20;0.0882352941176471;0.411764705882353
Control.SRR15539824;37;40;0.621621621621622;14;23;0.121621621621622;0.378378378378378
Control.SRR15539824;41;40;0.463414634146341;22;19;0.0365853658536585;0.463414634146341
Control.SRR15539824;41;40;0.414634146341463;24;17;0.0853658536585366;0.414634146341463
Control.SRR15539824;42;40;0.523809523809524;20;22;0.0238095238095238;0.476190476190476
Control.SRR15539824;35;40;0.542857142857143;16;19;0.0428571428571428;0.457142857142857
Control.SRR15539824;39;40;0.461538461538462;21;18;0.0384615384615384;0.461538461538462
Control.SRR15539824;37;40;0.486486486486487;19;18;0.0135135135135135;0.486486486486487
Control.SRR15539824;35;40;0.514285714285714;17;18;0.0142857142857142;0.485714285714286
Control.SRR15539824;41;40;0.536585365853659;19;22;0.0365853658536586;0.463414634146341
Control.SRR15539824;38;40;0.578947368421053;16;22;0.0789473684210527;0.421052631578947
Control.SRR15539824;34;40;0.411764705882353;20;14;0.0882352941176471;0.411764705882353
Control.SRR15539824;35;40;0.571428571428571;15;20;0.0714285714285714;0.428571428571429
Control.SRR15539824;43;40;0.558139534883721;19;24;0.0581395348837209;0.441860465116279
Control.SRR15539824;35;40;0.457142857142857;19;16;0.0428571428571429;0.457142857142857
Control.SRR15539824;33;40;0.636363636363636;12;21;0.136363636363636;0.363636363636364
Control.SRR15539824;39;40;0.487179487179487;20;19;0.0128205128205128;0.487179487179487
Control.SRR15539824;37;40;0.513513513513513;18;19;0.0135135135135135;0.486486486486487
Control.SRR15539824;40;40;0.425;23;17;0.075;0.425
Control.SRR15539824;35;40;0.285714285714286;25;10;0.214285714285714;0.285714285714286
Control.SRR15539824;40;40;0.6;16;24;0.1;0.4
Control.SRR15539824;35;40;0.4;21;14;0.1;0.4
Control.SRR15539824;41;40;0.707317073170732;12;29;0.207317073170732;0.292682926829268
Control.SRR15539824;34;40;0.529411764705882;16;18;0.0294117647058824;0.470588235294118
Control.SRR15539824;40;40;0.65;14;26;0.15;0.35
Control.SRR15539824;37;40;0.405405405405405;22;15;0.0945945945945946;0.405405405405405
Control.SRR15539824;41;40;0.439024390243902;23;18;0.0609756097560976;0.439024390243902
Control.SRR15539824;33;40;0.424242424242424;19;14;0.0757575757575757;0.424242424242424
Control.SRR15539824;42;40;0.404761904761905;25;17;0.0952380952380952;0.404761904761905
Control.SRR15539824;35;40;0.314285714285714;24;11;0.185714285714286;0.314285714285714
Control.SRR15539824;38;40;0.368421052631579;24;14;0.131578947368421;0.368421052631579
Control.SRR15539824;37;40;0.459459459459459;20;17;0.0405405405405405;0.459459459459459
Control.SRR15539824;34;40;0.588235294117647;14;20;0.0882352941176471;0.411764705882353
Control.SRR15539824;43;40;0.441860465116279;24;19;0.0581395348837209;0.441860465116279
Control.SRR15539824;39;40;0.564102564102564;17;22;0.0641025641025641;0.435897435897436
Control.SRR15539824;37;40;0.513513513513513;18;19;0.0135135135135135;0.486486486486487
Control.SRR15539824;43;40;0.558139534883721;19;24;0.0581395348837209;0.441860465116279
Control.SRR15539824;43;40;0.581395348837209;18;25;0.0813953488372093;0.418604651162791
Control.SRR15539824;40;40;0.475;21;19;0.025;0.475
Control.SRR15539824;43;40;0.581395348837209;18;25;0.0813953488372093;0.418604651162791
Control.SRR15539824;42;40;0.5;21;21;0;0.5
Control.SRR15539824;41;40;0.463414634146341;22;19;0.0365853658536585;0.463414634146341
Control.SRR15539824;42;40;0.428571428571429;24;18;0.0714285714285715;0.428571428571429
Control.SRR15539824;37;40;0.432432432432432;21;16;0.0675675675675675;0.432432432432432
Control.SRR15539824;37;40;0.432432432432432;21;16;0.0675675675675675;0.432432432432432
Control.SRR15539824;35;40;0.571428571428571;15;20;0.0714285714285714;0.428571428571429
Control.SRR15539824;39;40;0.487179487179487;20;19;0.0128205128205128;0.487179487179487
Control.SRR15539824;41;40;0.48780487804878;21;20;0.0121951219512195;0.48780487804878
Control.SRR15539824;38;40;0.605263157894737;15;23;0.105263157894737;0.394736842105263
Control.SRR15539824;36;40;0.527777777777778;17;19;0.0277777777777778;0.472222222222222
Control.SRR15539824;36;40;0.611111111111111;14;22;0.111111111111111;0.388888888888889
Control.SRR15539824;41;40;0.51219512195122;20;21;0.0121951219512195;0.48780487804878
Control.SRR15539824;33;40;0.484848484848485;17;16;0.0151515151515151;0.484848484848485
Control.SRR15539824;38;40;0.5;19;19;0;0.5
Control.SRR15539824;34;40;0.352941176470588;22;12;0.147058823529412;0.352941176470588
Control.SRR15539824;37;40;0.405405405405405;22;15;0.0945945945945946;0.405405405405405
Control.SRR15539824;37;40;0.432432432432432;21;16;0.0675675675675675;0.432432432432432
Control.SRR15539824;35;40;0.6;14;21;0.1;0.4
Control.SRR15539824;35;40;0.428571428571429;20;15;0.0714285714285715;0.428571428571429
Control.SRR15539824;40;40;0.425;23;17;0.075;0.425
Control.SRR15539824;41;40;0.585365853658537;17;24;0.0853658536585366;0.414634146341463
Control.SRR15539824;34;40;0.5;17;17;0;0.5
Control.SRR15539824;34;40;0.5;17;17;0;0.5
Control.SRR15539824;41;40;0.439024390243902;23;18;0.0609756097560976;0.439024390243902
Control.SRR15539824;41;40;0.658536585365854;14;27;0.158536585365854;0.341463414634146
Control.SRR15539824;36;40;0.444444444444444;20;16;0.0555555555555556;0.444444444444444
Control.SRR15539824;40;40;0.425;23;17;0.075;0.425
Control.SRR15539824;42;40;0.523809523809524;20;22;0.0238095238095238;0.476190476190476
Control.SRR15539824;41;40;0.414634146341463;24;17;0.0853658536585366;0.414634146341463
Control.SRR15539824;35;40;0.4;21;14;0.1;0.4
Control.SRR15539824;37;40;0.405405405405405;22;15;0.0945945945945946;0.405405405405405
Control.SRR15539824;41;40;0.439024390243902;23;18;0.0609756097560976;0.439024390243902
Control.SRR15539824;40;40;0.525;19;21;0.025;0.475
Control.SRR15539824;37;40;0.540540540540541;17;20;0.0405405405405406;0.459459459459459
Control.SRR15539824;37;40;0.297297297297297;26;11;0.202702702702703;0.297297297297297
Control.SRR15539824;41;40;0.536585365853659;19;22;0.0365853658536586;0.463414634146341
Control.SRR15539824;40;40;0.525;19;21;0.025;0.475
Control.SRR15539824;35;40;0.542857142857143;16;19;0.0428571428571428;0.457142857142857
Control.SRR15539824;36;40;0.444444444444444;20;16;0.0555555555555556;0.444444444444444
Control.SRR15539824;34;40;0.411764705882353;20;14;0.0882352941176471;0.411764705882353
Control.SRR15539824;35;40;0.285714285714286;25;10;0.214285714285714;0.285714285714286
Control.SRR15539824;34;40;0.382352941176471;21;13;0.117647058823529;0.382352941176471
Control.SRR15539824;38;40;0.526315789473684;18;20;0.0263157894736842;0.473684210526316
Control.SRR15539824;36;40;0.527777777777778;17;19;0.0277777777777778;0.472222222222222
Control.SRR15539824;41;40;0.439024390243902;23;18;0.0609756097560976;0.439024390243902
Control.SRR15539824;38;40;0.526315789473684;18;20;0.0263157894736842;0.473684210526316
Control.SRR15539824;38;40;0.552631578947368;17;21;0.0526315789473685;0.447368421052632
Control.SRR15539824;40;40;0.45;22;18;0.05;0.45
Control.SRR15539824;35;40;0.4;21;14;0.1;0.4
Control.SRR15539824;33;40;0.606060606060606;13;20;0.106060606060606;0.393939393939394
Control.SRR15539824;41;40;0.560975609756098;18;23;0.0609756097560976;0.439024390243902
Control.SRR15539824;34;40;0.529411764705882;16;18;0.0294117647058824;0.470588235294118
Control.SRR15539824;37;40;0.567567567567568;16;21;0.0675675675675675;0.432432432432432
Control.SRR15539824;35;40;0.628571428571429;13;22;0.128571428571429;0.371428571428571
Control.SRR15539824;36;40;0.5;18;18;0;0.5
Control.SRR15539824;42;40;0.476190476190476;22;20;0.0238095238095238;0.476190476190476
Control.SRR15539824;43;40;0.395348837209302;26;17;0.104651162790698;0.395348837209302
Control.SRR15539824;38;40;0.684210526315789;12;26;0.184210526315789;0.315789473684211
Control.SRR15539824;35;40;0.457142857142857;19;16;0.0428571428571429;0.457142857142857
Control.SRR15539824;36;40;0.472222222222222;19;17;0.0277777777777778;0.472222222222222
Control.SRR15539824;35;40;0.371428571428571;22;13;0.128571428571429;0.371428571428571
Control.SRR15539824;35;40;0.6;14;21;0.1;0.4
Control.SRR15539824;43;40;0.581395348837209;18;25;0.0813953488372093;0.418604651162791
Control.SRR15539824;42;40;0.523809523809524;20;22;0.0238095238095238;0.476190476190476
Control.SRR15539824;37;40;0.540540540540541;17;20;0.0405405405405406;0.459459459459459
Control.SRR15539824;42;40;0.404761904761905;25;17;0.0952380952380952;0.404761904761905
Control.SRR15539824;42;40;0.523809523809524;20;22;0.0238095238095238;0.476190476190476
Control.SRR15539824;33;40;0.515151515151515;16;17;0.0151515151515151;0.484848484848485
Control.SRR15539824;37;40;0.459459459459459;20;17;0.0405405405405405;0.459459459459459
Control.SRR15539824;35;40;0.542857142857143;16;19;0.0428571428571428;0.457142857142857
Control.SRR15539824;39;40;0.358974358974359;25;14;0.141025641025641;0.358974358974359
Control.SRR15539824;40;40;0.475;21;19;0.025;0.475
Control.SRR15539824;37;40;0.432432432432432;21;16;0.0675675675675675;0.432432432432432
Control.SRR15539824;38;40;0.473684210526316;20;18;0.0263157894736842;0.473684210526316
Control.SRR15539824;35;40;0.657142857142857;12;23;0.157142857142857;0.342857142857143
Control.SRR15539824;42;40;0.428571428571429;24;18;0.0714285714285715;0.428571428571429
Control.SRR15539824;33;40;0.606060606060606;13;20;0.106060606060606;0.393939393939394
Control.SRR15539824;33;40;0.575757575757576;14;19;0.0757575757575758;0.424242424242424
Control.SRR15539824;35;40;0.485714285714286;18;17;0.0142857142857143;0.485714285714286
Control.SRR15539824;42;40;0.5;21;21;0;0.5
Control.SRR15539824;42;40;0.523809523809524;20;22;0.0238095238095238;0.476190476190476
Control.SRR15539824;42;40;0.547619047619048;19;23;0.0476190476190477;0.452380952380952
Control.SRR15539824;42;40;0.428571428571429;24;18;0.0714285714285715;0.428571428571429
Control.SRR15539824;37;40;0.540540540540541;17;20;0.0405405405405406;0.459459459459459
Control.SRR15539824;36;40;0.555555555555556;16;20;0.0555555555555556;0.444444444444444
Control.SRR15539824;42;40;0.571428571428571;18;24;0.0714285714285714;0.428571428571429
Control.SRR15539824;34;40;0.529411764705882;16;18;0.0294117647058824;0.470588235294118
Control.SRR15539824;36;40;0.416666666666667;21;15;0.0833333333333333;0.416666666666667
Control.SRR15539824;33;40;0.484848484848485;17;16;0.0151515151515151;0.484848484848485
Control.SRR15539824;37;40;0.432432432432432;21;16;0.0675675675675675;0.432432432432432
Control.SRR15539824;33;40;0.484848484848485;17;16;0.0151515151515151;0.484848484848485
Control.SRR15539824;35;40;0.485714285714286;18;17;0.0142857142857143;0.485714285714286
Control.SRR15539824;35;40;0.485714285714286;18;17;0.0142857142857143;0.485714285714286
Control.SRR15539824;33;40;0.606060606060606;13;20;0.106060606060606;0.393939393939394
Control.SRR15539824;36;40;0.555555555555556;16;20;0.0555555555555556;0.444444444444444
Control.SRR15539824;35;40;0.4;21;14;0.1;0.4
Control.SRR15539824;33;40;0.333333333333333;22;11;0.166666666666667;0.333333333333333
Control.SRR15539824;38;40;0.526315789473684;18;20;0.0263157894736842;0.473684210526316
Control.SRR15539824;38;40;0.394736842105263;23;15;0.105263157894737;0.394736842105263
Control.SRR15539824;33;40;0.606060606060606;13;20;0.106060606060606;0.393939393939394
Control.SRR15539824;41;40;0.463414634146341;22;19;0.0365853658536585;0.463414634146341
Control.SRR15539824;33;40;0.636363636363636;12;21;0.136363636363636;0.363636363636364
Control.SRR15539824;42;40;0.5;21;21;0;0.5
Control.SRR15539824;39;40;0.358974358974359;25;14;0.141025641025641;0.358974358974359
Control.SRR15539824;35;40;0.571428571428571;15;20;0.0714285714285714;0.428571428571429
Control.SRR15539824;37;40;0.324324324324324;25;12;0.175675675675676;0.324324324324324
Control.SRR15539824;38;40;0.473684210526316;20;18;0.0263157894736842;0.473684210526316
Control.SRR15539824;36;40;0.5;18;18;0;0.5
Control.SRR15539824;42;40;0.452380952380952;23;19;0.0476190476190476;0.452380952380952
Control.SRR15539824;38;40;0.5;19;19;0;0.5
Control.SRR15539824;41;40;0.48780487804878;21;20;0.0121951219512195;0.48780487804878
Control.SRR15539824;35;40;0.342857142857143;23;12;0.157142857142857;0.342857142857143
Control.SRR15539824;33;40;0.606060606060606;13;20;0.106060606060606;0.393939393939394
Control.SRR15539824;34;40;0.5;17;17;0;0.5
Control.SRR15539824;34;40;0.470588235294118;18;16;0.0294117647058824;0.470588235294118
Control.SRR15539824;42;40;0.523809523809524;20;22;0.0238095238095238;0.476190476190476
Control.SRR15539824;42;40;0.5;21;21;0;0.5
Control.SRR15539824;37;40;0.486486486486487;19;18;0.0135135135135135;0.486486486486487
Control.SRR15539824;34;40;0.617647058823529;13;21;0.117647058823529;0.382352941176471
Control.SRR15539824;33;40;0.212121212121212;26;7;0.287878787878788;0.212121212121212
Control.SRR15539824;34;40;0.617647058823529;13;21;0.117647058823529;0.382352941176471
Control.SRR15539824;35;40;0.485714285714286;18;17;0.0142857142857143;0.485714285714286
Control.SRR15539824;35;40;0.4;21;14;0.1;0.4
Control.SRR15539824;42;40;0.428571428571429;24;18;0.0714285714285715;0.428571428571429
Control.SRR15539824;36;40;0.611111111111111;14;22;0.111111111111111;0.388888888888889
Control.SRR15539824;37;40;0.432432432432432;21;16;0.0675675675675675;0.432432432432432
Control.SRR15539824;33;40;0.636363636363636;12;21;0.136363636363636;0.363636363636364
Control.SRR15539824;37;40;0.432432432432432;21;16;0.0675675675675675;0.432432432432432
Control.SRR15539824;39;40;0.538461538461538;18;21;0.0384615384615384;0.461538461538462
Control.SRR15539824;38;40;0.552631578947368;17;21;0.0526315789473685;0.447368421052632
Control.SRR15539824;42;40;0.595238095238095;17;25;0.0952380952380952;0.404761904761905
Control.SRR15539824;39;40;0.487179487179487;20;19;0.0128205128205128;0.487179487179487
Control.SRR15539824;38;40;0.421052631578947;22;16;0.0789473684210527;0.421052631578947
Control.SRR15539824;40;40;0.525;19;21;0.025;0.475
Control.SRR15539824;36;40;0.472222222222222;19;17;0.0277777777777778;0.472222222222222
Control.SRR15539824;43;40;0.558139534883721;19;24;0.0581395348837209;0.441860465116279
Control.SRR15539824;36;40;0.472222222222222;19;17;0.0277777777777778;0.472222222222222
Control.SRR15539824;33;40;0.454545454545455;18;15;0.0454545454545455;0.454545454545455
Control.SRR15539824;41;40;0.707317073170732;12;29;0.207317073170732;0.292682926829268
Control.SRR15539824;42;40;0.428571428571429;24;18;0.0714285714285715;0.428571428571429
Control.SRR15539824;34;40;0.5;17;17;0;0.5
Control.SRR15539824;36;40;0.5;18;18;0;0.5
Control.SRR15539824;34;40;0.470588235294118;18;16;0.0294117647058824;0.470588235294118
Control.SRR15539824;35;40;0.542857142857143;16;19;0.0428571428571428;0.457142857142857
Control.SRR15539824;43;40;0.581395348837209;18;25;0.0813953488372093;0.418604651162791
Control.SRR15539824;39;40;0.512820512820513;19;20;0.0128205128205128;0.487179487179487
Control.SRR15539824;39;40;0.487179487179487;20;19;0.0128205128205128;0.487179487179487
Control.SRR15539824;38;40;0.526315789473684;18;20;0.0263157894736842;0.473684210526316
Control.SRR15539824;41;40;0.463414634146341;22;19;0.0365853658536585;0.463414634146341
Control.SRR15539824;35;40;0.514285714285714;17;18;0.0142857142857142;0.485714285714286
Control.SRR15539824;38;40;0.473684210526316;20;18;0.0263157894736842;0.473684210526316
Control.SRR15539824;42;40;0.595238095238095;17;25;0.0952380952380952;0.404761904761905
Control.SRR15539824;35;40;0.485714285714286;18;17;0.0142857142857143;0.485714285714286
Control.SRR15539824;36;40;0.555555555555556;16;20;0.0555555555555556;0.444444444444444
Control.SRR15539824;43;40;0.511627906976744;21;22;0.0116279069767442;0.488372093023256
Control.SRR15539824;42;40;0.452380952380952;23;19;0.0476190476190476;0.452380952380952
Control.SRR15539824;35;40;0.514285714285714;17;18;0.0142857142857142;0.485714285714286
Control.SRR15539824;33;40;0.484848484848485;17;16;0.0151515151515151;0.484848484848485
Control.SRR15539824;39;40;0.487179487179487;20;19;0.0128205128205128;0.487179487179487
Control.SRR15539824;39;40;0.487179487179487;20;19;0.0128205128205128;0.487179487179487
Control.SRR15539824;42;40;0.452380952380952;23;19;0.0476190476190476;0.452380952380952
Control.SRR15539824;37;40;0.513513513513513;18;19;0.0135135135135135;0.486486486486487
Control.SRR15539824;38;40;0.5;19;19;0;0.5
Control.SRR15539824;38;40;0.552631578947368;17;21;0.0526315789473685;0.447368421052632
Control.SRR15539824;40;40;0.5;20;20;0;0.5
Control.SRR15539824;43;40;0.604651162790698;17;26;0.104651162790698;0.395348837209302
Control.SRR15539824;33;40;0.515151515151515;16;17;0.0151515151515151;0.484848484848485
Control.SRR15539824;39;40;0.435897435897436;22;17;0.0641025641025641;0.435897435897436
Control.SRR15539824;35;40;0.457142857142857;19;16;0.0428571428571429;0.457142857142857
Control.SRR15539824;33;40;0.424242424242424;19;14;0.0757575757575757;0.424242424242424
Control.SRR15539824;34;40;0.352941176470588;22;12;0.147058823529412;0.352941176470588
Control.SRR15539824;38;40;0.578947368421053;16;22;0.0789473684210527;0.421052631578947
Control.SRR15539824;42;40;0.547619047619048;19;23;0.0476190476190477;0.452380952380952
Control.SRR15539824;33;40;0.424242424242424;19;14;0.0757575757575757;0.424242424242424
Control.SRR15539824;42;40;0.357142857142857;27;15;0.142857142857143;0.357142857142857
Control.SRR15539824;41;40;0.51219512195122;20;21;0.0121951219512195;0.48780487804878
Control.SRR15539824;36;40;0.361111111111111;23;13;0.138888888888889;0.361111111111111
Control.SRR15539824;34;40;0.529411764705882;16;18;0.0294117647058824;0.470588235294118
Control.SRR15539824;33;40;0.666666666666667;11;22;0.166666666666667;0.333333333333333
Control.SRR15539824;34;40;0.411764705882353;20;14;0.0882352941176471;0.411764705882353
Control.SRR15539824;34;40;0.470588235294118;18;16;0.0294117647058824;0.470588235294118
Control.SRR15539824;36;40;0.611111111111111;14;22;0.111111111111111;0.388888888888889
Control.SRR15539824;42;40;0.571428571428571;18;24;0.0714285714285714;0.428571428571429
Control.SRR15539824;38;40;0.552631578947368;17;21;0.0526315789473685;0.447368421052632
Control.SRR15539824;40;40;0.55;18;22;0.05;0.45
Control.SRR15539824;35;40;0.571428571428571;15;20;0.0714285714285714;0.428571428571429
Control.SRR15539824;41;40;0.609756097560976;16;25;0.109756097560976;0.390243902439024
Control.SRR15539824;43;40;0.604651162790698;17;26;0.104651162790698;0.395348837209302
Control.SRR15539824;42;40;0.380952380952381;26;16;0.119047619047619;0.380952380952381
Control.SRR15539824;36;40;0.583333333333333;15;21;0.0833333333333334;0.416666666666667
Control.SRR15539824;37;40;0.540540540540541;17;20;0.0405405405405406;0.459459459459459
Control.SRR15539824;39;40;0.487179487179487;20;19;0.0128205128205128;0.487179487179487
Control.SRR15539824;37;40;0.351351351351351;24;13;0.148648648648649;0.351351351351351
Control.SRR15539824;36;40;0.472222222222222;19;17;0.0277777777777778;0.472222222222222
Control.SRR15539824;37;40;0.432432432432432;21;16;0.0675675675675675;0.432432432432432
Control.SRR15539824;38;40;0.5;19;19;0;0.5
Control.SRR15539824;39;40;0.641025641025641;14;25;0.141025641025641;0.358974358974359
Control.SRR15539824;36;40;0.583333333333333;15;21;0.0833333333333334;0.416666666666667
Control.SRR15539824;41;40;0.390243902439024;25;16;0.109756097560976;0.390243902439024
Control.SRR15539824;34;40;0.411764705882353;20;14;0.0882352941176471;0.411764705882353
Control.SRR15539824;35;40;0.428571428571429;20;15;0.0714285714285715;0.428571428571429
Control.SRR15539824;35;40;0.657142857142857;12;23;0.157142857142857;0.342857142857143
Control.SRR15539824;36;40;0.694444444444444;11;25;0.194444444444444;0.305555555555556
Control.SRR15539824;39;40;0.487179487179487;20;19;0.0128205128205128;0.487179487179487
Control.SRR15539824;35;40;0.571428571428571;15;20;0.0714285714285714;0.428571428571429
Control.SRR15539824;42;40;0.523809523809524;20;22;0.0238095238095238;0.476190476190476
Control.SRR15539824;41;40;0.585365853658537;17;24;0.0853658536585366;0.414634146341463
Control.SRR15539824;36;40;0.472222222222222;19;17;0.0277777777777778;0.472222222222222
Control.SRR15539824;42;40;0.452380952380952;23;19;0.0476190476190476;0.452380952380952
Control.SRR15539824;43;40;0.441860465116279;24;19;0.0581395348837209;0.441860465116279
Control.SRR15539824;38;40;0.526315789473684;18;20;0.0263157894736842;0.473684210526316
Control.SRR15539824;36;40;0.472222222222222;19;17;0.0277777777777778;0.472222222222222
Control.SRR15539824;37;40;0.594594594594595;15;22;0.0945945945945946;0.405405405405405
Control.SRR15539824;39;40;0.564102564102564;17;22;0.0641025641025641;0.435897435897436
Control.SRR15539824;38;40;0.526315789473684;18;20;0.0263157894736842;0.473684210526316
Control.SRR15539824;41;40;0.536585365853659;19;22;0.0365853658536586;0.463414634146341
Control.SRR15539824;40;40;0.375;25;15;0.125;0.375
Control.SRR15539824;33;40;0.515151515151515;16;17;0.0151515151515151;0.484848484848485
Control.SRR15539824;34;40;0.441176470588235;19;15;0.0588235294117647;0.441176470588235
Control.SRR15539824;34;40;0.323529411764706;23;11;0.176470588235294;0.323529411764706
Control.SRR15539824;40;40;0.5;20;20;0;0.5
Control.SRR15539824;36;40;0.5;18;18;0;0.5
Control.SRR15539824;40;40;0.425;23;17;0.075;0.425
Control.SRR15539824;42;40;0.619047619047619;16;26;0.119047619047619;0.380952380952381
Control.SRR15539824;40;40;0.575;17;23;0.075;0.425
Control.SRR15539824;38;40;0.578947368421053;16;22;0.0789473684210527;0.421052631578947
Control.SRR15539824;35;40;0.6;14;21;0.1;0.4
Control.SRR15539824;39;40;0.564102564102564;17;22;0.0641025641025641;0.435897435897436
Control.SRR15539824;40;40;0.425;23;17;0.075;0.425
Control.SRR15539824;34;40;0.588235294117647;14;20;0.0882352941176471;0.411764705882353
Control.SRR15539824;33;40;0.363636363636364;21;12;0.136363636363636;0.363636363636364
Control.SRR15539824;42;40;0.571428571428571;18;24;0.0714285714285714;0.428571428571429
Control.SRR15539824;39;40;0.487179487179487;20;19;0.0128205128205128;0.487179487179487
Control.SRR15539824;37;40;0.540540540540541;17;20;0.0405405405405406;0.459459459459459
Control.SRR15539824;39;40;0.461538461538462;21;18;0.0384615384615384;0.461538461538462
Control.SRR15539824;38;40;0.394736842105263;23;15;0.105263157894737;0.394736842105263
Control.SRR15539824;40;40;0.575;17;23;0.075;0.425
Control.SRR15539824;41;40;0.585365853658537;17;24;0.0853658536585366;0.414634146341463
Control.SRR15539824;41;40;0.48780487804878;21;20;0.0121951219512195;0.48780487804878
Control.SRR15539824;37;40;0.459459459459459;20;17;0.0405405405405405;0.459459459459459
Control.SRR15539824;34;40;0.5;17;17;0;0.5
Control.SRR15539824;36;40;0.5;18;18;0;0.5
Control.SRR15539824;41;40;0.48780487804878;21;20;0.0121951219512195;0.48780487804878
Control.SRR15539824;43;40;0.558139534883721;19;24;0.0581395348837209;0.441860465116279
Control.SRR15539824;42;40;0.285714285714286;30;12;0.214285714285714;0.285714285714286
Control.SRR15539824;43;40;0.418604651162791;25;18;0.0813953488372093;0.418604651162791
Control.SRR15539824;39;40;0.538461538461538;18;21;0.0384615384615384;0.461538461538462
Control.SRR15539824;39;40;0.58974358974359;16;23;0.0897435897435898;0.41025641025641
Control.SRR15539824;42;40;0.357142857142857;27;15;0.142857142857143;0.357142857142857
Control.SRR15539824;38;40;0.552631578947368;17;21;0.0526315789473685;0.447368421052632
Control.SRR15539824;42;40;0.452380952380952;23;19;0.0476190476190476;0.452380952380952
Control.SRR15539824;38;40;0.578947368421053;16;22;0.0789473684210527;0.421052631578947
Control.SRR15539824;43;40;0.395348837209302;26;17;0.104651162790698;0.395348837209302
Control.SRR15539824;40;40;0.525;19;21;0.025;0.475
Control.SRR15539824;41;40;0.463414634146341;22;19;0.0365853658536585;0.463414634146341
Control.SRR15539824;33;40;0.393939393939394;20;13;0.106060606060606;0.393939393939394
Control.SRR15539824;33;40;0.484848484848485;17;16;0.0151515151515151;0.484848484848485
Control.SRR15539824;40;40;0.65;14;26;0.15;0.35
Control.SRR15539824;41;40;0.682926829268293;13;28;0.182926829268293;0.317073170731707
Control.SRR15539824;38;40;0.473684210526316;20;18;0.0263157894736842;0.473684210526316
Control.SRR15539824;39;40;0.538461538461538;18;21;0.0384615384615384;0.461538461538462
Control.SRR15539824;33;40;0.636363636363636;12;21;0.136363636363636;0.363636363636364
Control.SRR15539824;36;40;0.527777777777778;17;19;0.0277777777777778;0.472222222222222
Control.SRR15539824;34;40;0.5;17;17;0;0.5
Control.SRR15539824;37;40;0.459459459459459;20;17;0.0405405405405405;0.459459459459459
Control.SRR15539824;38;40;0.447368421052632;21;17;0.0526315789473684;0.447368421052632
Control.SRR15539824;36;40;0.361111111111111;23;13;0.138888888888889;0.361111111111111
Control.SRR15539824;42;40;0.452380952380952;23;19;0.0476190476190476;0.452380952380952
Control.SRR15539824;37;40;0.567567567567568;16;21;0.0675675675675675;0.432432432432432
Control.SRR15539824;34;40;0.529411764705882;16;18;0.0294117647058824;0.470588235294118
Control.SRR15539824;33;40;0.606060606060606;13;20;0.106060606060606;0.393939393939394
Control.SRR15539824;36;40;0.583333333333333;15;21;0.0833333333333334;0.416666666666667
Control.SRR15539824;42;40;0.571428571428571;18;24;0.0714285714285714;0.428571428571429
Control.SRR15539824;40;40;0.575;17;23;0.075;0.425
Control.SRR15539824;39;40;0.538461538461538;18;21;0.0384615384615384;0.461538461538462
Control.SRR15539824;36;40;0.583333333333333;15;21;0.0833333333333334;0.416666666666667
Control.SRR15539824;38;40;0.473684210526316;20;18;0.0263157894736842;0.473684210526316
Control.SRR15539824;41;40;0.609756097560976;16;25;0.109756097560976;0.390243902439024
Control.SRR15539824;33;40;0.454545454545455;18;15;0.0454545454545455;0.454545454545455
Control.SRR15539824;42;40;0.357142857142857;27;15;0.142857142857143;0.357142857142857
Control.SRR15539824;40;40;0.575;17;23;0.075;0.425
Control.SRR15539824;34;40;0.441176470588235;19;15;0.0588235294117647;0.441176470588235
Control.SRR15539824;35;40;0.571428571428571;15;20;0.0714285714285714;0.428571428571429
Control.SRR15539824;35;40;0.371428571428571;22;13;0.128571428571429;0.371428571428571
Control.SRR15539824;34;40;0.5;17;17;0;0.5
Control.SRR15539824;34;40;0.529411764705882;16;18;0.0294117647058824;0.470588235294118
Control.SRR15539824;39;40;0.384615384615385;24;15;0.115384615384615;0.384615384615385
Control.SRR15539824;40;40;0.625;15;25;0.125;0.375
Control.SRR15539824;36;40;0.416666666666667;21;15;0.0833333333333333;0.416666666666667
Control.SRR15539824;39;40;0.564102564102564;17;22;0.0641025641025641;0.435897435897436
Control.SRR15539824;37;40;0.324324324324324;25;12;0.175675675675676;0.324324324324324
Control.SRR15539824;37;40;0.486486486486487;19;18;0.0135135135135135;0.486486486486487
Control.SRR15539824;34;40;0.558823529411765;15;19;0.0588235294117647;0.441176470588235
Control.SRR15539824;37;40;0.378378378378378;23;14;0.121621621621622;0.378378378378378
Control.SRR15539824;37;40;0.378378378378378;23;14;0.121621621621622;0.378378378378378
Control.SRR15539824;40;40;0.475;21;19;0.025;0.475
Control.SRR15539824;42;40;0.476190476190476;22;20;0.0238095238095238;0.476190476190476
Control.SRR15539824;33;40;0.606060606060606;13;20;0.106060606060606;0.393939393939394
Control.SRR15539824;41;40;0.414634146341463;24;17;0.0853658536585366;0.414634146341463
Control.SRR15539824;34;40;0.588235294117647;14;20;0.0882352941176471;0.411764705882353
Control.SRR15539824;41;40;0.414634146341463;24;17;0.0853658536585366;0.414634146341463
Control.SRR15539824;37;40;0.459459459459459;20;17;0.0405405405405405;0.459459459459459
Control.SRR15539824;34;40;0.617647058823529;13;21;0.117647058823529;0.382352941176471
Control.SRR15539824;36;40;0.444444444444444;20;16;0.0555555555555556;0.444444444444444
Control.SRR15539824;37;40;0.621621621621622;14;23;0.121621621621622;0.378378378378378
Control.SRR15539824;43;40;0.465116279069767;23;20;0.0348837209302326;0.465116279069767
Control.SRR15539824;35;40;0.371428571428571;22;13;0.128571428571429;0.371428571428571
Control.SRR15539824;36;40;0.555555555555556;16;20;0.0555555555555556;0.444444444444444
Control.SRR15539824;37;40;0.567567567567568;16;21;0.0675675675675675;0.432432432432432
Control.SRR15539824;40;40;0.55;18;22;0.05;0.45
Control.SRR15539824;39;40;0.512820512820513;19;20;0.0128205128205128;0.487179487179487
Control.SRR15539824;40;40;0.525;19;21;0.025;0.475
Control.SRR15539824;37;40;0.486486486486487;19;18;0.0135135135135135;0.486486486486487
Control.SRR15539824;43;40;0.511627906976744;21;22;0.0116279069767442;0.488372093023256
Control.SRR15539824;43;40;0.558139534883721;19;24;0.0581395348837209;0.441860465116279
Control.SRR15539824;43;40;0.604651162790698;17;26;0.104651162790698;0.395348837209302
Control.SRR15539824;39;40;0.384615384615385;24;15;0.115384615384615;0.384615384615385
Control.SRR15539824;37;40;0.459459459459459;20;17;0.0405405405405405;0.459459459459459
Control.SRR15539824;39;40;0.512820512820513;19;20;0.0128205128205128;0.487179487179487
Control.SRR15539824;43;40;0.558139534883721;19;24;0.0581395348837209;0.441860465116279
Control.SRR15539824;41;40;0.48780487804878;21;20;0.0121951219512195;0.48780487804878
Control.SRR15539824;34;40;0.441176470588235;19;15;0.0588235294117647;0.441176470588235
Control.SRR15539824;36;40;0.5;18;18;0;0.5
Control.SRR15539824;37;40;0.459459459459459;20;17;0.0405405405405405;0.459459459459459
Control.SRR15539824;40;40;0.575;17;23;0.075;0.425
Control.SRR15539824;33;40;0.515151515151515;16;17;0.0151515151515151;0.484848484848485
Control.SRR15539824;33;40;0.454545454545455;18;15;0.0454545454545455;0.454545454545455
Control.SRR15539824;39;40;0.538461538461538;18;21;0.0384615384615384;0.461538461538462
Control.SRR15539824;37;40;0.351351351351351;24;13;0.148648648648649;0.351351351351351
Control.SRR15539824;35;40;0.457142857142857;19;16;0.0428571428571429;0.457142857142857
Control.SRR15539824;38;40;0.447368421052632;21;17;0.0526315789473684;0.447368421052632
Control.SRR15539824;34;40;0.411764705882353;20;14;0.0882352941176471;0.411764705882353
Control.SRR15539824;43;40;0.488372093023256;22;21;0.0116279069767442;0.488372093023256
Control.SRR15539824;39;40;0.512820512820513;19;20;0.0128205128205128;0.487179487179487
Control.SRR15539824;42;40;0.357142857142857;27;15;0.142857142857143;0.357142857142857
Control.SRR15539824;42;40;0.571428571428571;18;24;0.0714285714285714;0.428571428571429
Control.SRR15539824;37;40;0.486486486486487;19;18;0.0135135135135135;0.486486486486487
Control.SRR15539824;33;40;0.636363636363636;12;21;0.136363636363636;0.363636363636364
Control.SRR15539824;37;40;0.540540540540541;17;20;0.0405405405405406;0.459459459459459
Control.SRR15539824;33;40;0.363636363636364;21;12;0.136363636363636;0.363636363636364
Control.SRR15539824;35;40;0.514285714285714;17;18;0.0142857142857142;0.485714285714286
Control.SRR15539824;33;40;0.545454545454545;15;18;0.0454545454545454;0.454545454545455
Control.SRR15539824;34;40;0.5;17;17;0;0.5
Control.SRR15539824;39;40;0.564102564102564;17;22;0.0641025641025641;0.435897435897436
Control.SRR15539824;40;40;0.35;26;14;0.15;0.35
Control.SRR15539824;39;40;0.358974358974359;25;14;0.141025641025641;0.358974358974359
Control.SRR15539824;35;40;0.485714285714286;18;17;0.0142857142857143;0.485714285714286
Control.SRR15539824;41;40;0.48780487804878;21;20;0.0121951219512195;0.48780487804878
Control.SRR15539824;41;40;0.536585365853659;19;22;0.0365853658536586;0.463414634146341
Control.SRR15539824;42;40;0.5;21;21;0;0.5
Control.SRR15539824;37;40;0.540540540540541;17;20;0.0405405405405406;0.459459459459459
Control.SRR15539824;41;40;0.48780487804878;21;20;0.0121951219512195;0.48780487804878
Control.SRR15539824;42;40;0.523809523809524;20;22;0.0238095238095238;0.476190476190476
Control.SRR15539824;41;40;0.48780487804878;21;20;0.0121951219512195;0.48780487804878
Control.SRR15539824;39;40;0.512820512820513;19;20;0.0128205128205128;0.487179487179487
Control.SRR15539824;41;40;0.48780487804878;21;20;0.0121951219512195;0.48780487804878
Control.SRR15539824;34;40;0.352941176470588;22;12;0.147058823529412;0.352941176470588
Control.SRR15539824;37;40;0.432432432432432;21;16;0.0675675675675675;0.432432432432432
Control.SRR15539824;38;40;0.552631578947368;17;21;0.0526315789473685;0.447368421052632
Control.SRR15539824;43;40;0.418604651162791;25;18;0.0813953488372093;0.418604651162791
Control.SRR15539824;34;40;0.617647058823529;13;21;0.117647058823529;0.382352941176471
Control.SRR15539824;42;40;0.547619047619048;19;23;0.0476190476190477;0.452380952380952
Control.SRR15539824;35;40;0.542857142857143;16;19;0.0428571428571428;0.457142857142857
Control.SRR15539824;38;40;0.578947368421053;16;22;0.0789473684210527;0.421052631578947
Control.SRR15539824;39;40;0.435897435897436;22;17;0.0641025641025641;0.435897435897436
Control.SRR15539824;35;40;0.485714285714286;18;17;0.0142857142857143;0.485714285714286
Control.SRR15539824;36;40;0.472222222222222;19;17;0.0277777777777778;0.472222222222222
Control.SRR15539824;40;40;0.625;15;25;0.125;0.375
Control.SRR15539824;42;40;0.523809523809524;20;22;0.0238095238095238;0.476190476190476
Control.SRR15539824;40;40;0.6;16;24;0.1;0.4
Control.SRR15539824;39;40;0.564102564102564;17;22;0.0641025641025641;0.435897435897436
Control.SRR15539824;35;40;0.542857142857143;16;19;0.0428571428571428;0.457142857142857
Control.SRR15539824;37;40;0.459459459459459;20;17;0.0405405405405405;0.459459459459459
Control.SRR15539824;43;40;0.488372093023256;22;21;0.0116279069767442;0.488372093023256
Control.SRR15539824;35;40;0.485714285714286;18;17;0.0142857142857143;0.485714285714286
Control.SRR15539824;40;40;0.425;23;17;0.075;0.425
Control.SRR15539824;37;40;0.405405405405405;22;15;0.0945945945945946;0.405405405405405
Control.SRR15539824;38;40;0.605263157894737;15;23;0.105263157894737;0.394736842105263
Control.SRR15539824;42;40;0.547619047619048;19;23;0.0476190476190477;0.452380952380952
Control.SRR15539824;35;40;0.485714285714286;18;17;0.0142857142857143;0.485714285714286
Control.SRR15539824;41;40;0.51219512195122;20;21;0.0121951219512195;0.48780487804878
Control.SRR15539824;41;40;0.48780487804878;21;20;0.0121951219512195;0.48780487804878
Control.SRR15539824;34;40;0.529411764705882;16;18;0.0294117647058824;0.470588235294118
Control.SRR15539824;41;40;0.585365853658537;17;24;0.0853658536585366;0.414634146341463
Control.SRR15539824;39;40;0.538461538461538;18;21;0.0384615384615384;0.461538461538462
Control.SRR15539824;35;40;0.428571428571429;20;15;0.0714285714285715;0.428571428571429
Control.SRR15539824;43;40;0.604651162790698;17;26;0.104651162790698;0.395348837209302
Control.SRR15539824;39;40;0.564102564102564;17;22;0.0641025641025641;0.435897435897436
Control.SRR15539824;36;40;0.555555555555556;16;20;0.0555555555555556;0.444444444444444
Control.SRR15539824;35;40;0.628571428571429;13;22;0.128571428571429;0.371428571428571
Control.SRR15539824;35;40;0.4;21;14;0.1;0.4
Control.SRR15539824;38;40;0.5;19;19;0;0.5
Control.SRR15539824;35;40;0.4;21;14;0.1;0.4
Control.SRR15539824;40;40;0.425;23;17;0.075;0.425
Control.SRR15539824;34;40;0.558823529411765;15;19;0.0588235294117647;0.441176470588235
Control.SRR15539824;39;40;0.512820512820513;19;20;0.0128205128205128;0.487179487179487
Control.SRR15539824;34;40;0.5;17;17;0;0.5
Control.SRR15539824;33;40;0.666666666666667;11;22;0.166666666666667;0.333333333333333
Control.SRR15539824;33;40;0.636363636363636;12;21;0.136363636363636;0.363636363636364
Control.SRR15539824;37;40;0.486486486486487;19;18;0.0135135135135135;0.486486486486487
Control.SRR15539824;40;40;0.525;19;21;0.025;0.475
Control.SRR15539824;39;40;0.384615384615385;24;15;0.115384615384615;0.384615384615385
Control.SRR15539824;41;40;0.51219512195122;20;21;0.0121951219512195;0.48780487804878
Control.SRR15539824;42;40;0.523809523809524;20;22;0.0238095238095238;0.476190476190476
Control.SRR15539824;40;40;0.55;18;22;0.05;0.45
Control.SRR15539824;36;40;0.5;18;18;0;0.5
Control.SRR15539824;36;40;0.5;18;18;0;0.5
Control.SRR15539824;35;40;0.4;21;14;0.1;0.4
Control.SRR15539824;41;40;0.536585365853659;19;22;0.0365853658536586;0.463414634146341
Control.SRR15539824;37;40;0.405405405405405;22;15;0.0945945945945946;0.405405405405405
Control.SRR15539824;37;40;0.459459459459459;20;17;0.0405405405405405;0.459459459459459
Control.SRR15539824;33;40;0.454545454545455;18;15;0.0454545454545455;0.454545454545455
Control.SRR15539824;40;40;0.55;18;22;0.05;0.45
Control.SRR15539824;39;40;0.461538461538462;21;18;0.0384615384615384;0.461538461538462
Control.SRR15539824;38;40;0.5;19;19;0;0.5
Control.SRR15539824;36;40;0.25;27;9;0.25;0.25
Control.SRR15539824;41;40;0.536585365853659;19;22;0.0365853658536586;0.463414634146341
Control.SRR15539824;41;40;0.560975609756098;18;23;0.0609756097560976;0.439024390243902
Control.SRR15539824;43;40;0.534883720930233;20;23;0.0348837209302325;0.465116279069767
Control.SRR15539824;43;40;0.488372093023256;22;21;0.0116279069767442;0.488372093023256
Control.SRR15539824;41;40;0.585365853658537;17;24;0.0853658536585366;0.414634146341463
Control.SRR15539824;39;40;0.512820512820513;19;20;0.0128205128205128;0.487179487179487
Control.SRR15539824;35;40;0.4;21;14;0.1;0.4
Control.SRR15539824;35;40;0.542857142857143;16;19;0.0428571428571428;0.457142857142857
Control.SRR15539824;41;40;0.560975609756098;18;23;0.0609756097560976;0.439024390243902
Control.SRR15539824;33;40;0.454545454545455;18;15;0.0454545454545455;0.454545454545455
Control.SRR15539824;37;40;0.513513513513513;18;19;0.0135135135135135;0.486486486486487
Control.SRR15539824;38;40;0.605263157894737;15;23;0.105263157894737;0.394736842105263
Control.SRR15539824;33;40;0.515151515151515;16;17;0.0151515151515151;0.484848484848485
Control.SRR15539824;34;40;0.411764705882353;20;14;0.0882352941176471;0.411764705882353
Control.SRR15539824;36;40;0.527777777777778;17;19;0.0277777777777778;0.472222222222222
Control.SRR15539824;35;40;0.514285714285714;17;18;0.0142857142857142;0.485714285714286
Control.SRR15539824;34;40;0.441176470588235;19;15;0.0588235294117647;0.441176470588235
Control.SRR15539824;33;40;0.666666666666667;11;22;0.166666666666667;0.333333333333333
Control.SRR15539824;36;40;0.527777777777778;17;19;0.0277777777777778;0.472222222222222
Control.SRR15539824;37;40;0.540540540540541;17;20;0.0405405405405406;0.459459459459459
Control.SRR15539824;39;40;0.538461538461538;18;21;0.0384615384615384;0.461538461538462
Control.SRR15539824;35;40;0.457142857142857;19;16;0.0428571428571429;0.457142857142857
Control.SRR15539824;40;40;0.625;15;25;0.125;0.375
Control.SRR15539824;39;40;0.564102564102564;17;22;0.0641025641025641;0.435897435897436
Control.SRR15539824;41;40;0.48780487804878;21;20;0.0121951219512195;0.48780487804878
Control.SRR15539824;38;40;0.552631578947368;17;21;0.0526315789473685;0.447368421052632
Control.SRR15539824;40;40;0.575;17;23;0.075;0.425
Control.SRR15539824;39;40;0.487179487179487;20;19;0.0128205128205128;0.487179487179487
Control.SRR15539824;38;40;0.526315789473684;18;20;0.0263157894736842;0.473684210526316
Control.SRR15539824;35;40;0.514285714285714;17;18;0.0142857142857142;0.485714285714286
Control.SRR15539824;38;40;0.421052631578947;22;16;0.0789473684210527;0.421052631578947
Control.SRR15539824;40;40;0.425;23;17;0.075;0.425
Control.SRR15539824;34;40;0.529411764705882;16;18;0.0294117647058824;0.470588235294118
Control.SRR15539824;36;40;0.472222222222222;19;17;0.0277777777777778;0.472222222222222
Control.SRR15539824;43;40;0.697674418604651;13;30;0.197674418604651;0.302325581395349
Control.SRR15539824;42;40;0.380952380952381;26;16;0.119047619047619;0.380952380952381
Control.SRR15539824;41;40;0.463414634146341;22;19;0.0365853658536585;0.463414634146341
Control.SRR15539824;43;40;0.604651162790698;17;26;0.104651162790698;0.395348837209302
Control.SRR15539824;41;40;0.560975609756098;18;23;0.0609756097560976;0.439024390243902
Control.SRR15539824;39;40;0.538461538461538;18;21;0.0384615384615384;0.461538461538462
Control.SRR15539824;33;40;0.484848484848485;17;16;0.0151515151515151;0.484848484848485
Control.SRR15539824;39;40;0.564102564102564;17;22;0.0641025641025641;0.435897435897436
Control.SRR15539824;36;40;0.472222222222222;19;17;0.0277777777777778;0.472222222222222
Control.SRR15539824;38;40;0.552631578947368;17;21;0.0526315789473685;0.447368421052632
Control.SRR15539824;42;40;0.428571428571429;24;18;0.0714285714285715;0.428571428571429
Control.SRR15539824;36;40;0.555555555555556;16;20;0.0555555555555556;0.444444444444444
Control.SRR15539824;36;40;0.472222222222222;19;17;0.0277777777777778;0.472222222222222
Control.SRR15539824;38;40;0.421052631578947;22;16;0.0789473684210527;0.421052631578947
Control.SRR15539824;41;40;0.390243902439024;25;16;0.109756097560976;0.390243902439024
Control.SRR15539824;35;40;0.485714285714286;18;17;0.0142857142857143;0.485714285714286
Control.SRR15539824;35;40;0.428571428571429;20;15;0.0714285714285715;0.428571428571429
Control.SRR15539824;37;40;0.594594594594595;15;22;0.0945945945945946;0.405405405405405
Control.SRR15539824;43;40;0.627906976744186;16;27;0.127906976744186;0.372093023255814
Control.SRR15539824;39;40;0.538461538461538;18;21;0.0384615384615384;0.461538461538462
Control.SRR15539824;35;40;0.485714285714286;18;17;0.0142857142857143;0.485714285714286
Control.SRR15539824;42;40;0.476190476190476;22;20;0.0238095238095238;0.476190476190476
Control.SRR15539824;33;40;0.454545454545455;18;15;0.0454545454545455;0.454545454545455
Control.SRR15539824;36;40;0.555555555555556;16;20;0.0555555555555556;0.444444444444444
Control.SRR15539824;40;40;0.475;21;19;0.025;0.475
Control.SRR15539824;33;40;0.333333333333333;22;11;0.166666666666667;0.333333333333333
Control.SRR15539824;36;40;0.416666666666667;21;15;0.0833333333333333;0.416666666666667
Control.SRR15539824;36;40;0.388888888888889;22;14;0.111111111111111;0.388888888888889
Control.SRR15539824;34;40;0.441176470588235;19;15;0.0588235294117647;0.441176470588235
Control.SRR15539824;37;40;0.513513513513513;18;19;0.0135135135135135;0.486486486486487
Control.SRR15539824;42;40;0.476190476190476;22;20;0.0238095238095238;0.476190476190476
Control.SRR15539824;40;40;0.575;17;23;0.075;0.425
Control.SRR15539824;39;40;0.58974358974359;16;23;0.0897435897435898;0.41025641025641
Control.SRR15539824;40;40;0.5;20;20;0;0.5
Control.SRR15539824;39;40;0.564102564102564;17;22;0.0641025641025641;0.435897435897436
Control.SRR15539824;42;40;0.523809523809524;20;22;0.0238095238095238;0.476190476190476
Control.SRR15539824;37;40;0.540540540540541;17;20;0.0405405405405406;0.459459459459459
Control.SRR15539824;40;40;0.6;16;24;0.1;0.4
Control.SRR15539824;35;40;0.657142857142857;12;23;0.157142857142857;0.342857142857143
Control.SRR15539824;41;40;0.634146341463415;15;26;0.134146341463415;0.365853658536585
Control.SRR15539824;39;40;0.487179487179487;20;19;0.0128205128205128;0.487179487179487
Control.SRR15539824;33;40;0.545454545454545;15;18;0.0454545454545454;0.454545454545455
Control.SRR15539824;37;40;0.486486486486487;19;18;0.0135135135135135;0.486486486486487
Control.SRR15539824;33;40;0.515151515151515;16;17;0.0151515151515151;0.484848484848485
Control.SRR15539824;38;40;0.5;19;19;0;0.5
Control.SRR15539824;40;40;0.55;18;22;0.05;0.45
Control.SRR15539824;35;40;0.371428571428571;22;13;0.128571428571429;0.371428571428571
Control.SRR15539824;36;40;0.444444444444444;20;16;0.0555555555555556;0.444444444444444
Control.SRR15539824;38;40;0.526315789473684;18;20;0.0263157894736842;0.473684210526316
Control.SRR15539824;41;40;0.585365853658537;17;24;0.0853658536585366;0.414634146341463
Control.SRR15539824;43;40;0.441860465116279;24;19;0.0581395348837209;0.441860465116279
Control.SRR15539824;36;40;0.555555555555556;16;20;0.0555555555555556;0.444444444444444
Control.SRR15539824;36;40;0.583333333333333;15;21;0.0833333333333334;0.416666666666667
Control.SRR15539824;35;40;0.485714285714286;18;17;0.0142857142857143;0.485714285714286
Control.SRR15539824;34;40;0.5;17;17;0;0.5
Control.SRR15539824;38;40;0.552631578947368;17;21;0.0526315789473685;0.447368421052632
Control.SRR15539824;37;40;0.405405405405405;22;15;0.0945945945945946;0.405405405405405
Control.SRR15539824;36;40;0.416666666666667;21;15;0.0833333333333333;0.416666666666667
Control.SRR15539824;33;40;0.484848484848485;17;16;0.0151515151515151;0.484848484848485
Control.SRR15539824;34;40;0.588235294117647;14;20;0.0882352941176471;0.411764705882353
Control.SRR15539824;35;40;0.457142857142857;19;16;0.0428571428571429;0.457142857142857
Control.SRR15539824;35;40;0.571428571428571;15;20;0.0714285714285714;0.428571428571429
Control.SRR15539824;42;40;0.547619047619048;19;23;0.0476190476190477;0.452380952380952
Control.SRR15539824;38;40;0.631578947368421;14;24;0.131578947368421;0.368421052631579
Control.SRR15539824;36;40;0.638888888888889;13;23;0.138888888888889;0.361111111111111
Control.SRR15539824;40;40;0.525;19;21;0.025;0.475
Control.SRR15539824;36;40;0.583333333333333;15;21;0.0833333333333334;0.416666666666667
Control.SRR15539824;34;40;0.617647058823529;13;21;0.117647058823529;0.382352941176471
Control.SRR15539824;43;40;0.558139534883721;19;24;0.0581395348837209;0.441860465116279
Control.SRR15539824;34;40;0.5;17;17;0;0.5
Control.SRR15539824;33;40;0.454545454545455;18;15;0.0454545454545455;0.454545454545455
Control.SRR15539824;36;40;0.361111111111111;23;13;0.138888888888889;0.361111111111111
Control.SRR15539824;33;40;0.575757575757576;14;19;0.0757575757575758;0.424242424242424
Control.SRR15539824;41;40;0.634146341463415;15;26;0.134146341463415;0.365853658536585
Control.SRR15539824;36;40;0.555555555555556;16;20;0.0555555555555556;0.444444444444444
Control.SRR15539824;41;40;0.48780487804878;21;20;0.0121951219512195;0.48780487804878
Control.SRR15539824;35;40;0.542857142857143;16;19;0.0428571428571428;0.457142857142857
Control.SRR15539824;42;40;0.595238095238095;17;25;0.0952380952380952;0.404761904761905
Control.SRR15539824;42;40;0.595238095238095;17;25;0.0952380952380952;0.404761904761905
Control.SRR15539824;37;40;0.513513513513513;18;19;0.0135135135135135;0.486486486486487
Control.SRR15539824;39;40;0.487179487179487;20;19;0.0128205128205128;0.487179487179487
Control.SRR15539824;40;40;0.55;18;22;0.05;0.45
Control.SRR15539824;40;40;0.475;21;19;0.025;0.475
Control.SRR15539824;42;40;0.452380952380952;23;19;0.0476190476190476;0.452380952380952
Control.SRR15539824;40;40;0.525;19;21;0.025;0.475
Control.SRR15539824;35;40;0.371428571428571;22;13;0.128571428571429;0.371428571428571
Control.SRR15539824;42;40;0.452380952380952;23;19;0.0476190476190476;0.452380952380952
Control.SRR15539824;33;40;0.545454545454545;15;18;0.0454545454545454;0.454545454545455
Control.SRR15539824;35;40;0.6;14;21;0.1;0.4
Control.SRR15539824;41;40;0.390243902439024;25;16;0.109756097560976;0.390243902439024
Control.SRR15539824;37;40;0.621621621621622;14;23;0.121621621621622;0.378378378378378
Control.SRR15539824;39;40;0.615384615384615;15;24;0.115384615384615;0.384615384615385
Control.SRR15539824;37;40;0.459459459459459;20;17;0.0405405405405405;0.459459459459459
Control.SRR15539824;43;40;0.581395348837209;18;25;0.0813953488372093;0.418604651162791
Control.SRR15539824;39;40;0.435897435897436;22;17;0.0641025641025641;0.435897435897436
Control.SRR15539824;43;40;0.558139534883721;19;24;0.0581395348837209;0.441860465116279
Control.SRR15539824;42;40;0.571428571428571;18;24;0.0714285714285714;0.428571428571429
Control.SRR15539824;42;40;0.333333333333333;28;14;0.166666666666667;0.333333333333333
Control.SRR15539824;43;40;0.511627906976744;21;22;0.0116279069767442;0.488372093023256
Control.SRR15539824;33;40;0.363636363636364;21;12;0.136363636363636;0.363636363636364
Control.SRR15539824;40;40;0.425;23;17;0.075;0.425
Control.SRR15539824;40;40;0.55;18;22;0.05;0.45
Control.SRR15539824;39;40;0.512820512820513;19;20;0.0128205128205128;0.487179487179487
Control.SRR15539824;43;40;0.581395348837209;18;25;0.0813953488372093;0.418604651162791
Control.SRR15539824;42;40;0.5;21;21;0;0.5
Control.SRR15539824;43;40;0.302325581395349;30;13;0.197674418604651;0.302325581395349
Control.SRR15539824;41;40;0.707317073170732;12;29;0.207317073170732;0.292682926829268
Control.SRR15539824;43;40;0.558139534883721;19;24;0.0581395348837209;0.441860465116279
Control.SRR15539824;34;40;0.529411764705882;16;18;0.0294117647058824;0.470588235294118
Control.SRR15539824;37;40;0.432432432432432;21;16;0.0675675675675675;0.432432432432432
Control.SRR15539824;35;40;0.514285714285714;17;18;0.0142857142857142;0.485714285714286
Control.SRR15539824;41;40;0.439024390243902;23;18;0.0609756097560976;0.439024390243902
Control.SRR15539824;34;40;0.558823529411765;15;19;0.0588235294117647;0.441176470588235
Control.SRR15539824;35;40;0.485714285714286;18;17;0.0142857142857143;0.485714285714286
Control.SRR15539824;36;40;0.444444444444444;20;16;0.0555555555555556;0.444444444444444
Control.SRR15539824;33;40;0.575757575757576;14;19;0.0757575757575758;0.424242424242424
Control.SRR15539824;34;40;0.441176470588235;19;15;0.0588235294117647;0.441176470588235
Control.SRR15539824;43;40;0.534883720930233;20;23;0.0348837209302325;0.465116279069767
Control.SRR15539824;37;40;0.513513513513513;18;19;0.0135135135135135;0.486486486486487
Control.SRR15539824;37;40;0.486486486486487;19;18;0.0135135135135135;0.486486486486487
Control.SRR15539824;33;40;0.545454545454545;15;18;0.0454545454545454;0.454545454545455
Control.SRR15539824;39;40;0.615384615384615;15;24;0.115384615384615;0.384615384615385
Control.SRR15539824;36;40;0.527777777777778;17;19;0.0277777777777778;0.472222222222222
Control.SRR15539824;36;40;0.555555555555556;16;20;0.0555555555555556;0.444444444444444
Control.SRR15539824;33;40;0.484848484848485;17;16;0.0151515151515151;0.484848484848485
Control.SRR15539824;37;40;0.486486486486487;19;18;0.0135135135135135;0.486486486486487
Control.SRR15539824;39;40;0.538461538461538;18;21;0.0384615384615384;0.461538461538462
Control.SRR15539824;37;40;0.594594594594595;15;22;0.0945945945945946;0.405405405405405
Control.SRR15539824;35;40;0.485714285714286;18;17;0.0142857142857143;0.485714285714286
Control.SRR15539824;35;40;0.285714285714286;25;10;0.214285714285714;0.285714285714286
Control.SRR15539824;39;40;0.512820512820513;19;20;0.0128205128205128;0.487179487179487
Control.SRR15539824;42;40;0.666666666666667;14;28;0.166666666666667;0.333333333333333
Control.SRR15539824;41;40;0.634146341463415;15;26;0.134146341463415;0.365853658536585
Control.SRR15539824;43;40;0.511627906976744;21;22;0.0116279069767442;0.488372093023256
Control.SRR15539824;34;40;0.588235294117647;14;20;0.0882352941176471;0.411764705882353
Control.SRR15539824;34;40;0.647058823529412;12;22;0.147058823529412;0.352941176470588
Control.SRR15539824;33;40;0.363636363636364;21;12;0.136363636363636;0.363636363636364
Control.SRR15539824;34;40;0.5;17;17;0;0.5
Control.SRR15539824;36;40;0.416666666666667;21;15;0.0833333333333333;0.416666666666667
Control.SRR15539824;37;40;0.486486486486487;19;18;0.0135135135135135;0.486486486486487
Control.SRR15539824;34;40;0.558823529411765;15;19;0.0588235294117647;0.441176470588235
Control.SRR15539824;38;40;0.5;19;19;0;0.5
Control.SRR15539824;41;40;0.585365853658537;17;24;0.0853658536585366;0.414634146341463
Control.SRR15539824;39;40;0.538461538461538;18;21;0.0384615384615384;0.461538461538462
Control.SRR15539824;37;40;0.432432432432432;21;16;0.0675675675675675;0.432432432432432
Control.SRR15539824;40;40;0.6;16;24;0.1;0.4
Control.SRR15539824;42;40;0.523809523809524;20;22;0.0238095238095238;0.476190476190476
Control.SRR15539824;43;40;0.581395348837209;18;25;0.0813953488372093;0.418604651162791
Control.SRR15539824;43;40;0.534883720930233;20;23;0.0348837209302325;0.465116279069767
Control.SRR15539824;38;40;0.421052631578947;22;16;0.0789473684210527;0.421052631578947
Control.SRR15539824;38;40;0.631578947368421;14;24;0.131578947368421;0.368421052631579
Control.SRR15539824;34;40;0.470588235294118;18;16;0.0294117647058824;0.470588235294118
Control.SRR15539824;41;40;0.390243902439024;25;16;0.109756097560976;0.390243902439024
Control.SRR15539824;39;40;0.384615384615385;24;15;0.115384615384615;0.384615384615385
Control.SRR15539824;42;40;0.428571428571429;24;18;0.0714285714285715;0.428571428571429
Control.SRR15539824;40;40;0.625;15;25;0.125;0.375
Control.SRR15539824;39;40;0.538461538461538;18;21;0.0384615384615384;0.461538461538462
Control.SRR15539824;33;40;0.575757575757576;14;19;0.0757575757575758;0.424242424242424
Control.SRR15539824;43;40;0.418604651162791;25;18;0.0813953488372093;0.418604651162791
Control.SRR15539824;42;40;0.476190476190476;22;20;0.0238095238095238;0.476190476190476
Control.SRR15539824;40;40;0.6;16;24;0.1;0.4
Control.SRR15539824;39;40;0.538461538461538;18;21;0.0384615384615384;0.461538461538462
Control.SRR15539824;36;40;0.444444444444444;20;16;0.0555555555555556;0.444444444444444
Control.SRR15539824;33;40;0.545454545454545;15;18;0.0454545454545454;0.454545454545455
Control.SRR15539824;35;40;0.542857142857143;16;19;0.0428571428571428;0.457142857142857
Control.SRR15539824;35;40;0.571428571428571;15;20;0.0714285714285714;0.428571428571429
Control.SRR15539824;38;40;0.526315789473684;18;20;0.0263157894736842;0.473684210526316
Control.SRR15539824;35;40;0.571428571428571;15;20;0.0714285714285714;0.428571428571429
Control.SRR15539824;33;40;0.454545454545455;18;15;0.0454545454545455;0.454545454545455
Control.SRR15539824;37;40;0.486486486486487;19;18;0.0135135135135135;0.486486486486487
Control.SRR15539824;42;40;0.476190476190476;22;20;0.0238095238095238;0.476190476190476
Control.SRR15539824;43;40;0.581395348837209;18;25;0.0813953488372093;0.418604651162791
Control.SRR15539824;42;40;0.547619047619048;19;23;0.0476190476190477;0.452380952380952
Control.SRR15539824;34;40;0.470588235294118;18;16;0.0294117647058824;0.470588235294118
Control.SRR15539824;40;40;0.525;19;21;0.025;0.475
Control.SRR15539824;43;40;0.441860465116279;24;19;0.0581395348837209;0.441860465116279
Control.SRR15539824;40;40;0.475;21;19;0.025;0.475
Control.SRR15539824;42;40;0.404761904761905;25;17;0.0952380952380952;0.404761904761905
Control.SRR15539824;42;40;0.452380952380952;23;19;0.0476190476190476;0.452380952380952
Control.SRR15539824;42;40;0.404761904761905;25;17;0.0952380952380952;0.404761904761905
Control.SRR15539824;39;40;0.461538461538462;21;18;0.0384615384615384;0.461538461538462
Control.SRR15539824;40;40;0.475;21;19;0.025;0.475
Control.SRR15539824;36;40;0.555555555555556;16;20;0.0555555555555556;0.444444444444444
Control.SRR15539824;42;40;0.5;21;21;0;0.5
Control.SRR15539824;38;40;0.5;19;19;0;0.5
Control.SRR15539824;43;40;0.534883720930233;20;23;0.0348837209302325;0.465116279069767
Control.SRR15539824;41;40;0.560975609756098;18;23;0.0609756097560976;0.439024390243902
Control.SRR15539824;41;40;0.390243902439024;25;16;0.109756097560976;0.390243902439024
Control.SRR15539824;39;40;0.512820512820513;19;20;0.0128205128205128;0.487179487179487
Control.SRR15539824;36;40;0.583333333333333;15;21;0.0833333333333334;0.416666666666667
Control.SRR15539824;36;40;0.527777777777778;17;19;0.0277777777777778;0.472222222222222
Control.SRR15539824;39;40;0.641025641025641;14;25;0.141025641025641;0.358974358974359
Control.SRR15539824;42;40;0.452380952380952;23;19;0.0476190476190476;0.452380952380952
Control.SRR15539824;38;40;0.421052631578947;22;16;0.0789473684210527;0.421052631578947
Control.SRR15539824;34;40;0.5;17;17;0;0.5
Control.SRR15539824;43;40;0.488372093023256;22;21;0.0116279069767442;0.488372093023256
Control.SRR15539824;34;40;0.470588235294118;18;16;0.0294117647058824;0.470588235294118
Control.SRR15539824;36;40;0.527777777777778;17;19;0.0277777777777778;0.472222222222222
Control.SRR15539824;40;40;0.45;22;18;0.05;0.45
Control.SRR15539824;40;40;0.625;15;25;0.125;0.375
Control.SRR15539824;41;40;0.560975609756098;18;23;0.0609756097560976;0.439024390243902
Control.SRR15539824;43;40;0.325581395348837;29;14;0.174418604651163;0.325581395348837
Control.SRR15539824;34;40;0.529411764705882;16;18;0.0294117647058824;0.470588235294118
Control.SRR15539824;40;40;0.45;22;18;0.05;0.45
Control.SRR15539824;38;40;0.473684210526316;20;18;0.0263157894736842;0.473684210526316
Control.SRR15539824;41;40;0.51219512195122;20;21;0.0121951219512195;0.48780487804878
Control.SRR15539824;42;40;0.452380952380952;23;19;0.0476190476190476;0.452380952380952
Control.SRR15539824;33;40;0.393939393939394;20;13;0.106060606060606;0.393939393939394
Control.SRR15539824;42;40;0.380952380952381;26;16;0.119047619047619;0.380952380952381
Control.SRR15539824;39;40;0.358974358974359;25;14;0.141025641025641;0.358974358974359
Control.SRR15539824;33;40;0.454545454545455;18;15;0.0454545454545455;0.454545454545455
Control.SRR15539824;43;40;0.441860465116279;24;19;0.0581395348837209;0.441860465116279
Control.SRR15539824;37;40;0.540540540540541;17;20;0.0405405405405406;0.459459459459459
Control.SRR15539824;38;40;0.368421052631579;24;14;0.131578947368421;0.368421052631579
Control.SRR15539824;41;40;0.48780487804878;21;20;0.0121951219512195;0.48780487804878
Control.SRR15539824;40;40;0.475;21;19;0.025;0.475
Control.SRR15539824;41;40;0.658536585365854;14;27;0.158536585365854;0.341463414634146
Control.SRR15539824;33;40;0.545454545454545;15;18;0.0454545454545454;0.454545454545455
Control.SRR15539824;41;40;0.439024390243902;23;18;0.0609756097560976;0.439024390243902
Control.SRR15539824;41;40;0.48780487804878;21;20;0.0121951219512195;0.48780487804878
Control.SRR15539824;43;40;0.511627906976744;21;22;0.0116279069767442;0.488372093023256
Control.SRR15539824;38;40;0.394736842105263;23;15;0.105263157894737;0.394736842105263
Control.SRR15539824;40;40;0.45;22;18;0.05;0.45
Control.SRR15539824;39;40;0.512820512820513;19;20;0.0128205128205128;0.487179487179487
Control.SRR15539824;42;40;0.547619047619048;19;23;0.0476190476190477;0.452380952380952
Control.SRR15539824;42;40;0.452380952380952;23;19;0.0476190476190476;0.452380952380952
Control.SRR15539824;41;40;0.536585365853659;19;22;0.0365853658536586;0.463414634146341
Control.SRR15539824;39;40;0.358974358974359;25;14;0.141025641025641;0.358974358974359
Control.SRR15539824;35;40;0.571428571428571;15;20;0.0714285714285714;0.428571428571429
Control.SRR15539824;41;40;0.609756097560976;16;25;0.109756097560976;0.390243902439024
Control.SRR15539824;41;40;0.390243902439024;25;16;0.109756097560976;0.390243902439024
Control.SRR15539824;38;40;0.5;19;19;0;0.5
Control.SRR15539824;40;40;0.625;15;25;0.125;0.375
Control.SRR15539824;42;40;0.452380952380952;23;19;0.0476190476190476;0.452380952380952
Control.SRR15539824;40;40;0.5;20;20;0;0.5
Control.SRR15539824;37;40;0.405405405405405;22;15;0.0945945945945946;0.405405405405405
Control.SRR15539824;42;40;0.5;21;21;0;0.5
Control.SRR15539824;34;40;0.411764705882353;20;14;0.0882352941176471;0.411764705882353
Control.SRR15539824;42;40;0.5;21;21;0;0.5
Control.SRR15539824;37;40;0.432432432432432;21;16;0.0675675675675675;0.432432432432432
Control.SRR15539824;35;40;0.6;14;21;0.1;0.4
Control.SRR15539824;39;40;0.487179487179487;20;19;0.0128205128205128;0.487179487179487
Control.SRR15539824;43;40;0.558139534883721;19;24;0.0581395348837209;0.441860465116279
Control.SRR15539824;37;40;0.432432432432432;21;16;0.0675675675675675;0.432432432432432
Control.SRR15539824;43;40;0.511627906976744;21;22;0.0116279069767442;0.488372093023256
Control.SRR15539824;41;40;0.51219512195122;20;21;0.0121951219512195;0.48780487804878
Control.SRR15539824;43;40;0.441860465116279;24;19;0.0581395348837209;0.441860465116279
Control.SRR15539824;42;40;0.404761904761905;25;17;0.0952380952380952;0.404761904761905
Control.SRR15539824;43;40;0.465116279069767;23;20;0.0348837209302326;0.465116279069767
Control.SRR15539824;42;40;0.476190476190476;22;20;0.0238095238095238;0.476190476190476
Control.SRR15539824;40;40;0.525;19;21;0.025;0.475
Control.SRR15539824;38;40;0.526315789473684;18;20;0.0263157894736842;0.473684210526316
Control.SRR15539824;41;40;0.463414634146341;22;19;0.0365853658536585;0.463414634146341
Control.SRR15539824;43;40;0.465116279069767;23;20;0.0348837209302326;0.465116279069767
Control.SRR15539824;39;40;0.435897435897436;22;17;0.0641025641025641;0.435897435897436
Control.SRR15539824;34;40;0.558823529411765;15;19;0.0588235294117647;0.441176470588235
Control.SRR15539824;36;40;0.333333333333333;24;12;0.166666666666667;0.333333333333333
Control.SRR15539824;36;40;0.5;18;18;0;0.5
Control.SRR15539824;37;40;0.540540540540541;17;20;0.0405405405405406;0.459459459459459
Control.SRR15539824;37;40;0.432432432432432;21;16;0.0675675675675675;0.432432432432432
Control.SRR15539824;38;40;0.578947368421053;16;22;0.0789473684210527;0.421052631578947
Control.SRR15539824;39;40;0.333333333333333;26;13;0.166666666666667;0.333333333333333
Control.SRR15539824;41;40;0.390243902439024;25;16;0.109756097560976;0.390243902439024
Control.SRR15539824;41;40;0.439024390243902;23;18;0.0609756097560976;0.439024390243902
Control.SRR15539824;40;40;0.575;17;23;0.075;0.425
Control.SRR15539824;37;40;0.486486486486487;19;18;0.0135135135135135;0.486486486486487
Control.SRR15539824;33;40;0.333333333333333;22;11;0.166666666666667;0.333333333333333
Control.SRR15539824;37;40;0.540540540540541;17;20;0.0405405405405406;0.459459459459459
Control.SRR15539824;38;40;0.5;19;19;0;0.5
Control.SRR15539824;42;40;0.380952380952381;26;16;0.119047619047619;0.380952380952381
Control.SRR15539824;38;40;0.473684210526316;20;18;0.0263157894736842;0.473684210526316
Control.SRR15539824;41;40;0.609756097560976;16;25;0.109756097560976;0.390243902439024
Control.SRR15539824;35;40;0.571428571428571;15;20;0.0714285714285714;0.428571428571429
Control.SRR15539824;40;40;0.6;16;24;0.1;0.4
Control.SRR15539824;38;40;0.473684210526316;20;18;0.0263157894736842;0.473684210526316
Control.SRR15539824;41;40;0.536585365853659;19;22;0.0365853658536586;0.463414634146341
Control.SRR15539824;43;40;0.488372093023256;22;21;0.0116279069767442;0.488372093023256
Control.SRR15539824;43;40;0.627906976744186;16;27;0.127906976744186;0.372093023255814
Control.SRR15539824;43;40;0.348837209302326;28;15;0.151162790697674;0.348837209302326
Control.SRR15539824;39;40;0.41025641025641;23;16;0.0897435897435898;0.41025641025641
Control.SRR15539824;33;40;0.333333333333333;22;11;0.166666666666667;0.333333333333333
Control.SRR15539824;43;40;0.488372093023256;22;21;0.0116279069767442;0.488372093023256
Control.SRR15539824;37;40;0.459459459459459;20;17;0.0405405405405405;0.459459459459459
Control.SRR15539824;42;40;0.452380952380952;23;19;0.0476190476190476;0.452380952380952
Control.SRR15539824;33;40;0.545454545454545;15;18;0.0454545454545454;0.454545454545455
Control.SRR15539824;40;40;0.525;19;21;0.025;0.475
Control.SRR15539824;42;40;0.595238095238095;17;25;0.0952380952380952;0.404761904761905
Control.SRR15539824;35;40;0.371428571428571;22;13;0.128571428571429;0.371428571428571
Control.SRR15539824;42;40;0.476190476190476;22;20;0.0238095238095238;0.476190476190476
Control.SRR15539824;43;40;0.581395348837209;18;25;0.0813953488372093;0.418604651162791
Control.SRR15539824;41;40;0.51219512195122;20;21;0.0121951219512195;0.48780487804878
Control.SRR15539824;37;40;0.486486486486487;19;18;0.0135135135135135;0.486486486486487
Control.SRR15539824;35;40;0.285714285714286;25;10;0.214285714285714;0.285714285714286
Control.SRR15539824;42;40;0.428571428571429;24;18;0.0714285714285715;0.428571428571429
Control.SRR15539824;43;40;0.534883720930233;20;23;0.0348837209302325;0.465116279069767
Control.SRR15539824;35;40;0.371428571428571;22;13;0.128571428571429;0.371428571428571
Control.SRR15539824;39;40;0.461538461538462;21;18;0.0384615384615384;0.461538461538462
Control.SRR15539824;37;40;0.540540540540541;17;20;0.0405405405405406;0.459459459459459
Control.SRR15539824;35;40;0.457142857142857;19;16;0.0428571428571429;0.457142857142857
Control.SRR15539824;33;40;0.696969696969697;10;23;0.196969696969697;0.303030303030303
Control.SRR15539824;34;40;0.470588235294118;18;16;0.0294117647058824;0.470588235294118
Control.SRR15539824;37;40;0.513513513513513;18;19;0.0135135135135135;0.486486486486487
Control.SRR15539824;43;40;0.534883720930233;20;23;0.0348837209302325;0.465116279069767
Control.SRR15539824;34;40;0.470588235294118;18;16;0.0294117647058824;0.470588235294118
Control.SRR15539824;37;40;0.648648648648649;13;24;0.148648648648649;0.351351351351351
Control.SRR15539824;39;40;0.384615384615385;24;15;0.115384615384615;0.384615384615385
Control.SRR15539824;37;40;0.648648648648649;13;24;0.148648648648649;0.351351351351351
Control.SRR15539824;38;40;0.526315789473684;18;20;0.0263157894736842;0.473684210526316
Control.SRR15539824;43;40;0.465116279069767;23;20;0.0348837209302326;0.465116279069767
Control.SRR15539824;40;40;0.525;19;21;0.025;0.475
Control.SRR15539824;39;40;0.461538461538462;21;18;0.0384615384615384;0.461538461538462
Control.SRR15539824;43;40;0.534883720930233;20;23;0.0348837209302325;0.465116279069767
Control.SRR15539824;40;40;0.45;22;18;0.05;0.45
Control.SRR15539824;35;40;0.485714285714286;18;17;0.0142857142857143;0.485714285714286
Control.SRR15539824;39;40;0.615384615384615;15;24;0.115384615384615;0.384615384615385
Control.SRR15539824;37;40;0.540540540540541;17;20;0.0405405405405406;0.459459459459459
Control.SRR15539824;39;40;0.512820512820513;19;20;0.0128205128205128;0.487179487179487
Control.SRR15539824;34;40;0.676470588235294;11;23;0.176470588235294;0.323529411764706
Control.SRR15539824;35;40;0.542857142857143;16;19;0.0428571428571428;0.457142857142857
Control.SRR15539824;42;40;0.476190476190476;22;20;0.0238095238095238;0.476190476190476
Control.SRR15539824;38;40;0.421052631578947;22;16;0.0789473684210527;0.421052631578947
Control.SRR15539824;39;40;0.41025641025641;23;16;0.0897435897435898;0.41025641025641
Control.SRR15539824;40;40;0.5;20;20;0;0.5
Control.SRR15539824;38;40;0.552631578947368;17;21;0.0526315789473685;0.447368421052632
Control.SRR15539824;40;40;0.6;16;24;0.1;0.4
Control.SRR15539824;39;40;0.564102564102564;17;22;0.0641025641025641;0.435897435897436
Control.SRR15539824;37;40;0.513513513513513;18;19;0.0135135135135135;0.486486486486487
Control.SRR15539824;42;40;0.404761904761905;25;17;0.0952380952380952;0.404761904761905
Control.SRR15539824;39;40;0.461538461538462;21;18;0.0384615384615384;0.461538461538462
Control.SRR15539824;34;40;0.529411764705882;16;18;0.0294117647058824;0.470588235294118
Control.SRR15539824;38;40;0.552631578947368;17;21;0.0526315789473685;0.447368421052632
Control.SRR15539824;43;40;0.348837209302326;28;15;0.151162790697674;0.348837209302326
Control.SRR15539824;37;40;0.324324324324324;25;12;0.175675675675676;0.324324324324324
Control.SRR15539824;38;40;0.578947368421053;16;22;0.0789473684210527;0.421052631578947
Control.SRR15539824;38;40;0.342105263157895;25;13;0.157894736842105;0.342105263157895
Control.SRR15539824;35;40;0.428571428571429;20;15;0.0714285714285715;0.428571428571429
Control.SRR15539824;39;40;0.538461538461538;18;21;0.0384615384615384;0.461538461538462
Control.SRR15539824;37;40;0.351351351351351;24;13;0.148648648648649;0.351351351351351
Control.SRR15539824;38;40;0.473684210526316;20;18;0.0263157894736842;0.473684210526316
Control.SRR15539824;43;40;0.627906976744186;16;27;0.127906976744186;0.372093023255814
Control.SRR15539824;33;40;0.575757575757576;14;19;0.0757575757575758;0.424242424242424
Control.SRR15539824;40;40;0.4;24;16;0.1;0.4
Control.SRR15539824;40;40;0.55;18;22;0.05;0.45
Control.SRR15539824;41;40;0.463414634146341;22;19;0.0365853658536585;0.463414634146341
Control.SRR15539824;39;40;0.538461538461538;18;21;0.0384615384615384;0.461538461538462
Control.SRR15539824;40;40;0.525;19;21;0.025;0.475
Control.SRR15539824;40;40;0.55;18;22;0.05;0.45
Control.SRR15539824;40;40;0.5;20;20;0;0.5
Control.SRR15539824;40;40;0.575;17;23;0.075;0.425
Control.SRR15539824;42;40;0.476190476190476;22;20;0.0238095238095238;0.476190476190476
Control.SRR15539824;39;40;0.41025641025641;23;16;0.0897435897435898;0.41025641025641
Control.SRR15539824;37;40;0.567567567567568;16;21;0.0675675675675675;0.432432432432432
Control.SRR15539824;36;40;0.444444444444444;20;16;0.0555555555555556;0.444444444444444
Control.SRR15539824;39;40;0.461538461538462;21;18;0.0384615384615384;0.461538461538462
Control.SRR15539824;40;40;0.4;24;16;0.1;0.4
Control.SRR15539824;39;40;0.564102564102564;17;22;0.0641025641025641;0.435897435897436
Control.SRR15539824;43;40;0.418604651162791;25;18;0.0813953488372093;0.418604651162791
Control.SRR15539824;40;40;0.275;29;11;0.225;0.275
Control.SRR15539824;42;40;0.428571428571429;24;18;0.0714285714285715;0.428571428571429
Control.SRR15539824;42;40;0.380952380952381;26;16;0.119047619047619;0.380952380952381
Control.SRR15539824;40;40;0.375;25;15;0.125;0.375
Control.SRR15539824;42;40;0.523809523809524;20;22;0.0238095238095238;0.476190476190476
Control.SRR15539824;34;40;0.323529411764706;23;11;0.176470588235294;0.323529411764706
Control.SRR15539824;36;40;0.5;18;18;0;0.5
Control.SRR15539824;40;40;0.475;21;19;0.025;0.475
Control.SRR15539824;41;40;0.463414634146341;22;19;0.0365853658536585;0.463414634146341
Control.SRR15539824;39;40;0.615384615384615;15;24;0.115384615384615;0.384615384615385
Control.SRR15539824;35;40;0.457142857142857;19;16;0.0428571428571429;0.457142857142857
Control.SRR15539824;41;40;0.536585365853659;19;22;0.0365853658536586;0.463414634146341
Control.SRR15539824;39;40;0.41025641025641;23;16;0.0897435897435898;0.41025641025641
Control.SRR15539824;40;40;0.425;23;17;0.075;0.425
Control.SRR15539824;38;40;0.447368421052632;21;17;0.0526315789473684;0.447368421052632
Control.SRR15539824;40;40;0.425;23;17;0.075;0.425
Control.SRR15539824;41;40;0.48780487804878;21;20;0.0121951219512195;0.48780487804878
Control.SRR15539824;43;40;0.372093023255814;27;16;0.127906976744186;0.372093023255814
Control.SRR15539824;33;40;0.636363636363636;12;21;0.136363636363636;0.363636363636364
Control.SRR15539824;39;40;0.41025641025641;23;16;0.0897435897435898;0.41025641025641
Control.SRR15539824;41;40;0.48780487804878;21;20;0.0121951219512195;0.48780487804878
Control.SRR15539824;42;40;0.404761904761905;25;17;0.0952380952380952;0.404761904761905
Control.SRR15539824;38;40;0.473684210526316;20;18;0.0263157894736842;0.473684210526316
Control.SRR15539824;43;40;0.488372093023256;22;21;0.0116279069767442;0.488372093023256
Control.SRR15539824;39;40;0.487179487179487;20;19;0.0128205128205128;0.487179487179487
Control.SRR15539824;34;40;0.617647058823529;13;21;0.117647058823529;0.382352941176471
Control.SRR15539824;40;40;0.475;21;19;0.025;0.475
Control.SRR15539824;37;40;0.513513513513513;18;19;0.0135135135135135;0.486486486486487
Control.SRR15539824;43;40;0.348837209302326;28;15;0.151162790697674;0.348837209302326
Control.SRR15539824;43;40;0.511627906976744;21;22;0.0116279069767442;0.488372093023256
Control.SRR15539824;43;40;0.488372093023256;22;21;0.0116279069767442;0.488372093023256
Control.SRR15539824;41;40;0.439024390243902;23;18;0.0609756097560976;0.439024390243902
Control.SRR15539824;39;40;0.58974358974359;16;23;0.0897435897435898;0.41025641025641
Control.SRR15539824;43;40;0.604651162790698;17;26;0.104651162790698;0.395348837209302
Control.SRR15539824;40;40;0.375;25;15;0.125;0.375
Control.SRR15539824;33;40;0.484848484848485;17;16;0.0151515151515151;0.484848484848485
Control.SRR15539824;38;40;0.526315789473684;18;20;0.0263157894736842;0.473684210526316
Control.SRR15539824;41;40;0.463414634146341;22;19;0.0365853658536585;0.463414634146341
Control.SRR15539824;39;40;0.512820512820513;19;20;0.0128205128205128;0.487179487179487
Control.SRR15539824;36;40;0.611111111111111;14;22;0.111111111111111;0.388888888888889
Control.SRR15539824;43;40;0.372093023255814;27;16;0.127906976744186;0.372093023255814
Control.SRR15539824;42;40;0.428571428571429;24;18;0.0714285714285715;0.428571428571429
Control.SRR15539824;35;40;0.428571428571429;20;15;0.0714285714285715;0.428571428571429
Control.SRR15539824;39;40;0.461538461538462;21;18;0.0384615384615384;0.461538461538462
Control.SRR15539824;36;40;0.416666666666667;21;15;0.0833333333333333;0.416666666666667
Control.SRR15539824;43;40;0.534883720930233;20;23;0.0348837209302325;0.465116279069767
Control.SRR15539824;41;40;0.536585365853659;19;22;0.0365853658536586;0.463414634146341
Control.SRR15539824;39;40;0.538461538461538;18;21;0.0384615384615384;0.461538461538462
Control.SRR15539824;34;40;0.529411764705882;16;18;0.0294117647058824;0.470588235294118
Control.SRR15539824;39;40;0.461538461538462;21;18;0.0384615384615384;0.461538461538462
Control.SRR15539824;37;40;0.567567567567568;16;21;0.0675675675675675;0.432432432432432
Control.SRR15539824;40;40;0.575;17;23;0.075;0.425
Control.SRR15539824;38;40;0.552631578947368;17;21;0.0526315789473685;0.447368421052632
Control.SRR15539824;39;40;0.564102564102564;17;22;0.0641025641025641;0.435897435897436
Control.SRR15539824;42;40;0.571428571428571;18;24;0.0714285714285714;0.428571428571429
Control.SRR15539824;43;40;0.511627906976744;21;22;0.0116279069767442;0.488372093023256
Control.SRR15539824;33;40;0.484848484848485;17;16;0.0151515151515151;0.484848484848485
Control.SRR15539824;41;40;0.439024390243902;23;18;0.0609756097560976;0.439024390243902
Control.SRR15539824;41;40;0.536585365853659;19;22;0.0365853658536586;0.463414634146341
Control.SRR15539824;34;40;0.558823529411765;15;19;0.0588235294117647;0.441176470588235
Control.SRR15539824;33;40;0.303030303030303;23;10;0.196969696969697;0.303030303030303
Control.SRR15539824;42;40;0.547619047619048;19;23;0.0476190476190477;0.452380952380952
Control.SRR15539824;43;40;0.465116279069767;23;20;0.0348837209302326;0.465116279069767
Control.SRR15539824;37;40;0.513513513513513;18;19;0.0135135135135135;0.486486486486487
Control.SRR15539824;37;40;0.351351351351351;24;13;0.148648648648649;0.351351351351351
Control.SRR15539824;37;40;0.405405405405405;22;15;0.0945945945945946;0.405405405405405
Control.SRR15539824;38;40;0.605263157894737;15;23;0.105263157894737;0.394736842105263
Control.SRR15539824;41;40;0.365853658536585;26;15;0.134146341463415;0.365853658536585
Control.SRR15539824;43;40;0.465116279069767;23;20;0.0348837209302326;0.465116279069767
Control.SRR15539824;38;40;0.5;19;19;0;0.5
Control.SRR15539824;43;40;0.534883720930233;20;23;0.0348837209302325;0.465116279069767
Control.SRR15539824;35;40;0.542857142857143;16;19;0.0428571428571428;0.457142857142857
Control.SRR15539824;33;40;0.333333333333333;22;11;0.166666666666667;0.333333333333333
Control.SRR15539824;41;40;0.48780487804878;21;20;0.0121951219512195;0.48780487804878
Control.SRR15539824;36;40;0.444444444444444;20;16;0.0555555555555556;0.444444444444444
Control.SRR15539824;35;40;0.514285714285714;17;18;0.0142857142857142;0.485714285714286
Control.SRR15539824;41;40;0.439024390243902;23;18;0.0609756097560976;0.439024390243902
Control.SRR15539824;42;40;0.380952380952381;26;16;0.119047619047619;0.380952380952381
Control.SRR15539824;42;40;0.5;21;21;0;0.5
Control.SRR15539824;37;40;0.486486486486487;19;18;0.0135135135135135;0.486486486486487
Control.SRR15539824;35;40;0.514285714285714;17;18;0.0142857142857142;0.485714285714286
Control.SRR15539824;38;40;0.447368421052632;21;17;0.0526315789473684;0.447368421052632
Control.SRR15539824;36;40;0.444444444444444;20;16;0.0555555555555556;0.444444444444444
Control.SRR15539824;33;40;0.393939393939394;20;13;0.106060606060606;0.393939393939394
Control.SRR15539824;38;40;0.631578947368421;14;24;0.131578947368421;0.368421052631579
Control.SRR15539824;40;40;0.6;16;24;0.1;0.4
Control.SRR15539824;39;40;0.512820512820513;19;20;0.0128205128205128;0.487179487179487
Control.SRR15539824;38;40;0.394736842105263;23;15;0.105263157894737;0.394736842105263
Control.SRR15539824;41;40;0.48780487804878;21;20;0.0121951219512195;0.48780487804878
Control.SRR15539824;38;40;0.473684210526316;20;18;0.0263157894736842;0.473684210526316
Control.SRR15539824;43;40;0.534883720930233;20;23;0.0348837209302325;0.465116279069767
Control.SRR15539824;34;40;0.558823529411765;15;19;0.0588235294117647;0.441176470588235
Control.SRR15539824;33;40;0.454545454545455;18;15;0.0454545454545455;0.454545454545455
Control.SRR15539824;43;40;0.511627906976744;21;22;0.0116279069767442;0.488372093023256
Control.SRR15539824;40;40;0.475;21;19;0.025;0.475
Control.SRR15539824;34;40;0.5;17;17;0;0.5
Control.SRR15539824;38;40;0.5;19;19;0;0.5
Control.SRR15539824;42;40;0.30952380952381;29;13;0.19047619047619;0.30952380952381
Control.SRR15539824;41;40;0.560975609756098;18;23;0.0609756097560976;0.439024390243902
Control.SRR15539824;34;40;0.441176470588235;19;15;0.0588235294117647;0.441176470588235
Control.SRR15539824;35;40;0.485714285714286;18;17;0.0142857142857143;0.485714285714286
Control.SRR15539824;39;40;0.615384615384615;15;24;0.115384615384615;0.384615384615385
Control.SRR15539824;38;40;0.605263157894737;15;23;0.105263157894737;0.394736842105263
Control.SRR15539824;38;40;0.5;19;19;0;0.5
Control.SRR15539824;43;40;0.395348837209302;26;17;0.104651162790698;0.395348837209302
Control.SRR15539824;39;40;0.538461538461538;18;21;0.0384615384615384;0.461538461538462
Control.SRR15539824;36;40;0.527777777777778;17;19;0.0277777777777778;0.472222222222222
Control.SRR15539824;37;40;0.486486486486487;19;18;0.0135135135135135;0.486486486486487
Control.SRR15539824;33;40;0.545454545454545;15;18;0.0454545454545454;0.454545454545455
Control.SRR15539824;42;40;0.428571428571429;24;18;0.0714285714285715;0.428571428571429
Control.SRR15539824;42;40;0.476190476190476;22;20;0.0238095238095238;0.476190476190476
Control.SRR15539824;38;40;0.421052631578947;22;16;0.0789473684210527;0.421052631578947
Control.SRR15539824;42;40;0.571428571428571;18;24;0.0714285714285714;0.428571428571429
Control.SRR15539824;35;40;0.428571428571429;20;15;0.0714285714285715;0.428571428571429
Control.SRR15539824;33;40;0.454545454545455;18;15;0.0454545454545455;0.454545454545455
Control.SRR15539824;38;40;0.605263157894737;15;23;0.105263157894737;0.394736842105263
Control.SRR15539824;41;40;0.414634146341463;24;17;0.0853658536585366;0.414634146341463
Control.SRR15539824;36;40;0.527777777777778;17;19;0.0277777777777778;0.472222222222222
Control.SRR15539824;41;40;0.439024390243902;23;18;0.0609756097560976;0.439024390243902
Control.SRR15539824;33;40;0.636363636363636;12;21;0.136363636363636;0.363636363636364
Control.SRR15539824;34;40;0.558823529411765;15;19;0.0588235294117647;0.441176470588235
Control.SRR15539824;34;40;0.558823529411765;15;19;0.0588235294117647;0.441176470588235
Control.SRR15539824;34;40;0.5;17;17;0;0.5
Control.SRR15539824;35;40;0.457142857142857;19;16;0.0428571428571429;0.457142857142857
Control.SRR15539824;36;40;0.5;18;18;0;0.5
Control.SRR15539824;37;40;0.459459459459459;20;17;0.0405405405405405;0.459459459459459
Control.SRR15539824;37;40;0.486486486486487;19;18;0.0135135135135135;0.486486486486487
Control.SRR15539824;43;40;0.558139534883721;19;24;0.0581395348837209;0.441860465116279
Control.SRR15539824;41;40;0.51219512195122;20;21;0.0121951219512195;0.48780487804878
Control.SRR15539824;41;40;0.585365853658537;17;24;0.0853658536585366;0.414634146341463
Control.SRR15539824;39;40;0.512820512820513;19;20;0.0128205128205128;0.487179487179487
Control.SRR15539824;34;40;0.441176470588235;19;15;0.0588235294117647;0.441176470588235
Control.SRR15539824;40;40;0.65;14;26;0.15;0.35
Control.SRR15539824;43;40;0.651162790697674;15;28;0.151162790697674;0.348837209302326
Control.SRR15539824;38;40;0.526315789473684;18;20;0.0263157894736842;0.473684210526316
Control.SRR15539824;35;40;0.542857142857143;16;19;0.0428571428571428;0.457142857142857
Control.SRR15539824;37;40;0.621621621621622;14;23;0.121621621621622;0.378378378378378
Control.SRR15539824;35;40;0.542857142857143;16;19;0.0428571428571428;0.457142857142857
Control.SRR15539824;39;40;0.461538461538462;21;18;0.0384615384615384;0.461538461538462
Control.SRR15539824;39;40;0.358974358974359;25;14;0.141025641025641;0.358974358974359
Control.SRR15539824;38;40;0.552631578947368;17;21;0.0526315789473685;0.447368421052632
Control.SRR15539824;42;40;0.428571428571429;24;18;0.0714285714285715;0.428571428571429
Control.SRR15539824;37;40;0.378378378378378;23;14;0.121621621621622;0.378378378378378
Control.SRR15539824;38;40;0.421052631578947;22;16;0.0789473684210527;0.421052631578947
Control.SRR15539824;34;40;0.441176470588235;19;15;0.0588235294117647;0.441176470588235
Control.SRR15539824;36;40;0.583333333333333;15;21;0.0833333333333334;0.416666666666667
Control.SRR15539824;37;40;0.513513513513513;18;19;0.0135135135135135;0.486486486486487
Control.SRR15539824;36;40;0.472222222222222;19;17;0.0277777777777778;0.472222222222222
Control.SRR15539824;41;40;0.560975609756098;18;23;0.0609756097560976;0.439024390243902
Control.SRR15539824;37;40;0.459459459459459;20;17;0.0405405405405405;0.459459459459459
Control.SRR15539824;38;40;0.578947368421053;16;22;0.0789473684210527;0.421052631578947
Control.SRR15539824;41;40;0.609756097560976;16;25;0.109756097560976;0.390243902439024
Control.SRR15539824;34;40;0.558823529411765;15;19;0.0588235294117647;0.441176470588235
Control.SRR15539824;37;40;0.405405405405405;22;15;0.0945945945945946;0.405405405405405
Control.SRR15539824;36;40;0.444444444444444;20;16;0.0555555555555556;0.444444444444444
Control.SRR15539824;35;40;0.4;21;14;0.1;0.4
Control.SRR15539824;37;40;0.567567567567568;16;21;0.0675675675675675;0.432432432432432
Control.SRR15539824;33;40;0.333333333333333;22;11;0.166666666666667;0.333333333333333
Control.SRR15539824;37;40;0.594594594594595;15;22;0.0945945945945946;0.405405405405405
Control.SRR15539824;35;40;0.4;21;14;0.1;0.4
Control.SRR15539824;38;40;0.473684210526316;20;18;0.0263157894736842;0.473684210526316
Control.SRR15539824;40;40;0.525;19;21;0.025;0.475
Control.SRR15539824;36;40;0.388888888888889;22;14;0.111111111111111;0.388888888888889
Control.SRR15539824;41;40;0.439024390243902;23;18;0.0609756097560976;0.439024390243902
Control.SRR15539824;43;40;0.441860465116279;24;19;0.0581395348837209;0.441860465116279
Control.SRR15539824;39;40;0.666666666666667;13;26;0.166666666666667;0.333333333333333
Control.SRR15539824;39;40;0.487179487179487;20;19;0.0128205128205128;0.487179487179487
Control.SRR15539824;36;40;0.555555555555556;16;20;0.0555555555555556;0.444444444444444
Control.SRR15539824;33;40;0.484848484848485;17;16;0.0151515151515151;0.484848484848485
Control.SRR15539824;35;40;0.571428571428571;15;20;0.0714285714285714;0.428571428571429
Control.SRR15539824;35;40;0.542857142857143;16;19;0.0428571428571428;0.457142857142857
Control.SRR15539824;38;40;0.526315789473684;18;20;0.0263157894736842;0.473684210526316
Control.SRR15539824;33;40;0.484848484848485;17;16;0.0151515151515151;0.484848484848485
Control.SRR15539824;36;40;0.388888888888889;22;14;0.111111111111111;0.388888888888889
Control.SRR15539824;41;40;0.48780487804878;21;20;0.0121951219512195;0.48780487804878
Control.SRR15539824;36;40;0.472222222222222;19;17;0.0277777777777778;0.472222222222222
Control.SRR15539824;40;40;0.5;20;20;0;0.5
Control.SRR15539824;42;40;0.5;21;21;0;0.5
Control.SRR15539824;43;40;0.418604651162791;25;18;0.0813953488372093;0.418604651162791
Control.SRR15539824;37;40;0.432432432432432;21;16;0.0675675675675675;0.432432432432432
Control.SRR15539824;38;40;0.421052631578947;22;16;0.0789473684210527;0.421052631578947
Control.SRR15539824;37;40;0.459459459459459;20;17;0.0405405405405405;0.459459459459459
Control.SRR15539824;34;40;0.558823529411765;15;19;0.0588235294117647;0.441176470588235
Control.SRR15539824;41;40;0.585365853658537;17;24;0.0853658536585366;0.414634146341463
Control.SRR15539824;38;40;0.447368421052632;21;17;0.0526315789473684;0.447368421052632
Control.SRR15539824;42;40;0.523809523809524;20;22;0.0238095238095238;0.476190476190476
Control.SRR15539824;38;40;0.5;19;19;0;0.5
Control.SRR15539824;42;40;0.547619047619048;19;23;0.0476190476190477;0.452380952380952
Control.SRR15539824;39;40;0.564102564102564;17;22;0.0641025641025641;0.435897435897436
Control.SRR15539824;35;40;0.485714285714286;18;17;0.0142857142857143;0.485714285714286
Control.SRR15539824;36;40;0.388888888888889;22;14;0.111111111111111;0.388888888888889
Control.SRR15539824;42;40;0.595238095238095;17;25;0.0952380952380952;0.404761904761905
Control.SRR15539824;42;40;0.357142857142857;27;15;0.142857142857143;0.357142857142857
Control.SRR15539824;35;40;0.571428571428571;15;20;0.0714285714285714;0.428571428571429
Control.SRR15539824;34;40;0.588235294117647;14;20;0.0882352941176471;0.411764705882353
Control.SRR15539824;42;40;0.476190476190476;22;20;0.0238095238095238;0.476190476190476
Control.SRR15539824;39;40;0.564102564102564;17;22;0.0641025641025641;0.435897435897436
Control.SRR15539824;34;40;0.588235294117647;14;20;0.0882352941176471;0.411764705882353
Control.SRR15539824;34;40;0.470588235294118;18;16;0.0294117647058824;0.470588235294118
Control.SRR15539824;37;40;0.567567567567568;16;21;0.0675675675675675;0.432432432432432
Control.SRR15539824;35;40;0.571428571428571;15;20;0.0714285714285714;0.428571428571429
Control.SRR15539824;39;40;0.58974358974359;16;23;0.0897435897435898;0.41025641025641
Control.SRR15539824;39;40;0.615384615384615;15;24;0.115384615384615;0.384615384615385
Control.SRR15539824;39;40;0.435897435897436;22;17;0.0641025641025641;0.435897435897436
Control.SRR15539824;37;40;0.513513513513513;18;19;0.0135135135135135;0.486486486486487
Control.SRR15539824;38;40;0.526315789473684;18;20;0.0263157894736842;0.473684210526316
Control.SRR15539824;42;40;0.547619047619048;19;23;0.0476190476190477;0.452380952380952
Control.SRR15539824;42;40;0.523809523809524;20;22;0.0238095238095238;0.476190476190476
Control.SRR15539824;37;40;0.459459459459459;20;17;0.0405405405405405;0.459459459459459
Control.SRR15539824;34;40;0.529411764705882;16;18;0.0294117647058824;0.470588235294118
Control.SRR15539824;36;40;0.472222222222222;19;17;0.0277777777777778;0.472222222222222
Control.SRR15539824;36;40;0.388888888888889;22;14;0.111111111111111;0.388888888888889
Control.SRR15539824;40;40;0.65;14;26;0.15;0.35
Control.SRR15539824;39;40;0.435897435897436;22;17;0.0641025641025641;0.435897435897436
Control.SRR15539824;39;40;0.487179487179487;20;19;0.0128205128205128;0.487179487179487
Control.SRR15539824;34;40;0.617647058823529;13;21;0.117647058823529;0.382352941176471
Control.SRR15539824;41;40;0.48780487804878;21;20;0.0121951219512195;0.48780487804878
Control.SRR15539824;33;40;0.363636363636364;21;12;0.136363636363636;0.363636363636364
Control.SRR15539824;41;40;0.560975609756098;18;23;0.0609756097560976;0.439024390243902
Control.SRR15539824;39;40;0.538461538461538;18;21;0.0384615384615384;0.461538461538462
Control.SRR15539824;41;40;0.51219512195122;20;21;0.0121951219512195;0.48780487804878
Control.SRR15539824;37;40;0.432432432432432;21;16;0.0675675675675675;0.432432432432432
Control.SRR15539824;38;40;0.473684210526316;20;18;0.0263157894736842;0.473684210526316
Control.SRR15539824;38;40;0.526315789473684;18;20;0.0263157894736842;0.473684210526316
Control.SRR15539824;34;40;0.411764705882353;20;14;0.0882352941176471;0.411764705882353
Control.SRR15539824;40;40;0.55;18;22;0.05;0.45
Control.SRR15539824;36;40;0.444444444444444;20;16;0.0555555555555556;0.444444444444444
Control.SRR15539824;38;40;0.5;19;19;0;0.5
Control.SRR15539824;35;40;0.457142857142857;19;16;0.0428571428571429;0.457142857142857
Control.SRR15539824;38;40;0.5;19;19;0;0.5
Control.SRR15539824;43;40;0.395348837209302;26;17;0.104651162790698;0.395348837209302
Control.SRR15539824;41;40;0.463414634146341;22;19;0.0365853658536585;0.463414634146341
Control.SRR15539824;42;40;0.571428571428571;18;24;0.0714285714285714;0.428571428571429
Control.SRR15539824;43;40;0.441860465116279;24;19;0.0581395348837209;0.441860465116279
Control.SRR15539824;37;40;0.567567567567568;16;21;0.0675675675675675;0.432432432432432
Control.SRR15539824;38;40;0.5;19;19;0;0.5
Control.SRR15539824;43;40;0.534883720930233;20;23;0.0348837209302325;0.465116279069767
Control.SRR15539824;42;40;0.619047619047619;16;26;0.119047619047619;0.380952380952381
Control.SRR15539824;41;40;0.48780487804878;21;20;0.0121951219512195;0.48780487804878
Control.SRR15539824;41;40;0.48780487804878;21;20;0.0121951219512195;0.48780487804878
Control.SRR15539824;43;40;0.488372093023256;22;21;0.0116279069767442;0.488372093023256
Control.SRR15539824;36;40;0.361111111111111;23;13;0.138888888888889;0.361111111111111
Control.SRR15539824;38;40;0.526315789473684;18;20;0.0263157894736842;0.473684210526316
Control.SRR15539824;40;40;0.45;22;18;0.05;0.45
Control.SRR15539824;36;40;0.5;18;18;0;0.5
Control.SRR15539824;41;40;0.390243902439024;25;16;0.109756097560976;0.390243902439024
Control.SRR15539824;43;40;0.465116279069767;23;20;0.0348837209302326;0.465116279069767
Control.SRR15539824;42;40;0.523809523809524;20;22;0.0238095238095238;0.476190476190476
Control.SRR15539824;34;40;0.323529411764706;23;11;0.176470588235294;0.323529411764706
Control.SRR15539824;34;40;0.5;17;17;0;0.5
Control.SRR15539824;37;40;0.567567567567568;16;21;0.0675675675675675;0.432432432432432
Control.SRR15539824;40;40;0.475;21;19;0.025;0.475
Control.SRR15539824;40;40;0.3;28;12;0.2;0.3
Control.SRR15539824;41;40;0.51219512195122;20;21;0.0121951219512195;0.48780487804878
Control.SRR15539824;38;40;0.447368421052632;21;17;0.0526315789473684;0.447368421052632
Control.SRR15539824;38;40;0.421052631578947;22;16;0.0789473684210527;0.421052631578947
Control.SRR15539824;42;40;0.547619047619048;19;23;0.0476190476190477;0.452380952380952
Control.SRR15539824;39;40;0.461538461538462;21;18;0.0384615384615384;0.461538461538462
Control.SRR15539824;43;40;0.558139534883721;19;24;0.0581395348837209;0.441860465116279
Control.SRR15539824;36;40;0.5;18;18;0;0.5
Control.SRR15539824;36;40;0.333333333333333;24;12;0.166666666666667;0.333333333333333
Control.SRR15539824;36;40;0.472222222222222;19;17;0.0277777777777778;0.472222222222222
Control.SRR15539824;39;40;0.615384615384615;15;24;0.115384615384615;0.384615384615385
Control.SRR15539824;35;40;0.457142857142857;19;16;0.0428571428571429;0.457142857142857
Control.SRR15539824;41;40;0.463414634146341;22;19;0.0365853658536585;0.463414634146341
Control.SRR15539824;36;40;0.555555555555556;16;20;0.0555555555555556;0.444444444444444
Control.SRR15539824;42;40;0.547619047619048;19;23;0.0476190476190477;0.452380952380952
Control.SRR15539824;39;40;0.538461538461538;18;21;0.0384615384615384;0.461538461538462
Control.SRR15539824;44;40;0.431818181818182;25;19;0.0681818181818182;0.431818181818182
Control.SRR15539824;34;40;0.411764705882353;20;14;0.0882352941176471;0.411764705882353
Control.SRR15539824;36;40;0.305555555555556;25;11;0.194444444444444;0.305555555555556
Control.SRR15539824;40;40;0.625;15;25;0.125;0.375
Control.SRR15539824;39;40;0.384615384615385;24;15;0.115384615384615;0.384615384615385
Control.SRR15539824;35;40;0.6;14;21;0.1;0.4
Control.SRR15539824;43;40;0.441860465116279;24;19;0.0581395348837209;0.441860465116279
Control.SRR15539824;39;40;0.41025641025641;23;16;0.0897435897435898;0.41025641025641
Control.SRR15539824;40;40;0.4;24;16;0.1;0.4
Control.SRR15539824;43;40;0.558139534883721;19;24;0.0581395348837209;0.441860465116279
Control.SRR15539824;39;40;0.538461538461538;18;21;0.0384615384615384;0.461538461538462
Control.SRR15539824;38;40;0.526315789473684;18;20;0.0263157894736842;0.473684210526316
Control.SRR15539824;35;40;0.542857142857143;16;19;0.0428571428571428;0.457142857142857
Control.SRR15539824;34;40;0.529411764705882;16;18;0.0294117647058824;0.470588235294118
Control.SRR15539824;37;40;0.486486486486487;19;18;0.0135135135135135;0.486486486486487
Control.SRR15539824;40;40;0.65;14;26;0.15;0.35
Control.SRR15539824;41;40;0.51219512195122;20;21;0.0121951219512195;0.48780487804878
Control.SRR15539824;38;40;0.552631578947368;17;21;0.0526315789473685;0.447368421052632
Control.SRR15539824;34;40;0.441176470588235;19;15;0.0588235294117647;0.441176470588235
Control.SRR15539824;39;40;0.512820512820513;19;20;0.0128205128205128;0.487179487179487
Control.SRR15539824;35;40;0.542857142857143;16;19;0.0428571428571428;0.457142857142857
Control.SRR15539824;35;40;0.628571428571429;13;22;0.128571428571429;0.371428571428571
Control.SRR15539824;37;40;0.486486486486487;19;18;0.0135135135135135;0.486486486486487
Control.SRR15539824;36;40;0.444444444444444;20;16;0.0555555555555556;0.444444444444444
Control.SRR15539824;42;40;0.380952380952381;26;16;0.119047619047619;0.380952380952381
Control.SRR15539824;37;40;0.567567567567568;16;21;0.0675675675675675;0.432432432432432
Control.SRR15539824;43;40;0.418604651162791;25;18;0.0813953488372093;0.418604651162791
Control.SRR15539824;36;40;0.472222222222222;19;17;0.0277777777777778;0.472222222222222
Control.SRR15539824;37;40;0.540540540540541;17;20;0.0405405405405406;0.459459459459459
Control.SRR15539824;34;40;0.558823529411765;15;19;0.0588235294117647;0.441176470588235
Control.SRR15539824;34;40;0.470588235294118;18;16;0.0294117647058824;0.470588235294118
Control.SRR15539824;37;40;0.486486486486487;19;18;0.0135135135135135;0.486486486486487
Control.SRR15539824;38;40;0.684210526315789;12;26;0.184210526315789;0.315789473684211
Control.SRR15539824;42;40;0.452380952380952;23;19;0.0476190476190476;0.452380952380952
Control.SRR15539824;37;40;0.594594594594595;15;22;0.0945945945945946;0.405405405405405
Control.SRR15539824;40;40;0.425;23;17;0.075;0.425
Control.SRR15539824;44;40;0.431818181818182;25;19;0.0681818181818182;0.431818181818182
Control.SRR15539824;39;40;0.487179487179487;20;19;0.0128205128205128;0.487179487179487
Control.SRR15539824;40;40;0.65;14;26;0.15;0.35
Control.SRR15539824;38;40;0.394736842105263;23;15;0.105263157894737;0.394736842105263
Control.SRR15539824;38;40;0.473684210526316;20;18;0.0263157894736842;0.473684210526316
Control.SRR15539824;37;40;0.486486486486487;19;18;0.0135135135135135;0.486486486486487
Control.SRR15539824;35;40;0.542857142857143;16;19;0.0428571428571428;0.457142857142857
Control.SRR15539824;34;40;0.617647058823529;13;21;0.117647058823529;0.382352941176471
Control.SRR15539824;35;40;0.542857142857143;16;19;0.0428571428571428;0.457142857142857
Control.SRR15539824;43;40;0.511627906976744;21;22;0.0116279069767442;0.488372093023256
Control.SRR15539824;40;40;0.5;20;20;0;0.5
Control.SRR15539824;34;40;0.558823529411765;15;19;0.0588235294117647;0.441176470588235
Control.SRR15539824;34;40;0.470588235294118;18;16;0.0294117647058824;0.470588235294118
Control.SRR15539824;38;40;0.526315789473684;18;20;0.0263157894736842;0.473684210526316
Control.SRR15539824;38;40;0.526315789473684;18;20;0.0263157894736842;0.473684210526316
Control.SRR15539824;37;40;0.459459459459459;20;17;0.0405405405405405;0.459459459459459
Control.SRR15539824;41;40;0.48780487804878;21;20;0.0121951219512195;0.48780487804878
Control.SRR15539824;42;40;0.5;21;21;0;0.5
Control.SRR15539824;36;40;0.5;18;18;0;0.5
Control.SRR15539824;36;40;0.333333333333333;24;12;0.166666666666667;0.333333333333333
Control.SRR15539824;34;40;0.617647058823529;13;21;0.117647058823529;0.382352941176471
Control.SRR15539824;38;40;0.526315789473684;18;20;0.0263157894736842;0.473684210526316
Control.SRR15539824;41;40;0.560975609756098;18;23;0.0609756097560976;0.439024390243902
Control.SRR15539824;37;40;0.621621621621622;14;23;0.121621621621622;0.378378378378378
Control.SRR15539824;35;40;0.571428571428571;15;20;0.0714285714285714;0.428571428571429
Control.SRR15539824;38;40;0.631578947368421;14;24;0.131578947368421;0.368421052631579
Control.SRR15539824;44;40;0.454545454545455;24;20;0.0454545454545455;0.454545454545455
Control.SRR15539824;35;40;0.457142857142857;19;16;0.0428571428571429;0.457142857142857
Control.SRR15539824;39;40;0.487179487179487;20;19;0.0128205128205128;0.487179487179487
Control.SRR15539824;41;40;0.463414634146341;22;19;0.0365853658536585;0.463414634146341
Control.SRR15539824;44;40;0.431818181818182;25;19;0.0681818181818182;0.431818181818182
Control.SRR15539824;34;40;0.529411764705882;16;18;0.0294117647058824;0.470588235294118
Control.SRR15539824;38;40;0.5;19;19;0;0.5
Control.SRR15539824;44;40;0.568181818181818;19;25;0.0681818181818182;0.431818181818182
Control.SRR15539824;40;40;0.425;23;17;0.075;0.425
Control.SRR15539824;40;40;0.55;18;22;0.05;0.45
Control.SRR15539824;43;40;0.534883720930233;20;23;0.0348837209302325;0.465116279069767
Control.SRR15539824;43;40;0.372093023255814;27;16;0.127906976744186;0.372093023255814
Control.SRR15539824;38;40;0.526315789473684;18;20;0.0263157894736842;0.473684210526316
Control.SRR15539824;40;40;0.5;20;20;0;0.5
Control.SRR15539824;40;40;0.475;21;19;0.025;0.475
Control.SRR15539824;44;40;0.409090909090909;26;18;0.0909090909090909;0.409090909090909
Control.SRR15539824;37;40;0.432432432432432;21;16;0.0675675675675675;0.432432432432432
Control.SRR15539824;35;40;0.542857142857143;16;19;0.0428571428571428;0.457142857142857
Control.SRR15539824;40;40;0.5;20;20;0;0.5
Control.SRR15539824;42;40;0.523809523809524;20;22;0.0238095238095238;0.476190476190476
Control.SRR15539824;43;40;0.511627906976744;21;22;0.0116279069767442;0.488372093023256
Control.SRR15539824;36;40;0.416666666666667;21;15;0.0833333333333333;0.416666666666667
Control.SRR15539824;36;40;0.555555555555556;16;20;0.0555555555555556;0.444444444444444
Control.SRR15539824;37;40;0.486486486486487;19;18;0.0135135135135135;0.486486486486487
Control.SRR15539824;34;40;0.676470588235294;11;23;0.176470588235294;0.323529411764706
Control.SRR15539824;42;40;0.547619047619048;19;23;0.0476190476190477;0.452380952380952
Control.SRR15539824;34;40;0.441176470588235;19;15;0.0588235294117647;0.441176470588235
Control.SRR15539824;40;40;0.55;18;22;0.05;0.45
Control.SRR15539824;42;40;0.452380952380952;23;19;0.0476190476190476;0.452380952380952
Control.SRR15539824;44;40;0.409090909090909;26;18;0.0909090909090909;0.409090909090909
Control.SRR15539824;41;40;0.439024390243902;23;18;0.0609756097560976;0.439024390243902
Control.SRR15539824;40;40;0.5;20;20;0;0.5
Control.SRR15539824;38;40;0.421052631578947;22;16;0.0789473684210527;0.421052631578947
Control.SRR15539824;40;40;0.475;21;19;0.025;0.475
Control.SRR15539824;35;40;0.457142857142857;19;16;0.0428571428571429;0.457142857142857
Control.SRR15539824;40;40;0.55;18;22;0.05;0.45
Control.SRR15539824;41;40;0.536585365853659;19;22;0.0365853658536586;0.463414634146341
Control.SRR15539824;38;40;0.526315789473684;18;20;0.0263157894736842;0.473684210526316
Control.SRR15539824;35;40;0.542857142857143;16;19;0.0428571428571428;0.457142857142857
Control.SRR15539824;40;40;0.475;21;19;0.025;0.475
Control.SRR15539824;42;40;0.476190476190476;22;20;0.0238095238095238;0.476190476190476
Control.SRR15539824;36;40;0.472222222222222;19;17;0.0277777777777778;0.472222222222222
Control.SRR15539824;43;40;0.511627906976744;21;22;0.0116279069767442;0.488372093023256
Control.SRR15539824;35;40;0.514285714285714;17;18;0.0142857142857142;0.485714285714286
Control.SRR15539824;42;40;0.476190476190476;22;20;0.0238095238095238;0.476190476190476
Control.SRR15539824;37;40;0.72972972972973;10;27;0.22972972972973;0.27027027027027
Control.SRR15539824;35;40;0.428571428571429;20;15;0.0714285714285715;0.428571428571429
Control.SRR15539824;38;40;0.526315789473684;18;20;0.0263157894736842;0.473684210526316
Control.SRR15539824;39;40;0.461538461538462;21;18;0.0384615384615384;0.461538461538462
Control.SRR15539824;36;40;0.527777777777778;17;19;0.0277777777777778;0.472222222222222
Control.SRR15539824;39;40;0.487179487179487;20;19;0.0128205128205128;0.487179487179487
Control.SRR15539824;44;40;0.704545454545455;13;31;0.204545454545455;0.295454545454545
Control.SRR15539824;40;40;0.35;26;14;0.15;0.35
Control.SRR15539824;42;40;0.333333333333333;28;14;0.166666666666667;0.333333333333333
Control.SRR15539824;40;40;0.375;25;15;0.125;0.375
Control.SRR15539824;35;40;0.485714285714286;18;17;0.0142857142857143;0.485714285714286
Control.SRR15539824;40;40;0.525;19;21;0.025;0.475
Control.SRR15539824;36;40;0.333333333333333;24;12;0.166666666666667;0.333333333333333
Control.SRR15539824;34;40;0.558823529411765;15;19;0.0588235294117647;0.441176470588235
Control.SRR15539824;44;40;0.522727272727273;21;23;0.0227272727272727;0.477272727272727
Control.SRR15539824;41;40;0.317073170731707;28;13;0.182926829268293;0.317073170731707
Control.SRR15539824;42;40;0.357142857142857;27;15;0.142857142857143;0.357142857142857
Control.SRR15539824;44;40;0.363636363636364;28;16;0.136363636363636;0.363636363636364
Control.SRR15539824;42;40;0.5;21;21;0;0.5
Control.SRR15539824;41;40;0.365853658536585;26;15;0.134146341463415;0.365853658536585
Control.SRR15539824;34;40;0.617647058823529;13;21;0.117647058823529;0.382352941176471
Control.SRR15539824;35;40;0.742857142857143;9;26;0.242857142857143;0.257142857142857
Control.SRR15539824;34;40;0.441176470588235;19;15;0.0588235294117647;0.441176470588235
Control.SRR15539824;37;40;0.621621621621622;14;23;0.121621621621622;0.378378378378378
Control.SRR15539824;39;40;0.41025641025641;23;16;0.0897435897435898;0.41025641025641
Control.SRR15539824;38;40;0.552631578947368;17;21;0.0526315789473685;0.447368421052632
Control.SRR15539824;40;40;0.525;19;21;0.025;0.475
Control.SRR15539824;36;40;0.5;18;18;0;0.5
Control.SRR15539824;38;40;0.447368421052632;21;17;0.0526315789473684;0.447368421052632
Control.SRR15539824;41;40;0.585365853658537;17;24;0.0853658536585366;0.414634146341463
Control.SRR15539824;40;40;0.525;19;21;0.025;0.475
Control.SRR15539824;42;40;0.595238095238095;17;25;0.0952380952380952;0.404761904761905
Control.SRR15539824;41;40;0.365853658536585;26;15;0.134146341463415;0.365853658536585
Control.SRR15539824;38;40;0.552631578947368;17;21;0.0526315789473685;0.447368421052632
Control.SRR15539824;42;40;0.523809523809524;20;22;0.0238095238095238;0.476190476190476
Control.SRR15539824;34;40;0.558823529411765;15;19;0.0588235294117647;0.441176470588235
Control.SRR15539824;40;40;0.4;24;16;0.1;0.4
Control.SRR15539824;44;40;0.522727272727273;21;23;0.0227272727272727;0.477272727272727
Control.SRR15539824;38;40;0.552631578947368;17;21;0.0526315789473685;0.447368421052632
Control.SRR15539824;39;40;0.41025641025641;23;16;0.0897435897435898;0.41025641025641
Control.SRR15539824;40;40;0.5;20;20;0;0.5
Control.SRR15539824;34;40;0.558823529411765;15;19;0.0588235294117647;0.441176470588235
Control.SRR15539824;44;40;0.454545454545455;24;20;0.0454545454545455;0.454545454545455
Control.SRR15539824;40;40;0.525;19;21;0.025;0.475
Control.SRR15539824;43;40;0.488372093023256;22;21;0.0116279069767442;0.488372093023256
Control.SRR15539824;35;40;0.571428571428571;15;20;0.0714285714285714;0.428571428571429
Control.SRR15539824;39;40;0.512820512820513;19;20;0.0128205128205128;0.487179487179487
Control.SRR15539824;35;40;0.485714285714286;18;17;0.0142857142857143;0.485714285714286
Control.SRR15539824;41;40;0.585365853658537;17;24;0.0853658536585366;0.414634146341463
Control.SRR15539824;35;40;0.457142857142857;19;16;0.0428571428571429;0.457142857142857
Control.SRR15539824;38;40;0.526315789473684;18;20;0.0263157894736842;0.473684210526316
Control.SRR15539824;38;40;0.526315789473684;18;20;0.0263157894736842;0.473684210526316
Control.SRR15539824;40;40;0.5;20;20;0;0.5
Control.SRR15539824;37;40;0.567567567567568;16;21;0.0675675675675675;0.432432432432432
Control.SRR15539824;36;40;0.5;18;18;0;0.5
Control.SRR15539824;39;40;0.487179487179487;20;19;0.0128205128205128;0.487179487179487
Control.SRR15539824;35;40;0.371428571428571;22;13;0.128571428571429;0.371428571428571
Control.SRR15539824;42;40;0.523809523809524;20;22;0.0238095238095238;0.476190476190476
Control.SRR15539824;37;40;0.378378378378378;23;14;0.121621621621622;0.378378378378378
Control.SRR15539824;39;40;0.58974358974359;16;23;0.0897435897435898;0.41025641025641
Control.SRR15539824;39;40;0.41025641025641;23;16;0.0897435897435898;0.41025641025641
Control.SRR15539824;39;40;0.487179487179487;20;19;0.0128205128205128;0.487179487179487
Control.SRR15539824;42;40;0.523809523809524;20;22;0.0238095238095238;0.476190476190476
Control.SRR15539824;42;40;0.571428571428571;18;24;0.0714285714285714;0.428571428571429
Control.SRR15539824;41;40;0.536585365853659;19;22;0.0365853658536586;0.463414634146341
Control.SRR15539824;34;40;0.558823529411765;15;19;0.0588235294117647;0.441176470588235
Control.SRR15539824;42;40;0.547619047619048;19;23;0.0476190476190477;0.452380952380952
Control.SRR15539824;36;40;0.527777777777778;17;19;0.0277777777777778;0.472222222222222
Control.SRR15539824;39;40;0.461538461538462;21;18;0.0384615384615384;0.461538461538462
Control.SRR15539824;41;40;0.390243902439024;25;16;0.109756097560976;0.390243902439024
Control.SRR15539824;37;40;0.486486486486487;19;18;0.0135135135135135;0.486486486486487
Control.SRR15539824;39;40;0.487179487179487;20;19;0.0128205128205128;0.487179487179487
Control.SRR15539824;35;40;0.542857142857143;16;19;0.0428571428571428;0.457142857142857
Control.SRR15539824;36;40;0.555555555555556;16;20;0.0555555555555556;0.444444444444444
Control.SRR15539824;35;40;0.542857142857143;16;19;0.0428571428571428;0.457142857142857
Control.SRR15539824;35;40;0.628571428571429;13;22;0.128571428571429;0.371428571428571
Control.SRR15539824;36;40;0.5;18;18;0;0.5
Control.SRR15539824;35;40;0.457142857142857;19;16;0.0428571428571429;0.457142857142857
Control.SRR15539824;43;40;0.534883720930233;20;23;0.0348837209302325;0.465116279069767
Control.SRR15539824;35;40;0.628571428571429;13;22;0.128571428571429;0.371428571428571
Control.SRR15539824;40;40;0.525;19;21;0.025;0.475
Control.SRR15539824;40;40;0.6;16;24;0.1;0.4
Control.SRR15539824;39;40;0.435897435897436;22;17;0.0641025641025641;0.435897435897436
Control.SRR15539824;35;40;0.485714285714286;18;17;0.0142857142857143;0.485714285714286
Control.SRR15539824;40;40;0.475;21;19;0.025;0.475
Control.SRR15539824;34;40;0.588235294117647;14;20;0.0882352941176471;0.411764705882353
Control.SRR15539824;38;40;0.605263157894737;15;23;0.105263157894737;0.394736842105263
Control.SRR15539824;40;40;0.525;19;21;0.025;0.475
Control.SRR15539824;42;40;0.476190476190476;22;20;0.0238095238095238;0.476190476190476
Control.SRR15539824;38;40;0.526315789473684;18;20;0.0263157894736842;0.473684210526316
Control.SRR15539824;40;40;0.375;25;15;0.125;0.375
Control.SRR15539824;37;40;0.459459459459459;20;17;0.0405405405405405;0.459459459459459
Control.SRR15539824;34;40;0.470588235294118;18;16;0.0294117647058824;0.470588235294118
Control.SRR15539824;42;40;0.476190476190476;22;20;0.0238095238095238;0.476190476190476
Control.SRR15539824;37;40;0.459459459459459;20;17;0.0405405405405405;0.459459459459459
Control.SRR15539824;37;40;0.351351351351351;24;13;0.148648648648649;0.351351351351351
Control.SRR15539824;37;40;0.378378378378378;23;14;0.121621621621622;0.378378378378378
Control.SRR15539824;40;40;0.5;20;20;0;0.5
Control.SRR15539824;38;40;0.5;19;19;0;0.5
Control.SRR15539824;40;40;0.35;26;14;0.15;0.35
Control.SRR15539824;39;40;0.58974358974359;16;23;0.0897435897435898;0.41025641025641
Control.SRR15539824;43;40;0.604651162790698;17;26;0.104651162790698;0.395348837209302
Control.SRR15539824;43;40;0.558139534883721;19;24;0.0581395348837209;0.441860465116279
Control.SRR15539824;44;40;0.522727272727273;21;23;0.0227272727272727;0.477272727272727
Control.SRR15539824;34;40;0.529411764705882;16;18;0.0294117647058824;0.470588235294118
Control.SRR15539824;42;40;0.547619047619048;19;23;0.0476190476190477;0.452380952380952
Control.SRR15539824;35;40;0.571428571428571;15;20;0.0714285714285714;0.428571428571429
Control.SRR15539824;36;40;0.472222222222222;19;17;0.0277777777777778;0.472222222222222
Control.SRR15539824;37;40;0.459459459459459;20;17;0.0405405405405405;0.459459459459459
Control.SRR15539824;35;40;0.371428571428571;22;13;0.128571428571429;0.371428571428571
Control.SRR15539824;38;40;0.473684210526316;20;18;0.0263157894736842;0.473684210526316
Control.SRR15539824;34;40;0.470588235294118;18;16;0.0294117647058824;0.470588235294118
Control.SRR15539824;34;40;0.705882352941177;10;24;0.205882352941177;0.294117647058824
Control.SRR15539824;35;40;0.457142857142857;19;16;0.0428571428571429;0.457142857142857
Control.SRR15539824;36;40;0.416666666666667;21;15;0.0833333333333333;0.416666666666667
Control.SRR15539824;34;40;0.382352941176471;21;13;0.117647058823529;0.382352941176471
Control.SRR15539824;39;40;0.58974358974359;16;23;0.0897435897435898;0.41025641025641
Control.SRR15539824;35;40;0.542857142857143;16;19;0.0428571428571428;0.457142857142857
Control.SRR15539824;41;40;0.536585365853659;19;22;0.0365853658536586;0.463414634146341
Control.SRR15539824;38;40;0.552631578947368;17;21;0.0526315789473685;0.447368421052632
Control.SRR15539824;37;40;0.459459459459459;20;17;0.0405405405405405;0.459459459459459
Control.SRR15539824;37;40;0.486486486486487;19;18;0.0135135135135135;0.486486486486487
Control.SRR15539824;37;40;0.486486486486487;19;18;0.0135135135135135;0.486486486486487
Control.SRR15539824;37;40;0.405405405405405;22;15;0.0945945945945946;0.405405405405405
Control.SRR15539824;38;40;0.447368421052632;21;17;0.0526315789473684;0.447368421052632
Control.SRR15539824;34;40;0.5;17;17;0;0.5
Control.SRR15539824;36;40;0.583333333333333;15;21;0.0833333333333334;0.416666666666667
Control.SRR15539824;42;40;0.5;21;21;0;0.5
Control.SRR15539824;34;40;0.382352941176471;21;13;0.117647058823529;0.382352941176471
Control.SRR15539824;42;40;0.380952380952381;26;16;0.119047619047619;0.380952380952381
Control.SRR15539824;42;40;0.5;21;21;0;0.5
Control.SRR15539824;42;40;0.452380952380952;23;19;0.0476190476190476;0.452380952380952
Control.SRR15539824;37;40;0.432432432432432;21;16;0.0675675675675675;0.432432432432432
Control.SRR15539824;38;40;0.5;19;19;0;0.5
Control.SRR15539824;38;40;0.447368421052632;21;17;0.0526315789473684;0.447368421052632
Control.SRR15539824;37;40;0.432432432432432;21;16;0.0675675675675675;0.432432432432432
Control.SRR15539824;44;40;0.340909090909091;29;15;0.159090909090909;0.340909090909091
Control.SRR15539824;34;40;0.529411764705882;16;18;0.0294117647058824;0.470588235294118
Control.SRR15539824;39;40;0.487179487179487;20;19;0.0128205128205128;0.487179487179487
Control.SRR15539824;38;40;0.342105263157895;25;13;0.157894736842105;0.342105263157895
Control.SRR15539824;41;40;0.560975609756098;18;23;0.0609756097560976;0.439024390243902
Control.SRR15539824;37;40;0.540540540540541;17;20;0.0405405405405406;0.459459459459459
Control.SRR15539824;34;40;0.382352941176471;21;13;0.117647058823529;0.382352941176471
Control.SRR15539824;41;40;0.439024390243902;23;18;0.0609756097560976;0.439024390243902
Control.SRR15539824;37;40;0.378378378378378;23;14;0.121621621621622;0.378378378378378
Control.SRR15539824;38;40;0.578947368421053;16;22;0.0789473684210527;0.421052631578947
Control.SRR15539824;43;40;0.558139534883721;19;24;0.0581395348837209;0.441860465116279
Control.SRR15539824;34;40;0.558823529411765;15;19;0.0588235294117647;0.441176470588235
Control.SRR15539824;39;40;0.487179487179487;20;19;0.0128205128205128;0.487179487179487
Control.SRR15539824;36;40;0.583333333333333;15;21;0.0833333333333334;0.416666666666667
Control.SRR15539824;40;40;0.575;17;23;0.075;0.425
Control.SRR15539824;39;40;0.461538461538462;21;18;0.0384615384615384;0.461538461538462
Control.SRR15539824;39;40;0.512820512820513;19;20;0.0128205128205128;0.487179487179487
Control.SRR15539824;41;40;0.51219512195122;20;21;0.0121951219512195;0.48780487804878
Control.SRR15539824;39;40;0.461538461538462;21;18;0.0384615384615384;0.461538461538462
Control.SRR15539824;40;40;0.6;16;24;0.1;0.4
Control.SRR15539824;36;40;0.361111111111111;23;13;0.138888888888889;0.361111111111111
Control.SRR15539824;34;40;0.647058823529412;12;22;0.147058823529412;0.352941176470588
Control.SRR15539824;42;40;0.476190476190476;22;20;0.0238095238095238;0.476190476190476
Control.SRR15539824;40;40;0.55;18;22;0.05;0.45
Control.SRR15539824;37;40;0.594594594594595;15;22;0.0945945945945946;0.405405405405405
Control.SRR15539824;35;40;0.457142857142857;19;16;0.0428571428571429;0.457142857142857
Control.SRR15539824;35;40;0.485714285714286;18;17;0.0142857142857143;0.485714285714286
Control.SRR15539824;42;40;0.571428571428571;18;24;0.0714285714285714;0.428571428571429
Control.SRR15539824;44;40;0.545454545454545;20;24;0.0454545454545454;0.454545454545455
Control.SRR15539824;42;40;0.547619047619048;19;23;0.0476190476190477;0.452380952380952
Control.SRR15539824;43;40;0.534883720930233;20;23;0.0348837209302325;0.465116279069767
Control.SRR15539824;37;40;0.567567567567568;16;21;0.0675675675675675;0.432432432432432
Control.SRR15539824;42;40;0.642857142857143;15;27;0.142857142857143;0.357142857142857
Control.SRR15539824;42;40;0.476190476190476;22;20;0.0238095238095238;0.476190476190476
Control.SRR15539824;44;40;0.477272727272727;23;21;0.0227272727272727;0.477272727272727
Control.SRR15539824;34;40;0.411764705882353;20;14;0.0882352941176471;0.411764705882353
Control.SRR15539824;41;40;0.463414634146341;22;19;0.0365853658536585;0.463414634146341
Control.SRR15539824;40;40;0.4;24;16;0.1;0.4
Control.SRR15539824;41;40;0.536585365853659;19;22;0.0365853658536586;0.463414634146341
Control.SRR15539824;41;40;0.390243902439024;25;16;0.109756097560976;0.390243902439024
Control.SRR15539824;37;40;0.405405405405405;22;15;0.0945945945945946;0.405405405405405
Control.SRR15539824;38;40;0.526315789473684;18;20;0.0263157894736842;0.473684210526316
Control.SRR15539824;36;40;0.555555555555556;16;20;0.0555555555555556;0.444444444444444
Control.SRR15539824;35;40;0.542857142857143;16;19;0.0428571428571428;0.457142857142857
Control.SRR15539824;37;40;0.567567567567568;16;21;0.0675675675675675;0.432432432432432
Control.SRR15539824;34;40;0.441176470588235;19;15;0.0588235294117647;0.441176470588235
Control.SRR15539824;42;40;0.571428571428571;18;24;0.0714285714285714;0.428571428571429
Control.SRR15539824;44;40;0.386363636363636;27;17;0.113636363636364;0.386363636363636
Control.SRR15539824;35;40;0.485714285714286;18;17;0.0142857142857143;0.485714285714286
Control.SRR15539824;38;40;0.526315789473684;18;20;0.0263157894736842;0.473684210526316
Control.SRR15539824;35;40;0.571428571428571;15;20;0.0714285714285714;0.428571428571429
Control.SRR15539824;39;40;0.538461538461538;18;21;0.0384615384615384;0.461538461538462
Control.SRR15539824;37;40;0.459459459459459;20;17;0.0405405405405405;0.459459459459459
Control.SRR15539824;37;40;0.567567567567568;16;21;0.0675675675675675;0.432432432432432
Control.SRR15539824;40;40;0.575;17;23;0.075;0.425
Control.SRR15539824;40;40;0.325;27;13;0.175;0.325
Control.SRR15539824;39;40;0.615384615384615;15;24;0.115384615384615;0.384615384615385
Control.SRR15539824;44;40;0.454545454545455;24;20;0.0454545454545455;0.454545454545455
Control.SRR15539824;38;40;0.394736842105263;23;15;0.105263157894737;0.394736842105263
Control.SRR15539824;40;40;0.525;19;21;0.025;0.475
Control.SRR15539824;39;40;0.564102564102564;17;22;0.0641025641025641;0.435897435897436
Control.SRR15539824;38;40;0.5;19;19;0;0.5
Control.SRR15539824;35;40;0.457142857142857;19;16;0.0428571428571429;0.457142857142857
Control.SRR15539824;36;40;0.611111111111111;14;22;0.111111111111111;0.388888888888889
Control.SRR15539824;35;40;0.514285714285714;17;18;0.0142857142857142;0.485714285714286
Control.SRR15539824;42;40;0.452380952380952;23;19;0.0476190476190476;0.452380952380952
Control.SRR15539824;41;40;0.536585365853659;19;22;0.0365853658536586;0.463414634146341
Control.SRR15539824;37;40;0.405405405405405;22;15;0.0945945945945946;0.405405405405405
Control.SRR15539824;43;40;0.441860465116279;24;19;0.0581395348837209;0.441860465116279
Control.SRR15539824;36;40;0.472222222222222;19;17;0.0277777777777778;0.472222222222222
Control.SRR15539824;35;40;0.485714285714286;18;17;0.0142857142857143;0.485714285714286
Control.SRR15539824;37;40;0.432432432432432;21;16;0.0675675675675675;0.432432432432432
Control.SRR15539824;38;40;0.578947368421053;16;22;0.0789473684210527;0.421052631578947
Control.SRR15539824;40;40;0.525;19;21;0.025;0.475
Control.SRR15539824;38;40;0.526315789473684;18;20;0.0263157894736842;0.473684210526316
Control.SRR15539824;36;40;0.416666666666667;21;15;0.0833333333333333;0.416666666666667
Control.SRR15539824;39;40;0.512820512820513;19;20;0.0128205128205128;0.487179487179487
Control.SRR15539824;44;40;0.5;22;22;0;0.5
Control.SRR15539824;37;40;0.540540540540541;17;20;0.0405405405405406;0.459459459459459
Control.SRR15539824;40;40;0.3;28;12;0.2;0.3
Control.SRR15539824;42;40;0.476190476190476;22;20;0.0238095238095238;0.476190476190476
Control.SRR15539824;38;40;0.552631578947368;17;21;0.0526315789473685;0.447368421052632
Control.SRR15539824;40;40;0.55;18;22;0.05;0.45
Control.SRR15539824;40;40;0.45;22;18;0.05;0.45
Control.SRR15539824;36;40;0.361111111111111;23;13;0.138888888888889;0.361111111111111
Control.SRR15539824;37;40;0.567567567567568;16;21;0.0675675675675675;0.432432432432432
Control.SRR15539824;41;40;0.560975609756098;18;23;0.0609756097560976;0.439024390243902
Control.SRR15539824;41;40;0.51219512195122;20;21;0.0121951219512195;0.48780487804878
Control.SRR15539824;34;40;0.470588235294118;18;16;0.0294117647058824;0.470588235294118
Control.SRR15539824;35;40;0.4;21;14;0.1;0.4
Control.SRR15539824;37;40;0.567567567567568;16;21;0.0675675675675675;0.432432432432432
Control.SRR15539824;35;40;0.457142857142857;19;16;0.0428571428571429;0.457142857142857
Control.SRR15539824;40;40;0.375;25;15;0.125;0.375
Control.SRR15539824;37;40;0.486486486486487;19;18;0.0135135135135135;0.486486486486487
Control.SRR15539824;43;40;0.418604651162791;25;18;0.0813953488372093;0.418604651162791
Control.SRR15539824;40;40;0.525;19;21;0.025;0.475
Control.SRR15539824;34;40;0.558823529411765;15;19;0.0588235294117647;0.441176470588235
Control.SRR15539824;38;40;0.552631578947368;17;21;0.0526315789473685;0.447368421052632
Control.SRR15539824;44;40;0.568181818181818;19;25;0.0681818181818182;0.431818181818182
Control.SRR15539824;35;40;0.6;14;21;0.1;0.4
Control.SRR15539824;34;40;0.647058823529412;12;22;0.147058823529412;0.352941176470588
Control.SRR15539824;41;40;0.48780487804878;21;20;0.0121951219512195;0.48780487804878
Control.SRR15539824;41;40;0.51219512195122;20;21;0.0121951219512195;0.48780487804878
Control.SRR15539824;40;40;0.5;20;20;0;0.5
Control.SRR15539824;38;40;0.526315789473684;18;20;0.0263157894736842;0.473684210526316
Control.SRR15539824;38;40;0.473684210526316;20;18;0.0263157894736842;0.473684210526316
Control.SRR15539824;37;40;0.540540540540541;17;20;0.0405405405405406;0.459459459459459
Control.SRR15539824;41;40;0.48780487804878;21;20;0.0121951219512195;0.48780487804878
Control.SRR15539824;35;40;0.371428571428571;22;13;0.128571428571429;0.371428571428571
Control.SRR15539824;41;40;0.585365853658537;17;24;0.0853658536585366;0.414634146341463
Control.SRR15539824;41;40;0.439024390243902;23;18;0.0609756097560976;0.439024390243902
Control.SRR15539824;40;40;0.45;22;18;0.05;0.45
Control.SRR15539824;43;40;0.511627906976744;21;22;0.0116279069767442;0.488372093023256
Control.SRR15539824;39;40;0.358974358974359;25;14;0.141025641025641;0.358974358974359
Control.SRR15539824;41;40;0.609756097560976;16;25;0.109756097560976;0.390243902439024
Control.SRR15539824;39;40;0.461538461538462;21;18;0.0384615384615384;0.461538461538462
Control.SRR15539824;42;40;0.595238095238095;17;25;0.0952380952380952;0.404761904761905
Control.SRR15539824;44;40;0.590909090909091;18;26;0.0909090909090909;0.409090909090909
Control.SRR15539824;44;40;0.545454545454545;20;24;0.0454545454545454;0.454545454545455
Control.SRR15539824;44;40;0.522727272727273;21;23;0.0227272727272727;0.477272727272727
Control.SRR15539824;37;40;0.459459459459459;20;17;0.0405405405405405;0.459459459459459
Control.SRR15539824;43;40;0.674418604651163;14;29;0.174418604651163;0.325581395348837
Control.SRR15539824;39;40;0.41025641025641;23;16;0.0897435897435898;0.41025641025641
Control.SRR15539824;34;40;0.558823529411765;15;19;0.0588235294117647;0.441176470588235
Control.SRR15539824;40;40;0.475;21;19;0.025;0.475
Control.SRR15539824;38;40;0.578947368421053;16;22;0.0789473684210527;0.421052631578947
Control.SRR15539824;39;40;0.512820512820513;19;20;0.0128205128205128;0.487179487179487
Control.SRR15539824;42;40;0.619047619047619;16;26;0.119047619047619;0.380952380952381
Control.SRR15539824;39;40;0.564102564102564;17;22;0.0641025641025641;0.435897435897436
Control.SRR15539824;38;40;0.447368421052632;21;17;0.0526315789473684;0.447368421052632
Control.SRR15539824;35;40;0.542857142857143;16;19;0.0428571428571428;0.457142857142857
Control.SRR15539824;39;40;0.358974358974359;25;14;0.141025641025641;0.358974358974359
Control.SRR15539824;36;40;0.444444444444444;20;16;0.0555555555555556;0.444444444444444
Control.SRR15539824;34;40;0.617647058823529;13;21;0.117647058823529;0.382352941176471
Control.SRR15539824;44;40;0.5;22;22;0;0.5
Control.SRR15539824;41;40;0.439024390243902;23;18;0.0609756097560976;0.439024390243902
Control.SRR15539824;40;40;0.4;24;16;0.1;0.4
Control.SRR15539824;41;40;0.390243902439024;25;16;0.109756097560976;0.390243902439024
Control.SRR15539824;41;40;0.536585365853659;19;22;0.0365853658536586;0.463414634146341
Control.SRR15539824;42;40;0.666666666666667;14;28;0.166666666666667;0.333333333333333
Control.SRR15539824;43;40;0.674418604651163;14;29;0.174418604651163;0.325581395348837
Control.SRR15539824;36;40;0.388888888888889;22;14;0.111111111111111;0.388888888888889
Control.SRR15539824;36;40;0.5;18;18;0;0.5
Control.SRR15539824;42;40;0.547619047619048;19;23;0.0476190476190477;0.452380952380952
Control.SRR15539824;43;40;0.488372093023256;22;21;0.0116279069767442;0.488372093023256
Control.SRR15539824;40;40;0.45;22;18;0.05;0.45
Control.SRR15539824;40;40;0.525;19;21;0.025;0.475
Control.SRR15539824;35;40;0.342857142857143;23;12;0.157142857142857;0.342857142857143
Control.SRR15539824;43;40;0.465116279069767;23;20;0.0348837209302326;0.465116279069767
Control.SRR15539824;42;40;0.476190476190476;22;20;0.0238095238095238;0.476190476190476
Control.SRR15539824;40;40;0.6;16;24;0.1;0.4
Control.SRR15539824;41;40;0.390243902439024;25;16;0.109756097560976;0.390243902439024
Control.SRR15539824;42;40;0.452380952380952;23;19;0.0476190476190476;0.452380952380952
Control.SRR15539824;42;40;0.571428571428571;18;24;0.0714285714285714;0.428571428571429
Control.SRR15539824;39;40;0.487179487179487;20;19;0.0128205128205128;0.487179487179487
Control.SRR15539824;34;40;0.529411764705882;16;18;0.0294117647058824;0.470588235294118
Control.SRR15539824;41;40;0.390243902439024;25;16;0.109756097560976;0.390243902439024
Control.SRR15539824;42;40;0.547619047619048;19;23;0.0476190476190477;0.452380952380952
Control.SRR15539824;43;40;0.465116279069767;23;20;0.0348837209302326;0.465116279069767
Control.SRR15539824;34;40;0.5;17;17;0;0.5
Control.SRR15539824;44;40;0.5;22;22;0;0.5
Control.SRR15539824;35;40;0.485714285714286;18;17;0.0142857142857143;0.485714285714286
Control.SRR15539824;41;40;0.463414634146341;22;19;0.0365853658536585;0.463414634146341
Control.SRR15539824;39;40;0.512820512820513;19;20;0.0128205128205128;0.487179487179487
Control.SRR15539824;34;40;0.470588235294118;18;16;0.0294117647058824;0.470588235294118
Control.SRR15539824;41;40;0.463414634146341;22;19;0.0365853658536585;0.463414634146341
Control.SRR15539824;43;40;0.558139534883721;19;24;0.0581395348837209;0.441860465116279
Control.SRR15539824;34;40;0.588235294117647;14;20;0.0882352941176471;0.411764705882353
Control.SRR15539824;35;40;0.628571428571429;13;22;0.128571428571429;0.371428571428571
Control.SRR15539824;39;40;0.512820512820513;19;20;0.0128205128205128;0.487179487179487
Control.SRR15539824;44;40;0.613636363636364;17;27;0.113636363636364;0.386363636363636
Control.SRR15539824;37;40;0.459459459459459;20;17;0.0405405405405405;0.459459459459459
Control.SRR15539824;37;40;0.405405405405405;22;15;0.0945945945945946;0.405405405405405
Control.SRR15539824;39;40;0.461538461538462;21;18;0.0384615384615384;0.461538461538462
Control.SRR15539824;41;40;0.634146341463415;15;26;0.134146341463415;0.365853658536585
Control.SRR15539824;44;40;0.522727272727273;21;23;0.0227272727272727;0.477272727272727
Control.SRR15539824;44;40;0.5;22;22;0;0.5
Control.SRR15539824;38;40;0.421052631578947;22;16;0.0789473684210527;0.421052631578947
Control.SRR15539824;39;40;0.461538461538462;21;18;0.0384615384615384;0.461538461538462
Control.SRR15539824;44;40;0.477272727272727;23;21;0.0227272727272727;0.477272727272727
Control.SRR15539824;40;40;0.55;18;22;0.05;0.45
Control.SRR15539824;37;40;0.405405405405405;22;15;0.0945945945945946;0.405405405405405
Control.SRR15539824;38;40;0.526315789473684;18;20;0.0263157894736842;0.473684210526316
Control.SRR15539824;37;40;0.486486486486487;19;18;0.0135135135135135;0.486486486486487
Control.SRR15539824;38;40;0.447368421052632;21;17;0.0526315789473684;0.447368421052632
Control.SRR15539824;35;40;0.6;14;21;0.1;0.4
Control.SRR15539824;37;40;0.594594594594595;15;22;0.0945945945945946;0.405405405405405
Control.SRR15539824;36;40;0.583333333333333;15;21;0.0833333333333334;0.416666666666667
Control.SRR15539824;38;40;0.421052631578947;22;16;0.0789473684210527;0.421052631578947
Control.SRR15539824;43;40;0.581395348837209;18;25;0.0813953488372093;0.418604651162791
Control.SRR15539824;42;40;0.5;21;21;0;0.5
Control.SRR15539824;36;40;0.333333333333333;24;12;0.166666666666667;0.333333333333333
Control.SRR15539824;40;40;0.425;23;17;0.075;0.425
Control.SRR15539824;40;40;0.525;19;21;0.025;0.475
Control.SRR15539824;43;40;0.511627906976744;21;22;0.0116279069767442;0.488372093023256
Control.SRR15539824;39;40;0.615384615384615;15;24;0.115384615384615;0.384615384615385
Control.SRR15539824;40;40;0.575;17;23;0.075;0.425
Control.SRR15539824;40;40;0.475;21;19;0.025;0.475
Control.SRR15539824;36;40;0.305555555555556;25;11;0.194444444444444;0.305555555555556
Control.SRR15539824;35;40;0.514285714285714;17;18;0.0142857142857142;0.485714285714286
Control.SRR15539824;36;40;0.638888888888889;13;23;0.138888888888889;0.361111111111111
Control.SRR15539824;37;40;0.621621621621622;14;23;0.121621621621622;0.378378378378378
Control.SRR15539824;42;40;0.5;21;21;0;0.5
Control.SRR15539824;37;40;0.486486486486487;19;18;0.0135135135135135;0.486486486486487
Control.SRR15539824;37;40;0.567567567567568;16;21;0.0675675675675675;0.432432432432432
Control.SRR15539824;40;40;0.475;21;19;0.025;0.475
Control.SRR15539824;39;40;0.487179487179487;20;19;0.0128205128205128;0.487179487179487
Control.SRR15539824;40;40;0.55;18;22;0.05;0.45
Control.SRR15539824;44;40;0.477272727272727;23;21;0.0227272727272727;0.477272727272727
Control.SRR15539824;41;40;0.317073170731707;28;13;0.182926829268293;0.317073170731707
Control.SRR15539824;37;40;0.459459459459459;20;17;0.0405405405405405;0.459459459459459
Control.SRR15539824;43;40;0.441860465116279;24;19;0.0581395348837209;0.441860465116279
Control.SRR15539824;42;40;0.404761904761905;25;17;0.0952380952380952;0.404761904761905
Control.SRR15539824;39;40;0.435897435897436;22;17;0.0641025641025641;0.435897435897436
Control.SRR15539824;44;40;0.681818181818182;14;30;0.181818181818182;0.318181818181818
Control.SRR15539824;38;40;0.447368421052632;21;17;0.0526315789473684;0.447368421052632
Control.SRR15539824;41;40;0.536585365853659;19;22;0.0365853658536586;0.463414634146341
Control.SRR15539824;40;40;0.625;15;25;0.125;0.375
Control.SRR15539824;41;40;0.51219512195122;20;21;0.0121951219512195;0.48780487804878
Control.SRR15539824;43;40;0.627906976744186;16;27;0.127906976744186;0.372093023255814
Control.SRR15539824;39;40;0.538461538461538;18;21;0.0384615384615384;0.461538461538462
Control.SRR15539824;37;40;0.486486486486487;19;18;0.0135135135135135;0.486486486486487
Control.SRR15539824;39;40;0.564102564102564;17;22;0.0641025641025641;0.435897435897436
Control.SRR15539824;39;40;0.538461538461538;18;21;0.0384615384615384;0.461538461538462
Control.SRR15539824;35;40;0.571428571428571;15;20;0.0714285714285714;0.428571428571429
Control.SRR15539824;44;40;0.545454545454545;20;24;0.0454545454545454;0.454545454545455
Control.SRR15539824;40;40;0.55;18;22;0.05;0.45
Control.SRR15539824;44;40;0.477272727272727;23;21;0.0227272727272727;0.477272727272727
Control.SRR15539824;44;40;0.568181818181818;19;25;0.0681818181818182;0.431818181818182
Control.SRR15539824;40;40;0.525;19;21;0.025;0.475
Control.SRR15539824;40;40;0.425;23;17;0.075;0.425
Control.SRR15539824;39;40;0.384615384615385;24;15;0.115384615384615;0.384615384615385
Control.SRR15539824;41;40;0.560975609756098;18;23;0.0609756097560976;0.439024390243902
Control.SRR15539824;41;40;0.560975609756098;18;23;0.0609756097560976;0.439024390243902
Control.SRR15539824;38;40;0.526315789473684;18;20;0.0263157894736842;0.473684210526316
Control.SRR15539824;36;40;0.5;18;18;0;0.5
Control.SRR15539824;37;40;0.486486486486487;19;18;0.0135135135135135;0.486486486486487
Control.SRR15539824;39;40;0.41025641025641;23;16;0.0897435897435898;0.41025641025641
Control.SRR15539824;41;40;0.536585365853659;19;22;0.0365853658536586;0.463414634146341
Control.SRR15539824;42;40;0.571428571428571;18;24;0.0714285714285714;0.428571428571429
Control.SRR15539824;40;40;0.525;19;21;0.025;0.475
Control.SRR15539824;37;40;0.432432432432432;21;16;0.0675675675675675;0.432432432432432
Control.SRR15539824;34;40;0.5;17;17;0;0.5
Control.SRR15539824;41;40;0.439024390243902;23;18;0.0609756097560976;0.439024390243902
Control.SRR15539824;35;40;0.514285714285714;17;18;0.0142857142857142;0.485714285714286
Control.SRR15539824;35;40;0.571428571428571;15;20;0.0714285714285714;0.428571428571429
Control.SRR15539824;35;40;0.457142857142857;19;16;0.0428571428571429;0.457142857142857
Control.SRR15539824;37;40;0.405405405405405;22;15;0.0945945945945946;0.405405405405405
Control.SRR15539824;38;40;0.421052631578947;22;16;0.0789473684210527;0.421052631578947
Control.SRR15539824;43;40;0.465116279069767;23;20;0.0348837209302326;0.465116279069767
Control.SRR15539824;40;40;0.45;22;18;0.05;0.45
Control.SRR15539824;35;40;0.628571428571429;13;22;0.128571428571429;0.371428571428571
Control.SRR15539824;35;40;0.4;21;14;0.1;0.4
Control.SRR15539824;36;40;0.5;18;18;0;0.5
Control.SRR15539824;38;40;0.578947368421053;16;22;0.0789473684210527;0.421052631578947
Control.SRR15539824;38;40;0.447368421052632;21;17;0.0526315789473684;0.447368421052632
Control.SRR15539824;43;40;0.534883720930233;20;23;0.0348837209302325;0.465116279069767
Control.SRR15539824;39;40;0.512820512820513;19;20;0.0128205128205128;0.487179487179487
Control.SRR15539824;38;40;0.526315789473684;18;20;0.0263157894736842;0.473684210526316
Control.SRR15539824;37;40;0.486486486486487;19;18;0.0135135135135135;0.486486486486487
Control.SRR15539824;38;40;0.578947368421053;16;22;0.0789473684210527;0.421052631578947
Control.SRR15539824;40;40;0.425;23;17;0.075;0.425
Control.SRR15539824;36;40;0.472222222222222;19;17;0.0277777777777778;0.472222222222222
Control.SRR15539824;38;40;0.473684210526316;20;18;0.0263157894736842;0.473684210526316
Control.SRR15539824;37;40;0.513513513513513;18;19;0.0135135135135135;0.486486486486487
Control.SRR15539824;43;40;0.372093023255814;27;16;0.127906976744186;0.372093023255814
Control.SRR15539824;41;40;0.439024390243902;23;18;0.0609756097560976;0.439024390243902
Control.SRR15539824;44;40;0.659090909090909;15;29;0.159090909090909;0.340909090909091
Control.SRR15539824;37;40;0.351351351351351;24;13;0.148648648648649;0.351351351351351
Control.SRR15539824;44;40;0.590909090909091;18;26;0.0909090909090909;0.409090909090909
Control.SRR15539824;43;40;0.511627906976744;21;22;0.0116279069767442;0.488372093023256
Control.SRR15539824;44;40;0.636363636363636;16;28;0.136363636363636;0.363636363636364
Control.SRR15539824;39;40;0.564102564102564;17;22;0.0641025641025641;0.435897435897436
Control.SRR15539824;41;40;0.609756097560976;16;25;0.109756097560976;0.390243902439024
Control.SRR15539824;42;40;0.452380952380952;23;19;0.0476190476190476;0.452380952380952
Control.SRR15539824;43;40;0.558139534883721;19;24;0.0581395348837209;0.441860465116279
Control.SRR15539824;39;40;0.538461538461538;18;21;0.0384615384615384;0.461538461538462
Control.SRR15539824;40;40;0.4;24;16;0.1;0.4
Control.SRR15539824;43;40;0.604651162790698;17;26;0.104651162790698;0.395348837209302
Control.SRR15539824;38;40;0.473684210526316;20;18;0.0263157894736842;0.473684210526316
Control.SRR15539824;35;40;0.542857142857143;16;19;0.0428571428571428;0.457142857142857
Control.SRR15539824;42;40;0.452380952380952;23;19;0.0476190476190476;0.452380952380952
Control.SRR15539824;37;40;0.432432432432432;21;16;0.0675675675675675;0.432432432432432
Control.SRR15539824;35;40;0.485714285714286;18;17;0.0142857142857143;0.485714285714286
Control.SRR15539824;42;40;0.404761904761905;25;17;0.0952380952380952;0.404761904761905
Control.SRR15539824;42;40;0.476190476190476;22;20;0.0238095238095238;0.476190476190476
Control.SRR15539824;38;40;0.526315789473684;18;20;0.0263157894736842;0.473684210526316
Control.SRR15539824;43;40;0.534883720930233;20;23;0.0348837209302325;0.465116279069767
Control.SRR15539824;41;40;0.292682926829268;29;12;0.207317073170732;0.292682926829268
Control.SRR15539824;43;40;0.604651162790698;17;26;0.104651162790698;0.395348837209302
Control.SRR15539824;39;40;0.461538461538462;21;18;0.0384615384615384;0.461538461538462
Control.SRR15539824;44;40;0.409090909090909;26;18;0.0909090909090909;0.409090909090909
Control.SRR15539824;40;40;0.4;24;16;0.1;0.4
Control.SRR15539824;40;40;0.4;24;16;0.1;0.4
Control.SRR15539824;39;40;0.615384615384615;15;24;0.115384615384615;0.384615384615385
Control.SRR15539824;40;40;0.475;21;19;0.025;0.475
Control.SRR15539824;44;40;0.636363636363636;16;28;0.136363636363636;0.363636363636364
Control.SRR15539824;37;40;0.513513513513513;18;19;0.0135135135135135;0.486486486486487
Control.SRR15539824;38;40;0.578947368421053;16;22;0.0789473684210527;0.421052631578947
Control.SRR15539824;41;40;0.48780487804878;21;20;0.0121951219512195;0.48780487804878
Control.SRR15539824;39;40;0.564102564102564;17;22;0.0641025641025641;0.435897435897436
Control.SRR15539824;34;40;0.529411764705882;16;18;0.0294117647058824;0.470588235294118
Control.SRR15539824;35;40;0.6;14;21;0.1;0.4
Control.SRR15539824;35;40;0.514285714285714;17;18;0.0142857142857142;0.485714285714286
Control.SRR15539824;42;40;0.333333333333333;28;14;0.166666666666667;0.333333333333333
Control.SRR15539824;38;40;0.578947368421053;16;22;0.0789473684210527;0.421052631578947
Control.SRR15539824;43;40;0.511627906976744;21;22;0.0116279069767442;0.488372093023256
Control.SRR15539824;39;40;0.615384615384615;15;24;0.115384615384615;0.384615384615385
Control.SRR15539824;44;40;0.477272727272727;23;21;0.0227272727272727;0.477272727272727
Control.SRR15539824;41;40;0.609756097560976;16;25;0.109756097560976;0.390243902439024
Control.SRR15539824;43;40;0.488372093023256;22;21;0.0116279069767442;0.488372093023256
Control.SRR15539824;38;40;0.368421052631579;24;14;0.131578947368421;0.368421052631579
Control.SRR15539824;44;40;0.636363636363636;16;28;0.136363636363636;0.363636363636364
Control.SRR15539824;41;40;0.390243902439024;25;16;0.109756097560976;0.390243902439024
Control.SRR15539824;42;40;0.547619047619048;19;23;0.0476190476190477;0.452380952380952
Control.SRR15539824;42;40;0.428571428571429;24;18;0.0714285714285715;0.428571428571429
Control.SRR15539824;41;40;0.48780487804878;21;20;0.0121951219512195;0.48780487804878
Control.SRR15539824;41;40;0.609756097560976;16;25;0.109756097560976;0.390243902439024
Control.SRR15539824;34;40;0.5;17;17;0;0.5
Control.SRR15539824;39;40;0.487179487179487;20;19;0.0128205128205128;0.487179487179487
Control.SRR15539824;38;40;0.447368421052632;21;17;0.0526315789473684;0.447368421052632
Control.SRR15539824;41;40;0.536585365853659;19;22;0.0365853658536586;0.463414634146341
Control.SRR15539824;44;40;0.545454545454545;20;24;0.0454545454545454;0.454545454545455
Control.SRR15539824;39;40;0.58974358974359;16;23;0.0897435897435898;0.41025641025641
Control.SRR15539824;38;40;0.421052631578947;22;16;0.0789473684210527;0.421052631578947
Control.SRR15539824;34;40;0.529411764705882;16;18;0.0294117647058824;0.470588235294118
Control.SRR15539824;43;40;0.511627906976744;21;22;0.0116279069767442;0.488372093023256
Control.SRR15539824;44;40;0.5;22;22;0;0.5
Control.SRR15539824;36;40;0.527777777777778;17;19;0.0277777777777778;0.472222222222222
Control.SRR15539824;44;40;0.386363636363636;27;17;0.113636363636364;0.386363636363636
Control.SRR15539824;39;40;0.512820512820513;19;20;0.0128205128205128;0.487179487179487
Control.SRR15539824;37;40;0.594594594594595;15;22;0.0945945945945946;0.405405405405405
Control.SRR15539824;37;40;0.648648648648649;13;24;0.148648648648649;0.351351351351351
Control.SRR15539824;37;40;0.459459459459459;20;17;0.0405405405405405;0.459459459459459
Control.SRR15539824;38;40;0.631578947368421;14;24;0.131578947368421;0.368421052631579
Control.SRR15539824;34;40;0.470588235294118;18;16;0.0294117647058824;0.470588235294118
Control.SRR15539824;40;40;0.425;23;17;0.075;0.425
Control.SRR15539824;44;40;0.477272727272727;23;21;0.0227272727272727;0.477272727272727
Control.SRR15539824;43;40;0.674418604651163;14;29;0.174418604651163;0.325581395348837
Control.SRR15539824;42;40;0.714285714285714;12;30;0.214285714285714;0.285714285714286
Control.SRR15539824;44;40;0.477272727272727;23;21;0.0227272727272727;0.477272727272727
Control.SRR15539824;44;40;0.477272727272727;23;21;0.0227272727272727;0.477272727272727
Control.SRR15539824;42;40;0.476190476190476;22;20;0.0238095238095238;0.476190476190476
Control.SRR15539824;41;40;0.463414634146341;22;19;0.0365853658536585;0.463414634146341
Control.SRR15539824;42;40;0.333333333333333;28;14;0.166666666666667;0.333333333333333
Control.SRR15539824;40;40;0.5;20;20;0;0.5
Control.SRR15539824;37;40;0.594594594594595;15;22;0.0945945945945946;0.405405405405405
Control.SRR15539824;41;40;0.536585365853659;19;22;0.0365853658536586;0.463414634146341
Control.SRR15539824;41;40;0.585365853658537;17;24;0.0853658536585366;0.414634146341463
Control.SRR15539824;41;40;0.536585365853659;19;22;0.0365853658536586;0.463414634146341
Control.SRR15539824;40;40;0.625;15;25;0.125;0.375
Control.SRR15539824;40;40;0.55;18;22;0.05;0.45
Control.SRR15539824;39;40;0.487179487179487;20;19;0.0128205128205128;0.487179487179487
Control.SRR15539824;40;40;0.45;22;18;0.05;0.45
Control.SRR15539824;38;40;0.368421052631579;24;14;0.131578947368421;0.368421052631579
Control.SRR15539824;38;40;0.578947368421053;16;22;0.0789473684210527;0.421052631578947
Control.SRR15539824;35;40;0.514285714285714;17;18;0.0142857142857142;0.485714285714286
Control.SRR15539824;41;40;0.463414634146341;22;19;0.0365853658536585;0.463414634146341
Control.SRR15539824;41;40;0.390243902439024;25;16;0.109756097560976;0.390243902439024
Control.SRR15539824;42;40;0.452380952380952;23;19;0.0476190476190476;0.452380952380952
Control.SRR15539824;38;40;0.5;19;19;0;0.5
Control.SRR15539824;40;40;0.6;16;24;0.1;0.4
Control.SRR15539824;37;40;0.567567567567568;16;21;0.0675675675675675;0.432432432432432
Control.SRR15539824;35;40;0.314285714285714;24;11;0.185714285714286;0.314285714285714
Control.SRR15539824;36;40;0.583333333333333;15;21;0.0833333333333334;0.416666666666667
Control.SRR15539824;35;40;0.628571428571429;13;22;0.128571428571429;0.371428571428571
Control.SRR15539824;44;40;0.522727272727273;21;23;0.0227272727272727;0.477272727272727
Control.SRR15539824;39;40;0.564102564102564;17;22;0.0641025641025641;0.435897435897436
Control.SRR15539824;34;40;0.411764705882353;20;14;0.0882352941176471;0.411764705882353
Control.SRR15539824;41;40;0.585365853658537;17;24;0.0853658536585366;0.414634146341463
Control.SRR15539824;41;40;0.560975609756098;18;23;0.0609756097560976;0.439024390243902
Control.SRR15539824;43;40;0.534883720930233;20;23;0.0348837209302325;0.465116279069767
Control.SRR15539824;43;40;0.627906976744186;16;27;0.127906976744186;0.372093023255814
Control.SRR15539824;43;40;0.488372093023256;22;21;0.0116279069767442;0.488372093023256
Control.SRR15539824;39;40;0.487179487179487;20;19;0.0128205128205128;0.487179487179487
Control.SRR15539824;38;40;0.421052631578947;22;16;0.0789473684210527;0.421052631578947
Control.SRR15539824;43;40;0.441860465116279;24;19;0.0581395348837209;0.441860465116279
Control.SRR15539824;39;40;0.564102564102564;17;22;0.0641025641025641;0.435897435897436
Control.SRR15539824;40;40;0.425;23;17;0.075;0.425
Control.SRR15539824;35;40;0.514285714285714;17;18;0.0142857142857142;0.485714285714286
Control.SRR15539824;40;40;0.55;18;22;0.05;0.45
Control.SRR15539824;38;40;0.394736842105263;23;15;0.105263157894737;0.394736842105263
Control.SRR15539824;40;40;0.425;23;17;0.075;0.425
Control.SRR15539824;40;40;0.475;21;19;0.025;0.475
Control.SRR15539824;43;40;0.465116279069767;23;20;0.0348837209302326;0.465116279069767
Control.SRR15539824;34;40;0.647058823529412;12;22;0.147058823529412;0.352941176470588
Control.SRR15539824;38;40;0.473684210526316;20;18;0.0263157894736842;0.473684210526316
Control.SRR15539824;34;40;0.647058823529412;12;22;0.147058823529412;0.352941176470588
Control.SRR15539824;38;40;0.657894736842105;13;25;0.157894736842105;0.342105263157895
Control.SRR15539824;44;40;0.5;22;22;0;0.5
Control.SRR15539824;41;40;0.585365853658537;17;24;0.0853658536585366;0.414634146341463
Control.SRR15539824;40;40;0.35;26;14;0.15;0.35
Control.SRR15539824;39;40;0.538461538461538;18;21;0.0384615384615384;0.461538461538462
Control.SRR15539824;36;40;0.472222222222222;19;17;0.0277777777777778;0.472222222222222
Control.SRR15539824;42;40;0.476190476190476;22;20;0.0238095238095238;0.476190476190476
Control.SRR15539824;36;40;0.444444444444444;20;16;0.0555555555555556;0.444444444444444
Control.SRR15539824;41;40;0.48780487804878;21;20;0.0121951219512195;0.48780487804878
Control.SRR15539824;40;40;0.6;16;24;0.1;0.4
Control.SRR15539824;41;40;0.585365853658537;17;24;0.0853658536585366;0.414634146341463
Control.SRR15539824;35;40;0.485714285714286;18;17;0.0142857142857143;0.485714285714286
Control.SRR15539824;36;40;0.583333333333333;15;21;0.0833333333333334;0.416666666666667
Control.SRR15539824;41;40;0.439024390243902;23;18;0.0609756097560976;0.439024390243902
Control.SRR15539824;34;40;0.411764705882353;20;14;0.0882352941176471;0.411764705882353
Control.SRR15539824;36;40;0.388888888888889;22;14;0.111111111111111;0.388888888888889
Control.SRR15539824;40;40;0.45;22;18;0.05;0.45
Control.SRR15539824;41;40;0.463414634146341;22;19;0.0365853658536585;0.463414634146341
Control.SRR15539824;41;40;0.463414634146341;22;19;0.0365853658536585;0.463414634146341
Control.SRR15539824;42;40;0.619047619047619;16;26;0.119047619047619;0.380952380952381
Control.SRR15539824;43;40;0.534883720930233;20;23;0.0348837209302325;0.465116279069767
Control.SRR15539824;41;40;0.536585365853659;19;22;0.0365853658536586;0.463414634146341
Control.SRR15539824;44;40;0.477272727272727;23;21;0.0227272727272727;0.477272727272727
Control.SRR15539824;41;40;0.560975609756098;18;23;0.0609756097560976;0.439024390243902
Control.SRR15539824;43;40;0.511627906976744;21;22;0.0116279069767442;0.488372093023256
Control.SRR15539824;41;40;0.414634146341463;24;17;0.0853658536585366;0.414634146341463
Control.SRR15539824;38;40;0.552631578947368;17;21;0.0526315789473685;0.447368421052632
Control.SRR15539824;38;40;0.473684210526316;20;18;0.0263157894736842;0.473684210526316
Control.SRR15539824;41;40;0.439024390243902;23;18;0.0609756097560976;0.439024390243902
Control.SRR15539824;43;40;0.465116279069767;23;20;0.0348837209302326;0.465116279069767
Control.SRR15539824;43;40;0.558139534883721;19;24;0.0581395348837209;0.441860465116279
Control.SRR15539824;37;40;0.567567567567568;16;21;0.0675675675675675;0.432432432432432
Control.SRR15539824;41;40;0.439024390243902;23;18;0.0609756097560976;0.439024390243902
Control.SRR15539824;38;40;0.447368421052632;21;17;0.0526315789473684;0.447368421052632
Control.SRR15539824;43;40;0.581395348837209;18;25;0.0813953488372093;0.418604651162791
Control.SRR15539824;44;40;0.5;22;22;0;0.5
Control.SRR15539824;42;40;0.476190476190476;22;20;0.0238095238095238;0.476190476190476
Control.SRR15539824;40;40;0.475;21;19;0.025;0.475
Control.SRR15539824;36;40;0.611111111111111;14;22;0.111111111111111;0.388888888888889
Control.SRR15539824;37;40;0.513513513513513;18;19;0.0135135135135135;0.486486486486487
Control.SRR15539824;44;40;0.545454545454545;20;24;0.0454545454545454;0.454545454545455
Control.SRR15539824;35;40;0.457142857142857;19;16;0.0428571428571429;0.457142857142857
Control.SRR15539824;38;40;0.526315789473684;18;20;0.0263157894736842;0.473684210526316
Control.SRR15539824;41;40;0.51219512195122;20;21;0.0121951219512195;0.48780487804878
Control.SRR15539824;36;40;0.472222222222222;19;17;0.0277777777777778;0.472222222222222
Control.SRR15539824;34;40;0.441176470588235;19;15;0.0588235294117647;0.441176470588235
Control.SRR15539824;43;40;0.418604651162791;25;18;0.0813953488372093;0.418604651162791
Control.SRR15539824;41;40;0.536585365853659;19;22;0.0365853658536586;0.463414634146341
Control.SRR15539824;37;40;0.378378378378378;23;14;0.121621621621622;0.378378378378378
Control.SRR15539824;44;40;0.431818181818182;25;19;0.0681818181818182;0.431818181818182
Control.SRR15539824;39;40;0.435897435897436;22;17;0.0641025641025641;0.435897435897436
Control.SRR15539824;42;40;0.452380952380952;23;19;0.0476190476190476;0.452380952380952
Control.SRR15539824;39;40;0.487179487179487;20;19;0.0128205128205128;0.487179487179487
Control.SRR15539824;40;40;0.6;16;24;0.1;0.4
Control.SRR15539824;40;40;0.425;23;17;0.075;0.425
Control.SRR15539824;42;40;0.404761904761905;25;17;0.0952380952380952;0.404761904761905
Control.SRR15539824;43;40;0.627906976744186;16;27;0.127906976744186;0.372093023255814
Control.SRR15539824;39;40;0.564102564102564;17;22;0.0641025641025641;0.435897435897436
Control.SRR15539824;38;40;0.447368421052632;21;17;0.0526315789473684;0.447368421052632
Control.SRR15539824;44;40;0.522727272727273;21;23;0.0227272727272727;0.477272727272727
Control.SRR15539824;40;40;0.525;19;21;0.025;0.475
Control.SRR15539824;41;40;0.414634146341463;24;17;0.0853658536585366;0.414634146341463
Control.SRR15539824;42;40;0.476190476190476;22;20;0.0238095238095238;0.476190476190476
Control.SRR15539824;43;40;0.627906976744186;16;27;0.127906976744186;0.372093023255814
Control.SRR15539824;40;40;0.575;17;23;0.075;0.425
Control.SRR15539824;44;40;0.477272727272727;23;21;0.0227272727272727;0.477272727272727
Control.SRR15539824;35;40;0.6;14;21;0.1;0.4
Control.SRR15539824;40;40;0.55;18;22;0.05;0.45
Control.SRR15539824;41;40;0.536585365853659;19;22;0.0365853658536586;0.463414634146341
Control.SRR15539824;38;40;0.394736842105263;23;15;0.105263157894737;0.394736842105263
Control.SRR15539824;38;40;0.605263157894737;15;23;0.105263157894737;0.394736842105263
Control.SRR15539824;39;40;0.487179487179487;20;19;0.0128205128205128;0.487179487179487
Control.SRR15539824;43;40;0.604651162790698;17;26;0.104651162790698;0.395348837209302
Control.SRR15539824;41;40;0.390243902439024;25;16;0.109756097560976;0.390243902439024
Control.SRR15539824;38;40;0.578947368421053;16;22;0.0789473684210527;0.421052631578947
Control.SRR15539824;37;40;0.567567567567568;16;21;0.0675675675675675;0.432432432432432
Control.SRR15539824;44;40;0.5;22;22;0;0.5
Control.SRR15539824;40;40;0.375;25;15;0.125;0.375
Control.SRR15539824;43;40;0.627906976744186;16;27;0.127906976744186;0.372093023255814
Control.SRR15539824;36;40;0.472222222222222;19;17;0.0277777777777778;0.472222222222222
Control.SRR15539824;41;40;0.414634146341463;24;17;0.0853658536585366;0.414634146341463
Control.SRR15539824;34;40;0.529411764705882;16;18;0.0294117647058824;0.470588235294118
Control.SRR15539824;39;40;0.461538461538462;21;18;0.0384615384615384;0.461538461538462
Control.SRR15539824;37;40;0.675675675675676;12;25;0.175675675675676;0.324324324324324
Control.SRR15539824;43;40;0.418604651162791;25;18;0.0813953488372093;0.418604651162791
Control.SRR15539824;37;40;0.567567567567568;16;21;0.0675675675675675;0.432432432432432
Control.SRR15539824;36;40;0.361111111111111;23;13;0.138888888888889;0.361111111111111
Control.SRR15539824;38;40;0.421052631578947;22;16;0.0789473684210527;0.421052631578947
Control.SRR15539824;39;40;0.384615384615385;24;15;0.115384615384615;0.384615384615385
Control.SRR15539824;34;40;0.676470588235294;11;23;0.176470588235294;0.323529411764706
Control.SRR15539824;41;40;0.585365853658537;17;24;0.0853658536585366;0.414634146341463
Control.SRR15539824;42;40;0.523809523809524;20;22;0.0238095238095238;0.476190476190476
Control.SRR15539824;42;40;0.452380952380952;23;19;0.0476190476190476;0.452380952380952
Control.SRR15539824;41;40;0.414634146341463;24;17;0.0853658536585366;0.414634146341463
Control.SRR15539824;38;40;0.578947368421053;16;22;0.0789473684210527;0.421052631578947
Control.SRR15539824;41;40;0.634146341463415;15;26;0.134146341463415;0.365853658536585
Control.SRR15539824;37;40;0.459459459459459;20;17;0.0405405405405405;0.459459459459459
Control.SRR15539824;39;40;0.41025641025641;23;16;0.0897435897435898;0.41025641025641
Control.SRR15539824;42;40;0.571428571428571;18;24;0.0714285714285714;0.428571428571429
Control.SRR15539824;39;40;0.435897435897436;22;17;0.0641025641025641;0.435897435897436
Control.SRR15539824;35;40;0.428571428571429;20;15;0.0714285714285715;0.428571428571429
Control.SRR15539824;35;40;0.485714285714286;18;17;0.0142857142857143;0.485714285714286
Control.SRR15539824;36;40;0.555555555555556;16;20;0.0555555555555556;0.444444444444444
Control.SRR15539824;36;40;0.444444444444444;20;16;0.0555555555555556;0.444444444444444
Control.SRR15539824;35;40;0.342857142857143;23;12;0.157142857142857;0.342857142857143
Control.SRR15539824;40;40;0.45;22;18;0.05;0.45
Control.SRR15539824;42;40;0.547619047619048;19;23;0.0476190476190477;0.452380952380952
Control.SRR15539824;40;40;0.45;22;18;0.05;0.45
Control.SRR15539824;36;40;0.527777777777778;17;19;0.0277777777777778;0.472222222222222
Control.SRR15539824;41;40;0.390243902439024;25;16;0.109756097560976;0.390243902439024
Control.SRR15539824;44;40;0.454545454545455;24;20;0.0454545454545455;0.454545454545455
Control.SRR15539824;42;40;0.619047619047619;16;26;0.119047619047619;0.380952380952381
Control.SRR15539824;34;40;0.617647058823529;13;21;0.117647058823529;0.382352941176471
Control.SRR15539824;38;40;0.578947368421053;16;22;0.0789473684210527;0.421052631578947
Control.SRR15539824;39;40;0.435897435897436;22;17;0.0641025641025641;0.435897435897436
Control.SRR15539824;44;40;0.340909090909091;29;15;0.159090909090909;0.340909090909091
Control.SRR15539824;39;40;0.384615384615385;24;15;0.115384615384615;0.384615384615385
Control.SRR15539824;41;40;0.609756097560976;16;25;0.109756097560976;0.390243902439024
Control.SRR15539824;40;40;0.6;16;24;0.1;0.4
Control.SRR15539824;41;40;0.390243902439024;25;16;0.109756097560976;0.390243902439024
Control.SRR15539824;43;40;0.627906976744186;16;27;0.127906976744186;0.372093023255814
Control.SRR15539824;42;40;0.476190476190476;22;20;0.0238095238095238;0.476190476190476
Control.SRR15539824;37;40;0.540540540540541;17;20;0.0405405405405406;0.459459459459459
Control.SRR15539824;38;40;0.421052631578947;22;16;0.0789473684210527;0.421052631578947
Control.SRR15539824;34;40;0.470588235294118;18;16;0.0294117647058824;0.470588235294118
Control.SRR15539824;44;40;0.613636363636364;17;27;0.113636363636364;0.386363636363636
Control.SRR15539824;40;40;0.6;16;24;0.1;0.4
Control.SRR15539824;40;40;0.55;18;22;0.05;0.45
Control.SRR15539824;35;40;0.6;14;21;0.1;0.4
Control.SRR15539824;43;40;0.581395348837209;18;25;0.0813953488372093;0.418604651162791
Control.SRR15539824;35;40;0.485714285714286;18;17;0.0142857142857143;0.485714285714286
Control.SRR15539824;37;40;0.513513513513513;18;19;0.0135135135135135;0.486486486486487
Control.SRR15539824;41;40;0.560975609756098;18;23;0.0609756097560976;0.439024390243902
Control.SRR15539824;41;40;0.48780487804878;21;20;0.0121951219512195;0.48780487804878
Control.SRR15539824;37;40;0.486486486486487;19;18;0.0135135135135135;0.486486486486487
Control.SRR15539824;40;40;0.6;16;24;0.1;0.4
Control.SRR15539824;42;40;0.523809523809524;20;22;0.0238095238095238;0.476190476190476
Control.SRR15539824;41;40;0.560975609756098;18;23;0.0609756097560976;0.439024390243902
Control.SRR15539824;36;40;0.388888888888889;22;14;0.111111111111111;0.388888888888889
Control.SRR15539824;41;40;0.317073170731707;28;13;0.182926829268293;0.317073170731707
Control.SRR15539824;34;40;0.529411764705882;16;18;0.0294117647058824;0.470588235294118
Control.SRR15539824;42;40;0.547619047619048;19;23;0.0476190476190477;0.452380952380952
Control.SRR15539824;41;40;0.48780487804878;21;20;0.0121951219512195;0.48780487804878
Control.SRR15539824;42;40;0.452380952380952;23;19;0.0476190476190476;0.452380952380952
Control.SRR15539824;42;40;0.452380952380952;23;19;0.0476190476190476;0.452380952380952
Control.SRR15539824;37;40;0.459459459459459;20;17;0.0405405405405405;0.459459459459459
Control.SRR15539824;35;40;0.6;14;21;0.1;0.4
Control.SRR15539824;43;40;0.511627906976744;21;22;0.0116279069767442;0.488372093023256
Control.SRR15539824;42;40;0.547619047619048;19;23;0.0476190476190477;0.452380952380952
Control.SRR15539824;41;40;0.439024390243902;23;18;0.0609756097560976;0.439024390243902
Control.SRR15539824;39;40;0.358974358974359;25;14;0.141025641025641;0.358974358974359
Control.SRR15539824;41;40;0.390243902439024;25;16;0.109756097560976;0.390243902439024
Control.SRR15539824;43;40;0.441860465116279;24;19;0.0581395348837209;0.441860465116279
Control.SRR15539824;34;40;0.529411764705882;16;18;0.0294117647058824;0.470588235294118
Control.SRR15539824;38;40;0.5;19;19;0;0.5
Control.SRR15539824;43;40;0.604651162790698;17;26;0.104651162790698;0.395348837209302
Control.SRR15539824;44;40;0.454545454545455;24;20;0.0454545454545455;0.454545454545455
Control.SRR15539824;44;40;0.522727272727273;21;23;0.0227272727272727;0.477272727272727
Control.SRR15539824;41;40;0.536585365853659;19;22;0.0365853658536586;0.463414634146341
Control.SRR15539824;44;40;0.431818181818182;25;19;0.0681818181818182;0.431818181818182
Control.SRR15539824;38;40;0.342105263157895;25;13;0.157894736842105;0.342105263157895
Control.SRR15539824;36;40;0.527777777777778;17;19;0.0277777777777778;0.472222222222222
Control.SRR15539824;40;40;0.475;21;19;0.025;0.475
Control.SRR15539824;36;40;0.75;9;27;0.25;0.25
Control.SRR15539824;34;40;0.647058823529412;12;22;0.147058823529412;0.352941176470588
Control.SRR15539824;38;40;0.578947368421053;16;22;0.0789473684210527;0.421052631578947
Control.SRR15539824;34;40;0.441176470588235;19;15;0.0588235294117647;0.441176470588235
Control.SRR15539824;39;40;0.538461538461538;18;21;0.0384615384615384;0.461538461538462
Control.SRR15539824;43;40;0.488372093023256;22;21;0.0116279069767442;0.488372093023256
Control.SRR15539824;34;40;0.558823529411765;15;19;0.0588235294117647;0.441176470588235
Control.SRR15539824;34;40;0.676470588235294;11;23;0.176470588235294;0.323529411764706
Control.SRR15539824;38;40;0.447368421052632;21;17;0.0526315789473684;0.447368421052632
Control.SRR15539824;41;40;0.51219512195122;20;21;0.0121951219512195;0.48780487804878
Control.SRR15539824;39;40;0.538461538461538;18;21;0.0384615384615384;0.461538461538462
Control.SRR15539824;40;40;0.625;15;25;0.125;0.375
Control.SRR15539824;42;40;0.5;21;21;0;0.5
Control.SRR15539824;41;40;0.463414634146341;22;19;0.0365853658536585;0.463414634146341
Control.SRR15539824;42;40;0.5;21;21;0;0.5
Control.SRR15539824;41;40;0.609756097560976;16;25;0.109756097560976;0.390243902439024
Control.SRR15539824;41;40;0.585365853658537;17;24;0.0853658536585366;0.414634146341463
Control.SRR15539824;39;40;0.538461538461538;18;21;0.0384615384615384;0.461538461538462
Control.SRR15539824;36;40;0.555555555555556;16;20;0.0555555555555556;0.444444444444444
Control.SRR15539824;42;40;0.547619047619048;19;23;0.0476190476190477;0.452380952380952
Control.SRR15539824;37;40;0.567567567567568;16;21;0.0675675675675675;0.432432432432432
Control.SRR15539824;42;40;0.595238095238095;17;25;0.0952380952380952;0.404761904761905
Control.SRR15539824;39;40;0.538461538461538;18;21;0.0384615384615384;0.461538461538462
Control.SRR15539824;39;40;0.333333333333333;26;13;0.166666666666667;0.333333333333333
Control.SRR15539824;36;40;0.388888888888889;22;14;0.111111111111111;0.388888888888889
Control.SRR15539824;39;40;0.615384615384615;15;24;0.115384615384615;0.384615384615385
Control.SRR15539824;37;40;0.432432432432432;21;16;0.0675675675675675;0.432432432432432
Control.SRR15539824;35;40;0.542857142857143;16;19;0.0428571428571428;0.457142857142857
Control.SRR15539824;37;40;0.540540540540541;17;20;0.0405405405405406;0.459459459459459
Control.SRR15539824;39;40;0.435897435897436;22;17;0.0641025641025641;0.435897435897436
Control.SRR15539824;39;40;0.512820512820513;19;20;0.0128205128205128;0.487179487179487
Control.SRR15539824;40;40;0.6;16;24;0.1;0.4
Control.SRR15539824;39;40;0.487179487179487;20;19;0.0128205128205128;0.487179487179487
Control.SRR15539824;40;40;0.575;17;23;0.075;0.425
Control.SRR15539824;34;40;0.470588235294118;18;16;0.0294117647058824;0.470588235294118
Control.SRR15539824;39;40;0.564102564102564;17;22;0.0641025641025641;0.435897435897436
Control.SRR15539824;37;40;0.459459459459459;20;17;0.0405405405405405;0.459459459459459
Control.SRR15539824;38;40;0.368421052631579;24;14;0.131578947368421;0.368421052631579
Control.SRR15539824;42;40;0.476190476190476;22;20;0.0238095238095238;0.476190476190476
Control.SRR15539824;40;40;0.425;23;17;0.075;0.425
Control.SRR15539824;40;40;0.6;16;24;0.1;0.4
Control.SRR15539824;40;40;0.425;23;17;0.075;0.425
Control.SRR15539824;42;40;0.547619047619048;19;23;0.0476190476190477;0.452380952380952
Control.SRR15539824;39;40;0.384615384615385;24;15;0.115384615384615;0.384615384615385
Control.SRR15539824;40;40;0.525;19;21;0.025;0.475
Control.SRR15539824;44;40;0.522727272727273;21;23;0.0227272727272727;0.477272727272727
Control.SRR15539824;34;40;0.617647058823529;13;21;0.117647058823529;0.382352941176471
Control.SRR15539824;35;40;0.542857142857143;16;19;0.0428571428571428;0.457142857142857
Control.SRR15539824;39;40;0.461538461538462;21;18;0.0384615384615384;0.461538461538462
Control.SRR15539824;43;40;0.534883720930233;20;23;0.0348837209302325;0.465116279069767
Control.SRR15539824;36;40;0.611111111111111;14;22;0.111111111111111;0.388888888888889
Control.SRR15539824;34;40;0.529411764705882;16;18;0.0294117647058824;0.470588235294118
Control.SRR15539824;37;40;0.459459459459459;20;17;0.0405405405405405;0.459459459459459
Control.SRR15539824;38;40;0.315789473684211;26;12;0.184210526315789;0.315789473684211
Control.SRR15539824;35;40;0.6;14;21;0.1;0.4
Control.SRR15539824;36;40;0.611111111111111;14;22;0.111111111111111;0.388888888888889
Control.SRR15539824;39;40;0.384615384615385;24;15;0.115384615384615;0.384615384615385
Control.SRR15539824;40;40;0.5;20;20;0;0.5
Control.SRR15539824;42;40;0.523809523809524;20;22;0.0238095238095238;0.476190476190476
Control.SRR15539824;40;40;0.45;22;18;0.05;0.45
Control.SRR15539824;37;40;0.486486486486487;19;18;0.0135135135135135;0.486486486486487
Control.SRR15539824;37;40;0.486486486486487;19;18;0.0135135135135135;0.486486486486487
Control.SRR15539824;41;40;0.439024390243902;23;18;0.0609756097560976;0.439024390243902
Control.SRR15539824;35;40;0.485714285714286;18;17;0.0142857142857143;0.485714285714286
Control.SRR15539824;44;40;0.431818181818182;25;19;0.0681818181818182;0.431818181818182
Control.SRR15539824;37;40;0.486486486486487;19;18;0.0135135135135135;0.486486486486487
Control.SRR15539824;43;40;0.581395348837209;18;25;0.0813953488372093;0.418604651162791
Control.SRR15539824;44;40;0.5;22;22;0;0.5
Control.SRR15539824;43;40;0.465116279069767;23;20;0.0348837209302326;0.465116279069767
Control.SRR15539824;37;40;0.513513513513513;18;19;0.0135135135135135;0.486486486486487
Control.SRR15539824;35;40;0.514285714285714;17;18;0.0142857142857142;0.485714285714286
Control.SRR15539824;38;40;0.447368421052632;21;17;0.0526315789473684;0.447368421052632
Control.SRR15539824;38;40;0.473684210526316;20;18;0.0263157894736842;0.473684210526316
Control.SRR15539824;42;40;0.5;21;21;0;0.5
Control.SRR15539824;37;40;0.486486486486487;19;18;0.0135135135135135;0.486486486486487
Control.SRR15539824;39;40;0.461538461538462;21;18;0.0384615384615384;0.461538461538462
Control.SRR15539824;43;40;0.627906976744186;16;27;0.127906976744186;0.372093023255814
Control.SRR15539824;40;40;0.55;18;22;0.05;0.45
Control.SRR15539824;39;40;0.384615384615385;24;15;0.115384615384615;0.384615384615385
Control.SRR15539824;40;40;0.6;16;24;0.1;0.4
Control.SRR15539824;37;40;0.540540540540541;17;20;0.0405405405405406;0.459459459459459
Control.SRR15539824;36;40;0.527777777777778;17;19;0.0277777777777778;0.472222222222222
Control.SRR15539824;35;40;0.485714285714286;18;17;0.0142857142857143;0.485714285714286
Control.SRR15539824;43;40;0.511627906976744;21;22;0.0116279069767442;0.488372093023256
Control.SRR15539824;35;40;0.514285714285714;17;18;0.0142857142857142;0.485714285714286
Control.SRR15539824;37;40;0.486486486486487;19;18;0.0135135135135135;0.486486486486487
Control.SRR15539824;39;40;0.538461538461538;18;21;0.0384615384615384;0.461538461538462
Control.SRR15539824;41;40;0.48780487804878;21;20;0.0121951219512195;0.48780487804878
Control.SRR15539824;41;40;0.560975609756098;18;23;0.0609756097560976;0.439024390243902
Control.SRR15539824;42;40;0.5;21;21;0;0.5
Control.SRR15539824;44;40;0.477272727272727;23;21;0.0227272727272727;0.477272727272727
Control.SRR15539824;37;40;0.459459459459459;20;17;0.0405405405405405;0.459459459459459
Control.SRR15539824;40;40;0.55;18;22;0.05;0.45
Control.SRR15539824;36;40;0.388888888888889;22;14;0.111111111111111;0.388888888888889
Control.SRR15539824;39;40;0.487179487179487;20;19;0.0128205128205128;0.487179487179487
Control.SRR15539824;41;40;0.51219512195122;20;21;0.0121951219512195;0.48780487804878
Control.SRR15539824;41;40;0.536585365853659;19;22;0.0365853658536586;0.463414634146341
Control.SRR15539824;38;40;0.447368421052632;21;17;0.0526315789473684;0.447368421052632
Control.SRR15539824;42;40;0.380952380952381;26;16;0.119047619047619;0.380952380952381
Control.SRR15539824;35;40;0.571428571428571;15;20;0.0714285714285714;0.428571428571429
Control.SRR15539824;44;40;0.477272727272727;23;21;0.0227272727272727;0.477272727272727
Control.SRR15539824;35;40;0.342857142857143;23;12;0.157142857142857;0.342857142857143
Control.SRR15539824;35;40;0.571428571428571;15;20;0.0714285714285714;0.428571428571429
Control.SRR15539824;34;40;0.5;17;17;0;0.5
Control.SRR15539824;39;40;0.487179487179487;20;19;0.0128205128205128;0.487179487179487
Control.SRR15539824;37;40;0.459459459459459;20;17;0.0405405405405405;0.459459459459459
Control.SRR15539824;38;40;0.526315789473684;18;20;0.0263157894736842;0.473684210526316
Control.SRR15539824;38;40;0.526315789473684;18;20;0.0263157894736842;0.473684210526316
Control.SRR15539824;38;40;0.394736842105263;23;15;0.105263157894737;0.394736842105263
Control.SRR15539824;42;40;0.380952380952381;26;16;0.119047619047619;0.380952380952381
Control.SRR15539824;39;40;0.333333333333333;26;13;0.166666666666667;0.333333333333333
Control.SRR15539824;43;40;0.465116279069767;23;20;0.0348837209302326;0.465116279069767
Control.SRR15539824;39;40;0.358974358974359;25;14;0.141025641025641;0.358974358974359
Control.SRR15539824;40;40;0.525;19;21;0.025;0.475
Control.SRR15539824;39;40;0.615384615384615;15;24;0.115384615384615;0.384615384615385
Control.SRR15539824;41;40;0.585365853658537;17;24;0.0853658536585366;0.414634146341463
Control.SRR15539824;39;40;0.717948717948718;11;28;0.217948717948718;0.282051282051282
Control.SRR15539824;37;40;0.594594594594595;15;22;0.0945945945945946;0.405405405405405
Control.SRR15539824;38;40;0.578947368421053;16;22;0.0789473684210527;0.421052631578947
Control.SRR15539824;37;40;0.432432432432432;21;16;0.0675675675675675;0.432432432432432
Control.SRR15539824;43;40;0.534883720930233;20;23;0.0348837209302325;0.465116279069767
Control.SRR15539824;43;40;0.534883720930233;20;23;0.0348837209302325;0.465116279069767
Control.SRR15539824;40;40;0.525;19;21;0.025;0.475
Control.SRR15539824;39;40;0.512820512820513;19;20;0.0128205128205128;0.487179487179487
Control.SRR15539824;36;40;0.666666666666667;12;24;0.166666666666667;0.333333333333333
Control.SRR15539824;44;40;0.522727272727273;21;23;0.0227272727272727;0.477272727272727
Control.SRR15539824;34;40;0.382352941176471;21;13;0.117647058823529;0.382352941176471
Control.SRR15539824;38;40;0.421052631578947;22;16;0.0789473684210527;0.421052631578947
Control.SRR15539824;44;40;0.454545454545455;24;20;0.0454545454545455;0.454545454545455
Control.SRR15539824;36;40;0.472222222222222;19;17;0.0277777777777778;0.472222222222222
Control.SRR15539824;37;40;0.378378378378378;23;14;0.121621621621622;0.378378378378378
Control.SRR15539824;34;40;0.294117647058824;24;10;0.205882352941176;0.294117647058824
Control.SRR15539824;35;40;0.485714285714286;18;17;0.0142857142857143;0.485714285714286
Control.SRR15539824;43;40;0.534883720930233;20;23;0.0348837209302325;0.465116279069767
Control.SRR15539824;37;40;0.513513513513513;18;19;0.0135135135135135;0.486486486486487
Control.SRR15539824;37;40;0.621621621621622;14;23;0.121621621621622;0.378378378378378
Control.SRR15539824;44;40;0.681818181818182;14;30;0.181818181818182;0.318181818181818
Control.SRR15539824;35;40;0.342857142857143;23;12;0.157142857142857;0.342857142857143
Control.SRR15539824;34;40;0.382352941176471;21;13;0.117647058823529;0.382352941176471
Control.SRR15539824;35;40;0.457142857142857;19;16;0.0428571428571429;0.457142857142857
Control.SRR15539824;41;40;0.317073170731707;28;13;0.182926829268293;0.317073170731707
Control.SRR15539824;44;40;0.568181818181818;19;25;0.0681818181818182;0.431818181818182
Control.SRR15539824;39;40;0.487179487179487;20;19;0.0128205128205128;0.487179487179487
Control.SRR15539824;43;40;0.511627906976744;21;22;0.0116279069767442;0.488372093023256
Control.SRR15539824;35;40;0.542857142857143;16;19;0.0428571428571428;0.457142857142857
Control.SRR15539824;42;40;0.523809523809524;20;22;0.0238095238095238;0.476190476190476
Control.SRR15539824;35;40;0.542857142857143;16;19;0.0428571428571428;0.457142857142857
Control.SRR15539824;34;40;0.529411764705882;16;18;0.0294117647058824;0.470588235294118
Control.SRR15539824;43;40;0.348837209302326;28;15;0.151162790697674;0.348837209302326
Control.SRR15539824;37;40;0.432432432432432;21;16;0.0675675675675675;0.432432432432432
Control.SRR15539824;40;40;0.45;22;18;0.05;0.45
Control.SRR15539824;44;40;0.590909090909091;18;26;0.0909090909090909;0.409090909090909
Control.SRR15539824;35;40;0.514285714285714;17;18;0.0142857142857142;0.485714285714286
Control.SRR15539824;38;40;0.394736842105263;23;15;0.105263157894737;0.394736842105263
Control.SRR15539824;36;40;0.555555555555556;16;20;0.0555555555555556;0.444444444444444
Control.SRR15539824;39;40;0.538461538461538;18;21;0.0384615384615384;0.461538461538462
Control.SRR15539824;44;40;0.659090909090909;15;29;0.159090909090909;0.340909090909091
Control.SRR15539824;36;40;0.555555555555556;16;20;0.0555555555555556;0.444444444444444
Control.SRR15539824;37;40;0.459459459459459;20;17;0.0405405405405405;0.459459459459459
Control.SRR15539824;39;40;0.487179487179487;20;19;0.0128205128205128;0.487179487179487
Control.SRR15539824;38;40;0.605263157894737;15;23;0.105263157894737;0.394736842105263
Control.SRR15539824;39;40;0.435897435897436;22;17;0.0641025641025641;0.435897435897436
Control.SRR15539824;42;40;0.452380952380952;23;19;0.0476190476190476;0.452380952380952
Control.SRR15539824;40;40;0.4;24;16;0.1;0.4
Control.SRR15539824;43;40;0.488372093023256;22;21;0.0116279069767442;0.488372093023256
Control.SRR15539824;42;40;0.452380952380952;23;19;0.0476190476190476;0.452380952380952
Control.SRR15539824;41;40;0.48780487804878;21;20;0.0121951219512195;0.48780487804878
Control.SRR15539824;34;40;0.735294117647059;9;25;0.235294117647059;0.264705882352941
Control.SRR15539824;36;40;0.472222222222222;19;17;0.0277777777777778;0.472222222222222
Control.SRR15539824;40;40;0.5;20;20;0;0.5
Control.SRR15539824;36;40;0.388888888888889;22;14;0.111111111111111;0.388888888888889
Control.SRR15539824;34;40;0.470588235294118;18;16;0.0294117647058824;0.470588235294118
Control.SRR15539824;34;40;0.558823529411765;15;19;0.0588235294117647;0.441176470588235
Control.SRR15539824;34;40;0.441176470588235;19;15;0.0588235294117647;0.441176470588235
Control.SRR15539824;42;40;0.5;21;21;0;0.5
Control.SRR15539824;40;40;0.6;16;24;0.1;0.4
Control.SRR15539824;44;40;0.409090909090909;26;18;0.0909090909090909;0.409090909090909
Control.SRR15539824;42;40;0.404761904761905;25;17;0.0952380952380952;0.404761904761905
Control.SRR15539824;37;40;0.621621621621622;14;23;0.121621621621622;0.378378378378378
Control.SRR15539824;42;40;0.619047619047619;16;26;0.119047619047619;0.380952380952381
Control.SRR15539824;40;40;0.375;25;15;0.125;0.375
Control.SRR15539824;35;40;0.428571428571429;20;15;0.0714285714285715;0.428571428571429
Control.SRR15539824;34;40;0.5;17;17;0;0.5
Control.SRR15539824;40;40;0.5;20;20;0;0.5
Control.SRR15539824;39;40;0.41025641025641;23;16;0.0897435897435898;0.41025641025641
Control.SRR15539824;36;40;0.472222222222222;19;17;0.0277777777777778;0.472222222222222
Control.SRR15539824;39;40;0.41025641025641;23;16;0.0897435897435898;0.41025641025641
Control.SRR15539824;40;40;0.525;19;21;0.025;0.475
Control.SRR15539824;34;40;0.588235294117647;14;20;0.0882352941176471;0.411764705882353
Control.SRR15539824;37;40;0.594594594594595;15;22;0.0945945945945946;0.405405405405405
Control.SRR15539824;44;40;0.454545454545455;24;20;0.0454545454545455;0.454545454545455
Control.SRR15539824;37;40;0.567567567567568;16;21;0.0675675675675675;0.432432432432432
Control.SRR15539824;40;40;0.5;20;20;0;0.5
Control.SRR15539824;37;40;0.621621621621622;14;23;0.121621621621622;0.378378378378378
Control.SRR15539824;43;40;0.488372093023256;22;21;0.0116279069767442;0.488372093023256
Control.SRR15539824;38;40;0.342105263157895;25;13;0.157894736842105;0.342105263157895
Control.SRR15539824;35;40;0.628571428571429;13;22;0.128571428571429;0.371428571428571
Control.SRR15539824;36;40;0.416666666666667;21;15;0.0833333333333333;0.416666666666667
Control.SRR15539824;40;40;0.425;23;17;0.075;0.425
Control.SRR15539824;40;40;0.525;19;21;0.025;0.475
Control.SRR15539824;43;40;0.441860465116279;24;19;0.0581395348837209;0.441860465116279
Control.SRR15539824;36;40;0.555555555555556;16;20;0.0555555555555556;0.444444444444444
Control.SRR15539824;35;40;0.542857142857143;16;19;0.0428571428571428;0.457142857142857
Control.SRR15539824;36;40;0.388888888888889;22;14;0.111111111111111;0.388888888888889
Control.SRR15539824;37;40;0.432432432432432;21;16;0.0675675675675675;0.432432432432432
Control.SRR15539824;36;40;0.416666666666667;21;15;0.0833333333333333;0.416666666666667
Control.SRR15539824;41;40;0.48780487804878;21;20;0.0121951219512195;0.48780487804878
Control.SRR15539824;39;40;0.564102564102564;17;22;0.0641025641025641;0.435897435897436
Control.SRR15539824;41;40;0.585365853658537;17;24;0.0853658536585366;0.414634146341463
Control.SRR15539824;42;40;0.619047619047619;16;26;0.119047619047619;0.380952380952381
Control.SRR15539824;42;40;0.452380952380952;23;19;0.0476190476190476;0.452380952380952
Control.SRR15539824;35;40;0.428571428571429;20;15;0.0714285714285715;0.428571428571429
Control.SRR15539824;39;40;0.435897435897436;22;17;0.0641025641025641;0.435897435897436
Control.SRR15539824;38;40;0.447368421052632;21;17;0.0526315789473684;0.447368421052632
Control.SRR15539824;35;40;0.542857142857143;16;19;0.0428571428571428;0.457142857142857
Control.SRR15539824;38;40;0.631578947368421;14;24;0.131578947368421;0.368421052631579
Control.SRR15539824;44;40;0.477272727272727;23;21;0.0227272727272727;0.477272727272727
Control.SRR15539824;43;40;0.581395348837209;18;25;0.0813953488372093;0.418604651162791
Control.SRR15539824;42;40;0.5;21;21;0;0.5
Control.SRR15539824;41;40;0.341463414634146;27;14;0.158536585365854;0.341463414634146
Control.SRR15539824;36;40;0.583333333333333;15;21;0.0833333333333334;0.416666666666667
Control.SRR15539824;40;40;0.425;23;17;0.075;0.425
Control.SRR15539824;41;40;0.536585365853659;19;22;0.0365853658536586;0.463414634146341
Control.SRR15539824;43;40;0.465116279069767;23;20;0.0348837209302326;0.465116279069767
Control.SRR15539824;43;40;0.488372093023256;22;21;0.0116279069767442;0.488372093023256
Control.SRR15539824;34;40;0.352941176470588;22;12;0.147058823529412;0.352941176470588
Control.SRR15539824;36;40;0.305555555555556;25;11;0.194444444444444;0.305555555555556
Control.SRR15539824;39;40;0.41025641025641;23;16;0.0897435897435898;0.41025641025641
Control.SRR15539824;43;40;0.395348837209302;26;17;0.104651162790698;0.395348837209302
Control.SRR15539824;35;40;0.542857142857143;16;19;0.0428571428571428;0.457142857142857
Control.SRR15539824;44;40;0.477272727272727;23;21;0.0227272727272727;0.477272727272727
Control.SRR15539824;40;40;0.375;25;15;0.125;0.375
Control.SRR15539824;36;40;0.638888888888889;13;23;0.138888888888889;0.361111111111111
Control.SRR15539824;38;40;0.710526315789474;11;27;0.210526315789474;0.289473684210526
Control.SRR15539824;39;40;0.538461538461538;18;21;0.0384615384615384;0.461538461538462
Control.SRR15539824;43;40;0.511627906976744;21;22;0.0116279069767442;0.488372093023256
Control.SRR15539824;42;40;0.404761904761905;25;17;0.0952380952380952;0.404761904761905
Control.SRR15539824;37;40;0.459459459459459;20;17;0.0405405405405405;0.459459459459459
Control.SRR15539824;41;40;0.609756097560976;16;25;0.109756097560976;0.390243902439024
Control.SRR15539824;43;40;0.441860465116279;24;19;0.0581395348837209;0.441860465116279
Control.SRR15539824;43;40;0.558139534883721;19;24;0.0581395348837209;0.441860465116279
Control.SRR15539824;34;40;0.470588235294118;18;16;0.0294117647058824;0.470588235294118
Control.SRR15539824;40;40;0.425;23;17;0.075;0.425
Control.SRR15539824;43;40;0.441860465116279;24;19;0.0581395348837209;0.441860465116279
Control.SRR15539824;39;40;0.487179487179487;20;19;0.0128205128205128;0.487179487179487
Control.SRR15539824;38;40;0.447368421052632;21;17;0.0526315789473684;0.447368421052632
Control.SRR15539824;42;40;0.452380952380952;23;19;0.0476190476190476;0.452380952380952
Control.SRR15539824;43;40;0.441860465116279;24;19;0.0581395348837209;0.441860465116279
Control.SRR15539824;42;40;0.547619047619048;19;23;0.0476190476190477;0.452380952380952
Control.SRR15539824;37;40;0.594594594594595;15;22;0.0945945945945946;0.405405405405405
Control.SRR15539824;42;40;0.5;21;21;0;0.5
Control.SRR15539824;38;40;0.5;19;19;0;0.5
Control.SRR15539824;39;40;0.58974358974359;16;23;0.0897435897435898;0.41025641025641
Control.SRR15539824;43;40;0.488372093023256;22;21;0.0116279069767442;0.488372093023256
Control.SRR15539824;43;40;0.558139534883721;19;24;0.0581395348837209;0.441860465116279
Control.SRR15539824;44;40;0.431818181818182;25;19;0.0681818181818182;0.431818181818182
Control.SRR15539824;41;40;0.317073170731707;28;13;0.182926829268293;0.317073170731707
Control.SRR15539824;38;40;0.578947368421053;16;22;0.0789473684210527;0.421052631578947
Control.SRR15539824;37;40;0.594594594594595;15;22;0.0945945945945946;0.405405405405405
Control.SRR15539824;36;40;0.5;18;18;0;0.5
Control.SRR15539824;36;40;0.388888888888889;22;14;0.111111111111111;0.388888888888889
Control.SRR15539824;38;40;0.526315789473684;18;20;0.0263157894736842;0.473684210526316
Control.SRR15539824;42;40;0.523809523809524;20;22;0.0238095238095238;0.476190476190476
Control.SRR15539824;37;40;0.513513513513513;18;19;0.0135135135135135;0.486486486486487
Control.SRR15539824;38;40;0.394736842105263;23;15;0.105263157894737;0.394736842105263
Control.SRR15539824;34;40;0.382352941176471;21;13;0.117647058823529;0.382352941176471
Control.SRR15539824;42;40;0.547619047619048;19;23;0.0476190476190477;0.452380952380952
Control.SRR15539824;38;40;0.5;19;19;0;0.5
Control.SRR15539824;42;40;0.666666666666667;14;28;0.166666666666667;0.333333333333333
Control.SRR15539824;39;40;0.41025641025641;23;16;0.0897435897435898;0.41025641025641
Control.SRR15539824;34;40;0.411764705882353;20;14;0.0882352941176471;0.411764705882353
Control.SRR15539824;41;40;0.51219512195122;20;21;0.0121951219512195;0.48780487804878
Control.SRR15539824;43;40;0.465116279069767;23;20;0.0348837209302326;0.465116279069767
Control.SRR15539824;40;40;0.35;26;14;0.15;0.35
Control.SRR15539824;42;40;0.523809523809524;20;22;0.0238095238095238;0.476190476190476
Control.SRR15539824;41;40;0.536585365853659;19;22;0.0365853658536586;0.463414634146341
Control.SRR15539824;44;40;0.454545454545455;24;20;0.0454545454545455;0.454545454545455
Control.SRR15539824;42;40;0.476190476190476;22;20;0.0238095238095238;0.476190476190476
Control.SRR15539824;34;40;0.617647058823529;13;21;0.117647058823529;0.382352941176471
Control.SRR15539824;34;40;0.5;17;17;0;0.5
Control.SRR15539824;39;40;0.307692307692308;27;12;0.192307692307692;0.307692307692308
Control.SRR15539824;43;40;0.418604651162791;25;18;0.0813953488372093;0.418604651162791
Control.SRR15539824;44;40;0.363636363636364;28;16;0.136363636363636;0.363636363636364
Control.SRR15539824;39;40;0.512820512820513;19;20;0.0128205128205128;0.487179487179487
Control.SRR15539824;37;40;0.378378378378378;23;14;0.121621621621622;0.378378378378378
Control.SRR15539824;37;40;0.567567567567568;16;21;0.0675675675675675;0.432432432432432
Control.SRR15539824;35;40;0.514285714285714;17;18;0.0142857142857142;0.485714285714286
Control.SRR15539824;35;40;0.485714285714286;18;17;0.0142857142857143;0.485714285714286
Control.SRR15539824;35;40;0.485714285714286;18;17;0.0142857142857143;0.485714285714286
Control.SRR15539824;40;40;0.5;20;20;0;0.5
Control.SRR15539824;36;40;0.555555555555556;16;20;0.0555555555555556;0.444444444444444
Control.SRR15539824;41;40;0.536585365853659;19;22;0.0365853658536586;0.463414634146341
Control.SRR15539824;36;40;0.416666666666667;21;15;0.0833333333333333;0.416666666666667
Control.SRR15539824;42;40;0.404761904761905;25;17;0.0952380952380952;0.404761904761905
Control.SRR15539824;39;40;0.384615384615385;24;15;0.115384615384615;0.384615384615385
Control.SRR15539824;44;40;0.545454545454545;20;24;0.0454545454545454;0.454545454545455
Control.SRR15539824;43;40;0.441860465116279;24;19;0.0581395348837209;0.441860465116279
Control.SRR15539824;42;40;0.571428571428571;18;24;0.0714285714285714;0.428571428571429
Control.SRR15539824;36;40;0.638888888888889;13;23;0.138888888888889;0.361111111111111
Control.SRR15539824;37;40;0.432432432432432;21;16;0.0675675675675675;0.432432432432432
Control.SRR15539824;37;40;0.432432432432432;21;16;0.0675675675675675;0.432432432432432
Control.SRR15539824;39;40;0.512820512820513;19;20;0.0128205128205128;0.487179487179487
Control.SRR15539824;37;40;0.486486486486487;19;18;0.0135135135135135;0.486486486486487
Control.SRR15539824;38;40;0.447368421052632;21;17;0.0526315789473684;0.447368421052632
Control.SRR15539824;41;40;0.390243902439024;25;16;0.109756097560976;0.390243902439024
Control.SRR15539824;42;40;0.428571428571429;24;18;0.0714285714285715;0.428571428571429
Control.SRR15539824;39;40;0.487179487179487;20;19;0.0128205128205128;0.487179487179487
Control.SRR15539824;40;40;0.4;24;16;0.1;0.4
Control.SRR15539824;41;40;0.536585365853659;19;22;0.0365853658536586;0.463414634146341
Control.SRR15539824;44;40;0.681818181818182;14;30;0.181818181818182;0.318181818181818
Control.SRR15539824;39;40;0.461538461538462;21;18;0.0384615384615384;0.461538461538462
Control.SRR15539824;39;40;0.461538461538462;21;18;0.0384615384615384;0.461538461538462
Control.SRR15539824;37;40;0.459459459459459;20;17;0.0405405405405405;0.459459459459459
Control.SRR15539824;43;40;0.418604651162791;25;18;0.0813953488372093;0.418604651162791
Control.SRR15539824;40;40;0.375;25;15;0.125;0.375
Control.SRR15539824;34;40;0.5;17;17;0;0.5
Control.SRR15539824;42;40;0.452380952380952;23;19;0.0476190476190476;0.452380952380952
Control.SRR15539824;40;40;0.575;17;23;0.075;0.425
Control.SRR15539824;42;40;0.523809523809524;20;22;0.0238095238095238;0.476190476190476
Control.SRR15539824;43;40;0.627906976744186;16;27;0.127906976744186;0.372093023255814
Control.SRR15539824;37;40;0.486486486486487;19;18;0.0135135135135135;0.486486486486487
Control.SRR15539824;38;40;0.578947368421053;16;22;0.0789473684210527;0.421052631578947
Control.SRR15539824;42;40;0.476190476190476;22;20;0.0238095238095238;0.476190476190476
Control.SRR15539824;35;40;0.571428571428571;15;20;0.0714285714285714;0.428571428571429
Control.SRR15539824;41;40;0.560975609756098;18;23;0.0609756097560976;0.439024390243902
Control.SRR15539824;40;40;0.525;19;21;0.025;0.475
Control.SRR15539824;42;40;0.5;21;21;0;0.5
Control.SRR15539824;40;40;0.5;20;20;0;0.5
Control.SRR15539824;37;40;0.324324324324324;25;12;0.175675675675676;0.324324324324324
Control.SRR15539824;42;40;0.666666666666667;14;28;0.166666666666667;0.333333333333333
Control.SRR15539824;44;40;0.5;22;22;0;0.5
Control.SRR15539824;40;40;0.45;22;18;0.05;0.45
Control.SRR15539824;41;40;0.439024390243902;23;18;0.0609756097560976;0.439024390243902
Control.SRR15539824;35;40;0.285714285714286;25;10;0.214285714285714;0.285714285714286
Control.SRR15539824;39;40;0.461538461538462;21;18;0.0384615384615384;0.461538461538462
Control.SRR15539824;41;40;0.51219512195122;20;21;0.0121951219512195;0.48780487804878
Control.SRR15539824;44;40;0.409090909090909;26;18;0.0909090909090909;0.409090909090909
Control.SRR15539824;42;40;0.642857142857143;15;27;0.142857142857143;0.357142857142857
Control.SRR15539824;40;40;0.4;24;16;0.1;0.4
Control.SRR15539824;40;40;0.325;27;13;0.175;0.325
Control.SRR15539824;41;40;0.585365853658537;17;24;0.0853658536585366;0.414634146341463
Control.SRR15539824;40;40;0.375;25;15;0.125;0.375
Control.SRR15539824;36;40;0.444444444444444;20;16;0.0555555555555556;0.444444444444444
Control.SRR15539824;40;40;0.35;26;14;0.15;0.35
Control.SRR15539824;44;40;0.568181818181818;19;25;0.0681818181818182;0.431818181818182
Control.SRR15539824;38;40;0.421052631578947;22;16;0.0789473684210527;0.421052631578947
Control.SRR15539824;38;40;0.473684210526316;20;18;0.0263157894736842;0.473684210526316
Control.SRR15539824;37;40;0.378378378378378;23;14;0.121621621621622;0.378378378378378
Control.SRR15539824;35;40;0.514285714285714;17;18;0.0142857142857142;0.485714285714286
Control.SRR15539824;39;40;0.512820512820513;19;20;0.0128205128205128;0.487179487179487
Control.SRR15539824;36;40;0.527777777777778;17;19;0.0277777777777778;0.472222222222222
Control.SRR15539824;44;40;0.522727272727273;21;23;0.0227272727272727;0.477272727272727
Control.SRR15539824;36;40;0.611111111111111;14;22;0.111111111111111;0.388888888888889
Control.SRR15539824;40;40;0.3;28;12;0.2;0.3
Control.SRR15539824;43;40;0.534883720930233;20;23;0.0348837209302325;0.465116279069767
Control.SRR15539824;36;40;0.361111111111111;23;13;0.138888888888889;0.361111111111111
Control.SRR15539824;44;40;0.568181818181818;19;25;0.0681818181818182;0.431818181818182
Control.SRR15539824;40;40;0.475;21;19;0.025;0.475
Control.SRR15539824;36;40;0.416666666666667;21;15;0.0833333333333333;0.416666666666667
Control.SRR15539824;43;40;0.372093023255814;27;16;0.127906976744186;0.372093023255814
Control.SRR15539824;41;40;0.51219512195122;20;21;0.0121951219512195;0.48780487804878
Control.SRR15539824;42;40;0.5;21;21;0;0.5
Control.SRR15539824;38;40;0.5;19;19;0;0.5
Control.SRR15539824;43;40;0.395348837209302;26;17;0.104651162790698;0.395348837209302
Control.SRR15539824;34;40;0.441176470588235;19;15;0.0588235294117647;0.441176470588235
Control.SRR15539824;41;40;0.536585365853659;19;22;0.0365853658536586;0.463414634146341
Control.SRR15539824;34;40;0.529411764705882;16;18;0.0294117647058824;0.470588235294118
Control.SRR15539824;38;40;0.526315789473684;18;20;0.0263157894736842;0.473684210526316
Control.SRR15539824;41;40;0.390243902439024;25;16;0.109756097560976;0.390243902439024
Control.SRR15539824;40;40;0.4;24;16;0.1;0.4
Control.SRR15539824;38;40;0.631578947368421;14;24;0.131578947368421;0.368421052631579
Control.SRR15539824;35;40;0.371428571428571;22;13;0.128571428571429;0.371428571428571
Control.SRR15539824;40;40;0.65;14;26;0.15;0.35
Control.SRR15539824;39;40;0.58974358974359;16;23;0.0897435897435898;0.41025641025641
Control.SRR15539824;36;40;0.5;18;18;0;0.5
Control.SRR15539824;36;40;0.611111111111111;14;22;0.111111111111111;0.388888888888889
Control.SRR15539824;36;40;0.583333333333333;15;21;0.0833333333333334;0.416666666666667
Control.SRR15539824;40;40;0.475;21;19;0.025;0.475
Control.SRR15539824;42;40;0.5;21;21;0;0.5
Control.SRR15539824;36;40;0.444444444444444;20;16;0.0555555555555556;0.444444444444444
Control.SRR15539824;43;40;0.441860465116279;24;19;0.0581395348837209;0.441860465116279
Control.SRR15539824;41;40;0.536585365853659;19;22;0.0365853658536586;0.463414634146341
Control.SRR15539824;37;40;0.594594594594595;15;22;0.0945945945945946;0.405405405405405
Control.SRR15539824;40;40;0.5;20;20;0;0.5
Control.SRR15539824;42;40;0.404761904761905;25;17;0.0952380952380952;0.404761904761905
Control.SRR15539824;43;40;0.488372093023256;22;21;0.0116279069767442;0.488372093023256
Control.SRR15539824;43;40;0.604651162790698;17;26;0.104651162790698;0.395348837209302
Control.SRR15539824;37;40;0.405405405405405;22;15;0.0945945945945946;0.405405405405405
Control.SRR15539824;38;40;0.5;19;19;0;0.5
Control.SRR15539824;40;40;0.25;30;10;0.25;0.25
Control.SRR15539824;38;40;0.578947368421053;16;22;0.0789473684210527;0.421052631578947
Control.SRR15539824;36;40;0.5;18;18;0;0.5
Control.SRR15539824;34;40;0.558823529411765;15;19;0.0588235294117647;0.441176470588235
Control.SRR15539824;38;40;0.526315789473684;18;20;0.0263157894736842;0.473684210526316
Control.SRR15539824;35;40;0.571428571428571;15;20;0.0714285714285714;0.428571428571429
Control.SRR15539824;38;40;0.684210526315789;12;26;0.184210526315789;0.315789473684211
Control.SRR15539824;41;40;0.365853658536585;26;15;0.134146341463415;0.365853658536585
Control.SRR15539824;35;40;0.542857142857143;16;19;0.0428571428571428;0.457142857142857
Control.SRR15539824;39;40;0.307692307692308;27;12;0.192307692307692;0.307692307692308
Control.SRR15539824;43;40;0.534883720930233;20;23;0.0348837209302325;0.465116279069767
Control.SRR15539824;38;40;0.631578947368421;14;24;0.131578947368421;0.368421052631579
Control.SRR15539824;40;40;0.625;15;25;0.125;0.375
Control.SRR15539824;44;40;0.568181818181818;19;25;0.0681818181818182;0.431818181818182
Control.SRR15539824;34;40;0.529411764705882;16;18;0.0294117647058824;0.470588235294118
Control.SRR15539824;42;40;0.5;21;21;0;0.5
Control.SRR15539824;41;40;0.48780487804878;21;20;0.0121951219512195;0.48780487804878
Control.SRR15539824;34;40;0.470588235294118;18;16;0.0294117647058824;0.470588235294118
Control.SRR15539824;40;40;0.45;22;18;0.05;0.45
Control.SRR15539824;35;40;0.485714285714286;18;17;0.0142857142857143;0.485714285714286
Control.SRR15539824;41;40;0.634146341463415;15;26;0.134146341463415;0.365853658536585
Control.SRR15539824;37;40;0.594594594594595;15;22;0.0945945945945946;0.405405405405405
Control.SRR15539824;41;40;0.51219512195122;20;21;0.0121951219512195;0.48780487804878
Control.SRR15539824;41;40;0.365853658536585;26;15;0.134146341463415;0.365853658536585
Control.SRR15539824;34;40;0.441176470588235;19;15;0.0588235294117647;0.441176470588235
Control.SRR15539824;39;40;0.461538461538462;21;18;0.0384615384615384;0.461538461538462
Control.SRR15539824;38;40;0.5;19;19;0;0.5
Control.SRR15539824;44;40;0.522727272727273;21;23;0.0227272727272727;0.477272727272727
Control.SRR15539824;42;40;0.547619047619048;19;23;0.0476190476190477;0.452380952380952
Control.SRR15539824;36;40;0.472222222222222;19;17;0.0277777777777778;0.472222222222222
Control.SRR15539824;34;40;0.558823529411765;15;19;0.0588235294117647;0.441176470588235
Control.SRR15539824;37;40;0.621621621621622;14;23;0.121621621621622;0.378378378378378
Control.SRR15539824;43;40;0.465116279069767;23;20;0.0348837209302326;0.465116279069767
Control.SRR15539824;39;40;0.538461538461538;18;21;0.0384615384615384;0.461538461538462
Control.SRR15539824;34;40;0.470588235294118;18;16;0.0294117647058824;0.470588235294118
Control.SRR15539824;36;40;0.666666666666667;12;24;0.166666666666667;0.333333333333333
Control.SRR15539824;35;40;0.342857142857143;23;12;0.157142857142857;0.342857142857143
Control.SRR15539824;39;40;0.512820512820513;19;20;0.0128205128205128;0.487179487179487
Control.SRR15539824;40;40;0.45;22;18;0.05;0.45
Control.SRR15539824;40;40;0.45;22;18;0.05;0.45
Control.SRR15539824;34;40;0.617647058823529;13;21;0.117647058823529;0.382352941176471
Control.SRR15539824;43;40;0.395348837209302;26;17;0.104651162790698;0.395348837209302
Control.SRR15539824;39;40;0.487179487179487;20;19;0.0128205128205128;0.487179487179487
Control.SRR15539824;42;40;0.666666666666667;14;28;0.166666666666667;0.333333333333333
Control.SRR15539824;42;40;0.571428571428571;18;24;0.0714285714285714;0.428571428571429
Control.SRR15539824;37;40;0.675675675675676;12;25;0.175675675675676;0.324324324324324
Control.SRR15539824;41;40;0.463414634146341;22;19;0.0365853658536585;0.463414634146341
Control.SRR15539824;35;40;0.342857142857143;23;12;0.157142857142857;0.342857142857143
Control.SRR15539824;35;40;0.657142857142857;12;23;0.157142857142857;0.342857142857143
Control.SRR15539824;36;40;0.472222222222222;19;17;0.0277777777777778;0.472222222222222
Control.SRR15539824;38;40;0.5;19;19;0;0.5
Control.SRR15539824;34;40;0.588235294117647;14;20;0.0882352941176471;0.411764705882353
Control.SRR15539824;34;40;0.382352941176471;21;13;0.117647058823529;0.382352941176471
Control.SRR15539824;39;40;0.333333333333333;26;13;0.166666666666667;0.333333333333333
Control.SRR15539824;38;40;0.394736842105263;23;15;0.105263157894737;0.394736842105263
Control.SRR15539824;43;40;0.465116279069767;23;20;0.0348837209302326;0.465116279069767
Control.SRR15539824;44;40;0.431818181818182;25;19;0.0681818181818182;0.431818181818182
Control.SRR15539824;41;40;0.414634146341463;24;17;0.0853658536585366;0.414634146341463
Control.SRR15539824;36;40;0.555555555555556;16;20;0.0555555555555556;0.444444444444444
Control.SRR15539824;34;40;0.470588235294118;18;16;0.0294117647058824;0.470588235294118
Control.SRR15539824;36;40;0.527777777777778;17;19;0.0277777777777778;0.472222222222222
Control.SRR15539824;35;40;0.514285714285714;17;18;0.0142857142857142;0.485714285714286
Control.SRR15539824;42;40;0.404761904761905;25;17;0.0952380952380952;0.404761904761905
Control.SRR15539824;35;40;0.428571428571429;20;15;0.0714285714285715;0.428571428571429
Control.SRR15539824;38;40;0.5;19;19;0;0.5
Control.SRR15539824;34;40;0.5;17;17;0;0.5
Control.SRR15539824;40;40;0.475;21;19;0.025;0.475
Control.SRR15539824;36;40;0.583333333333333;15;21;0.0833333333333334;0.416666666666667
Control.SRR15539824;35;40;0.342857142857143;23;12;0.157142857142857;0.342857142857143
Control.SRR15539824;43;40;0.534883720930233;20;23;0.0348837209302325;0.465116279069767
Control.SRR15539824;39;40;0.666666666666667;13;26;0.166666666666667;0.333333333333333
Control.SRR15539824;43;40;0.418604651162791;25;18;0.0813953488372093;0.418604651162791
Control.SRR15539824;34;40;0.382352941176471;21;13;0.117647058823529;0.382352941176471
Control.SRR15539824;34;40;0.5;17;17;0;0.5
Control.SRR15539824;34;40;0.470588235294118;18;16;0.0294117647058824;0.470588235294118
Control.SRR15539824;36;40;0.472222222222222;19;17;0.0277777777777778;0.472222222222222
Control.SRR15539824;40;40;0.425;23;17;0.075;0.425
Control.SRR15539824;41;40;0.390243902439024;25;16;0.109756097560976;0.390243902439024
Control.SRR15539824;44;40;0.5;22;22;0;0.5
Control.SRR15539824;36;40;0.472222222222222;19;17;0.0277777777777778;0.472222222222222
Control.SRR15539824;34;40;0.470588235294118;18;16;0.0294117647058824;0.470588235294118
Control.SRR15539824;42;40;0.571428571428571;18;24;0.0714285714285714;0.428571428571429
Control.SRR15539824;35;40;0.514285714285714;17;18;0.0142857142857142;0.485714285714286
Control.SRR15539824;41;40;0.51219512195122;20;21;0.0121951219512195;0.48780487804878
Control.SRR15539824;34;40;0.411764705882353;20;14;0.0882352941176471;0.411764705882353
Control.SRR15539824;44;40;0.545454545454545;20;24;0.0454545454545454;0.454545454545455
Control.SRR15539824;34;40;0.411764705882353;20;14;0.0882352941176471;0.411764705882353
Control.SRR15539824;34;40;0.382352941176471;21;13;0.117647058823529;0.382352941176471
Control.SRR15539824;42;40;0.523809523809524;20;22;0.0238095238095238;0.476190476190476
Control.SRR15539824;34;40;0.676470588235294;11;23;0.176470588235294;0.323529411764706
Control.SRR15539824;44;40;0.454545454545455;24;20;0.0454545454545455;0.454545454545455
Control.SRR15539824;36;40;0.472222222222222;19;17;0.0277777777777778;0.472222222222222
Control.SRR15539824;40;40;0.625;15;25;0.125;0.375
Control.SRR15539824;42;40;0.5;21;21;0;0.5
Control.SRR15539824;36;40;0.5;18;18;0;0.5
Control.SRR15539824;42;40;0.595238095238095;17;25;0.0952380952380952;0.404761904761905
Control.SRR15539824;44;40;0.5;22;22;0;0.5
Control.SRR15539824;39;40;0.461538461538462;21;18;0.0384615384615384;0.461538461538462
Control.SRR15539824;41;40;0.51219512195122;20;21;0.0121951219512195;0.48780487804878
Control.SRR15539824;34;40;0.441176470588235;19;15;0.0588235294117647;0.441176470588235
Control.SRR15539824;36;40;0.555555555555556;16;20;0.0555555555555556;0.444444444444444
Control.SRR15539824;35;40;0.457142857142857;19;16;0.0428571428571429;0.457142857142857
Control.SRR15539824;39;40;0.538461538461538;18;21;0.0384615384615384;0.461538461538462
Control.SRR15539824;38;40;0.657894736842105;13;25;0.157894736842105;0.342105263157895
Control.SRR15539824;35;40;0.428571428571429;20;15;0.0714285714285715;0.428571428571429
Control.SRR15539824;41;40;0.365853658536585;26;15;0.134146341463415;0.365853658536585
Control.SRR15539824;37;40;0.594594594594595;15;22;0.0945945945945946;0.405405405405405
Control.SRR15539824;39;40;0.435897435897436;22;17;0.0641025641025641;0.435897435897436
Control.SRR15539824;41;40;0.390243902439024;25;16;0.109756097560976;0.390243902439024
Control.SRR15539824;44;40;0.522727272727273;21;23;0.0227272727272727;0.477272727272727
Control.SRR15539824;39;40;0.384615384615385;24;15;0.115384615384615;0.384615384615385
Control.SRR15539824;36;40;0.444444444444444;20;16;0.0555555555555556;0.444444444444444
Control.SRR15539824;36;40;0.444444444444444;20;16;0.0555555555555556;0.444444444444444
Control.SRR15539824;35;40;0.542857142857143;16;19;0.0428571428571428;0.457142857142857
Control.SRR15539824;39;40;0.487179487179487;20;19;0.0128205128205128;0.487179487179487
Control.SRR15539824;34;40;0.588235294117647;14;20;0.0882352941176471;0.411764705882353
Control.SRR15539824;37;40;0.459459459459459;20;17;0.0405405405405405;0.459459459459459
Control.SRR15539824;34;40;0.5;17;17;0;0.5
Control.SRR15539824;38;40;0.447368421052632;21;17;0.0526315789473684;0.447368421052632
Control.SRR15539824;43;40;0.604651162790698;17;26;0.104651162790698;0.395348837209302
Control.SRR15539824;41;40;0.560975609756098;18;23;0.0609756097560976;0.439024390243902
Control.SRR15539824;42;40;0.523809523809524;20;22;0.0238095238095238;0.476190476190476
Control.SRR15539824;38;40;0.657894736842105;13;25;0.157894736842105;0.342105263157895
Control.SRR15539824;34;40;0.382352941176471;21;13;0.117647058823529;0.382352941176471
Control.SRR15539824;36;40;0.583333333333333;15;21;0.0833333333333334;0.416666666666667
Control.SRR15539824;44;40;0.5;22;22;0;0.5
Control.SRR15539824;41;40;0.536585365853659;19;22;0.0365853658536586;0.463414634146341
Control.SRR15539824;34;40;0.441176470588235;19;15;0.0588235294117647;0.441176470588235
Control.SRR15539824;37;40;0.378378378378378;23;14;0.121621621621622;0.378378378378378
Control.SRR15539824;37;40;0.594594594594595;15;22;0.0945945945945946;0.405405405405405
Control.SRR15539824;42;40;0.547619047619048;19;23;0.0476190476190477;0.452380952380952
Control.SRR15539824;43;40;0.581395348837209;18;25;0.0813953488372093;0.418604651162791
Control.SRR15539824;39;40;0.487179487179487;20;19;0.0128205128205128;0.487179487179487
Control.SRR15539824;37;40;0.513513513513513;18;19;0.0135135135135135;0.486486486486487
Control.SRR15539824;35;40;0.657142857142857;12;23;0.157142857142857;0.342857142857143
Control.SRR15539824;36;40;0.583333333333333;15;21;0.0833333333333334;0.416666666666667
Control.SRR15539824;35;40;0.428571428571429;20;15;0.0714285714285715;0.428571428571429
Control.SRR15539824;36;40;0.472222222222222;19;17;0.0277777777777778;0.472222222222222
Control.SRR15539824;43;40;0.651162790697674;15;28;0.151162790697674;0.348837209302326
Control.SRR15539824;43;40;0.511627906976744;21;22;0.0116279069767442;0.488372093023256
Control.SRR15539824;35;40;0.371428571428571;22;13;0.128571428571429;0.371428571428571
Control.SRR15539824;36;40;0.361111111111111;23;13;0.138888888888889;0.361111111111111
Control.SRR15539824;39;40;0.615384615384615;15;24;0.115384615384615;0.384615384615385
Control.SRR15539824;37;40;0.594594594594595;15;22;0.0945945945945946;0.405405405405405
Control.SRR15539824;35;40;0.685714285714286;11;24;0.185714285714286;0.314285714285714
Control.SRR15539824;35;40;0.571428571428571;15;20;0.0714285714285714;0.428571428571429
Control.SRR15539824;38;40;0.473684210526316;20;18;0.0263157894736842;0.473684210526316
Control.SRR15539824;43;40;0.418604651162791;25;18;0.0813953488372093;0.418604651162791
Control.SRR15539824;35;40;0.514285714285714;17;18;0.0142857142857142;0.485714285714286
Control.SRR15539824;39;40;0.384615384615385;24;15;0.115384615384615;0.384615384615385
Control.SRR15539824;40;40;0.425;23;17;0.075;0.425
Control.SRR15539824;37;40;0.486486486486487;19;18;0.0135135135135135;0.486486486486487
Control.SRR15539824;38;40;0.473684210526316;20;18;0.0263157894736842;0.473684210526316
Control.SRR15539824;43;40;0.581395348837209;18;25;0.0813953488372093;0.418604651162791
Control.SRR15539824;35;40;0.457142857142857;19;16;0.0428571428571429;0.457142857142857
Control.SRR15539824;41;40;0.463414634146341;22;19;0.0365853658536585;0.463414634146341
Control.SRR15539824;38;40;0.421052631578947;22;16;0.0789473684210527;0.421052631578947
Control.SRR15539824;39;40;0.435897435897436;22;17;0.0641025641025641;0.435897435897436
Control.SRR15539824;40;40;0.5;20;20;0;0.5
Control.SRR15539824;44;40;0.477272727272727;23;21;0.0227272727272727;0.477272727272727
Control.SRR15539824;36;40;0.611111111111111;14;22;0.111111111111111;0.388888888888889
Control.SRR15539824;38;40;0.473684210526316;20;18;0.0263157894736842;0.473684210526316
Control.SRR15539824;39;40;0.615384615384615;15;24;0.115384615384615;0.384615384615385
Control.SRR15539824;37;40;0.540540540540541;17;20;0.0405405405405406;0.459459459459459
Control.SRR15539824;36;40;0.666666666666667;12;24;0.166666666666667;0.333333333333333
Control.SRR15539824;43;40;0.581395348837209;18;25;0.0813953488372093;0.418604651162791
Control.SRR15539824;40;40;0.5;20;20;0;0.5
Control.SRR15539824;35;40;0.4;21;14;0.1;0.4
Control.SRR15539824;42;40;0.571428571428571;18;24;0.0714285714285714;0.428571428571429
Control.SRR15539824;39;40;0.538461538461538;18;21;0.0384615384615384;0.461538461538462
Control.SRR15539824;40;40;0.5;20;20;0;0.5
Control.SRR15539824;34;40;0.529411764705882;16;18;0.0294117647058824;0.470588235294118
Control.SRR15539824;39;40;0.58974358974359;16;23;0.0897435897435898;0.41025641025641
Control.SRR15539824;42;40;0.5;21;21;0;0.5
Control.SRR15539824;36;40;0.388888888888889;22;14;0.111111111111111;0.388888888888889
Control.SRR15539824;37;40;0.486486486486487;19;18;0.0135135135135135;0.486486486486487
Control.SRR15539824;34;40;0.470588235294118;18;16;0.0294117647058824;0.470588235294118
Control.SRR15539824;41;40;0.439024390243902;23;18;0.0609756097560976;0.439024390243902
Control.SRR15539824;42;40;0.380952380952381;26;16;0.119047619047619;0.380952380952381
Control.SRR15539824;37;40;0.567567567567568;16;21;0.0675675675675675;0.432432432432432
Control.SRR15539824;37;40;0.486486486486487;19;18;0.0135135135135135;0.486486486486487
Control.SRR15539824;36;40;0.5;18;18;0;0.5
Control.SRR15539824;35;40;0.542857142857143;16;19;0.0428571428571428;0.457142857142857
Control.SRR15539824;35;40;0.485714285714286;18;17;0.0142857142857143;0.485714285714286
Control.SRR15539824;34;40;0.588235294117647;14;20;0.0882352941176471;0.411764705882353
Control.SRR15539824;34;40;0.470588235294118;18;16;0.0294117647058824;0.470588235294118
Control.SRR15539824;36;40;0.5;18;18;0;0.5
Control.SRR15539824;38;40;0.421052631578947;22;16;0.0789473684210527;0.421052631578947
Control.SRR15539824;40;40;0.65;14;26;0.15;0.35
Control.SRR15539824;43;40;0.441860465116279;24;19;0.0581395348837209;0.441860465116279
Control.SRR15539824;34;40;0.529411764705882;16;18;0.0294117647058824;0.470588235294118
Control.SRR15539824;36;40;0.444444444444444;20;16;0.0555555555555556;0.444444444444444
Control.SRR15539824;40;40;0.55;18;22;0.05;0.45
Control.SRR15539824;38;40;0.552631578947368;17;21;0.0526315789473685;0.447368421052632
Control.SRR15539824;37;40;0.540540540540541;17;20;0.0405405405405406;0.459459459459459
Control.SRR15539824;34;40;0.470588235294118;18;16;0.0294117647058824;0.470588235294118
Control.SRR15539824;43;40;0.488372093023256;22;21;0.0116279069767442;0.488372093023256
Control.SRR15539824;40;40;0.5;20;20;0;0.5
Control.SRR15539824;40;40;0.45;22;18;0.05;0.45
Control.SRR15539824;38;40;0.5;19;19;0;0.5
Control.SRR15539824;36;40;0.555555555555556;16;20;0.0555555555555556;0.444444444444444
Control.SRR15539824;35;40;0.514285714285714;17;18;0.0142857142857142;0.485714285714286
Control.SRR15539824;43;40;0.511627906976744;21;22;0.0116279069767442;0.488372093023256
Control.SRR15539824;41;40;0.463414634146341;22;19;0.0365853658536585;0.463414634146341
Control.SRR15539824;41;40;0.560975609756098;18;23;0.0609756097560976;0.439024390243902
Control.SRR15539824;42;40;0.476190476190476;22;20;0.0238095238095238;0.476190476190476
Control.SRR15539824;37;40;0.567567567567568;16;21;0.0675675675675675;0.432432432432432
Control.SRR15539824;36;40;0.583333333333333;15;21;0.0833333333333334;0.416666666666667
Control.SRR15539824;42;40;0.5;21;21;0;0.5
Control.SRR15539824;40;40;0.525;19;21;0.025;0.475
Control.SRR15539824;43;40;0.488372093023256;22;21;0.0116279069767442;0.488372093023256
Control.SRR15539824;44;40;0.477272727272727;23;21;0.0227272727272727;0.477272727272727
Control.SRR15539824;37;40;0.378378378378378;23;14;0.121621621621622;0.378378378378378
Control.SRR15539824;36;40;0.5;18;18;0;0.5
Control.SRR15539824;44;40;0.613636363636364;17;27;0.113636363636364;0.386363636363636
Control.SRR15539824;34;40;0.5;17;17;0;0.5
Control.SRR15539824;37;40;0.756756756756757;9;28;0.256756756756757;0.243243243243243
Control.SRR15539824;38;40;0.578947368421053;16;22;0.0789473684210527;0.421052631578947
Control.SRR15539824;37;40;0.540540540540541;17;20;0.0405405405405406;0.459459459459459
Control.SRR15539824;41;40;0.536585365853659;19;22;0.0365853658536586;0.463414634146341
Control.SRR15539824;34;40;0.382352941176471;21;13;0.117647058823529;0.382352941176471
Control.SRR15539824;34;40;0.470588235294118;18;16;0.0294117647058824;0.470588235294118
Control.SRR15539824;35;40;0.428571428571429;20;15;0.0714285714285715;0.428571428571429
Control.SRR15539824;41;40;0.658536585365854;14;27;0.158536585365854;0.341463414634146
Control.SRR15539824;44;40;0.522727272727273;21;23;0.0227272727272727;0.477272727272727
Control.SRR15539824;34;40;0.441176470588235;19;15;0.0588235294117647;0.441176470588235
Control.SRR15539824;36;40;0.388888888888889;22;14;0.111111111111111;0.388888888888889
Control.SRR15539824;40;40;0.5;20;20;0;0.5
Control.SRR15539824;43;40;0.395348837209302;26;17;0.104651162790698;0.395348837209302
Control.SRR15539824;39;40;0.564102564102564;17;22;0.0641025641025641;0.435897435897436
Control.SRR15539824;41;40;0.51219512195122;20;21;0.0121951219512195;0.48780487804878
Control.SRR15539824;36;40;0.5;18;18;0;0.5
Control.SRR15539824;42;40;0.476190476190476;22;20;0.0238095238095238;0.476190476190476
Control.SRR15539824;36;40;0.638888888888889;13;23;0.138888888888889;0.361111111111111
Control.SRR15539824;34;40;0.441176470588235;19;15;0.0588235294117647;0.441176470588235
Control.SRR15539824;37;40;0.513513513513513;18;19;0.0135135135135135;0.486486486486487
Control.SRR15539824;34;40;0.588235294117647;14;20;0.0882352941176471;0.411764705882353
Control.SRR15539824;40;40;0.55;18;22;0.05;0.45
Control.SRR15539824;36;40;0.444444444444444;20;16;0.0555555555555556;0.444444444444444
Control.SRR15539824;39;40;0.615384615384615;15;24;0.115384615384615;0.384615384615385
Control.SRR15539824;43;40;0.511627906976744;21;22;0.0116279069767442;0.488372093023256
Control.SRR15539824;38;40;0.578947368421053;16;22;0.0789473684210527;0.421052631578947
Control.SRR15539824;37;40;0.513513513513513;18;19;0.0135135135135135;0.486486486486487
Control.SRR15539824;40;40;0.4;24;16;0.1;0.4
Control.SRR15539824;39;40;0.358974358974359;25;14;0.141025641025641;0.358974358974359
Control.SRR15539824;42;40;0.5;21;21;0;0.5
Control.SRR15539824;39;40;0.615384615384615;15;24;0.115384615384615;0.384615384615385
Control.SRR15539824;40;40;0.525;19;21;0.025;0.475
Control.SRR15539824;39;40;0.487179487179487;20;19;0.0128205128205128;0.487179487179487
Control.SRR15539824;41;40;0.560975609756098;18;23;0.0609756097560976;0.439024390243902
Control.SRR15539824;37;40;0.297297297297297;26;11;0.202702702702703;0.297297297297297
Control.SRR15539824;39;40;0.358974358974359;25;14;0.141025641025641;0.358974358974359
Control.SRR15539824;38;40;0.447368421052632;21;17;0.0526315789473684;0.447368421052632
Control.SRR15539824;37;40;0.675675675675676;12;25;0.175675675675676;0.324324324324324
Control.SRR15539824;37;40;0.432432432432432;21;16;0.0675675675675675;0.432432432432432
Control.SRR15539824;35;40;0.4;21;14;0.1;0.4
Control.SRR15539824;41;40;0.536585365853659;19;22;0.0365853658536586;0.463414634146341
Control.SRR15539824;36;40;0.472222222222222;19;17;0.0277777777777778;0.472222222222222
Control.SRR15539824;42;40;0.595238095238095;17;25;0.0952380952380952;0.404761904761905
Control.SRR15539824;38;40;0.5;19;19;0;0.5
Control.SRR15539824;33;40;0.393939393939394;20;13;0.106060606060606;0.393939393939394
Control.SRR15539824;36;40;0.472222222222222;19;17;0.0277777777777778;0.472222222222222
Control.SRR15539824;38;40;0.578947368421053;16;22;0.0789473684210527;0.421052631578947
Control.SRR15539824;35;40;0.485714285714286;18;17;0.0142857142857143;0.485714285714286
Control.SRR15539824;34;40;0.647058823529412;12;22;0.147058823529412;0.352941176470588
Control.SRR15539824;38;40;0.605263157894737;15;23;0.105263157894737;0.394736842105263
Control.SRR15539824;40;40;0.45;22;18;0.05;0.45
Control.SRR15539824;36;40;0.583333333333333;15;21;0.0833333333333334;0.416666666666667
Control.SRR15539824;37;40;0.513513513513513;18;19;0.0135135135135135;0.486486486486487
Control.SRR15539824;42;40;0.5;21;21;0;0.5
Control.SRR15539824;37;40;0.432432432432432;21;16;0.0675675675675675;0.432432432432432
Control.SRR15539824;40;40;0.55;18;22;0.05;0.45
Control.SRR15539824;34;40;0.470588235294118;18;16;0.0294117647058824;0.470588235294118
Control.SRR15539824;36;40;0.555555555555556;16;20;0.0555555555555556;0.444444444444444
Control.SRR15539824;34;40;0.441176470588235;19;15;0.0588235294117647;0.441176470588235
Control.SRR15539824;36;40;0.638888888888889;13;23;0.138888888888889;0.361111111111111
Control.SRR15539824;35;40;0.371428571428571;22;13;0.128571428571429;0.371428571428571
Control.SRR15539824;33;40;0.212121212121212;26;7;0.287878787878788;0.212121212121212
Control.SRR15539824;38;40;0.684210526315789;12;26;0.184210526315789;0.315789473684211
Control.SRR15539824;39;40;0.333333333333333;26;13;0.166666666666667;0.333333333333333
Control.SRR15539824;33;40;0.484848484848485;17;16;0.0151515151515151;0.484848484848485
Control.SRR15539824;37;40;0.405405405405405;22;15;0.0945945945945946;0.405405405405405
Control.SRR15539824;33;40;0.515151515151515;16;17;0.0151515151515151;0.484848484848485
Control.SRR15539824;41;40;0.536585365853659;19;22;0.0365853658536586;0.463414634146341
Control.SRR15539824;41;40;0.560975609756098;18;23;0.0609756097560976;0.439024390243902
Control.SRR15539824;39;40;0.58974358974359;16;23;0.0897435897435898;0.41025641025641
Control.SRR15539824;42;40;0.5;21;21;0;0.5
Control.SRR15539824;35;40;0.428571428571429;20;15;0.0714285714285715;0.428571428571429
Control.SRR15539824;39;40;0.564102564102564;17;22;0.0641025641025641;0.435897435897436
Control.SRR15539824;42;40;0.428571428571429;24;18;0.0714285714285715;0.428571428571429
Control.SRR15539824;39;40;0.512820512820513;19;20;0.0128205128205128;0.487179487179487
Control.SRR15539824;41;40;0.51219512195122;20;21;0.0121951219512195;0.48780487804878
Control.SRR15539824;40;40;0.425;23;17;0.075;0.425
Control.SRR15539824;33;40;0.393939393939394;20;13;0.106060606060606;0.393939393939394
Control.SRR15539824;42;40;0.476190476190476;22;20;0.0238095238095238;0.476190476190476
Control.SRR15539824;38;40;0.368421052631579;24;14;0.131578947368421;0.368421052631579
Control.SRR15539824;32;40;0.5;16;16;0;0.5
Control.SRR15539824;35;40;0.314285714285714;24;11;0.185714285714286;0.314285714285714
Control.SRR15539824;32;40;0.59375;13;19;0.09375;0.40625
Control.SRR15539824;33;40;0.545454545454545;15;18;0.0454545454545454;0.454545454545455
Control.SRR15539824;36;40;0.416666666666667;21;15;0.0833333333333333;0.416666666666667
Control.SRR15539824;36;40;0.5;18;18;0;0.5
Control.SRR15539824;41;40;0.414634146341463;24;17;0.0853658536585366;0.414634146341463
Control.SRR15539824;36;40;0.388888888888889;22;14;0.111111111111111;0.388888888888889
Control.SRR15539824;37;40;0.567567567567568;16;21;0.0675675675675675;0.432432432432432
Control.SRR15539824;40;40;0.45;22;18;0.05;0.45
Control.SRR15539824;35;40;0.457142857142857;19;16;0.0428571428571429;0.457142857142857
Control.SRR15539824;35;40;0.657142857142857;12;23;0.157142857142857;0.342857142857143
Control.SRR15539824;37;40;0.432432432432432;21;16;0.0675675675675675;0.432432432432432
Control.SRR15539824;40;40;0.3;28;12;0.2;0.3
Control.SRR15539824;38;40;0.421052631578947;22;16;0.0789473684210527;0.421052631578947
Control.SRR15539824;36;40;0.527777777777778;17;19;0.0277777777777778;0.472222222222222
Control.SRR15539824;37;40;0.540540540540541;17;20;0.0405405405405406;0.459459459459459
Control.SRR15539824;35;40;0.428571428571429;20;15;0.0714285714285715;0.428571428571429
Control.SRR15539824;39;40;0.487179487179487;20;19;0.0128205128205128;0.487179487179487
Control.SRR15539824;42;40;0.428571428571429;24;18;0.0714285714285715;0.428571428571429
Control.SRR15539824;35;40;0.657142857142857;12;23;0.157142857142857;0.342857142857143
Control.SRR15539824;36;40;0.583333333333333;15;21;0.0833333333333334;0.416666666666667
Control.SRR15539824;41;40;0.536585365853659;19;22;0.0365853658536586;0.463414634146341
Control.SRR15539824;35;40;0.457142857142857;19;16;0.0428571428571429;0.457142857142857
Control.SRR15539824;40;40;0.525;19;21;0.025;0.475
Control.SRR15539824;33;40;0.515151515151515;16;17;0.0151515151515151;0.484848484848485
Control.SRR15539824;32;40;0.5;16;16;0;0.5
Control.SRR15539824;38;40;0.552631578947368;17;21;0.0526315789473685;0.447368421052632
Control.SRR15539824;33;40;0.545454545454545;15;18;0.0454545454545454;0.454545454545455
Control.SRR15539824;42;40;0.5;21;21;0;0.5
Control.SRR15539824;36;40;0.5;18;18;0;0.5
Control.SRR15539824;37;40;0.513513513513513;18;19;0.0135135135135135;0.486486486486487
Control.SRR15539824;36;40;0.333333333333333;24;12;0.166666666666667;0.333333333333333
Control.SRR15539824;37;40;0.513513513513513;18;19;0.0135135135135135;0.486486486486487
Control.SRR15539824;40;40;0.6;16;24;0.1;0.4
Control.SRR15539824;40;40;0.5;20;20;0;0.5
Control.SRR15539824;41;40;0.560975609756098;18;23;0.0609756097560976;0.439024390243902
Control.SRR15539824;40;40;0.625;15;25;0.125;0.375
Control.SRR15539824;33;40;0.454545454545455;18;15;0.0454545454545455;0.454545454545455
Control.SRR15539824;37;40;0.621621621621622;14;23;0.121621621621622;0.378378378378378
Control.SRR15539824;38;40;0.526315789473684;18;20;0.0263157894736842;0.473684210526316
Control.SRR15539824;39;40;0.461538461538462;21;18;0.0384615384615384;0.461538461538462
Control.SRR15539824;35;40;0.542857142857143;16;19;0.0428571428571428;0.457142857142857
Control.SRR15539824;32;40;0.5;16;16;0;0.5
Control.SRR15539824;34;40;0.441176470588235;19;15;0.0588235294117647;0.441176470588235
Control.SRR15539824;32;40;0.3125;22;10;0.1875;0.3125
Control.SRR15539824;41;40;0.634146341463415;15;26;0.134146341463415;0.365853658536585
Control.SRR15539824;33;40;0.454545454545455;18;15;0.0454545454545455;0.454545454545455
Control.SRR15539824;40;40;0.325;27;13;0.175;0.325
Control.SRR15539824;34;40;0.382352941176471;21;13;0.117647058823529;0.382352941176471
Control.SRR15539824;38;40;0.578947368421053;16;22;0.0789473684210527;0.421052631578947
Control.SRR15539824;41;40;0.658536585365854;14;27;0.158536585365854;0.341463414634146
Control.SRR15539824;32;40;0.46875;17;15;0.03125;0.46875
Control.SRR15539824;38;40;0.473684210526316;20;18;0.0263157894736842;0.473684210526316
Control.SRR15539824;36;40;0.611111111111111;14;22;0.111111111111111;0.388888888888889
Control.SRR15539824;35;40;0.457142857142857;19;16;0.0428571428571429;0.457142857142857
Control.SRR15539824;32;40;0.46875;17;15;0.03125;0.46875
Control.SRR15539824;37;40;0.648648648648649;13;24;0.148648648648649;0.351351351351351
Control.SRR15539824;32;40;0.5625;14;18;0.0625;0.4375
Control.SRR15539824;38;40;0.473684210526316;20;18;0.0263157894736842;0.473684210526316
Control.SRR15539824;40;40;0.5;20;20;0;0.5
Control.SRR15539824;33;40;0.515151515151515;16;17;0.0151515151515151;0.484848484848485
Control.SRR15539824;36;40;0.472222222222222;19;17;0.0277777777777778;0.472222222222222
Control.SRR15539824;40;40;0.425;23;17;0.075;0.425
Control.SRR15539824;40;40;0.475;21;19;0.025;0.475
Control.SRR15539824;39;40;0.58974358974359;16;23;0.0897435897435898;0.41025641025641
Control.SRR15539824;39;40;0.358974358974359;25;14;0.141025641025641;0.358974358974359
Control.SRR15539824;32;40;0.5;16;16;0;0.5
Control.SRR15539824;38;40;0.447368421052632;21;17;0.0526315789473684;0.447368421052632
Control.SRR15539824;33;40;0.666666666666667;11;22;0.166666666666667;0.333333333333333
Control.SRR15539824;42;40;0.452380952380952;23;19;0.0476190476190476;0.452380952380952
Control.SRR15539824;36;40;0.555555555555556;16;20;0.0555555555555556;0.444444444444444
Control.SRR15539824;38;40;0.473684210526316;20;18;0.0263157894736842;0.473684210526316
Control.SRR15539824;38;40;0.394736842105263;23;15;0.105263157894737;0.394736842105263
Control.SRR15539824;36;40;0.694444444444444;11;25;0.194444444444444;0.305555555555556
Control.SRR15539824;36;40;0.666666666666667;12;24;0.166666666666667;0.333333333333333
Control.SRR15539824;35;40;0.428571428571429;20;15;0.0714285714285715;0.428571428571429
Control.SRR15539824;38;40;0.631578947368421;14;24;0.131578947368421;0.368421052631579
Control.SRR15539824;36;40;0.611111111111111;14;22;0.111111111111111;0.388888888888889
Control.SRR15539824;33;40;0.272727272727273;24;9;0.227272727272727;0.272727272727273
Control.SRR15539824;34;40;0.588235294117647;14;20;0.0882352941176471;0.411764705882353
Control.SRR15539824;34;40;0.558823529411765;15;19;0.0588235294117647;0.441176470588235
Control.SRR15539824;39;40;0.512820512820513;19;20;0.0128205128205128;0.487179487179487
Control.SRR15539824;36;40;0.611111111111111;14;22;0.111111111111111;0.388888888888889
Control.SRR15539824;33;40;0.454545454545455;18;15;0.0454545454545455;0.454545454545455
Control.SRR15539824;37;40;0.540540540540541;17;20;0.0405405405405406;0.459459459459459
Control.SRR15539824;41;40;0.51219512195122;20;21;0.0121951219512195;0.48780487804878
Control.SRR15539824;38;40;0.447368421052632;21;17;0.0526315789473684;0.447368421052632
Control.SRR15539824;36;40;0.583333333333333;15;21;0.0833333333333334;0.416666666666667
Control.SRR15539824;35;40;0.628571428571429;13;22;0.128571428571429;0.371428571428571
Control.SRR15539824;36;40;0.583333333333333;15;21;0.0833333333333334;0.416666666666667
Control.SRR15539824;41;40;0.463414634146341;22;19;0.0365853658536585;0.463414634146341
Control.SRR15539824;39;40;0.564102564102564;17;22;0.0641025641025641;0.435897435897436
Control.SRR15539824;41;40;0.51219512195122;20;21;0.0121951219512195;0.48780487804878
Control.SRR15539824;39;40;0.538461538461538;18;21;0.0384615384615384;0.461538461538462
Control.SRR15539824;36;40;0.361111111111111;23;13;0.138888888888889;0.361111111111111
Control.SRR15539824;32;40;0.5625;14;18;0.0625;0.4375
Control.SRR15539824;33;40;0.303030303030303;23;10;0.196969696969697;0.303030303030303
Control.SRR15539824;37;40;0.540540540540541;17;20;0.0405405405405406;0.459459459459459
Control.SRR15539824;37;40;0.594594594594595;15;22;0.0945945945945946;0.405405405405405
Control.SRR15539824;38;40;0.342105263157895;25;13;0.157894736842105;0.342105263157895
Control.SRR15539824;37;40;0.594594594594595;15;22;0.0945945945945946;0.405405405405405
Control.SRR15539824;42;40;0.5;21;21;0;0.5
Control.SRR15539824;36;40;0.527777777777778;17;19;0.0277777777777778;0.472222222222222
Control.SRR15539824;35;40;0.485714285714286;18;17;0.0142857142857143;0.485714285714286
Control.SRR15539824;35;40;0.571428571428571;15;20;0.0714285714285714;0.428571428571429
Control.SRR15539824;36;40;0.416666666666667;21;15;0.0833333333333333;0.416666666666667
Control.SRR15539824;34;40;0.5;17;17;0;0.5
Control.SRR15539824;39;40;0.564102564102564;17;22;0.0641025641025641;0.435897435897436
Control.SRR15539824;37;40;0.432432432432432;21;16;0.0675675675675675;0.432432432432432
Control.SRR15539824;38;40;0.631578947368421;14;24;0.131578947368421;0.368421052631579
Control.SRR15539824;40;40;0.625;15;25;0.125;0.375
Control.SRR15539824;40;40;0.525;19;21;0.025;0.475
Control.SRR15539824;34;40;0.470588235294118;18;16;0.0294117647058824;0.470588235294118
Control.SRR15539824;32;40;0.46875;17;15;0.03125;0.46875
Control.SRR15539824;33;40;0.393939393939394;20;13;0.106060606060606;0.393939393939394
Control.SRR15539824;38;40;0.526315789473684;18;20;0.0263157894736842;0.473684210526316
Control.SRR15539824;41;40;0.439024390243902;23;18;0.0609756097560976;0.439024390243902
Control.SRR15539824;42;40;0.642857142857143;15;27;0.142857142857143;0.357142857142857
Control.SRR15539824;40;40;0.475;21;19;0.025;0.475
Control.SRR15539824;37;40;0.567567567567568;16;21;0.0675675675675675;0.432432432432432
Control.SRR15539824;33;40;0.575757575757576;14;19;0.0757575757575758;0.424242424242424
Control.SRR15539824;35;40;0.542857142857143;16;19;0.0428571428571428;0.457142857142857
Control.SRR15539824;35;40;0.628571428571429;13;22;0.128571428571429;0.371428571428571
Control.SRR15539824;39;40;0.333333333333333;26;13;0.166666666666667;0.333333333333333
Control.SRR15539824;39;40;0.615384615384615;15;24;0.115384615384615;0.384615384615385
Control.SRR15539824;33;40;0.484848484848485;17;16;0.0151515151515151;0.484848484848485
Control.SRR15539824;40;40;0.475;21;19;0.025;0.475
Control.SRR15539824;39;40;0.435897435897436;22;17;0.0641025641025641;0.435897435897436
Control.SRR15539824;41;40;0.317073170731707;28;13;0.182926829268293;0.317073170731707
Control.SRR15539824;41;40;0.560975609756098;18;23;0.0609756097560976;0.439024390243902
Control.SRR15539824;38;40;0.526315789473684;18;20;0.0263157894736842;0.473684210526316
Control.SRR15539824;36;40;0.583333333333333;15;21;0.0833333333333334;0.416666666666667
Control.SRR15539824;35;40;0.428571428571429;20;15;0.0714285714285715;0.428571428571429
Control.SRR15539824;38;40;0.421052631578947;22;16;0.0789473684210527;0.421052631578947
Control.SRR15539824;40;40;0.5;20;20;0;0.5
Control.SRR15539824;36;40;0.361111111111111;23;13;0.138888888888889;0.361111111111111
Control.SRR15539824;41;40;0.48780487804878;21;20;0.0121951219512195;0.48780487804878
Control.SRR15539824;40;40;0.5;20;20;0;0.5
Control.SRR15539824;40;40;0.375;25;15;0.125;0.375
Control.SRR15539824;35;40;0.628571428571429;13;22;0.128571428571429;0.371428571428571
Control.SRR15539824;32;40;0.65625;11;21;0.15625;0.34375
Control.SRR15539824;36;40;0.611111111111111;14;22;0.111111111111111;0.388888888888889
Control.SRR15539824;32;40;0.4375;18;14;0.0625;0.4375
Control.SRR15539824;37;40;0.486486486486487;19;18;0.0135135135135135;0.486486486486487
Control.SRR15539824;39;40;0.435897435897436;22;17;0.0641025641025641;0.435897435897436
Control.SRR15539824;32;40;0.625;12;20;0.125;0.375
Control.SRR15539824;37;40;0.594594594594595;15;22;0.0945945945945946;0.405405405405405
Control.SRR15539824;41;40;0.341463414634146;27;14;0.158536585365854;0.341463414634146
Control.SRR15539824;41;40;0.560975609756098;18;23;0.0609756097560976;0.439024390243902
Control.SRR15539824;40;40;0.575;17;23;0.075;0.425
Control.SRR15539824;42;40;0.404761904761905;25;17;0.0952380952380952;0.404761904761905
Control.SRR15539824;39;40;0.641025641025641;14;25;0.141025641025641;0.358974358974359
Control.SRR15539824;39;40;0.512820512820513;19;20;0.0128205128205128;0.487179487179487
Control.SRR15539824;35;40;0.514285714285714;17;18;0.0142857142857142;0.485714285714286
Control.SRR15539824;42;40;0.452380952380952;23;19;0.0476190476190476;0.452380952380952
Control.SRR15539824;32;40;0.46875;17;15;0.03125;0.46875
Control.SRR15539824;33;40;0.515151515151515;16;17;0.0151515151515151;0.484848484848485
Control.SRR15539824;38;40;0.605263157894737;15;23;0.105263157894737;0.394736842105263
Control.SRR15539824;41;40;0.51219512195122;20;21;0.0121951219512195;0.48780487804878
Control.SRR15539824;36;40;0.472222222222222;19;17;0.0277777777777778;0.472222222222222
Control.SRR15539824;38;40;0.5;19;19;0;0.5
Control.SRR15539824;37;40;0.594594594594595;15;22;0.0945945945945946;0.405405405405405
Control.SRR15539824;39;40;0.41025641025641;23;16;0.0897435897435898;0.41025641025641
Control.SRR15539824;38;40;0.473684210526316;20;18;0.0263157894736842;0.473684210526316
Control.SRR15539824;36;40;0.555555555555556;16;20;0.0555555555555556;0.444444444444444
Control.SRR15539824;40;40;0.475;21;19;0.025;0.475
Control.SRR15539824;39;40;0.487179487179487;20;19;0.0128205128205128;0.487179487179487
Control.SRR15539824;38;40;0.5;19;19;0;0.5
Control.SRR15539824;42;40;0.476190476190476;22;20;0.0238095238095238;0.476190476190476
Control.SRR15539824;33;40;0.515151515151515;16;17;0.0151515151515151;0.484848484848485
Control.SRR15539824;37;40;0.459459459459459;20;17;0.0405405405405405;0.459459459459459
Control.SRR15539824;37;40;0.513513513513513;18;19;0.0135135135135135;0.486486486486487
Control.SRR15539824;34;40;0.441176470588235;19;15;0.0588235294117647;0.441176470588235
Control.SRR15539824;38;40;0.631578947368421;14;24;0.131578947368421;0.368421052631579
Control.SRR15539824;40;40;0.5;20;20;0;0.5
Control.SRR15539824;39;40;0.461538461538462;21;18;0.0384615384615384;0.461538461538462
Control.SRR15539824;40;40;0.5;20;20;0;0.5
Control.SRR15539824;37;40;0.486486486486487;19;18;0.0135135135135135;0.486486486486487
Control.SRR15539824;41;40;0.414634146341463;24;17;0.0853658536585366;0.414634146341463
Control.SRR15539824;36;40;0.472222222222222;19;17;0.0277777777777778;0.472222222222222
Control.SRR15539824;36;40;0.305555555555556;25;11;0.194444444444444;0.305555555555556
Control.SRR15539824;38;40;0.526315789473684;18;20;0.0263157894736842;0.473684210526316
Control.SRR15539824;39;40;0.487179487179487;20;19;0.0128205128205128;0.487179487179487
Control.SRR15539824;39;40;0.358974358974359;25;14;0.141025641025641;0.358974358974359
Control.SRR15539824;38;40;0.552631578947368;17;21;0.0526315789473685;0.447368421052632
Control.SRR15539824;39;40;0.435897435897436;22;17;0.0641025641025641;0.435897435897436
Control.SRR15539824;39;40;0.564102564102564;17;22;0.0641025641025641;0.435897435897436
Control.SRR15539824;42;40;0.5;21;21;0;0.5
Control.SRR15539824;32;40;0.625;12;20;0.125;0.375
Control.SRR15539824;38;40;0.631578947368421;14;24;0.131578947368421;0.368421052631579
Control.SRR15539824;33;40;0.515151515151515;16;17;0.0151515151515151;0.484848484848485
Control.SRR15539824;38;40;0.421052631578947;22;16;0.0789473684210527;0.421052631578947
Control.SRR15539824;41;40;0.48780487804878;21;20;0.0121951219512195;0.48780487804878
Control.SRR15539824;36;40;0.527777777777778;17;19;0.0277777777777778;0.472222222222222
Control.SRR15539824;40;40;0.575;17;23;0.075;0.425
Control.SRR15539824;39;40;0.41025641025641;23;16;0.0897435897435898;0.41025641025641
Control.SRR15539824;34;40;0.617647058823529;13;21;0.117647058823529;0.382352941176471
Control.SRR15539824;39;40;0.487179487179487;20;19;0.0128205128205128;0.487179487179487
Control.SRR15539824;34;40;0.529411764705882;16;18;0.0294117647058824;0.470588235294118
Control.SRR15539824;38;40;0.447368421052632;21;17;0.0526315789473684;0.447368421052632
Control.SRR15539824;39;40;0.487179487179487;20;19;0.0128205128205128;0.487179487179487
Control.SRR15539824;39;40;0.487179487179487;20;19;0.0128205128205128;0.487179487179487
Control.SRR15539824;38;40;0.526315789473684;18;20;0.0263157894736842;0.473684210526316
Control.SRR15539824;38;40;0.631578947368421;14;24;0.131578947368421;0.368421052631579
Control.SRR15539824;41;40;0.51219512195122;20;21;0.0121951219512195;0.48780487804878
Control.SRR15539824;36;40;0.416666666666667;21;15;0.0833333333333333;0.416666666666667
Control.SRR15539824;41;40;0.390243902439024;25;16;0.109756097560976;0.390243902439024
Control.SRR15539824;33;40;0.484848484848485;17;16;0.0151515151515151;0.484848484848485
Control.SRR15539824;42;40;0.5;21;21;0;0.5
Control.SRR15539824;39;40;0.487179487179487;20;19;0.0128205128205128;0.487179487179487
Control.SRR15539824;39;40;0.487179487179487;20;19;0.0128205128205128;0.487179487179487
Control.SRR15539824;39;40;0.282051282051282;28;11;0.217948717948718;0.282051282051282
Control.SRR15539824;40;40;0.475;21;19;0.025;0.475
Control.SRR15539824;41;40;0.585365853658537;17;24;0.0853658536585366;0.414634146341463
Control.SRR15539824;41;40;0.390243902439024;25;16;0.109756097560976;0.390243902439024
Control.SRR15539824;41;40;0.51219512195122;20;21;0.0121951219512195;0.48780487804878
Control.SRR15539824;39;40;0.435897435897436;22;17;0.0641025641025641;0.435897435897436
Control.SRR15539824;36;40;0.472222222222222;19;17;0.0277777777777778;0.472222222222222
Control.SRR15539824;38;40;0.5;19;19;0;0.5
Control.SRR15539824;41;40;0.51219512195122;20;21;0.0121951219512195;0.48780487804878
Control.SRR15539824;41;40;0.439024390243902;23;18;0.0609756097560976;0.439024390243902
Control.SRR15539824;35;40;0.485714285714286;18;17;0.0142857142857143;0.485714285714286
Control.SRR15539824;41;40;0.560975609756098;18;23;0.0609756097560976;0.439024390243902
Control.SRR15539824;40;40;0.45;22;18;0.05;0.45
Control.SRR15539824;33;40;0.515151515151515;16;17;0.0151515151515151;0.484848484848485
Control.SRR15539824;38;40;0.526315789473684;18;20;0.0263157894736842;0.473684210526316
Control.SRR15539824;33;40;0.545454545454545;15;18;0.0454545454545454;0.454545454545455
Control.SRR15539824;38;40;0.657894736842105;13;25;0.157894736842105;0.342105263157895
Control.SRR15539824;41;40;0.585365853658537;17;24;0.0853658536585366;0.414634146341463
Control.SRR15539824;41;40;0.634146341463415;15;26;0.134146341463415;0.365853658536585
Control.SRR15539824;40;40;0.575;17;23;0.075;0.425
Control.SRR15539824;33;40;0.424242424242424;19;14;0.0757575757575757;0.424242424242424
Control.SRR15539824;40;40;0.475;21;19;0.025;0.475
Control.SRR15539824;39;40;0.538461538461538;18;21;0.0384615384615384;0.461538461538462
Control.SRR15539824;34;40;0.558823529411765;15;19;0.0588235294117647;0.441176470588235
Control.SRR15539824;38;40;0.394736842105263;23;15;0.105263157894737;0.394736842105263
Control.SRR15539824;33;40;0.545454545454545;15;18;0.0454545454545454;0.454545454545455
Control.SRR15539824;36;40;0.527777777777778;17;19;0.0277777777777778;0.472222222222222
Control.SRR15539824;34;40;0.411764705882353;20;14;0.0882352941176471;0.411764705882353
Control.SRR15539824;33;40;0.515151515151515;16;17;0.0151515151515151;0.484848484848485
Control.SRR15539824;35;40;0.514285714285714;17;18;0.0142857142857142;0.485714285714286
Control.SRR15539824;35;40;0.6;14;21;0.1;0.4
Control.SRR15539824;41;40;0.463414634146341;22;19;0.0365853658536585;0.463414634146341
Control.SRR15539824;42;40;0.404761904761905;25;17;0.0952380952380952;0.404761904761905
Control.SRR15539824;38;40;0.710526315789474;11;27;0.210526315789474;0.289473684210526
Control.SRR15539824;42;40;0.547619047619048;19;23;0.0476190476190477;0.452380952380952
Control.SRR15539824;40;40;0.475;21;19;0.025;0.475
Control.SRR15539824;36;40;0.416666666666667;21;15;0.0833333333333333;0.416666666666667
Control.SRR15539824;34;40;0.382352941176471;21;13;0.117647058823529;0.382352941176471
Control.SRR15539824;35;40;0.457142857142857;19;16;0.0428571428571429;0.457142857142857
Control.SRR15539824;34;40;0.470588235294118;18;16;0.0294117647058824;0.470588235294118
Control.SRR15539824;33;40;0.515151515151515;16;17;0.0151515151515151;0.484848484848485
Control.SRR15539824;35;40;0.542857142857143;16;19;0.0428571428571428;0.457142857142857
Control.SRR15539824;35;40;0.685714285714286;11;24;0.185714285714286;0.314285714285714
Control.SRR15539824;34;40;0.294117647058824;24;10;0.205882352941176;0.294117647058824
Control.SRR15539824;41;40;0.390243902439024;25;16;0.109756097560976;0.390243902439024
Control.SRR15539824;35;40;0.514285714285714;17;18;0.0142857142857142;0.485714285714286
Control.SRR15539824;42;40;0.5;21;21;0;0.5
Control.SRR15539824;41;40;0.609756097560976;16;25;0.109756097560976;0.390243902439024
Control.SRR15539824;35;40;0.457142857142857;19;16;0.0428571428571429;0.457142857142857
Control.SRR15539824;42;40;0.357142857142857;27;15;0.142857142857143;0.357142857142857
Control.SRR15539824;37;40;0.432432432432432;21;16;0.0675675675675675;0.432432432432432
Control.SRR15539824;42;40;0.5;21;21;0;0.5
Control.SRR15539824;34;40;0.617647058823529;13;21;0.117647058823529;0.382352941176471
Control.SRR15539824;38;40;0.447368421052632;21;17;0.0526315789473684;0.447368421052632
Control.SRR15539824;39;40;0.538461538461538;18;21;0.0384615384615384;0.461538461538462
Control.SRR15539824;32;40;0.5;16;16;0;0.5
Control.SRR15539824;40;40;0.425;23;17;0.075;0.425
Control.SRR15539824;39;40;0.487179487179487;20;19;0.0128205128205128;0.487179487179487
Control.SRR15539824;34;40;0.558823529411765;15;19;0.0588235294117647;0.441176470588235
Control.SRR15539824;33;40;0.424242424242424;19;14;0.0757575757575757;0.424242424242424
Control.SRR15539824;41;40;0.609756097560976;16;25;0.109756097560976;0.390243902439024
Control.SRR15539824;35;40;0.657142857142857;12;23;0.157142857142857;0.342857142857143
Control.SRR15539824;42;40;0.5;21;21;0;0.5
Control.SRR15539824;41;40;0.585365853658537;17;24;0.0853658536585366;0.414634146341463
Control.SRR15539824;41;40;0.48780487804878;21;20;0.0121951219512195;0.48780487804878
Control.SRR15539824;42;40;0.476190476190476;22;20;0.0238095238095238;0.476190476190476
Control.SRR15539824;40;40;0.375;25;15;0.125;0.375
Control.SRR15539824;35;40;0.457142857142857;19;16;0.0428571428571429;0.457142857142857
Control.SRR15539824;40;40;0.375;25;15;0.125;0.375
Control.SRR15539824;35;40;0.571428571428571;15;20;0.0714285714285714;0.428571428571429
Control.SRR15539824;33;40;0.363636363636364;21;12;0.136363636363636;0.363636363636364
Control.SRR15539824;41;40;0.390243902439024;25;16;0.109756097560976;0.390243902439024
Control.SRR15539824;38;40;0.578947368421053;16;22;0.0789473684210527;0.421052631578947
Control.SRR15539824;32;40;0.53125;15;17;0.03125;0.46875
Control.SRR15539824;40;40;0.425;23;17;0.075;0.425
Control.SRR15539824;34;40;0.558823529411765;15;19;0.0588235294117647;0.441176470588235
Control.SRR15539824;42;40;0.452380952380952;23;19;0.0476190476190476;0.452380952380952
Control.SRR15539824;39;40;0.435897435897436;22;17;0.0641025641025641;0.435897435897436
Control.SRR15539824;34;40;0.5;17;17;0;0.5
Control.SRR15539824;42;40;0.452380952380952;23;19;0.0476190476190476;0.452380952380952
Control.SRR15539824;38;40;0.631578947368421;14;24;0.131578947368421;0.368421052631579
Control.SRR15539824;42;40;0.523809523809524;20;22;0.0238095238095238;0.476190476190476
Control.SRR15539824;38;40;0.368421052631579;24;14;0.131578947368421;0.368421052631579
Control.SRR15539824;41;40;0.51219512195122;20;21;0.0121951219512195;0.48780487804878
Control.SRR15539824;37;40;0.540540540540541;17;20;0.0405405405405406;0.459459459459459
Control.SRR15539824;37;40;0.486486486486487;19;18;0.0135135135135135;0.486486486486487
Control.SRR15539824;38;40;0.5;19;19;0;0.5
Control.SRR15539824;41;40;0.51219512195122;20;21;0.0121951219512195;0.48780487804878
Control.SRR15539824;42;40;0.595238095238095;17;25;0.0952380952380952;0.404761904761905
Control.SRR15539824;40;40;0.575;17;23;0.075;0.425
Control.SRR15539824;39;40;0.564102564102564;17;22;0.0641025641025641;0.435897435897436
Control.SRR15539824;32;40;0.53125;15;17;0.03125;0.46875
Control.SRR15539824;38;40;0.447368421052632;21;17;0.0526315789473684;0.447368421052632
Control.SRR15539824;38;40;0.657894736842105;13;25;0.157894736842105;0.342105263157895
Control.SRR15539824;42;40;0.642857142857143;15;27;0.142857142857143;0.357142857142857
Control.SRR15539824;35;40;0.457142857142857;19;16;0.0428571428571429;0.457142857142857
Control.SRR15539824;36;40;0.527777777777778;17;19;0.0277777777777778;0.472222222222222
Control.SRR15539824;37;40;0.540540540540541;17;20;0.0405405405405406;0.459459459459459
Control.SRR15539824;42;40;0.476190476190476;22;20;0.0238095238095238;0.476190476190476
Control.SRR15539824;39;40;0.307692307692308;27;12;0.192307692307692;0.307692307692308
Control.SRR15539824;42;40;0.547619047619048;19;23;0.0476190476190477;0.452380952380952
Control.SRR15539824;42;40;0.476190476190476;22;20;0.0238095238095238;0.476190476190476
Control.SRR15539824;35;40;0.485714285714286;18;17;0.0142857142857143;0.485714285714286
Control.SRR15539824;40;40;0.525;19;21;0.025;0.475
Control.SRR15539824;41;40;0.51219512195122;20;21;0.0121951219512195;0.48780487804878
Control.SRR15539824;40;40;0.6;16;24;0.1;0.4
Control.SRR15539824;37;40;0.378378378378378;23;14;0.121621621621622;0.378378378378378
Control.SRR15539824;36;40;0.555555555555556;16;20;0.0555555555555556;0.444444444444444
Control.SRR15539824;33;40;0.333333333333333;22;11;0.166666666666667;0.333333333333333
Control.SRR15539824;34;40;0.411764705882353;20;14;0.0882352941176471;0.411764705882353
Control.SRR15539824;42;40;0.428571428571429;24;18;0.0714285714285715;0.428571428571429
Control.SRR15539824;42;40;0.333333333333333;28;14;0.166666666666667;0.333333333333333
Control.SRR15539824;34;40;0.5;17;17;0;0.5
Control.SRR15539824;37;40;0.405405405405405;22;15;0.0945945945945946;0.405405405405405
Control.SRR15539824;40;40;0.425;23;17;0.075;0.425
Control.SRR15539824;42;40;0.595238095238095;17;25;0.0952380952380952;0.404761904761905
Control.SRR15539824;41;40;0.463414634146341;22;19;0.0365853658536585;0.463414634146341
Control.SRR15539824;34;40;0.411764705882353;20;14;0.0882352941176471;0.411764705882353
Control.SRR15539824;34;40;0.5;17;17;0;0.5
Control.SRR15539824;36;40;0.722222222222222;10;26;0.222222222222222;0.277777777777778
Control.SRR15539824;37;40;0.594594594594595;15;22;0.0945945945945946;0.405405405405405
Control.SRR15539824;41;40;0.365853658536585;26;15;0.134146341463415;0.365853658536585
Control.SRR15539824;40;40;0.5;20;20;0;0.5
Control.SRR15539824;35;40;0.485714285714286;18;17;0.0142857142857143;0.485714285714286
Control.SRR15539824;37;40;0.459459459459459;20;17;0.0405405405405405;0.459459459459459
Control.SRR15539824;39;40;0.461538461538462;21;18;0.0384615384615384;0.461538461538462
Control.SRR15539824;41;40;0.317073170731707;28;13;0.182926829268293;0.317073170731707
Control.SRR15539824;39;40;0.666666666666667;13;26;0.166666666666667;0.333333333333333
Control.SRR15539824;41;40;0.48780487804878;21;20;0.0121951219512195;0.48780487804878
Control.SRR15539824;41;40;0.365853658536585;26;15;0.134146341463415;0.365853658536585
Control.SRR15539824;42;40;0.547619047619048;19;23;0.0476190476190477;0.452380952380952
Control.SRR15539824;38;40;0.5;19;19;0;0.5
Control.SRR15539824;38;40;0.552631578947368;17;21;0.0526315789473685;0.447368421052632
Control.SRR15539824;32;40;0.34375;21;11;0.15625;0.34375
Control.SRR15539824;36;40;0.527777777777778;17;19;0.0277777777777778;0.472222222222222
Control.SRR15539824;33;40;0.484848484848485;17;16;0.0151515151515151;0.484848484848485
Control.SRR15539824;40;40;0.45;22;18;0.05;0.45
Control.SRR15539824;37;40;0.594594594594595;15;22;0.0945945945945946;0.405405405405405
Control.SRR15539824;40;40;0.35;26;14;0.15;0.35
Control.SRR15539824;39;40;0.487179487179487;20;19;0.0128205128205128;0.487179487179487
Control.SRR15539824;41;40;0.585365853658537;17;24;0.0853658536585366;0.414634146341463
Control.SRR15539824;39;40;0.435897435897436;22;17;0.0641025641025641;0.435897435897436
Control.SRR15539824;41;40;0.317073170731707;28;13;0.182926829268293;0.317073170731707
Control.SRR15539824;33;40;0.484848484848485;17;16;0.0151515151515151;0.484848484848485
Control.SRR15539824;35;40;0.571428571428571;15;20;0.0714285714285714;0.428571428571429
Control.SRR15539824;36;40;0.277777777777778;26;10;0.222222222222222;0.277777777777778
Control.SRR15539824;39;40;0.512820512820513;19;20;0.0128205128205128;0.487179487179487
Control.SRR15539824;41;40;0.536585365853659;19;22;0.0365853658536586;0.463414634146341
Control.SRR15539824;32;40;0.5;16;16;0;0.5
Control.SRR15539824;37;40;0.513513513513513;18;19;0.0135135135135135;0.486486486486487
Control.SRR15539824;39;40;0.564102564102564;17;22;0.0641025641025641;0.435897435897436
Control.SRR15539824;41;40;0.48780487804878;21;20;0.0121951219512195;0.48780487804878
Control.SRR15539824;37;40;0.486486486486487;19;18;0.0135135135135135;0.486486486486487
Control.SRR15539824;37;40;0.378378378378378;23;14;0.121621621621622;0.378378378378378
Control.SRR15539824;35;40;0.542857142857143;16;19;0.0428571428571428;0.457142857142857
Control.SRR15539824;35;40;0.428571428571429;20;15;0.0714285714285715;0.428571428571429
Control.SRR15539824;40;40;0.475;21;19;0.025;0.475
Control.SRR15539824;36;40;0.5;18;18;0;0.5
Control.SRR15539824;40;40;0.425;23;17;0.075;0.425
Control.SRR15539824;38;40;0.526315789473684;18;20;0.0263157894736842;0.473684210526316
Control.SRR15539824;41;40;0.585365853658537;17;24;0.0853658536585366;0.414634146341463
Control.SRR15539824;40;40;0.525;19;21;0.025;0.475
Control.SRR15539824;33;40;0.424242424242424;19;14;0.0757575757575757;0.424242424242424
Control.SRR15539824;42;40;0.547619047619048;19;23;0.0476190476190477;0.452380952380952
Control.SRR15539824;40;40;0.425;23;17;0.075;0.425
Control.SRR15539824;41;40;0.48780487804878;21;20;0.0121951219512195;0.48780487804878
Control.SRR15539824;40;40;0.4;24;16;0.1;0.4
Control.SRR15539824;37;40;0.594594594594595;15;22;0.0945945945945946;0.405405405405405
Control.SRR15539824;39;40;0.435897435897436;22;17;0.0641025641025641;0.435897435897436
Control.SRR15539824;35;40;0.457142857142857;19;16;0.0428571428571429;0.457142857142857
Control.SRR15539824;41;40;0.51219512195122;20;21;0.0121951219512195;0.48780487804878
Control.SRR15539824;36;40;0.527777777777778;17;19;0.0277777777777778;0.472222222222222
Control.SRR15539824;32;40;0.5;16;16;0;0.5
Control.SRR15539824;40;40;0.575;17;23;0.075;0.425
Control.SRR15539824;40;40;0.45;22;18;0.05;0.45
Control.SRR15539824;39;40;0.58974358974359;16;23;0.0897435897435898;0.41025641025641
Control.SRR15539824;38;40;0.447368421052632;21;17;0.0526315789473684;0.447368421052632
Control.SRR15539824;36;40;0.416666666666667;21;15;0.0833333333333333;0.416666666666667
Control.SRR15539824;41;40;0.560975609756098;18;23;0.0609756097560976;0.439024390243902
Control.SRR15539824;35;40;0.514285714285714;17;18;0.0142857142857142;0.485714285714286
Control.SRR15539824;40;40;0.475;21;19;0.025;0.475
Control.SRR15539824;40;40;0.6;16;24;0.1;0.4
Control.SRR15539824;42;40;0.428571428571429;24;18;0.0714285714285715;0.428571428571429
Control.SRR15539824;41;40;0.609756097560976;16;25;0.109756097560976;0.390243902439024
Control.SRR15539824;37;40;0.486486486486487;19;18;0.0135135135135135;0.486486486486487
Control.SRR15539824;33;40;0.424242424242424;19;14;0.0757575757575757;0.424242424242424
Control.SRR15539824;38;40;0.526315789473684;18;20;0.0263157894736842;0.473684210526316
Control.SRR15539824;37;40;0.459459459459459;20;17;0.0405405405405405;0.459459459459459
Control.SRR15539824;38;40;0.5;19;19;0;0.5
Control.SRR15539824;40;40;0.375;25;15;0.125;0.375
Control.SRR15539824;41;40;0.609756097560976;16;25;0.109756097560976;0.390243902439024
Control.SRR15539824;42;40;0.547619047619048;19;23;0.0476190476190477;0.452380952380952
Control.SRR15539824;33;40;0.575757575757576;14;19;0.0757575757575758;0.424242424242424
Control.SRR15539824;41;40;0.536585365853659;19;22;0.0365853658536586;0.463414634146341
Control.SRR15539824;41;40;0.414634146341463;24;17;0.0853658536585366;0.414634146341463
Control.SRR15539824;40;40;0.575;17;23;0.075;0.425
Control.SRR15539824;40;40;0.55;18;22;0.05;0.45
Control.SRR15539824;41;40;0.439024390243902;23;18;0.0609756097560976;0.439024390243902
Control.SRR15539824;33;40;0.606060606060606;13;20;0.106060606060606;0.393939393939394
Control.SRR15539824;36;40;0.527777777777778;17;19;0.0277777777777778;0.472222222222222
Control.SRR15539824;35;40;0.4;21;14;0.1;0.4
Control.SRR15539824;40;40;0.475;21;19;0.025;0.475
Control.SRR15539824;41;40;0.439024390243902;23;18;0.0609756097560976;0.439024390243902
Control.SRR15539824;36;40;0.527777777777778;17;19;0.0277777777777778;0.472222222222222
Control.SRR15539824;40;40;0.375;25;15;0.125;0.375
Control.SRR15539824;40;40;0.525;19;21;0.025;0.475
Control.SRR15539824;41;40;0.585365853658537;17;24;0.0853658536585366;0.414634146341463
Control.SRR15539824;40;40;0.425;23;17;0.075;0.425
Control.SRR15539824;37;40;0.486486486486487;19;18;0.0135135135135135;0.486486486486487
Control.SRR15539824;38;40;0.552631578947368;17;21;0.0526315789473685;0.447368421052632
Control.SRR15539824;39;40;0.461538461538462;21;18;0.0384615384615384;0.461538461538462
Control.SRR15539824;39;40;0.538461538461538;18;21;0.0384615384615384;0.461538461538462
Control.SRR15539824;38;40;0.421052631578947;22;16;0.0789473684210527;0.421052631578947
Control.SRR15539824;37;40;0.513513513513513;18;19;0.0135135135135135;0.486486486486487
Control.SRR15539824;35;40;0.428571428571429;20;15;0.0714285714285715;0.428571428571429
Control.SRR15539824;40;40;0.575;17;23;0.075;0.425
Control.SRR15539824;36;40;0.555555555555556;16;20;0.0555555555555556;0.444444444444444
Control.SRR15539824;41;40;0.463414634146341;22;19;0.0365853658536585;0.463414634146341
Control.SRR15539824;38;40;0.552631578947368;17;21;0.0526315789473685;0.447368421052632
Control.SRR15539824;39;40;0.461538461538462;21;18;0.0384615384615384;0.461538461538462
Control.SRR15539824;42;40;0.428571428571429;24;18;0.0714285714285715;0.428571428571429
Control.SRR15539824;39;40;0.461538461538462;21;18;0.0384615384615384;0.461538461538462
Control.SRR15539824;39;40;0.58974358974359;16;23;0.0897435897435898;0.41025641025641
Control.SRR15539824;42;40;0.5;21;21;0;0.5
Control.SRR15539824;42;40;0.619047619047619;16;26;0.119047619047619;0.380952380952381
Control.SRR15539824;35;40;0.542857142857143;16;19;0.0428571428571428;0.457142857142857
Control.SRR15539824;42;40;0.571428571428571;18;24;0.0714285714285714;0.428571428571429
Control.SRR15539824;39;40;0.487179487179487;20;19;0.0128205128205128;0.487179487179487
Control.SRR15539824;37;40;0.486486486486487;19;18;0.0135135135135135;0.486486486486487
Control.SRR15539824;42;40;0.380952380952381;26;16;0.119047619047619;0.380952380952381
Control.SRR15539824;41;40;0.439024390243902;23;18;0.0609756097560976;0.439024390243902
Control.SRR15539824;37;40;0.405405405405405;22;15;0.0945945945945946;0.405405405405405
Control.SRR15539824;33;40;0.575757575757576;14;19;0.0757575757575758;0.424242424242424
Control.SRR15539824;37;40;0.378378378378378;23;14;0.121621621621622;0.378378378378378
Control.SRR15539824;35;40;0.514285714285714;17;18;0.0142857142857142;0.485714285714286
Control.SRR15539824;36;40;0.638888888888889;13;23;0.138888888888889;0.361111111111111
Control.SRR15539824;38;40;0.421052631578947;22;16;0.0789473684210527;0.421052631578947
Control.SRR15539824;33;40;0.484848484848485;17;16;0.0151515151515151;0.484848484848485
Control.SRR15539824;41;40;0.560975609756098;18;23;0.0609756097560976;0.439024390243902
Control.SRR15539824;34;40;0.588235294117647;14;20;0.0882352941176471;0.411764705882353
Control.SRR15539824;40;40;0.425;23;17;0.075;0.425
Control.SRR15539824;42;40;0.380952380952381;26;16;0.119047619047619;0.380952380952381
Control.SRR15539824;42;40;0.571428571428571;18;24;0.0714285714285714;0.428571428571429
Control.SRR15539824;36;40;0.527777777777778;17;19;0.0277777777777778;0.472222222222222
Control.SRR15539824;36;40;0.527777777777778;17;19;0.0277777777777778;0.472222222222222
Control.SRR15539824;42;40;0.547619047619048;19;23;0.0476190476190477;0.452380952380952
Control.SRR15539824;36;40;0.527777777777778;17;19;0.0277777777777778;0.472222222222222
Control.SRR15539824;37;40;0.594594594594595;15;22;0.0945945945945946;0.405405405405405
Control.SRR15539824;38;40;0.342105263157895;25;13;0.157894736842105;0.342105263157895
Control.SRR15539824;37;40;0.486486486486487;19;18;0.0135135135135135;0.486486486486487
Control.SRR15539824;32;40;0.46875;17;15;0.03125;0.46875
Control.SRR15539824;42;40;0.380952380952381;26;16;0.119047619047619;0.380952380952381
Control.SRR15539824;32;40;0.53125;15;17;0.03125;0.46875
Control.SRR15539824;39;40;0.41025641025641;23;16;0.0897435897435898;0.41025641025641
Control.SRR15539824;40;40;0.625;15;25;0.125;0.375
Control.SRR15539824;40;40;0.55;18;22;0.05;0.45
Control.SRR15539824;34;40;0.529411764705882;16;18;0.0294117647058824;0.470588235294118
Control.SRR15539824;38;40;0.5;19;19;0;0.5
Control.SRR15539824;32;40;0.46875;17;15;0.03125;0.46875
Control.SRR15539824;39;40;0.487179487179487;20;19;0.0128205128205128;0.487179487179487
Control.SRR15539824;42;40;0.523809523809524;20;22;0.0238095238095238;0.476190476190476
Control.SRR15539824;41;40;0.51219512195122;20;21;0.0121951219512195;0.48780487804878
Control.SRR15539824;37;40;0.459459459459459;20;17;0.0405405405405405;0.459459459459459
Control.SRR15539824;40;40;0.525;19;21;0.025;0.475
Control.SRR15539824;42;40;0.476190476190476;22;20;0.0238095238095238;0.476190476190476
Control.SRR15539824;34;40;0.382352941176471;21;13;0.117647058823529;0.382352941176471
Control.SRR15539824;38;40;0.447368421052632;21;17;0.0526315789473684;0.447368421052632
Control.SRR15539824;39;40;0.41025641025641;23;16;0.0897435897435898;0.41025641025641
Control.SRR15539824;41;40;0.463414634146341;22;19;0.0365853658536585;0.463414634146341
Control.SRR15539824;41;40;0.51219512195122;20;21;0.0121951219512195;0.48780487804878
Control.SRR15539824;39;40;0.358974358974359;25;14;0.141025641025641;0.358974358974359
Control.SRR15539824;42;40;0.404761904761905;25;17;0.0952380952380952;0.404761904761905
Control.SRR15539824;39;40;0.435897435897436;22;17;0.0641025641025641;0.435897435897436
Control.SRR15539824;37;40;0.486486486486487;19;18;0.0135135135135135;0.486486486486487
Control.SRR15539824;42;40;0.595238095238095;17;25;0.0952380952380952;0.404761904761905
Control.SRR15539824;36;40;0.527777777777778;17;19;0.0277777777777778;0.472222222222222
Control.SRR15539824;40;40;0.45;22;18;0.05;0.45
Control.SRR15539824;36;40;0.444444444444444;20;16;0.0555555555555556;0.444444444444444
Control.SRR15539824;37;40;0.540540540540541;17;20;0.0405405405405406;0.459459459459459
Control.SRR15539824;40;40;0.65;14;26;0.15;0.35
Control.SRR15539824;37;40;0.648648648648649;13;24;0.148648648648649;0.351351351351351
Control.SRR15539824;33;40;0.393939393939394;20;13;0.106060606060606;0.393939393939394
Control.SRR15539824;41;40;0.463414634146341;22;19;0.0365853658536585;0.463414634146341
Control.SRR15539824;37;40;0.378378378378378;23;14;0.121621621621622;0.378378378378378
Control.SRR15539824;38;40;0.552631578947368;17;21;0.0526315789473685;0.447368421052632
Control.SRR15539824;40;40;0.425;23;17;0.075;0.425
Control.SRR15539824;39;40;0.538461538461538;18;21;0.0384615384615384;0.461538461538462
Control.SRR15539824;39;40;0.538461538461538;18;21;0.0384615384615384;0.461538461538462
Control.SRR15539824;35;40;0.6;14;21;0.1;0.4
Control.SRR15539824;37;40;0.594594594594595;15;22;0.0945945945945946;0.405405405405405
Control.SRR15539824;37;40;0.513513513513513;18;19;0.0135135135135135;0.486486486486487
Control.SRR15539824;36;40;0.583333333333333;15;21;0.0833333333333334;0.416666666666667
Control.SRR15539824;37;40;0.405405405405405;22;15;0.0945945945945946;0.405405405405405
Control.SRR15539824;38;40;0.526315789473684;18;20;0.0263157894736842;0.473684210526316
Control.SRR15539824;33;40;0.484848484848485;17;16;0.0151515151515151;0.484848484848485
Control.SRR15539824;37;40;0.567567567567568;16;21;0.0675675675675675;0.432432432432432
Control.SRR15539824;36;40;0.5;18;18;0;0.5
Control.SRR15539824;40;40;0.525;19;21;0.025;0.475
Control.SRR15539824;32;40;0.59375;13;19;0.09375;0.40625
Control.SRR15539824;35;40;0.457142857142857;19;16;0.0428571428571429;0.457142857142857
Control.SRR15539824;32;40;0.46875;17;15;0.03125;0.46875
Control.SRR15539824;39;40;0.487179487179487;20;19;0.0128205128205128;0.487179487179487
Control.SRR15539824;35;40;0.514285714285714;17;18;0.0142857142857142;0.485714285714286
Control.SRR15539824;38;40;0.473684210526316;20;18;0.0263157894736842;0.473684210526316
Control.SRR15539824;40;40;0.45;22;18;0.05;0.45
Control.SRR15539824;37;40;0.459459459459459;20;17;0.0405405405405405;0.459459459459459
Control.SRR15539824;36;40;0.444444444444444;20;16;0.0555555555555556;0.444444444444444
Control.SRR15539824;32;40;0.53125;15;17;0.03125;0.46875
Control.SRR15539824;34;40;0.5;17;17;0;0.5
Control.SRR15539824;32;40;0.625;12;20;0.125;0.375
Control.SRR15539824;40;40;0.525;19;21;0.025;0.475
Control.SRR15539824;39;40;0.538461538461538;18;21;0.0384615384615384;0.461538461538462
Control.SRR15539824;42;40;0.428571428571429;24;18;0.0714285714285715;0.428571428571429
Control.SRR15539824;40;40;0.475;21;19;0.025;0.475
Control.SRR15539824;37;40;0.486486486486487;19;18;0.0135135135135135;0.486486486486487
Control.SRR15539824;40;40;0.55;18;22;0.05;0.45
Control.SRR15539824;40;40;0.525;19;21;0.025;0.475
Control.SRR15539824;42;40;0.547619047619048;19;23;0.0476190476190477;0.452380952380952
Control.SRR15539824;40;40;0.6;16;24;0.1;0.4
Control.SRR15539824;40;40;0.575;17;23;0.075;0.425
Control.SRR15539824;41;40;0.463414634146341;22;19;0.0365853658536585;0.463414634146341
Control.SRR15539824;39;40;0.384615384615385;24;15;0.115384615384615;0.384615384615385
Control.SRR15539824;33;40;0.545454545454545;15;18;0.0454545454545454;0.454545454545455
Control.SRR15539824;38;40;0.526315789473684;18;20;0.0263157894736842;0.473684210526316
Control.SRR15539824;34;40;0.470588235294118;18;16;0.0294117647058824;0.470588235294118
Control.SRR15539824;33;40;0.575757575757576;14;19;0.0757575757575758;0.424242424242424
Control.SRR15539824;42;40;0.452380952380952;23;19;0.0476190476190476;0.452380952380952
Control.SRR15539824;39;40;0.435897435897436;22;17;0.0641025641025641;0.435897435897436
Control.SRR15539824;40;40;0.475;21;19;0.025;0.475
Control.SRR15539824;34;40;0.588235294117647;14;20;0.0882352941176471;0.411764705882353
Control.SRR15539824;32;40;0.5;16;16;0;0.5
Control.SRR15539824;41;40;0.439024390243902;23;18;0.0609756097560976;0.439024390243902
Control.SRR15539824;42;40;0.5;21;21;0;0.5
Control.SRR15539824;35;40;0.457142857142857;19;16;0.0428571428571429;0.457142857142857
Control.SRR15539824;34;40;0.470588235294118;18;16;0.0294117647058824;0.470588235294118
Control.SRR15539824;36;40;0.611111111111111;14;22;0.111111111111111;0.388888888888889
Control.SRR15539824;40;40;0.5;20;20;0;0.5
Control.SRR15539824;34;40;0.470588235294118;18;16;0.0294117647058824;0.470588235294118
Control.SRR15539824;35;40;0.628571428571429;13;22;0.128571428571429;0.371428571428571
Control.SRR15539824;38;40;0.394736842105263;23;15;0.105263157894737;0.394736842105263
Control.SRR15539824;40;40;0.425;23;17;0.075;0.425
Control.SRR15539824;39;40;0.512820512820513;19;20;0.0128205128205128;0.487179487179487
Control.SRR15539824;37;40;0.486486486486487;19;18;0.0135135135135135;0.486486486486487
Control.SRR15539824;32;40;0.46875;17;15;0.03125;0.46875
Control.SRR15539824;35;40;0.514285714285714;17;18;0.0142857142857142;0.485714285714286
Control.SRR15539824;33;40;0.393939393939394;20;13;0.106060606060606;0.393939393939394
Control.SRR15539824;33;40;0.545454545454545;15;18;0.0454545454545454;0.454545454545455
Control.SRR15539824;32;40;0.625;12;20;0.125;0.375
Control.SRR15539824;32;40;0.53125;15;17;0.03125;0.46875
Control.SRR15539824;32;40;0.53125;15;17;0.03125;0.46875
Control.SRR15539824;33;40;0.393939393939394;20;13;0.106060606060606;0.393939393939394
Control.SRR15539824;37;40;0.540540540540541;17;20;0.0405405405405406;0.459459459459459
Control.SRR15539824;35;40;0.4;21;14;0.1;0.4
Control.SRR15539824;33;40;0.484848484848485;17;16;0.0151515151515151;0.484848484848485
Control.SRR15539824;37;40;0.540540540540541;17;20;0.0405405405405406;0.459459459459459
Control.SRR15539824;37;40;0.405405405405405;22;15;0.0945945945945946;0.405405405405405
Control.SRR15539824;37;40;0.540540540540541;17;20;0.0405405405405406;0.459459459459459
Control.SRR15539824;36;40;0.472222222222222;19;17;0.0277777777777778;0.472222222222222
Control.SRR15539824;40;40;0.55;18;22;0.05;0.45
Control.SRR15539824;35;40;0.457142857142857;19;16;0.0428571428571429;0.457142857142857
Control.SRR15539824;42;40;0.404761904761905;25;17;0.0952380952380952;0.404761904761905
Control.SRR15539824;34;40;0.382352941176471;21;13;0.117647058823529;0.382352941176471
Control.SRR15539824;40;40;0.5;20;20;0;0.5
Control.SRR15539824;35;40;0.657142857142857;12;23;0.157142857142857;0.342857142857143
Control.SRR15539824;35;40;0.4;21;14;0.1;0.4
Control.SRR15539824;36;40;0.472222222222222;19;17;0.0277777777777778;0.472222222222222
Control.SRR15539824;33;40;0.363636363636364;21;12;0.136363636363636;0.363636363636364
Control.SRR15539824;42;40;0.571428571428571;18;24;0.0714285714285714;0.428571428571429
Control.SRR15539824;36;40;0.472222222222222;19;17;0.0277777777777778;0.472222222222222
Control.SRR15539824;39;40;0.435897435897436;22;17;0.0641025641025641;0.435897435897436
Control.SRR15539824;35;40;0.542857142857143;16;19;0.0428571428571428;0.457142857142857
Control.SRR15539824;33;40;0.454545454545455;18;15;0.0454545454545455;0.454545454545455
Control.SRR15539824;42;40;0.571428571428571;18;24;0.0714285714285714;0.428571428571429
Control.SRR15539824;39;40;0.564102564102564;17;22;0.0641025641025641;0.435897435897436
Control.SRR15539824;42;40;0.595238095238095;17;25;0.0952380952380952;0.404761904761905
Control.SRR15539824;34;40;0.470588235294118;18;16;0.0294117647058824;0.470588235294118
Control.SRR15539824;37;40;0.648648648648649;13;24;0.148648648648649;0.351351351351351
Control.SRR15539824;35;40;0.514285714285714;17;18;0.0142857142857142;0.485714285714286
Control.SRR15539824;34;40;0.617647058823529;13;21;0.117647058823529;0.382352941176471
Control.SRR15539824;34;40;0.5;17;17;0;0.5
Control.SRR15539824;40;40;0.375;25;15;0.125;0.375
Control.SRR15539824;40;40;0.425;23;17;0.075;0.425
Control.SRR15539824;41;40;0.463414634146341;22;19;0.0365853658536585;0.463414634146341
Control.SRR15539824;33;40;0.333333333333333;22;11;0.166666666666667;0.333333333333333
Control.SRR15539824;35;40;0.4;21;14;0.1;0.4
Control.SRR15539824;42;40;0.428571428571429;24;18;0.0714285714285715;0.428571428571429
Control.SRR15539824;40;40;0.45;22;18;0.05;0.45
Control.SRR15539824;37;40;0.405405405405405;22;15;0.0945945945945946;0.405405405405405
Control.SRR15539824;33;40;0.454545454545455;18;15;0.0454545454545455;0.454545454545455
Control.SRR15539824;37;40;0.432432432432432;21;16;0.0675675675675675;0.432432432432432
Control.SRR15539824;40;40;0.575;17;23;0.075;0.425
Control.SRR15539824;42;40;0.642857142857143;15;27;0.142857142857143;0.357142857142857
Control.SRR15539824;39;40;0.512820512820513;19;20;0.0128205128205128;0.487179487179487
Control.SRR15539824;40;40;0.675;13;27;0.175;0.325
Control.SRR15539824;40;40;0.525;19;21;0.025;0.475
Control.SRR15539824;41;40;0.414634146341463;24;17;0.0853658536585366;0.414634146341463
Control.SRR15539824;40;40;0.45;22;18;0.05;0.45
Control.SRR15539824;33;40;0.454545454545455;18;15;0.0454545454545455;0.454545454545455
Control.SRR15539824;38;40;0.473684210526316;20;18;0.0263157894736842;0.473684210526316
Control.SRR15539824;39;40;0.461538461538462;21;18;0.0384615384615384;0.461538461538462
Control.SRR15539824;32;40;0.625;12;20;0.125;0.375
Control.SRR15539824;40;40;0.55;18;22;0.05;0.45
Control.SRR15539824;42;40;0.428571428571429;24;18;0.0714285714285715;0.428571428571429
Control.SRR15539824;39;40;0.41025641025641;23;16;0.0897435897435898;0.41025641025641
Control.SRR15539824;39;40;0.41025641025641;23;16;0.0897435897435898;0.41025641025641
Control.SRR15539824;35;40;0.457142857142857;19;16;0.0428571428571429;0.457142857142857
Control.SRR15539824;33;40;0.545454545454545;15;18;0.0454545454545454;0.454545454545455
Control.SRR15539824;40;40;0.5;20;20;0;0.5
Control.SRR15539824;39;40;0.564102564102564;17;22;0.0641025641025641;0.435897435897436
Control.SRR15539824;41;40;0.609756097560976;16;25;0.109756097560976;0.390243902439024
Control.SRR15539824;40;40;0.525;19;21;0.025;0.475
Control.SRR15539824;33;40;0.515151515151515;16;17;0.0151515151515151;0.484848484848485
Control.SRR15539824;39;40;0.58974358974359;16;23;0.0897435897435898;0.41025641025641
Control.SRR15539824;36;40;0.472222222222222;19;17;0.0277777777777778;0.472222222222222
Control.SRR15539824;32;40;0.59375;13;19;0.09375;0.40625
Control.SRR15539824;39;40;0.461538461538462;21;18;0.0384615384615384;0.461538461538462
Control.SRR15539824;40;40;0.4;24;16;0.1;0.4
Control.SRR15539824;41;40;0.609756097560976;16;25;0.109756097560976;0.390243902439024
Control.SRR15539824;34;40;0.617647058823529;13;21;0.117647058823529;0.382352941176471
Control.SRR15539824;33;40;0.606060606060606;13;20;0.106060606060606;0.393939393939394
Control.SRR15539824;42;40;0.5;21;21;0;0.5
Control.SRR15539824;37;40;0.432432432432432;21;16;0.0675675675675675;0.432432432432432
Control.SRR15539824;37;40;0.513513513513513;18;19;0.0135135135135135;0.486486486486487
Control.SRR15539824;40;40;0.6;16;24;0.1;0.4
Control.SRR15539824;36;40;0.416666666666667;21;15;0.0833333333333333;0.416666666666667
Control.SRR15539824;40;40;0.425;23;17;0.075;0.425
Control.SRR15539824;32;40;0.59375;13;19;0.09375;0.40625
Control.SRR15539824;40;40;0.425;23;17;0.075;0.425
Control.SRR15539824;40;40;0.525;19;21;0.025;0.475
Control.SRR15539824;42;40;0.595238095238095;17;25;0.0952380952380952;0.404761904761905
Control.SRR15539824;40;40;0.525;19;21;0.025;0.475
Control.SRR15539824;35;40;0.571428571428571;15;20;0.0714285714285714;0.428571428571429
Control.SRR15539824;38;40;0.473684210526316;20;18;0.0263157894736842;0.473684210526316
Control.SRR15539824;41;40;0.439024390243902;23;18;0.0609756097560976;0.439024390243902
Control.SRR15539824;37;40;0.378378378378378;23;14;0.121621621621622;0.378378378378378
Control.SRR15539824;34;40;0.5;17;17;0;0.5
Control.SRR15539824;38;40;0.526315789473684;18;20;0.0263157894736842;0.473684210526316
Control.SRR15539824;34;40;0.470588235294118;18;16;0.0294117647058824;0.470588235294118
Control.SRR15539824;38;40;0.473684210526316;20;18;0.0263157894736842;0.473684210526316
Control.SRR15539824;39;40;0.384615384615385;24;15;0.115384615384615;0.384615384615385
Control.SRR15539824;40;40;0.65;14;26;0.15;0.35
Control.SRR15539824;42;40;0.571428571428571;18;24;0.0714285714285714;0.428571428571429
Control.SRR15539824;37;40;0.459459459459459;20;17;0.0405405405405405;0.459459459459459
Control.SRR15539824;32;40;0.40625;19;13;0.09375;0.40625
Control.SRR15539824;39;40;0.461538461538462;21;18;0.0384615384615384;0.461538461538462
Control.SRR15539824;35;40;0.571428571428571;15;20;0.0714285714285714;0.428571428571429
Control.SRR15539824;42;40;0.69047619047619;13;29;0.19047619047619;0.30952380952381
Control.SRR15539824;36;40;0.527777777777778;17;19;0.0277777777777778;0.472222222222222
Control.SRR15539824;36;40;0.444444444444444;20;16;0.0555555555555556;0.444444444444444
Control.SRR15539824;42;40;0.285714285714286;30;12;0.214285714285714;0.285714285714286
Control.SRR15539824;36;40;0.583333333333333;15;21;0.0833333333333334;0.416666666666667
Control.SRR15539824;38;40;0.578947368421053;16;22;0.0789473684210527;0.421052631578947
Control.SRR15539824;39;40;0.564102564102564;17;22;0.0641025641025641;0.435897435897436
Control.SRR15539824;32;40;0.4375;18;14;0.0625;0.4375
Control.SRR15539824;32;40;0.53125;15;17;0.03125;0.46875
Control.SRR15539824;40;40;0.45;22;18;0.05;0.45
Control.SRR15539824;34;40;0.411764705882353;20;14;0.0882352941176471;0.411764705882353
Control.SRR15539824;42;40;0.380952380952381;26;16;0.119047619047619;0.380952380952381
Control.SRR15539824;41;40;0.609756097560976;16;25;0.109756097560976;0.390243902439024
Control.SRR15539824;42;40;0.5;21;21;0;0.5
Control.SRR15539824;34;40;0.558823529411765;15;19;0.0588235294117647;0.441176470588235
Control.SRR15539824;41;40;0.390243902439024;25;16;0.109756097560976;0.390243902439024
Control.SRR15539824;38;40;0.526315789473684;18;20;0.0263157894736842;0.473684210526316
Control.SRR15539824;38;40;0.5;19;19;0;0.5
Control.SRR15539824;36;40;0.416666666666667;21;15;0.0833333333333333;0.416666666666667
Control.SRR15539824;39;40;0.333333333333333;26;13;0.166666666666667;0.333333333333333
Control.SRR15539824;41;40;0.390243902439024;25;16;0.109756097560976;0.390243902439024
Control.SRR15539824;40;40;0.525;19;21;0.025;0.475
Control.SRR15539824;37;40;0.432432432432432;21;16;0.0675675675675675;0.432432432432432
Control.SRR15539824;39;40;0.538461538461538;18;21;0.0384615384615384;0.461538461538462
Control.SRR15539824;40;40;0.45;22;18;0.05;0.45
Control.SRR15539824;38;40;0.447368421052632;21;17;0.0526315789473684;0.447368421052632
Control.SRR15539824;39;40;0.461538461538462;21;18;0.0384615384615384;0.461538461538462
Control.SRR15539824;38;40;0.447368421052632;21;17;0.0526315789473684;0.447368421052632
Control.SRR15539824;33;40;0.636363636363636;12;21;0.136363636363636;0.363636363636364
Control.SRR15539824;35;40;0.571428571428571;15;20;0.0714285714285714;0.428571428571429
Control.SRR15539824;37;40;0.486486486486487;19;18;0.0135135135135135;0.486486486486487
Control.SRR15539824;41;40;0.585365853658537;17;24;0.0853658536585366;0.414634146341463
Control.SRR15539824;36;40;0.333333333333333;24;12;0.166666666666667;0.333333333333333
Control.SRR15539824;33;40;0.575757575757576;14;19;0.0757575757575758;0.424242424242424
Control.SRR15539824;33;40;0.666666666666667;11;22;0.166666666666667;0.333333333333333
Control.SRR15539824;40;40;0.525;19;21;0.025;0.475
Control.SRR15539824;42;40;0.5;21;21;0;0.5
Control.SRR15539824;42;40;0.380952380952381;26;16;0.119047619047619;0.380952380952381
Control.SRR15539824;34;40;0.382352941176471;21;13;0.117647058823529;0.382352941176471
Control.SRR15539824;32;40;0.375;20;12;0.125;0.375
Control.SRR15539824;36;40;0.444444444444444;20;16;0.0555555555555556;0.444444444444444
Control.SRR15539824;33;40;0.484848484848485;17;16;0.0151515151515151;0.484848484848485
Control.SRR15539824;35;40;0.514285714285714;17;18;0.0142857142857142;0.485714285714286
Control.SRR15539824;40;40;0.425;23;17;0.075;0.425
Control.SRR15539824;41;40;0.439024390243902;23;18;0.0609756097560976;0.439024390243902
Control.SRR15539824;36;40;0.638888888888889;13;23;0.138888888888889;0.361111111111111
Control.SRR15539824;32;40;0.5;16;16;0;0.5
Control.SRR15539824;36;40;0.361111111111111;23;13;0.138888888888889;0.361111111111111
Control.SRR15539824;37;40;0.405405405405405;22;15;0.0945945945945946;0.405405405405405
Control.SRR15539824;34;40;0.441176470588235;19;15;0.0588235294117647;0.441176470588235
Control.SRR15539824;38;40;0.421052631578947;22;16;0.0789473684210527;0.421052631578947
Control.SRR15539824;40;40;0.55;18;22;0.05;0.45
Control.SRR15539824;42;40;0.452380952380952;23;19;0.0476190476190476;0.452380952380952
Control.SRR15539824;34;40;0.411764705882353;20;14;0.0882352941176471;0.411764705882353
Control.SRR15539824;32;40;0.53125;15;17;0.03125;0.46875
Control.SRR15539824;33;40;0.545454545454545;15;18;0.0454545454545454;0.454545454545455
Control.SRR15539824;40;40;0.425;23;17;0.075;0.425
Control.SRR15539824;34;40;0.470588235294118;18;16;0.0294117647058824;0.470588235294118
Control.SRR15539824;38;40;0.526315789473684;18;20;0.0263157894736842;0.473684210526316
Control.SRR15539824;39;40;0.512820512820513;19;20;0.0128205128205128;0.487179487179487
Control.SRR15539824;35;40;0.685714285714286;11;24;0.185714285714286;0.314285714285714
Control.SRR15539824;41;40;0.536585365853659;19;22;0.0365853658536586;0.463414634146341
Control.SRR15539824;42;40;0.380952380952381;26;16;0.119047619047619;0.380952380952381
Control.SRR15539824;42;40;0.619047619047619;16;26;0.119047619047619;0.380952380952381
Control.SRR15539824;37;40;0.432432432432432;21;16;0.0675675675675675;0.432432432432432
Control.SRR15539824;37;40;0.513513513513513;18;19;0.0135135135135135;0.486486486486487
Control.SRR15539824;34;40;0.558823529411765;15;19;0.0588235294117647;0.441176470588235
Control.SRR15539824;34;40;0.558823529411765;15;19;0.0588235294117647;0.441176470588235
Control.SRR15539824;39;40;0.641025641025641;14;25;0.141025641025641;0.358974358974359
Control.SRR15539824;34;40;0.352941176470588;22;12;0.147058823529412;0.352941176470588
Control.SRR15539824;37;40;0.594594594594595;15;22;0.0945945945945946;0.405405405405405
Control.SRR15539824;35;40;0.371428571428571;22;13;0.128571428571429;0.371428571428571
Control.SRR15539824;33;40;0.515151515151515;16;17;0.0151515151515151;0.484848484848485
Control.SRR15539824;36;40;0.555555555555556;16;20;0.0555555555555556;0.444444444444444
Control.SRR15539824;39;40;0.461538461538462;21;18;0.0384615384615384;0.461538461538462
Control.SRR15539824;34;40;0.5;17;17;0;0.5
Control.SRR15539824;38;40;0.526315789473684;18;20;0.0263157894736842;0.473684210526316
Control.SRR15539824;34;40;0.529411764705882;16;18;0.0294117647058824;0.470588235294118
Control.SRR15539824;34;40;0.529411764705882;16;18;0.0294117647058824;0.470588235294118
Control.SRR15539824;33;40;0.575757575757576;14;19;0.0757575757575758;0.424242424242424
Control.SRR15539824;33;40;0.363636363636364;21;12;0.136363636363636;0.363636363636364
Control.SRR15539824;32;40;0.40625;19;13;0.09375;0.40625
Control.SRR15539824;35;40;0.457142857142857;19;16;0.0428571428571429;0.457142857142857
Control.SRR15539824;41;40;0.585365853658537;17;24;0.0853658536585366;0.414634146341463
Control.SRR15539824;40;40;0.5;20;20;0;0.5
Control.SRR15539824;37;40;0.459459459459459;20;17;0.0405405405405405;0.459459459459459
Control.SRR15539824;37;40;0.540540540540541;17;20;0.0405405405405406;0.459459459459459
Control.SRR15539824;42;40;0.595238095238095;17;25;0.0952380952380952;0.404761904761905
Control.SRR15539824;39;40;0.435897435897436;22;17;0.0641025641025641;0.435897435897436
Control.SRR15539824;41;40;0.51219512195122;20;21;0.0121951219512195;0.48780487804878
Control.SRR15539824;36;40;0.555555555555556;16;20;0.0555555555555556;0.444444444444444
Control.SRR15539824;40;40;0.525;19;21;0.025;0.475
Control.SRR15539824;38;40;0.447368421052632;21;17;0.0526315789473684;0.447368421052632
Control.SRR15539824;34;40;0.5;17;17;0;0.5
Control.SRR15539824;32;40;0.46875;17;15;0.03125;0.46875
Control.SRR15539824;32;40;0.53125;15;17;0.03125;0.46875
Control.SRR15539824;36;40;0.583333333333333;15;21;0.0833333333333334;0.416666666666667
Control.SRR15539824;37;40;0.378378378378378;23;14;0.121621621621622;0.378378378378378
Control.SRR15539824;36;40;0.611111111111111;14;22;0.111111111111111;0.388888888888889
Control.SRR15539824;41;40;0.707317073170732;12;29;0.207317073170732;0.292682926829268
Control.SRR15539824;42;40;0.333333333333333;28;14;0.166666666666667;0.333333333333333
Control.SRR15539824;39;40;0.564102564102564;17;22;0.0641025641025641;0.435897435897436
Control.SRR15539824;41;40;0.48780487804878;21;20;0.0121951219512195;0.48780487804878
Control.SRR15539824;42;40;0.523809523809524;20;22;0.0238095238095238;0.476190476190476
Control.SRR15539824;40;40;0.55;18;22;0.05;0.45
Control.SRR15539824;36;40;0.472222222222222;19;17;0.0277777777777778;0.472222222222222
Control.SRR15539824;34;40;0.382352941176471;21;13;0.117647058823529;0.382352941176471
Control.SRR15539824;33;40;0.424242424242424;19;14;0.0757575757575757;0.424242424242424
Control.SRR15539824;32;40;0.5;16;16;0;0.5
Control.SRR15539824;35;40;0.542857142857143;16;19;0.0428571428571428;0.457142857142857
Control.SRR15539824;40;40;0.675;13;27;0.175;0.325
Control.SRR15539824;42;40;0.404761904761905;25;17;0.0952380952380952;0.404761904761905
Control.SRR15539824;39;40;0.512820512820513;19;20;0.0128205128205128;0.487179487179487
Control.SRR15539824;32;40;0.625;12;20;0.125;0.375
Control.SRR15539824;36;40;0.5;18;18;0;0.5
Control.SRR15539824;41;40;0.439024390243902;23;18;0.0609756097560976;0.439024390243902
Control.SRR15539824;34;40;0.441176470588235;19;15;0.0588235294117647;0.441176470588235
Control.SRR15539824;33;40;0.333333333333333;22;11;0.166666666666667;0.333333333333333
Control.SRR15539824;33;40;0.545454545454545;15;18;0.0454545454545454;0.454545454545455
Control.SRR15539824;40;40;0.625;15;25;0.125;0.375
Control.SRR15539824;33;40;0.545454545454545;15;18;0.0454545454545454;0.454545454545455
Control.SRR15539824;32;40;0.3125;22;10;0.1875;0.3125
Control.SRR15539824;36;40;0.583333333333333;15;21;0.0833333333333334;0.416666666666667
Control.SRR15539824;37;40;0.567567567567568;16;21;0.0675675675675675;0.432432432432432
Control.SRR15539824;35;40;0.485714285714286;18;17;0.0142857142857143;0.485714285714286
Control.SRR15539824;39;40;0.615384615384615;15;24;0.115384615384615;0.384615384615385
Control.SRR15539824;35;40;0.428571428571429;20;15;0.0714285714285715;0.428571428571429
Control.SRR15539824;41;40;0.365853658536585;26;15;0.134146341463415;0.365853658536585
Control.SRR15539824;35;40;0.485714285714286;18;17;0.0142857142857143;0.485714285714286
Control.SRR15539824;36;40;0.333333333333333;24;12;0.166666666666667;0.333333333333333
Control.SRR15539824;33;40;0.484848484848485;17;16;0.0151515151515151;0.484848484848485
Control.SRR15539824;38;40;0.473684210526316;20;18;0.0263157894736842;0.473684210526316
Control.SRR15539824;34;40;0.529411764705882;16;18;0.0294117647058824;0.470588235294118
Control.SRR15539824;42;40;0.523809523809524;20;22;0.0238095238095238;0.476190476190476
Control.SRR15539824;33;40;0.484848484848485;17;16;0.0151515151515151;0.484848484848485
Control.SRR15539824;41;40;0.536585365853659;19;22;0.0365853658536586;0.463414634146341
Control.SRR15539824;33;40;0.666666666666667;11;22;0.166666666666667;0.333333333333333
Control.SRR15539824;37;40;0.594594594594595;15;22;0.0945945945945946;0.405405405405405
Control.SRR15539824;39;40;0.435897435897436;22;17;0.0641025641025641;0.435897435897436
Control.SRR15539824;32;40;0.53125;15;17;0.03125;0.46875
Control.SRR15539824;32;40;0.375;20;12;0.125;0.375
Control.SRR15539824;35;40;0.542857142857143;16;19;0.0428571428571428;0.457142857142857
Control.SRR15539824;38;40;0.5;19;19;0;0.5
Control.SRR15539824;35;40;0.485714285714286;18;17;0.0142857142857143;0.485714285714286
Control.SRR15539824;36;40;0.555555555555556;16;20;0.0555555555555556;0.444444444444444
Control.SRR15539824;41;40;0.390243902439024;25;16;0.109756097560976;0.390243902439024
Control.SRR15539824;38;40;0.447368421052632;21;17;0.0526315789473684;0.447368421052632
Control.SRR15539824;34;40;0.441176470588235;19;15;0.0588235294117647;0.441176470588235
Control.SRR15539824;34;40;0.323529411764706;23;11;0.176470588235294;0.323529411764706
Control.SRR15539824;37;40;0.432432432432432;21;16;0.0675675675675675;0.432432432432432
Control.SRR15539824;42;40;0.5;21;21;0;0.5
Control.SRR15539824;33;40;0.454545454545455;18;15;0.0454545454545455;0.454545454545455
Control.SRR15539824;38;40;0.394736842105263;23;15;0.105263157894737;0.394736842105263
Control.SRR15539824;41;40;0.414634146341463;24;17;0.0853658536585366;0.414634146341463
Control.SRR15539824;42;40;0.5;21;21;0;0.5
Control.SRR15539824;33;40;0.515151515151515;16;17;0.0151515151515151;0.484848484848485
Control.SRR15539824;36;40;0.388888888888889;22;14;0.111111111111111;0.388888888888889
Control.SRR15539824;38;40;0.5;19;19;0;0.5
Control.SRR15539824;33;40;0.575757575757576;14;19;0.0757575757575758;0.424242424242424
Control.SRR15539824;39;40;0.41025641025641;23;16;0.0897435897435898;0.41025641025641
Control.SRR15539824;36;40;0.555555555555556;16;20;0.0555555555555556;0.444444444444444
Control.SRR15539824;38;40;0.552631578947368;17;21;0.0526315789473685;0.447368421052632
Control.SRR15539824;36;40;0.638888888888889;13;23;0.138888888888889;0.361111111111111
Control.SRR15539824;37;40;0.432432432432432;21;16;0.0675675675675675;0.432432432432432
Control.SRR15539824;40;40;0.575;17;23;0.075;0.425
Control.SRR15539824;39;40;0.512820512820513;19;20;0.0128205128205128;0.487179487179487
Control.SRR15539824;33;40;0.393939393939394;20;13;0.106060606060606;0.393939393939394
Control.SRR15539824;35;40;0.714285714285714;10;25;0.214285714285714;0.285714285714286
Control.SRR15539824;36;40;0.555555555555556;16;20;0.0555555555555556;0.444444444444444
Control.SRR15539824;32;40;0.59375;13;19;0.09375;0.40625
Control.SRR15539824;33;40;0.575757575757576;14;19;0.0757575757575758;0.424242424242424
Control.SRR15539824;37;40;0.702702702702703;11;26;0.202702702702703;0.297297297297297
Control.SRR15539824;36;40;0.5;18;18;0;0.5
Control.SRR15539824;35;40;0.371428571428571;22;13;0.128571428571429;0.371428571428571
Control.SRR15539824;40;40;0.375;25;15;0.125;0.375
Control.SRR15539824;34;40;0.617647058823529;13;21;0.117647058823529;0.382352941176471
Control.SRR15539824;37;40;0.513513513513513;18;19;0.0135135135135135;0.486486486486487
Control.SRR15539824;35;40;0.457142857142857;19;16;0.0428571428571429;0.457142857142857
Control.SRR15539824;37;40;0.513513513513513;18;19;0.0135135135135135;0.486486486486487
Control.SRR15539824;39;40;0.641025641025641;14;25;0.141025641025641;0.358974358974359
Control.SRR15539824;34;40;0.558823529411765;15;19;0.0588235294117647;0.441176470588235
Control.SRR15539824;42;40;0.476190476190476;22;20;0.0238095238095238;0.476190476190476
Control.SRR15539824;32;40;0.375;20;12;0.125;0.375
Control.SRR15539824;34;40;0.5;17;17;0;0.5
Control.SRR15539824;37;40;0.594594594594595;15;22;0.0945945945945946;0.405405405405405
Control.SRR15539824;38;40;0.710526315789474;11;27;0.210526315789474;0.289473684210526
Control.SRR15539824;33;40;0.393939393939394;20;13;0.106060606060606;0.393939393939394
Control.SRR15539824;39;40;0.358974358974359;25;14;0.141025641025641;0.358974358974359
Control.SRR15539824;37;40;0.432432432432432;21;16;0.0675675675675675;0.432432432432432
Control.SRR15539824;37;40;0.567567567567568;16;21;0.0675675675675675;0.432432432432432
Control.SRR15539824;34;40;0.382352941176471;21;13;0.117647058823529;0.382352941176471
Control.SRR15539824;37;40;0.513513513513513;18;19;0.0135135135135135;0.486486486486487
Control.SRR15539824;39;40;0.435897435897436;22;17;0.0641025641025641;0.435897435897436
Control.SRR15539824;41;40;0.585365853658537;17;24;0.0853658536585366;0.414634146341463
Control.SRR15539824;33;40;0.545454545454545;15;18;0.0454545454545454;0.454545454545455
Control.SRR15539824;35;40;0.457142857142857;19;16;0.0428571428571429;0.457142857142857
Control.SRR15539824;34;40;0.382352941176471;21;13;0.117647058823529;0.382352941176471
Control.SRR15539824;37;40;0.351351351351351;24;13;0.148648648648649;0.351351351351351
Control.SRR15539824;35;40;0.428571428571429;20;15;0.0714285714285715;0.428571428571429
Control.SRR15539824;41;40;0.48780487804878;21;20;0.0121951219512195;0.48780487804878
Control.SRR15539824;35;40;0.428571428571429;20;15;0.0714285714285715;0.428571428571429
Control.SRR15539824;41;40;0.414634146341463;24;17;0.0853658536585366;0.414634146341463
Control.SRR15539824;38;40;0.368421052631579;24;14;0.131578947368421;0.368421052631579
Control.SRR15539824;38;40;0.578947368421053;16;22;0.0789473684210527;0.421052631578947
Control.SRR15539824;39;40;0.487179487179487;20;19;0.0128205128205128;0.487179487179487
Control.SRR15539824;39;40;0.564102564102564;17;22;0.0641025641025641;0.435897435897436
Control.SRR15539824;37;40;0.567567567567568;16;21;0.0675675675675675;0.432432432432432
Control.SRR15539824;35;40;0.485714285714286;18;17;0.0142857142857143;0.485714285714286
Control.SRR15539824;34;40;0.588235294117647;14;20;0.0882352941176471;0.411764705882353
Control.SRR15539824;41;40;0.609756097560976;16;25;0.109756097560976;0.390243902439024
Control.SRR15539824;38;40;0.631578947368421;14;24;0.131578947368421;0.368421052631579
Control.SRR15539824;37;40;0.405405405405405;22;15;0.0945945945945946;0.405405405405405
Control.SRR15539824;38;40;0.605263157894737;15;23;0.105263157894737;0.394736842105263
Control.SRR15539824;40;40;0.575;17;23;0.075;0.425
Control.SRR15539824;38;40;0.473684210526316;20;18;0.0263157894736842;0.473684210526316
Control.SRR15539824;42;40;0.428571428571429;24;18;0.0714285714285715;0.428571428571429
Control.SRR15539824;40;40;0.45;22;18;0.05;0.45
Control.SRR15539824;37;40;0.540540540540541;17;20;0.0405405405405406;0.459459459459459
Control.SRR15539824;40;40;0.45;22;18;0.05;0.45
Control.SRR15539824;34;40;0.5;17;17;0;0.5
Control.SRR15539824;36;40;0.5;18;18;0;0.5
Control.SRR15539824;39;40;0.615384615384615;15;24;0.115384615384615;0.384615384615385
Control.SRR15539824;39;40;0.512820512820513;19;20;0.0128205128205128;0.487179487179487
Control.SRR15539824;40;40;0.55;18;22;0.05;0.45
Control.SRR15539824;37;40;0.459459459459459;20;17;0.0405405405405405;0.459459459459459
Control.SRR15539824;39;40;0.564102564102564;17;22;0.0641025641025641;0.435897435897436
Control.SRR15539824;34;40;0.529411764705882;16;18;0.0294117647058824;0.470588235294118
Control.SRR15539824;34;40;0.5;17;17;0;0.5
Control.SRR15539824;34;40;0.558823529411765;15;19;0.0588235294117647;0.441176470588235
Control.SRR15539824;35;40;0.4;21;14;0.1;0.4
Control.SRR15539824;41;40;0.634146341463415;15;26;0.134146341463415;0.365853658536585
Control.SRR15539824;36;40;0.416666666666667;21;15;0.0833333333333333;0.416666666666667
Control.SRR15539824;34;40;0.411764705882353;20;14;0.0882352941176471;0.411764705882353
Control.SRR15539824;33;40;0.545454545454545;15;18;0.0454545454545454;0.454545454545455
Control.SRR15539824;32;40;0.625;12;20;0.125;0.375
Control.SRR15539824;41;40;0.48780487804878;21;20;0.0121951219512195;0.48780487804878
Control.SRR15539824;41;40;0.536585365853659;19;22;0.0365853658536586;0.463414634146341
Control.SRR15539824;42;40;0.5;21;21;0;0.5
Control.SRR15539824;33;40;0.424242424242424;19;14;0.0757575757575757;0.424242424242424
Control.SRR15539824;34;40;0.441176470588235;19;15;0.0588235294117647;0.441176470588235
Control.SRR15539824;34;40;0.441176470588235;19;15;0.0588235294117647;0.441176470588235
Control.SRR15539824;41;40;0.463414634146341;22;19;0.0365853658536585;0.463414634146341
Control.SRR15539824;35;40;0.371428571428571;22;13;0.128571428571429;0.371428571428571
Control.SRR15539824;38;40;0.394736842105263;23;15;0.105263157894737;0.394736842105263
Control.SRR15539824;38;40;0.447368421052632;21;17;0.0526315789473684;0.447368421052632
Control.SRR15539824;38;40;0.552631578947368;17;21;0.0526315789473685;0.447368421052632
Control.SRR15539824;37;40;0.486486486486487;19;18;0.0135135135135135;0.486486486486487
Control.SRR15539824;34;40;0.411764705882353;20;14;0.0882352941176471;0.411764705882353
Control.SRR15539824;42;40;0.571428571428571;18;24;0.0714285714285714;0.428571428571429
Control.SRR15539824;40;40;0.425;23;17;0.075;0.425
Control.SRR15539824;38;40;0.421052631578947;22;16;0.0789473684210527;0.421052631578947
Control.SRR15539824;39;40;0.461538461538462;21;18;0.0384615384615384;0.461538461538462
Control.SRR15539824;36;40;0.361111111111111;23;13;0.138888888888889;0.361111111111111
Control.SRR15539824;35;40;0.6;14;21;0.1;0.4
Control.SRR15539824;33;40;0.545454545454545;15;18;0.0454545454545454;0.454545454545455
Control.SRR15539824;35;40;0.628571428571429;13;22;0.128571428571429;0.371428571428571
Control.SRR15539824;37;40;0.486486486486487;19;18;0.0135135135135135;0.486486486486487
Control.SRR15539824;42;40;0.5;21;21;0;0.5
Control.SRR15539824;42;40;0.452380952380952;23;19;0.0476190476190476;0.452380952380952
Control.SRR15539824;34;40;0.441176470588235;19;15;0.0588235294117647;0.441176470588235
Control.SRR15539824;41;40;0.317073170731707;28;13;0.182926829268293;0.317073170731707
Control.SRR15539824;35;40;0.514285714285714;17;18;0.0142857142857142;0.485714285714286
Control.SRR15539824;41;40;0.390243902439024;25;16;0.109756097560976;0.390243902439024
Control.SRR15539824;41;40;0.341463414634146;27;14;0.158536585365854;0.341463414634146
Control.SRR15539824;42;40;0.619047619047619;16;26;0.119047619047619;0.380952380952381
Control.SRR15539824;33;40;0.424242424242424;19;14;0.0757575757575757;0.424242424242424
Control.SRR15539824;41;40;0.463414634146341;22;19;0.0365853658536585;0.463414634146341
Control.SRR15539824;36;40;0.472222222222222;19;17;0.0277777777777778;0.472222222222222
Control.SRR15539824;36;40;0.5;18;18;0;0.5
Control.SRR15539824;40;40;0.475;21;19;0.025;0.475
Control.SRR15539824;38;40;0.473684210526316;20;18;0.0263157894736842;0.473684210526316
Control.SRR15539824;34;40;0.529411764705882;16;18;0.0294117647058824;0.470588235294118
Control.SRR15539824;38;40;0.526315789473684;18;20;0.0263157894736842;0.473684210526316
Control.SRR15539824;40;40;0.45;22;18;0.05;0.45
Control.SRR15539824;41;40;0.536585365853659;19;22;0.0365853658536586;0.463414634146341
Control.SRR15539824;36;40;0.611111111111111;14;22;0.111111111111111;0.388888888888889
Control.SRR15539824;41;40;0.463414634146341;22;19;0.0365853658536585;0.463414634146341
Control.SRR15539824;42;40;0.523809523809524;20;22;0.0238095238095238;0.476190476190476
Control.SRR15539824;40;40;0.375;25;15;0.125;0.375
Control.SRR15539824;33;40;0.545454545454545;15;18;0.0454545454545454;0.454545454545455
Control.SRR15539824;35;40;0.628571428571429;13;22;0.128571428571429;0.371428571428571
Control.SRR15539824;36;40;0.555555555555556;16;20;0.0555555555555556;0.444444444444444
Control.SRR15539824;41;40;0.48780487804878;21;20;0.0121951219512195;0.48780487804878
Control.SRR15539824;40;40;0.55;18;22;0.05;0.45
Control.SRR15539824;40;40;0.4;24;16;0.1;0.4
Control.SRR15539824;37;40;0.540540540540541;17;20;0.0405405405405406;0.459459459459459
Control.SRR15539824;34;40;0.529411764705882;16;18;0.0294117647058824;0.470588235294118
Control.SRR15539824;41;40;0.463414634146341;22;19;0.0365853658536585;0.463414634146341
Control.SRR15539824;41;40;0.560975609756098;18;23;0.0609756097560976;0.439024390243902
Control.SRR15539824;42;40;0.380952380952381;26;16;0.119047619047619;0.380952380952381
Control.SRR15539824;39;40;0.564102564102564;17;22;0.0641025641025641;0.435897435897436
Control.SRR15539824;32;40;0.3125;22;10;0.1875;0.3125
Control.SRR15539824;38;40;0.421052631578947;22;16;0.0789473684210527;0.421052631578947
Control.SRR15539824;41;40;0.536585365853659;19;22;0.0365853658536586;0.463414634146341
Control.SRR15539824;35;40;0.514285714285714;17;18;0.0142857142857142;0.485714285714286
Control.SRR15539824;32;40;0.3125;22;10;0.1875;0.3125
Control.SRR15539824;40;40;0.425;23;17;0.075;0.425
Control.SRR15539824;38;40;0.552631578947368;17;21;0.0526315789473685;0.447368421052632
Control.SRR15539824;32;40;0.5625;14;18;0.0625;0.4375
Control.SRR15539824;35;40;0.6;14;21;0.1;0.4
Control.SRR15539824;40;40;0.35;26;14;0.15;0.35
Control.SRR15539824;32;40;0.59375;13;19;0.09375;0.40625
Control.SRR15539824;37;40;0.513513513513513;18;19;0.0135135135135135;0.486486486486487
Control.SRR15539824;39;40;0.41025641025641;23;16;0.0897435897435898;0.41025641025641
Control.SRR15539824;39;40;0.435897435897436;22;17;0.0641025641025641;0.435897435897436
Control.SRR15539824;42;40;0.476190476190476;22;20;0.0238095238095238;0.476190476190476
Control.SRR15539824;37;40;0.486486486486487;19;18;0.0135135135135135;0.486486486486487
Control.SRR15539824;36;40;0.611111111111111;14;22;0.111111111111111;0.388888888888889
Control.SRR15539824;42;40;0.452380952380952;23;19;0.0476190476190476;0.452380952380952
Control.SRR15539824;35;40;0.485714285714286;18;17;0.0142857142857143;0.485714285714286
Control.SRR15539824;38;40;0.394736842105263;23;15;0.105263157894737;0.394736842105263
Control.SRR15539824;33;40;0.454545454545455;18;15;0.0454545454545455;0.454545454545455
Control.SRR15539824;35;40;0.6;14;21;0.1;0.4
Control.SRR15539824;35;40;0.457142857142857;19;16;0.0428571428571429;0.457142857142857
Control.SRR15539824;35;40;0.6;14;21;0.1;0.4
Control.SRR15539824;42;40;0.5;21;21;0;0.5
Control.SRR15539824;42;40;0.619047619047619;16;26;0.119047619047619;0.380952380952381
Control.SRR15539824;36;40;0.444444444444444;20;16;0.0555555555555556;0.444444444444444
Control.SRR15539824;35;40;0.457142857142857;19;16;0.0428571428571429;0.457142857142857
Control.SRR15539824;41;40;0.414634146341463;24;17;0.0853658536585366;0.414634146341463
Control.SRR15539824;40;40;0.425;23;17;0.075;0.425
Control.SRR15539824;41;40;0.48780487804878;21;20;0.0121951219512195;0.48780487804878
Control.SRR15539824;32;40;0.5625;14;18;0.0625;0.4375
Control.SRR15539824;39;40;0.58974358974359;16;23;0.0897435897435898;0.41025641025641
Control.SRR15539824;40;40;0.475;21;19;0.025;0.475
Control.SRR15539824;38;40;0.447368421052632;21;17;0.0526315789473684;0.447368421052632
Control.SRR15539824;35;40;0.514285714285714;17;18;0.0142857142857142;0.485714285714286
Control.SRR15539824;33;40;0.454545454545455;18;15;0.0454545454545455;0.454545454545455
Control.SRR15539824;35;40;0.485714285714286;18;17;0.0142857142857143;0.485714285714286
Control.SRR15539824;41;40;0.536585365853659;19;22;0.0365853658536586;0.463414634146341
Control.SRR15539824;39;40;0.461538461538462;21;18;0.0384615384615384;0.461538461538462
Control.SRR15539824;37;40;0.540540540540541;17;20;0.0405405405405406;0.459459459459459
Control.SRR15539824;40;40;0.375;25;15;0.125;0.375
Control.SRR15539824;37;40;0.459459459459459;20;17;0.0405405405405405;0.459459459459459
Control.SRR15539824;40;40;0.525;19;21;0.025;0.475
Control.SRR15539824;33;40;0.363636363636364;21;12;0.136363636363636;0.363636363636364
Control.SRR15539824;42;40;0.642857142857143;15;27;0.142857142857143;0.357142857142857
Control.SRR15539824;39;40;0.435897435897436;22;17;0.0641025641025641;0.435897435897436
Control.SRR15539824;40;40;0.5;20;20;0;0.5
Control.SRR15539824;42;40;0.595238095238095;17;25;0.0952380952380952;0.404761904761905
Control.SRR15539824;36;40;0.305555555555556;25;11;0.194444444444444;0.305555555555556
Control.SRR15539824;36;40;0.388888888888889;22;14;0.111111111111111;0.388888888888889
Control.SRR15539824;38;40;0.5;19;19;0;0.5
Control.SRR15539824;35;40;0.514285714285714;17;18;0.0142857142857142;0.485714285714286
Control.SRR15539824;40;40;0.475;21;19;0.025;0.475
Control.SRR15539824;37;40;0.621621621621622;14;23;0.121621621621622;0.378378378378378
Control.SRR15539824;34;40;0.647058823529412;12;22;0.147058823529412;0.352941176470588
Control.SRR15539824;41;40;0.560975609756098;18;23;0.0609756097560976;0.439024390243902
Control.SRR15539824;40;40;0.4;24;16;0.1;0.4
Control.SRR15539824;35;40;0.514285714285714;17;18;0.0142857142857142;0.485714285714286
Control.SRR15539824;37;40;0.459459459459459;20;17;0.0405405405405405;0.459459459459459
Control.SRR15539824;35;40;0.485714285714286;18;17;0.0142857142857143;0.485714285714286
Control.SRR15539824;41;40;0.536585365853659;19;22;0.0365853658536586;0.463414634146341
Control.SRR15539824;42;40;0.404761904761905;25;17;0.0952380952380952;0.404761904761905
Control.SRR15539824;40;40;0.425;23;17;0.075;0.425
Control.SRR15539824;38;40;0.447368421052632;21;17;0.0526315789473684;0.447368421052632
Control.SRR15539824;37;40;0.432432432432432;21;16;0.0675675675675675;0.432432432432432
Control.SRR15539824;39;40;0.358974358974359;25;14;0.141025641025641;0.358974358974359
Control.SRR15539824;39;40;0.384615384615385;24;15;0.115384615384615;0.384615384615385
Control.SRR15539824;39;40;0.384615384615385;24;15;0.115384615384615;0.384615384615385
Control.SRR15539824;36;40;0.472222222222222;19;17;0.0277777777777778;0.472222222222222
Control.SRR15539824;39;40;0.512820512820513;19;20;0.0128205128205128;0.487179487179487
Control.SRR15539824;36;40;0.388888888888889;22;14;0.111111111111111;0.388888888888889
Control.SRR15539824;34;40;0.411764705882353;20;14;0.0882352941176471;0.411764705882353
Control.SRR15539824;33;40;0.454545454545455;18;15;0.0454545454545455;0.454545454545455
Control.SRR15539824;37;40;0.594594594594595;15;22;0.0945945945945946;0.405405405405405
Control.SRR15539824;33;40;0.454545454545455;18;15;0.0454545454545455;0.454545454545455
Control.SRR15539824;42;40;0.547619047619048;19;23;0.0476190476190477;0.452380952380952
Control.SRR15539824;39;40;0.564102564102564;17;22;0.0641025641025641;0.435897435897436
Control.SRR15539824;40;40;0.275;29;11;0.225;0.275
Control.SRR15539824;34;40;0.588235294117647;14;20;0.0882352941176471;0.411764705882353
Control.SRR15539824;34;40;0.588235294117647;14;20;0.0882352941176471;0.411764705882353
Control.SRR15539824;34;40;0.441176470588235;19;15;0.0588235294117647;0.441176470588235
Control.SRR15539824;33;40;0.666666666666667;11;22;0.166666666666667;0.333333333333333
Control.SRR15539824;39;40;0.487179487179487;20;19;0.0128205128205128;0.487179487179487
Control.SRR15539824;36;40;0.444444444444444;20;16;0.0555555555555556;0.444444444444444
Control.SRR15539824;34;40;0.529411764705882;16;18;0.0294117647058824;0.470588235294118
Control.SRR15539824;34;40;0.529411764705882;16;18;0.0294117647058824;0.470588235294118
Control.SRR15539824;41;40;0.560975609756098;18;23;0.0609756097560976;0.439024390243902
Control.SRR15539824;37;40;0.567567567567568;16;21;0.0675675675675675;0.432432432432432
Control.SRR15539824;38;40;0.421052631578947;22;16;0.0789473684210527;0.421052631578947
Control.SRR15539824;36;40;0.555555555555556;16;20;0.0555555555555556;0.444444444444444
Control.SRR15539824;41;40;0.463414634146341;22;19;0.0365853658536585;0.463414634146341
Control.SRR15539824;39;40;0.461538461538462;21;18;0.0384615384615384;0.461538461538462
Control.SRR15539824;39;40;0.461538461538462;21;18;0.0384615384615384;0.461538461538462
Control.SRR15539824;36;40;0.555555555555556;16;20;0.0555555555555556;0.444444444444444
Control.SRR15539824;40;40;0.5;20;20;0;0.5
Control.SRR15539824;42;40;0.428571428571429;24;18;0.0714285714285715;0.428571428571429
Control.SRR15539824;33;40;0.333333333333333;22;11;0.166666666666667;0.333333333333333
Control.SRR15539824;38;40;0.473684210526316;20;18;0.0263157894736842;0.473684210526316
Control.SRR15539824;39;40;0.512820512820513;19;20;0.0128205128205128;0.487179487179487
Control.SRR15539824;33;40;0.515151515151515;16;17;0.0151515151515151;0.484848484848485
Control.SRR15539824;38;40;0.5;19;19;0;0.5
Control.SRR15539824;38;40;0.552631578947368;17;21;0.0526315789473685;0.447368421052632
Control.SRR15539824;39;40;0.564102564102564;17;22;0.0641025641025641;0.435897435897436
Control.SRR15539824;38;40;0.394736842105263;23;15;0.105263157894737;0.394736842105263
Control.SRR15539824;34;40;0.617647058823529;13;21;0.117647058823529;0.382352941176471
Control.SRR15539824;34;40;0.588235294117647;14;20;0.0882352941176471;0.411764705882353
Control.SRR15539824;38;40;0.421052631578947;22;16;0.0789473684210527;0.421052631578947
Control.SRR15539824;38;40;0.631578947368421;14;24;0.131578947368421;0.368421052631579
Control.SRR15539824;40;40;0.55;18;22;0.05;0.45
Control.SRR15539824;37;40;0.486486486486487;19;18;0.0135135135135135;0.486486486486487
Control.SRR15539824;36;40;0.472222222222222;19;17;0.0277777777777778;0.472222222222222
Control.SRR15539824;37;40;0.567567567567568;16;21;0.0675675675675675;0.432432432432432
Control.SRR15539824;32;40;0.53125;15;17;0.03125;0.46875
Control.SRR15539824;33;40;0.696969696969697;10;23;0.196969696969697;0.303030303030303
Control.SRR15539824;35;40;0.485714285714286;18;17;0.0142857142857143;0.485714285714286
Control.SRR15539824;35;40;0.457142857142857;19;16;0.0428571428571429;0.457142857142857
Control.SRR15539824;33;40;0.484848484848485;17;16;0.0151515151515151;0.484848484848485
Control.SRR15539824;42;40;0.5;21;21;0;0.5
Control.SRR15539824;38;40;0.421052631578947;22;16;0.0789473684210527;0.421052631578947
Control.SRR15539824;34;40;0.529411764705882;16;18;0.0294117647058824;0.470588235294118
Control.SRR15539824;34;40;0.382352941176471;21;13;0.117647058823529;0.382352941176471
Control.SRR15539824;36;40;0.611111111111111;14;22;0.111111111111111;0.388888888888889
Control.SRR15539824;32;40;0.625;12;20;0.125;0.375
Control.SRR15539824;36;40;0.472222222222222;19;17;0.0277777777777778;0.472222222222222
Control.SRR15539824;36;40;0.472222222222222;19;17;0.0277777777777778;0.472222222222222
Control.SRR15539824;41;40;0.51219512195122;20;21;0.0121951219512195;0.48780487804878
Control.SRR15539824;40;40;0.4;24;16;0.1;0.4
Control.SRR15539824;40;40;0.575;17;23;0.075;0.425
Control.SRR15539824;38;40;0.526315789473684;18;20;0.0263157894736842;0.473684210526316
Control.SRR15539824;42;40;0.547619047619048;19;23;0.0476190476190477;0.452380952380952
Control.SRR15539824;40;40;0.525;19;21;0.025;0.475
Control.SRR15539824;37;40;0.567567567567568;16;21;0.0675675675675675;0.432432432432432
Control.SRR15539824;35;40;0.457142857142857;19;16;0.0428571428571429;0.457142857142857
Control.SRR15539824;35;40;0.542857142857143;16;19;0.0428571428571428;0.457142857142857
Control.SRR15539824;39;40;0.487179487179487;20;19;0.0128205128205128;0.487179487179487
Control.SRR15539824;34;40;0.617647058823529;13;21;0.117647058823529;0.382352941176471
Control.SRR15539824;36;40;0.5;18;18;0;0.5
Control.SRR15539824;39;40;0.615384615384615;15;24;0.115384615384615;0.384615384615385
Control.SRR15539824;36;40;0.583333333333333;15;21;0.0833333333333334;0.416666666666667
Control.SRR15539824;38;40;0.473684210526316;20;18;0.0263157894736842;0.473684210526316
Control.SRR15539824;37;40;0.648648648648649;13;24;0.148648648648649;0.351351351351351
Control.SRR15539824;40;40;0.525;19;21;0.025;0.475
Control.SRR15539824;40;40;0.525;19;21;0.025;0.475
Control.SRR15539824;37;40;0.756756756756757;9;28;0.256756756756757;0.243243243243243
Control.SRR15539824;36;40;0.5;18;18;0;0.5
Control.SRR15539824;42;40;0.428571428571429;24;18;0.0714285714285715;0.428571428571429
Control.SRR15539824;42;40;0.5;21;21;0;0.5
Control.SRR15539824;35;40;0.485714285714286;18;17;0.0142857142857143;0.485714285714286
Control.SRR15539824;40;40;0.425;23;17;0.075;0.425
Control.SRR15539824;40;40;0.575;17;23;0.075;0.425
Control.SRR15539824;32;40;0.4375;18;14;0.0625;0.4375
Control.SRR15539824;37;40;0.513513513513513;18;19;0.0135135135135135;0.486486486486487
Control.SRR15539824;39;40;0.384615384615385;24;15;0.115384615384615;0.384615384615385
Control.SRR15539824;33;40;0.515151515151515;16;17;0.0151515151515151;0.484848484848485
Control.SRR15539824;38;40;0.5;19;19;0;0.5
Control.SRR15539824;32;40;0.59375;13;19;0.09375;0.40625
Control.SRR15539824;34;40;0.529411764705882;16;18;0.0294117647058824;0.470588235294118
Control.SRR15539824;35;40;0.4;21;14;0.1;0.4
Control.SRR15539824;34;40;0.588235294117647;14;20;0.0882352941176471;0.411764705882353
Control.SRR15539824;41;40;0.463414634146341;22;19;0.0365853658536585;0.463414634146341
Control.SRR15539824;37;40;0.621621621621622;14;23;0.121621621621622;0.378378378378378
Control.SRR15539824;42;40;0.547619047619048;19;23;0.0476190476190477;0.452380952380952
Control.SRR15539824;35;40;0.457142857142857;19;16;0.0428571428571429;0.457142857142857
Control.SRR15539824;33;40;0.545454545454545;15;18;0.0454545454545454;0.454545454545455
Control.SRR15539824;32;40;0.625;12;20;0.125;0.375
Control.SRR15539824;34;40;0.588235294117647;14;20;0.0882352941176471;0.411764705882353
Control.SRR15539824;39;40;0.487179487179487;20;19;0.0128205128205128;0.487179487179487
Control.SRR15539824;36;40;0.638888888888889;13;23;0.138888888888889;0.361111111111111
Control.SRR15539824;42;40;0.380952380952381;26;16;0.119047619047619;0.380952380952381
Control.SRR15539824;33;40;0.484848484848485;17;16;0.0151515151515151;0.484848484848485
Control.SRR15539824;39;40;0.461538461538462;21;18;0.0384615384615384;0.461538461538462
Control.SRR15539824;41;40;0.463414634146341;22;19;0.0365853658536585;0.463414634146341
Control.SRR15539824;40;40;0.55;18;22;0.05;0.45
Control.SRR15539824;37;40;0.567567567567568;16;21;0.0675675675675675;0.432432432432432
Control.SRR15539824;34;40;0.470588235294118;18;16;0.0294117647058824;0.470588235294118
Control.SRR15539824;34;40;0.352941176470588;22;12;0.147058823529412;0.352941176470588
Control.SRR15539824;42;40;0.5;21;21;0;0.5
Control.SRR15539824;35;40;0.542857142857143;16;19;0.0428571428571428;0.457142857142857
Control.SRR15539824;36;40;0.555555555555556;16;20;0.0555555555555556;0.444444444444444
Control.SRR15539824;37;40;0.540540540540541;17;20;0.0405405405405406;0.459459459459459
Control.SRR15539824;37;40;0.513513513513513;18;19;0.0135135135135135;0.486486486486487
Control.SRR15539824;36;40;0.666666666666667;12;24;0.166666666666667;0.333333333333333
Control.SRR15539824;37;40;0.621621621621622;14;23;0.121621621621622;0.378378378378378
Control.SRR15539824;34;40;0.470588235294118;18;16;0.0294117647058824;0.470588235294118
Control.SRR15539824;34;40;0.323529411764706;23;11;0.176470588235294;0.323529411764706
Control.SRR15539824;38;40;0.552631578947368;17;21;0.0526315789473685;0.447368421052632
Control.SRR15539824;41;40;0.536585365853659;19;22;0.0365853658536586;0.463414634146341
Control.SRR15539824;36;40;0.472222222222222;19;17;0.0277777777777778;0.472222222222222
Control.SRR15539824;32;40;0.46875;17;15;0.03125;0.46875
Control.SRR15539824;40;40;0.425;23;17;0.075;0.425
Control.SRR15539824;33;40;0.515151515151515;16;17;0.0151515151515151;0.484848484848485
Control.SRR15539824;33;40;0.696969696969697;10;23;0.196969696969697;0.303030303030303
Control.SRR15539824;35;40;0.657142857142857;12;23;0.157142857142857;0.342857142857143
Control.SRR15539824;35;40;0.4;21;14;0.1;0.4
Control.SRR15539824;36;40;0.527777777777778;17;19;0.0277777777777778;0.472222222222222
Control.SRR15539824;36;40;0.611111111111111;14;22;0.111111111111111;0.388888888888889
Control.SRR15539824;36;40;0.361111111111111;23;13;0.138888888888889;0.361111111111111
Control.SRR15539824;38;40;0.526315789473684;18;20;0.0263157894736842;0.473684210526316
Control.SRR15539824;39;40;0.58974358974359;16;23;0.0897435897435898;0.41025641025641
Control.SRR15539824;36;40;0.527777777777778;17;19;0.0277777777777778;0.472222222222222
Control.SRR15539824;35;40;0.342857142857143;23;12;0.157142857142857;0.342857142857143
Control.SRR15539824;33;40;0.484848484848485;17;16;0.0151515151515151;0.484848484848485
Control.SRR15539824;33;40;0.545454545454545;15;18;0.0454545454545454;0.454545454545455
Control.SRR15539824;36;40;0.5;18;18;0;0.5
Control.SRR15539824;40;40;0.375;25;15;0.125;0.375
Control.SRR15539824;41;40;0.51219512195122;20;21;0.0121951219512195;0.48780487804878
Control.SRR15539824;36;40;0.611111111111111;14;22;0.111111111111111;0.388888888888889
Control.SRR15539824;40;40;0.55;18;22;0.05;0.45
Control.SRR15539824;37;40;0.459459459459459;20;17;0.0405405405405405;0.459459459459459
Control.SRR15539824;37;40;0.459459459459459;20;17;0.0405405405405405;0.459459459459459
Control.SRR15539824;37;40;0.513513513513513;18;19;0.0135135135135135;0.486486486486487
Control.SRR15539824;38;40;0.5;19;19;0;0.5
Control.SRR15539824;36;40;0.638888888888889;13;23;0.138888888888889;0.361111111111111
Control.SRR15539824;38;40;0.473684210526316;20;18;0.0263157894736842;0.473684210526316
Control.SRR15539824;38;40;0.605263157894737;15;23;0.105263157894737;0.394736842105263
Control.SRR15539824;35;40;0.571428571428571;15;20;0.0714285714285714;0.428571428571429
Control.SRR15539824;35;40;0.485714285714286;18;17;0.0142857142857143;0.485714285714286
Control.SRR15539824;38;40;0.657894736842105;13;25;0.157894736842105;0.342105263157895
Control.SRR15539824;41;40;0.585365853658537;17;24;0.0853658536585366;0.414634146341463
Control.SRR15539824;34;40;0.558823529411765;15;19;0.0588235294117647;0.441176470588235
Control.SRR15539824;37;40;0.432432432432432;21;16;0.0675675675675675;0.432432432432432
Control.SRR15539824;32;40;0.5625;14;18;0.0625;0.4375
Control.SRR15539824;33;40;0.212121212121212;26;7;0.287878787878788;0.212121212121212
Control.SRR15539824;34;40;0.588235294117647;14;20;0.0882352941176471;0.411764705882353
Control.SRR15539824;36;40;0.472222222222222;19;17;0.0277777777777778;0.472222222222222
Control.SRR15539824;39;40;0.58974358974359;16;23;0.0897435897435898;0.41025641025641
Control.SRR15539824;36;40;0.527777777777778;17;19;0.0277777777777778;0.472222222222222
Control.SRR15539824;34;40;0.411764705882353;20;14;0.0882352941176471;0.411764705882353
Control.SRR15539824;42;40;0.428571428571429;24;18;0.0714285714285715;0.428571428571429
Control.SRR15539824;36;40;0.333333333333333;24;12;0.166666666666667;0.333333333333333
Control.SRR15539824;41;40;0.536585365853659;19;22;0.0365853658536586;0.463414634146341
Control.SRR15539824;33;40;0.515151515151515;16;17;0.0151515151515151;0.484848484848485
Control.SRR15539824;33;40;0.606060606060606;13;20;0.106060606060606;0.393939393939394
Control.SRR15539824;35;40;0.514285714285714;17;18;0.0142857142857142;0.485714285714286
Control.SRR15539824;42;40;0.476190476190476;22;20;0.0238095238095238;0.476190476190476
Control.SRR15539824;39;40;0.564102564102564;17;22;0.0641025641025641;0.435897435897436
Control.SRR15539824;35;40;0.571428571428571;15;20;0.0714285714285714;0.428571428571429
Control.SRR15539824;39;40;0.358974358974359;25;14;0.141025641025641;0.358974358974359
Control.SRR15539824;40;40;0.55;18;22;0.05;0.45
Control.SRR15539824;32;40;0.53125;15;17;0.03125;0.46875
Control.SRR15539824;36;40;0.444444444444444;20;16;0.0555555555555556;0.444444444444444
Control.SRR15539824;41;40;0.414634146341463;24;17;0.0853658536585366;0.414634146341463
Control.SRR15539824;33;40;0.454545454545455;18;15;0.0454545454545455;0.454545454545455
Control.SRR15539824;36;40;0.277777777777778;26;10;0.222222222222222;0.277777777777778
Control.SRR15539824;33;40;0.606060606060606;13;20;0.106060606060606;0.393939393939394
Control.SRR15539824;36;40;0.555555555555556;16;20;0.0555555555555556;0.444444444444444
Control.SRR15539824;41;40;0.560975609756098;18;23;0.0609756097560976;0.439024390243902
Control.SRR15539824;39;40;0.41025641025641;23;16;0.0897435897435898;0.41025641025641
Control.SRR15539824;42;40;0.357142857142857;27;15;0.142857142857143;0.357142857142857
Control.SRR15539824;36;40;0.555555555555556;16;20;0.0555555555555556;0.444444444444444
Control.SRR15539824;36;40;0.527777777777778;17;19;0.0277777777777778;0.472222222222222
Control.SRR15539824;40;40;0.575;17;23;0.075;0.425
Control.SRR15539824;35;40;0.485714285714286;18;17;0.0142857142857143;0.485714285714286
Control.SRR15539824;36;40;0.5;18;18;0;0.5
Control.SRR15539824;41;40;0.560975609756098;18;23;0.0609756097560976;0.439024390243902
Control.SRR15539824;38;40;0.578947368421053;16;22;0.0789473684210527;0.421052631578947
Control.SRR15539824;36;40;0.611111111111111;14;22;0.111111111111111;0.388888888888889
Control.SRR15539824;37;40;0.648648648648649;13;24;0.148648648648649;0.351351351351351
Control.SRR15539824;33;40;0.545454545454545;15;18;0.0454545454545454;0.454545454545455
Control.SRR15539824;40;40;0.45;22;18;0.05;0.45
Control.SRR15539824;37;40;0.432432432432432;21;16;0.0675675675675675;0.432432432432432
Control.SRR15539824;36;40;0.583333333333333;15;21;0.0833333333333334;0.416666666666667
Control.SRR15539824;35;40;0.428571428571429;20;15;0.0714285714285715;0.428571428571429
Control.SRR15539824;36;40;0.527777777777778;17;19;0.0277777777777778;0.472222222222222
Control.SRR15539824;38;40;0.394736842105263;23;15;0.105263157894737;0.394736842105263
Control.SRR15539824;36;40;0.611111111111111;14;22;0.111111111111111;0.388888888888889
Control.SRR15539824;36;40;0.5;18;18;0;0.5
Control.SRR15539824;37;40;0.648648648648649;13;24;0.148648648648649;0.351351351351351
Control.SRR15539824;41;40;0.560975609756098;18;23;0.0609756097560976;0.439024390243902
Control.SRR15539824;37;40;0.594594594594595;15;22;0.0945945945945946;0.405405405405405
Control.SRR15539824;38;40;0.5;19;19;0;0.5
Control.SRR15539824;34;40;0.470588235294118;18;16;0.0294117647058824;0.470588235294118
Control.SRR15539824;39;40;0.666666666666667;13;26;0.166666666666667;0.333333333333333
Control.SRR15539824;38;40;0.394736842105263;23;15;0.105263157894737;0.394736842105263
Control.SRR15539824;35;40;0.4;21;14;0.1;0.4
Control.SRR15539824;37;40;0.621621621621622;14;23;0.121621621621622;0.378378378378378
Control.SRR15539824;32;40;0.46875;17;15;0.03125;0.46875
Control.SRR15539824;41;40;0.414634146341463;24;17;0.0853658536585366;0.414634146341463
Control.SRR15539824;35;40;0.542857142857143;16;19;0.0428571428571428;0.457142857142857
Control.SRR15539824;34;40;0.529411764705882;16;18;0.0294117647058824;0.470588235294118
Control.SRR15539824;36;40;0.638888888888889;13;23;0.138888888888889;0.361111111111111
Control.SRR15539824;39;40;0.487179487179487;20;19;0.0128205128205128;0.487179487179487
Control.SRR15539824;32;40;0.59375;13;19;0.09375;0.40625
Control.SRR15539824;36;40;0.555555555555556;16;20;0.0555555555555556;0.444444444444444
Control.SRR15539824;38;40;0.5;19;19;0;0.5
Control.SRR15539824;36;40;0.388888888888889;22;14;0.111111111111111;0.388888888888889
Control.SRR15539824;37;40;0.459459459459459;20;17;0.0405405405405405;0.459459459459459
Control.SRR15539824;36;40;0.555555555555556;16;20;0.0555555555555556;0.444444444444444
Control.SRR15539824;37;40;0.513513513513513;18;19;0.0135135135135135;0.486486486486487
Control.SRR15539824;32;40;0.375;20;12;0.125;0.375
Control.SRR15539824;33;40;0.363636363636364;21;12;0.136363636363636;0.363636363636364
Control.SRR15539824;37;40;0.459459459459459;20;17;0.0405405405405405;0.459459459459459
Control.SRR15539824;38;40;0.447368421052632;21;17;0.0526315789473684;0.447368421052632
Control.SRR15539824;33;40;0.545454545454545;15;18;0.0454545454545454;0.454545454545455
Control.SRR15539824;36;40;0.472222222222222;19;17;0.0277777777777778;0.472222222222222
Control.SRR15539824;33;40;0.484848484848485;17;16;0.0151515151515151;0.484848484848485
Control.SRR15539824;40;40;0.525;19;21;0.025;0.475
Control.SRR15539824;37;40;0.621621621621622;14;23;0.121621621621622;0.378378378378378
Control.SRR15539824;40;40;0.65;14;26;0.15;0.35
Control.SRR15539824;36;40;0.638888888888889;13;23;0.138888888888889;0.361111111111111
Control.SRR15539824;34;40;0.470588235294118;18;16;0.0294117647058824;0.470588235294118
Control.SRR15539824;40;40;0.5;20;20;0;0.5
Control.SRR15539824;36;40;0.5;18;18;0;0.5
Control.SRR15539824;39;40;0.564102564102564;17;22;0.0641025641025641;0.435897435897436
Control.SRR15539824;38;40;0.578947368421053;16;22;0.0789473684210527;0.421052631578947
Control.SRR15539824;32;40;0.40625;19;13;0.09375;0.40625
Control.SRR15539824;39;40;0.461538461538462;21;18;0.0384615384615384;0.461538461538462
Control.SRR15539824;32;40;0.5625;14;18;0.0625;0.4375
Control.SRR15539824;35;40;0.657142857142857;12;23;0.157142857142857;0.342857142857143
Control.SRR15539824;33;40;0.545454545454545;15;18;0.0454545454545454;0.454545454545455
Control.SRR15539824;32;40;0.5625;14;18;0.0625;0.4375
Control.SRR15539824;38;40;0.605263157894737;15;23;0.105263157894737;0.394736842105263
Control.SRR15539824;32;40;0.5625;14;18;0.0625;0.4375
Control.SRR15539824;33;40;0.636363636363636;12;21;0.136363636363636;0.363636363636364
Control.SRR15539824;36;40;0.444444444444444;20;16;0.0555555555555556;0.444444444444444
Control.SRR15539824;38;40;0.5;19;19;0;0.5
Control.SRR15539824;39;40;0.333333333333333;26;13;0.166666666666667;0.333333333333333
Control.SRR15539824;32;40;0.46875;17;15;0.03125;0.46875
Control.SRR15539824;35;40;0.6;14;21;0.1;0.4
Control.SRR15539824;36;40;0.444444444444444;20;16;0.0555555555555556;0.444444444444444
Control.SRR15539824;38;40;0.421052631578947;22;16;0.0789473684210527;0.421052631578947
Control.SRR15539824;35;40;0.485714285714286;18;17;0.0142857142857143;0.485714285714286
Control.SRR15539824;38;40;0.447368421052632;21;17;0.0526315789473684;0.447368421052632
Control.SRR15539824;33;40;0.575757575757576;14;19;0.0757575757575758;0.424242424242424
Control.SRR15539824;38;40;0.447368421052632;21;17;0.0526315789473684;0.447368421052632
Control.SRR15539824;40;40;0.55;18;22;0.05;0.45
Control.SRR15539824;40;40;0.55;18;22;0.05;0.45
Control.SRR15539824;39;40;0.58974358974359;16;23;0.0897435897435898;0.41025641025641
Control.SRR15539824;36;40;0.583333333333333;15;21;0.0833333333333334;0.416666666666667
Control.SRR15539824;36;40;0.527777777777778;17;19;0.0277777777777778;0.472222222222222
Control.SRR15539824;35;40;0.485714285714286;18;17;0.0142857142857143;0.485714285714286
Control.SRR15539824;37;40;0.486486486486487;19;18;0.0135135135135135;0.486486486486487
Control.SRR15539824;39;40;0.487179487179487;20;19;0.0128205128205128;0.487179487179487
Control.SRR15539824;35;40;0.685714285714286;11;24;0.185714285714286;0.314285714285714
Control.SRR15539824;35;40;0.371428571428571;22;13;0.128571428571429;0.371428571428571
Control.SRR15539824;36;40;0.666666666666667;12;24;0.166666666666667;0.333333333333333
Control.SRR15539824;35;40;0.485714285714286;18;17;0.0142857142857143;0.485714285714286
Control.SRR15539824;42;40;0.428571428571429;24;18;0.0714285714285715;0.428571428571429
Control.SRR15539824;34;40;0.558823529411765;15;19;0.0588235294117647;0.441176470588235
Control.SRR15539824;32;40;0.5625;14;18;0.0625;0.4375
Control.SRR15539824;32;40;0.5;16;16;0;0.5
Control.SRR15539824;32;40;0.53125;15;17;0.03125;0.46875
Control.SRR15539824;36;40;0.555555555555556;16;20;0.0555555555555556;0.444444444444444
Control.SRR15539824;32;40;0.625;12;20;0.125;0.375
Control.SRR15539824;34;40;0.470588235294118;18;16;0.0294117647058824;0.470588235294118
Control.SRR15539824;41;40;0.463414634146341;22;19;0.0365853658536585;0.463414634146341
Control.SRR15539824;33;40;0.515151515151515;16;17;0.0151515151515151;0.484848484848485
Control.SRR15539824;36;40;0.5;18;18;0;0.5
Control.SRR15539824;39;40;0.615384615384615;15;24;0.115384615384615;0.384615384615385
Control.SRR15539824;39;40;0.435897435897436;22;17;0.0641025641025641;0.435897435897436
Control.SRR15539824;39;40;0.384615384615385;24;15;0.115384615384615;0.384615384615385
Control.SRR15539824;37;40;0.459459459459459;20;17;0.0405405405405405;0.459459459459459
Control.SRR15539824;35;40;0.485714285714286;18;17;0.0142857142857143;0.485714285714286
Control.SRR15539824;42;40;0.595238095238095;17;25;0.0952380952380952;0.404761904761905
Control.SRR15539824;39;40;0.641025641025641;14;25;0.141025641025641;0.358974358974359
Control.SRR15539824;37;40;0.621621621621622;14;23;0.121621621621622;0.378378378378378
Control.SRR15539824;39;40;0.435897435897436;22;17;0.0641025641025641;0.435897435897436
Control.SRR15539824;39;40;0.512820512820513;19;20;0.0128205128205128;0.487179487179487
Control.SRR15539824;38;40;0.578947368421053;16;22;0.0789473684210527;0.421052631578947
Control.SRR15539824;37;40;0.486486486486487;19;18;0.0135135135135135;0.486486486486487
Control.SRR15539824;40;40;0.375;25;15;0.125;0.375
Control.SRR15539824;34;40;0.558823529411765;15;19;0.0588235294117647;0.441176470588235
Control.SRR15539824;38;40;0.552631578947368;17;21;0.0526315789473685;0.447368421052632
Control.SRR15539824;39;40;0.487179487179487;20;19;0.0128205128205128;0.487179487179487
Control.SRR15539824;41;40;0.51219512195122;20;21;0.0121951219512195;0.48780487804878
Control.SRR15539824;38;40;0.5;19;19;0;0.5
Control.SRR15539824;35;40;0.628571428571429;13;22;0.128571428571429;0.371428571428571
Control.SRR15539824;35;40;0.542857142857143;16;19;0.0428571428571428;0.457142857142857
Control.SRR15539824;33;40;0.545454545454545;15;18;0.0454545454545454;0.454545454545455
Control.SRR15539824;40;40;0.575;17;23;0.075;0.425
Control.SRR15539824;37;40;0.513513513513513;18;19;0.0135135135135135;0.486486486486487
Control.SRR15539824;39;40;0.487179487179487;20;19;0.0128205128205128;0.487179487179487
Control.SRR15539824;37;40;0.513513513513513;18;19;0.0135135135135135;0.486486486486487
Control.SRR15539824;36;40;0.527777777777778;17;19;0.0277777777777778;0.472222222222222
Control.SRR15539824;35;40;0.485714285714286;18;17;0.0142857142857143;0.485714285714286
Control.SRR15539824;36;40;0.361111111111111;23;13;0.138888888888889;0.361111111111111
Control.SRR15539824;33;40;0.666666666666667;11;22;0.166666666666667;0.333333333333333
Control.SRR15539824;33;40;0.454545454545455;18;15;0.0454545454545455;0.454545454545455
Control.SRR15539824;37;40;0.432432432432432;21;16;0.0675675675675675;0.432432432432432
Control.SRR15539824;39;40;0.615384615384615;15;24;0.115384615384615;0.384615384615385
Control.SRR15539824;35;40;0.514285714285714;17;18;0.0142857142857142;0.485714285714286
Control.SRR15539824;34;40;0.529411764705882;16;18;0.0294117647058824;0.470588235294118
Control.SRR15539824;40;40;0.5;20;20;0;0.5
Control.SRR15539824;42;40;0.452380952380952;23;19;0.0476190476190476;0.452380952380952
Control.SRR15539824;35;40;0.542857142857143;16;19;0.0428571428571428;0.457142857142857
Control.SRR15539824;33;40;0.606060606060606;13;20;0.106060606060606;0.393939393939394
Control.SRR15539824;35;40;0.457142857142857;19;16;0.0428571428571429;0.457142857142857
Control.SRR15539824;42;40;0.547619047619048;19;23;0.0476190476190477;0.452380952380952
Control.SRR15539824;41;40;0.560975609756098;18;23;0.0609756097560976;0.439024390243902
Control.SRR15539824;40;40;0.525;19;21;0.025;0.475
Control.SRR15539824;39;40;0.487179487179487;20;19;0.0128205128205128;0.487179487179487
Control.SRR15539824;33;40;0.484848484848485;17;16;0.0151515151515151;0.484848484848485
Control.SRR15539824;37;40;0.513513513513513;18;19;0.0135135135135135;0.486486486486487
Control.SRR15539824;35;40;0.485714285714286;18;17;0.0142857142857143;0.485714285714286
Control.SRR15539824;38;40;0.473684210526316;20;18;0.0263157894736842;0.473684210526316
Control.SRR15539824;41;40;0.292682926829268;29;12;0.207317073170732;0.292682926829268
Control.SRR15539824;35;40;0.514285714285714;17;18;0.0142857142857142;0.485714285714286
Control.SRR15539824;34;40;0.470588235294118;18;16;0.0294117647058824;0.470588235294118
Control.SRR15539824;36;40;0.388888888888889;22;14;0.111111111111111;0.388888888888889
Control.SRR15539824;42;40;0.5;21;21;0;0.5
Control.SRR15539824;39;40;0.538461538461538;18;21;0.0384615384615384;0.461538461538462
Control.SRR15539824;38;40;0.631578947368421;14;24;0.131578947368421;0.368421052631579
Control.SRR15539824;40;40;0.6;16;24;0.1;0.4
Control.SRR15539824;34;40;0.529411764705882;16;18;0.0294117647058824;0.470588235294118
Control.SRR15539824;42;40;0.571428571428571;18;24;0.0714285714285714;0.428571428571429
Control.SRR15539824;39;40;0.435897435897436;22;17;0.0641025641025641;0.435897435897436
Control.SRR15539824;37;40;0.486486486486487;19;18;0.0135135135135135;0.486486486486487
Control.SRR15539824;33;40;0.454545454545455;18;15;0.0454545454545455;0.454545454545455
Control.SRR15539824;43;40;0.302325581395349;30;13;0.197674418604651;0.302325581395349
Control.SRR15539824;38;40;0.447368421052632;21;17;0.0526315789473684;0.447368421052632
Control.SRR15539824;39;40;0.564102564102564;17;22;0.0641025641025641;0.435897435897436
Control.SRR15539824;36;40;0.555555555555556;16;20;0.0555555555555556;0.444444444444444
Control.SRR15539824;43;40;0.604651162790698;17;26;0.104651162790698;0.395348837209302
Control.SRR15539824;41;40;0.51219512195122;20;21;0.0121951219512195;0.48780487804878
Control.SRR15539824;43;40;0.441860465116279;24;19;0.0581395348837209;0.441860465116279
Control.SRR15539824;38;40;0.394736842105263;23;15;0.105263157894737;0.394736842105263
Control.SRR15539824;37;40;0.513513513513513;18;19;0.0135135135135135;0.486486486486487
Control.SRR15539824;43;40;0.627906976744186;16;27;0.127906976744186;0.372093023255814
Control.SRR15539824;36;40;0.416666666666667;21;15;0.0833333333333333;0.416666666666667
Control.SRR15539824;39;40;0.435897435897436;22;17;0.0641025641025641;0.435897435897436
Control.SRR15539824;40;40;0.5;20;20;0;0.5
Control.SRR15539824;40;40;0.5;20;20;0;0.5
Control.SRR15539824;38;40;0.447368421052632;21;17;0.0526315789473684;0.447368421052632
Control.SRR15539824;33;40;0.636363636363636;12;21;0.136363636363636;0.363636363636364
Control.SRR15539824;36;40;0.527777777777778;17;19;0.0277777777777778;0.472222222222222
Control.SRR15539824;34;40;0.5;17;17;0;0.5
Control.SRR15539824;37;40;0.567567567567568;16;21;0.0675675675675675;0.432432432432432
Control.SRR15539824;33;40;0.454545454545455;18;15;0.0454545454545455;0.454545454545455
Control.SRR15539824;40;40;0.575;17;23;0.075;0.425
Control.SRR15539824;35;40;0.485714285714286;18;17;0.0142857142857143;0.485714285714286
Control.SRR15539824;34;40;0.441176470588235;19;15;0.0588235294117647;0.441176470588235
Control.SRR15539824;36;40;0.527777777777778;17;19;0.0277777777777778;0.472222222222222
Control.SRR15539824;39;40;0.41025641025641;23;16;0.0897435897435898;0.41025641025641
Control.SRR15539824;33;40;0.484848484848485;17;16;0.0151515151515151;0.484848484848485
Control.SRR15539824;33;40;0.454545454545455;18;15;0.0454545454545455;0.454545454545455
Control.SRR15539824;35;40;0.542857142857143;16;19;0.0428571428571428;0.457142857142857
Control.SRR15539824;33;40;0.454545454545455;18;15;0.0454545454545455;0.454545454545455
Control.SRR15539824;33;40;0.575757575757576;14;19;0.0757575757575758;0.424242424242424
Control.SRR15539824;34;40;0.294117647058824;24;10;0.205882352941176;0.294117647058824
Control.SRR15539824;35;40;0.542857142857143;16;19;0.0428571428571428;0.457142857142857
Control.SRR15539824;34;40;0.5;17;17;0;0.5
Control.SRR15539824;43;40;0.534883720930233;20;23;0.0348837209302325;0.465116279069767
Control.SRR15539824;41;40;0.48780487804878;21;20;0.0121951219512195;0.48780487804878
Control.SRR15539824;36;40;0.527777777777778;17;19;0.0277777777777778;0.472222222222222
Control.SRR15539824;36;40;0.361111111111111;23;13;0.138888888888889;0.361111111111111
Control.SRR15539824;34;40;0.441176470588235;19;15;0.0588235294117647;0.441176470588235
Control.SRR15539824;42;40;0.595238095238095;17;25;0.0952380952380952;0.404761904761905
Control.SRR15539824;35;40;0.428571428571429;20;15;0.0714285714285715;0.428571428571429
Control.SRR15539824;37;40;0.540540540540541;17;20;0.0405405405405406;0.459459459459459
Control.SRR15539824;38;40;0.368421052631579;24;14;0.131578947368421;0.368421052631579
Control.SRR15539824;37;40;0.567567567567568;16;21;0.0675675675675675;0.432432432432432
Control.SRR15539824;35;40;0.485714285714286;18;17;0.0142857142857143;0.485714285714286
Control.SRR15539824;37;40;0.540540540540541;17;20;0.0405405405405406;0.459459459459459
Control.SRR15539824;40;40;0.475;21;19;0.025;0.475
Control.SRR15539824;40;40;0.475;21;19;0.025;0.475
Control.SRR15539824;36;40;0.527777777777778;17;19;0.0277777777777778;0.472222222222222
Control.SRR15539824;37;40;0.594594594594595;15;22;0.0945945945945946;0.405405405405405
Control.SRR15539824;37;40;0.513513513513513;18;19;0.0135135135135135;0.486486486486487
Control.SRR15539824;37;40;0.513513513513513;18;19;0.0135135135135135;0.486486486486487
Control.SRR15539824;39;40;0.435897435897436;22;17;0.0641025641025641;0.435897435897436
Control.SRR15539824;39;40;0.41025641025641;23;16;0.0897435897435898;0.41025641025641
Control.SRR15539824;37;40;0.513513513513513;18;19;0.0135135135135135;0.486486486486487
Control.SRR15539824;38;40;0.578947368421053;16;22;0.0789473684210527;0.421052631578947
Control.SRR15539824;34;40;0.352941176470588;22;12;0.147058823529412;0.352941176470588
Control.SRR15539824;35;40;0.428571428571429;20;15;0.0714285714285715;0.428571428571429
Control.SRR15539824;37;40;0.486486486486487;19;18;0.0135135135135135;0.486486486486487
Control.SRR15539824;36;40;0.666666666666667;12;24;0.166666666666667;0.333333333333333
Control.SRR15539824;38;40;0.447368421052632;21;17;0.0526315789473684;0.447368421052632
Control.SRR15539824;37;40;0.378378378378378;23;14;0.121621621621622;0.378378378378378
Control.SRR15539824;42;40;0.595238095238095;17;25;0.0952380952380952;0.404761904761905
Control.SRR15539824;40;40;0.5;20;20;0;0.5
Control.SRR15539824;39;40;0.666666666666667;13;26;0.166666666666667;0.333333333333333
Control.SRR15539824;40;40;0.5;20;20;0;0.5
Control.SRR15539824;41;40;0.51219512195122;20;21;0.0121951219512195;0.48780487804878
Control.SRR15539824;40;40;0.725;11;29;0.225;0.275
Control.SRR15539824;40;40;0.375;25;15;0.125;0.375
Control.SRR15539824;43;40;0.511627906976744;21;22;0.0116279069767442;0.488372093023256
Control.SRR15539824;36;40;0.555555555555556;16;20;0.0555555555555556;0.444444444444444
Control.SRR15539824;40;40;0.575;17;23;0.075;0.425
Control.SRR15539824;40;40;0.6;16;24;0.1;0.4
Control.SRR15539824;40;40;0.575;17;23;0.075;0.425
Control.SRR15539824;36;40;0.555555555555556;16;20;0.0555555555555556;0.444444444444444
Control.SRR15539824;36;40;0.444444444444444;20;16;0.0555555555555556;0.444444444444444
Control.SRR15539824;35;40;0.4;21;14;0.1;0.4
Control.SRR15539824;42;40;0.333333333333333;28;14;0.166666666666667;0.333333333333333
Control.SRR15539824;35;40;0.514285714285714;17;18;0.0142857142857142;0.485714285714286
Control.SRR15539824;33;40;0.454545454545455;18;15;0.0454545454545455;0.454545454545455
Control.SRR15539824;34;40;0.558823529411765;15;19;0.0588235294117647;0.441176470588235
Control.SRR15539824;39;40;0.538461538461538;18;21;0.0384615384615384;0.461538461538462
Control.SRR15539824;43;40;0.488372093023256;22;21;0.0116279069767442;0.488372093023256
Control.SRR15539824;33;40;0.545454545454545;15;18;0.0454545454545454;0.454545454545455
Control.SRR15539824;43;40;0.511627906976744;21;22;0.0116279069767442;0.488372093023256
Control.SRR15539824;37;40;0.405405405405405;22;15;0.0945945945945946;0.405405405405405
Control.SRR15539824;37;40;0.648648648648649;13;24;0.148648648648649;0.351351351351351
Control.SRR15539824;39;40;0.641025641025641;14;25;0.141025641025641;0.358974358974359
Control.SRR15539824;41;40;0.51219512195122;20;21;0.0121951219512195;0.48780487804878
Control.SRR15539824;38;40;0.552631578947368;17;21;0.0526315789473685;0.447368421052632
Control.SRR15539824;39;40;0.538461538461538;18;21;0.0384615384615384;0.461538461538462
Control.SRR15539824;37;40;0.675675675675676;12;25;0.175675675675676;0.324324324324324
Control.SRR15539824;36;40;0.583333333333333;15;21;0.0833333333333334;0.416666666666667
Control.SRR15539824;36;40;0.472222222222222;19;17;0.0277777777777778;0.472222222222222
Control.SRR15539824;41;40;0.51219512195122;20;21;0.0121951219512195;0.48780487804878
Control.SRR15539824;40;40;0.525;19;21;0.025;0.475
Control.SRR15539824;42;40;0.571428571428571;18;24;0.0714285714285714;0.428571428571429
Control.SRR15539824;36;40;0.416666666666667;21;15;0.0833333333333333;0.416666666666667
Control.SRR15539824;37;40;0.432432432432432;21;16;0.0675675675675675;0.432432432432432
Control.SRR15539824;33;40;0.484848484848485;17;16;0.0151515151515151;0.484848484848485
Control.SRR15539824;36;40;0.638888888888889;13;23;0.138888888888889;0.361111111111111
Control.SRR15539824;35;40;0.6;14;21;0.1;0.4
Control.SRR15539824;35;40;0.514285714285714;17;18;0.0142857142857142;0.485714285714286
Control.SRR15539824;37;40;0.486486486486487;19;18;0.0135135135135135;0.486486486486487
Control.SRR15539824;38;40;0.526315789473684;18;20;0.0263157894736842;0.473684210526316
Control.SRR15539824;38;40;0.473684210526316;20;18;0.0263157894736842;0.473684210526316
Control.SRR15539824;38;40;0.394736842105263;23;15;0.105263157894737;0.394736842105263
Control.SRR15539824;43;40;0.534883720930233;20;23;0.0348837209302325;0.465116279069767
Control.SRR15539824;38;40;0.473684210526316;20;18;0.0263157894736842;0.473684210526316
Control.SRR15539824;33;40;0.575757575757576;14;19;0.0757575757575758;0.424242424242424
Control.SRR15539824;40;40;0.5;20;20;0;0.5
Control.SRR15539824;33;40;0.575757575757576;14;19;0.0757575757575758;0.424242424242424
Control.SRR15539824;42;40;0.547619047619048;19;23;0.0476190476190477;0.452380952380952
Control.SRR15539824;43;40;0.534883720930233;20;23;0.0348837209302325;0.465116279069767
Control.SRR15539824;34;40;0.617647058823529;13;21;0.117647058823529;0.382352941176471
Control.SRR15539824;37;40;0.648648648648649;13;24;0.148648648648649;0.351351351351351
Control.SRR15539824;40;40;0.4;24;16;0.1;0.4
Control.SRR15539824;37;40;0.540540540540541;17;20;0.0405405405405406;0.459459459459459
Control.SRR15539824;43;40;0.465116279069767;23;20;0.0348837209302326;0.465116279069767
Control.SRR15539824;40;40;0.475;21;19;0.025;0.475
Control.SRR15539824;40;40;0.6;16;24;0.1;0.4
Control.SRR15539824;40;40;0.55;18;22;0.05;0.45
Control.SRR15539824;37;40;0.621621621621622;14;23;0.121621621621622;0.378378378378378
Control.SRR15539824;40;40;0.425;23;17;0.075;0.425
Control.SRR15539824;37;40;0.513513513513513;18;19;0.0135135135135135;0.486486486486487
Control.SRR15539824;33;40;0.484848484848485;17;16;0.0151515151515151;0.484848484848485
Control.SRR15539824;36;40;0.555555555555556;16;20;0.0555555555555556;0.444444444444444
Control.SRR15539824;38;40;0.473684210526316;20;18;0.0263157894736842;0.473684210526316
Control.SRR15539824;35;40;0.457142857142857;19;16;0.0428571428571429;0.457142857142857
Control.SRR15539824;34;40;0.470588235294118;18;16;0.0294117647058824;0.470588235294118
Control.SRR15539824;37;40;0.405405405405405;22;15;0.0945945945945946;0.405405405405405
Control.SRR15539824;35;40;0.628571428571429;13;22;0.128571428571429;0.371428571428571
Control.SRR15539824;36;40;0.444444444444444;20;16;0.0555555555555556;0.444444444444444
Control.SRR15539824;36;40;0.666666666666667;12;24;0.166666666666667;0.333333333333333
Control.SRR15539824;34;40;0.411764705882353;20;14;0.0882352941176471;0.411764705882353
Control.SRR15539824;35;40;0.514285714285714;17;18;0.0142857142857142;0.485714285714286
Control.SRR15539824;36;40;0.472222222222222;19;17;0.0277777777777778;0.472222222222222
Control.SRR15539824;40;40;0.45;22;18;0.05;0.45
Control.SRR15539824;33;40;0.484848484848485;17;16;0.0151515151515151;0.484848484848485
Control.SRR15539824;36;40;0.5;18;18;0;0.5
Control.SRR15539824;38;40;0.473684210526316;20;18;0.0263157894736842;0.473684210526316
Control.SRR15539824;43;40;0.534883720930233;20;23;0.0348837209302325;0.465116279069767
Control.SRR15539824;34;40;0.470588235294118;18;16;0.0294117647058824;0.470588235294118
Control.SRR15539824;37;40;0.486486486486487;19;18;0.0135135135135135;0.486486486486487
Control.SRR15539824;38;40;0.552631578947368;17;21;0.0526315789473685;0.447368421052632
Control.SRR15539824;36;40;0.555555555555556;16;20;0.0555555555555556;0.444444444444444
Control.SRR15539824;39;40;0.487179487179487;20;19;0.0128205128205128;0.487179487179487
Control.SRR15539824;42;40;0.571428571428571;18;24;0.0714285714285714;0.428571428571429
Control.SRR15539824;40;40;0.45;22;18;0.05;0.45
Control.SRR15539824;39;40;0.384615384615385;24;15;0.115384615384615;0.384615384615385
Control.SRR15539824;36;40;0.444444444444444;20;16;0.0555555555555556;0.444444444444444
Control.SRR15539824;33;40;0.454545454545455;18;15;0.0454545454545455;0.454545454545455
Control.SRR15539824;38;40;0.578947368421053;16;22;0.0789473684210527;0.421052631578947
Control.SRR15539824;34;40;0.588235294117647;14;20;0.0882352941176471;0.411764705882353
Control.SRR15539824;34;40;0.411764705882353;20;14;0.0882352941176471;0.411764705882353
Control.SRR15539824;42;40;0.476190476190476;22;20;0.0238095238095238;0.476190476190476
Control.SRR15539824;38;40;0.552631578947368;17;21;0.0526315789473685;0.447368421052632
Control.SRR15539824;40;40;0.525;19;21;0.025;0.475
Control.SRR15539824;41;40;0.51219512195122;20;21;0.0121951219512195;0.48780487804878
Control.SRR15539824;38;40;0.473684210526316;20;18;0.0263157894736842;0.473684210526316
Control.SRR15539824;43;40;0.465116279069767;23;20;0.0348837209302326;0.465116279069767
Control.SRR15539824;38;40;0.421052631578947;22;16;0.0789473684210527;0.421052631578947
Control.SRR15539824;37;40;0.513513513513513;18;19;0.0135135135135135;0.486486486486487
Control.SRR15539824;34;40;0.588235294117647;14;20;0.0882352941176471;0.411764705882353
Control.SRR15539824;36;40;0.5;18;18;0;0.5
Control.SRR15539824;37;40;0.459459459459459;20;17;0.0405405405405405;0.459459459459459
Control.SRR15539824;34;40;0.529411764705882;16;18;0.0294117647058824;0.470588235294118
Control.SRR15539824;37;40;0.486486486486487;19;18;0.0135135135135135;0.486486486486487
Control.SRR15539824;41;40;0.585365853658537;17;24;0.0853658536585366;0.414634146341463
Control.SRR15539824;40;40;0.475;21;19;0.025;0.475
Control.SRR15539824;38;40;0.394736842105263;23;15;0.105263157894737;0.394736842105263
Control.SRR15539824;40;40;0.475;21;19;0.025;0.475
Control.SRR15539824;43;40;0.348837209302326;28;15;0.151162790697674;0.348837209302326
Control.SRR15539824;37;40;0.486486486486487;19;18;0.0135135135135135;0.486486486486487
Control.SRR15539824;37;40;0.486486486486487;19;18;0.0135135135135135;0.486486486486487
Control.SRR15539824;43;40;0.581395348837209;18;25;0.0813953488372093;0.418604651162791
Control.SRR15539824;42;40;0.595238095238095;17;25;0.0952380952380952;0.404761904761905
Control.SRR15539824;37;40;0.540540540540541;17;20;0.0405405405405406;0.459459459459459
Control.SRR15539824;39;40;0.538461538461538;18;21;0.0384615384615384;0.461538461538462
Control.SRR15539824;39;40;0.461538461538462;21;18;0.0384615384615384;0.461538461538462
Control.SRR15539824;41;40;0.536585365853659;19;22;0.0365853658536586;0.463414634146341
Control.SRR15539824;36;40;0.638888888888889;13;23;0.138888888888889;0.361111111111111
Control.SRR15539824;35;40;0.542857142857143;16;19;0.0428571428571428;0.457142857142857
Control.SRR15539824;37;40;0.405405405405405;22;15;0.0945945945945946;0.405405405405405
Control.SRR15539824;43;40;0.558139534883721;19;24;0.0581395348837209;0.441860465116279
Control.SRR15539824;34;40;0.441176470588235;19;15;0.0588235294117647;0.441176470588235
Control.SRR15539824;40;40;0.625;15;25;0.125;0.375
Control.SRR15539824;40;40;0.45;22;18;0.05;0.45
Control.SRR15539824;34;40;0.558823529411765;15;19;0.0588235294117647;0.441176470588235
Control.SRR15539824;34;40;0.441176470588235;19;15;0.0588235294117647;0.441176470588235
Control.SRR15539824;37;40;0.513513513513513;18;19;0.0135135135135135;0.486486486486487
Control.SRR15539824;39;40;0.487179487179487;20;19;0.0128205128205128;0.487179487179487
Control.SRR15539824;43;40;0.441860465116279;24;19;0.0581395348837209;0.441860465116279
Control.SRR15539824;43;40;0.581395348837209;18;25;0.0813953488372093;0.418604651162791
Control.SRR15539824;38;40;0.447368421052632;21;17;0.0526315789473684;0.447368421052632
Control.SRR15539824;36;40;0.388888888888889;22;14;0.111111111111111;0.388888888888889
Control.SRR15539824;43;40;0.511627906976744;21;22;0.0116279069767442;0.488372093023256
Control.SRR15539824;35;40;0.571428571428571;15;20;0.0714285714285714;0.428571428571429
Control.SRR15539824;41;40;0.536585365853659;19;22;0.0365853658536586;0.463414634146341
Control.SRR15539824;35;40;0.628571428571429;13;22;0.128571428571429;0.371428571428571
Control.SRR15539824;33;40;0.636363636363636;12;21;0.136363636363636;0.363636363636364
Control.SRR15539824;34;40;0.411764705882353;20;14;0.0882352941176471;0.411764705882353
Control.SRR15539824;42;40;0.642857142857143;15;27;0.142857142857143;0.357142857142857
Control.SRR15539824;33;40;0.424242424242424;19;14;0.0757575757575757;0.424242424242424
Control.SRR15539824;40;40;0.375;25;15;0.125;0.375
Control.SRR15539824;39;40;0.41025641025641;23;16;0.0897435897435898;0.41025641025641
Control.SRR15539824;34;40;0.411764705882353;20;14;0.0882352941176471;0.411764705882353
Control.SRR15539824;36;40;0.555555555555556;16;20;0.0555555555555556;0.444444444444444
Control.SRR15539824;37;40;0.432432432432432;21;16;0.0675675675675675;0.432432432432432
Control.SRR15539824;34;40;0.588235294117647;14;20;0.0882352941176471;0.411764705882353
Control.SRR15539824;42;40;0.571428571428571;18;24;0.0714285714285714;0.428571428571429
Control.SRR15539824;34;40;0.617647058823529;13;21;0.117647058823529;0.382352941176471
Control.SRR15539824;34;40;0.558823529411765;15;19;0.0588235294117647;0.441176470588235
Control.SRR15539824;33;40;0.393939393939394;20;13;0.106060606060606;0.393939393939394
Control.SRR15539824;40;40;0.425;23;17;0.075;0.425
Control.SRR15539824;38;40;0.421052631578947;22;16;0.0789473684210527;0.421052631578947
Control.SRR15539824;39;40;0.384615384615385;24;15;0.115384615384615;0.384615384615385
Control.SRR15539824;41;40;0.390243902439024;25;16;0.109756097560976;0.390243902439024
Control.SRR15539824;42;40;0.595238095238095;17;25;0.0952380952380952;0.404761904761905
Control.SRR15539824;39;40;0.333333333333333;26;13;0.166666666666667;0.333333333333333
Control.SRR15539824;41;40;0.414634146341463;24;17;0.0853658536585366;0.414634146341463
Control.SRR15539824;42;40;0.571428571428571;18;24;0.0714285714285714;0.428571428571429
Control.SRR15539824;43;40;0.465116279069767;23;20;0.0348837209302326;0.465116279069767
Control.SRR15539824;40;40;0.45;22;18;0.05;0.45
Control.SRR15539824;39;40;0.512820512820513;19;20;0.0128205128205128;0.487179487179487
Control.SRR15539824;34;40;0.411764705882353;20;14;0.0882352941176471;0.411764705882353
Control.SRR15539824;36;40;0.611111111111111;14;22;0.111111111111111;0.388888888888889
Control.SRR15539824;35;40;0.657142857142857;12;23;0.157142857142857;0.342857142857143
Control.SRR15539824;40;40;0.625;15;25;0.125;0.375
Control.SRR15539824;33;40;0.515151515151515;16;17;0.0151515151515151;0.484848484848485
Control.SRR15539824;38;40;0.552631578947368;17;21;0.0526315789473685;0.447368421052632
Control.SRR15539824;34;40;0.470588235294118;18;16;0.0294117647058824;0.470588235294118
Control.SRR15539824;37;40;0.459459459459459;20;17;0.0405405405405405;0.459459459459459
Control.SRR15539824;37;40;0.621621621621622;14;23;0.121621621621622;0.378378378378378
Control.SRR15539824;39;40;0.564102564102564;17;22;0.0641025641025641;0.435897435897436
Control.SRR15539824;39;40;0.461538461538462;21;18;0.0384615384615384;0.461538461538462
Control.SRR15539824;42;40;0.595238095238095;17;25;0.0952380952380952;0.404761904761905
Control.SRR15539824;39;40;0.512820512820513;19;20;0.0128205128205128;0.487179487179487
Control.SRR15539824;39;40;0.435897435897436;22;17;0.0641025641025641;0.435897435897436
Control.SRR15539824;41;40;0.585365853658537;17;24;0.0853658536585366;0.414634146341463
Control.SRR15539824;37;40;0.540540540540541;17;20;0.0405405405405406;0.459459459459459
Control.SRR15539824;42;40;0.428571428571429;24;18;0.0714285714285715;0.428571428571429
Control.SRR15539824;41;40;0.560975609756098;18;23;0.0609756097560976;0.439024390243902
Control.SRR15539824;36;40;0.5;18;18;0;0.5
Control.SRR15539824;33;40;0.606060606060606;13;20;0.106060606060606;0.393939393939394
Control.SRR15539824;35;40;0.571428571428571;15;20;0.0714285714285714;0.428571428571429
Control.SRR15539824;35;40;0.542857142857143;16;19;0.0428571428571428;0.457142857142857
Control.SRR15539824;35;40;0.6;14;21;0.1;0.4
Control.SRR15539824;35;40;0.514285714285714;17;18;0.0142857142857142;0.485714285714286
Control.SRR15539824;39;40;0.58974358974359;16;23;0.0897435897435898;0.41025641025641
Control.SRR15539824;38;40;0.421052631578947;22;16;0.0789473684210527;0.421052631578947
Control.SRR15539824;35;40;0.514285714285714;17;18;0.0142857142857142;0.485714285714286
Control.SRR15539824;34;40;0.411764705882353;20;14;0.0882352941176471;0.411764705882353
Control.SRR15539824;37;40;0.513513513513513;18;19;0.0135135135135135;0.486486486486487
Control.SRR15539824;34;40;0.5;17;17;0;0.5
Control.SRR15539824;39;40;0.538461538461538;18;21;0.0384615384615384;0.461538461538462
Control.SRR15539824;33;40;0.393939393939394;20;13;0.106060606060606;0.393939393939394
Control.SRR15539824;35;40;0.485714285714286;18;17;0.0142857142857143;0.485714285714286
Control.SRR15539824;37;40;0.540540540540541;17;20;0.0405405405405406;0.459459459459459
Control.SRR15539824;37;40;0.432432432432432;21;16;0.0675675675675675;0.432432432432432
Control.SRR15539824;33;40;0.606060606060606;13;20;0.106060606060606;0.393939393939394
Control.SRR15539824;38;40;0.552631578947368;17;21;0.0526315789473685;0.447368421052632
Control.SRR15539824;37;40;0.540540540540541;17;20;0.0405405405405406;0.459459459459459
Control.SRR15539824;34;40;0.558823529411765;15;19;0.0588235294117647;0.441176470588235
Control.SRR15539824;34;40;0.470588235294118;18;16;0.0294117647058824;0.470588235294118
Control.SRR15539824;37;40;0.432432432432432;21;16;0.0675675675675675;0.432432432432432
Control.SRR15539824;37;40;0.621621621621622;14;23;0.121621621621622;0.378378378378378
Control.SRR15539824;42;40;0.523809523809524;20;22;0.0238095238095238;0.476190476190476
Control.SRR15539824;39;40;0.435897435897436;22;17;0.0641025641025641;0.435897435897436
Control.SRR15539824;36;40;0.444444444444444;20;16;0.0555555555555556;0.444444444444444
Control.SRR15539824;36;40;0.472222222222222;19;17;0.0277777777777778;0.472222222222222
Control.SRR15539824;39;40;0.487179487179487;20;19;0.0128205128205128;0.487179487179487
Control.SRR15539824;39;40;0.333333333333333;26;13;0.166666666666667;0.333333333333333
Control.SRR15539824;40;40;0.45;22;18;0.05;0.45
Control.SRR15539824;36;40;0.388888888888889;22;14;0.111111111111111;0.388888888888889
Control.SRR15539824;33;40;0.575757575757576;14;19;0.0757575757575758;0.424242424242424
Control.SRR15539824;33;40;0.515151515151515;16;17;0.0151515151515151;0.484848484848485
Control.SRR15539824;39;40;0.58974358974359;16;23;0.0897435897435898;0.41025641025641
Control.SRR15539824;39;40;0.538461538461538;18;21;0.0384615384615384;0.461538461538462
Control.SRR15539824;36;40;0.388888888888889;22;14;0.111111111111111;0.388888888888889
Control.SRR15539824;37;40;0.675675675675676;12;25;0.175675675675676;0.324324324324324
Control.SRR15539824;43;40;0.465116279069767;23;20;0.0348837209302326;0.465116279069767
Control.SRR15539824;34;40;0.441176470588235;19;15;0.0588235294117647;0.441176470588235
Control.SRR15539824;36;40;0.5;18;18;0;0.5
Control.SRR15539824;39;40;0.41025641025641;23;16;0.0897435897435898;0.41025641025641
Control.SRR15539824;35;40;0.457142857142857;19;16;0.0428571428571429;0.457142857142857
Control.SRR15539824;35;40;0.4;21;14;0.1;0.4
Control.SRR15539824;37;40;0.378378378378378;23;14;0.121621621621622;0.378378378378378
Control.SRR15539824;35;40;0.514285714285714;17;18;0.0142857142857142;0.485714285714286
Control.SRR15539824;39;40;0.564102564102564;17;22;0.0641025641025641;0.435897435897436
Control.SRR15539824;37;40;0.459459459459459;20;17;0.0405405405405405;0.459459459459459
Control.SRR15539824;39;40;0.333333333333333;26;13;0.166666666666667;0.333333333333333
Control.SRR15539824;39;40;0.512820512820513;19;20;0.0128205128205128;0.487179487179487
Control.SRR15539824;39;40;0.564102564102564;17;22;0.0641025641025641;0.435897435897436
Control.SRR15539824;35;40;0.6;14;21;0.1;0.4
Control.SRR15539824;42;40;0.380952380952381;26;16;0.119047619047619;0.380952380952381
Control.SRR15539824;37;40;0.486486486486487;19;18;0.0135135135135135;0.486486486486487
Control.SRR15539824;34;40;0.529411764705882;16;18;0.0294117647058824;0.470588235294118
Control.SRR15539824;37;40;0.486486486486487;19;18;0.0135135135135135;0.486486486486487
Control.SRR15539824;37;40;0.432432432432432;21;16;0.0675675675675675;0.432432432432432
Control.SRR15539824;33;40;0.454545454545455;18;15;0.0454545454545455;0.454545454545455
Control.SRR15539824;41;40;0.536585365853659;19;22;0.0365853658536586;0.463414634146341
Control.SRR15539824;40;40;0.6;16;24;0.1;0.4
Control.SRR15539824;38;40;0.394736842105263;23;15;0.105263157894737;0.394736842105263
Control.SRR15539824;35;40;0.4;21;14;0.1;0.4
Control.SRR15539824;38;40;0.394736842105263;23;15;0.105263157894737;0.394736842105263
Control.SRR15539824;36;40;0.527777777777778;17;19;0.0277777777777778;0.472222222222222
Control.SRR15539824;41;40;0.51219512195122;20;21;0.0121951219512195;0.48780487804878
Control.SRR15539824;34;40;0.529411764705882;16;18;0.0294117647058824;0.470588235294118
Control.SRR15539824;38;40;0.552631578947368;17;21;0.0526315789473685;0.447368421052632
Control.SRR15539824;39;40;0.461538461538462;21;18;0.0384615384615384;0.461538461538462
Control.SRR15539824;33;40;0.545454545454545;15;18;0.0454545454545454;0.454545454545455
Control.SRR15539824;35;40;0.485714285714286;18;17;0.0142857142857143;0.485714285714286
Control.SRR15539824;33;40;0.393939393939394;20;13;0.106060606060606;0.393939393939394
Control.SRR15539824;34;40;0.529411764705882;16;18;0.0294117647058824;0.470588235294118
Control.SRR15539824;43;40;0.488372093023256;22;21;0.0116279069767442;0.488372093023256
Control.SRR15539824;39;40;0.435897435897436;22;17;0.0641025641025641;0.435897435897436
Control.SRR15539824;34;40;0.617647058823529;13;21;0.117647058823529;0.382352941176471
Control.SRR15539824;33;40;0.454545454545455;18;15;0.0454545454545455;0.454545454545455
Control.SRR15539824;42;40;0.547619047619048;19;23;0.0476190476190477;0.452380952380952
Control.SRR15539824;43;40;0.534883720930233;20;23;0.0348837209302325;0.465116279069767
Control.SRR15539824;39;40;0.564102564102564;17;22;0.0641025641025641;0.435897435897436
Control.SRR15539824;37;40;0.459459459459459;20;17;0.0405405405405405;0.459459459459459
Control.SRR15539824;37;40;0.405405405405405;22;15;0.0945945945945946;0.405405405405405
Control.SRR15539824;37;40;0.540540540540541;17;20;0.0405405405405406;0.459459459459459
Control.SRR15539824;41;40;0.560975609756098;18;23;0.0609756097560976;0.439024390243902
Control.SRR15539824;34;40;0.5;17;17;0;0.5
Control.SRR15539824;40;40;0.45;22;18;0.05;0.45
Control.SRR15539824;39;40;0.384615384615385;24;15;0.115384615384615;0.384615384615385
Control.SRR15539824;40;40;0.625;15;25;0.125;0.375
Control.SRR15539824;42;40;0.452380952380952;23;19;0.0476190476190476;0.452380952380952
Control.SRR15539824;34;40;0.441176470588235;19;15;0.0588235294117647;0.441176470588235
Control.SRR15539824;36;40;0.444444444444444;20;16;0.0555555555555556;0.444444444444444
Control.SRR15539824;36;40;0.5;18;18;0;0.5
Control.SRR15539824;39;40;0.41025641025641;23;16;0.0897435897435898;0.41025641025641
Control.SRR15539824;39;40;0.564102564102564;17;22;0.0641025641025641;0.435897435897436
Control.SRR15539824;40;40;0.45;22;18;0.05;0.45
Control.SRR15539824;40;40;0.55;18;22;0.05;0.45
Control.SRR15539824;35;40;0.485714285714286;18;17;0.0142857142857143;0.485714285714286
Control.SRR15539824;42;40;0.380952380952381;26;16;0.119047619047619;0.380952380952381
Control.SRR15539824;38;40;0.473684210526316;20;18;0.0263157894736842;0.473684210526316
Control.SRR15539824;37;40;0.594594594594595;15;22;0.0945945945945946;0.405405405405405
Control.SRR15539824;34;40;0.411764705882353;20;14;0.0882352941176471;0.411764705882353
Control.SRR15539824;38;40;0.631578947368421;14;24;0.131578947368421;0.368421052631579
Control.SRR15539824;39;40;0.487179487179487;20;19;0.0128205128205128;0.487179487179487
Control.SRR15539824;34;40;0.529411764705882;16;18;0.0294117647058824;0.470588235294118
Control.SRR15539824;39;40;0.564102564102564;17;22;0.0641025641025641;0.435897435897436
Control.SRR15539824;43;40;0.581395348837209;18;25;0.0813953488372093;0.418604651162791
Control.SRR15539824;40;40;0.525;19;21;0.025;0.475
Control.SRR15539824;33;40;0.606060606060606;13;20;0.106060606060606;0.393939393939394
Control.SRR15539824;35;40;0.571428571428571;15;20;0.0714285714285714;0.428571428571429
Control.SRR15539824;38;40;0.552631578947368;17;21;0.0526315789473685;0.447368421052632
Control.SRR15539824;38;40;0.5;19;19;0;0.5
Control.SRR15539824;43;40;0.558139534883721;19;24;0.0581395348837209;0.441860465116279
Control.SRR15539824;41;40;0.463414634146341;22;19;0.0365853658536585;0.463414634146341
Control.SRR15539824;34;40;0.470588235294118;18;16;0.0294117647058824;0.470588235294118
Control.SRR15539824;40;40;0.45;22;18;0.05;0.45
Control.SRR15539824;41;40;0.365853658536585;26;15;0.134146341463415;0.365853658536585
Control.SRR15539824;38;40;0.526315789473684;18;20;0.0263157894736842;0.473684210526316
Control.SRR15539824;36;40;0.472222222222222;19;17;0.0277777777777778;0.472222222222222
Control.SRR15539824;39;40;0.435897435897436;22;17;0.0641025641025641;0.435897435897436
Control.SRR15539824;41;40;0.536585365853659;19;22;0.0365853658536586;0.463414634146341
Control.SRR15539824;38;40;0.578947368421053;16;22;0.0789473684210527;0.421052631578947
Control.SRR15539824;39;40;0.538461538461538;18;21;0.0384615384615384;0.461538461538462
Control.SRR15539824;35;40;0.571428571428571;15;20;0.0714285714285714;0.428571428571429
Control.SRR15539824;34;40;0.529411764705882;16;18;0.0294117647058824;0.470588235294118
Control.SRR15539824;40;40;0.4;24;16;0.1;0.4
Control.SRR15539824;42;40;0.595238095238095;17;25;0.0952380952380952;0.404761904761905
Control.SRR15539824;38;40;0.447368421052632;21;17;0.0526315789473684;0.447368421052632
Control.SRR15539824;39;40;0.384615384615385;24;15;0.115384615384615;0.384615384615385
Control.SRR15539824;42;40;0.428571428571429;24;18;0.0714285714285715;0.428571428571429
Control.SRR15539824;40;40;0.55;18;22;0.05;0.45
Control.SRR15539824;37;40;0.378378378378378;23;14;0.121621621621622;0.378378378378378
Control.SRR15539824;36;40;0.5;18;18;0;0.5
Control.SRR15539824;35;40;0.371428571428571;22;13;0.128571428571429;0.371428571428571
Control.SRR15539824;40;40;0.525;19;21;0.025;0.475
Control.SRR15539824;40;40;0.375;25;15;0.125;0.375
Control.SRR15539824;34;40;0.558823529411765;15;19;0.0588235294117647;0.441176470588235
Control.SRR15539824;39;40;0.435897435897436;22;17;0.0641025641025641;0.435897435897436
Control.SRR15539824;36;40;0.555555555555556;16;20;0.0555555555555556;0.444444444444444
Control.SRR15539824;36;40;0.472222222222222;19;17;0.0277777777777778;0.472222222222222
Control.SRR15539824;38;40;0.605263157894737;15;23;0.105263157894737;0.394736842105263
Control.SRR15539824;40;40;0.45;22;18;0.05;0.45
Control.SRR15539824;43;40;0.581395348837209;18;25;0.0813953488372093;0.418604651162791
Control.SRR15539824;41;40;0.658536585365854;14;27;0.158536585365854;0.341463414634146
Control.SRR15539824;42;40;0.595238095238095;17;25;0.0952380952380952;0.404761904761905
Control.SRR15539824;39;40;0.58974358974359;16;23;0.0897435897435898;0.41025641025641
Control.SRR15539824;34;40;0.5;17;17;0;0.5
Control.SRR15539824;43;40;0.511627906976744;21;22;0.0116279069767442;0.488372093023256
Control.SRR15539824;43;40;0.441860465116279;24;19;0.0581395348837209;0.441860465116279
Control.SRR15539824;38;40;0.631578947368421;14;24;0.131578947368421;0.368421052631579
Control.SRR15539824;36;40;0.472222222222222;19;17;0.0277777777777778;0.472222222222222
Control.SRR15539824;37;40;0.405405405405405;22;15;0.0945945945945946;0.405405405405405
Control.SRR15539824;33;40;0.696969696969697;10;23;0.196969696969697;0.303030303030303
Control.SRR15539824;38;40;0.447368421052632;21;17;0.0526315789473684;0.447368421052632
Control.SRR15539824;39;40;0.461538461538462;21;18;0.0384615384615384;0.461538461538462
Control.SRR15539824;41;40;0.536585365853659;19;22;0.0365853658536586;0.463414634146341
Control.SRR15539824;38;40;0.605263157894737;15;23;0.105263157894737;0.394736842105263
Control.SRR15539824;35;40;0.457142857142857;19;16;0.0428571428571429;0.457142857142857
Control.SRR15539824;37;40;0.324324324324324;25;12;0.175675675675676;0.324324324324324
Control.SRR15539824;35;40;0.6;14;21;0.1;0.4
Control.SRR15539824;34;40;0.470588235294118;18;16;0.0294117647058824;0.470588235294118
Control.SRR15539824;35;40;0.485714285714286;18;17;0.0142857142857143;0.485714285714286
Control.SRR15539824;38;40;0.578947368421053;16;22;0.0789473684210527;0.421052631578947
Control.SRR15539824;37;40;0.567567567567568;16;21;0.0675675675675675;0.432432432432432
Control.SRR15539824;36;40;0.666666666666667;12;24;0.166666666666667;0.333333333333333
Control.SRR15539824;34;40;0.441176470588235;19;15;0.0588235294117647;0.441176470588235
Control.SRR15539824;36;40;0.666666666666667;12;24;0.166666666666667;0.333333333333333
Control.SRR15539824;36;40;0.527777777777778;17;19;0.0277777777777778;0.472222222222222
Control.SRR15539824;38;40;0.289473684210526;27;11;0.210526315789474;0.289473684210526
Control.SRR15539824;34;40;0.470588235294118;18;16;0.0294117647058824;0.470588235294118
Control.SRR15539824;36;40;0.444444444444444;20;16;0.0555555555555556;0.444444444444444
Control.SRR15539824;36;40;0.583333333333333;15;21;0.0833333333333334;0.416666666666667
Control.SRR15539824;36;40;0.527777777777778;17;19;0.0277777777777778;0.472222222222222
Control.SRR15539824;38;40;0.5;19;19;0;0.5
Control.SRR15539824;40;40;0.55;18;22;0.05;0.45
Control.SRR15539824;34;40;0.5;17;17;0;0.5
Control.SRR15539824;34;40;0.617647058823529;13;21;0.117647058823529;0.382352941176471
Control.SRR15539824;39;40;0.435897435897436;22;17;0.0641025641025641;0.435897435897436
Control.SRR15539824;41;40;0.414634146341463;24;17;0.0853658536585366;0.414634146341463
Control.SRR15539824;38;40;0.552631578947368;17;21;0.0526315789473685;0.447368421052632
Control.SRR15539824;34;40;0.558823529411765;15;19;0.0588235294117647;0.441176470588235
Control.SRR15539824;33;40;0.484848484848485;17;16;0.0151515151515151;0.484848484848485
Control.SRR15539824;33;40;0.545454545454545;15;18;0.0454545454545454;0.454545454545455
Control.SRR15539824;35;40;0.428571428571429;20;15;0.0714285714285715;0.428571428571429
Control.SRR15539824;35;40;0.485714285714286;18;17;0.0142857142857143;0.485714285714286
Control.SRR15539824;34;40;0.470588235294118;18;16;0.0294117647058824;0.470588235294118
Control.SRR15539824;33;40;0.424242424242424;19;14;0.0757575757575757;0.424242424242424
Control.SRR15539824;33;40;0.484848484848485;17;16;0.0151515151515151;0.484848484848485
Control.SRR15539824;40;40;0.475;21;19;0.025;0.475
Control.SRR15539824;38;40;0.526315789473684;18;20;0.0263157894736842;0.473684210526316
Control.SRR15539824;40;40;0.525;19;21;0.025;0.475
Control.SRR15539824;39;40;0.41025641025641;23;16;0.0897435897435898;0.41025641025641
Control.SRR15539824;41;40;0.51219512195122;20;21;0.0121951219512195;0.48780487804878
Control.SRR15539824;39;40;0.461538461538462;21;18;0.0384615384615384;0.461538461538462
Control.SRR15539824;40;40;0.65;14;26;0.15;0.35
Control.SRR15539824;33;40;0.515151515151515;16;17;0.0151515151515151;0.484848484848485
Control.SRR15539824;37;40;0.459459459459459;20;17;0.0405405405405405;0.459459459459459
Control.SRR15539824;33;40;0.484848484848485;17;16;0.0151515151515151;0.484848484848485
Control.SRR15539824;35;40;0.714285714285714;10;25;0.214285714285714;0.285714285714286
Control.SRR15539824;40;40;0.475;21;19;0.025;0.475
Control.SRR15539824;40;40;0.5;20;20;0;0.5
Control.SRR15539824;34;40;0.588235294117647;14;20;0.0882352941176471;0.411764705882353
Control.SRR15539824;42;40;0.714285714285714;12;30;0.214285714285714;0.285714285714286
Control.SRR15539824;40;40;0.525;19;21;0.025;0.475
Control.SRR15539824;36;40;0.416666666666667;21;15;0.0833333333333333;0.416666666666667
Control.SRR15539824;41;40;0.536585365853659;19;22;0.0365853658536586;0.463414634146341
Control.SRR15539824;38;40;0.605263157894737;15;23;0.105263157894737;0.394736842105263
Control.SRR15539824;34;40;0.382352941176471;21;13;0.117647058823529;0.382352941176471
Control.SRR15539824;38;40;0.526315789473684;18;20;0.0263157894736842;0.473684210526316
Control.SRR15539824;35;40;0.485714285714286;18;17;0.0142857142857143;0.485714285714286
Control.SRR15539824;34;40;0.647058823529412;12;22;0.147058823529412;0.352941176470588
Control.SRR15539824;38;40;0.526315789473684;18;20;0.0263157894736842;0.473684210526316
Control.SRR15539824;34;40;0.264705882352941;25;9;0.235294117647059;0.264705882352941
Control.SRR15539824;39;40;0.435897435897436;22;17;0.0641025641025641;0.435897435897436
Control.SRR15539824;39;40;0.435897435897436;22;17;0.0641025641025641;0.435897435897436
Control.SRR15539824;37;40;0.540540540540541;17;20;0.0405405405405406;0.459459459459459
Control.SRR15539824;38;40;0.684210526315789;12;26;0.184210526315789;0.315789473684211
Control.SRR15539824;36;40;0.5;18;18;0;0.5
Control.SRR15539824;34;40;0.588235294117647;14;20;0.0882352941176471;0.411764705882353
Control.SRR15539824;33;40;0.515151515151515;16;17;0.0151515151515151;0.484848484848485
Control.SRR15539824;42;40;0.333333333333333;28;14;0.166666666666667;0.333333333333333
Control.SRR15539824;41;40;0.463414634146341;22;19;0.0365853658536585;0.463414634146341
Control.SRR15539824;35;40;0.428571428571429;20;15;0.0714285714285715;0.428571428571429
Control.SRR15539824;38;40;0.447368421052632;21;17;0.0526315789473684;0.447368421052632
Control.SRR15539824;33;40;0.363636363636364;21;12;0.136363636363636;0.363636363636364
Control.SRR15539824;38;40;0.421052631578947;22;16;0.0789473684210527;0.421052631578947
Control.SRR15539824;37;40;0.567567567567568;16;21;0.0675675675675675;0.432432432432432
Control.SRR15539824;39;40;0.41025641025641;23;16;0.0897435897435898;0.41025641025641
Control.SRR15539824;36;40;0.694444444444444;11;25;0.194444444444444;0.305555555555556
Control.SRR15539824;36;40;0.388888888888889;22;14;0.111111111111111;0.388888888888889
Control.SRR15539824;40;40;0.525;19;21;0.025;0.475
Control.SRR15539824;34;40;0.617647058823529;13;21;0.117647058823529;0.382352941176471
Control.SRR15539824;42;40;0.5;21;21;0;0.5
Control.SRR15539824;37;40;0.378378378378378;23;14;0.121621621621622;0.378378378378378
Control.SRR15539824;37;40;0.459459459459459;20;17;0.0405405405405405;0.459459459459459
Control.SRR15539824;34;40;0.441176470588235;19;15;0.0588235294117647;0.441176470588235
Control.SRR15539824;42;40;0.452380952380952;23;19;0.0476190476190476;0.452380952380952
Control.SRR15539824;42;40;0.428571428571429;24;18;0.0714285714285715;0.428571428571429
Control.SRR15539824;40;40;0.5;20;20;0;0.5
Control.SRR15539824;38;40;0.473684210526316;20;18;0.0263157894736842;0.473684210526316
Control.SRR15539824;38;40;0.578947368421053;16;22;0.0789473684210527;0.421052631578947
Control.SRR15539824;37;40;0.459459459459459;20;17;0.0405405405405405;0.459459459459459
Control.SRR15539824;34;40;0.5;17;17;0;0.5
Control.SRR15539824;35;40;0.485714285714286;18;17;0.0142857142857143;0.485714285714286
Control.SRR15539824;43;40;0.581395348837209;18;25;0.0813953488372093;0.418604651162791
Control.SRR15539824;40;40;0.5;20;20;0;0.5
Control.SRR15539824;42;40;0.5;21;21;0;0.5
Control.SRR15539824;39;40;0.564102564102564;17;22;0.0641025641025641;0.435897435897436
Control.SRR15539824;41;40;0.609756097560976;16;25;0.109756097560976;0.390243902439024
Control.SRR15539824;33;40;0.424242424242424;19;14;0.0757575757575757;0.424242424242424
Control.SRR15539824;37;40;0.513513513513513;18;19;0.0135135135135135;0.486486486486487
Control.SRR15539824;37;40;0.594594594594595;15;22;0.0945945945945946;0.405405405405405
Control.SRR15539824;40;40;0.475;21;19;0.025;0.475
Control.SRR15539824;36;40;0.472222222222222;19;17;0.0277777777777778;0.472222222222222
Control.SRR15539824;36;40;0.527777777777778;17;19;0.0277777777777778;0.472222222222222
Control.SRR15539824;33;40;0.545454545454545;15;18;0.0454545454545454;0.454545454545455
Control.SRR15539824;42;40;0.476190476190476;22;20;0.0238095238095238;0.476190476190476
Control.SRR15539824;40;40;0.5;20;20;0;0.5
Control.SRR15539824;43;40;0.534883720930233;20;23;0.0348837209302325;0.465116279069767
Control.SRR15539824;42;40;0.476190476190476;22;20;0.0238095238095238;0.476190476190476
Control.SRR15539824;41;40;0.439024390243902;23;18;0.0609756097560976;0.439024390243902
Control.SRR15539824;41;40;0.463414634146341;22;19;0.0365853658536585;0.463414634146341
Control.SRR15539824;41;40;0.463414634146341;22;19;0.0365853658536585;0.463414634146341
Control.SRR15539824;38;40;0.447368421052632;21;17;0.0526315789473684;0.447368421052632
Control.SRR15539824;40;40;0.35;26;14;0.15;0.35
Control.SRR15539824;39;40;0.358974358974359;25;14;0.141025641025641;0.358974358974359
Control.SRR15539824;37;40;0.513513513513513;18;19;0.0135135135135135;0.486486486486487
Control.SRR15539824;39;40;0.666666666666667;13;26;0.166666666666667;0.333333333333333
Control.SRR15539824;40;40;0.5;20;20;0;0.5
Control.SRR15539824;36;40;0.388888888888889;22;14;0.111111111111111;0.388888888888889
Control.SRR15539824;38;40;0.473684210526316;20;18;0.0263157894736842;0.473684210526316
Control.SRR15539824;33;40;0.424242424242424;19;14;0.0757575757575757;0.424242424242424
Control.SRR15539824;34;40;0.411764705882353;20;14;0.0882352941176471;0.411764705882353
Control.SRR15539824;43;40;0.372093023255814;27;16;0.127906976744186;0.372093023255814
Control.SRR15539824;39;40;0.461538461538462;21;18;0.0384615384615384;0.461538461538462
Control.SRR15539824;38;40;0.552631578947368;17;21;0.0526315789473685;0.447368421052632
Control.SRR15539824;41;40;0.51219512195122;20;21;0.0121951219512195;0.48780487804878
Control.SRR15539824;34;40;0.470588235294118;18;16;0.0294117647058824;0.470588235294118
Control.SRR15539824;37;40;0.540540540540541;17;20;0.0405405405405406;0.459459459459459
Control.SRR15539824;36;40;0.472222222222222;19;17;0.0277777777777778;0.472222222222222
Control.SRR15539824;36;40;0.444444444444444;20;16;0.0555555555555556;0.444444444444444
Control.SRR15539824;36;40;0.416666666666667;21;15;0.0833333333333333;0.416666666666667
Control.SRR15539824;34;40;0.558823529411765;15;19;0.0588235294117647;0.441176470588235
Control.SRR15539824;38;40;0.421052631578947;22;16;0.0789473684210527;0.421052631578947
Control.SRR15539824;33;40;0.545454545454545;15;18;0.0454545454545454;0.454545454545455
Control.SRR15539824;37;40;0.378378378378378;23;14;0.121621621621622;0.378378378378378
Control.SRR15539824;37;40;0.486486486486487;19;18;0.0135135135135135;0.486486486486487
Control.SRR15539824;34;40;0.470588235294118;18;16;0.0294117647058824;0.470588235294118
Control.SRR15539824;33;40;0.303030303030303;23;10;0.196969696969697;0.303030303030303
Control.SRR15539824;33;40;0.545454545454545;15;18;0.0454545454545454;0.454545454545455
Control.SRR15539824;43;40;0.441860465116279;24;19;0.0581395348837209;0.441860465116279
Control.SRR15539824;42;40;0.5;21;21;0;0.5
Control.SRR15539824;33;40;0.545454545454545;15;18;0.0454545454545454;0.454545454545455
Control.SRR15539824;34;40;0.5;17;17;0;0.5
Control.SRR15539824;33;40;0.393939393939394;20;13;0.106060606060606;0.393939393939394
Control.SRR15539824;43;40;0.465116279069767;23;20;0.0348837209302326;0.465116279069767
Control.SRR15539824;41;40;0.463414634146341;22;19;0.0365853658536585;0.463414634146341
Control.SRR15539824;41;40;0.439024390243902;23;18;0.0609756097560976;0.439024390243902
Control.SRR15539824;38;40;0.684210526315789;12;26;0.184210526315789;0.315789473684211
Control.SRR15539824;39;40;0.512820512820513;19;20;0.0128205128205128;0.487179487179487
Control.SRR15539824;40;40;0.6;16;24;0.1;0.4
Control.SRR15539824;35;40;0.371428571428571;22;13;0.128571428571429;0.371428571428571
Control.SRR15539824;34;40;0.588235294117647;14;20;0.0882352941176471;0.411764705882353
Control.SRR15539824;34;40;0.617647058823529;13;21;0.117647058823529;0.382352941176471
Control.SRR15539824;35;40;0.485714285714286;18;17;0.0142857142857143;0.485714285714286
Control.SRR15539824;36;40;0.444444444444444;20;16;0.0555555555555556;0.444444444444444
Control.SRR15539824;42;40;0.69047619047619;13;29;0.19047619047619;0.30952380952381
Control.SRR15539824;41;40;0.536585365853659;19;22;0.0365853658536586;0.463414634146341
Control.SRR15539824;40;40;0.475;21;19;0.025;0.475
Control.SRR15539824;40;40;0.525;19;21;0.025;0.475
Control.SRR15539824;41;40;0.609756097560976;16;25;0.109756097560976;0.390243902439024
Control.SRR15539824;33;40;0.575757575757576;14;19;0.0757575757575758;0.424242424242424
Control.SRR15539824;36;40;0.444444444444444;20;16;0.0555555555555556;0.444444444444444
Control.SRR15539824;43;40;0.511627906976744;21;22;0.0116279069767442;0.488372093023256
Control.SRR15539824;38;40;0.736842105263158;10;28;0.236842105263158;0.263157894736842
Control.SRR15539824;35;40;0.514285714285714;17;18;0.0142857142857142;0.485714285714286
Control.SRR15539824;36;40;0.472222222222222;19;17;0.0277777777777778;0.472222222222222
Control.SRR15539824;34;40;0.529411764705882;16;18;0.0294117647058824;0.470588235294118
Control.SRR15539824;37;40;0.513513513513513;18;19;0.0135135135135135;0.486486486486487
Control.SRR15539824;41;40;0.609756097560976;16;25;0.109756097560976;0.390243902439024
Control.SRR15539824;41;40;0.268292682926829;30;11;0.231707317073171;0.268292682926829
Control.SRR15539824;41;40;0.48780487804878;21;20;0.0121951219512195;0.48780487804878
Control.SRR15539824;41;40;0.560975609756098;18;23;0.0609756097560976;0.439024390243902
Control.SRR15539824;42;40;0.452380952380952;23;19;0.0476190476190476;0.452380952380952
Control.SRR15539824;42;40;0.523809523809524;20;22;0.0238095238095238;0.476190476190476
Control.SRR15539824;36;40;0.5;18;18;0;0.5
Control.SRR15539824;37;40;0.486486486486487;19;18;0.0135135135135135;0.486486486486487
Control.SRR15539824;40;40;0.575;17;23;0.075;0.425
Control.SRR15539824;35;40;0.428571428571429;20;15;0.0714285714285715;0.428571428571429
Control.SRR15539824;39;40;0.41025641025641;23;16;0.0897435897435898;0.41025641025641
Control.SRR15539824;39;40;0.435897435897436;22;17;0.0641025641025641;0.435897435897436
Control.SRR15539824;41;40;0.560975609756098;18;23;0.0609756097560976;0.439024390243902
Control.SRR15539824;34;40;0.382352941176471;21;13;0.117647058823529;0.382352941176471
Control.SRR15539824;37;40;0.594594594594595;15;22;0.0945945945945946;0.405405405405405
Control.SRR15539824;40;40;0.625;15;25;0.125;0.375
Control.SRR15539824;39;40;0.538461538461538;18;21;0.0384615384615384;0.461538461538462
Control.SRR15539824;35;40;0.542857142857143;16;19;0.0428571428571428;0.457142857142857
Control.SRR15539824;37;40;0.621621621621622;14;23;0.121621621621622;0.378378378378378
Control.SRR15539824;36;40;0.388888888888889;22;14;0.111111111111111;0.388888888888889
Control.SRR15539824;37;40;0.432432432432432;21;16;0.0675675675675675;0.432432432432432
Control.SRR15539824;35;40;0.457142857142857;19;16;0.0428571428571429;0.457142857142857
Control.SRR15539824;34;40;0.411764705882353;20;14;0.0882352941176471;0.411764705882353
Control.SRR15539824;39;40;0.512820512820513;19;20;0.0128205128205128;0.487179487179487
Control.SRR15539824;39;40;0.538461538461538;18;21;0.0384615384615384;0.461538461538462
Control.SRR15539824;40;40;0.4;24;16;0.1;0.4
Control.SRR15539824;35;40;0.4;21;14;0.1;0.4
Control.SRR15539824;39;40;0.487179487179487;20;19;0.0128205128205128;0.487179487179487
Control.SRR15539824;43;40;0.604651162790698;17;26;0.104651162790698;0.395348837209302
Control.SRR15539824;38;40;0.421052631578947;22;16;0.0789473684210527;0.421052631578947
Control.SRR15539824;42;40;0.428571428571429;24;18;0.0714285714285715;0.428571428571429
Control.SRR15539824;39;40;0.641025641025641;14;25;0.141025641025641;0.358974358974359
Control.SRR15539824;33;40;0.606060606060606;13;20;0.106060606060606;0.393939393939394
Control.SRR15539824;41;40;0.48780487804878;21;20;0.0121951219512195;0.48780487804878
Control.SRR15539824;43;40;0.441860465116279;24;19;0.0581395348837209;0.441860465116279
Control.SRR15539824;43;40;0.627906976744186;16;27;0.127906976744186;0.372093023255814
Control.SRR15539824;42;40;0.357142857142857;27;15;0.142857142857143;0.357142857142857
Control.SRR15539824;38;40;0.447368421052632;21;17;0.0526315789473684;0.447368421052632
Control.SRR15539824;36;40;0.527777777777778;17;19;0.0277777777777778;0.472222222222222
Control.SRR15539824;42;40;0.333333333333333;28;14;0.166666666666667;0.333333333333333
Control.SRR15539824;43;40;0.418604651162791;25;18;0.0813953488372093;0.418604651162791
Control.SRR15539824;41;40;0.48780487804878;21;20;0.0121951219512195;0.48780487804878
Control.SRR15539824;41;40;0.463414634146341;22;19;0.0365853658536585;0.463414634146341
Control.SRR15539824;34;40;0.558823529411765;15;19;0.0588235294117647;0.441176470588235
Control.SRR15539824;34;40;0.470588235294118;18;16;0.0294117647058824;0.470588235294118
Control.SRR15539824;37;40;0.540540540540541;17;20;0.0405405405405406;0.459459459459459
Control.SRR15539824;42;40;0.404761904761905;25;17;0.0952380952380952;0.404761904761905
Control.SRR15539824;35;40;0.485714285714286;18;17;0.0142857142857143;0.485714285714286
Control.SRR15539824;37;40;0.486486486486487;19;18;0.0135135135135135;0.486486486486487
Control.SRR15539824;41;40;0.48780487804878;21;20;0.0121951219512195;0.48780487804878
Control.SRR15539824;40;40;0.7;12;28;0.2;0.3
Control.SRR15539824;38;40;0.552631578947368;17;21;0.0526315789473685;0.447368421052632
Control.SRR15539824;36;40;0.5;18;18;0;0.5
Control.SRR15539824;41;40;0.463414634146341;22;19;0.0365853658536585;0.463414634146341
Control.SRR15539824;39;40;0.384615384615385;24;15;0.115384615384615;0.384615384615385
Control.SRR15539824;43;40;0.488372093023256;22;21;0.0116279069767442;0.488372093023256
Control.SRR15539824;34;40;0.588235294117647;14;20;0.0882352941176471;0.411764705882353
Control.SRR15539824;38;40;0.473684210526316;20;18;0.0263157894736842;0.473684210526316
Control.SRR15539824;40;40;0.7;12;28;0.2;0.3
Control.SRR15539824;43;40;0.441860465116279;24;19;0.0581395348837209;0.441860465116279
Control.SRR15539824;34;40;0.441176470588235;19;15;0.0588235294117647;0.441176470588235
Control.SRR15539824;33;40;0.363636363636364;21;12;0.136363636363636;0.363636363636364
Control.SRR15539824;37;40;0.351351351351351;24;13;0.148648648648649;0.351351351351351
Control.SRR15539824;41;40;0.48780487804878;21;20;0.0121951219512195;0.48780487804878
Control.SRR15539824;36;40;0.5;18;18;0;0.5
Control.SRR15539824;40;40;0.5;20;20;0;0.5
Control.SRR15539824;41;40;0.560975609756098;18;23;0.0609756097560976;0.439024390243902
Control.SRR15539824;40;40;0.575;17;23;0.075;0.425
Control.SRR15539824;43;40;0.604651162790698;17;26;0.104651162790698;0.395348837209302
Control.SRR15539824;33;40;0.333333333333333;22;11;0.166666666666667;0.333333333333333
Control.SRR15539824;34;40;0.676470588235294;11;23;0.176470588235294;0.323529411764706
Control.SRR15539824;38;40;0.526315789473684;18;20;0.0263157894736842;0.473684210526316
Control.SRR15539824;34;40;0.441176470588235;19;15;0.0588235294117647;0.441176470588235
Control.SRR15539824;43;40;0.465116279069767;23;20;0.0348837209302326;0.465116279069767
Control.SRR15539824;34;40;0.5;17;17;0;0.5
Control.SRR15539824;43;40;0.651162790697674;15;28;0.151162790697674;0.348837209302326
Control.SRR15539824;34;40;0.647058823529412;12;22;0.147058823529412;0.352941176470588
Control.SRR15539824;38;40;0.473684210526316;20;18;0.0263157894736842;0.473684210526316
Control.SRR15539824;39;40;0.512820512820513;19;20;0.0128205128205128;0.487179487179487
Control.SRR15539824;35;40;0.514285714285714;17;18;0.0142857142857142;0.485714285714286
Control.SRR15539824;42;40;0.523809523809524;20;22;0.0238095238095238;0.476190476190476
Control.SRR15539824;34;40;0.5;17;17;0;0.5
Control.SRR15539824;36;40;0.583333333333333;15;21;0.0833333333333334;0.416666666666667
Control.SRR15539824;34;40;0.529411764705882;16;18;0.0294117647058824;0.470588235294118
Control.SRR15539824;39;40;0.564102564102564;17;22;0.0641025641025641;0.435897435897436
Control.SRR15539824;36;40;0.5;18;18;0;0.5
Control.SRR15539824;38;40;0.421052631578947;22;16;0.0789473684210527;0.421052631578947
Control.SRR15539824;39;40;0.307692307692308;27;12;0.192307692307692;0.307692307692308
Control.SRR15539824;37;40;0.486486486486487;19;18;0.0135135135135135;0.486486486486487
Control.SRR15539824;40;40;0.5;20;20;0;0.5
Control.SRR15539824;35;40;0.571428571428571;15;20;0.0714285714285714;0.428571428571429
Control.SRR15539824;33;40;0.484848484848485;17;16;0.0151515151515151;0.484848484848485
Control.SRR15539824;39;40;0.461538461538462;21;18;0.0384615384615384;0.461538461538462
Control.SRR15539824;36;40;0.472222222222222;19;17;0.0277777777777778;0.472222222222222
Control.SRR15539824;35;40;0.457142857142857;19;16;0.0428571428571429;0.457142857142857
Control.SRR15539824;40;40;0.575;17;23;0.075;0.425
Control.SRR15539824;38;40;0.421052631578947;22;16;0.0789473684210527;0.421052631578947
Control.SRR15539824;38;40;0.447368421052632;21;17;0.0526315789473684;0.447368421052632
Control.SRR15539824;43;40;0.604651162790698;17;26;0.104651162790698;0.395348837209302
Control.SRR15539824;42;40;0.428571428571429;24;18;0.0714285714285715;0.428571428571429
Control.SRR15539824;37;40;0.486486486486487;19;18;0.0135135135135135;0.486486486486487
Control.SRR15539824;40;40;0.425;23;17;0.075;0.425
Control.SRR15539824;41;40;0.439024390243902;23;18;0.0609756097560976;0.439024390243902
Control.SRR15539824;43;40;0.534883720930233;20;23;0.0348837209302325;0.465116279069767
Control.SRR15539824;33;40;0.454545454545455;18;15;0.0454545454545455;0.454545454545455
Control.SRR15539824;40;40;0.325;27;13;0.175;0.325
Control.SRR15539824;34;40;0.352941176470588;22;12;0.147058823529412;0.352941176470588
Control.SRR15539824;33;40;0.575757575757576;14;19;0.0757575757575758;0.424242424242424
Control.SRR15539824;42;40;0.380952380952381;26;16;0.119047619047619;0.380952380952381
Control.SRR15539824;39;40;0.435897435897436;22;17;0.0641025641025641;0.435897435897436
Control.SRR15539824;37;40;0.594594594594595;15;22;0.0945945945945946;0.405405405405405
Control.SRR15539824;37;40;0.540540540540541;17;20;0.0405405405405406;0.459459459459459
Control.SRR15539824;37;40;0.432432432432432;21;16;0.0675675675675675;0.432432432432432
Control.SRR15539824;40;40;0.5;20;20;0;0.5
Control.SRR15539824;34;40;0.588235294117647;14;20;0.0882352941176471;0.411764705882353
Control.SRR15539824;37;40;0.513513513513513;18;19;0.0135135135135135;0.486486486486487
Control.SRR15539824;43;40;0.558139534883721;19;24;0.0581395348837209;0.441860465116279
Control.SRR15539824;42;40;0.5;21;21;0;0.5
Control.SRR15539824;36;40;0.5;18;18;0;0.5
Control.SRR15539824;33;40;0.484848484848485;17;16;0.0151515151515151;0.484848484848485
Control.SRR15539824;38;40;0.552631578947368;17;21;0.0526315789473685;0.447368421052632
Control.SRR15539824;41;40;0.634146341463415;15;26;0.134146341463415;0.365853658536585
Control.SRR15539824;40;40;0.425;23;17;0.075;0.425
Control.SRR15539824;41;40;0.48780487804878;21;20;0.0121951219512195;0.48780487804878
Control.SRR15539824;41;40;0.365853658536585;26;15;0.134146341463415;0.365853658536585
Control.SRR15539824;36;40;0.444444444444444;20;16;0.0555555555555556;0.444444444444444
Control.SRR15539824;43;40;0.627906976744186;16;27;0.127906976744186;0.372093023255814
Control.SRR15539824;42;40;0.452380952380952;23;19;0.0476190476190476;0.452380952380952
Control.SRR15539824;37;40;0.594594594594595;15;22;0.0945945945945946;0.405405405405405
Control.SRR15539824;41;40;0.463414634146341;22;19;0.0365853658536585;0.463414634146341
Control.SRR15539824;39;40;0.58974358974359;16;23;0.0897435897435898;0.41025641025641
Control.SRR15539824;42;40;0.476190476190476;22;20;0.0238095238095238;0.476190476190476
Control.SRR15539824;42;40;0.523809523809524;20;22;0.0238095238095238;0.476190476190476
Control.SRR15539824;34;40;0.529411764705882;16;18;0.0294117647058824;0.470588235294118
Control.SRR15539824;34;40;0.5;17;17;0;0.5
Control.SRR15539824;38;40;0.394736842105263;23;15;0.105263157894737;0.394736842105263
Control.SRR15539824;41;40;0.24390243902439;31;10;0.25609756097561;0.24390243902439
Control.SRR15539824;43;40;0.627906976744186;16;27;0.127906976744186;0.372093023255814
Control.SRR15539824;35;40;0.628571428571429;13;22;0.128571428571429;0.371428571428571
Control.SRR15539824;43;40;0.511627906976744;21;22;0.0116279069767442;0.488372093023256
Control.SRR15539824;40;40;0.575;17;23;0.075;0.425
Control.SRR15539824;41;40;0.365853658536585;26;15;0.134146341463415;0.365853658536585
Control.SRR15539824;43;40;0.534883720930233;20;23;0.0348837209302325;0.465116279069767
Control.SRR15539824;33;40;0.545454545454545;15;18;0.0454545454545454;0.454545454545455
Control.SRR15539824;37;40;0.432432432432432;21;16;0.0675675675675675;0.432432432432432
Control.SRR15539824;35;40;0.685714285714286;11;24;0.185714285714286;0.314285714285714
Control.SRR15539824;37;40;0.783783783783784;8;29;0.283783783783784;0.216216216216216
Control.SRR15539824;39;40;0.461538461538462;21;18;0.0384615384615384;0.461538461538462
Control.SRR15539824;38;40;0.578947368421053;16;22;0.0789473684210527;0.421052631578947
Control.SRR15539824;37;40;0.540540540540541;17;20;0.0405405405405406;0.459459459459459
Control.SRR15539824;42;40;0.595238095238095;17;25;0.0952380952380952;0.404761904761905
Control.SRR15539824;39;40;0.461538461538462;21;18;0.0384615384615384;0.461538461538462
Control.SRR15539824;39;40;0.641025641025641;14;25;0.141025641025641;0.358974358974359
Control.SRR15539824;42;40;0.476190476190476;22;20;0.0238095238095238;0.476190476190476
Control.SRR15539824;40;40;0.475;21;19;0.025;0.475
Control.SRR15539824;36;40;0.611111111111111;14;22;0.111111111111111;0.388888888888889
Control.SRR15539824;35;40;0.514285714285714;17;18;0.0142857142857142;0.485714285714286
Control.SRR15539824;42;40;0.428571428571429;24;18;0.0714285714285715;0.428571428571429
Control.SRR15539824;43;40;0.534883720930233;20;23;0.0348837209302325;0.465116279069767
Control.SRR15539824;36;40;0.333333333333333;24;12;0.166666666666667;0.333333333333333
Control.SRR15539824;38;40;0.578947368421053;16;22;0.0789473684210527;0.421052631578947
Control.SRR15539824;39;40;0.487179487179487;20;19;0.0128205128205128;0.487179487179487
Control.SRR15539824;40;40;0.475;21;19;0.025;0.475
Control.SRR15539824;40;40;0.55;18;22;0.05;0.45
Control.SRR15539824;33;40;0.545454545454545;15;18;0.0454545454545454;0.454545454545455
Control.SRR15539824;41;40;0.48780487804878;21;20;0.0121951219512195;0.48780487804878
Control.SRR15539824;39;40;0.512820512820513;19;20;0.0128205128205128;0.487179487179487
Control.SRR15539824;37;40;0.378378378378378;23;14;0.121621621621622;0.378378378378378
Control.SRR15539824;33;40;0.636363636363636;12;21;0.136363636363636;0.363636363636364
Control.SRR15539824;35;40;0.485714285714286;18;17;0.0142857142857143;0.485714285714286
Control.SRR15539824;39;40;0.41025641025641;23;16;0.0897435897435898;0.41025641025641
Control.SRR15539824;36;40;0.611111111111111;14;22;0.111111111111111;0.388888888888889
Control.SRR15539824;43;40;0.465116279069767;23;20;0.0348837209302326;0.465116279069767
Control.SRR15539824;40;40;0.375;25;15;0.125;0.375
Control.SRR15539824;42;40;0.428571428571429;24;18;0.0714285714285715;0.428571428571429
Control.SRR15539824;41;40;0.51219512195122;20;21;0.0121951219512195;0.48780487804878
Control.SRR15539824;37;40;0.540540540540541;17;20;0.0405405405405406;0.459459459459459
Control.SRR15539824;40;40;0.45;22;18;0.05;0.45
Control.SRR15539824;36;40;0.444444444444444;20;16;0.0555555555555556;0.444444444444444
Control.SRR15539824;33;40;0.545454545454545;15;18;0.0454545454545454;0.454545454545455
Control.SRR15539824;42;40;0.547619047619048;19;23;0.0476190476190477;0.452380952380952
Control.SRR15539824;33;40;0.727272727272727;9;24;0.227272727272727;0.272727272727273
Control.SRR15539824;41;40;0.51219512195122;20;21;0.0121951219512195;0.48780487804878
Control.SRR15539824;41;40;0.439024390243902;23;18;0.0609756097560976;0.439024390243902
Control.SRR15539824;33;40;0.454545454545455;18;15;0.0454545454545455;0.454545454545455
Control.SRR15539824;34;40;0.441176470588235;19;15;0.0588235294117647;0.441176470588235
Control.SRR15539824;37;40;0.351351351351351;24;13;0.148648648648649;0.351351351351351
Control.SRR15539824;35;40;0.542857142857143;16;19;0.0428571428571428;0.457142857142857
Control.SRR15539824;35;40;0.6;14;21;0.1;0.4
Control.SRR15539824;33;40;0.545454545454545;15;18;0.0454545454545454;0.454545454545455
Control.SRR15539824;42;40;0.5;21;21;0;0.5
Control.SRR15539824;36;40;0.416666666666667;21;15;0.0833333333333333;0.416666666666667
Control.SRR15539824;40;40;0.45;22;18;0.05;0.45
Control.SRR15539824;43;40;0.511627906976744;21;22;0.0116279069767442;0.488372093023256
Control.SRR15539824;38;40;0.526315789473684;18;20;0.0263157894736842;0.473684210526316
Control.SRR15539824;33;40;0.696969696969697;10;23;0.196969696969697;0.303030303030303
Control.SRR15539824;34;40;0.470588235294118;18;16;0.0294117647058824;0.470588235294118
Control.SRR15539824;38;40;0.605263157894737;15;23;0.105263157894737;0.394736842105263
Control.SRR15539824;33;40;0.393939393939394;20;13;0.106060606060606;0.393939393939394
Control.SRR15539824;36;40;0.444444444444444;20;16;0.0555555555555556;0.444444444444444
Control.SRR15539824;34;40;0.5;17;17;0;0.5
Control.SRR15539824;33;40;0.484848484848485;17;16;0.0151515151515151;0.484848484848485
Control.SRR15539824;42;40;0.523809523809524;20;22;0.0238095238095238;0.476190476190476
Control.SRR15539824;43;40;0.395348837209302;26;17;0.104651162790698;0.395348837209302
Control.SRR15539824;39;40;0.487179487179487;20;19;0.0128205128205128;0.487179487179487
Control.SRR15539824;35;40;0.542857142857143;16;19;0.0428571428571428;0.457142857142857
Control.SRR15539824;38;40;0.394736842105263;23;15;0.105263157894737;0.394736842105263
Control.SRR15539824;37;40;0.621621621621622;14;23;0.121621621621622;0.378378378378378
Control.SRR15539824;37;40;0.432432432432432;21;16;0.0675675675675675;0.432432432432432
Control.SRR15539824;34;40;0.558823529411765;15;19;0.0588235294117647;0.441176470588235
Control.SRR15539824;43;40;0.511627906976744;21;22;0.0116279069767442;0.488372093023256
Control.SRR15539824;35;40;0.4;21;14;0.1;0.4
Control.SRR15539824;42;40;0.619047619047619;16;26;0.119047619047619;0.380952380952381
Control.SRR15539824;41;40;0.560975609756098;18;23;0.0609756097560976;0.439024390243902
Control.SRR15539824;34;40;0.382352941176471;21;13;0.117647058823529;0.382352941176471
Control.SRR15539824;35;40;0.428571428571429;20;15;0.0714285714285715;0.428571428571429
Control.SRR15539824;39;40;0.41025641025641;23;16;0.0897435897435898;0.41025641025641
Control.SRR15539824;39;40;0.358974358974359;25;14;0.141025641025641;0.358974358974359
Control.SRR15539824;40;40;0.525;19;21;0.025;0.475
Control.SRR15539824;41;40;0.439024390243902;23;18;0.0609756097560976;0.439024390243902
Control.SRR15539824;39;40;0.615384615384615;15;24;0.115384615384615;0.384615384615385
Control.SRR15539824;37;40;0.567567567567568;16;21;0.0675675675675675;0.432432432432432
Control.SRR15539824;38;40;0.473684210526316;20;18;0.0263157894736842;0.473684210526316
Control.SRR15539824;34;40;0.558823529411765;15;19;0.0588235294117647;0.441176470588235
Control.SRR15539824;33;40;0.333333333333333;22;11;0.166666666666667;0.333333333333333
Control.SRR15539824;38;40;0.421052631578947;22;16;0.0789473684210527;0.421052631578947
Control.SRR15539824;37;40;0.513513513513513;18;19;0.0135135135135135;0.486486486486487
Control.SRR15539824;39;40;0.512820512820513;19;20;0.0128205128205128;0.487179487179487
Control.SRR15539824;39;40;0.487179487179487;20;19;0.0128205128205128;0.487179487179487
Control.SRR15539824;37;40;0.540540540540541;17;20;0.0405405405405406;0.459459459459459
Control.SRR15539824;38;40;0.5;19;19;0;0.5
Control.SRR15539824;36;40;0.472222222222222;19;17;0.0277777777777778;0.472222222222222
Control.SRR15539824;36;40;0.444444444444444;20;16;0.0555555555555556;0.444444444444444
Control.SRR15539824;37;40;0.459459459459459;20;17;0.0405405405405405;0.459459459459459
Control.SRR15539824;36;40;0.666666666666667;12;24;0.166666666666667;0.333333333333333
Control.SRR15539824;39;40;0.358974358974359;25;14;0.141025641025641;0.358974358974359
Control.SRR15539824;41;40;0.390243902439024;25;16;0.109756097560976;0.390243902439024
Control.SRR15539824;38;40;0.526315789473684;18;20;0.0263157894736842;0.473684210526316
Control.SRR15539824;33;40;0.484848484848485;17;16;0.0151515151515151;0.484848484848485
Control.SRR15539824;34;40;0.294117647058824;24;10;0.205882352941176;0.294117647058824
Control.SRR15539824;34;40;0.470588235294118;18;16;0.0294117647058824;0.470588235294118
Control.SRR15539824;35;40;0.514285714285714;17;18;0.0142857142857142;0.485714285714286
Control.SRR15539824;42;40;0.452380952380952;23;19;0.0476190476190476;0.452380952380952
Control.SRR15539824;41;40;0.536585365853659;19;22;0.0365853658536586;0.463414634146341
Control.SRR15539824;42;40;0.619047619047619;16;26;0.119047619047619;0.380952380952381
Control.SRR15539824;42;40;0.523809523809524;20;22;0.0238095238095238;0.476190476190476
Control.SRR15539824;33;40;0.575757575757576;14;19;0.0757575757575758;0.424242424242424
Control.SRR15539824;33;40;0.393939393939394;20;13;0.106060606060606;0.393939393939394
Control.SRR15539824;40;40;0.575;17;23;0.075;0.425
Control.SRR15539824;37;40;0.567567567567568;16;21;0.0675675675675675;0.432432432432432
Control.SRR15539824;36;40;0.527777777777778;17;19;0.0277777777777778;0.472222222222222
Control.SRR15539824;35;40;0.571428571428571;15;20;0.0714285714285714;0.428571428571429
Control.SRR15539824;35;40;0.457142857142857;19;16;0.0428571428571429;0.457142857142857
Control.SRR15539824;39;40;0.435897435897436;22;17;0.0641025641025641;0.435897435897436
Control.SRR15539824;35;40;0.457142857142857;19;16;0.0428571428571429;0.457142857142857
Control.SRR15539824;41;40;0.585365853658537;17;24;0.0853658536585366;0.414634146341463
Control.SRR15539824;37;40;0.513513513513513;18;19;0.0135135135135135;0.486486486486487
Control.SRR15539824;37;40;0.486486486486487;19;18;0.0135135135135135;0.486486486486487
Control.SRR15539824;41;40;0.341463414634146;27;14;0.158536585365854;0.341463414634146
Control.SRR15539824;41;40;0.536585365853659;19;22;0.0365853658536586;0.463414634146341
Control.SRR15539824;38;40;0.473684210526316;20;18;0.0263157894736842;0.473684210526316
Control.SRR15539824;43;40;0.511627906976744;21;22;0.0116279069767442;0.488372093023256
Control.SRR15539824;40;40;0.5;20;20;0;0.5
Control.SRR15539824;35;40;0.428571428571429;20;15;0.0714285714285715;0.428571428571429
Control.SRR15539824;42;40;0.452380952380952;23;19;0.0476190476190476;0.452380952380952
Control.SRR15539824;42;40;0.476190476190476;22;20;0.0238095238095238;0.476190476190476
Control.SRR15539824;41;40;0.414634146341463;24;17;0.0853658536585366;0.414634146341463
Control.SRR15539824;42;40;0.452380952380952;23;19;0.0476190476190476;0.452380952380952
Control.SRR15539824;43;40;0.534883720930233;20;23;0.0348837209302325;0.465116279069767
Control.SRR15539824;43;40;0.465116279069767;23;20;0.0348837209302326;0.465116279069767
Control.SRR15539824;34;40;0.470588235294118;18;16;0.0294117647058824;0.470588235294118
Control.SRR15539824;36;40;0.666666666666667;12;24;0.166666666666667;0.333333333333333
Control.SRR15539824;40;40;0.55;18;22;0.05;0.45
Control.SRR15539824;36;40;0.611111111111111;14;22;0.111111111111111;0.388888888888889
Control.SRR15539824;38;40;0.447368421052632;21;17;0.0526315789473684;0.447368421052632
Control.SRR15539824;43;40;0.465116279069767;23;20;0.0348837209302326;0.465116279069767
Control.SRR15539824;34;40;0.588235294117647;14;20;0.0882352941176471;0.411764705882353
Control.SRR15539824;42;40;0.452380952380952;23;19;0.0476190476190476;0.452380952380952
Control.SRR15539824;39;40;0.384615384615385;24;15;0.115384615384615;0.384615384615385
Control.SRR15539824;33;40;0.484848484848485;17;16;0.0151515151515151;0.484848484848485
Control.SRR15539824;39;40;0.512820512820513;19;20;0.0128205128205128;0.487179487179487
Control.SRR15539824;41;40;0.51219512195122;20;21;0.0121951219512195;0.48780487804878
Control.SRR15539824;42;40;0.714285714285714;12;30;0.214285714285714;0.285714285714286
Control.SRR15539824;33;40;0.545454545454545;15;18;0.0454545454545454;0.454545454545455
Control.SRR15539824;33;40;0.636363636363636;12;21;0.136363636363636;0.363636363636364
Control.SRR15539824;33;40;0.454545454545455;18;15;0.0454545454545455;0.454545454545455
Control.SRR15539824;37;40;0.432432432432432;21;16;0.0675675675675675;0.432432432432432
Control.SRR15539824;33;40;0.454545454545455;18;15;0.0454545454545455;0.454545454545455
Control.SRR15539824;40;40;0.5;20;20;0;0.5
Control.SRR15539824;34;40;0.529411764705882;16;18;0.0294117647058824;0.470588235294118
Control.SRR15539824;33;40;0.393939393939394;20;13;0.106060606060606;0.393939393939394
Control.SRR15539824;41;40;0.609756097560976;16;25;0.109756097560976;0.390243902439024
Control.SRR15539824;38;40;0.605263157894737;15;23;0.105263157894737;0.394736842105263
Control.SRR15539824;37;40;0.486486486486487;19;18;0.0135135135135135;0.486486486486487
Control.SRR15539824;43;40;0.488372093023256;22;21;0.0116279069767442;0.488372093023256
Control.SRR15539824;37;40;0.351351351351351;24;13;0.148648648648649;0.351351351351351
Control.SRR15539824;35;40;0.6;14;21;0.1;0.4
Control.SRR15539824;38;40;0.473684210526316;20;18;0.0263157894736842;0.473684210526316
Control.SRR15539824;36;40;0.5;18;18;0;0.5
Control.SRR15539824;36;40;0.472222222222222;19;17;0.0277777777777778;0.472222222222222
Control.SRR15539824;35;40;0.4;21;14;0.1;0.4
Control.SRR15539824;42;40;0.476190476190476;22;20;0.0238095238095238;0.476190476190476
Control.SRR15539824;36;40;0.472222222222222;19;17;0.0277777777777778;0.472222222222222
Control.SRR15539824;38;40;0.394736842105263;23;15;0.105263157894737;0.394736842105263
Control.SRR15539824;38;40;0.421052631578947;22;16;0.0789473684210527;0.421052631578947
Control.SRR15539824;36;40;0.5;18;18;0;0.5
Control.SRR15539824;36;40;0.472222222222222;19;17;0.0277777777777778;0.472222222222222
Control.SRR15539824;35;40;0.514285714285714;17;18;0.0142857142857142;0.485714285714286
Control.SRR15539824;41;40;0.48780487804878;21;20;0.0121951219512195;0.48780487804878
Control.SRR15539824;36;40;0.472222222222222;19;17;0.0277777777777778;0.472222222222222
Control.SRR15539824;35;40;0.514285714285714;17;18;0.0142857142857142;0.485714285714286
Control.SRR15539824;36;40;0.277777777777778;26;10;0.222222222222222;0.277777777777778
Control.SRR15539824;41;40;0.634146341463415;15;26;0.134146341463415;0.365853658536585
Control.SRR15539824;40;40;0.5;20;20;0;0.5
Control.SRR15539824;36;40;0.555555555555556;16;20;0.0555555555555556;0.444444444444444
Control.SRR15539824;37;40;0.459459459459459;20;17;0.0405405405405405;0.459459459459459
Control.SRR15539824;38;40;0.473684210526316;20;18;0.0263157894736842;0.473684210526316
Control.SRR15539824;42;40;0.476190476190476;22;20;0.0238095238095238;0.476190476190476
Control.SRR15539824;39;40;0.41025641025641;23;16;0.0897435897435898;0.41025641025641
Control.SRR15539824;43;40;0.348837209302326;28;15;0.151162790697674;0.348837209302326
Control.SRR15539824;39;40;0.538461538461538;18;21;0.0384615384615384;0.461538461538462
Control.SRR15539824;41;40;0.439024390243902;23;18;0.0609756097560976;0.439024390243902
Control.SRR15539824;42;40;0.452380952380952;23;19;0.0476190476190476;0.452380952380952
Control.SRR15539824;33;40;0.424242424242424;19;14;0.0757575757575757;0.424242424242424
Control.SRR15539824;38;40;0.526315789473684;18;20;0.0263157894736842;0.473684210526316
Control.SRR15539824;43;40;0.534883720930233;20;23;0.0348837209302325;0.465116279069767
Control.SRR15539824;35;40;0.485714285714286;18;17;0.0142857142857143;0.485714285714286
Control.SRR15539824;34;40;0.647058823529412;12;22;0.147058823529412;0.352941176470588
Control.SRR15539824;35;40;0.4;21;14;0.1;0.4
Control.SRR15539824;37;40;0.486486486486487;19;18;0.0135135135135135;0.486486486486487
Control.SRR15539824;42;40;0.523809523809524;20;22;0.0238095238095238;0.476190476190476
Control.SRR15539824;40;40;0.625;15;25;0.125;0.375
Control.SRR15539824;36;40;0.555555555555556;16;20;0.0555555555555556;0.444444444444444
Control.SRR15539824;40;40;0.6;16;24;0.1;0.4
Control.SRR15539824;33;40;0.363636363636364;21;12;0.136363636363636;0.363636363636364
Control.SRR15539824;40;40;0.45;22;18;0.05;0.45
Control.SRR15539824;36;40;0.527777777777778;17;19;0.0277777777777778;0.472222222222222
Control.SRR15539824;40;40;0.525;19;21;0.025;0.475
Control.SRR15539824;35;40;0.542857142857143;16;19;0.0428571428571428;0.457142857142857
Control.SRR15539824;34;40;0.5;17;17;0;0.5
Control.SRR15539824;36;40;0.444444444444444;20;16;0.0555555555555556;0.444444444444444
Control.SRR15539824;35;40;0.457142857142857;19;16;0.0428571428571429;0.457142857142857
Control.SRR15539824;37;40;0.459459459459459;20;17;0.0405405405405405;0.459459459459459
Control.SRR15539824;37;40;0.540540540540541;17;20;0.0405405405405406;0.459459459459459
Control.SRR15539824;37;40;0.459459459459459;20;17;0.0405405405405405;0.459459459459459
Control.SRR15539824;42;40;0.5;21;21;0;0.5
Control.SRR15539824;34;40;0.470588235294118;18;16;0.0294117647058824;0.470588235294118
Control.SRR15539824;39;40;0.435897435897436;22;17;0.0641025641025641;0.435897435897436
Control.SRR15539824;42;40;0.476190476190476;22;20;0.0238095238095238;0.476190476190476
Control.SRR15539824;38;40;0.578947368421053;16;22;0.0789473684210527;0.421052631578947
Control.SRR15539824;36;40;0.416666666666667;21;15;0.0833333333333333;0.416666666666667
Control.SRR15539824;37;40;0.513513513513513;18;19;0.0135135135135135;0.486486486486487
Control.SRR15539824;40;40;0.425;23;17;0.075;0.425
Control.SRR15539824;38;40;0.5;19;19;0;0.5
Control.SRR15539824;39;40;0.358974358974359;25;14;0.141025641025641;0.358974358974359
Control.SRR15539824;37;40;0.432432432432432;21;16;0.0675675675675675;0.432432432432432
Control.SRR15539824;40;40;0.5;20;20;0;0.5
Control.SRR15539824;36;40;0.472222222222222;19;17;0.0277777777777778;0.472222222222222
Control.SRR15539824;36;40;0.5;18;18;0;0.5
Control.SRR15539824;34;40;0.5;17;17;0;0.5
Control.SRR15539824;40;40;0.425;23;17;0.075;0.425
Control.SRR15539824;42;40;0.428571428571429;24;18;0.0714285714285715;0.428571428571429
Control.SRR15539824;38;40;0.421052631578947;22;16;0.0789473684210527;0.421052631578947
Control.SRR15539824;40;40;0.6;16;24;0.1;0.4
Control.SRR15539824;38;40;0.552631578947368;17;21;0.0526315789473685;0.447368421052632
Control.SRR15539824;42;40;0.428571428571429;24;18;0.0714285714285715;0.428571428571429
Control.SRR15539824;40;40;0.475;21;19;0.025;0.475
Control.SRR15539824;34;40;0.382352941176471;21;13;0.117647058823529;0.382352941176471
Control.SRR15539824;40;40;0.475;21;19;0.025;0.475
Control.SRR15539824;41;40;0.51219512195122;20;21;0.0121951219512195;0.48780487804878
Control.SRR15539824;41;40;0.439024390243902;23;18;0.0609756097560976;0.439024390243902
Control.SRR15539824;38;40;0.631578947368421;14;24;0.131578947368421;0.368421052631579
Control.SRR15539824;40;40;0.45;22;18;0.05;0.45
Control.SRR15539824;35;40;0.657142857142857;12;23;0.157142857142857;0.342857142857143
Control.SRR15539824;35;40;0.542857142857143;16;19;0.0428571428571428;0.457142857142857
Control.SRR15539824;38;40;0.473684210526316;20;18;0.0263157894736842;0.473684210526316
Control.SRR15539824;39;40;0.487179487179487;20;19;0.0128205128205128;0.487179487179487
Control.SRR15539824;38;40;0.578947368421053;16;22;0.0789473684210527;0.421052631578947
Control.SRR15539824;34;40;0.558823529411765;15;19;0.0588235294117647;0.441176470588235
Control.SRR15539824;40;40;0.475;21;19;0.025;0.475
Control.SRR15539824;36;40;0.555555555555556;16;20;0.0555555555555556;0.444444444444444
Control.SRR15539824;37;40;0.783783783783784;8;29;0.283783783783784;0.216216216216216
Control.SRR15539824;38;40;0.552631578947368;17;21;0.0526315789473685;0.447368421052632
Control.SRR15539824;34;40;0.558823529411765;15;19;0.0588235294117647;0.441176470588235
Control.SRR15539824;36;40;0.527777777777778;17;19;0.0277777777777778;0.472222222222222
Control.SRR15539824;41;40;0.634146341463415;15;26;0.134146341463415;0.365853658536585
Control.SRR15539824;43;40;0.558139534883721;19;24;0.0581395348837209;0.441860465116279
Control.SRR15539824;41;40;0.51219512195122;20;21;0.0121951219512195;0.48780487804878
Control.SRR15539824;38;40;0.473684210526316;20;18;0.0263157894736842;0.473684210526316
Control.SRR15539824;40;40;0.475;21;19;0.025;0.475
Control.SRR15539824;40;40;0.6;16;24;0.1;0.4
Control.SRR15539824;39;40;0.487179487179487;20;19;0.0128205128205128;0.487179487179487
Control.SRR15539824;35;40;0.514285714285714;17;18;0.0142857142857142;0.485714285714286
Control.SRR15539824;40;40;0.475;21;19;0.025;0.475
Control.SRR15539824;35;40;0.4;21;14;0.1;0.4
Control.SRR15539824;41;40;0.51219512195122;20;21;0.0121951219512195;0.48780487804878
Control.SRR15539824;41;40;0.536585365853659;19;22;0.0365853658536586;0.463414634146341
Control.SRR15539824;39;40;0.564102564102564;17;22;0.0641025641025641;0.435897435897436
Control.SRR15539824;42;40;0.428571428571429;24;18;0.0714285714285715;0.428571428571429
Control.SRR15539824;34;40;0.352941176470588;22;12;0.147058823529412;0.352941176470588
Control.SRR15539824;41;40;0.707317073170732;12;29;0.207317073170732;0.292682926829268
Control.SRR15539824;36;40;0.472222222222222;19;17;0.0277777777777778;0.472222222222222
Control.SRR15539824;38;40;0.5;19;19;0;0.5
Control.SRR15539824;34;40;0.529411764705882;16;18;0.0294117647058824;0.470588235294118
Control.SRR15539824;41;40;0.51219512195122;20;21;0.0121951219512195;0.48780487804878
Control.SRR15539824;40;40;0.55;18;22;0.05;0.45
Control.SRR15539824;41;40;0.585365853658537;17;24;0.0853658536585366;0.414634146341463
Control.SRR15539824;40;40;0.425;23;17;0.075;0.425
Control.SRR15539824;40;40;0.4;24;16;0.1;0.4
Control.SRR15539824;39;40;0.41025641025641;23;16;0.0897435897435898;0.41025641025641
Control.SRR15539824;36;40;0.527777777777778;17;19;0.0277777777777778;0.472222222222222
Control.SRR15539824;42;40;0.547619047619048;19;23;0.0476190476190477;0.452380952380952
Control.SRR15539824;43;40;0.465116279069767;23;20;0.0348837209302326;0.465116279069767
Control.SRR15539824;35;40;0.485714285714286;18;17;0.0142857142857143;0.485714285714286
Control.SRR15539824;34;40;0.441176470588235;19;15;0.0588235294117647;0.441176470588235
Control.SRR15539824;33;40;0.575757575757576;14;19;0.0757575757575758;0.424242424242424
Control.SRR15539824;41;40;0.51219512195122;20;21;0.0121951219512195;0.48780487804878
Control.SRR15539824;42;40;0.428571428571429;24;18;0.0714285714285715;0.428571428571429
Control.SRR15539824;37;40;0.540540540540541;17;20;0.0405405405405406;0.459459459459459
Control.SRR15539824;37;40;0.513513513513513;18;19;0.0135135135135135;0.486486486486487
Control.SRR15539824;43;40;0.558139534883721;19;24;0.0581395348837209;0.441860465116279
Control.SRR15539824;41;40;0.463414634146341;22;19;0.0365853658536585;0.463414634146341
Control.SRR15539824;36;40;0.611111111111111;14;22;0.111111111111111;0.388888888888889
Control.SRR15539824;33;40;0.515151515151515;16;17;0.0151515151515151;0.484848484848485
Control.SRR15539824;34;40;0.588235294117647;14;20;0.0882352941176471;0.411764705882353
Control.SRR15539824;35;40;0.571428571428571;15;20;0.0714285714285714;0.428571428571429
Control.SRR15539824;33;40;0.393939393939394;20;13;0.106060606060606;0.393939393939394
Control.SRR15539824;42;40;0.571428571428571;18;24;0.0714285714285714;0.428571428571429
Control.SRR15539824;41;40;0.560975609756098;18;23;0.0609756097560976;0.439024390243902
Control.SRR15539824;40;40;0.5;20;20;0;0.5
Control.SRR15539824;39;40;0.41025641025641;23;16;0.0897435897435898;0.41025641025641
Control.SRR15539824;43;40;0.534883720930233;20;23;0.0348837209302325;0.465116279069767
Control.SRR15539824;42;40;0.5;21;21;0;0.5
Control.SRR15539824;37;40;0.486486486486487;19;18;0.0135135135135135;0.486486486486487
Control.SRR15539824;42;40;0.547619047619048;19;23;0.0476190476190477;0.452380952380952
Control.SRR15539824;36;40;0.527777777777778;17;19;0.0277777777777778;0.472222222222222
Control.SRR15539824;36;40;0.638888888888889;13;23;0.138888888888889;0.361111111111111
Control.SRR15539824;37;40;0.486486486486487;19;18;0.0135135135135135;0.486486486486487
Control.SRR15539824;33;40;0.545454545454545;15;18;0.0454545454545454;0.454545454545455
Control.SRR15539824;40;40;0.525;19;21;0.025;0.475
Control.SRR15539824;42;40;0.547619047619048;19;23;0.0476190476190477;0.452380952380952
Control.SRR15539824;41;40;0.414634146341463;24;17;0.0853658536585366;0.414634146341463
Control.SRR15539824;34;40;0.588235294117647;14;20;0.0882352941176471;0.411764705882353
Control.SRR15539824;42;40;0.452380952380952;23;19;0.0476190476190476;0.452380952380952
Control.SRR15539824;34;40;0.411764705882353;20;14;0.0882352941176471;0.411764705882353
Control.SRR15539824;43;40;0.488372093023256;22;21;0.0116279069767442;0.488372093023256
Control.SRR15539824;43;40;0.488372093023256;22;21;0.0116279069767442;0.488372093023256
Control.SRR15539824;43;40;0.558139534883721;19;24;0.0581395348837209;0.441860465116279
Control.SRR15539824;43;40;0.395348837209302;26;17;0.104651162790698;0.395348837209302
Control.SRR15539824;39;40;0.512820512820513;19;20;0.0128205128205128;0.487179487179487
Control.SRR15539824;41;40;0.219512195121951;32;9;0.280487804878049;0.219512195121951
Control.SRR15539824;41;40;0.51219512195122;20;21;0.0121951219512195;0.48780487804878
Control.SRR15539824;38;40;0.394736842105263;23;15;0.105263157894737;0.394736842105263
Control.SRR15539824;43;40;0.441860465116279;24;19;0.0581395348837209;0.441860465116279
Control.SRR15539824;38;40;0.447368421052632;21;17;0.0526315789473684;0.447368421052632
Control.SRR15539824;34;40;0.617647058823529;13;21;0.117647058823529;0.382352941176471
Control.SRR15539824;37;40;0.513513513513513;18;19;0.0135135135135135;0.486486486486487
Control.SRR15539824;40;40;0.45;22;18;0.05;0.45
Control.SRR15539824;43;40;0.511627906976744;21;22;0.0116279069767442;0.488372093023256
Control.SRR15539824;36;40;0.5;18;18;0;0.5
Control.SRR15539824;36;40;0.416666666666667;21;15;0.0833333333333333;0.416666666666667
Control.SRR15539824;34;40;0.5;17;17;0;0.5
Control.SRR15539824;35;40;0.6;14;21;0.1;0.4
Control.SRR15539824;34;40;0.411764705882353;20;14;0.0882352941176471;0.411764705882353
Control.SRR15539824;35;40;0.514285714285714;17;18;0.0142857142857142;0.485714285714286
Control.SRR15539824;39;40;0.564102564102564;17;22;0.0641025641025641;0.435897435897436
Control.SRR15539824;35;40;0.485714285714286;18;17;0.0142857142857143;0.485714285714286
Control.SRR15539824;39;40;0.461538461538462;21;18;0.0384615384615384;0.461538461538462
Control.SRR15539824;43;40;0.488372093023256;22;21;0.0116279069767442;0.488372093023256
Control.SRR15539824;42;40;0.380952380952381;26;16;0.119047619047619;0.380952380952381
Control.SRR15539824;34;40;0.411764705882353;20;14;0.0882352941176471;0.411764705882353
Control.SRR15539824;40;40;0.575;17;23;0.075;0.425
Control.SRR15539824;35;40;0.514285714285714;17;18;0.0142857142857142;0.485714285714286
Control.SRR15539824;39;40;0.564102564102564;17;22;0.0641025641025641;0.435897435897436
Control.SRR15539824;37;40;0.540540540540541;17;20;0.0405405405405406;0.459459459459459
Control.SRR15539824;42;40;0.428571428571429;24;18;0.0714285714285715;0.428571428571429
Control.SRR15539824;39;40;0.564102564102564;17;22;0.0641025641025641;0.435897435897436
Control.SRR15539824;38;40;0.447368421052632;21;17;0.0526315789473684;0.447368421052632
Control.SRR15539824;38;40;0.605263157894737;15;23;0.105263157894737;0.394736842105263
Control.SRR15539824;37;40;0.486486486486487;19;18;0.0135135135135135;0.486486486486487
Control.SRR15539824;35;40;0.514285714285714;17;18;0.0142857142857142;0.485714285714286
Control.SRR15539824;41;40;0.48780487804878;21;20;0.0121951219512195;0.48780487804878
Control.SRR15539824;41;40;0.48780487804878;21;20;0.0121951219512195;0.48780487804878
Control.SRR15539824;40;40;0.6;16;24;0.1;0.4
Control.SRR15539824;42;40;0.452380952380952;23;19;0.0476190476190476;0.452380952380952
Control.SRR15539824;33;40;0.636363636363636;12;21;0.136363636363636;0.363636363636364
Control.SRR15539824;40;40;0.55;18;22;0.05;0.45
Control.SRR15539824;35;40;0.485714285714286;18;17;0.0142857142857143;0.485714285714286
Control.SRR15539824;41;40;0.463414634146341;22;19;0.0365853658536585;0.463414634146341
Control.SRR15539824;41;40;0.414634146341463;24;17;0.0853658536585366;0.414634146341463
Control.SRR15539824;43;40;0.534883720930233;20;23;0.0348837209302325;0.465116279069767
Control.SRR15539824;35;40;0.514285714285714;17;18;0.0142857142857142;0.485714285714286
Control.SRR15539824;40;40;0.35;26;14;0.15;0.35
Control.SRR15539824;43;40;0.581395348837209;18;25;0.0813953488372093;0.418604651162791
Control.SRR15539824;34;40;0.529411764705882;16;18;0.0294117647058824;0.470588235294118
Control.SRR15539824;39;40;0.717948717948718;11;28;0.217948717948718;0.282051282051282
Control.SRR15539824;38;40;0.394736842105263;23;15;0.105263157894737;0.394736842105263
Control.SRR15539824;35;40;0.428571428571429;20;15;0.0714285714285715;0.428571428571429
Control.SRR15539824;41;40;0.414634146341463;24;17;0.0853658536585366;0.414634146341463
Control.SRR15539824;39;40;0.41025641025641;23;16;0.0897435897435898;0.41025641025641
Control.SRR15539824;41;40;0.48780487804878;21;20;0.0121951219512195;0.48780487804878
Control.SRR15539824;37;40;0.405405405405405;22;15;0.0945945945945946;0.405405405405405
Control.SRR15539824;36;40;0.472222222222222;19;17;0.0277777777777778;0.472222222222222
Control.SRR15539824;41;40;0.439024390243902;23;18;0.0609756097560976;0.439024390243902
Control.SRR15539824;40;40;0.5;20;20;0;0.5
Control.SRR15539824;42;40;0.547619047619048;19;23;0.0476190476190477;0.452380952380952
Control.SRR15539824;34;40;0.411764705882353;20;14;0.0882352941176471;0.411764705882353
Control.SRR15539824;39;40;0.461538461538462;21;18;0.0384615384615384;0.461538461538462
Control.SRR15539824;38;40;0.5;19;19;0;0.5
Control.SRR15539824;35;40;0.571428571428571;15;20;0.0714285714285714;0.428571428571429
Control.SRR15539824;36;40;0.611111111111111;14;22;0.111111111111111;0.388888888888889
Control.SRR15539824;42;40;0.357142857142857;27;15;0.142857142857143;0.357142857142857
Control.SRR15539824;40;40;0.425;23;17;0.075;0.425
Control.SRR15539824;36;40;0.444444444444444;20;16;0.0555555555555556;0.444444444444444
Control.SRR15539824;35;40;0.685714285714286;11;24;0.185714285714286;0.314285714285714
Control.SRR15539824;38;40;0.657894736842105;13;25;0.157894736842105;0.342105263157895
Control.SRR15539824;37;40;0.459459459459459;20;17;0.0405405405405405;0.459459459459459
Control.SRR15539824;40;40;0.55;18;22;0.05;0.45
Control.SRR15539824;41;40;0.536585365853659;19;22;0.0365853658536586;0.463414634146341
Control.SRR15539824;39;40;0.564102564102564;17;22;0.0641025641025641;0.435897435897436
Control.SRR15539824;39;40;0.487179487179487;20;19;0.0128205128205128;0.487179487179487
Control.SRR15539824;39;40;0.333333333333333;26;13;0.166666666666667;0.333333333333333
Control.SRR15539824;40;40;0.525;19;21;0.025;0.475
Control.SRR15539824;41;40;0.536585365853659;19;22;0.0365853658536586;0.463414634146341
Control.SRR15539824;43;40;0.488372093023256;22;21;0.0116279069767442;0.488372093023256
Control.SRR15539824;41;40;0.585365853658537;17;24;0.0853658536585366;0.414634146341463
Control.SRR15539824;43;40;0.488372093023256;22;21;0.0116279069767442;0.488372093023256
Control.SRR15539824;38;40;0.605263157894737;15;23;0.105263157894737;0.394736842105263
Control.SRR15539824;33;40;0.393939393939394;20;13;0.106060606060606;0.393939393939394
Control.SRR15539824;40;40;0.4;24;16;0.1;0.4
Control.SRR15539824;43;40;0.372093023255814;27;16;0.127906976744186;0.372093023255814
Control.SRR15539824;40;40;0.55;18;22;0.05;0.45
Control.SRR15539824;39;40;0.564102564102564;17;22;0.0641025641025641;0.435897435897436
Control.SRR15539824;42;40;0.547619047619048;19;23;0.0476190476190477;0.452380952380952
Control.SRR15539824;39;40;0.538461538461538;18;21;0.0384615384615384;0.461538461538462
Control.SRR15539824;38;40;0.526315789473684;18;20;0.0263157894736842;0.473684210526316
Control.SRR15539824;41;40;0.463414634146341;22;19;0.0365853658536585;0.463414634146341
Control.SRR15539824;39;40;0.487179487179487;20;19;0.0128205128205128;0.487179487179487
Control.SRR15539824;35;40;0.457142857142857;19;16;0.0428571428571429;0.457142857142857
Control.SRR15539824;38;40;0.394736842105263;23;15;0.105263157894737;0.394736842105263
Control.SRR15539824;42;40;0.547619047619048;19;23;0.0476190476190477;0.452380952380952
Control.SRR15539824;39;40;0.564102564102564;17;22;0.0641025641025641;0.435897435897436
Control.SRR15539824;38;40;0.552631578947368;17;21;0.0526315789473685;0.447368421052632
Control.SRR15539824;40;40;0.475;21;19;0.025;0.475
Control.SRR15539824;41;40;0.390243902439024;25;16;0.109756097560976;0.390243902439024
Control.SRR15539824;36;40;0.583333333333333;15;21;0.0833333333333334;0.416666666666667
Control.SRR15539824;38;40;0.447368421052632;21;17;0.0526315789473684;0.447368421052632
Control.SRR15539824;42;40;0.5;21;21;0;0.5
Control.SRR15539824;43;40;0.534883720930233;20;23;0.0348837209302325;0.465116279069767
Control.SRR15539824;38;40;0.473684210526316;20;18;0.0263157894736842;0.473684210526316
Control.SRR15539824;34;40;0.558823529411765;15;19;0.0588235294117647;0.441176470588235
Control.SRR15539824;33;40;0.515151515151515;16;17;0.0151515151515151;0.484848484848485
Control.SRR15539824;41;40;0.439024390243902;23;18;0.0609756097560976;0.439024390243902
Control.SRR15539824;39;40;0.461538461538462;21;18;0.0384615384615384;0.461538461538462
Control.SRR15539824;37;40;0.27027027027027;27;10;0.22972972972973;0.27027027027027
Control.SRR15539824;40;40;0.525;19;21;0.025;0.475
Control.SRR15539824;43;40;0.488372093023256;22;21;0.0116279069767442;0.488372093023256
Control.SRR15539824;36;40;0.472222222222222;19;17;0.0277777777777778;0.472222222222222
Control.SRR15539824;41;40;0.414634146341463;24;17;0.0853658536585366;0.414634146341463
Control.SRR15539824;33;40;0.484848484848485;17;16;0.0151515151515151;0.484848484848485
Control.SRR15539824;36;40;0.583333333333333;15;21;0.0833333333333334;0.416666666666667
Control.SRR15539824;41;40;0.536585365853659;19;22;0.0365853658536586;0.463414634146341
Control.SRR15539824;41;40;0.51219512195122;20;21;0.0121951219512195;0.48780487804878
Control.SRR15539824;37;40;0.594594594594595;15;22;0.0945945945945946;0.405405405405405
Control.SRR15539824;39;40;0.615384615384615;15;24;0.115384615384615;0.384615384615385
Control.SRR15539824;41;40;0.560975609756098;18;23;0.0609756097560976;0.439024390243902
Control.SRR15539824;39;40;0.461538461538462;21;18;0.0384615384615384;0.461538461538462
Control.SRR15539824;43;40;0.534883720930233;20;23;0.0348837209302325;0.465116279069767
Control.SRR15539824;43;40;0.627906976744186;16;27;0.127906976744186;0.372093023255814
Control.SRR15539824;38;40;0.578947368421053;16;22;0.0789473684210527;0.421052631578947
Control.SRR15539824;39;40;0.512820512820513;19;20;0.0128205128205128;0.487179487179487
Control.SRR15539824;37;40;0.513513513513513;18;19;0.0135135135135135;0.486486486486487
Control.SRR15539824;35;40;0.457142857142857;19;16;0.0428571428571429;0.457142857142857
Control.SRR15539824;39;40;0.41025641025641;23;16;0.0897435897435898;0.41025641025641
Control.SRR15539824;33;40;0.606060606060606;13;20;0.106060606060606;0.393939393939394
Control.SRR15539824;42;40;0.404761904761905;25;17;0.0952380952380952;0.404761904761905
Control.SRR15539824;38;40;0.421052631578947;22;16;0.0789473684210527;0.421052631578947
Control.SRR15539824;38;40;0.526315789473684;18;20;0.0263157894736842;0.473684210526316
Control.SRR15539824;42;40;0.595238095238095;17;25;0.0952380952380952;0.404761904761905
Control.SRR15539824;38;40;0.5;19;19;0;0.5
Control.SRR15539824;41;40;0.463414634146341;22;19;0.0365853658536585;0.463414634146341
Control.SRR15539824;37;40;0.513513513513513;18;19;0.0135135135135135;0.486486486486487
Control.SRR15539824;35;40;0.514285714285714;17;18;0.0142857142857142;0.485714285714286
Control.SRR15539824;34;40;0.5;17;17;0;0.5
Control.SRR15539824;34;40;0.558823529411765;15;19;0.0588235294117647;0.441176470588235
Control.SRR15539824;35;40;0.285714285714286;25;10;0.214285714285714;0.285714285714286
Control.SRR15539824;42;40;0.571428571428571;18;24;0.0714285714285714;0.428571428571429
Control.SRR15539824;42;40;0.619047619047619;16;26;0.119047619047619;0.380952380952381
Control.SRR15539824;41;40;0.390243902439024;25;16;0.109756097560976;0.390243902439024
Control.SRR15539824;41;40;0.463414634146341;22;19;0.0365853658536585;0.463414634146341
Control.SRR15539824;43;40;0.511627906976744;21;22;0.0116279069767442;0.488372093023256
Control.SRR15539824;39;40;0.512820512820513;19;20;0.0128205128205128;0.487179487179487
Control.SRR15539824;35;40;0.457142857142857;19;16;0.0428571428571429;0.457142857142857
Control.SRR15539824;35;40;0.4;21;14;0.1;0.4
Control.SRR15539824;42;40;0.571428571428571;18;24;0.0714285714285714;0.428571428571429
Control.SRR15539824;33;40;0.515151515151515;16;17;0.0151515151515151;0.484848484848485
Control.SRR15539824;43;40;0.418604651162791;25;18;0.0813953488372093;0.418604651162791
Control.SRR15539824;36;40;0.444444444444444;20;16;0.0555555555555556;0.444444444444444
Control.SRR15539824;43;40;0.27906976744186;31;12;0.22093023255814;0.27906976744186
Control.SRR15539824;35;40;0.457142857142857;19;16;0.0428571428571429;0.457142857142857
Control.SRR15539824;43;40;0.441860465116279;24;19;0.0581395348837209;0.441860465116279
Control.SRR15539824;34;40;0.411764705882353;20;14;0.0882352941176471;0.411764705882353
Control.SRR15539824;38;40;0.5;19;19;0;0.5
Control.SRR15539824;40;40;0.525;19;21;0.025;0.475
Control.SRR15539824;35;40;0.485714285714286;18;17;0.0142857142857143;0.485714285714286
Control.SRR15539824;37;40;0.432432432432432;21;16;0.0675675675675675;0.432432432432432
Control.SRR15539824;39;40;0.512820512820513;19;20;0.0128205128205128;0.487179487179487
Control.SRR15539824;34;40;0.470588235294118;18;16;0.0294117647058824;0.470588235294118
Control.SRR15539824;36;40;0.5;18;18;0;0.5
Control.SRR15539824;37;40;0.378378378378378;23;14;0.121621621621622;0.378378378378378
Control.SRR15539824;36;40;0.5;18;18;0;0.5
Control.SRR15539824;36;40;0.527777777777778;17;19;0.0277777777777778;0.472222222222222
Control.SRR15539824;37;40;0.540540540540541;17;20;0.0405405405405406;0.459459459459459
Control.SRR15539824;35;40;0.514285714285714;17;18;0.0142857142857142;0.485714285714286
Control.SRR15539824;42;40;0.595238095238095;17;25;0.0952380952380952;0.404761904761905
Control.SRR15539824;39;40;0.461538461538462;21;18;0.0384615384615384;0.461538461538462
Control.SRR15539824;38;40;0.473684210526316;20;18;0.0263157894736842;0.473684210526316
Control.SRR15539824;42;40;0.428571428571429;24;18;0.0714285714285715;0.428571428571429
Control.SRR15539824;36;40;0.5;18;18;0;0.5
Control.SRR15539824;36;40;0.638888888888889;13;23;0.138888888888889;0.361111111111111
Control.SRR15539824;42;40;0.595238095238095;17;25;0.0952380952380952;0.404761904761905
Control.SRR15539824;37;40;0.432432432432432;21;16;0.0675675675675675;0.432432432432432
Control.SRR15539824;33;40;0.606060606060606;13;20;0.106060606060606;0.393939393939394
Control.SRR15539824;43;40;0.674418604651163;14;29;0.174418604651163;0.325581395348837
Control.SRR15539824;43;40;0.651162790697674;15;28;0.151162790697674;0.348837209302326
Control.SRR15539824;38;40;0.605263157894737;15;23;0.105263157894737;0.394736842105263
Control.SRR15539824;41;40;0.48780487804878;21;20;0.0121951219512195;0.48780487804878
Control.SRR15539824;36;40;0.527777777777778;17;19;0.0277777777777778;0.472222222222222
Control.SRR15539824;41;40;0.609756097560976;16;25;0.109756097560976;0.390243902439024
Control.SRR15539824;40;40;0.325;27;13;0.175;0.325
Control.SRR15539824;42;40;0.404761904761905;25;17;0.0952380952380952;0.404761904761905
Control.SRR15539824;38;40;0.368421052631579;24;14;0.131578947368421;0.368421052631579
Control.SRR15539824;37;40;0.432432432432432;21;16;0.0675675675675675;0.432432432432432
Control.SRR15539824;37;40;0.621621621621622;14;23;0.121621621621622;0.378378378378378
Control.SRR15539824;41;40;0.536585365853659;19;22;0.0365853658536586;0.463414634146341
Control.SRR15539824;38;40;0.605263157894737;15;23;0.105263157894737;0.394736842105263
Control.SRR15539824;35;40;0.485714285714286;18;17;0.0142857142857143;0.485714285714286
Control.SRR15539824;41;40;0.51219512195122;20;21;0.0121951219512195;0.48780487804878
Control.SRR15539824;43;40;0.581395348837209;18;25;0.0813953488372093;0.418604651162791
Control.SRR15539824;38;40;0.552631578947368;17;21;0.0526315789473685;0.447368421052632
Control.SRR15539824;38;40;0.447368421052632;21;17;0.0526315789473684;0.447368421052632
Control.SRR15539824;36;40;0.527777777777778;17;19;0.0277777777777778;0.472222222222222
Control.SRR15539824;43;40;0.441860465116279;24;19;0.0581395348837209;0.441860465116279
Control.SRR15539824;43;40;0.558139534883721;19;24;0.0581395348837209;0.441860465116279
Control.SRR15539824;35;40;0.571428571428571;15;20;0.0714285714285714;0.428571428571429
Control.SRR15539824;36;40;0.5;18;18;0;0.5
Control.SRR15539824;41;40;0.463414634146341;22;19;0.0365853658536585;0.463414634146341
Control.SRR15539824;39;40;0.41025641025641;23;16;0.0897435897435898;0.41025641025641
Control.SRR15539824;38;40;0.5;19;19;0;0.5
Control.SRR15539824;40;40;0.575;17;23;0.075;0.425
Control.SRR15539824;37;40;0.621621621621622;14;23;0.121621621621622;0.378378378378378
Control.SRR15539824;41;40;0.609756097560976;16;25;0.109756097560976;0.390243902439024
Control.SRR15539824;34;40;0.529411764705882;16;18;0.0294117647058824;0.470588235294118
Control.SRR15539824;41;40;0.634146341463415;15;26;0.134146341463415;0.365853658536585
Control.SRR15539824;40;40;0.55;18;22;0.05;0.45
Control.SRR15539824;43;40;0.744186046511628;11;32;0.244186046511628;0.255813953488372
Control.SRR15539824;33;40;0.424242424242424;19;14;0.0757575757575757;0.424242424242424
Control.SRR15539824;37;40;0.405405405405405;22;15;0.0945945945945946;0.405405405405405
Control.SRR15539824;36;40;0.444444444444444;20;16;0.0555555555555556;0.444444444444444
Control.SRR15539824;43;40;0.534883720930233;20;23;0.0348837209302325;0.465116279069767
Control.SRR15539824;39;40;0.512820512820513;19;20;0.0128205128205128;0.487179487179487
Control.SRR15539824;42;40;0.523809523809524;20;22;0.0238095238095238;0.476190476190476
Control.SRR15539824;42;40;0.571428571428571;18;24;0.0714285714285714;0.428571428571429
Control.SRR15539824;37;40;0.540540540540541;17;20;0.0405405405405406;0.459459459459459
Control.SRR15539824;36;40;0.416666666666667;21;15;0.0833333333333333;0.416666666666667
Control.SRR15539824;36;40;0.416666666666667;21;15;0.0833333333333333;0.416666666666667
Control.SRR15539824;36;40;0.638888888888889;13;23;0.138888888888889;0.361111111111111
Control.SRR15539824;35;40;0.4;21;14;0.1;0.4
Control.SRR15539824;34;40;0.382352941176471;21;13;0.117647058823529;0.382352941176471
Control.SRR15539824;38;40;0.394736842105263;23;15;0.105263157894737;0.394736842105263
Control.SRR15539824;42;40;0.571428571428571;18;24;0.0714285714285714;0.428571428571429
Control.SRR15539824;36;40;0.583333333333333;15;21;0.0833333333333334;0.416666666666667
Control.SRR15539824;38;40;0.552631578947368;17;21;0.0526315789473685;0.447368421052632
Control.SRR15539824;33;40;0.454545454545455;18;15;0.0454545454545455;0.454545454545455
Control.SRR15539824;42;40;0.571428571428571;18;24;0.0714285714285714;0.428571428571429
Control.SRR15539824;39;40;0.461538461538462;21;18;0.0384615384615384;0.461538461538462
Control.SRR15539824;42;40;0.452380952380952;23;19;0.0476190476190476;0.452380952380952
Control.SRR15539824;41;40;0.390243902439024;25;16;0.109756097560976;0.390243902439024
Control.SRR15539824;40;40;0.475;21;19;0.025;0.475
Control.SRR15539824;36;40;0.388888888888889;22;14;0.111111111111111;0.388888888888889
Control.SRR15539824;35;40;0.428571428571429;20;15;0.0714285714285715;0.428571428571429
Control.SRR15539824;41;40;0.48780487804878;21;20;0.0121951219512195;0.48780487804878
Control.SRR15539824;41;40;0.634146341463415;15;26;0.134146341463415;0.365853658536585
Control.SRR15539824;42;40;0.523809523809524;20;22;0.0238095238095238;0.476190476190476
Control.SRR15539824;41;40;0.560975609756098;18;23;0.0609756097560976;0.439024390243902
Control.SRR15539824;43;40;0.558139534883721;19;24;0.0581395348837209;0.441860465116279
Control.SRR15539824;33;40;0.515151515151515;16;17;0.0151515151515151;0.484848484848485
Control.SRR15539824;39;40;0.512820512820513;19;20;0.0128205128205128;0.487179487179487
Control.SRR15539824;39;40;0.435897435897436;22;17;0.0641025641025641;0.435897435897436
Control.SRR15539824;42;40;0.547619047619048;19;23;0.0476190476190477;0.452380952380952
Control.SRR15539824;36;40;0.416666666666667;21;15;0.0833333333333333;0.416666666666667
Control.SRR15539824;35;40;0.542857142857143;16;19;0.0428571428571428;0.457142857142857
Control.SRR15539824;42;40;0.571428571428571;18;24;0.0714285714285714;0.428571428571429
Control.SRR15539824;41;40;0.463414634146341;22;19;0.0365853658536585;0.463414634146341
Control.SRR15539824;35;40;0.428571428571429;20;15;0.0714285714285715;0.428571428571429
Control.SRR15539824;34;40;0.470588235294118;18;16;0.0294117647058824;0.470588235294118
Control.SRR15539824;40;40;0.45;22;18;0.05;0.45
Control.SRR15539824;38;40;0.447368421052632;21;17;0.0526315789473684;0.447368421052632
Control.SRR15539824;40;40;0.625;15;25;0.125;0.375
Control.SRR15539824;38;40;0.526315789473684;18;20;0.0263157894736842;0.473684210526316
Control.SRR15539824;36;40;0.611111111111111;14;22;0.111111111111111;0.388888888888889
Control.SRR15539824;41;40;0.48780487804878;21;20;0.0121951219512195;0.48780487804878
Control.SRR15539824;37;40;0.486486486486487;19;18;0.0135135135135135;0.486486486486487
Control.SRR15539824;40;40;0.45;22;18;0.05;0.45
Control.SRR15539824;39;40;0.435897435897436;22;17;0.0641025641025641;0.435897435897436
Control.SRR15539824;43;40;0.488372093023256;22;21;0.0116279069767442;0.488372093023256
Control.SRR15539824;43;40;0.558139534883721;19;24;0.0581395348837209;0.441860465116279
Control.SRR15539824;42;40;0.357142857142857;27;15;0.142857142857143;0.357142857142857
Control.SRR15539824;36;40;0.5;18;18;0;0.5
Control.SRR15539824;34;40;0.647058823529412;12;22;0.147058823529412;0.352941176470588
Control.SRR15539824;36;40;0.638888888888889;13;23;0.138888888888889;0.361111111111111
Control.SRR15539824;36;40;0.527777777777778;17;19;0.0277777777777778;0.472222222222222
Control.SRR15539824;43;40;0.488372093023256;22;21;0.0116279069767442;0.488372093023256
Control.SRR15539824;37;40;0.567567567567568;16;21;0.0675675675675675;0.432432432432432
Control.SRR15539824;41;40;0.560975609756098;18;23;0.0609756097560976;0.439024390243902
Control.SRR15539824;38;40;0.473684210526316;20;18;0.0263157894736842;0.473684210526316
Control.SRR15539824;40;40;0.475;21;19;0.025;0.475
Control.SRR15539824;35;40;0.314285714285714;24;11;0.185714285714286;0.314285714285714
Control.SRR15539824;34;40;0.588235294117647;14;20;0.0882352941176471;0.411764705882353
Control.SRR15539824;33;40;0.363636363636364;21;12;0.136363636363636;0.363636363636364
Control.SRR15539824;38;40;0.447368421052632;21;17;0.0526315789473684;0.447368421052632
Control.SRR15539824;38;40;0.447368421052632;21;17;0.0526315789473684;0.447368421052632
Control.SRR15539824;42;40;0.571428571428571;18;24;0.0714285714285714;0.428571428571429
Control.SRR15539824;40;40;0.425;23;17;0.075;0.425
Control.SRR15539824;38;40;0.5;19;19;0;0.5
Control.SRR15539824;39;40;0.461538461538462;21;18;0.0384615384615384;0.461538461538462
Control.SRR15539824;36;40;0.555555555555556;16;20;0.0555555555555556;0.444444444444444
Control.SRR15539824;39;40;0.512820512820513;19;20;0.0128205128205128;0.487179487179487
Control.SRR15539824;33;40;0.545454545454545;15;18;0.0454545454545454;0.454545454545455
Control.SRR15539824;39;40;0.512820512820513;19;20;0.0128205128205128;0.487179487179487
Control.SRR15539824;41;40;0.585365853658537;17;24;0.0853658536585366;0.414634146341463
Control.SRR15539824;42;40;0.428571428571429;24;18;0.0714285714285715;0.428571428571429
Control.SRR15539824;42;40;0.476190476190476;22;20;0.0238095238095238;0.476190476190476
Control.SRR15539824;36;40;0.583333333333333;15;21;0.0833333333333334;0.416666666666667
Control.SRR15539824;43;40;0.558139534883721;19;24;0.0581395348837209;0.441860465116279
Control.SRR15539824;42;40;0.357142857142857;27;15;0.142857142857143;0.357142857142857
Control.SRR15539824;37;40;0.378378378378378;23;14;0.121621621621622;0.378378378378378
Control.SRR15539824;39;40;0.564102564102564;17;22;0.0641025641025641;0.435897435897436
Control.SRR15539824;36;40;0.444444444444444;20;16;0.0555555555555556;0.444444444444444
Control.SRR15539824;36;40;0.5;18;18;0;0.5
Control.SRR15539824;34;40;0.411764705882353;20;14;0.0882352941176471;0.411764705882353
Control.SRR15539824;39;40;0.461538461538462;21;18;0.0384615384615384;0.461538461538462
Control.SRR15539824;33;40;0.272727272727273;24;9;0.227272727272727;0.272727272727273
Control.SRR15539824;42;40;0.523809523809524;20;22;0.0238095238095238;0.476190476190476
Control.SRR15539824;42;40;0.452380952380952;23;19;0.0476190476190476;0.452380952380952
Control.SRR15539824;37;40;0.459459459459459;20;17;0.0405405405405405;0.459459459459459
Control.SRR15539824;39;40;0.41025641025641;23;16;0.0897435897435898;0.41025641025641
Control.SRR15539824;41;40;0.585365853658537;17;24;0.0853658536585366;0.414634146341463
Control.SRR15539824;37;40;0.459459459459459;20;17;0.0405405405405405;0.459459459459459
Control.SRR15539824;42;40;0.523809523809524;20;22;0.0238095238095238;0.476190476190476
Control.SRR15539824;38;40;0.5;19;19;0;0.5
Control.SRR15539824;40;40;0.4;24;16;0.1;0.4
Control.SRR15539824;36;40;0.611111111111111;14;22;0.111111111111111;0.388888888888889
Control.SRR15539824;37;40;0.567567567567568;16;21;0.0675675675675675;0.432432432432432
Control.SRR15539824;39;40;0.615384615384615;15;24;0.115384615384615;0.384615384615385
Control.SRR15539824;34;40;0.529411764705882;16;18;0.0294117647058824;0.470588235294118
Control.SRR15539824;36;40;0.472222222222222;19;17;0.0277777777777778;0.472222222222222
Control.SRR15539824;35;40;0.542857142857143;16;19;0.0428571428571428;0.457142857142857
Control.SRR15539824;38;40;0.605263157894737;15;23;0.105263157894737;0.394736842105263
Control.SRR15539824;39;40;0.512820512820513;19;20;0.0128205128205128;0.487179487179487
Control.SRR15539824;39;40;0.384615384615385;24;15;0.115384615384615;0.384615384615385
Control.SRR15539824;42;40;0.547619047619048;19;23;0.0476190476190477;0.452380952380952
Control.SRR15539824;38;40;0.473684210526316;20;18;0.0263157894736842;0.473684210526316
Control.SRR15539824;40;40;0.475;21;19;0.025;0.475
Control.SRR15539824;36;40;0.416666666666667;21;15;0.0833333333333333;0.416666666666667
Control.SRR15539824;37;40;0.459459459459459;20;17;0.0405405405405405;0.459459459459459
Control.SRR15539824;41;40;0.463414634146341;22;19;0.0365853658536585;0.463414634146341
Control.SRR15539824;43;40;0.581395348837209;18;25;0.0813953488372093;0.418604651162791
Control.SRR15539824;43;40;0.441860465116279;24;19;0.0581395348837209;0.441860465116279
Control.SRR15539824;38;40;0.473684210526316;20;18;0.0263157894736842;0.473684210526316
Control.SRR15539824;37;40;0.513513513513513;18;19;0.0135135135135135;0.486486486486487
Control.SRR15539824;36;40;0.611111111111111;14;22;0.111111111111111;0.388888888888889
Control.SRR15539824;40;40;0.65;14;26;0.15;0.35
Control.SRR15539824;42;40;0.619047619047619;16;26;0.119047619047619;0.380952380952381
Control.SRR15539824;33;40;0.575757575757576;14;19;0.0757575757575758;0.424242424242424
Control.SRR15539824;39;40;0.641025641025641;14;25;0.141025641025641;0.358974358974359
Control.SRR15539824;41;40;0.341463414634146;27;14;0.158536585365854;0.341463414634146
Control.SRR15539824;40;40;0.475;21;19;0.025;0.475
Control.SRR15539824;34;40;0.470588235294118;18;16;0.0294117647058824;0.470588235294118
Control.SRR15539824;40;40;0.525;19;21;0.025;0.475
Control.SRR15539824;35;40;0.628571428571429;13;22;0.128571428571429;0.371428571428571
Control.SRR15539824;42;40;0.404761904761905;25;17;0.0952380952380952;0.404761904761905
Control.SRR15539824;38;40;0.552631578947368;17;21;0.0526315789473685;0.447368421052632
Control.SRR15539824;34;40;0.588235294117647;14;20;0.0882352941176471;0.411764705882353
Control.SRR15539824;38;40;0.368421052631579;24;14;0.131578947368421;0.368421052631579
Control.SRR15539824;35;40;0.6;14;21;0.1;0.4
Control.SRR15539824;33;40;0.545454545454545;15;18;0.0454545454545454;0.454545454545455
Control.SRR15539824;33;40;0.545454545454545;15;18;0.0454545454545454;0.454545454545455
Control.SRR15539824;39;40;0.41025641025641;23;16;0.0897435897435898;0.41025641025641
Control.SRR15539824;37;40;0.297297297297297;26;11;0.202702702702703;0.297297297297297
Control.SRR15539824;42;40;0.571428571428571;18;24;0.0714285714285714;0.428571428571429
Control.SRR15539824;43;40;0.488372093023256;22;21;0.0116279069767442;0.488372093023256
Control.SRR15539824;43;40;0.465116279069767;23;20;0.0348837209302326;0.465116279069767
Control.SRR15539824;43;40;0.581395348837209;18;25;0.0813953488372093;0.418604651162791
Control.SRR15539824;43;40;0.558139534883721;19;24;0.0581395348837209;0.441860465116279
Control.SRR15539824;34;40;0.647058823529412;12;22;0.147058823529412;0.352941176470588
Control.SRR15539824;43;40;0.418604651162791;25;18;0.0813953488372093;0.418604651162791
Control.SRR15539824;42;40;0.523809523809524;20;22;0.0238095238095238;0.476190476190476
Control.SRR15539824;34;40;0.617647058823529;13;21;0.117647058823529;0.382352941176471
Control.SRR15539824;33;40;0.424242424242424;19;14;0.0757575757575757;0.424242424242424
Control.SRR15539824;35;40;0.6;14;21;0.1;0.4
Control.SRR15539824;33;40;0.636363636363636;12;21;0.136363636363636;0.363636363636364
Control.SRR15539824;36;40;0.527777777777778;17;19;0.0277777777777778;0.472222222222222
Control.SRR15539824;38;40;0.447368421052632;21;17;0.0526315789473684;0.447368421052632
Control.SRR15539824;43;40;0.558139534883721;19;24;0.0581395348837209;0.441860465116279
Control.SRR15539824;41;40;0.560975609756098;18;23;0.0609756097560976;0.439024390243902
Control.SRR15539824;37;40;0.405405405405405;22;15;0.0945945945945946;0.405405405405405
Control.SRR15539824;40;40;0.525;19;21;0.025;0.475
Control.SRR15539824;43;40;0.441860465116279;24;19;0.0581395348837209;0.441860465116279
Control.SRR15539824;43;40;0.372093023255814;27;16;0.127906976744186;0.372093023255814
Control.SRR15539824;39;40;0.461538461538462;21;18;0.0384615384615384;0.461538461538462
Control.SRR15539824;40;40;0.6;16;24;0.1;0.4
Control.SRR15539824;41;40;0.463414634146341;22;19;0.0365853658536585;0.463414634146341
Control.SRR15539824;37;40;0.486486486486487;19;18;0.0135135135135135;0.486486486486487
Control.SRR15539824;40;40;0.55;18;22;0.05;0.45
Control.SRR15539824;38;40;0.473684210526316;20;18;0.0263157894736842;0.473684210526316
Control.SRR15539824;34;40;0.441176470588235;19;15;0.0588235294117647;0.441176470588235
Control.SRR15539824;41;40;0.48780487804878;21;20;0.0121951219512195;0.48780487804878
Control.SRR15539824;38;40;0.526315789473684;18;20;0.0263157894736842;0.473684210526316
Control.SRR15539824;39;40;0.487179487179487;20;19;0.0128205128205128;0.487179487179487
Control.SRR15539824;38;40;0.5;19;19;0;0.5
Control.SRR15539824;37;40;0.648648648648649;13;24;0.148648648648649;0.351351351351351
Control.SRR15539824;39;40;0.538461538461538;18;21;0.0384615384615384;0.461538461538462
Control.SRR15539824;39;40;0.487179487179487;20;19;0.0128205128205128;0.487179487179487
Control.SRR15539824;41;40;0.51219512195122;20;21;0.0121951219512195;0.48780487804878
Control.SRR15539824;35;40;0.714285714285714;10;25;0.214285714285714;0.285714285714286
Control.SRR15539824;34;40;0.470588235294118;18;16;0.0294117647058824;0.470588235294118
Control.SRR15539824;36;40;0.416666666666667;21;15;0.0833333333333333;0.416666666666667
Control.SRR15539824;39;40;0.487179487179487;20;19;0.0128205128205128;0.487179487179487
Control.SRR15539824;37;40;0.540540540540541;17;20;0.0405405405405406;0.459459459459459
Control.SRR15539824;34;40;0.5;17;17;0;0.5
Control.SRR15539824;36;40;0.5;18;18;0;0.5
Control.SRR15539824;35;40;0.628571428571429;13;22;0.128571428571429;0.371428571428571
Control.SRR15539824;41;40;0.585365853658537;17;24;0.0853658536585366;0.414634146341463
Control.SRR15539824;41;40;0.536585365853659;19;22;0.0365853658536586;0.463414634146341
Control.SRR15539824;39;40;0.512820512820513;19;20;0.0128205128205128;0.487179487179487
Control.SRR15539824;37;40;0.675675675675676;12;25;0.175675675675676;0.324324324324324
Control.SRR15539824;42;40;0.547619047619048;19;23;0.0476190476190477;0.452380952380952
Control.SRR15539824;43;40;0.348837209302326;28;15;0.151162790697674;0.348837209302326
Control.SRR15539824;41;40;0.609756097560976;16;25;0.109756097560976;0.390243902439024
Control.SRR15539824;40;40;0.5;20;20;0;0.5
Control.SRR15539824;39;40;0.512820512820513;19;20;0.0128205128205128;0.487179487179487
Control.SRR15539824;40;40;0.4;24;16;0.1;0.4
Control.SRR15539824;42;40;0.452380952380952;23;19;0.0476190476190476;0.452380952380952
Control.SRR15539824;39;40;0.307692307692308;27;12;0.192307692307692;0.307692307692308
Control.SRR15539824;41;40;0.609756097560976;16;25;0.109756097560976;0.390243902439024
Control.SRR15539824;37;40;0.648648648648649;13;24;0.148648648648649;0.351351351351351
Control.SRR15539824;37;40;0.567567567567568;16;21;0.0675675675675675;0.432432432432432
Control.SRR15539824;41;40;0.536585365853659;19;22;0.0365853658536586;0.463414634146341
Control.SRR15539824;42;40;0.5;21;21;0;0.5
Control.SRR15539824;42;40;0.619047619047619;16;26;0.119047619047619;0.380952380952381
Control.SRR15539824;36;40;0.472222222222222;19;17;0.0277777777777778;0.472222222222222
Control.SRR15539824;40;40;0.425;23;17;0.075;0.425
Control.SRR15539824;38;40;0.657894736842105;13;25;0.157894736842105;0.342105263157895
Control.SRR15539824;42;40;0.428571428571429;24;18;0.0714285714285715;0.428571428571429
Control.SRR15539824;35;40;0.485714285714286;18;17;0.0142857142857143;0.485714285714286
Control.SRR15539824;33;40;0.666666666666667;11;22;0.166666666666667;0.333333333333333
Control.SRR15539824;39;40;0.435897435897436;22;17;0.0641025641025641;0.435897435897436
Control.SRR15539824;38;40;0.578947368421053;16;22;0.0789473684210527;0.421052631578947
Control.SRR15539824;35;40;0.457142857142857;19;16;0.0428571428571429;0.457142857142857
Control.SRR15539824;40;40;0.525;19;21;0.025;0.475
Control.SRR15539824;36;40;0.472222222222222;19;17;0.0277777777777778;0.472222222222222
Control.SRR15539824;41;40;0.560975609756098;18;23;0.0609756097560976;0.439024390243902
Control.SRR15539824;38;40;0.578947368421053;16;22;0.0789473684210527;0.421052631578947
Control.SRR15539824;40;40;0.55;18;22;0.05;0.45
Control.SRR15539824;36;40;0.527777777777778;17;19;0.0277777777777778;0.472222222222222
Control.SRR15539824;34;40;0.705882352941177;10;24;0.205882352941177;0.294117647058824
Control.SRR15539824;38;40;0.5;19;19;0;0.5
Control.SRR15539824;42;40;0.619047619047619;16;26;0.119047619047619;0.380952380952381
Control.SRR15539824;33;40;0.454545454545455;18;15;0.0454545454545455;0.454545454545455
Control.SRR15539824;37;40;0.567567567567568;16;21;0.0675675675675675;0.432432432432432
Control.SRR15539824;41;40;0.463414634146341;22;19;0.0365853658536585;0.463414634146341
Control.SRR15539824;33;40;0.515151515151515;16;17;0.0151515151515151;0.484848484848485
Control.SRR15539824;42;40;0.476190476190476;22;20;0.0238095238095238;0.476190476190476
Control.SRR15539824;41;40;0.51219512195122;20;21;0.0121951219512195;0.48780487804878
Control.SRR15539824;37;40;0.459459459459459;20;17;0.0405405405405405;0.459459459459459
Control.SRR15539824;40;40;0.65;14;26;0.15;0.35
Control.SRR15539824;33;40;0.545454545454545;15;18;0.0454545454545454;0.454545454545455
Control.SRR15539824;38;40;0.552631578947368;17;21;0.0526315789473685;0.447368421052632
Control.SRR15539824;41;40;0.560975609756098;18;23;0.0609756097560976;0.439024390243902
Control.SRR15539824;43;40;0.604651162790698;17;26;0.104651162790698;0.395348837209302
Control.SRR15539824;43;40;0.511627906976744;21;22;0.0116279069767442;0.488372093023256
Control.SRR15539824;34;40;0.470588235294118;18;16;0.0294117647058824;0.470588235294118
Control.SRR15539824;34;40;0.588235294117647;14;20;0.0882352941176471;0.411764705882353
Control.SRR15539824;35;40;0.4;21;14;0.1;0.4
Control.SRR15539824;36;40;0.5;18;18;0;0.5
Control.SRR15539824;34;40;0.617647058823529;13;21;0.117647058823529;0.382352941176471
Control.SRR15539824;36;40;0.611111111111111;14;22;0.111111111111111;0.388888888888889
Control.SRR15539824;35;40;0.514285714285714;17;18;0.0142857142857142;0.485714285714286
Control.SRR15539824;41;40;0.560975609756098;18;23;0.0609756097560976;0.439024390243902
Control.SRR15539824;39;40;0.41025641025641;23;16;0.0897435897435898;0.41025641025641
Control.SRR15539824;35;40;0.6;14;21;0.1;0.4
Control.SRR15539824;33;40;0.606060606060606;13;20;0.106060606060606;0.393939393939394
Control.SRR15539824;33;40;0.515151515151515;16;17;0.0151515151515151;0.484848484848485
Control.SRR15539824;42;40;0.523809523809524;20;22;0.0238095238095238;0.476190476190476
Control.SRR15539824;35;40;0.514285714285714;17;18;0.0142857142857142;0.485714285714286
Control.SRR15539824;34;40;0.5;17;17;0;0.5
Control.SRR15539824;36;40;0.472222222222222;19;17;0.0277777777777778;0.472222222222222
Control.SRR15539824;42;40;0.571428571428571;18;24;0.0714285714285714;0.428571428571429
Control.SRR15539824;42;40;0.595238095238095;17;25;0.0952380952380952;0.404761904761905
Control.SRR15539824;41;40;0.585365853658537;17;24;0.0853658536585366;0.414634146341463
Control.SRR15539824;36;40;0.694444444444444;11;25;0.194444444444444;0.305555555555556
Control.SRR15539824;43;40;0.581395348837209;18;25;0.0813953488372093;0.418604651162791
Control.SRR15539824;35;40;0.542857142857143;16;19;0.0428571428571428;0.457142857142857
Control.SRR15539824;35;40;0.457142857142857;19;16;0.0428571428571429;0.457142857142857
Control.SRR15539824;34;40;0.617647058823529;13;21;0.117647058823529;0.382352941176471
Control.SRR15539824;37;40;0.621621621621622;14;23;0.121621621621622;0.378378378378378
Control.SRR15539824;42;40;0.523809523809524;20;22;0.0238095238095238;0.476190476190476
Control.SRR15539824;39;40;0.461538461538462;21;18;0.0384615384615384;0.461538461538462
Control.SRR15539824;37;40;0.621621621621622;14;23;0.121621621621622;0.378378378378378
Control.SRR15539824;38;40;0.5;19;19;0;0.5
Control.SRR15539824;40;40;0.475;21;19;0.025;0.475
Control.SRR15539824;41;40;0.585365853658537;17;24;0.0853658536585366;0.414634146341463
Control.SRR15539824;33;40;0.333333333333333;22;11;0.166666666666667;0.333333333333333
Control.SRR15539824;36;40;0.583333333333333;15;21;0.0833333333333334;0.416666666666667
Control.SRR15539824;41;40;0.560975609756098;18;23;0.0609756097560976;0.439024390243902
Control.SRR15539824;36;40;0.555555555555556;16;20;0.0555555555555556;0.444444444444444
Control.SRR15539824;36;40;0.555555555555556;16;20;0.0555555555555556;0.444444444444444
Control.SRR15539824;36;40;0.527777777777778;17;19;0.0277777777777778;0.472222222222222
Control.SRR15539824;34;40;0.411764705882353;20;14;0.0882352941176471;0.411764705882353
Control.SRR15539824;35;40;0.457142857142857;19;16;0.0428571428571429;0.457142857142857
Control.SRR15539824;33;40;0.515151515151515;16;17;0.0151515151515151;0.484848484848485
Control.SRR15539824;39;40;0.435897435897436;22;17;0.0641025641025641;0.435897435897436
Control.SRR15539824;36;40;0.416666666666667;21;15;0.0833333333333333;0.416666666666667
Control.SRR15539824;41;40;0.390243902439024;25;16;0.109756097560976;0.390243902439024
Control.SRR15539824;37;40;0.594594594594595;15;22;0.0945945945945946;0.405405405405405
Control.SRR15539824;35;40;0.542857142857143;16;19;0.0428571428571428;0.457142857142857
Control.SRR15539824;35;40;0.4;21;14;0.1;0.4
Control.SRR15539824;34;40;0.558823529411765;15;19;0.0588235294117647;0.441176470588235
Control.SRR15539824;38;40;0.526315789473684;18;20;0.0263157894736842;0.473684210526316
Control.SRR15539824;36;40;0.583333333333333;15;21;0.0833333333333334;0.416666666666667
Control.SRR15539824;35;40;0.485714285714286;18;17;0.0142857142857143;0.485714285714286
Control.SRR15539824;40;40;0.55;18;22;0.05;0.45
Control.SRR15539824;35;40;0.485714285714286;18;17;0.0142857142857143;0.485714285714286
Control.SRR15539824;40;40;0.375;25;15;0.125;0.375
Control.SRR15539824;42;40;0.595238095238095;17;25;0.0952380952380952;0.404761904761905
Control.SRR15539824;35;40;0.542857142857143;16;19;0.0428571428571428;0.457142857142857
Control.SRR15539824;37;40;0.324324324324324;25;12;0.175675675675676;0.324324324324324
Control.SRR15539824;42;40;0.619047619047619;16;26;0.119047619047619;0.380952380952381
Control.SRR15539824;36;40;0.444444444444444;20;16;0.0555555555555556;0.444444444444444
Control.SRR15539824;41;40;0.365853658536585;26;15;0.134146341463415;0.365853658536585
Control.SRR15539824;43;40;0.418604651162791;25;18;0.0813953488372093;0.418604651162791
Control.SRR15539824;36;40;0.361111111111111;23;13;0.138888888888889;0.361111111111111
Control.SRR15539824;36;40;0.555555555555556;16;20;0.0555555555555556;0.444444444444444
Control.SRR15539824;37;40;0.594594594594595;15;22;0.0945945945945946;0.405405405405405
Control.SRR15539824;42;40;0.523809523809524;20;22;0.0238095238095238;0.476190476190476
Control.SRR15539824;42;40;0.452380952380952;23;19;0.0476190476190476;0.452380952380952
Control.SRR15539824;39;40;0.538461538461538;18;21;0.0384615384615384;0.461538461538462
Control.SRR15539824;40;40;0.525;19;21;0.025;0.475
Control.SRR15539824;36;40;0.5;18;18;0;0.5
Control.SRR15539824;43;40;0.465116279069767;23;20;0.0348837209302326;0.465116279069767
Control.SRR15539824;38;40;0.368421052631579;24;14;0.131578947368421;0.368421052631579
Control.SRR15539824;34;40;0.529411764705882;16;18;0.0294117647058824;0.470588235294118
Control.SRR15539824;35;40;0.571428571428571;15;20;0.0714285714285714;0.428571428571429
Control.SRR15539824;34;40;0.529411764705882;16;18;0.0294117647058824;0.470588235294118
Control.SRR15539824;36;40;0.416666666666667;21;15;0.0833333333333333;0.416666666666667
Control.SRR15539824;33;40;0.515151515151515;16;17;0.0151515151515151;0.484848484848485
Control.SRR15539824;35;40;0.514285714285714;17;18;0.0142857142857142;0.485714285714286
Control.SRR15539824;33;40;0.454545454545455;18;15;0.0454545454545455;0.454545454545455
Control.SRR15539824;33;40;0.636363636363636;12;21;0.136363636363636;0.363636363636364
Control.SRR15539824;33;40;0.575757575757576;14;19;0.0757575757575758;0.424242424242424
Control.SRR15539824;42;40;0.5;21;21;0;0.5
Control.SRR15539824;36;40;0.5;18;18;0;0.5
Control.SRR15539824;43;40;0.418604651162791;25;18;0.0813953488372093;0.418604651162791
Control.SRR15539824;38;40;0.657894736842105;13;25;0.157894736842105;0.342105263157895
Control.SRR15539824;37;40;0.432432432432432;21;16;0.0675675675675675;0.432432432432432
Control.SRR15539824;40;40;0.45;22;18;0.05;0.45
Control.SRR15539824;35;40;0.6;14;21;0.1;0.4
Control.SRR15539824;41;40;0.51219512195122;20;21;0.0121951219512195;0.48780487804878
Control.SRR15539824;37;40;0.459459459459459;20;17;0.0405405405405405;0.459459459459459
Control.SRR15539824;40;40;0.475;21;19;0.025;0.475
Control.SRR15539824;38;40;0.473684210526316;20;18;0.0263157894736842;0.473684210526316
Control.SRR15539824;43;40;0.604651162790698;17;26;0.104651162790698;0.395348837209302
Control.SRR15539824;36;40;0.444444444444444;20;16;0.0555555555555556;0.444444444444444
Control.SRR15539824;35;40;0.342857142857143;23;12;0.157142857142857;0.342857142857143
Control.SRR15539824;38;40;0.447368421052632;21;17;0.0526315789473684;0.447368421052632
Control.SRR15539824;40;40;0.6;16;24;0.1;0.4
Control.SRR15539824;36;40;0.444444444444444;20;16;0.0555555555555556;0.444444444444444
Control.SRR15539824;41;40;0.634146341463415;15;26;0.134146341463415;0.365853658536585
Control.SRR15539824;40;40;0.725;11;29;0.225;0.275
Control.SRR15539824;35;40;0.628571428571429;13;22;0.128571428571429;0.371428571428571
Control.SRR15539824;37;40;0.432432432432432;21;16;0.0675675675675675;0.432432432432432
Control.SRR15539824;37;40;0.540540540540541;17;20;0.0405405405405406;0.459459459459459
Control.SRR15539824;38;40;0.473684210526316;20;18;0.0263157894736842;0.473684210526316
Control.SRR15539824;37;40;0.567567567567568;16;21;0.0675675675675675;0.432432432432432
Control.SRR15539824;42;40;0.5;21;21;0;0.5
Control.SRR15539824;36;40;0.472222222222222;19;17;0.0277777777777778;0.472222222222222
Control.SRR15539824;43;40;0.488372093023256;22;21;0.0116279069767442;0.488372093023256
Control.SRR15539824;36;40;0.5;18;18;0;0.5
Control.SRR15539824;42;40;0.428571428571429;24;18;0.0714285714285715;0.428571428571429
Control.SRR15539824;42;40;0.428571428571429;24;18;0.0714285714285715;0.428571428571429
Control.SRR15539824;36;40;0.527777777777778;17;19;0.0277777777777778;0.472222222222222
Control.SRR15539824;41;40;0.439024390243902;23;18;0.0609756097560976;0.439024390243902
Control.SRR15539824;43;40;0.441860465116279;24;19;0.0581395348837209;0.441860465116279
Control.SRR15539824;41;40;0.585365853658537;17;24;0.0853658536585366;0.414634146341463
Control.SRR15539824;36;40;0.416666666666667;21;15;0.0833333333333333;0.416666666666667
Control.SRR15539824;35;40;0.371428571428571;22;13;0.128571428571429;0.371428571428571
Control.SRR15539824;40;40;0.575;17;23;0.075;0.425
Control.SRR15539824;35;40;0.6;14;21;0.1;0.4
Control.SRR15539824;36;40;0.472222222222222;19;17;0.0277777777777778;0.472222222222222
Control.SRR15539824;34;40;0.441176470588235;19;15;0.0588235294117647;0.441176470588235
Control.SRR15539824;39;40;0.384615384615385;24;15;0.115384615384615;0.384615384615385
Control.SRR15539824;37;40;0.621621621621622;14;23;0.121621621621622;0.378378378378378
Control.SRR15539824;43;40;0.441860465116279;24;19;0.0581395348837209;0.441860465116279
Control.SRR15539824;34;40;0.441176470588235;19;15;0.0588235294117647;0.441176470588235
Control.SRR15539824;36;40;0.555555555555556;16;20;0.0555555555555556;0.444444444444444
Control.SRR15539824;35;40;0.514285714285714;17;18;0.0142857142857142;0.485714285714286
Control.SRR15539824;34;40;0.441176470588235;19;15;0.0588235294117647;0.441176470588235
Control.SRR15539824;33;40;0.363636363636364;21;12;0.136363636363636;0.363636363636364
Control.SRR15539824;36;40;0.555555555555556;16;20;0.0555555555555556;0.444444444444444
Control.SRR15539824;39;40;0.538461538461538;18;21;0.0384615384615384;0.461538461538462
Control.SRR15539824;33;40;0.545454545454545;15;18;0.0454545454545454;0.454545454545455
Control.SRR15539824;38;40;0.526315789473684;18;20;0.0263157894736842;0.473684210526316
Control.SRR15539824;36;40;0.333333333333333;24;12;0.166666666666667;0.333333333333333
Control.SRR15539824;36;40;0.472222222222222;19;17;0.0277777777777778;0.472222222222222
Control.SRR15539824;37;40;0.405405405405405;22;15;0.0945945945945946;0.405405405405405
Control.SRR15539824;40;40;0.375;25;15;0.125;0.375
Control.SRR15539824;40;40;0.55;18;22;0.05;0.45
Control.SRR15539824;36;40;0.5;18;18;0;0.5
Control.SRR15539824;35;40;0.4;21;14;0.1;0.4
Control.SRR15539824;42;40;0.476190476190476;22;20;0.0238095238095238;0.476190476190476
Control.SRR15539824;37;40;0.351351351351351;24;13;0.148648648648649;0.351351351351351
Control.SRR15539824;35;40;0.371428571428571;22;13;0.128571428571429;0.371428571428571
Control.SRR15539824;37;40;0.432432432432432;21;16;0.0675675675675675;0.432432432432432
Control.SRR15539824;37;40;0.567567567567568;16;21;0.0675675675675675;0.432432432432432
Control.SRR15539824;38;40;0.342105263157895;25;13;0.157894736842105;0.342105263157895
Control.SRR15539824;35;40;0.485714285714286;18;17;0.0142857142857143;0.485714285714286
Control.SRR15539824;42;40;0.357142857142857;27;15;0.142857142857143;0.357142857142857
Control.SRR15539824;39;40;0.487179487179487;20;19;0.0128205128205128;0.487179487179487
Control.SRR15539824;36;40;0.527777777777778;17;19;0.0277777777777778;0.472222222222222
Control.SRR15539824;40;40;0.375;25;15;0.125;0.375
Control.SRR15539824;41;40;0.560975609756098;18;23;0.0609756097560976;0.439024390243902
Control.SRR15539824;39;40;0.435897435897436;22;17;0.0641025641025641;0.435897435897436
Control.SRR15539824;36;40;0.472222222222222;19;17;0.0277777777777778;0.472222222222222
Control.SRR15539824;38;40;0.421052631578947;22;16;0.0789473684210527;0.421052631578947
Control.SRR15539824;37;40;0.432432432432432;21;16;0.0675675675675675;0.432432432432432
Control.SRR15539824;43;40;0.511627906976744;21;22;0.0116279069767442;0.488372093023256
Control.SRR15539824;33;40;0.575757575757576;14;19;0.0757575757575758;0.424242424242424
Control.SRR15539824;33;40;0.606060606060606;13;20;0.106060606060606;0.393939393939394
Control.SRR15539824;40;40;0.375;25;15;0.125;0.375
Control.SRR15539824;39;40;0.487179487179487;20;19;0.0128205128205128;0.487179487179487
Control.SRR15539824;37;40;0.513513513513513;18;19;0.0135135135135135;0.486486486486487
Control.SRR15539824;35;40;0.485714285714286;18;17;0.0142857142857143;0.485714285714286
Control.SRR15539824;40;40;0.55;18;22;0.05;0.45
Control.SRR15539824;42;40;0.5;21;21;0;0.5
Control.SRR15539824;43;40;0.558139534883721;19;24;0.0581395348837209;0.441860465116279
Control.SRR15539824;37;40;0.486486486486487;19;18;0.0135135135135135;0.486486486486487
Control.SRR15539824;39;40;0.487179487179487;20;19;0.0128205128205128;0.487179487179487
Control.SRR15539824;40;40;0.4;24;16;0.1;0.4
Control.SRR15539824;40;40;0.45;22;18;0.05;0.45
Control.SRR15539824;37;40;0.459459459459459;20;17;0.0405405405405405;0.459459459459459
Control.SRR15539824;41;40;0.634146341463415;15;26;0.134146341463415;0.365853658536585
Control.SRR15539824;36;40;0.527777777777778;17;19;0.0277777777777778;0.472222222222222
Control.SRR15539824;39;40;0.512820512820513;19;20;0.0128205128205128;0.487179487179487
Control.SRR15539824;43;40;0.581395348837209;18;25;0.0813953488372093;0.418604651162791
Control.SRR15539824;37;40;0.621621621621622;14;23;0.121621621621622;0.378378378378378
Control.SRR15539824;41;40;0.560975609756098;18;23;0.0609756097560976;0.439024390243902
Control.SRR15539824;36;40;0.416666666666667;21;15;0.0833333333333333;0.416666666666667
Control.SRR15539824;33;40;0.545454545454545;15;18;0.0454545454545454;0.454545454545455
Control.SRR15539824;43;40;0.581395348837209;18;25;0.0813953488372093;0.418604651162791
Control.SRR15539824;33;40;0.484848484848485;17;16;0.0151515151515151;0.484848484848485
Control.SRR15539824;35;40;0.457142857142857;19;16;0.0428571428571429;0.457142857142857
Control.SRR15539824;43;40;0.372093023255814;27;16;0.127906976744186;0.372093023255814
Control.SRR15539824;41;40;0.536585365853659;19;22;0.0365853658536586;0.463414634146341
Control.SRR15539824;33;40;0.454545454545455;18;15;0.0454545454545455;0.454545454545455
Control.SRR15539824;41;40;0.585365853658537;17;24;0.0853658536585366;0.414634146341463
Control.SRR15539824;34;40;0.647058823529412;12;22;0.147058823529412;0.352941176470588
Control.SRR15539824;34;40;0.558823529411765;15;19;0.0588235294117647;0.441176470588235
Control.SRR15539824;42;40;0.523809523809524;20;22;0.0238095238095238;0.476190476190476
Control.SRR15539824;34;40;0.441176470588235;19;15;0.0588235294117647;0.441176470588235
Control.SRR15539824;33;40;0.333333333333333;22;11;0.166666666666667;0.333333333333333
Control.SRR15539824;39;40;0.564102564102564;17;22;0.0641025641025641;0.435897435897436
Control.SRR15539824;41;40;0.390243902439024;25;16;0.109756097560976;0.390243902439024
Control.SRR15539824;37;40;0.621621621621622;14;23;0.121621621621622;0.378378378378378
Control.SRR15539824;35;40;0.542857142857143;16;19;0.0428571428571428;0.457142857142857
Control.SRR15539824;42;40;0.666666666666667;14;28;0.166666666666667;0.333333333333333
Control.SRR15539824;38;40;0.368421052631579;24;14;0.131578947368421;0.368421052631579
Control.SRR15539824;33;40;0.696969696969697;10;23;0.196969696969697;0.303030303030303
Control.SRR15539824;34;40;0.529411764705882;16;18;0.0294117647058824;0.470588235294118
Control.SRR15539824;33;40;0.303030303030303;23;10;0.196969696969697;0.303030303030303
Control.SRR15539824;39;40;0.487179487179487;20;19;0.0128205128205128;0.487179487179487
Control.SRR15539824;35;40;0.371428571428571;22;13;0.128571428571429;0.371428571428571
Control.SRR15539824;35;40;0.428571428571429;20;15;0.0714285714285715;0.428571428571429
Control.SRR15539824;33;40;0.545454545454545;15;18;0.0454545454545454;0.454545454545455
Control.SRR15539824;43;40;0.534883720930233;20;23;0.0348837209302325;0.465116279069767
Control.SRR15539824;40;40;0.5;20;20;0;0.5
Control.SRR15539824;38;40;0.578947368421053;16;22;0.0789473684210527;0.421052631578947
Control.SRR15539824;42;40;0.428571428571429;24;18;0.0714285714285715;0.428571428571429
Control.SRR15539824;36;40;0.472222222222222;19;17;0.0277777777777778;0.472222222222222
Control.SRR15539824;40;40;0.575;17;23;0.075;0.425
Control.SRR15539824;39;40;0.564102564102564;17;22;0.0641025641025641;0.435897435897436
Control.SRR15539824;42;40;0.523809523809524;20;22;0.0238095238095238;0.476190476190476
Control.SRR15539824;43;40;0.418604651162791;25;18;0.0813953488372093;0.418604651162791
Control.SRR15539824;38;40;0.447368421052632;21;17;0.0526315789473684;0.447368421052632
Control.SRR15539824;42;40;0.476190476190476;22;20;0.0238095238095238;0.476190476190476
Control.SRR15539824;41;40;0.414634146341463;24;17;0.0853658536585366;0.414634146341463
Control.SRR15539824;41;40;0.414634146341463;24;17;0.0853658536585366;0.414634146341463
Control.SRR15539824;35;40;0.542857142857143;16;19;0.0428571428571428;0.457142857142857
Control.SRR15539824;33;40;0.454545454545455;18;15;0.0454545454545455;0.454545454545455
Control.SRR15539824;43;40;0.372093023255814;27;16;0.127906976744186;0.372093023255814
Control.SRR15539824;43;40;0.511627906976744;21;22;0.0116279069767442;0.488372093023256
Control.SRR15539824;33;40;0.484848484848485;17;16;0.0151515151515151;0.484848484848485
Control.SRR15539824;35;40;0.4;21;14;0.1;0.4
Control.SRR15539824;37;40;0.513513513513513;18;19;0.0135135135135135;0.486486486486487
Control.SRR15539824;36;40;0.472222222222222;19;17;0.0277777777777778;0.472222222222222
Control.SRR15539824;37;40;0.378378378378378;23;14;0.121621621621622;0.378378378378378
Control.SRR15539824;38;40;0.5;19;19;0;0.5
Control.SRR15539824;39;40;0.487179487179487;20;19;0.0128205128205128;0.487179487179487
Control.SRR15539824;34;40;0.617647058823529;13;21;0.117647058823529;0.382352941176471
Control.SRR15539824;42;40;0.404761904761905;25;17;0.0952380952380952;0.404761904761905
Control.SRR15539824;37;40;0.486486486486487;19;18;0.0135135135135135;0.486486486486487
Control.SRR15539824;38;40;0.578947368421053;16;22;0.0789473684210527;0.421052631578947
Control.SRR15539824;42;40;0.452380952380952;23;19;0.0476190476190476;0.452380952380952
Control.SRR15539824;38;40;0.473684210526316;20;18;0.0263157894736842;0.473684210526316
Control.SRR15539824;37;40;0.405405405405405;22;15;0.0945945945945946;0.405405405405405
Control.SRR15539824;41;40;0.634146341463415;15;26;0.134146341463415;0.365853658536585
Control.SRR15539824;35;40;0.771428571428571;8;27;0.271428571428571;0.228571428571429
Control.SRR15539824;41;40;0.536585365853659;19;22;0.0365853658536586;0.463414634146341
Control.SRR15539824;35;40;0.4;21;14;0.1;0.4
Control.SRR15539824;33;40;0.303030303030303;23;10;0.196969696969697;0.303030303030303
Control.SRR15539824;41;40;0.48780487804878;21;20;0.0121951219512195;0.48780487804878
Control.SRR15539824;40;40;0.475;21;19;0.025;0.475
Control.SRR15539824;38;40;0.552631578947368;17;21;0.0526315789473685;0.447368421052632
Control.SRR15539824;43;40;0.325581395348837;29;14;0.174418604651163;0.325581395348837
Control.SRR15539824;40;40;0.45;22;18;0.05;0.45
Control.SRR15539824;40;40;0.4;24;16;0.1;0.4
Control.SRR15539824;34;40;0.676470588235294;11;23;0.176470588235294;0.323529411764706
Control.SRR15539824;33;40;0.363636363636364;21;12;0.136363636363636;0.363636363636364
Control.SRR15539824;34;40;0.588235294117647;14;20;0.0882352941176471;0.411764705882353
Control.SRR15539824;39;40;0.461538461538462;21;18;0.0384615384615384;0.461538461538462
Control.SRR15539824;40;40;0.475;21;19;0.025;0.475
Control.SRR15539824;35;40;0.457142857142857;19;16;0.0428571428571429;0.457142857142857
Control.SRR15539824;34;40;0.5;17;17;0;0.5
Control.SRR15539824;43;40;0.511627906976744;21;22;0.0116279069767442;0.488372093023256
Control.SRR15539824;37;40;0.513513513513513;18;19;0.0135135135135135;0.486486486486487
Control.SRR15539824;35;40;0.457142857142857;19;16;0.0428571428571429;0.457142857142857
Control.SRR15539824;43;40;0.534883720930233;20;23;0.0348837209302325;0.465116279069767
Control.SRR15539824;42;40;0.619047619047619;16;26;0.119047619047619;0.380952380952381
Control.SRR15539824;42;40;0.523809523809524;20;22;0.0238095238095238;0.476190476190476
Control.SRR15539824;40;40;0.5;20;20;0;0.5
Control.SRR15539824;33;40;0.515151515151515;16;17;0.0151515151515151;0.484848484848485
Control.SRR15539824;33;40;0.515151515151515;16;17;0.0151515151515151;0.484848484848485
Control.SRR15539824;43;40;0.558139534883721;19;24;0.0581395348837209;0.441860465116279
Control.SRR15539824;36;40;0.5;18;18;0;0.5
Control.SRR15539824;33;40;0.363636363636364;21;12;0.136363636363636;0.363636363636364
Control.SRR15539824;34;40;0.441176470588235;19;15;0.0588235294117647;0.441176470588235
Control.SRR15539824;40;40;0.45;22;18;0.05;0.45
Control.SRR15539824;35;40;0.571428571428571;15;20;0.0714285714285714;0.428571428571429
Control.SRR15539824;38;40;0.605263157894737;15;23;0.105263157894737;0.394736842105263
Control.SRR15539824;38;40;0.578947368421053;16;22;0.0789473684210527;0.421052631578947
Control.SRR15539824;43;40;0.558139534883721;19;24;0.0581395348837209;0.441860465116279
Control.SRR15539824;41;40;0.585365853658537;17;24;0.0853658536585366;0.414634146341463
Control.SRR15539824;37;40;0.27027027027027;27;10;0.22972972972973;0.27027027027027
Control.SRR15539824;39;40;0.512820512820513;19;20;0.0128205128205128;0.487179487179487
Control.SRR15539824;42;40;0.642857142857143;15;27;0.142857142857143;0.357142857142857
Control.SRR15539824;35;40;0.457142857142857;19;16;0.0428571428571429;0.457142857142857
Control.SRR15539824;36;40;0.611111111111111;14;22;0.111111111111111;0.388888888888889
Control.SRR15539824;41;40;0.560975609756098;18;23;0.0609756097560976;0.439024390243902
Control.SRR15539824;39;40;0.461538461538462;21;18;0.0384615384615384;0.461538461538462
Control.SRR15539824;40;40;0.525;19;21;0.025;0.475
Control.SRR15539824;41;40;0.463414634146341;22;19;0.0365853658536585;0.463414634146341
Control.SRR15539824;35;40;0.4;21;14;0.1;0.4
Control.SRR15539824;37;40;0.594594594594595;15;22;0.0945945945945946;0.405405405405405
Control.SRR15539824;41;40;0.51219512195122;20;21;0.0121951219512195;0.48780487804878
Control.SRR15539824;43;40;0.651162790697674;15;28;0.151162790697674;0.348837209302326
Control.SRR15539824;38;40;0.447368421052632;21;17;0.0526315789473684;0.447368421052632
Control.SRR15539824;35;40;0.514285714285714;17;18;0.0142857142857142;0.485714285714286
Control.SRR15539824;33;40;0.363636363636364;21;12;0.136363636363636;0.363636363636364
Control.SRR15539824;36;40;0.555555555555556;16;20;0.0555555555555556;0.444444444444444
Control.SRR15539824;43;40;0.627906976744186;16;27;0.127906976744186;0.372093023255814
Control.SRR15539824;40;40;0.625;15;25;0.125;0.375
Control.SRR15539824;42;40;0.5;21;21;0;0.5
Control.SRR15539824;41;40;0.463414634146341;22;19;0.0365853658536585;0.463414634146341
Control.SRR15539824;41;40;0.536585365853659;19;22;0.0365853658536586;0.463414634146341
Control.SRR15539824;40;40;0.55;18;22;0.05;0.45
Control.SRR15539824;33;40;0.484848484848485;17;16;0.0151515151515151;0.484848484848485
Control.SRR15539824;37;40;0.513513513513513;18;19;0.0135135135135135;0.486486486486487
Control.SRR15539824;34;40;0.470588235294118;18;16;0.0294117647058824;0.470588235294118
Control.SRR15539824;42;40;0.619047619047619;16;26;0.119047619047619;0.380952380952381
Control.SRR15539824;41;40;0.439024390243902;23;18;0.0609756097560976;0.439024390243902
Control.SRR15539824;42;40;0.428571428571429;24;18;0.0714285714285715;0.428571428571429
Control.SRR15539824;43;40;0.511627906976744;21;22;0.0116279069767442;0.488372093023256
Control.SRR15539824;33;40;0.424242424242424;19;14;0.0757575757575757;0.424242424242424
Control.SRR15539824;33;40;0.515151515151515;16;17;0.0151515151515151;0.484848484848485
Control.SRR15539824;33;40;0.484848484848485;17;16;0.0151515151515151;0.484848484848485
Control.SRR15539824;35;40;0.514285714285714;17;18;0.0142857142857142;0.485714285714286
Control.SRR15539824;40;40;0.375;25;15;0.125;0.375
Control.SRR15539824;37;40;0.540540540540541;17;20;0.0405405405405406;0.459459459459459
Control.SRR15539824;38;40;0.473684210526316;20;18;0.0263157894736842;0.473684210526316
Control.SRR15539824;38;40;0.526315789473684;18;20;0.0263157894736842;0.473684210526316
Control.SRR15539824;36;40;0.472222222222222;19;17;0.0277777777777778;0.472222222222222
Control.SRR15539824;38;40;0.552631578947368;17;21;0.0526315789473685;0.447368421052632
Control.SRR15539824;35;40;0.485714285714286;18;17;0.0142857142857143;0.485714285714286
Control.SRR15539824;42;40;0.5;21;21;0;0.5
Control.SRR15539824;37;40;0.675675675675676;12;25;0.175675675675676;0.324324324324324
Control.SRR15539824;39;40;0.512820512820513;19;20;0.0128205128205128;0.487179487179487
Control.SRR15539824;38;40;0.526315789473684;18;20;0.0263157894736842;0.473684210526316
Control.SRR15539824;35;40;0.514285714285714;17;18;0.0142857142857142;0.485714285714286
Control.SRR15539824;41;40;0.536585365853659;19;22;0.0365853658536586;0.463414634146341
Control.SRR15539824;35;40;0.657142857142857;12;23;0.157142857142857;0.342857142857143
Control.SRR15539824;39;40;0.358974358974359;25;14;0.141025641025641;0.358974358974359
Control.SRR15539824;42;40;0.547619047619048;19;23;0.0476190476190477;0.452380952380952
Control.SRR15539824;37;40;0.513513513513513;18;19;0.0135135135135135;0.486486486486487
Control.SRR15539824;42;40;0.476190476190476;22;20;0.0238095238095238;0.476190476190476
Control.SRR15539824;40;40;0.65;14;26;0.15;0.35
Control.SRR15539824;42;40;0.571428571428571;18;24;0.0714285714285714;0.428571428571429
Control.SRR15539824;39;40;0.358974358974359;25;14;0.141025641025641;0.358974358974359
Control.SRR15539824;33;40;0.575757575757576;14;19;0.0757575757575758;0.424242424242424
Control.SRR15539824;37;40;0.513513513513513;18;19;0.0135135135135135;0.486486486486487
Control.SRR15539824;34;40;0.529411764705882;16;18;0.0294117647058824;0.470588235294118
Control.SRR15539824;35;40;0.342857142857143;23;12;0.157142857142857;0.342857142857143
Control.SRR15539824;35;40;0.428571428571429;20;15;0.0714285714285715;0.428571428571429
Control.SRR15539824;34;40;0.529411764705882;16;18;0.0294117647058824;0.470588235294118
Control.SRR15539824;40;40;0.55;18;22;0.05;0.45
Control.SRR15539824;33;40;0.545454545454545;15;18;0.0454545454545454;0.454545454545455
Control.SRR15539824;39;40;0.435897435897436;22;17;0.0641025641025641;0.435897435897436
Control.SRR15539824;34;40;0.617647058823529;13;21;0.117647058823529;0.382352941176471
Control.SRR15539824;40;40;0.425;23;17;0.075;0.425
Control.SRR15539824;33;40;0.363636363636364;21;12;0.136363636363636;0.363636363636364
Control.SRR15539824;38;40;0.5;19;19;0;0.5
Control.SRR15539824;39;40;0.538461538461538;18;21;0.0384615384615384;0.461538461538462
Control.SRR15539824;40;40;0.325;27;13;0.175;0.325
Control.SRR15539824;40;40;0.525;19;21;0.025;0.475
Control.SRR15539824;37;40;0.540540540540541;17;20;0.0405405405405406;0.459459459459459
Control.SRR15539824;34;40;0.676470588235294;11;23;0.176470588235294;0.323529411764706
Control.SRR15539824;34;40;0.529411764705882;16;18;0.0294117647058824;0.470588235294118
Control.SRR15539824;39;40;0.58974358974359;16;23;0.0897435897435898;0.41025641025641
Control.SRR15539824;35;40;0.485714285714286;18;17;0.0142857142857143;0.485714285714286
Control.SRR15539824;36;40;0.5;18;18;0;0.5
Control.SRR15539824;35;40;0.6;14;21;0.1;0.4
Control.SRR15539824;43;40;0.558139534883721;19;24;0.0581395348837209;0.441860465116279
Control.SRR15539824;33;40;0.545454545454545;15;18;0.0454545454545454;0.454545454545455
Control.SRR15539824;37;40;0.513513513513513;18;19;0.0135135135135135;0.486486486486487
Control.SRR15539824;34;40;0.676470588235294;11;23;0.176470588235294;0.323529411764706
Control.SRR15539824;42;40;0.523809523809524;20;22;0.0238095238095238;0.476190476190476
Control.SRR15539824;40;40;0.525;19;21;0.025;0.475
Control.SRR15539824;38;40;0.447368421052632;21;17;0.0526315789473684;0.447368421052632
Control.SRR15539824;33;40;0.606060606060606;13;20;0.106060606060606;0.393939393939394
Control.SRR15539824;42;40;0.523809523809524;20;22;0.0238095238095238;0.476190476190476
Control.SRR15539824;43;40;0.441860465116279;24;19;0.0581395348837209;0.441860465116279
Control.SRR15539824;42;40;0.476190476190476;22;20;0.0238095238095238;0.476190476190476
Control.SRR15539824;34;40;0.558823529411765;15;19;0.0588235294117647;0.441176470588235
Control.SRR15539824;41;40;0.48780487804878;21;20;0.0121951219512195;0.48780487804878
Control.SRR15539824;42;40;0.476190476190476;22;20;0.0238095238095238;0.476190476190476
Control.SRR15539824;42;40;0.547619047619048;19;23;0.0476190476190477;0.452380952380952
Control.SRR15539824;39;40;0.41025641025641;23;16;0.0897435897435898;0.41025641025641
Control.SRR15539824;35;40;0.485714285714286;18;17;0.0142857142857143;0.485714285714286
Control.SRR15539824;38;40;0.526315789473684;18;20;0.0263157894736842;0.473684210526316
Control.SRR15539824;41;40;0.48780487804878;21;20;0.0121951219512195;0.48780487804878
Control.SRR15539824;35;40;0.428571428571429;20;15;0.0714285714285715;0.428571428571429
Control.SRR15539824;40;40;0.525;19;21;0.025;0.475
Control.SRR15539824;38;40;0.447368421052632;21;17;0.0526315789473684;0.447368421052632
Control.SRR15539824;39;40;0.564102564102564;17;22;0.0641025641025641;0.435897435897436
Control.SRR15539824;33;40;0.545454545454545;15;18;0.0454545454545454;0.454545454545455
Control.SRR15539824;36;40;0.555555555555556;16;20;0.0555555555555556;0.444444444444444
Control.SRR15539824;40;40;0.475;21;19;0.025;0.475
Control.SRR15539824;37;40;0.567567567567568;16;21;0.0675675675675675;0.432432432432432
Control.SRR15539824;33;40;0.545454545454545;15;18;0.0454545454545454;0.454545454545455
Control.SRR15539824;41;40;0.48780487804878;21;20;0.0121951219512195;0.48780487804878
Control.SRR15539824;39;40;0.461538461538462;21;18;0.0384615384615384;0.461538461538462
Control.SRR15539824;41;40;0.463414634146341;22;19;0.0365853658536585;0.463414634146341
Control.SRR15539824;38;40;0.447368421052632;21;17;0.0526315789473684;0.447368421052632
Control.SRR15539824;42;40;0.476190476190476;22;20;0.0238095238095238;0.476190476190476
Control.SRR15539824;36;40;0.444444444444444;20;16;0.0555555555555556;0.444444444444444
Control.SRR15539824;36;40;0.444444444444444;20;16;0.0555555555555556;0.444444444444444
Control.SRR15539824;37;40;0.540540540540541;17;20;0.0405405405405406;0.459459459459459
Control.SRR15539824;41;40;0.341463414634146;27;14;0.158536585365854;0.341463414634146
Control.SRR15539824;42;40;0.5;21;21;0;0.5
Control.SRR15539824;37;40;0.567567567567568;16;21;0.0675675675675675;0.432432432432432
Control.SRR15539824;42;40;0.523809523809524;20;22;0.0238095238095238;0.476190476190476
Control.SRR15539824;38;40;0.526315789473684;18;20;0.0263157894736842;0.473684210526316
Control.SRR15539824;41;40;0.536585365853659;19;22;0.0365853658536586;0.463414634146341
Control.SRR15539824;42;40;0.428571428571429;24;18;0.0714285714285715;0.428571428571429
Control.SRR15539824;38;40;0.473684210526316;20;18;0.0263157894736842;0.473684210526316
Control.SRR15539824;37;40;0.513513513513513;18;19;0.0135135135135135;0.486486486486487
Control.SRR15539824;38;40;0.552631578947368;17;21;0.0526315789473685;0.447368421052632
Control.SRR15539824;33;40;0.393939393939394;20;13;0.106060606060606;0.393939393939394
Control.SRR15539824;33;40;0.424242424242424;19;14;0.0757575757575757;0.424242424242424
Control.SRR15539824;37;40;0.594594594594595;15;22;0.0945945945945946;0.405405405405405
Control.SRR15539824;34;40;0.617647058823529;13;21;0.117647058823529;0.382352941176471
Control.SRR15539824;38;40;0.552631578947368;17;21;0.0526315789473685;0.447368421052632
Control.SRR15539824;43;40;0.534883720930233;20;23;0.0348837209302325;0.465116279069767
Control.SRR15539824;38;40;0.447368421052632;21;17;0.0526315789473684;0.447368421052632
Control.SRR15539824;35;40;0.6;14;21;0.1;0.4
Control.SRR15539824;33;40;0.515151515151515;16;17;0.0151515151515151;0.484848484848485
Control.SRR15539824;43;40;0.581395348837209;18;25;0.0813953488372093;0.418604651162791
Control.SRR15539824;38;40;0.526315789473684;18;20;0.0263157894736842;0.473684210526316
Control.SRR15539824;40;40;0.4;24;16;0.1;0.4
Control.SRR15539824;43;40;0.697674418604651;13;30;0.197674418604651;0.302325581395349
Control.SRR15539824;39;40;0.615384615384615;15;24;0.115384615384615;0.384615384615385
Control.SRR15539824;35;40;0.542857142857143;16;19;0.0428571428571428;0.457142857142857
Control.SRR15539824;38;40;0.526315789473684;18;20;0.0263157894736842;0.473684210526316
Control.SRR15539824;39;40;0.564102564102564;17;22;0.0641025641025641;0.435897435897436
Control.SRR15539824;40;40;0.5;20;20;0;0.5
Control.SRR15539824;35;40;0.514285714285714;17;18;0.0142857142857142;0.485714285714286
Control.SRR15539824;37;40;0.459459459459459;20;17;0.0405405405405405;0.459459459459459
Control.SRR15539824;35;40;0.428571428571429;20;15;0.0714285714285715;0.428571428571429
Control.SRR15539824;37;40;0.486486486486487;19;18;0.0135135135135135;0.486486486486487
Control.SRR15539824;34;40;0.558823529411765;15;19;0.0588235294117647;0.441176470588235
Control.SRR15539824;35;40;0.571428571428571;15;20;0.0714285714285714;0.428571428571429
Control.SRR15539824;33;40;0.333333333333333;22;11;0.166666666666667;0.333333333333333
Control.SRR15539824;39;40;0.487179487179487;20;19;0.0128205128205128;0.487179487179487
Control.SRR15539824;35;40;0.6;14;21;0.1;0.4
Control.SRR15539824;36;40;0.277777777777778;26;10;0.222222222222222;0.277777777777778
Control.SRR15539824;36;40;0.472222222222222;19;17;0.0277777777777778;0.472222222222222
Control.SRR15539824;40;40;0.425;23;17;0.075;0.425
Control.SRR15539824;42;40;0.380952380952381;26;16;0.119047619047619;0.380952380952381
Control.SRR15539824;36;40;0.527777777777778;17;19;0.0277777777777778;0.472222222222222
Control.SRR15539824;37;40;0.405405405405405;22;15;0.0945945945945946;0.405405405405405
Control.SRR15539824;34;40;0.529411764705882;16;18;0.0294117647058824;0.470588235294118
Control.SRR15539824;42;40;0.357142857142857;27;15;0.142857142857143;0.357142857142857
Control.SRR15539824;38;40;0.5;19;19;0;0.5
Control.SRR15539824;36;40;0.555555555555556;16;20;0.0555555555555556;0.444444444444444
Control.SRR15539824;33;40;0.515151515151515;16;17;0.0151515151515151;0.484848484848485
Control.SRR15539824;40;40;0.55;18;22;0.05;0.45
Control.SRR15539824;40;40;0.575;17;23;0.075;0.425
Control.SRR15539824;40;40;0.6;16;24;0.1;0.4
Control.SRR15539824;36;40;0.388888888888889;22;14;0.111111111111111;0.388888888888889
Control.SRR15539824;40;40;0.475;21;19;0.025;0.475
Control.SRR15539824;37;40;0.513513513513513;18;19;0.0135135135135135;0.486486486486487
Control.SRR15539824;33;40;0.515151515151515;16;17;0.0151515151515151;0.484848484848485
Control.SRR15539824;36;40;0.5;18;18;0;0.5
Control.SRR15539824;33;40;0.515151515151515;16;17;0.0151515151515151;0.484848484848485
Control.SRR15539824;38;40;0.394736842105263;23;15;0.105263157894737;0.394736842105263
Control.SRR15539824;38;40;0.552631578947368;17;21;0.0526315789473685;0.447368421052632
Control.SRR15539824;37;40;0.405405405405405;22;15;0.0945945945945946;0.405405405405405
Control.SRR15539824;37;40;0.459459459459459;20;17;0.0405405405405405;0.459459459459459
Control.SRR15539824;43;40;0.534883720930233;20;23;0.0348837209302325;0.465116279069767
Control.SRR15539824;40;40;0.4;24;16;0.1;0.4
Control.SRR15539824;40;40;0.55;18;22;0.05;0.45
Control.SRR15539824;39;40;0.538461538461538;18;21;0.0384615384615384;0.461538461538462
Control.SRR15539824;33;40;0.545454545454545;15;18;0.0454545454545454;0.454545454545455
Control.SRR15539824;33;40;0.393939393939394;20;13;0.106060606060606;0.393939393939394
Control.SRR15539824;38;40;0.605263157894737;15;23;0.105263157894737;0.394736842105263
Control.SRR15539824;39;40;0.564102564102564;17;22;0.0641025641025641;0.435897435897436
Control.SRR15539824;41;40;0.51219512195122;20;21;0.0121951219512195;0.48780487804878
Control.SRR15539824;34;40;0.411764705882353;20;14;0.0882352941176471;0.411764705882353
Control.SRR15539824;36;40;0.444444444444444;20;16;0.0555555555555556;0.444444444444444
Control.SRR15539824;37;40;0.486486486486487;19;18;0.0135135135135135;0.486486486486487
Control.SRR15539824;33;40;0.303030303030303;23;10;0.196969696969697;0.303030303030303
Control.SRR15539824;39;40;0.487179487179487;20;19;0.0128205128205128;0.487179487179487
Control.SRR15539824;37;40;0.567567567567568;16;21;0.0675675675675675;0.432432432432432
Control.SRR15539824;43;40;0.465116279069767;23;20;0.0348837209302326;0.465116279069767
Control.SRR15539824;33;40;0.545454545454545;15;18;0.0454545454545454;0.454545454545455
Control.SRR15539824;33;40;0.575757575757576;14;19;0.0757575757575758;0.424242424242424
Control.SRR15539824;40;40;0.6;16;24;0.1;0.4
Control.SRR15539824;36;40;0.416666666666667;21;15;0.0833333333333333;0.416666666666667
Control.SRR15539824;39;40;0.564102564102564;17;22;0.0641025641025641;0.435897435897436
Control.SRR15539824;38;40;0.552631578947368;17;21;0.0526315789473685;0.447368421052632
Control.SRR15539824;34;40;0.5;17;17;0;0.5
Control.SRR15539824;39;40;0.58974358974359;16;23;0.0897435897435898;0.41025641025641
Control.SRR15539824;38;40;0.421052631578947;22;16;0.0789473684210527;0.421052631578947
Control.SRR15539824;38;40;0.5;19;19;0;0.5
Control.SRR15539824;40;40;0.375;25;15;0.125;0.375
Control.SRR15539824;43;40;0.511627906976744;21;22;0.0116279069767442;0.488372093023256
Control.SRR15539824;34;40;0.441176470588235;19;15;0.0588235294117647;0.441176470588235
Control.SRR15539824;41;40;0.341463414634146;27;14;0.158536585365854;0.341463414634146
Control.SRR15539824;33;40;0.545454545454545;15;18;0.0454545454545454;0.454545454545455
Control.SRR15539824;35;40;0.314285714285714;24;11;0.185714285714286;0.314285714285714
Control.SRR15539824;39;40;0.41025641025641;23;16;0.0897435897435898;0.41025641025641
Control.SRR15539824;33;40;0.424242424242424;19;14;0.0757575757575757;0.424242424242424
Control.SRR15539824;36;40;0.444444444444444;20;16;0.0555555555555556;0.444444444444444
Control.SRR15539824;37;40;0.567567567567568;16;21;0.0675675675675675;0.432432432432432
Control.SRR15539824;38;40;0.447368421052632;21;17;0.0526315789473684;0.447368421052632
Control.SRR15539824;38;40;0.447368421052632;21;17;0.0526315789473684;0.447368421052632
Control.SRR15539824;38;40;0.605263157894737;15;23;0.105263157894737;0.394736842105263
Control.SRR15539824;33;40;0.454545454545455;18;15;0.0454545454545455;0.454545454545455
Control.SRR15539824;40;40;0.5;20;20;0;0.5
Control.SRR15539824;42;40;0.547619047619048;19;23;0.0476190476190477;0.452380952380952
Control.SRR15539824;37;40;0.486486486486487;19;18;0.0135135135135135;0.486486486486487
Control.SRR15539824;34;40;0.411764705882353;20;14;0.0882352941176471;0.411764705882353
Control.SRR15539824;36;40;0.5;18;18;0;0.5
Control.SRR15539824;36;40;0.527777777777778;17;19;0.0277777777777778;0.472222222222222
Control.SRR15539824;37;40;0.459459459459459;20;17;0.0405405405405405;0.459459459459459
Control.SRR15539824;37;40;0.513513513513513;18;19;0.0135135135135135;0.486486486486487
Control.SRR15539824;37;40;0.486486486486487;19;18;0.0135135135135135;0.486486486486487
Control.SRR15539824;36;40;0.472222222222222;19;17;0.0277777777777778;0.472222222222222
Control.SRR15539824;33;40;0.545454545454545;15;18;0.0454545454545454;0.454545454545455
Control.SRR15539824;34;40;0.647058823529412;12;22;0.147058823529412;0.352941176470588
Control.SRR15539824;41;40;0.609756097560976;16;25;0.109756097560976;0.390243902439024
Control.SRR15539824;37;40;0.486486486486487;19;18;0.0135135135135135;0.486486486486487
Control.SRR15539824;38;40;0.342105263157895;25;13;0.157894736842105;0.342105263157895
Control.SRR15539824;42;40;0.5;21;21;0;0.5
Control.SRR15539824;35;40;0.542857142857143;16;19;0.0428571428571428;0.457142857142857
Control.SRR15539824;34;40;0.5;17;17;0;0.5
Control.SRR15539824;34;40;0.617647058823529;13;21;0.117647058823529;0.382352941176471
Control.SRR15539824;43;40;0.488372093023256;22;21;0.0116279069767442;0.488372093023256
Control.SRR15539824;39;40;0.461538461538462;21;18;0.0384615384615384;0.461538461538462
Control.SRR15539824;38;40;0.473684210526316;20;18;0.0263157894736842;0.473684210526316
Control.SRR15539824;37;40;0.702702702702703;11;26;0.202702702702703;0.297297297297297
Control.SRR15539824;33;40;0.545454545454545;15;18;0.0454545454545454;0.454545454545455
Control.SRR15539824;35;40;0.485714285714286;18;17;0.0142857142857143;0.485714285714286
Control.SRR15539824;41;40;0.439024390243902;23;18;0.0609756097560976;0.439024390243902
Control.SRR15539824;37;40;0.405405405405405;22;15;0.0945945945945946;0.405405405405405
Control.SRR15539824;33;40;0.393939393939394;20;13;0.106060606060606;0.393939393939394
Control.SRR15539824;35;40;0.514285714285714;17;18;0.0142857142857142;0.485714285714286
Control.SRR15539824;34;40;0.470588235294118;18;16;0.0294117647058824;0.470588235294118
Control.SRR15539824;33;40;0.333333333333333;22;11;0.166666666666667;0.333333333333333
Control.SRR15539824;34;40;0.382352941176471;21;13;0.117647058823529;0.382352941176471
Control.SRR15539824;37;40;0.621621621621622;14;23;0.121621621621622;0.378378378378378
Control.SRR15539824;42;40;0.5;21;21;0;0.5
Control.SRR15539824;33;40;0.545454545454545;15;18;0.0454545454545454;0.454545454545455
Control.SRR15539824;33;40;0.545454545454545;15;18;0.0454545454545454;0.454545454545455
Control.SRR15539824;43;40;0.511627906976744;21;22;0.0116279069767442;0.488372093023256
Control.SRR15539824;34;40;0.441176470588235;19;15;0.0588235294117647;0.441176470588235
Control.SRR15539824;43;40;0.558139534883721;19;24;0.0581395348837209;0.441860465116279
Control.SRR15539824;34;40;0.558823529411765;15;19;0.0588235294117647;0.441176470588235
Control.SRR15539824;37;40;0.513513513513513;18;19;0.0135135135135135;0.486486486486487
Control.SRR15539824;39;40;0.435897435897436;22;17;0.0641025641025641;0.435897435897436
Control.SRR15539824;41;40;0.48780487804878;21;20;0.0121951219512195;0.48780487804878
Control.SRR15539824;36;40;0.361111111111111;23;13;0.138888888888889;0.361111111111111
Control.SRR15539824;41;40;0.463414634146341;22;19;0.0365853658536585;0.463414634146341
Control.SRR15539824;43;40;0.348837209302326;28;15;0.151162790697674;0.348837209302326
Control.SRR15539824;41;40;0.48780487804878;21;20;0.0121951219512195;0.48780487804878
Control.SRR15539824;35;40;0.457142857142857;19;16;0.0428571428571429;0.457142857142857
Control.SRR15539824;39;40;0.41025641025641;23;16;0.0897435897435898;0.41025641025641
Control.SRR15539824;41;40;0.560975609756098;18;23;0.0609756097560976;0.439024390243902
Control.SRR15539824;41;40;0.414634146341463;24;17;0.0853658536585366;0.414634146341463
Control.SRR15539824;43;40;0.418604651162791;25;18;0.0813953488372093;0.418604651162791
Control.SRR15539824;41;40;0.390243902439024;25;16;0.109756097560976;0.390243902439024
Control.SRR15539824;42;40;0.428571428571429;24;18;0.0714285714285715;0.428571428571429
Control.SRR15539824;39;40;0.384615384615385;24;15;0.115384615384615;0.384615384615385
Control.SRR15539824;39;40;0.564102564102564;17;22;0.0641025641025641;0.435897435897436
Control.SRR15539824;40;40;0.425;23;17;0.075;0.425
Control.SRR15539824;35;40;0.714285714285714;10;25;0.214285714285714;0.285714285714286
Control.SRR15539824;41;40;0.51219512195122;20;21;0.0121951219512195;0.48780487804878
Control.SRR15539824;40;40;0.525;19;21;0.025;0.475
Control.SRR15539824;33;40;0.545454545454545;15;18;0.0454545454545454;0.454545454545455
Control.SRR15539824;41;40;0.51219512195122;20;21;0.0121951219512195;0.48780487804878
Control.SRR15539824;36;40;0.638888888888889;13;23;0.138888888888889;0.361111111111111
Control.SRR15539824;40;40;0.5;20;20;0;0.5
Control.SRR15539824;34;40;0.441176470588235;19;15;0.0588235294117647;0.441176470588235
Control.SRR15539824;35;40;0.485714285714286;18;17;0.0142857142857143;0.485714285714286
Control.SRR15539824;42;40;0.476190476190476;22;20;0.0238095238095238;0.476190476190476
Control.SRR15539824;43;40;0.604651162790698;17;26;0.104651162790698;0.395348837209302
Control.SRR15539824;40;40;0.5;20;20;0;0.5
Control.SRR15539824;42;40;0.357142857142857;27;15;0.142857142857143;0.357142857142857
Control.SRR15539824;39;40;0.666666666666667;13;26;0.166666666666667;0.333333333333333
Control.SRR15539824;43;40;0.511627906976744;21;22;0.0116279069767442;0.488372093023256
Control.SRR15539824;41;40;0.51219512195122;20;21;0.0121951219512195;0.48780487804878
Control.SRR15539824;41;40;0.609756097560976;16;25;0.109756097560976;0.390243902439024
Control.SRR15539824;39;40;0.384615384615385;24;15;0.115384615384615;0.384615384615385
Control.SRR15539824;36;40;0.611111111111111;14;22;0.111111111111111;0.388888888888889
Control.SRR15539824;41;40;0.48780487804878;21;20;0.0121951219512195;0.48780487804878
Control.SRR15539824;40;40;0.525;19;21;0.025;0.475
Control.SRR15539824;40;40;0.575;17;23;0.075;0.425
Control.SRR15539824;39;40;0.461538461538462;21;18;0.0384615384615384;0.461538461538462
Control.SRR15539824;37;40;0.621621621621622;14;23;0.121621621621622;0.378378378378378
Control.SRR15539824;40;40;0.4;24;16;0.1;0.4
Control.SRR15539824;41;40;0.731707317073171;11;30;0.231707317073171;0.268292682926829
Control.SRR15539824;34;40;0.558823529411765;15;19;0.0588235294117647;0.441176470588235
Control.SRR15539824;33;40;0.393939393939394;20;13;0.106060606060606;0.393939393939394
Control.SRR15539824;40;40;0.475;21;19;0.025;0.475
Control.SRR15539824;35;40;0.4;21;14;0.1;0.4
Control.SRR15539824;40;40;0.375;25;15;0.125;0.375
Control.SRR15539824;42;40;0.619047619047619;16;26;0.119047619047619;0.380952380952381
Control.SRR15539824;33;40;0.575757575757576;14;19;0.0757575757575758;0.424242424242424
Control.SRR15539824;38;40;0.552631578947368;17;21;0.0526315789473685;0.447368421052632
Control.SRR15539824;42;40;0.523809523809524;20;22;0.0238095238095238;0.476190476190476
Control.SRR15539824;33;40;0.454545454545455;18;15;0.0454545454545455;0.454545454545455
Control.SRR15539824;34;40;0.5;17;17;0;0.5
Control.SRR15539824;36;40;0.611111111111111;14;22;0.111111111111111;0.388888888888889
Control.SRR15539824;36;40;0.583333333333333;15;21;0.0833333333333334;0.416666666666667
Control.SRR15539824;34;40;0.617647058823529;13;21;0.117647058823529;0.382352941176471
Control.SRR15539824;34;40;0.294117647058824;24;10;0.205882352941176;0.294117647058824
Control.SRR15539824;37;40;0.432432432432432;21;16;0.0675675675675675;0.432432432432432
Control.SRR15539824;39;40;0.41025641025641;23;16;0.0897435897435898;0.41025641025641
Control.SRR15539824;42;40;0.452380952380952;23;19;0.0476190476190476;0.452380952380952
Control.SRR15539824;34;40;0.558823529411765;15;19;0.0588235294117647;0.441176470588235
Control.SRR15539824;36;40;0.472222222222222;19;17;0.0277777777777778;0.472222222222222
Control.SRR15539824;35;40;0.542857142857143;16;19;0.0428571428571428;0.457142857142857
Control.SRR15539824;41;40;0.51219512195122;20;21;0.0121951219512195;0.48780487804878
Control.SRR15539824;33;40;0.424242424242424;19;14;0.0757575757575757;0.424242424242424
Control.SRR15539824;37;40;0.486486486486487;19;18;0.0135135135135135;0.486486486486487
Control.SRR15539824;42;40;0.404761904761905;25;17;0.0952380952380952;0.404761904761905
Control.SRR15539824;38;40;0.605263157894737;15;23;0.105263157894737;0.394736842105263
Control.SRR15539824;40;40;0.475;21;19;0.025;0.475
Control.SRR15539824;40;40;0.525;19;21;0.025;0.475
Control.SRR15539824;38;40;0.578947368421053;16;22;0.0789473684210527;0.421052631578947
Control.SRR15539824;37;40;0.594594594594595;15;22;0.0945945945945946;0.405405405405405
Control.SRR15539824;40;40;0.475;21;19;0.025;0.475
Control.SRR15539824;43;40;0.441860465116279;24;19;0.0581395348837209;0.441860465116279
Control.SRR15539824;34;40;0.529411764705882;16;18;0.0294117647058824;0.470588235294118
Control.SRR15539824;34;40;0.676470588235294;11;23;0.176470588235294;0.323529411764706
Control.SRR15539824;40;40;0.475;21;19;0.025;0.475
Control.SRR15539824;37;40;0.351351351351351;24;13;0.148648648648649;0.351351351351351
Control.SRR15539824;37;40;0.324324324324324;25;12;0.175675675675676;0.324324324324324
Control.SRR15539824;40;40;0.45;22;18;0.05;0.45
Control.SRR15539824;37;40;0.405405405405405;22;15;0.0945945945945946;0.405405405405405
Control.SRR15539824;33;40;0.363636363636364;21;12;0.136363636363636;0.363636363636364
Control.SRR15539824;40;40;0.55;18;22;0.05;0.45
Control.SRR15539824;40;40;0.575;17;23;0.075;0.425
Control.SRR15539824;35;40;0.542857142857143;16;19;0.0428571428571428;0.457142857142857
Control.SRR15539824;39;40;0.512820512820513;19;20;0.0128205128205128;0.487179487179487
Control.SRR15539824;33;40;0.484848484848485;17;16;0.0151515151515151;0.484848484848485
Control.SRR15539824;40;40;0.45;22;18;0.05;0.45
Control.SRR15539824;38;40;0.5;19;19;0;0.5
Control.SRR15539824;35;40;0.571428571428571;15;20;0.0714285714285714;0.428571428571429
Control.SRR15539824;39;40;0.487179487179487;20;19;0.0128205128205128;0.487179487179487
Control.SRR15539824;38;40;0.552631578947368;17;21;0.0526315789473685;0.447368421052632
Control.SRR15539824;37;40;0.567567567567568;16;21;0.0675675675675675;0.432432432432432
Control.SRR15539824;40;40;0.475;21;19;0.025;0.475
Control.SRR15539824;42;40;0.523809523809524;20;22;0.0238095238095238;0.476190476190476
Control.SRR15539824;33;40;0.545454545454545;15;18;0.0454545454545454;0.454545454545455
Control.SRR15539824;38;40;0.605263157894737;15;23;0.105263157894737;0.394736842105263
Control.SRR15539824;42;40;0.476190476190476;22;20;0.0238095238095238;0.476190476190476
Control.SRR15539824;37;40;0.459459459459459;20;17;0.0405405405405405;0.459459459459459
Control.SRR15539824;40;40;0.475;21;19;0.025;0.475
Control.SRR15539824;40;40;0.475;21;19;0.025;0.475
Control.SRR15539824;42;40;0.404761904761905;25;17;0.0952380952380952;0.404761904761905
Control.SRR15539824;34;40;0.5;17;17;0;0.5
Control.SRR15539824;36;40;0.472222222222222;19;17;0.0277777777777778;0.472222222222222
Control.SRR15539824;37;40;0.459459459459459;20;17;0.0405405405405405;0.459459459459459
Control.SRR15539824;38;40;0.5;19;19;0;0.5
Control.SRR15539824;39;40;0.564102564102564;17;22;0.0641025641025641;0.435897435897436
Control.SRR15539824;36;40;0.611111111111111;14;22;0.111111111111111;0.388888888888889
Control.SRR15539824;38;40;0.526315789473684;18;20;0.0263157894736842;0.473684210526316
Control.SRR15539824;38;40;0.394736842105263;23;15;0.105263157894737;0.394736842105263
Control.SRR15539824;34;40;0.617647058823529;13;21;0.117647058823529;0.382352941176471
Control.SRR15539824;42;40;0.452380952380952;23;19;0.0476190476190476;0.452380952380952
Control.SRR15539824;34;40;0.470588235294118;18;16;0.0294117647058824;0.470588235294118
Control.SRR15539824;35;40;0.4;21;14;0.1;0.4
Control.SRR15539824;38;40;0.526315789473684;18;20;0.0263157894736842;0.473684210526316
Control.SRR15539824;33;40;0.484848484848485;17;16;0.0151515151515151;0.484848484848485
Control.SRR15539824;34;40;0.588235294117647;14;20;0.0882352941176471;0.411764705882353
Control.SRR15539824;38;40;0.526315789473684;18;20;0.0263157894736842;0.473684210526316
Control.SRR15539824;37;40;0.675675675675676;12;25;0.175675675675676;0.324324324324324
Control.SRR15539824;34;40;0.558823529411765;15;19;0.0588235294117647;0.441176470588235
Control.SRR15539824;40;40;0.4;24;16;0.1;0.4
Control.SRR15539824;39;40;0.512820512820513;19;20;0.0128205128205128;0.487179487179487
Control.SRR15539824;43;40;0.488372093023256;22;21;0.0116279069767442;0.488372093023256
Control.SRR15539824;42;40;0.452380952380952;23;19;0.0476190476190476;0.452380952380952
Control.SRR15539824;42;40;0.476190476190476;22;20;0.0238095238095238;0.476190476190476
Control.SRR15539824;36;40;0.555555555555556;16;20;0.0555555555555556;0.444444444444444
Control.SRR15539824;42;40;0.476190476190476;22;20;0.0238095238095238;0.476190476190476
Control.SRR15539824;35;40;0.571428571428571;15;20;0.0714285714285714;0.428571428571429
Control.SRR15539824;34;40;0.5;17;17;0;0.5
Control.SRR15539824;36;40;0.555555555555556;16;20;0.0555555555555556;0.444444444444444
Control.SRR15539824;36;40;0.472222222222222;19;17;0.0277777777777778;0.472222222222222
Control.SRR15539824;37;40;0.621621621621622;14;23;0.121621621621622;0.378378378378378
Control.SRR15539824;35;40;0.428571428571429;20;15;0.0714285714285715;0.428571428571429
Control.SRR15539824;36;40;0.388888888888889;22;14;0.111111111111111;0.388888888888889
Control.SRR15539824;39;40;0.435897435897436;22;17;0.0641025641025641;0.435897435897436
Control.SRR15539824;41;40;0.439024390243902;23;18;0.0609756097560976;0.439024390243902
Control.SRR15539824;38;40;0.473684210526316;20;18;0.0263157894736842;0.473684210526316
Control.SRR15539824;41;40;0.414634146341463;24;17;0.0853658536585366;0.414634146341463
Control.SRR15539824;36;40;0.333333333333333;24;12;0.166666666666667;0.333333333333333
Control.SRR15539824;40;40;0.525;19;21;0.025;0.475
Control.SRR15539824;37;40;0.540540540540541;17;20;0.0405405405405406;0.459459459459459
Control.SRR15539824;35;40;0.428571428571429;20;15;0.0714285714285715;0.428571428571429
Control.SRR15539824;38;40;0.342105263157895;25;13;0.157894736842105;0.342105263157895
Control.SRR15539824;36;40;0.416666666666667;21;15;0.0833333333333333;0.416666666666667
Control.SRR15539824;38;40;0.421052631578947;22;16;0.0789473684210527;0.421052631578947
Control.SRR15539824;36;40;0.416666666666667;21;15;0.0833333333333333;0.416666666666667
Control.SRR15539824;38;40;0.526315789473684;18;20;0.0263157894736842;0.473684210526316
Control.SRR15539824;33;40;0.515151515151515;16;17;0.0151515151515151;0.484848484848485
Control.SRR15539824;43;40;0.302325581395349;30;13;0.197674418604651;0.302325581395349
Control.SRR15539824;39;40;0.666666666666667;13;26;0.166666666666667;0.333333333333333
Control.SRR15539824;36;40;0.527777777777778;17;19;0.0277777777777778;0.472222222222222
Control.SRR15539824;36;40;0.527777777777778;17;19;0.0277777777777778;0.472222222222222
Control.SRR15539824;38;40;0.421052631578947;22;16;0.0789473684210527;0.421052631578947
Control.SRR15539824;39;40;0.512820512820513;19;20;0.0128205128205128;0.487179487179487
Control.SRR15539824;36;40;0.5;18;18;0;0.5
Control.SRR15539824;41;40;0.585365853658537;17;24;0.0853658536585366;0.414634146341463
Control.SRR15539824;37;40;0.486486486486487;19;18;0.0135135135135135;0.486486486486487
Control.SRR15539824;39;40;0.461538461538462;21;18;0.0384615384615384;0.461538461538462
Control.SRR15539824;33;40;0.515151515151515;16;17;0.0151515151515151;0.484848484848485
Control.SRR15539824;35;40;0.542857142857143;16;19;0.0428571428571428;0.457142857142857
Control.SRR15539824;35;40;0.457142857142857;19;16;0.0428571428571429;0.457142857142857
Control.SRR15539824;36;40;0.472222222222222;19;17;0.0277777777777778;0.472222222222222
Control.SRR15539824;40;40;0.45;22;18;0.05;0.45
Control.SRR15539824;35;40;0.6;14;21;0.1;0.4
Control.SRR15539824;42;40;0.523809523809524;20;22;0.0238095238095238;0.476190476190476
Control.SRR15539824;33;40;0.515151515151515;16;17;0.0151515151515151;0.484848484848485
Control.SRR15539824;34;40;0.470588235294118;18;16;0.0294117647058824;0.470588235294118
Control.SRR15539824;37;40;0.378378378378378;23;14;0.121621621621622;0.378378378378378
Control.SRR15539824;35;40;0.457142857142857;19;16;0.0428571428571429;0.457142857142857
Control.SRR15539824;34;40;0.470588235294118;18;16;0.0294117647058824;0.470588235294118
Control.SRR15539824;37;40;0.351351351351351;24;13;0.148648648648649;0.351351351351351
Control.SRR15539824;36;40;0.527777777777778;17;19;0.0277777777777778;0.472222222222222
Control.SRR15539824;42;40;0.476190476190476;22;20;0.0238095238095238;0.476190476190476
Control.SRR15539824;33;40;0.484848484848485;17;16;0.0151515151515151;0.484848484848485
Control.SRR15539824;36;40;0.472222222222222;19;17;0.0277777777777778;0.472222222222222
Control.SRR15539824;34;40;0.529411764705882;16;18;0.0294117647058824;0.470588235294118
Control.SRR15539824;41;40;0.634146341463415;15;26;0.134146341463415;0.365853658536585
Control.SRR15539824;34;40;0.382352941176471;21;13;0.117647058823529;0.382352941176471
Control.SRR15539824;35;40;0.485714285714286;18;17;0.0142857142857143;0.485714285714286
Control.SRR15539824;39;40;0.41025641025641;23;16;0.0897435897435898;0.41025641025641
Control.SRR15539824;40;40;0.525;19;21;0.025;0.475
Control.SRR15539824;39;40;0.564102564102564;17;22;0.0641025641025641;0.435897435897436
Control.SRR15539824;34;40;0.558823529411765;15;19;0.0588235294117647;0.441176470588235
Control.SRR15539824;38;40;0.552631578947368;17;21;0.0526315789473685;0.447368421052632
Control.SRR15539824;42;40;0.642857142857143;15;27;0.142857142857143;0.357142857142857
Control.SRR15539824;40;40;0.625;15;25;0.125;0.375
Control.SRR15539824;33;40;0.454545454545455;18;15;0.0454545454545455;0.454545454545455
Control.SRR15539824;43;40;0.465116279069767;23;20;0.0348837209302326;0.465116279069767
Control.SRR15539824;41;40;0.48780487804878;21;20;0.0121951219512195;0.48780487804878
Control.SRR15539824;37;40;0.405405405405405;22;15;0.0945945945945946;0.405405405405405
Control.SRR15539824;39;40;0.487179487179487;20;19;0.0128205128205128;0.487179487179487
Control.SRR15539824;35;40;0.514285714285714;17;18;0.0142857142857142;0.485714285714286
Control.SRR15539824;35;40;0.571428571428571;15;20;0.0714285714285714;0.428571428571429
Control.SRR15539824;41;40;0.463414634146341;22;19;0.0365853658536585;0.463414634146341
Control.SRR15539824;37;40;0.405405405405405;22;15;0.0945945945945946;0.405405405405405
Control.SRR15539824;38;40;0.657894736842105;13;25;0.157894736842105;0.342105263157895
Control.SRR15539824;34;40;0.558823529411765;15;19;0.0588235294117647;0.441176470588235
Control.SRR15539824;38;40;0.421052631578947;22;16;0.0789473684210527;0.421052631578947
Control.SRR15539824;38;40;0.5;19;19;0;0.5
Control.SRR15539824;41;40;0.682926829268293;13;28;0.182926829268293;0.317073170731707
Control.SRR15539824;33;40;0.393939393939394;20;13;0.106060606060606;0.393939393939394
Control.SRR15539824;36;40;0.5;18;18;0;0.5
Control.SRR15539824;35;40;0.542857142857143;16;19;0.0428571428571428;0.457142857142857
Control.SRR15539824;42;40;0.5;21;21;0;0.5
Control.SRR15539824;41;40;0.609756097560976;16;25;0.109756097560976;0.390243902439024
Control.SRR15539824;41;40;0.51219512195122;20;21;0.0121951219512195;0.48780487804878
Control.SRR15539824;35;40;0.514285714285714;17;18;0.0142857142857142;0.485714285714286
Control.SRR15539824;36;40;0.527777777777778;17;19;0.0277777777777778;0.472222222222222
Control.SRR15539824;42;40;0.642857142857143;15;27;0.142857142857143;0.357142857142857
Control.SRR15539824;43;40;0.395348837209302;26;17;0.104651162790698;0.395348837209302
Control.SRR15539824;36;40;0.555555555555556;16;20;0.0555555555555556;0.444444444444444
Control.SRR15539824;40;40;0.375;25;15;0.125;0.375
Control.SRR15539824;36;40;0.444444444444444;20;16;0.0555555555555556;0.444444444444444
Control.SRR15539824;42;40;0.476190476190476;22;20;0.0238095238095238;0.476190476190476
Control.SRR15539824;41;40;0.48780487804878;21;20;0.0121951219512195;0.48780487804878
Control.SRR15539824;37;40;0.405405405405405;22;15;0.0945945945945946;0.405405405405405
Control.SRR15539824;43;40;0.395348837209302;26;17;0.104651162790698;0.395348837209302
Control.SRR15539824;33;40;0.424242424242424;19;14;0.0757575757575757;0.424242424242424
Control.SRR15539824;34;40;0.529411764705882;16;18;0.0294117647058824;0.470588235294118
Control.SRR15539824;38;40;0.5;19;19;0;0.5
Control.SRR15539824;37;40;0.351351351351351;24;13;0.148648648648649;0.351351351351351
Control.SRR15539824;41;40;0.536585365853659;19;22;0.0365853658536586;0.463414634146341
Control.SRR15539824;33;40;0.454545454545455;18;15;0.0454545454545455;0.454545454545455
Control.SRR15539824;36;40;0.333333333333333;24;12;0.166666666666667;0.333333333333333
Control.SRR15539824;34;40;0.411764705882353;20;14;0.0882352941176471;0.411764705882353
Control.SRR15539824;40;40;0.45;22;18;0.05;0.45
Control.SRR15539824;36;40;0.611111111111111;14;22;0.111111111111111;0.388888888888889
Control.SRR15539824;39;40;0.666666666666667;13;26;0.166666666666667;0.333333333333333
Control.SRR15539824;37;40;0.513513513513513;18;19;0.0135135135135135;0.486486486486487
Control.SRR15539824;38;40;0.447368421052632;21;17;0.0526315789473684;0.447368421052632
Control.SRR15539824;35;40;0.342857142857143;23;12;0.157142857142857;0.342857142857143
Control.SRR15539824;41;40;0.536585365853659;19;22;0.0365853658536586;0.463414634146341
Control.SRR15539824;33;40;0.272727272727273;24;9;0.227272727272727;0.272727272727273
Control.SRR15539824;35;40;0.542857142857143;16;19;0.0428571428571428;0.457142857142857
Control.SRR15539824;38;40;0.368421052631579;24;14;0.131578947368421;0.368421052631579
Control.SRR15539824;39;40;0.461538461538462;21;18;0.0384615384615384;0.461538461538462
Control.SRR15539824;38;40;0.526315789473684;18;20;0.0263157894736842;0.473684210526316
Control.SRR15539824;34;40;0.558823529411765;15;19;0.0588235294117647;0.441176470588235
Control.SRR15539824;35;40;0.514285714285714;17;18;0.0142857142857142;0.485714285714286
Control.SRR15539824;40;40;0.475;21;19;0.025;0.475
Control.SRR15539824;35;40;0.457142857142857;19;16;0.0428571428571429;0.457142857142857
Control.SRR15539824;37;40;0.513513513513513;18;19;0.0135135135135135;0.486486486486487
Control.SRR15539824;33;40;0.424242424242424;19;14;0.0757575757575757;0.424242424242424
Control.SRR15539824;40;40;0.5;20;20;0;0.5
Control.SRR15539824;39;40;0.538461538461538;18;21;0.0384615384615384;0.461538461538462
Control.SRR15539824;39;40;0.512820512820513;19;20;0.0128205128205128;0.487179487179487
Control.SRR15539824;33;40;0.545454545454545;15;18;0.0454545454545454;0.454545454545455
Control.SRR15539824;35;40;0.514285714285714;17;18;0.0142857142857142;0.485714285714286
Control.SRR15539824;40;40;0.5;20;20;0;0.5
Control.SRR15539824;35;40;0.457142857142857;19;16;0.0428571428571429;0.457142857142857
Control.SRR15539824;35;40;0.657142857142857;12;23;0.157142857142857;0.342857142857143
Control.SRR15539824;42;40;0.428571428571429;24;18;0.0714285714285715;0.428571428571429
Control.SRR15539824;36;40;0.416666666666667;21;15;0.0833333333333333;0.416666666666667
Control.SRR15539824;40;40;0.6;16;24;0.1;0.4
Control.SRR15539824;37;40;0.351351351351351;24;13;0.148648648648649;0.351351351351351
Control.SRR15539824;37;40;0.378378378378378;23;14;0.121621621621622;0.378378378378378
Control.SRR15539824;40;40;0.525;19;21;0.025;0.475
Control.SRR15539824;39;40;0.512820512820513;19;20;0.0128205128205128;0.487179487179487
Control.SRR15539824;34;40;0.382352941176471;21;13;0.117647058823529;0.382352941176471
Control.SRR15539824;33;40;0.545454545454545;15;18;0.0454545454545454;0.454545454545455
Control.SRR15539824;33;40;0.575757575757576;14;19;0.0757575757575758;0.424242424242424
Control.SRR15539824;43;40;0.534883720930233;20;23;0.0348837209302325;0.465116279069767
Control.SRR15539824;40;40;0.575;17;23;0.075;0.425
Control.SRR15539824;35;40;0.514285714285714;17;18;0.0142857142857142;0.485714285714286
Control.SRR15539824;33;40;0.484848484848485;17;16;0.0151515151515151;0.484848484848485
Control.SRR15539824;38;40;0.473684210526316;20;18;0.0263157894736842;0.473684210526316
Control.SRR15539824;37;40;0.621621621621622;14;23;0.121621621621622;0.378378378378378
Control.SRR15539824;36;40;0.472222222222222;19;17;0.0277777777777778;0.472222222222222
Control.SRR15539824;37;40;0.432432432432432;21;16;0.0675675675675675;0.432432432432432
Control.SRR15539824;35;40;0.6;14;21;0.1;0.4
Control.SRR15539824;33;40;0.424242424242424;19;14;0.0757575757575757;0.424242424242424
Control.SRR15539824;38;40;0.394736842105263;23;15;0.105263157894737;0.394736842105263
Control.SRR15539824;34;40;0.5;17;17;0;0.5
Control.SRR15539824;34;40;0.558823529411765;15;19;0.0588235294117647;0.441176470588235
Control.SRR15539824;38;40;0.342105263157895;25;13;0.157894736842105;0.342105263157895
Control.SRR15539824;42;40;0.404761904761905;25;17;0.0952380952380952;0.404761904761905
Control.SRR15539824;38;40;0.526315789473684;18;20;0.0263157894736842;0.473684210526316
Control.SRR15539824;38;40;0.631578947368421;14;24;0.131578947368421;0.368421052631579
Control.SRR15539824;43;40;0.465116279069767;23;20;0.0348837209302326;0.465116279069767
Control.SRR15539824;38;40;0.447368421052632;21;17;0.0526315789473684;0.447368421052632
Control.SRR15539824;40;40;0.7;12;28;0.2;0.3
Control.SRR15539824;34;40;0.529411764705882;16;18;0.0294117647058824;0.470588235294118
Control.SRR15539824;39;40;0.512820512820513;19;20;0.0128205128205128;0.487179487179487
Control.SRR15539824;38;40;0.5;19;19;0;0.5
