Sample;coverage;median_coverage;ALTF;RDR;RDA;Complexity;MAF
Control.ERR205724;55;59;0.509090909090909;27;28;0.00909090909090904;0.490909090909091
Control.ERR205724;52;59;0.5;26;26;0;0.5
Control.ERR205724;52;59;0.596153846153846;21;31;0.0961538461538461;0.403846153846154
Control.ERR205724;61;59;0.590163934426229;25;36;0.0901639344262295;0.409836065573771
Control.ERR205724;50;59;0.48;26;24;0.02;0.48
Control.ERR205724;51;59;0.431372549019608;29;22;0.0686274509803921;0.431372549019608
Control.ERR205724;53;59;0.415094339622642;31;22;0.0849056603773585;0.415094339622642
Control.ERR205724;53;59;0.584905660377358;22;31;0.0849056603773585;0.415094339622642
Control.ERR205724;57;59;0.43859649122807;32;25;0.0614035087719298;0.43859649122807
Control.ERR205724;66;59;0.439393939393939;37;29;0.0606060606060606;0.439393939393939
Control.ERR205724;57;59;0.596491228070175;23;34;0.0964912280701754;0.403508771929825
Control.ERR205724;52;59;0.442307692307692;29;23;0.0576923076923077;0.442307692307692
Control.ERR205724;62;59;0.564516129032258;27;35;0.0645161290322581;0.435483870967742
Control.ERR205724;53;59;0.39622641509434;32;21;0.10377358490566;0.39622641509434
Control.ERR205724;50;59;0.54;23;27;0.04;0.46
Control.ERR205724;64;59;0.53125;30;34;0.03125;0.46875
Control.ERR205724;58;59;0.431034482758621;33;25;0.0689655172413793;0.431034482758621
Control.ERR205724;56;59;0.446428571428571;31;25;0.0535714285714285;0.446428571428571
Control.ERR205724;51;59;0.607843137254902;20;31;0.107843137254902;0.392156862745098
Control.ERR205724;62;59;0.516129032258065;30;32;0.0161290322580645;0.483870967741935
Control.ERR205724;61;59;0.491803278688525;31;30;0.00819672131147542;0.491803278688525
Control.ERR205724;59;59;0.491525423728814;30;29;0.00847457627118642;0.491525423728814
Control.ERR205724;60;59;0.4;36;24;0.1;0.4
Control.ERR205724;54;59;0.555555555555556;24;30;0.0555555555555556;0.444444444444444
Control.ERR205724;52;59;0.557692307692308;23;29;0.0576923076923077;0.442307692307692
Control.ERR205724;53;59;0.471698113207547;28;25;0.0283018867924528;0.471698113207547
Control.ERR205724;51;59;0.470588235294118;27;24;0.0294117647058824;0.470588235294118
Control.ERR205724;50;59;0.52;24;26;0.02;0.48
Control.ERR205724;54;59;0.5;27;27;0;0.5
Control.ERR205724;53;59;0.566037735849057;23;30;0.0660377358490566;0.433962264150943
Control.ERR205724;61;59;0.459016393442623;33;28;0.040983606557377;0.459016393442623
Control.ERR205724;54;59;0.611111111111111;21;33;0.111111111111111;0.388888888888889
Control.ERR205724;55;59;0.545454545454545;25;30;0.0454545454545454;0.454545454545455
Control.ERR205724;58;59;0.517241379310345;28;30;0.0172413793103449;0.482758620689655
Control.ERR205724;57;59;0.43859649122807;32;25;0.0614035087719298;0.43859649122807
Control.ERR205724;57;59;0.578947368421053;24;33;0.0789473684210527;0.421052631578947
Control.ERR205724;66;59;0.621212121212121;25;41;0.121212121212121;0.378787878787879
Control.ERR205724;55;59;0.527272727272727;26;29;0.0272727272727272;0.472727272727273
Control.ERR205724;61;59;0.491803278688525;31;30;0.00819672131147542;0.491803278688525
Control.ERR205724;58;59;0.53448275862069;27;31;0.0344827586206896;0.46551724137931
Control.ERR205724;51;59;0.549019607843137;23;28;0.0490196078431373;0.450980392156863
Control.ERR205724;60;59;0.483333333333333;31;29;0.0166666666666667;0.483333333333333
Control.ERR205724;50;59;0.56;22;28;0.0600000000000001;0.44
Control.ERR205724;54;59;0.537037037037037;25;29;0.0370370370370371;0.462962962962963
Control.ERR205724;51;59;0.509803921568627;25;26;0.00980392156862742;0.490196078431373
Control.ERR205724;50;59;0.46;27;23;0.04;0.46
Control.ERR205724;55;59;0.581818181818182;23;32;0.0818181818181818;0.418181818181818
Control.ERR205724;58;59;0.344827586206897;38;20;0.155172413793103;0.344827586206897
Control.ERR205724;52;59;0.653846153846154;18;34;0.153846153846154;0.346153846153846
Control.ERR205724;62;59;0.548387096774194;28;34;0.0483870967741935;0.451612903225806
Control.ERR205724;58;59;0.46551724137931;31;27;0.0344827586206897;0.46551724137931
Control.ERR205724;56;59;0.5;28;28;0;0.5
Control.ERR205724;54;59;0.481481481481481;28;26;0.0185185185185185;0.481481481481481
Control.ERR205724;54;59;0.444444444444444;30;24;0.0555555555555556;0.444444444444444
Control.ERR205724;64;59;0.578125;27;37;0.078125;0.421875
Control.ERR205724;56;59;0.464285714285714;30;26;0.0357142857142857;0.464285714285714
Control.ERR205724;54;59;0.537037037037037;25;29;0.0370370370370371;0.462962962962963
Control.ERR205724;51;59;0.411764705882353;30;21;0.0882352941176471;0.411764705882353
Control.ERR205724;55;59;0.545454545454545;25;30;0.0454545454545454;0.454545454545455
Control.ERR205724;53;59;0.528301886792453;25;28;0.0283018867924528;0.471698113207547
Control.ERR205724;61;59;0.475409836065574;32;29;0.0245901639344263;0.475409836065574
Control.ERR205724;50;59;0.5;25;25;0;0.5
Control.ERR205724;62;59;0.483870967741935;32;30;0.0161290322580645;0.483870967741935
Control.ERR205724;58;59;0.413793103448276;34;24;0.0862068965517241;0.413793103448276
Control.ERR205724;58;59;0.431034482758621;33;25;0.0689655172413793;0.431034482758621
Control.ERR205724;55;59;0.418181818181818;32;23;0.0818181818181818;0.418181818181818
Control.ERR205724;55;59;0.490909090909091;28;27;0.00909090909090909;0.490909090909091
Control.ERR205724;54;59;0.388888888888889;33;21;0.111111111111111;0.388888888888889
Control.ERR205724;61;59;0.508196721311475;30;31;0.00819672131147542;0.491803278688525
Control.ERR205724;63;59;0.634920634920635;23;40;0.134920634920635;0.365079365079365
Control.ERR205724;64;59;0.484375;33;31;0.015625;0.484375
Control.ERR205724;60;59;0.516666666666667;29;31;0.0166666666666667;0.483333333333333
Control.ERR205724;52;59;0.596153846153846;21;31;0.0961538461538461;0.403846153846154
Control.ERR205724;64;59;0.546875;29;35;0.046875;0.453125
Control.ERR205724;63;59;0.444444444444444;35;28;0.0555555555555556;0.444444444444444
Control.ERR205724;60;59;0.566666666666667;26;34;0.0666666666666667;0.433333333333333
Control.ERR205724;53;59;0.415094339622642;31;22;0.0849056603773585;0.415094339622642
Control.ERR205724;55;59;0.545454545454545;25;30;0.0454545454545454;0.454545454545455
Control.ERR205724;54;59;0.5;27;27;0;0.5
Control.ERR205724;55;59;0.509090909090909;27;28;0.00909090909090904;0.490909090909091
Control.ERR205724;54;59;0.592592592592593;22;32;0.0925925925925926;0.407407407407407
Control.ERR205724;57;59;0.526315789473684;27;30;0.0263157894736842;0.473684210526316
Control.ERR205724;57;59;0.508771929824561;28;29;0.00877192982456143;0.491228070175439
Control.ERR205724;52;59;0.5;26;26;0;0.5
Control.ERR205724;55;59;0.672727272727273;18;37;0.172727272727273;0.327272727272727
Control.ERR205724;57;59;0.526315789473684;27;30;0.0263157894736842;0.473684210526316
Control.ERR205724;60;59;0.466666666666667;32;28;0.0333333333333333;0.466666666666667
Control.ERR205724;62;59;0.467741935483871;33;29;0.0322580645161291;0.467741935483871
Control.ERR205724;51;59;0.490196078431373;26;25;0.00980392156862747;0.490196078431373
Control.ERR205724;54;59;0.574074074074074;23;31;0.0740740740740741;0.425925925925926
Control.ERR205724;63;59;0.444444444444444;35;28;0.0555555555555556;0.444444444444444
Control.ERR205724;60;59;0.45;33;27;0.05;0.45
Control.ERR205724;56;59;0.464285714285714;30;26;0.0357142857142857;0.464285714285714
Control.ERR205724;53;59;0.415094339622642;31;22;0.0849056603773585;0.415094339622642
Control.ERR205724;61;59;0.557377049180328;27;34;0.0573770491803278;0.442622950819672
Control.ERR205724;65;59;0.461538461538462;35;30;0.0384615384615384;0.461538461538462
Control.ERR205724;61;59;0.508196721311475;30;31;0.00819672131147542;0.491803278688525
Control.ERR205724;52;59;0.423076923076923;30;22;0.0769230769230769;0.423076923076923
Control.ERR205724;66;59;0.439393939393939;37;29;0.0606060606060606;0.439393939393939
Control.ERR205724;56;59;0.392857142857143;34;22;0.107142857142857;0.392857142857143
Control.ERR205724;65;59;0.523076923076923;31;34;0.0230769230769231;0.476923076923077
Control.ERR205724;56;59;0.482142857142857;29;27;0.0178571428571428;0.482142857142857
Control.ERR205724;56;59;0.571428571428571;24;32;0.0714285714285714;0.428571428571429
Control.ERR205724;61;59;0.442622950819672;34;27;0.0573770491803279;0.442622950819672
Control.ERR205724;62;59;0.564516129032258;27;35;0.0645161290322581;0.435483870967742
Control.ERR205724;54;59;0.5;27;27;0;0.5
Control.ERR205724;55;59;0.490909090909091;28;27;0.00909090909090909;0.490909090909091
Control.ERR205724;56;59;0.625;21;35;0.125;0.375
Control.ERR205724;66;59;0.621212121212121;25;41;0.121212121212121;0.378787878787879
Control.ERR205724;50;59;0.5;25;25;0;0.5
Control.ERR205724;61;59;0.491803278688525;31;30;0.00819672131147542;0.491803278688525
Control.ERR205724;66;59;0.560606060606061;29;37;0.0606060606060606;0.439393939393939
Control.ERR205724;57;59;0.543859649122807;26;31;0.043859649122807;0.456140350877193
Control.ERR205724;62;59;0.387096774193548;38;24;0.112903225806452;0.387096774193548
Control.ERR205724;54;59;0.351851851851852;35;19;0.148148148148148;0.351851851851852
Control.ERR205724;57;59;0.56140350877193;25;32;0.0614035087719298;0.43859649122807
Control.ERR205724;60;59;0.5;30;30;0;0.5
Control.ERR205724;52;59;0.384615384615385;32;20;0.115384615384615;0.384615384615385
Control.ERR205724;51;59;0.529411764705882;24;27;0.0294117647058824;0.470588235294118
Control.ERR205724;61;59;0.557377049180328;27;34;0.0573770491803278;0.442622950819672
Control.ERR205724;56;59;0.428571428571429;32;24;0.0714285714285715;0.428571428571429
Control.ERR205724;63;59;0.666666666666667;21;42;0.166666666666667;0.333333333333333
Control.ERR205724;55;59;0.581818181818182;23;32;0.0818181818181818;0.418181818181818
Control.ERR205724;64;59;0.484375;33;31;0.015625;0.484375
Control.ERR205724;60;59;0.566666666666667;26;34;0.0666666666666667;0.433333333333333
Control.ERR205724;58;59;0.586206896551724;24;34;0.0862068965517241;0.413793103448276
Control.ERR205724;58;59;0.5;29;29;0;0.5
Control.ERR205724;58;59;0.448275862068966;32;26;0.0517241379310345;0.448275862068966
Control.ERR205724;66;59;0.454545454545455;36;30;0.0454545454545455;0.454545454545455
Control.ERR205724;64;59;0.421875;37;27;0.078125;0.421875
Control.ERR205724;65;59;0.584615384615385;27;38;0.0846153846153846;0.415384615384615
Control.ERR205724;62;59;0.483870967741935;32;30;0.0161290322580645;0.483870967741935
Control.ERR205724;59;59;0.542372881355932;27;32;0.0423728813559322;0.457627118644068
Control.ERR205724;58;59;0.482758620689655;30;28;0.0172413793103448;0.482758620689655
Control.ERR205724;55;59;0.472727272727273;29;26;0.0272727272727273;0.472727272727273
Control.ERR205724;55;59;0.436363636363636;31;24;0.0636363636363637;0.436363636363636
Control.ERR205724;53;59;0.471698113207547;28;25;0.0283018867924528;0.471698113207547
Control.ERR205724;50;59;0.54;23;27;0.04;0.46
Control.ERR205724;65;59;0.523076923076923;31;34;0.0230769230769231;0.476923076923077
Control.ERR205724;57;59;0.456140350877193;31;26;0.043859649122807;0.456140350877193
Control.ERR205724;57;59;0.421052631578947;33;24;0.0789473684210527;0.421052631578947
Control.ERR205724;56;59;0.571428571428571;24;32;0.0714285714285714;0.428571428571429
Control.ERR205724;54;59;0.537037037037037;25;29;0.0370370370370371;0.462962962962963
Control.ERR205724;52;59;0.596153846153846;21;31;0.0961538461538461;0.403846153846154
Control.ERR205724;59;59;0.457627118644068;32;27;0.0423728813559322;0.457627118644068
Control.ERR205724;60;59;0.55;27;33;0.05;0.45
Control.ERR205724;52;59;0.384615384615385;32;20;0.115384615384615;0.384615384615385
Control.ERR205724;66;59;0.560606060606061;29;37;0.0606060606060606;0.439393939393939
Control.ERR205724;53;59;0.452830188679245;29;24;0.0471698113207547;0.452830188679245
Control.ERR205724;60;59;0.666666666666667;20;40;0.166666666666667;0.333333333333333
Control.ERR205724;60;59;0.516666666666667;29;31;0.0166666666666667;0.483333333333333
Control.ERR205724;52;59;0.384615384615385;32;20;0.115384615384615;0.384615384615385
Control.ERR205724;59;59;0.457627118644068;32;27;0.0423728813559322;0.457627118644068
Control.ERR205724;53;59;0.547169811320755;24;29;0.0471698113207547;0.452830188679245
Control.ERR205724;63;59;0.523809523809524;30;33;0.0238095238095238;0.476190476190476
Control.ERR205724;61;59;0.426229508196721;35;26;0.0737704918032787;0.426229508196721
Control.ERR205724;53;59;0.471698113207547;28;25;0.0283018867924528;0.471698113207547
Control.ERR205724;61;59;0.524590163934426;29;32;0.0245901639344263;0.475409836065574
Control.ERR205724;62;59;0.532258064516129;29;33;0.032258064516129;0.467741935483871
Control.ERR205724;63;59;0.444444444444444;35;28;0.0555555555555556;0.444444444444444
Control.ERR205724;63;59;0.523809523809524;30;33;0.0238095238095238;0.476190476190476
Control.ERR205724;59;59;0.389830508474576;36;23;0.110169491525424;0.389830508474576
Control.ERR205724;56;59;0.517857142857143;27;29;0.0178571428571429;0.482142857142857
Control.ERR205724;52;59;0.423076923076923;30;22;0.0769230769230769;0.423076923076923
Control.ERR205724;55;59;0.618181818181818;21;34;0.118181818181818;0.381818181818182
Control.ERR205724;66;59;0.575757575757576;28;38;0.0757575757575758;0.424242424242424
Control.ERR205724;57;59;0.473684210526316;30;27;0.0263157894736842;0.473684210526316
Control.ERR205724;50;59;0.52;24;26;0.02;0.48
Control.ERR205724;60;59;0.516666666666667;29;31;0.0166666666666667;0.483333333333333
Control.ERR205724;56;59;0.5;28;28;0;0.5
Control.ERR205724;53;59;0.509433962264151;26;27;0.00943396226415094;0.490566037735849
Control.ERR205724;58;59;0.448275862068966;32;26;0.0517241379310345;0.448275862068966
Control.ERR205724;62;59;0.5;31;31;0;0.5
Control.ERR205724;57;59;0.473684210526316;30;27;0.0263157894736842;0.473684210526316
Control.ERR205724;62;59;0.419354838709677;36;26;0.0806451612903226;0.419354838709677
Control.ERR205724;50;59;0.52;24;26;0.02;0.48
Control.ERR205724;52;59;0.384615384615385;32;20;0.115384615384615;0.384615384615385
Control.ERR205724;66;59;0.424242424242424;38;28;0.0757575757575757;0.424242424242424
Control.ERR205724;65;59;0.523076923076923;31;34;0.0230769230769231;0.476923076923077
Control.ERR205724;58;59;0.603448275862069;23;35;0.103448275862069;0.396551724137931
Control.ERR205724;56;59;0.482142857142857;29;27;0.0178571428571428;0.482142857142857
Control.ERR205724;64;59;0.46875;34;30;0.03125;0.46875
Control.ERR205724;61;59;0.442622950819672;34;27;0.0573770491803279;0.442622950819672
Control.ERR205724;52;59;0.634615384615385;19;33;0.134615384615385;0.365384615384615
Control.ERR205724;50;59;0.5;25;25;0;0.5
Control.ERR205724;63;59;0.412698412698413;37;26;0.0873015873015873;0.412698412698413
Control.ERR205724;55;59;0.545454545454545;25;30;0.0454545454545454;0.454545454545455
Control.ERR205724;57;59;0.403508771929825;34;23;0.0964912280701755;0.403508771929825
Control.ERR205724;57;59;0.473684210526316;30;27;0.0263157894736842;0.473684210526316
Control.ERR205724;60;59;0.533333333333333;28;32;0.0333333333333333;0.466666666666667
Control.ERR205724;60;59;0.466666666666667;32;28;0.0333333333333333;0.466666666666667
Control.ERR205724;54;59;0.62962962962963;20;34;0.12962962962963;0.37037037037037
Control.ERR205724;52;59;0.576923076923077;22;30;0.0769230769230769;0.423076923076923
Control.ERR205724;62;59;0.548387096774194;28;34;0.0483870967741935;0.451612903225806
Control.ERR205724;66;59;0.651515151515151;23;43;0.151515151515151;0.348484848484849
Control.ERR205724;50;59;0.6;20;30;0.1;0.4
Control.ERR205724;50;59;0.36;32;18;0.14;0.36
Control.ERR205724;60;59;0.45;33;27;0.05;0.45
Control.ERR205724;58;59;0.586206896551724;24;34;0.0862068965517241;0.413793103448276
Control.ERR205724;64;59;0.515625;31;33;0.015625;0.484375
Control.ERR205724;55;59;0.4;33;22;0.1;0.4
Control.ERR205724;52;59;0.519230769230769;25;27;0.0192307692307693;0.480769230769231
Control.ERR205724;62;59;0.564516129032258;27;35;0.0645161290322581;0.435483870967742
Control.ERR205724;61;59;0.442622950819672;34;27;0.0573770491803279;0.442622950819672
Control.ERR205724;60;59;0.5;30;30;0;0.5
Control.ERR205724;64;59;0.546875;29;35;0.046875;0.453125
Control.ERR205724;56;59;0.446428571428571;31;25;0.0535714285714285;0.446428571428571
Control.ERR205724;64;59;0.453125;35;29;0.046875;0.453125
Control.ERR205724;59;59;0.440677966101695;33;26;0.0593220338983051;0.440677966101695
Control.ERR205724;56;59;0.535714285714286;26;30;0.0357142857142857;0.464285714285714
Control.ERR205724;57;59;0.508771929824561;28;29;0.00877192982456143;0.491228070175439
Control.ERR205724;63;59;0.523809523809524;30;33;0.0238095238095238;0.476190476190476
Control.ERR205724;64;59;0.640625;23;41;0.140625;0.359375
Control.ERR205724;60;59;0.566666666666667;26;34;0.0666666666666667;0.433333333333333
Control.ERR205724;64;59;0.53125;30;34;0.03125;0.46875
Control.ERR205724;64;59;0.484375;33;31;0.015625;0.484375
Control.ERR205724;64;59;0.515625;31;33;0.015625;0.484375
Control.ERR205724;61;59;0.442622950819672;34;27;0.0573770491803279;0.442622950819672
Control.ERR205724;57;59;0.456140350877193;31;26;0.043859649122807;0.456140350877193
Control.ERR205724;50;59;0.66;17;33;0.16;0.34
Control.ERR205724;51;59;0.627450980392157;19;32;0.127450980392157;0.372549019607843
Control.ERR205724;54;59;0.611111111111111;21;33;0.111111111111111;0.388888888888889
Control.ERR205724;62;59;0.483870967741935;32;30;0.0161290322580645;0.483870967741935
Control.ERR205724;51;59;0.411764705882353;30;21;0.0882352941176471;0.411764705882353
Control.ERR205724;56;59;0.571428571428571;24;32;0.0714285714285714;0.428571428571429
Control.ERR205724;59;59;0.491525423728814;30;29;0.00847457627118642;0.491525423728814
Control.ERR205724;64;59;0.6875;20;44;0.1875;0.3125
Control.ERR205724;53;59;0.528301886792453;25;28;0.0283018867924528;0.471698113207547
Control.ERR205724;66;59;0.454545454545455;36;30;0.0454545454545455;0.454545454545455
Control.ERR205724;59;59;0.542372881355932;27;32;0.0423728813559322;0.457627118644068
Control.ERR205724;61;59;0.639344262295082;22;39;0.139344262295082;0.360655737704918
Control.ERR205724;50;59;0.58;21;29;0.08;0.42
Control.ERR205724;62;59;0.580645161290323;26;36;0.0806451612903226;0.419354838709677
Control.ERR205724;65;59;0.523076923076923;31;34;0.0230769230769231;0.476923076923077
Control.ERR205724;58;59;0.413793103448276;34;24;0.0862068965517241;0.413793103448276
Control.ERR205724;64;59;0.375;40;24;0.125;0.375
Control.ERR205724;57;59;0.491228070175439;29;28;0.00877192982456143;0.491228070175439
Control.ERR205724;59;59;0.525423728813559;28;31;0.0254237288135594;0.474576271186441
Control.ERR205724;64;59;0.484375;33;31;0.015625;0.484375
Control.ERR205724;49;59;0.551020408163265;22;27;0.0510204081632653;0.448979591836735
Control.ERR205724;55;59;0.472727272727273;29;26;0.0272727272727273;0.472727272727273
Control.ERR205724;54;59;0.481481481481481;28;26;0.0185185185185185;0.481481481481481
Control.ERR205724;58;59;0.551724137931034;26;32;0.0517241379310345;0.448275862068966
Control.ERR205724;54;59;0.5;27;27;0;0.5
Control.ERR205724;56;59;0.5;28;28;0;0.5
Control.ERR205724;50;59;0.44;28;22;0.06;0.44
Control.ERR205724;52;59;0.557692307692308;23;29;0.0576923076923077;0.442307692307692
Control.ERR205724;61;59;0.442622950819672;34;27;0.0573770491803279;0.442622950819672
Control.ERR205724;52;59;0.480769230769231;27;25;0.0192307692307692;0.480769230769231
Control.ERR205724;64;59;0.4375;36;28;0.0625;0.4375
Control.ERR205724;55;59;0.4;33;22;0.1;0.4
Control.ERR205724;64;59;0.5;32;32;0;0.5
Control.ERR205724;57;59;0.473684210526316;30;27;0.0263157894736842;0.473684210526316
Control.ERR205724;65;59;0.461538461538462;35;30;0.0384615384615384;0.461538461538462
Control.ERR205724;53;59;0.433962264150943;30;23;0.0660377358490566;0.433962264150943
Control.ERR205724;59;59;0.372881355932203;37;22;0.127118644067797;0.372881355932203
Control.ERR205724;55;59;0.472727272727273;29;26;0.0272727272727273;0.472727272727273
Control.ERR205724;58;59;0.53448275862069;27;31;0.0344827586206896;0.46551724137931
Control.ERR205724;57;59;0.508771929824561;28;29;0.00877192982456143;0.491228070175439
Control.ERR205724;58;59;0.5;29;29;0;0.5
Control.ERR205724;60;59;0.5;30;30;0;0.5
Control.ERR205724;65;59;0.538461538461538;30;35;0.0384615384615384;0.461538461538462
Control.ERR205724;50;59;0.52;24;26;0.02;0.48
Control.ERR205724;58;59;0.431034482758621;33;25;0.0689655172413793;0.431034482758621
Control.ERR205724;53;59;0.566037735849057;23;30;0.0660377358490566;0.433962264150943
Control.ERR205724;57;59;0.421052631578947;33;24;0.0789473684210527;0.421052631578947
Control.ERR205724;53;59;0.528301886792453;25;28;0.0283018867924528;0.471698113207547
Control.ERR205724;56;59;0.517857142857143;27;29;0.0178571428571429;0.482142857142857
Control.ERR205724;65;59;0.430769230769231;37;28;0.0692307692307692;0.430769230769231
Control.ERR205724;49;59;0.489795918367347;25;24;0.0102040816326531;0.489795918367347
Control.ERR205724;53;59;0.452830188679245;29;24;0.0471698113207547;0.452830188679245
Control.ERR205724;51;59;0.431372549019608;29;22;0.0686274509803921;0.431372549019608
Control.ERR205724;54;59;0.537037037037037;25;29;0.0370370370370371;0.462962962962963
Control.ERR205724;50;59;0.46;27;23;0.04;0.46
Control.ERR205724;49;59;0.448979591836735;27;22;0.0510204081632653;0.448979591836735
Control.ERR205724;55;59;0.490909090909091;28;27;0.00909090909090909;0.490909090909091
Control.ERR205724;57;59;0.543859649122807;26;31;0.043859649122807;0.456140350877193
Control.ERR205724;50;59;0.46;27;23;0.04;0.46
Control.ERR205724;51;59;0.509803921568627;25;26;0.00980392156862742;0.490196078431373
Control.ERR205724;65;59;0.538461538461538;30;35;0.0384615384615384;0.461538461538462
Control.ERR205724;58;59;0.482758620689655;30;28;0.0172413793103448;0.482758620689655
Control.ERR205724;57;59;0.526315789473684;27;30;0.0263157894736842;0.473684210526316
Control.ERR205724;55;59;0.4;33;22;0.1;0.4
Control.ERR205724;61;59;0.590163934426229;25;36;0.0901639344262295;0.409836065573771
Control.ERR205724;56;59;0.5;28;28;0;0.5
Control.ERR205724;61;59;0.442622950819672;34;27;0.0573770491803279;0.442622950819672
Control.ERR205724;56;59;0.642857142857143;20;36;0.142857142857143;0.357142857142857
Control.ERR205724;51;59;0.431372549019608;29;22;0.0686274509803921;0.431372549019608
Control.ERR205724;57;59;0.508771929824561;28;29;0.00877192982456143;0.491228070175439
Control.ERR205724;55;59;0.490909090909091;28;27;0.00909090909090909;0.490909090909091
Control.ERR205724;62;59;0.548387096774194;28;34;0.0483870967741935;0.451612903225806
Control.ERR205724;59;59;0.389830508474576;36;23;0.110169491525424;0.389830508474576
Control.ERR205724;63;59;0.555555555555556;28;35;0.0555555555555556;0.444444444444444
Control.ERR205724;64;59;0.5625;28;36;0.0625;0.4375
Control.ERR205724;60;59;0.533333333333333;28;32;0.0333333333333333;0.466666666666667
Control.ERR205724;59;59;0.508474576271186;29;30;0.00847457627118642;0.491525423728814
Control.ERR205724;62;59;0.564516129032258;27;35;0.0645161290322581;0.435483870967742
Control.ERR205724;57;59;0.543859649122807;26;31;0.043859649122807;0.456140350877193
Control.ERR205724;60;59;0.533333333333333;28;32;0.0333333333333333;0.466666666666667
Control.ERR205724;64;59;0.5625;28;36;0.0625;0.4375
Control.ERR205724;64;59;0.53125;30;34;0.03125;0.46875
Control.ERR205724;57;59;0.543859649122807;26;31;0.043859649122807;0.456140350877193
Control.ERR205724;62;59;0.5;31;31;0;0.5
Control.ERR205724;59;59;0.474576271186441;31;28;0.0254237288135593;0.474576271186441
Control.ERR205724;63;59;0.507936507936508;31;32;0.00793650793650791;0.492063492063492
Control.ERR205724;58;59;0.448275862068966;32;26;0.0517241379310345;0.448275862068966
Control.ERR205724;53;59;0.584905660377358;22;31;0.0849056603773585;0.415094339622642
Control.ERR205724;62;59;0.451612903225806;34;28;0.0483870967741936;0.451612903225806
Control.ERR205724;60;59;0.583333333333333;25;35;0.0833333333333334;0.416666666666667
Control.ERR205724;63;59;0.444444444444444;35;28;0.0555555555555556;0.444444444444444
Control.ERR205724;52;59;0.442307692307692;29;23;0.0576923076923077;0.442307692307692
Control.ERR205724;52;59;0.384615384615385;32;20;0.115384615384615;0.384615384615385
Control.ERR205724;61;59;0.459016393442623;33;28;0.040983606557377;0.459016393442623
Control.ERR205724;50;59;0.58;21;29;0.08;0.42
Control.ERR205724;59;59;0.542372881355932;27;32;0.0423728813559322;0.457627118644068
Control.ERR205724;52;59;0.576923076923077;22;30;0.0769230769230769;0.423076923076923
Control.ERR205724;52;59;0.480769230769231;27;25;0.0192307692307692;0.480769230769231
Control.ERR205724;58;59;0.46551724137931;31;27;0.0344827586206897;0.46551724137931
Control.ERR205724;61;59;0.475409836065574;32;29;0.0245901639344263;0.475409836065574
Control.ERR205724;60;59;0.55;27;33;0.05;0.45
Control.ERR205724;61;59;0.557377049180328;27;34;0.0573770491803278;0.442622950819672
Control.ERR205724;52;59;0.538461538461538;24;28;0.0384615384615384;0.461538461538462
Control.ERR205724;61;59;0.590163934426229;25;36;0.0901639344262295;0.409836065573771
Control.ERR205724;49;59;0.551020408163265;22;27;0.0510204081632653;0.448979591836735
Control.ERR205724;57;59;0.508771929824561;28;29;0.00877192982456143;0.491228070175439
Control.ERR205724;49;59;0.326530612244898;33;16;0.173469387755102;0.326530612244898
Control.ERR205724;58;59;0.448275862068966;32;26;0.0517241379310345;0.448275862068966
Control.ERR205724;59;59;0.593220338983051;24;35;0.0932203389830508;0.406779661016949
Control.ERR205724;50;59;0.46;27;23;0.04;0.46
Control.ERR205724;57;59;0.368421052631579;36;21;0.131578947368421;0.368421052631579
Control.ERR205724;58;59;0.396551724137931;35;23;0.103448275862069;0.396551724137931
Control.ERR205724;56;59;0.553571428571429;25;31;0.0535714285714286;0.446428571428571
Control.ERR205724;56;59;0.357142857142857;36;20;0.142857142857143;0.357142857142857
Control.ERR205724;62;59;0.580645161290323;26;36;0.0806451612903226;0.419354838709677
Control.ERR205724;63;59;0.507936507936508;31;32;0.00793650793650791;0.492063492063492
Control.ERR205724;58;59;0.586206896551724;24;34;0.0862068965517241;0.413793103448276
Control.ERR205724;59;59;0.593220338983051;24;35;0.0932203389830508;0.406779661016949
Control.ERR205724;58;59;0.517241379310345;28;30;0.0172413793103449;0.482758620689655
Control.ERR205724;62;59;0.580645161290323;26;36;0.0806451612903226;0.419354838709677
Control.ERR205724;59;59;0.457627118644068;32;27;0.0423728813559322;0.457627118644068
Control.ERR205724;63;59;0.476190476190476;33;30;0.0238095238095238;0.476190476190476
Control.ERR205724;55;59;0.509090909090909;27;28;0.00909090909090904;0.490909090909091
Control.ERR205724;55;59;0.654545454545455;19;36;0.154545454545455;0.345454545454545
Control.ERR205724;64;59;0.5;32;32;0;0.5
Control.ERR205724;51;59;0.431372549019608;29;22;0.0686274509803921;0.431372549019608
Control.ERR205724;62;59;0.516129032258065;30;32;0.0161290322580645;0.483870967741935
Control.ERR205724;54;59;0.611111111111111;21;33;0.111111111111111;0.388888888888889
Control.ERR205724;54;59;0.407407407407407;32;22;0.0925925925925926;0.407407407407407
Control.ERR205724;59;59;0.474576271186441;31;28;0.0254237288135593;0.474576271186441
Control.ERR205724;51;59;0.431372549019608;29;22;0.0686274509803921;0.431372549019608
Control.ERR205724;61;59;0.442622950819672;34;27;0.0573770491803279;0.442622950819672
Control.ERR205724;51;59;0.568627450980392;22;29;0.0686274509803921;0.431372549019608
Control.ERR205724;52;59;0.326923076923077;35;17;0.173076923076923;0.326923076923077
Control.ERR205724;54;59;0.555555555555556;24;30;0.0555555555555556;0.444444444444444
Control.ERR205724;51;59;0.490196078431373;26;25;0.00980392156862747;0.490196078431373
Control.ERR205724;52;59;0.461538461538462;28;24;0.0384615384615384;0.461538461538462
Control.ERR205724;59;59;0.491525423728814;30;29;0.00847457627118642;0.491525423728814
Control.ERR205724;56;59;0.535714285714286;26;30;0.0357142857142857;0.464285714285714
Control.ERR205724;64;59;0.46875;34;30;0.03125;0.46875
Control.ERR205724;63;59;0.428571428571429;36;27;0.0714285714285715;0.428571428571429
Control.ERR205724;59;59;0.559322033898305;26;33;0.059322033898305;0.440677966101695
Control.ERR205724;58;59;0.5;29;29;0;0.5
Control.ERR205724;55;59;0.618181818181818;21;34;0.118181818181818;0.381818181818182
Control.ERR205724;60;59;0.35;39;21;0.15;0.35
Control.ERR205724;60;59;0.45;33;27;0.05;0.45
Control.ERR205724;65;59;0.523076923076923;31;34;0.0230769230769231;0.476923076923077
Control.ERR205724;55;59;0.472727272727273;29;26;0.0272727272727273;0.472727272727273
Control.ERR205724;59;59;0.525423728813559;28;31;0.0254237288135594;0.474576271186441
Control.ERR205724;62;59;0.435483870967742;35;27;0.0645161290322581;0.435483870967742
Control.ERR205724;53;59;0.471698113207547;28;25;0.0283018867924528;0.471698113207547
Control.ERR205724;59;59;0.474576271186441;31;28;0.0254237288135593;0.474576271186441
Control.ERR205724;56;59;0.446428571428571;31;25;0.0535714285714285;0.446428571428571
Control.ERR205724;62;59;0.516129032258065;30;32;0.0161290322580645;0.483870967741935
Control.ERR205724;62;59;0.419354838709677;36;26;0.0806451612903226;0.419354838709677
Control.ERR205724;60;59;0.533333333333333;28;32;0.0333333333333333;0.466666666666667
Control.ERR205724;62;59;0.467741935483871;33;29;0.0322580645161291;0.467741935483871
Control.ERR205724;59;59;0.457627118644068;32;27;0.0423728813559322;0.457627118644068
Control.ERR205724;58;59;0.551724137931034;26;32;0.0517241379310345;0.448275862068966
Control.ERR205724;57;59;0.526315789473684;27;30;0.0263157894736842;0.473684210526316
Control.ERR205724;54;59;0.462962962962963;29;25;0.037037037037037;0.462962962962963
Control.ERR205724;57;59;0.456140350877193;31;26;0.043859649122807;0.456140350877193
Control.ERR205724;55;59;0.490909090909091;28;27;0.00909090909090909;0.490909090909091
Control.ERR205724;61;59;0.655737704918033;21;40;0.155737704918033;0.344262295081967
Control.ERR205724;53;59;0.452830188679245;29;24;0.0471698113207547;0.452830188679245
Control.ERR205724;61;59;0.475409836065574;32;29;0.0245901639344263;0.475409836065574
Control.ERR205724;60;59;0.583333333333333;25;35;0.0833333333333334;0.416666666666667
Control.ERR205724;54;59;0.407407407407407;32;22;0.0925925925925926;0.407407407407407
Control.ERR205724;60;59;0.566666666666667;26;34;0.0666666666666667;0.433333333333333
Control.ERR205724;58;59;0.396551724137931;35;23;0.103448275862069;0.396551724137931
Control.ERR205724;51;59;0.568627450980392;22;29;0.0686274509803921;0.431372549019608
Control.ERR205724;60;59;0.383333333333333;37;23;0.116666666666667;0.383333333333333
Control.ERR205724;61;59;0.475409836065574;32;29;0.0245901639344263;0.475409836065574
Control.ERR205724;51;59;0.529411764705882;24;27;0.0294117647058824;0.470588235294118
Control.ERR205724;58;59;0.5;29;29;0;0.5
Control.ERR205724;54;59;0.5;27;27;0;0.5
Control.ERR205724;60;59;0.533333333333333;28;32;0.0333333333333333;0.466666666666667
Control.ERR205724;59;59;0.508474576271186;29;30;0.00847457627118642;0.491525423728814
Control.ERR205724;59;59;0.389830508474576;36;23;0.110169491525424;0.389830508474576
Control.ERR205724;60;59;0.583333333333333;25;35;0.0833333333333334;0.416666666666667
Control.ERR205724;54;59;0.62962962962963;20;34;0.12962962962963;0.37037037037037
Control.ERR205724;65;59;0.446153846153846;36;29;0.0538461538461538;0.446153846153846
Control.ERR205724;53;59;0.415094339622642;31;22;0.0849056603773585;0.415094339622642
Control.ERR205724;53;59;0.471698113207547;28;25;0.0283018867924528;0.471698113207547
Control.ERR205724;50;59;0.48;26;24;0.02;0.48
Control.ERR205724;62;59;0.435483870967742;35;27;0.0645161290322581;0.435483870967742
Control.ERR205724;62;59;0.516129032258065;30;32;0.0161290322580645;0.483870967741935
Control.ERR205724;51;59;0.470588235294118;27;24;0.0294117647058824;0.470588235294118
Control.ERR205724;51;59;0.490196078431373;26;25;0.00980392156862747;0.490196078431373
Control.ERR205724;54;59;0.555555555555556;24;30;0.0555555555555556;0.444444444444444
Control.ERR205724;55;59;0.618181818181818;21;34;0.118181818181818;0.381818181818182
Control.ERR205724;62;59;0.532258064516129;29;33;0.032258064516129;0.467741935483871
Control.ERR205724;61;59;0.491803278688525;31;30;0.00819672131147542;0.491803278688525
Control.ERR205724;62;59;0.548387096774194;28;34;0.0483870967741935;0.451612903225806
Control.ERR205724;56;59;0.482142857142857;29;27;0.0178571428571428;0.482142857142857
Control.ERR205724;55;59;0.509090909090909;27;28;0.00909090909090904;0.490909090909091
Control.ERR205724;57;59;0.508771929824561;28;29;0.00877192982456143;0.491228070175439
Control.ERR205724;57;59;0.421052631578947;33;24;0.0789473684210527;0.421052631578947
Control.ERR205724;60;59;0.45;33;27;0.05;0.45
Control.ERR205724;59;59;0.474576271186441;31;28;0.0254237288135593;0.474576271186441
Control.ERR205724;60;59;0.483333333333333;31;29;0.0166666666666667;0.483333333333333
Control.ERR205724;59;59;0.474576271186441;31;28;0.0254237288135593;0.474576271186441
Control.ERR205724;62;59;0.645161290322581;22;40;0.145161290322581;0.354838709677419
Control.ERR205724;53;59;0.547169811320755;24;29;0.0471698113207547;0.452830188679245
Control.ERR205724;55;59;0.545454545454545;25;30;0.0454545454545454;0.454545454545455
Control.ERR205724;62;59;0.451612903225806;34;28;0.0483870967741936;0.451612903225806
Control.ERR205724;53;59;0.547169811320755;24;29;0.0471698113207547;0.452830188679245
Control.ERR205724;57;59;0.421052631578947;33;24;0.0789473684210527;0.421052631578947
Control.ERR205724;54;59;0.592592592592593;22;32;0.0925925925925926;0.407407407407407
Control.ERR205724;62;59;0.483870967741935;32;30;0.0161290322580645;0.483870967741935
Control.ERR205724;59;59;0.457627118644068;32;27;0.0423728813559322;0.457627118644068
Control.ERR205724;64;59;0.53125;30;34;0.03125;0.46875
Control.ERR205724;50;59;0.48;26;24;0.02;0.48
Control.ERR205724;62;59;0.564516129032258;27;35;0.0645161290322581;0.435483870967742
Control.ERR205724;66;59;0.515151515151515;32;34;0.0151515151515151;0.484848484848485
Control.ERR205724;62;59;0.580645161290323;26;36;0.0806451612903226;0.419354838709677
Control.ERR205724;59;59;0.457627118644068;32;27;0.0423728813559322;0.457627118644068
Control.ERR205724;63;59;0.53968253968254;29;34;0.0396825396825397;0.46031746031746
Control.ERR205724;52;59;0.538461538461538;24;28;0.0384615384615384;0.461538461538462
Control.ERR205724;65;59;0.523076923076923;31;34;0.0230769230769231;0.476923076923077
Control.ERR205724;58;59;0.431034482758621;33;25;0.0689655172413793;0.431034482758621
Control.ERR205724;55;59;0.363636363636364;35;20;0.136363636363636;0.363636363636364
Control.ERR205724;54;59;0.555555555555556;24;30;0.0555555555555556;0.444444444444444
Control.ERR205724;59;59;0.423728813559322;34;25;0.076271186440678;0.423728813559322
Control.ERR205724;59;59;0.491525423728814;30;29;0.00847457627118642;0.491525423728814
Control.ERR205724;60;59;0.5;30;30;0;0.5
Control.ERR205724;59;59;0.525423728813559;28;31;0.0254237288135594;0.474576271186441
Control.ERR205724;60;59;0.383333333333333;37;23;0.116666666666667;0.383333333333333
Control.ERR205724;62;59;0.564516129032258;27;35;0.0645161290322581;0.435483870967742
Control.ERR205724;55;59;0.436363636363636;31;24;0.0636363636363637;0.436363636363636
Control.ERR205724;56;59;0.428571428571429;32;24;0.0714285714285715;0.428571428571429
Control.ERR205724;53;59;0.490566037735849;27;26;0.00943396226415094;0.490566037735849
Control.ERR205724;64;59;0.5625;28;36;0.0625;0.4375
Control.ERR205724;62;59;0.564516129032258;27;35;0.0645161290322581;0.435483870967742
Control.ERR205724;62;59;0.629032258064516;23;39;0.129032258064516;0.370967741935484
Control.ERR205724;58;59;0.482758620689655;30;28;0.0172413793103448;0.482758620689655
Control.ERR205724;54;59;0.5;27;27;0;0.5
Control.ERR205724;60;59;0.416666666666667;35;25;0.0833333333333333;0.416666666666667
Control.ERR205724;50;59;0.46;27;23;0.04;0.46
Control.ERR205724;51;59;0.470588235294118;27;24;0.0294117647058824;0.470588235294118
Control.ERR205724;63;59;0.444444444444444;35;28;0.0555555555555556;0.444444444444444
Control.ERR205724;53;59;0.528301886792453;25;28;0.0283018867924528;0.471698113207547
Control.ERR205724;64;59;0.34375;42;22;0.15625;0.34375
Control.ERR205724;58;59;0.5;29;29;0;0.5
Control.ERR205724;57;59;0.578947368421053;24;33;0.0789473684210527;0.421052631578947
Control.ERR205724;62;59;0.5;31;31;0;0.5
Control.ERR205724;52;59;0.557692307692308;23;29;0.0576923076923077;0.442307692307692
Control.ERR205724;58;59;0.53448275862069;27;31;0.0344827586206896;0.46551724137931
Control.ERR205724;51;59;0.509803921568627;25;26;0.00980392156862742;0.490196078431373
Control.ERR205724;54;59;0.555555555555556;24;30;0.0555555555555556;0.444444444444444
Control.ERR205724;54;59;0.555555555555556;24;30;0.0555555555555556;0.444444444444444
Control.ERR205724;63;59;0.682539682539683;20;43;0.182539682539683;0.317460317460317
Control.ERR205724;56;59;0.5;28;28;0;0.5
Control.ERR205724;60;59;0.5;30;30;0;0.5
Control.ERR205724;55;59;0.490909090909091;28;27;0.00909090909090909;0.490909090909091
Control.ERR205724;61;59;0.409836065573771;36;25;0.0901639344262295;0.409836065573771
Control.ERR205724;59;59;0.491525423728814;30;29;0.00847457627118642;0.491525423728814
Control.ERR205724;58;59;0.5;29;29;0;0.5
Control.ERR205724;62;59;0.532258064516129;29;33;0.032258064516129;0.467741935483871
Control.ERR205724;59;59;0.542372881355932;27;32;0.0423728813559322;0.457627118644068
Control.ERR205724;59;59;0.593220338983051;24;35;0.0932203389830508;0.406779661016949
Control.ERR205724;58;59;0.448275862068966;32;26;0.0517241379310345;0.448275862068966
Control.ERR205724;53;59;0.452830188679245;29;24;0.0471698113207547;0.452830188679245
Control.ERR205724;56;59;0.482142857142857;29;27;0.0178571428571428;0.482142857142857
Control.ERR205724;52;59;0.538461538461538;24;28;0.0384615384615384;0.461538461538462
Control.ERR205724;54;59;0.444444444444444;30;24;0.0555555555555556;0.444444444444444
Control.ERR205724;51;59;0.450980392156863;28;23;0.0490196078431372;0.450980392156863
Control.ERR205724;56;59;0.428571428571429;32;24;0.0714285714285715;0.428571428571429
Control.ERR205724;59;59;0.661016949152542;20;39;0.161016949152542;0.338983050847458
Control.ERR205724;57;59;0.456140350877193;31;26;0.043859649122807;0.456140350877193
Control.ERR205724;54;59;0.5;27;27;0;0.5
Control.ERR205724;61;59;0.360655737704918;39;22;0.139344262295082;0.360655737704918
Control.ERR205724;61;59;0.524590163934426;29;32;0.0245901639344263;0.475409836065574
Control.ERR205724;58;59;0.5;29;29;0;0.5
Control.ERR205724;55;59;0.527272727272727;26;29;0.0272727272727272;0.472727272727273
Control.ERR205724;60;59;0.533333333333333;28;32;0.0333333333333333;0.466666666666667
Control.ERR205724;63;59;0.523809523809524;30;33;0.0238095238095238;0.476190476190476
Control.ERR205724;65;59;0.507692307692308;32;33;0.00769230769230766;0.492307692307692
Control.ERR205724;60;59;0.4;36;24;0.1;0.4
Control.ERR205724;52;59;0.384615384615385;32;20;0.115384615384615;0.384615384615385
Control.ERR205724;61;59;0.442622950819672;34;27;0.0573770491803279;0.442622950819672
Control.ERR205724;57;59;0.578947368421053;24;33;0.0789473684210527;0.421052631578947
Control.ERR205724;57;59;0.421052631578947;33;24;0.0789473684210527;0.421052631578947
Control.ERR205724;56;59;0.607142857142857;22;34;0.107142857142857;0.392857142857143
Control.ERR205724;54;59;0.537037037037037;25;29;0.0370370370370371;0.462962962962963
Control.ERR205724;53;59;0.452830188679245;29;24;0.0471698113207547;0.452830188679245
Control.ERR205724;58;59;0.517241379310345;28;30;0.0172413793103449;0.482758620689655
Control.ERR205724;51;59;0.549019607843137;23;28;0.0490196078431373;0.450980392156863
Control.ERR205724;50;59;0.58;21;29;0.08;0.42
Control.ERR205724;51;59;0.411764705882353;30;21;0.0882352941176471;0.411764705882353
Control.ERR205724;60;59;0.533333333333333;28;32;0.0333333333333333;0.466666666666667
Control.ERR205724;55;59;0.6;22;33;0.1;0.4
Control.ERR205724;58;59;0.568965517241379;25;33;0.0689655172413793;0.431034482758621
Control.ERR205724;63;59;0.444444444444444;35;28;0.0555555555555556;0.444444444444444
Control.ERR205724;62;59;0.5;31;31;0;0.5
Control.ERR205724;55;59;0.454545454545455;30;25;0.0454545454545455;0.454545454545455
Control.ERR205724;58;59;0.448275862068966;32;26;0.0517241379310345;0.448275862068966
Control.ERR205724;64;59;0.53125;30;34;0.03125;0.46875
Control.ERR205724;56;59;0.428571428571429;32;24;0.0714285714285715;0.428571428571429
Control.ERR205724;55;59;0.4;33;22;0.1;0.4
Control.ERR205724;58;59;0.46551724137931;31;27;0.0344827586206897;0.46551724137931
Control.ERR205724;54;59;0.574074074074074;23;31;0.0740740740740741;0.425925925925926
Control.ERR205724;55;59;0.454545454545455;30;25;0.0454545454545455;0.454545454545455
Control.ERR205724;52;59;0.480769230769231;27;25;0.0192307692307692;0.480769230769231
Control.ERR205724;51;59;0.431372549019608;29;22;0.0686274509803921;0.431372549019608
Control.ERR205724;57;59;0.385964912280702;35;22;0.114035087719298;0.385964912280702
Control.ERR205724;58;59;0.586206896551724;24;34;0.0862068965517241;0.413793103448276
Control.ERR205724;55;59;0.472727272727273;29;26;0.0272727272727273;0.472727272727273
Control.ERR205724;61;59;0.442622950819672;34;27;0.0573770491803279;0.442622950819672
Control.ERR205724;60;59;0.55;27;33;0.05;0.45
Control.ERR205724;51;59;0.568627450980392;22;29;0.0686274509803921;0.431372549019608
Control.ERR205724;61;59;0.475409836065574;32;29;0.0245901639344263;0.475409836065574
Control.ERR205724;51;59;0.509803921568627;25;26;0.00980392156862742;0.490196078431373
Control.ERR205724;58;59;0.413793103448276;34;24;0.0862068965517241;0.413793103448276
Control.ERR205724;54;59;0.462962962962963;29;25;0.037037037037037;0.462962962962963
Control.ERR205724;57;59;0.508771929824561;28;29;0.00877192982456143;0.491228070175439
Control.ERR205724;55;59;0.618181818181818;21;34;0.118181818181818;0.381818181818182
Control.ERR205724;57;59;0.596491228070175;23;34;0.0964912280701754;0.403508771929825
Control.ERR205724;56;59;0.5;28;28;0;0.5
Control.ERR205724;60;59;0.566666666666667;26;34;0.0666666666666667;0.433333333333333
Control.ERR205724;62;59;0.516129032258065;30;32;0.0161290322580645;0.483870967741935
Control.ERR205724;62;59;0.532258064516129;29;33;0.032258064516129;0.467741935483871
Control.ERR205724;61;59;0.491803278688525;31;30;0.00819672131147542;0.491803278688525
Control.ERR205724;65;59;0.584615384615385;27;38;0.0846153846153846;0.415384615384615
Control.ERR205724;66;59;0.590909090909091;27;39;0.0909090909090909;0.409090909090909
Control.ERR205724;54;59;0.444444444444444;30;24;0.0555555555555556;0.444444444444444
Control.ERR205724;62;59;0.483870967741935;32;30;0.0161290322580645;0.483870967741935
Control.ERR205724;53;59;0.452830188679245;29;24;0.0471698113207547;0.452830188679245
Control.ERR205724;63;59;0.666666666666667;21;42;0.166666666666667;0.333333333333333
Control.ERR205724;60;59;0.516666666666667;29;31;0.0166666666666667;0.483333333333333
Control.ERR205724;59;59;0.423728813559322;34;25;0.076271186440678;0.423728813559322
Control.ERR205724;61;59;0.442622950819672;34;27;0.0573770491803279;0.442622950819672
Control.ERR205724;60;59;0.35;39;21;0.15;0.35
Control.ERR205724;58;59;0.396551724137931;35;23;0.103448275862069;0.396551724137931
Control.ERR205724;56;59;0.482142857142857;29;27;0.0178571428571428;0.482142857142857
Control.ERR205724;60;59;0.5;30;30;0;0.5
Control.ERR205724;63;59;0.53968253968254;29;34;0.0396825396825397;0.46031746031746
Control.ERR205724;63;59;0.507936507936508;31;32;0.00793650793650791;0.492063492063492
Control.ERR205724;57;59;0.491228070175439;29;28;0.00877192982456143;0.491228070175439
Control.ERR205724;62;59;0.661290322580645;21;41;0.161290322580645;0.338709677419355
Control.ERR205724;56;59;0.464285714285714;30;26;0.0357142857142857;0.464285714285714
Control.ERR205724;56;59;0.428571428571429;32;24;0.0714285714285715;0.428571428571429
Control.ERR205724;59;59;0.491525423728814;30;29;0.00847457627118642;0.491525423728814
Control.ERR205724;61;59;0.508196721311475;30;31;0.00819672131147542;0.491803278688525
Control.ERR205724;60;59;0.566666666666667;26;34;0.0666666666666667;0.433333333333333
Control.ERR205724;58;59;0.586206896551724;24;34;0.0862068965517241;0.413793103448276
Control.ERR205724;61;59;0.459016393442623;33;28;0.040983606557377;0.459016393442623
Control.ERR205724;63;59;0.349206349206349;41;22;0.150793650793651;0.349206349206349
Control.ERR205724;65;59;0.584615384615385;27;38;0.0846153846153846;0.415384615384615
Control.ERR205724;61;59;0.540983606557377;28;33;0.0409836065573771;0.459016393442623
Control.ERR205724;57;59;0.473684210526316;30;27;0.0263157894736842;0.473684210526316
Control.ERR205724;66;59;0.454545454545455;36;30;0.0454545454545455;0.454545454545455
Control.ERR205724;67;59;0.507462686567164;33;34;0.0074626865671642;0.492537313432836
Control.ERR205724;68;59;0.602941176470588;27;41;0.102941176470588;0.397058823529412
Control.ERR205724;56;59;0.482142857142857;29;27;0.0178571428571428;0.482142857142857
Control.ERR205724;64;59;0.484375;33;31;0.015625;0.484375
Control.ERR205724;53;59;0.547169811320755;24;29;0.0471698113207547;0.452830188679245
Control.ERR205724;61;59;0.475409836065574;32;29;0.0245901639344263;0.475409836065574
Control.ERR205724;60;59;0.533333333333333;28;32;0.0333333333333333;0.466666666666667
Control.ERR205724;60;59;0.4;36;24;0.1;0.4
Control.ERR205724;67;59;0.552238805970149;30;37;0.0522388059701493;0.447761194029851
Control.ERR205724;70;59;0.571428571428571;30;40;0.0714285714285714;0.428571428571429
Control.ERR205724;66;59;0.424242424242424;38;28;0.0757575757575757;0.424242424242424
Control.ERR205724;70;59;0.528571428571429;33;37;0.0285714285714286;0.471428571428571
Control.ERR205724;63;59;0.523809523809524;30;33;0.0238095238095238;0.476190476190476
Control.ERR205724;61;59;0.475409836065574;32;29;0.0245901639344263;0.475409836065574
Control.ERR205724;53;59;0.622641509433962;20;33;0.122641509433962;0.377358490566038
Control.ERR205724;67;59;0.417910447761194;39;28;0.082089552238806;0.417910447761194
Control.ERR205724;67;59;0.447761194029851;37;30;0.0522388059701492;0.447761194029851
Control.ERR205724;61;59;0.442622950819672;34;27;0.0573770491803279;0.442622950819672
Control.ERR205724;57;59;0.491228070175439;29;28;0.00877192982456143;0.491228070175439
Control.ERR205724;63;59;0.53968253968254;29;34;0.0396825396825397;0.46031746031746
Control.ERR205724;56;59;0.392857142857143;34;22;0.107142857142857;0.392857142857143
Control.ERR205724;60;59;0.466666666666667;32;28;0.0333333333333333;0.466666666666667
Control.ERR205724;53;59;0.490566037735849;27;26;0.00943396226415094;0.490566037735849
Control.ERR205724;59;59;0.457627118644068;32;27;0.0423728813559322;0.457627118644068
Control.ERR205724;57;59;0.543859649122807;26;31;0.043859649122807;0.456140350877193
Control.ERR205724;60;59;0.366666666666667;38;22;0.133333333333333;0.366666666666667
Control.ERR205724;64;59;0.515625;31;33;0.015625;0.484375
Control.ERR205724;61;59;0.524590163934426;29;32;0.0245901639344263;0.475409836065574
Control.ERR205724;58;59;0.46551724137931;31;27;0.0344827586206897;0.46551724137931
Control.ERR205724;61;59;0.475409836065574;32;29;0.0245901639344263;0.475409836065574
Control.ERR205724;60;59;0.45;33;27;0.05;0.45
Control.ERR205724;66;59;0.53030303030303;31;35;0.0303030303030303;0.46969696969697
Control.ERR205724;57;59;0.491228070175439;29;28;0.00877192982456143;0.491228070175439
Control.ERR205724;69;59;0.536231884057971;32;37;0.0362318840579711;0.463768115942029
Control.ERR205724;66;59;0.46969696969697;35;31;0.0303030303030303;0.46969696969697
Control.ERR205724;67;59;0.522388059701492;32;35;0.0223880597014925;0.477611940298507
Control.ERR205724;68;59;0.529411764705882;32;36;0.0294117647058824;0.470588235294118
Control.ERR205724;70;59;0.542857142857143;32;38;0.0428571428571428;0.457142857142857
Control.ERR205724;60;59;0.666666666666667;20;40;0.166666666666667;0.333333333333333
Control.ERR205724;56;59;0.589285714285714;23;33;0.0892857142857143;0.410714285714286
Control.ERR205724;63;59;0.650793650793651;22;41;0.150793650793651;0.349206349206349
Control.ERR205724;57;59;0.543859649122807;26;31;0.043859649122807;0.456140350877193
Control.ERR205724;68;59;0.5;34;34;0;0.5
Control.ERR205724;71;59;0.492957746478873;36;35;0.00704225352112675;0.492957746478873
Control.ERR205724;54;59;0.555555555555556;24;30;0.0555555555555556;0.444444444444444
Control.ERR205724;62;59;0.467741935483871;33;29;0.0322580645161291;0.467741935483871
Control.ERR205724;61;59;0.524590163934426;29;32;0.0245901639344263;0.475409836065574
Control.ERR205724;71;59;0.507042253521127;35;36;0.00704225352112675;0.492957746478873
Control.ERR205724;60;59;0.533333333333333;28;32;0.0333333333333333;0.466666666666667
Control.ERR205724;60;59;0.466666666666667;32;28;0.0333333333333333;0.466666666666667
Control.ERR205724;60;59;0.533333333333333;28;32;0.0333333333333333;0.466666666666667
Control.ERR205724;57;59;0.508771929824561;28;29;0.00877192982456143;0.491228070175439
Control.ERR205724;49;59;0.387755102040816;30;19;0.112244897959184;0.387755102040816
Control.ERR205724;53;59;0.547169811320755;24;29;0.0471698113207547;0.452830188679245
Control.ERR205724;61;59;0.491803278688525;31;30;0.00819672131147542;0.491803278688525
Control.ERR205724;62;59;0.483870967741935;32;30;0.0161290322580645;0.483870967741935
Control.ERR205724;54;59;0.518518518518518;26;28;0.0185185185185185;0.481481481481481
Control.ERR205724;50;59;0.4;30;20;0.1;0.4
Control.ERR205724;54;59;0.537037037037037;25;29;0.0370370370370371;0.462962962962963
Control.ERR205724;51;59;0.490196078431373;26;25;0.00980392156862747;0.490196078431373
Control.ERR205724;50;59;0.42;29;21;0.08;0.42
Control.ERR205724;66;59;0.363636363636364;42;24;0.136363636363636;0.363636363636364
Control.ERR205724;56;59;0.517857142857143;27;29;0.0178571428571429;0.482142857142857
Control.ERR205724;52;59;0.519230769230769;25;27;0.0192307692307693;0.480769230769231
Control.ERR205724;66;59;0.454545454545455;36;30;0.0454545454545455;0.454545454545455
Control.ERR205724;56;59;0.464285714285714;30;26;0.0357142857142857;0.464285714285714
Control.ERR205724;59;59;0.644067796610169;21;38;0.144067796610169;0.355932203389831
Control.ERR205724;56;59;0.410714285714286;33;23;0.0892857142857143;0.410714285714286
Control.ERR205724;59;59;0.491525423728814;30;29;0.00847457627118642;0.491525423728814
Control.ERR205724;58;59;0.53448275862069;27;31;0.0344827586206896;0.46551724137931
Control.ERR205724;50;59;0.56;22;28;0.0600000000000001;0.44
Control.ERR205724;53;59;0.433962264150943;30;23;0.0660377358490566;0.433962264150943
Control.ERR205724;60;59;0.516666666666667;29;31;0.0166666666666667;0.483333333333333
Control.ERR205724;60;59;0.466666666666667;32;28;0.0333333333333333;0.466666666666667
Control.ERR205724;58;59;0.448275862068966;32;26;0.0517241379310345;0.448275862068966
Control.ERR205724;53;59;0.547169811320755;24;29;0.0471698113207547;0.452830188679245
Control.ERR205724;63;59;0.523809523809524;30;33;0.0238095238095238;0.476190476190476
Control.ERR205724;63;59;0.492063492063492;32;31;0.00793650793650796;0.492063492063492
Control.ERR205724;64;59;0.609375;25;39;0.109375;0.390625
Control.ERR205724;51;59;0.509803921568627;25;26;0.00980392156862742;0.490196078431373
Control.ERR205724;61;59;0.475409836065574;32;29;0.0245901639344263;0.475409836065574
Control.ERR205724;61;59;0.491803278688525;31;30;0.00819672131147542;0.491803278688525
Control.ERR205724;61;59;0.540983606557377;28;33;0.0409836065573771;0.459016393442623
Control.ERR205724;66;59;0.454545454545455;36;30;0.0454545454545455;0.454545454545455
Control.ERR205724;61;59;0.459016393442623;33;28;0.040983606557377;0.459016393442623
Control.ERR205724;60;59;0.5;30;30;0;0.5
Control.ERR205724;63;59;0.571428571428571;27;36;0.0714285714285714;0.428571428571429
Control.ERR205724;57;59;0.43859649122807;32;25;0.0614035087719298;0.43859649122807
Control.ERR205724;51;59;0.529411764705882;24;27;0.0294117647058824;0.470588235294118
Control.ERR205724;52;59;0.596153846153846;21;31;0.0961538461538461;0.403846153846154
Control.ERR205724;57;59;0.578947368421053;24;33;0.0789473684210527;0.421052631578947
Control.ERR205724;57;59;0.491228070175439;29;28;0.00877192982456143;0.491228070175439
Control.ERR205724;63;59;0.492063492063492;32;31;0.00793650793650796;0.492063492063492
Control.ERR205724;49;59;0.551020408163265;22;27;0.0510204081632653;0.448979591836735
Control.ERR205724;65;59;0.553846153846154;29;36;0.0538461538461539;0.446153846153846
Control.ERR205724;58;59;0.46551724137931;31;27;0.0344827586206897;0.46551724137931
Control.ERR205724;65;59;0.507692307692308;32;33;0.00769230769230766;0.492307692307692
Control.ERR205724;57;59;0.508771929824561;28;29;0.00877192982456143;0.491228070175439
Control.ERR205724;50;59;0.6;20;30;0.1;0.4
Control.ERR205724;59;59;0.389830508474576;36;23;0.110169491525424;0.389830508474576
Control.ERR205724;52;59;0.403846153846154;31;21;0.0961538461538461;0.403846153846154
Control.ERR205724;50;59;0.52;24;26;0.02;0.48
Control.ERR205724;54;59;0.425925925925926;31;23;0.0740740740740741;0.425925925925926
Control.ERR205724;56;59;0.482142857142857;29;27;0.0178571428571428;0.482142857142857
Control.ERR205724;54;59;0.62962962962963;20;34;0.12962962962963;0.37037037037037
Control.ERR205724;65;59;0.476923076923077;34;31;0.0230769230769231;0.476923076923077
Control.ERR205724;56;59;0.464285714285714;30;26;0.0357142857142857;0.464285714285714
Control.ERR205724;54;59;0.611111111111111;21;33;0.111111111111111;0.388888888888889
Control.ERR205724;58;59;0.551724137931034;26;32;0.0517241379310345;0.448275862068966
Control.ERR205724;59;59;0.525423728813559;28;31;0.0254237288135594;0.474576271186441
Control.ERR205724;62;59;0.516129032258065;30;32;0.0161290322580645;0.483870967741935
Control.ERR205724;59;59;0.491525423728814;30;29;0.00847457627118642;0.491525423728814
Control.ERR205724;64;59;0.46875;34;30;0.03125;0.46875
Control.ERR205724;55;59;0.345454545454545;36;19;0.154545454545455;0.345454545454545
Control.ERR205724;54;59;0.537037037037037;25;29;0.0370370370370371;0.462962962962963
Control.ERR205724;55;59;0.581818181818182;23;32;0.0818181818181818;0.418181818181818
Control.ERR205724;56;59;0.589285714285714;23;33;0.0892857142857143;0.410714285714286
Control.ERR205724;53;59;0.547169811320755;24;29;0.0471698113207547;0.452830188679245
Control.ERR205724;54;59;0.574074074074074;23;31;0.0740740740740741;0.425925925925926
Control.ERR205724;59;59;0.491525423728814;30;29;0.00847457627118642;0.491525423728814
Control.ERR205724;60;59;0.5;30;30;0;0.5
Control.ERR205724;59;59;0.508474576271186;29;30;0.00847457627118642;0.491525423728814
Control.ERR205724;63;59;0.428571428571429;36;27;0.0714285714285715;0.428571428571429
Control.ERR205724;63;59;0.46031746031746;34;29;0.0396825396825397;0.46031746031746
Control.ERR205724;60;59;0.566666666666667;26;34;0.0666666666666667;0.433333333333333
Control.ERR205724;56;59;0.517857142857143;27;29;0.0178571428571429;0.482142857142857
Control.ERR205724;63;59;0.619047619047619;24;39;0.119047619047619;0.380952380952381
Control.ERR205724;57;59;0.631578947368421;21;36;0.131578947368421;0.368421052631579
Control.ERR205724;56;59;0.482142857142857;29;27;0.0178571428571428;0.482142857142857
Control.ERR205724;65;59;0.446153846153846;36;29;0.0538461538461538;0.446153846153846
Control.ERR205724;54;59;0.5;27;27;0;0.5
Control.ERR205724;65;59;0.6;26;39;0.1;0.4
Control.ERR205724;60;59;0.6;24;36;0.1;0.4
Control.ERR205724;58;59;0.551724137931034;26;32;0.0517241379310345;0.448275862068966
Control.ERR205724;64;59;0.609375;25;39;0.109375;0.390625
Control.ERR205724;66;59;0.666666666666667;22;44;0.166666666666667;0.333333333333333
Control.ERR205724;60;59;0.583333333333333;25;35;0.0833333333333334;0.416666666666667
Control.ERR205724;60;59;0.583333333333333;25;35;0.0833333333333334;0.416666666666667
Control.ERR205724;57;59;0.631578947368421;21;36;0.131578947368421;0.368421052631579
Control.ERR205724;52;59;0.5;26;26;0;0.5
Control.ERR205724;55;59;0.490909090909091;28;27;0.00909090909090909;0.490909090909091
Control.ERR205724;56;59;0.375;35;21;0.125;0.375
Control.ERR205724;60;59;0.483333333333333;31;29;0.0166666666666667;0.483333333333333
Control.ERR205724;61;59;0.426229508196721;35;26;0.0737704918032787;0.426229508196721
Control.ERR205724;59;59;0.593220338983051;24;35;0.0932203389830508;0.406779661016949
Control.ERR205724;58;59;0.568965517241379;25;33;0.0689655172413793;0.431034482758621
Control.ERR205724;59;59;0.542372881355932;27;32;0.0423728813559322;0.457627118644068
Control.ERR205724;52;59;0.538461538461538;24;28;0.0384615384615384;0.461538461538462
Control.ERR205724;60;59;0.55;27;33;0.05;0.45
Control.ERR205724;54;59;0.462962962962963;29;25;0.037037037037037;0.462962962962963
Control.ERR205724;59;59;0.474576271186441;31;28;0.0254237288135593;0.474576271186441
Control.ERR205724;60;59;0.616666666666667;23;37;0.116666666666667;0.383333333333333
Control.ERR205724;65;59;0.584615384615385;27;38;0.0846153846153846;0.415384615384615
Control.ERR205724;63;59;0.53968253968254;29;34;0.0396825396825397;0.46031746031746
Control.ERR205724;60;59;0.416666666666667;35;25;0.0833333333333333;0.416666666666667
Control.ERR205724;63;59;0.476190476190476;33;30;0.0238095238095238;0.476190476190476
Control.ERR205724;65;59;0.476923076923077;34;31;0.0230769230769231;0.476923076923077
Control.ERR205724;63;59;0.523809523809524;30;33;0.0238095238095238;0.476190476190476
Control.ERR205724;58;59;0.517241379310345;28;30;0.0172413793103449;0.482758620689655
Control.ERR205724;53;59;0.471698113207547;28;25;0.0283018867924528;0.471698113207547
Control.ERR205724;62;59;0.435483870967742;35;27;0.0645161290322581;0.435483870967742
Control.ERR205724;58;59;0.517241379310345;28;30;0.0172413793103449;0.482758620689655
Control.ERR205724;60;59;0.483333333333333;31;29;0.0166666666666667;0.483333333333333
Control.ERR205724;61;59;0.491803278688525;31;30;0.00819672131147542;0.491803278688525
Control.ERR205724;65;59;0.553846153846154;29;36;0.0538461538461539;0.446153846153846
Control.ERR205724;62;59;0.467741935483871;33;29;0.0322580645161291;0.467741935483871
Control.ERR205724;63;59;0.492063492063492;32;31;0.00793650793650796;0.492063492063492
Control.ERR205724;57;59;0.543859649122807;26;31;0.043859649122807;0.456140350877193
Control.ERR205724;61;59;0.524590163934426;29;32;0.0245901639344263;0.475409836065574
Control.ERR205724;67;59;0.552238805970149;30;37;0.0522388059701493;0.447761194029851
Control.ERR205724;59;59;0.406779661016949;35;24;0.0932203389830508;0.406779661016949
Control.ERR205724;60;59;0.533333333333333;28;32;0.0333333333333333;0.466666666666667
Control.ERR205724;55;59;0.545454545454545;25;30;0.0454545454545454;0.454545454545455
Control.ERR205724;60;59;0.383333333333333;37;23;0.116666666666667;0.383333333333333
Control.ERR205724;54;59;0.444444444444444;30;24;0.0555555555555556;0.444444444444444
Control.ERR205724;68;59;0.529411764705882;32;36;0.0294117647058824;0.470588235294118
Control.ERR205724;64;59;0.484375;33;31;0.015625;0.484375
Control.ERR205724;58;59;0.568965517241379;25;33;0.0689655172413793;0.431034482758621
Control.ERR205724;58;59;0.603448275862069;23;35;0.103448275862069;0.396551724137931
Control.ERR205724;70;59;0.471428571428571;37;33;0.0285714285714286;0.471428571428571
Control.ERR205724;64;59;0.5;32;32;0;0.5
Control.ERR205724;61;59;0.409836065573771;36;25;0.0901639344262295;0.409836065573771
Control.ERR205724;58;59;0.413793103448276;34;24;0.0862068965517241;0.413793103448276
Control.ERR205724;58;59;0.448275862068966;32;26;0.0517241379310345;0.448275862068966
Control.ERR205724;53;59;0.490566037735849;27;26;0.00943396226415094;0.490566037735849
Control.ERR205724;55;59;0.436363636363636;31;24;0.0636363636363637;0.436363636363636
Control.ERR205724;57;59;0.421052631578947;33;24;0.0789473684210527;0.421052631578947
Control.ERR205724;62;59;0.483870967741935;32;30;0.0161290322580645;0.483870967741935
Control.ERR205724;71;59;0.47887323943662;37;34;0.0211267605633803;0.47887323943662
Control.ERR205724;53;59;0.490566037735849;27;26;0.00943396226415094;0.490566037735849
Control.ERR205724;63;59;0.587301587301587;26;37;0.0873015873015873;0.412698412698413
Control.ERR205724;54;59;0.444444444444444;30;24;0.0555555555555556;0.444444444444444
Control.ERR205724;53;59;0.566037735849057;23;30;0.0660377358490566;0.433962264150943
Control.ERR205724;56;59;0.553571428571429;25;31;0.0535714285714286;0.446428571428571
Control.ERR205724;53;59;0.433962264150943;30;23;0.0660377358490566;0.433962264150943
Control.ERR205724;56;59;0.464285714285714;30;26;0.0357142857142857;0.464285714285714
Control.ERR205724;61;59;0.459016393442623;33;28;0.040983606557377;0.459016393442623
Control.ERR205724;67;59;0.552238805970149;30;37;0.0522388059701493;0.447761194029851
Control.ERR205724;65;59;0.492307692307692;33;32;0.00769230769230766;0.492307692307692
Control.ERR205724;69;59;0.478260869565217;36;33;0.0217391304347826;0.478260869565217
Control.ERR205724;67;59;0.552238805970149;30;37;0.0522388059701493;0.447761194029851
Control.ERR205724;58;59;0.431034482758621;33;25;0.0689655172413793;0.431034482758621
Control.ERR205724;57;59;0.385964912280702;35;22;0.114035087719298;0.385964912280702
Control.ERR205724;54;59;0.5;27;27;0;0.5
Control.ERR205724;57;59;0.456140350877193;31;26;0.043859649122807;0.456140350877193
Control.ERR205724;57;59;0.543859649122807;26;31;0.043859649122807;0.456140350877193
Control.ERR205724;61;59;0.508196721311475;30;31;0.00819672131147542;0.491803278688525
Control.ERR205724;53;59;0.509433962264151;26;27;0.00943396226415094;0.490566037735849
Control.ERR205724;63;59;0.396825396825397;38;25;0.103174603174603;0.396825396825397
Control.ERR205724;60;59;0.5;30;30;0;0.5
Control.ERR205724;56;59;0.5;28;28;0;0.5
Control.ERR205724;57;59;0.578947368421053;24;33;0.0789473684210527;0.421052631578947
Control.ERR205724;68;59;0.617647058823529;26;42;0.117647058823529;0.382352941176471
Control.ERR205724;61;59;0.573770491803279;26;35;0.0737704918032787;0.426229508196721
Control.ERR205724;69;59;0.507246376811594;34;35;0.00724637681159424;0.492753623188406
Control.ERR205724;56;59;0.535714285714286;26;30;0.0357142857142857;0.464285714285714
Control.ERR205724;53;59;0.415094339622642;31;22;0.0849056603773585;0.415094339622642
Control.ERR205724;66;59;0.454545454545455;36;30;0.0454545454545455;0.454545454545455
Control.ERR205724;54;59;0.481481481481481;28;26;0.0185185185185185;0.481481481481481
Control.ERR205724;63;59;0.571428571428571;27;36;0.0714285714285714;0.428571428571429
Control.ERR205724;53;59;0.415094339622642;31;22;0.0849056603773585;0.415094339622642
Control.ERR205724;67;59;0.462686567164179;36;31;0.0373134328358209;0.462686567164179
Control.ERR205724;57;59;0.578947368421053;24;33;0.0789473684210527;0.421052631578947
Control.ERR205724;55;59;0.490909090909091;28;27;0.00909090909090909;0.490909090909091
Control.ERR205724;71;59;0.605633802816901;28;43;0.105633802816901;0.394366197183099
Control.ERR205724;70;59;0.5;35;35;0;0.5
Control.ERR205724;68;59;0.485294117647059;35;33;0.0147058823529412;0.485294117647059
Control.ERR205724;66;59;0.46969696969697;35;31;0.0303030303030303;0.46969696969697
Control.ERR205724;65;59;0.461538461538462;35;30;0.0384615384615384;0.461538461538462
Control.ERR205724;70;59;0.485714285714286;36;34;0.0142857142857143;0.485714285714286
Control.ERR205724;64;59;0.421875;37;27;0.078125;0.421875
Control.ERR205724;56;59;0.535714285714286;26;30;0.0357142857142857;0.464285714285714
Control.ERR205724;62;59;0.532258064516129;29;33;0.032258064516129;0.467741935483871
Control.ERR205724;59;59;0.440677966101695;33;26;0.0593220338983051;0.440677966101695
Control.ERR205724;60;59;0.5;30;30;0;0.5
Control.ERR205724;62;59;0.483870967741935;32;30;0.0161290322580645;0.483870967741935
Control.ERR205724;63;59;0.396825396825397;38;25;0.103174603174603;0.396825396825397
Control.ERR205724;63;59;0.619047619047619;24;39;0.119047619047619;0.380952380952381
Control.ERR205724;61;59;0.491803278688525;31;30;0.00819672131147542;0.491803278688525
Control.ERR205724;61;59;0.459016393442623;33;28;0.040983606557377;0.459016393442623
Control.ERR205724;60;59;0.483333333333333;31;29;0.0166666666666667;0.483333333333333
Control.ERR205724;63;59;0.507936507936508;31;32;0.00793650793650791;0.492063492063492
Control.ERR205724;60;59;0.466666666666667;32;28;0.0333333333333333;0.466666666666667
Control.ERR205724;61;59;0.491803278688525;31;30;0.00819672131147542;0.491803278688525
Control.ERR205724;66;59;0.439393939393939;37;29;0.0606060606060606;0.439393939393939
Control.ERR205724;66;59;0.545454545454545;30;36;0.0454545454545454;0.454545454545455
Control.ERR205724;66;59;0.348484848484849;43;23;0.151515151515151;0.348484848484849
Control.ERR205724;58;59;0.53448275862069;27;31;0.0344827586206896;0.46551724137931
Control.ERR205724;64;59;0.515625;31;33;0.015625;0.484375
Control.ERR205724;58;59;0.53448275862069;27;31;0.0344827586206896;0.46551724137931
Control.ERR205724;66;59;0.515151515151515;32;34;0.0151515151515151;0.484848484848485
Control.ERR205724;64;59;0.546875;29;35;0.046875;0.453125
Control.ERR205724;59;59;0.525423728813559;28;31;0.0254237288135594;0.474576271186441
Control.ERR205724;57;59;0.473684210526316;30;27;0.0263157894736842;0.473684210526316
Control.ERR205724;65;59;0.476923076923077;34;31;0.0230769230769231;0.476923076923077
Control.ERR205724;65;59;0.415384615384615;38;27;0.0846153846153846;0.415384615384615
Control.ERR205724;64;59;0.59375;26;38;0.09375;0.40625
Control.ERR205724;61;59;0.491803278688525;31;30;0.00819672131147542;0.491803278688525
Control.ERR205724;58;59;0.517241379310345;28;30;0.0172413793103449;0.482758620689655
Control.ERR205724;65;59;0.584615384615385;27;38;0.0846153846153846;0.415384615384615
Control.ERR205724;66;59;0.484848484848485;34;32;0.0151515151515151;0.484848484848485
Control.ERR205724;67;59;0.492537313432836;34;33;0.0074626865671642;0.492537313432836
Control.ERR205724;69;59;0.478260869565217;36;33;0.0217391304347826;0.478260869565217
Control.ERR205724;64;59;0.546875;29;35;0.046875;0.453125
Control.ERR205724;60;59;0.383333333333333;37;23;0.116666666666667;0.383333333333333
Control.ERR205724;72;59;0.375;45;27;0.125;0.375
Control.ERR205724;66;59;0.46969696969697;35;31;0.0303030303030303;0.46969696969697
Control.ERR205724;62;59;0.516129032258065;30;32;0.0161290322580645;0.483870967741935
Control.ERR205724;67;59;0.477611940298507;35;32;0.0223880597014925;0.477611940298507
Control.ERR205724;62;59;0.580645161290323;26;36;0.0806451612903226;0.419354838709677
Control.ERR205724;66;59;0.454545454545455;36;30;0.0454545454545455;0.454545454545455
Control.ERR205724;65;59;0.569230769230769;28;37;0.0692307692307692;0.430769230769231
Control.ERR205724;54;59;0.388888888888889;33;21;0.111111111111111;0.388888888888889
Control.ERR205724;57;59;0.456140350877193;31;26;0.043859649122807;0.456140350877193
Control.ERR205724;60;59;0.566666666666667;26;34;0.0666666666666667;0.433333333333333
Control.ERR205724;69;59;0.608695652173913;27;42;0.108695652173913;0.391304347826087
Control.ERR205724;64;59;0.46875;34;30;0.03125;0.46875
Control.ERR205724;59;59;0.491525423728814;30;29;0.00847457627118642;0.491525423728814
Control.ERR205724;60;59;0.416666666666667;35;25;0.0833333333333333;0.416666666666667
Control.ERR205724;58;59;0.413793103448276;34;24;0.0862068965517241;0.413793103448276
Control.ERR205724;61;59;0.590163934426229;25;36;0.0901639344262295;0.409836065573771
Control.ERR205724;59;59;0.423728813559322;34;25;0.076271186440678;0.423728813559322
Control.ERR205724;65;59;0.461538461538462;35;30;0.0384615384615384;0.461538461538462
Control.ERR205724;70;59;0.571428571428571;30;40;0.0714285714285714;0.428571428571429
Control.ERR205724;63;59;0.396825396825397;38;25;0.103174603174603;0.396825396825397
Control.ERR205724;55;59;0.490909090909091;28;27;0.00909090909090909;0.490909090909091
Control.ERR205724;59;59;0.474576271186441;31;28;0.0254237288135593;0.474576271186441
Control.ERR205724;63;59;0.53968253968254;29;34;0.0396825396825397;0.46031746031746
Control.ERR205724;64;59;0.515625;31;33;0.015625;0.484375
Control.ERR205724;65;59;0.507692307692308;32;33;0.00769230769230766;0.492307692307692
Control.ERR205724;66;59;0.484848484848485;34;32;0.0151515151515151;0.484848484848485
Control.ERR205724;59;59;0.457627118644068;32;27;0.0423728813559322;0.457627118644068
Control.ERR205724;56;59;0.5;28;28;0;0.5
Control.ERR205724;59;59;0.474576271186441;31;28;0.0254237288135593;0.474576271186441
Control.ERR205724;62;59;0.419354838709677;36;26;0.0806451612903226;0.419354838709677
Control.ERR205724;65;59;0.384615384615385;40;25;0.115384615384615;0.384615384615385
Control.ERR205724;69;59;0.579710144927536;29;40;0.0797101449275363;0.420289855072464
Control.ERR205724;65;59;0.523076923076923;31;34;0.0230769230769231;0.476923076923077
Control.ERR205724;61;59;0.475409836065574;32;29;0.0245901639344263;0.475409836065574
Control.ERR205724;71;59;0.394366197183099;43;28;0.105633802816901;0.394366197183099
Control.ERR205724;65;59;0.476923076923077;34;31;0.0230769230769231;0.476923076923077
Control.ERR205724;64;59;0.5625;28;36;0.0625;0.4375
Control.ERR205724;60;59;0.466666666666667;32;28;0.0333333333333333;0.466666666666667
Control.ERR205724;58;59;0.551724137931034;26;32;0.0517241379310345;0.448275862068966
Control.ERR205724;64;59;0.421875;37;27;0.078125;0.421875
Control.ERR205724;68;59;0.470588235294118;36;32;0.0294117647058824;0.470588235294118
Control.ERR205724;64;59;0.453125;35;29;0.046875;0.453125
Control.ERR205724;55;59;0.472727272727273;29;26;0.0272727272727273;0.472727272727273
Control.ERR205724;61;59;0.442622950819672;34;27;0.0573770491803279;0.442622950819672
Control.ERR205724;64;59;0.40625;38;26;0.09375;0.40625
Control.ERR205724;62;59;0.516129032258065;30;32;0.0161290322580645;0.483870967741935
Control.ERR205724;63;59;0.507936507936508;31;32;0.00793650793650791;0.492063492063492
Control.ERR205724;57;59;0.491228070175439;29;28;0.00877192982456143;0.491228070175439
Control.ERR205724;65;59;0.569230769230769;28;37;0.0692307692307692;0.430769230769231
Control.ERR205724;66;59;0.5;33;33;0;0.5
Control.ERR205724;56;59;0.535714285714286;26;30;0.0357142857142857;0.464285714285714
Control.ERR205724;61;59;0.508196721311475;30;31;0.00819672131147542;0.491803278688525
Control.ERR205724;62;59;0.451612903225806;34;28;0.0483870967741936;0.451612903225806
Control.ERR205724;64;59;0.40625;38;26;0.09375;0.40625
Control.ERR205724;66;59;0.5;33;33;0;0.5
Control.ERR205724;62;59;0.645161290322581;22;40;0.145161290322581;0.354838709677419
Control.ERR205724;61;59;0.475409836065574;32;29;0.0245901639344263;0.475409836065574
Control.ERR205724;60;59;0.516666666666667;29;31;0.0166666666666667;0.483333333333333
Control.ERR205724;68;59;0.529411764705882;32;36;0.0294117647058824;0.470588235294118
Control.ERR205724;68;59;0.470588235294118;36;32;0.0294117647058824;0.470588235294118
Control.ERR205724;67;59;0.567164179104478;29;38;0.0671641791044776;0.432835820895522
Control.ERR205724;66;59;0.424242424242424;38;28;0.0757575757575757;0.424242424242424
Control.ERR205724;63;59;0.523809523809524;30;33;0.0238095238095238;0.476190476190476
Control.ERR205724;59;59;0.508474576271186;29;30;0.00847457627118642;0.491525423728814
Control.ERR205724;66;59;0.439393939393939;37;29;0.0606060606060606;0.439393939393939
Control.ERR205724;62;59;0.467741935483871;33;29;0.0322580645161291;0.467741935483871
Control.ERR205724;62;59;0.5;31;31;0;0.5
Control.ERR205724;55;59;0.6;22;33;0.1;0.4
Control.ERR205724;56;59;0.517857142857143;27;29;0.0178571428571429;0.482142857142857
Control.ERR205724;69;59;0.478260869565217;36;33;0.0217391304347826;0.478260869565217
Control.ERR205724;66;59;0.424242424242424;38;28;0.0757575757575757;0.424242424242424
Control.ERR205724;66;59;0.53030303030303;31;35;0.0303030303030303;0.46969696969697
Control.ERR205724;63;59;0.507936507936508;31;32;0.00793650793650791;0.492063492063492
Control.ERR205724;56;59;0.517857142857143;27;29;0.0178571428571429;0.482142857142857
Control.ERR205724;62;59;0.548387096774194;28;34;0.0483870967741935;0.451612903225806
Control.ERR205724;67;59;0.507462686567164;33;34;0.0074626865671642;0.492537313432836
Control.ERR205724;61;59;0.426229508196721;35;26;0.0737704918032787;0.426229508196721
Control.ERR205724;53;59;0.547169811320755;24;29;0.0471698113207547;0.452830188679245
Control.ERR205724;59;59;0.525423728813559;28;31;0.0254237288135594;0.474576271186441
Control.ERR205724;60;59;0.516666666666667;29;31;0.0166666666666667;0.483333333333333
Control.ERR205724;63;59;0.587301587301587;26;37;0.0873015873015873;0.412698412698413
Control.ERR205724;55;59;0.581818181818182;23;32;0.0818181818181818;0.418181818181818
Control.ERR205724;69;59;0.608695652173913;27;42;0.108695652173913;0.391304347826087
Control.ERR205724;59;59;0.525423728813559;28;31;0.0254237288135594;0.474576271186441
Control.ERR205724;63;59;0.476190476190476;33;30;0.0238095238095238;0.476190476190476
Control.ERR205724;69;59;0.434782608695652;39;30;0.0652173913043478;0.434782608695652
Control.ERR205724;68;59;0.573529411764706;29;39;0.0735294117647058;0.426470588235294
Control.ERR205724;65;59;0.415384615384615;38;27;0.0846153846153846;0.415384615384615
Control.ERR205724;61;59;0.409836065573771;36;25;0.0901639344262295;0.409836065573771
Control.ERR205724;59;59;0.440677966101695;33;26;0.0593220338983051;0.440677966101695
Control.ERR205724;64;59;0.4375;36;28;0.0625;0.4375
Control.ERR205724;71;59;0.563380281690141;31;40;0.0633802816901409;0.436619718309859
Control.ERR205724;68;59;0.455882352941176;37;31;0.0441176470588235;0.455882352941176
Control.ERR205724;66;59;0.545454545454545;30;36;0.0454545454545454;0.454545454545455
Control.ERR205724;62;59;0.467741935483871;33;29;0.0322580645161291;0.467741935483871
Control.ERR205724;65;59;0.4;39;26;0.1;0.4
Control.ERR205724;61;59;0.475409836065574;32;29;0.0245901639344263;0.475409836065574
Control.ERR205724;71;59;0.436619718309859;40;31;0.0633802816901409;0.436619718309859
Control.ERR205724;66;59;0.439393939393939;37;29;0.0606060606060606;0.439393939393939
Control.ERR205724;58;59;0.46551724137931;31;27;0.0344827586206897;0.46551724137931
Control.ERR205724;67;59;0.626865671641791;25;42;0.126865671641791;0.373134328358209
Control.ERR205724;67;59;0.432835820895522;38;29;0.0671641791044776;0.432835820895522
Control.ERR205724;63;59;0.492063492063492;32;31;0.00793650793650796;0.492063492063492
Control.ERR205724;62;59;0.419354838709677;36;26;0.0806451612903226;0.419354838709677
Control.ERR205724;65;59;0.507692307692308;32;33;0.00769230769230766;0.492307692307692
Control.ERR205724;66;59;0.560606060606061;29;37;0.0606060606060606;0.439393939393939
Control.ERR205724;69;59;0.478260869565217;36;33;0.0217391304347826;0.478260869565217
Control.ERR205724;62;59;0.596774193548387;25;37;0.0967741935483871;0.403225806451613
Control.ERR205724;63;59;0.619047619047619;24;39;0.119047619047619;0.380952380952381
Control.ERR205724;65;59;0.461538461538462;35;30;0.0384615384615384;0.461538461538462
Control.ERR205724;62;59;0.596774193548387;25;37;0.0967741935483871;0.403225806451613
Control.ERR205724;68;59;0.529411764705882;32;36;0.0294117647058824;0.470588235294118
Control.ERR205724;60;59;0.433333333333333;34;26;0.0666666666666667;0.433333333333333
Control.ERR205724;70;59;0.542857142857143;32;38;0.0428571428571428;0.457142857142857
Control.ERR205724;56;59;0.553571428571429;25;31;0.0535714285714286;0.446428571428571
Control.ERR205724;60;59;0.583333333333333;25;35;0.0833333333333334;0.416666666666667
Control.ERR205724;61;59;0.377049180327869;38;23;0.122950819672131;0.377049180327869
Control.ERR205724;54;59;0.518518518518518;26;28;0.0185185185185185;0.481481481481481
Control.ERR205724;63;59;0.507936507936508;31;32;0.00793650793650791;0.492063492063492
Control.ERR205724;57;59;0.578947368421053;24;33;0.0789473684210527;0.421052631578947
Control.ERR205724;68;59;0.485294117647059;35;33;0.0147058823529412;0.485294117647059
Control.ERR205724;68;59;0.588235294117647;28;40;0.0882352941176471;0.411764705882353
Control.ERR205724;62;59;0.387096774193548;38;24;0.112903225806452;0.387096774193548
Control.ERR205724;70;59;0.457142857142857;38;32;0.0428571428571429;0.457142857142857
Control.ERR205724;71;59;0.535211267605634;33;38;0.0352112676056338;0.464788732394366
Control.ERR205724;61;59;0.426229508196721;35;26;0.0737704918032787;0.426229508196721
Control.ERR205724;60;59;0.466666666666667;32;28;0.0333333333333333;0.466666666666667
Control.ERR205724;61;59;0.459016393442623;33;28;0.040983606557377;0.459016393442623
Control.ERR205724;66;59;0.590909090909091;27;39;0.0909090909090909;0.409090909090909
Control.ERR205724;54;59;0.592592592592593;22;32;0.0925925925925926;0.407407407407407
Control.ERR205724;60;59;0.516666666666667;29;31;0.0166666666666667;0.483333333333333
Control.ERR205724;58;59;0.586206896551724;24;34;0.0862068965517241;0.413793103448276
Control.ERR205724;59;59;0.491525423728814;30;29;0.00847457627118642;0.491525423728814
Control.ERR205724;54;59;0.425925925925926;31;23;0.0740740740740741;0.425925925925926
Control.ERR205724;56;59;0.517857142857143;27;29;0.0178571428571429;0.482142857142857
Control.ERR205724;55;59;0.527272727272727;26;29;0.0272727272727272;0.472727272727273
Control.ERR205724;65;59;0.6;26;39;0.1;0.4
Control.ERR205724;57;59;0.56140350877193;25;32;0.0614035087719298;0.43859649122807
Control.ERR205724;60;59;0.533333333333333;28;32;0.0333333333333333;0.466666666666667
Control.ERR205724;61;59;0.590163934426229;25;36;0.0901639344262295;0.409836065573771
Control.ERR205724;57;59;0.473684210526316;30;27;0.0263157894736842;0.473684210526316
Control.ERR205724;65;59;0.384615384615385;40;25;0.115384615384615;0.384615384615385
Control.ERR205724;59;59;0.457627118644068;32;27;0.0423728813559322;0.457627118644068
Control.ERR205724;63;59;0.53968253968254;29;34;0.0396825396825397;0.46031746031746
Control.ERR205724;56;59;0.464285714285714;30;26;0.0357142857142857;0.464285714285714
Control.ERR205724;56;59;0.446428571428571;31;25;0.0535714285714285;0.446428571428571
Control.ERR205724;69;59;0.550724637681159;31;38;0.0507246376811594;0.449275362318841
Control.ERR205724;54;59;0.537037037037037;25;29;0.0370370370370371;0.462962962962963
Control.ERR205724;62;59;0.516129032258065;30;32;0.0161290322580645;0.483870967741935
Control.ERR205724;54;59;0.481481481481481;28;26;0.0185185185185185;0.481481481481481
Control.ERR205724;59;59;0.406779661016949;35;24;0.0932203389830508;0.406779661016949
Control.ERR205724;61;59;0.508196721311475;30;31;0.00819672131147542;0.491803278688525
Control.ERR205724;68;59;0.485294117647059;35;33;0.0147058823529412;0.485294117647059
Control.ERR205724;53;59;0.452830188679245;29;24;0.0471698113207547;0.452830188679245
Control.ERR205724;68;59;0.573529411764706;29;39;0.0735294117647058;0.426470588235294
Control.ERR205724;60;59;0.466666666666667;32;28;0.0333333333333333;0.466666666666667
Control.ERR205724;58;59;0.637931034482759;21;37;0.137931034482759;0.362068965517241
Control.ERR205724;63;59;0.650793650793651;22;41;0.150793650793651;0.349206349206349
Control.ERR205724;66;59;0.484848484848485;34;32;0.0151515151515151;0.484848484848485
Control.ERR205724;57;59;0.526315789473684;27;30;0.0263157894736842;0.473684210526316
Control.ERR205724;62;59;0.483870967741935;32;30;0.0161290322580645;0.483870967741935
Control.ERR205724;61;59;0.540983606557377;28;33;0.0409836065573771;0.459016393442623
Control.ERR205724;68;59;0.529411764705882;32;36;0.0294117647058824;0.470588235294118
Control.ERR205724;63;59;0.507936507936508;31;32;0.00793650793650791;0.492063492063492
Control.ERR205724;71;59;0.47887323943662;37;34;0.0211267605633803;0.47887323943662
Control.ERR205724;61;59;0.557377049180328;27;34;0.0573770491803278;0.442622950819672
Control.ERR205724;58;59;0.517241379310345;28;30;0.0172413793103449;0.482758620689655
Control.ERR205724;62;59;0.612903225806452;24;38;0.112903225806452;0.387096774193548
Control.ERR205724;67;59;0.611940298507463;26;41;0.111940298507463;0.388059701492537
Control.ERR205724;53;59;0.509433962264151;26;27;0.00943396226415094;0.490566037735849
Control.ERR205724;53;59;0.490566037735849;27;26;0.00943396226415094;0.490566037735849
Control.ERR205724;61;59;0.491803278688525;31;30;0.00819672131147542;0.491803278688525
Control.ERR205724;66;59;0.393939393939394;40;26;0.106060606060606;0.393939393939394
Control.ERR205724;68;59;0.470588235294118;36;32;0.0294117647058824;0.470588235294118
Control.ERR205724;71;59;0.591549295774648;29;42;0.0915492957746479;0.408450704225352
Control.ERR205724;65;59;0.476923076923077;34;31;0.0230769230769231;0.476923076923077
Control.ERR205724;64;59;0.515625;31;33;0.015625;0.484375
Control.ERR205724;69;59;0.536231884057971;32;37;0.0362318840579711;0.463768115942029
Control.ERR205724;58;59;0.517241379310345;28;30;0.0172413793103449;0.482758620689655
Control.ERR205724;59;59;0.355932203389831;38;21;0.144067796610169;0.355932203389831
Control.ERR205724;55;59;0.545454545454545;25;30;0.0454545454545454;0.454545454545455
Control.ERR205724;59;59;0.440677966101695;33;26;0.0593220338983051;0.440677966101695
Control.ERR205724;64;59;0.453125;35;29;0.046875;0.453125
Control.ERR205724;62;59;0.564516129032258;27;35;0.0645161290322581;0.435483870967742
Control.ERR205724;63;59;0.380952380952381;39;24;0.119047619047619;0.380952380952381
Control.ERR205724;56;59;0.571428571428571;24;32;0.0714285714285714;0.428571428571429
Control.ERR205724;59;59;0.508474576271186;29;30;0.00847457627118642;0.491525423728814
Control.ERR205724;59;59;0.474576271186441;31;28;0.0254237288135593;0.474576271186441
Control.ERR205724;61;59;0.459016393442623;33;28;0.040983606557377;0.459016393442623
Control.ERR205724;53;59;0.471698113207547;28;25;0.0283018867924528;0.471698113207547
Control.ERR205724;64;59;0.515625;31;33;0.015625;0.484375
Control.ERR205724;62;59;0.387096774193548;38;24;0.112903225806452;0.387096774193548
Control.ERR205724;62;59;0.580645161290323;26;36;0.0806451612903226;0.419354838709677
Control.ERR205724;56;59;0.464285714285714;30;26;0.0357142857142857;0.464285714285714
Control.ERR205724;58;59;0.517241379310345;28;30;0.0172413793103449;0.482758620689655
Control.ERR205724;67;59;0.552238805970149;30;37;0.0522388059701493;0.447761194029851
Control.ERR205724;67;59;0.537313432835821;31;36;0.0373134328358209;0.462686567164179
Control.ERR205724;54;59;0.425925925925926;31;23;0.0740740740740741;0.425925925925926
Control.ERR205724;69;59;0.623188405797101;26;43;0.123188405797101;0.376811594202899
Control.ERR205724;64;59;0.53125;30;34;0.03125;0.46875
Control.ERR205724;64;59;0.53125;30;34;0.03125;0.46875
Control.ERR205724;61;59;0.540983606557377;28;33;0.0409836065573771;0.459016393442623
Control.ERR205724;61;59;0.508196721311475;30;31;0.00819672131147542;0.491803278688525
Control.ERR205724;58;59;0.482758620689655;30;28;0.0172413793103448;0.482758620689655
Control.ERR205724;58;59;0.517241379310345;28;30;0.0172413793103449;0.482758620689655
Control.ERR205724;64;59;0.484375;33;31;0.015625;0.484375
Control.ERR205724;58;59;0.482758620689655;30;28;0.0172413793103448;0.482758620689655
Control.ERR205724;60;59;0.4;36;24;0.1;0.4
Control.ERR205724;57;59;0.456140350877193;31;26;0.043859649122807;0.456140350877193
Control.ERR205724;61;59;0.508196721311475;30;31;0.00819672131147542;0.491803278688525
Control.ERR205724;60;59;0.566666666666667;26;34;0.0666666666666667;0.433333333333333
Control.ERR205724;67;59;0.597014925373134;27;40;0.0970149253731343;0.402985074626866
Control.ERR205724;63;59;0.476190476190476;33;30;0.0238095238095238;0.476190476190476
Control.ERR205724;57;59;0.543859649122807;26;31;0.043859649122807;0.456140350877193
Control.ERR205724;54;59;0.481481481481481;28;26;0.0185185185185185;0.481481481481481
Control.ERR205724;68;59;0.529411764705882;32;36;0.0294117647058824;0.470588235294118
Control.ERR205724;70;59;0.385714285714286;43;27;0.114285714285714;0.385714285714286
Control.ERR205724;56;59;0.446428571428571;31;25;0.0535714285714285;0.446428571428571
Control.ERR205724;56;59;0.428571428571429;32;24;0.0714285714285715;0.428571428571429
Control.ERR205724;64;59;0.5;32;32;0;0.5
Control.ERR205724;65;59;0.492307692307692;33;32;0.00769230769230766;0.492307692307692
Control.ERR205724;69;59;0.420289855072464;40;29;0.0797101449275363;0.420289855072464
Control.ERR205724;57;59;0.56140350877193;25;32;0.0614035087719298;0.43859649122807
Control.ERR205724;55;59;0.545454545454545;25;30;0.0454545454545454;0.454545454545455
Control.ERR205724;63;59;0.476190476190476;33;30;0.0238095238095238;0.476190476190476
Control.ERR205724;69;59;0.434782608695652;39;30;0.0652173913043478;0.434782608695652
Control.ERR205724;56;59;0.625;21;35;0.125;0.375
Control.ERR205724;58;59;0.620689655172414;22;36;0.120689655172414;0.379310344827586
Control.ERR205724;55;59;0.436363636363636;31;24;0.0636363636363637;0.436363636363636
Control.ERR205724;65;59;0.507692307692308;32;33;0.00769230769230766;0.492307692307692
Control.ERR205724;58;59;0.517241379310345;28;30;0.0172413793103449;0.482758620689655
Control.ERR205724;54;59;0.444444444444444;30;24;0.0555555555555556;0.444444444444444
Control.ERR205724;56;59;0.517857142857143;27;29;0.0178571428571429;0.482142857142857
Control.ERR205724;61;59;0.475409836065574;32;29;0.0245901639344263;0.475409836065574
Control.ERR205724;66;59;0.5;33;33;0;0.5
Control.ERR205724;56;59;0.482142857142857;29;27;0.0178571428571428;0.482142857142857
Control.ERR205724;62;59;0.532258064516129;29;33;0.032258064516129;0.467741935483871
Control.ERR205724;69;59;0.434782608695652;39;30;0.0652173913043478;0.434782608695652
Control.ERR205724;63;59;0.492063492063492;32;31;0.00793650793650796;0.492063492063492
Control.ERR205724;63;59;0.555555555555556;28;35;0.0555555555555556;0.444444444444444
Control.ERR205724;59;59;0.508474576271186;29;30;0.00847457627118642;0.491525423728814
Control.ERR205724;57;59;0.491228070175439;29;28;0.00877192982456143;0.491228070175439
Control.ERR205724;64;59;0.46875;34;30;0.03125;0.46875
Control.ERR205724;63;59;0.428571428571429;36;27;0.0714285714285715;0.428571428571429
Control.ERR205724;60;59;0.516666666666667;29;31;0.0166666666666667;0.483333333333333
Control.ERR205724;64;59;0.546875;29;35;0.046875;0.453125
Control.ERR205724;59;59;0.559322033898305;26;33;0.059322033898305;0.440677966101695
Control.ERR205724;63;59;0.523809523809524;30;33;0.0238095238095238;0.476190476190476
Control.ERR205724;60;59;0.516666666666667;29;31;0.0166666666666667;0.483333333333333
Control.ERR205724;70;59;0.442857142857143;39;31;0.0571428571428572;0.442857142857143
Control.ERR205724;55;59;0.454545454545455;30;25;0.0454545454545455;0.454545454545455
Control.ERR205724;53;59;0.433962264150943;30;23;0.0660377358490566;0.433962264150943
Control.ERR205724;53;59;0.566037735849057;23;30;0.0660377358490566;0.433962264150943
Control.ERR205724;61;59;0.508196721311475;30;31;0.00819672131147542;0.491803278688525
Control.ERR205724;62;59;0.387096774193548;38;24;0.112903225806452;0.387096774193548
Control.ERR205724;65;59;0.553846153846154;29;36;0.0538461538461539;0.446153846153846
Control.ERR205724;63;59;0.571428571428571;27;36;0.0714285714285714;0.428571428571429
Control.ERR205724;68;59;0.514705882352941;33;35;0.0147058823529411;0.485294117647059
Control.ERR205724;60;59;0.45;33;27;0.05;0.45
Control.ERR205724;61;59;0.508196721311475;30;31;0.00819672131147542;0.491803278688525
Control.ERR205724;64;59;0.4375;36;28;0.0625;0.4375
Control.ERR205724;59;59;0.474576271186441;31;28;0.0254237288135593;0.474576271186441
Control.ERR205724;60;59;0.416666666666667;35;25;0.0833333333333333;0.416666666666667
Control.ERR205724;66;59;0.53030303030303;31;35;0.0303030303030303;0.46969696969697
Control.ERR205724;66;59;0.424242424242424;38;28;0.0757575757575757;0.424242424242424
Control.ERR205724;71;59;0.366197183098592;45;26;0.133802816901408;0.366197183098592
Control.ERR205724;67;59;0.388059701492537;41;26;0.111940298507463;0.388059701492537
Control.ERR205724;61;59;0.475409836065574;32;29;0.0245901639344263;0.475409836065574
Control.ERR205724;59;59;0.440677966101695;33;26;0.0593220338983051;0.440677966101695
Control.ERR205724;61;59;0.590163934426229;25;36;0.0901639344262295;0.409836065573771
Control.ERR205724;60;59;0.466666666666667;32;28;0.0333333333333333;0.466666666666667
Control.ERR205724;70;59;0.442857142857143;39;31;0.0571428571428572;0.442857142857143
Control.ERR205724;58;59;0.448275862068966;32;26;0.0517241379310345;0.448275862068966
Control.ERR205724;60;59;0.533333333333333;28;32;0.0333333333333333;0.466666666666667
Control.ERR205724;57;59;0.614035087719298;22;35;0.114035087719298;0.385964912280702
Control.ERR205724;60;59;0.5;30;30;0;0.5
Control.ERR205724;69;59;0.521739130434783;33;36;0.0217391304347826;0.478260869565217
Control.ERR205724;60;59;0.483333333333333;31;29;0.0166666666666667;0.483333333333333
Control.ERR205724;62;59;0.483870967741935;32;30;0.0161290322580645;0.483870967741935
Control.ERR205724;60;59;0.5;30;30;0;0.5
Control.ERR205724;58;59;0.53448275862069;27;31;0.0344827586206896;0.46551724137931
Control.ERR205724;66;59;0.454545454545455;36;30;0.0454545454545455;0.454545454545455
Control.ERR205724;71;59;0.563380281690141;31;40;0.0633802816901409;0.436619718309859
Control.ERR205724;55;59;0.563636363636364;24;31;0.0636363636363636;0.436363636363636
Control.ERR205724;67;59;0.447761194029851;37;30;0.0522388059701492;0.447761194029851
Control.ERR205724;64;59;0.53125;30;34;0.03125;0.46875
Control.ERR205724;62;59;0.5;31;31;0;0.5
Control.ERR205724;71;59;0.492957746478873;36;35;0.00704225352112675;0.492957746478873
Control.ERR205724;68;59;0.308823529411765;47;21;0.191176470588235;0.308823529411765
Control.ERR205724;62;59;0.645161290322581;22;40;0.145161290322581;0.354838709677419
Control.ERR205724;55;59;0.527272727272727;26;29;0.0272727272727272;0.472727272727273
Control.ERR205724;62;59;0.5;31;31;0;0.5
Control.ERR205724;52;59;0.5;26;26;0;0.5
Control.ERR205724;57;59;0.456140350877193;31;26;0.043859649122807;0.456140350877193
Control.ERR205724;60;59;0.466666666666667;32;28;0.0333333333333333;0.466666666666667
Control.ERR205724;51;59;0.529411764705882;24;27;0.0294117647058824;0.470588235294118
Control.ERR205724;58;59;0.5;29;29;0;0.5
Control.ERR205724;62;59;0.516129032258065;30;32;0.0161290322580645;0.483870967741935
Control.ERR205724;58;59;0.53448275862069;27;31;0.0344827586206896;0.46551724137931
Control.ERR205724;61;59;0.524590163934426;29;32;0.0245901639344263;0.475409836065574
Control.ERR205724;64;59;0.390625;39;25;0.109375;0.390625
Control.ERR205724;58;59;0.53448275862069;27;31;0.0344827586206896;0.46551724137931
Control.ERR205724;62;59;0.645161290322581;22;40;0.145161290322581;0.354838709677419
Control.ERR205724;64;59;0.53125;30;34;0.03125;0.46875
Control.ERR205724;51;59;0.450980392156863;28;23;0.0490196078431372;0.450980392156863
Control.ERR205724;63;59;0.523809523809524;30;33;0.0238095238095238;0.476190476190476
Control.ERR205724;63;59;0.53968253968254;29;34;0.0396825396825397;0.46031746031746
Control.ERR205724;52;59;0.423076923076923;30;22;0.0769230769230769;0.423076923076923
Control.ERR205724;54;59;0.444444444444444;30;24;0.0555555555555556;0.444444444444444
Control.ERR205724;54;59;0.5;27;27;0;0.5
Control.ERR205724;60;59;0.45;33;27;0.05;0.45
Control.ERR205724;56;59;0.553571428571429;25;31;0.0535714285714286;0.446428571428571
Control.ERR205724;49;59;0.571428571428571;21;28;0.0714285714285714;0.428571428571429
Control.ERR205724;51;59;0.431372549019608;29;22;0.0686274509803921;0.431372549019608
Control.ERR205724;60;59;0.533333333333333;28;32;0.0333333333333333;0.466666666666667
Control.ERR205724;58;59;0.413793103448276;34;24;0.0862068965517241;0.413793103448276
Control.ERR205724;53;59;0.433962264150943;30;23;0.0660377358490566;0.433962264150943
Control.ERR205724;57;59;0.473684210526316;30;27;0.0263157894736842;0.473684210526316
Control.ERR205724;54;59;0.481481481481481;28;26;0.0185185185185185;0.481481481481481
Control.ERR205724;60;59;0.466666666666667;32;28;0.0333333333333333;0.466666666666667
Control.ERR205724;62;59;0.564516129032258;27;35;0.0645161290322581;0.435483870967742
Control.ERR205724;62;59;0.451612903225806;34;28;0.0483870967741936;0.451612903225806
Control.ERR205724;63;59;0.571428571428571;27;36;0.0714285714285714;0.428571428571429
Control.ERR205724;57;59;0.43859649122807;32;25;0.0614035087719298;0.43859649122807
Control.ERR205724;54;59;0.5;27;27;0;0.5
Control.ERR205724;55;59;0.454545454545455;30;25;0.0454545454545455;0.454545454545455
Control.ERR205724;63;59;0.412698412698413;37;26;0.0873015873015873;0.412698412698413
Control.ERR205724;53;59;0.622641509433962;20;33;0.122641509433962;0.377358490566038
Control.ERR205724;51;59;0.392156862745098;31;20;0.107843137254902;0.392156862745098
Control.ERR205724;56;59;0.446428571428571;31;25;0.0535714285714285;0.446428571428571
Control.ERR205724;53;59;0.547169811320755;24;29;0.0471698113207547;0.452830188679245
Control.ERR205724;53;59;0.433962264150943;30;23;0.0660377358490566;0.433962264150943
Control.ERR205724;52;59;0.596153846153846;21;31;0.0961538461538461;0.403846153846154
Control.ERR205724;65;59;0.523076923076923;31;34;0.0230769230769231;0.476923076923077
Control.ERR205724;65;59;0.492307692307692;33;32;0.00769230769230766;0.492307692307692
Control.ERR205724;60;59;0.55;27;33;0.05;0.45
Control.ERR205724;59;59;0.559322033898305;26;33;0.059322033898305;0.440677966101695
Control.ERR205724;55;59;0.581818181818182;23;32;0.0818181818181818;0.418181818181818
Control.ERR205724;63;59;0.507936507936508;31;32;0.00793650793650791;0.492063492063492
Control.ERR205724;62;59;0.5;31;31;0;0.5
Control.ERR205724;54;59;0.537037037037037;25;29;0.0370370370370371;0.462962962962963
Control.ERR205724;55;59;0.472727272727273;29;26;0.0272727272727273;0.472727272727273
Control.ERR205724;60;59;0.35;39;21;0.15;0.35
Control.ERR205724;53;59;0.433962264150943;30;23;0.0660377358490566;0.433962264150943
Control.ERR205724;54;59;0.537037037037037;25;29;0.0370370370370371;0.462962962962963
Control.ERR205724;62;59;0.532258064516129;29;33;0.032258064516129;0.467741935483871
Control.ERR205724;53;59;0.60377358490566;21;32;0.10377358490566;0.39622641509434
Control.ERR205724;56;59;0.464285714285714;30;26;0.0357142857142857;0.464285714285714
Control.ERR205724;55;59;0.509090909090909;27;28;0.00909090909090904;0.490909090909091
Control.ERR205724;53;59;0.415094339622642;31;22;0.0849056603773585;0.415094339622642
Control.ERR205724;55;59;0.509090909090909;27;28;0.00909090909090904;0.490909090909091
Control.ERR205724;51;59;0.686274509803922;16;35;0.186274509803922;0.313725490196078
Control.ERR205724;54;59;0.444444444444444;30;24;0.0555555555555556;0.444444444444444
Control.ERR205724;50;59;0.42;29;21;0.08;0.42
Control.ERR205724;61;59;0.377049180327869;38;23;0.122950819672131;0.377049180327869
Control.ERR205724;62;59;0.516129032258065;30;32;0.0161290322580645;0.483870967741935
Control.ERR205724;54;59;0.407407407407407;32;22;0.0925925925925926;0.407407407407407
Control.ERR205724;51;59;0.529411764705882;24;27;0.0294117647058824;0.470588235294118
Control.ERR205724;53;59;0.471698113207547;28;25;0.0283018867924528;0.471698113207547
Control.ERR205724;54;59;0.574074074074074;23;31;0.0740740740740741;0.425925925925926
Control.ERR205724;62;59;0.580645161290323;26;36;0.0806451612903226;0.419354838709677
Control.ERR205724;61;59;0.540983606557377;28;33;0.0409836065573771;0.459016393442623
Control.ERR205724;59;59;0.491525423728814;30;29;0.00847457627118642;0.491525423728814
Control.ERR205724;52;59;0.596153846153846;21;31;0.0961538461538461;0.403846153846154
Control.ERR205724;50;59;0.3;35;15;0.2;0.3
Control.ERR205724;53;59;0.452830188679245;29;24;0.0471698113207547;0.452830188679245
Control.ERR205724;57;59;0.526315789473684;27;30;0.0263157894736842;0.473684210526316
Control.ERR205724;59;59;0.576271186440678;25;34;0.076271186440678;0.423728813559322
Control.ERR205724;57;59;0.385964912280702;35;22;0.114035087719298;0.385964912280702
Control.ERR205724;61;59;0.475409836065574;32;29;0.0245901639344263;0.475409836065574
Control.ERR205724;58;59;0.482758620689655;30;28;0.0172413793103448;0.482758620689655
Control.ERR205724;49;59;0.591836734693878;20;29;0.0918367346938775;0.408163265306122
Control.ERR205724;60;59;0.45;33;27;0.05;0.45
Control.ERR205724;50;59;0.42;29;21;0.08;0.42
Control.ERR205724;64;59;0.53125;30;34;0.03125;0.46875
Control.ERR205724;60;59;0.533333333333333;28;32;0.0333333333333333;0.466666666666667
Control.ERR205724;65;59;0.553846153846154;29;36;0.0538461538461539;0.446153846153846
Control.ERR205724;61;59;0.557377049180328;27;34;0.0573770491803278;0.442622950819672
Control.ERR205724;63;59;0.492063492063492;32;31;0.00793650793650796;0.492063492063492
Control.ERR205724;64;59;0.453125;35;29;0.046875;0.453125
Control.ERR205724;60;59;0.616666666666667;23;37;0.116666666666667;0.383333333333333
Control.ERR205724;54;59;0.462962962962963;29;25;0.037037037037037;0.462962962962963
Control.ERR205724;62;59;0.516129032258065;30;32;0.0161290322580645;0.483870967741935
Control.ERR205724;56;59;0.357142857142857;36;20;0.142857142857143;0.357142857142857
Control.ERR205724;51;59;0.627450980392157;19;32;0.127450980392157;0.372549019607843
Control.ERR205724;57;59;0.421052631578947;33;24;0.0789473684210527;0.421052631578947
Control.ERR205724;63;59;0.571428571428571;27;36;0.0714285714285714;0.428571428571429
Control.ERR205724;56;59;0.464285714285714;30;26;0.0357142857142857;0.464285714285714
Control.ERR205724;65;59;0.523076923076923;31;34;0.0230769230769231;0.476923076923077
Control.ERR205724;58;59;0.637931034482759;21;37;0.137931034482759;0.362068965517241
Control.ERR205724;54;59;0.518518518518518;26;28;0.0185185185185185;0.481481481481481
Control.ERR205724;65;59;0.569230769230769;28;37;0.0692307692307692;0.430769230769231
Control.ERR205724;55;59;0.527272727272727;26;29;0.0272727272727272;0.472727272727273
Control.ERR205724;59;59;0.440677966101695;33;26;0.0593220338983051;0.440677966101695
Control.ERR205724;58;59;0.448275862068966;32;26;0.0517241379310345;0.448275862068966
Control.ERR205724;65;59;0.507692307692308;32;33;0.00769230769230766;0.492307692307692
Control.ERR205724;57;59;0.456140350877193;31;26;0.043859649122807;0.456140350877193
Control.ERR205724;51;59;0.450980392156863;28;23;0.0490196078431372;0.450980392156863
Control.ERR205724;57;59;0.543859649122807;26;31;0.043859649122807;0.456140350877193
Control.ERR205724;51;59;0.490196078431373;26;25;0.00980392156862747;0.490196078431373
Control.ERR205724;60;59;0.616666666666667;23;37;0.116666666666667;0.383333333333333
Control.ERR205724;58;59;0.396551724137931;35;23;0.103448275862069;0.396551724137931
Control.ERR205724;50;59;0.4;30;20;0.1;0.4
Control.ERR205724;57;59;0.526315789473684;27;30;0.0263157894736842;0.473684210526316
Control.ERR205724;60;59;0.6;24;36;0.1;0.4
Control.ERR205724;56;59;0.589285714285714;23;33;0.0892857142857143;0.410714285714286
Control.ERR205724;59;59;0.593220338983051;24;35;0.0932203389830508;0.406779661016949
Control.ERR205724;49;59;0.510204081632653;24;25;0.0102040816326531;0.489795918367347
Control.ERR205724;54;59;0.407407407407407;32;22;0.0925925925925926;0.407407407407407
Control.ERR205724;54;59;0.388888888888889;33;21;0.111111111111111;0.388888888888889
Control.ERR205724;64;59;0.484375;33;31;0.015625;0.484375
Control.ERR205724;53;59;0.490566037735849;27;26;0.00943396226415094;0.490566037735849
Control.ERR205724;49;59;0.571428571428571;21;28;0.0714285714285714;0.428571428571429
Control.ERR205724;51;59;0.509803921568627;25;26;0.00980392156862742;0.490196078431373
Control.ERR205724;53;59;0.60377358490566;21;32;0.10377358490566;0.39622641509434
Control.ERR205724;53;59;0.566037735849057;23;30;0.0660377358490566;0.433962264150943
Control.ERR205724;61;59;0.540983606557377;28;33;0.0409836065573771;0.459016393442623
Control.ERR205724;55;59;0.563636363636364;24;31;0.0636363636363636;0.436363636363636
Control.ERR205724;62;59;0.403225806451613;37;25;0.0967741935483871;0.403225806451613
Control.ERR205724;56;59;0.553571428571429;25;31;0.0535714285714286;0.446428571428571
Control.ERR205724;65;59;0.415384615384615;38;27;0.0846153846153846;0.415384615384615
Control.ERR205724;57;59;0.526315789473684;27;30;0.0263157894736842;0.473684210526316
Control.ERR205724;60;59;0.5;30;30;0;0.5
Control.ERR205724;64;59;0.40625;38;26;0.09375;0.40625
Control.ERR205724;57;59;0.543859649122807;26;31;0.043859649122807;0.456140350877193
Control.ERR205724;59;59;0.576271186440678;25;34;0.076271186440678;0.423728813559322
Control.ERR205724;62;59;0.5;31;31;0;0.5
Control.ERR205724;50;59;0.52;24;26;0.02;0.48
Control.ERR205724;49;59;0.489795918367347;25;24;0.0102040816326531;0.489795918367347
Control.ERR205724;50;59;0.58;21;29;0.08;0.42
Control.ERR205724;51;59;0.509803921568627;25;26;0.00980392156862742;0.490196078431373
Control.ERR205724;55;59;0.436363636363636;31;24;0.0636363636363637;0.436363636363636
Control.ERR205724;63;59;0.555555555555556;28;35;0.0555555555555556;0.444444444444444
Control.ERR205724;56;59;0.535714285714286;26;30;0.0357142857142857;0.464285714285714
Control.ERR205724;55;59;0.581818181818182;23;32;0.0818181818181818;0.418181818181818
Control.ERR205724;57;59;0.56140350877193;25;32;0.0614035087719298;0.43859649122807
Control.ERR205724;63;59;0.428571428571429;36;27;0.0714285714285715;0.428571428571429
Control.ERR205724;65;59;0.584615384615385;27;38;0.0846153846153846;0.415384615384615
Control.ERR205724;57;59;0.543859649122807;26;31;0.043859649122807;0.456140350877193
Control.ERR205724;60;59;0.55;27;33;0.05;0.45
Control.ERR205724;58;59;0.586206896551724;24;34;0.0862068965517241;0.413793103448276
Control.ERR205724;56;59;0.553571428571429;25;31;0.0535714285714286;0.446428571428571
Control.ERR205724;57;59;0.526315789473684;27;30;0.0263157894736842;0.473684210526316
Control.ERR205724;61;59;0.442622950819672;34;27;0.0573770491803279;0.442622950819672
Control.ERR205724;59;59;0.474576271186441;31;28;0.0254237288135593;0.474576271186441
Control.ERR205724;54;59;0.555555555555556;24;30;0.0555555555555556;0.444444444444444
Control.ERR205724;50;59;0.42;29;21;0.08;0.42
Control.ERR205724;61;59;0.295081967213115;43;18;0.204918032786885;0.295081967213115
Control.ERR205724;54;59;0.462962962962963;29;25;0.037037037037037;0.462962962962963
Control.ERR205724;56;59;0.535714285714286;26;30;0.0357142857142857;0.464285714285714
Control.ERR205724;53;59;0.490566037735849;27;26;0.00943396226415094;0.490566037735849
Control.ERR205724;60;59;0.466666666666667;32;28;0.0333333333333333;0.466666666666667
Control.ERR205724;55;59;0.454545454545455;30;25;0.0454545454545455;0.454545454545455
Control.ERR205724;62;59;0.451612903225806;34;28;0.0483870967741936;0.451612903225806
Control.ERR205724;55;59;0.490909090909091;28;27;0.00909090909090909;0.490909090909091
Control.ERR205724;56;59;0.428571428571429;32;24;0.0714285714285715;0.428571428571429
Control.ERR205724;57;59;0.473684210526316;30;27;0.0263157894736842;0.473684210526316
Control.ERR205724;54;59;0.462962962962963;29;25;0.037037037037037;0.462962962962963
Control.ERR205724;60;59;0.533333333333333;28;32;0.0333333333333333;0.466666666666667
Control.ERR205724;57;59;0.43859649122807;32;25;0.0614035087719298;0.43859649122807
Control.ERR205724;62;59;0.596774193548387;25;37;0.0967741935483871;0.403225806451613
Control.ERR205724;57;59;0.578947368421053;24;33;0.0789473684210527;0.421052631578947
Control.ERR205724;58;59;0.396551724137931;35;23;0.103448275862069;0.396551724137931
Control.ERR205724;55;59;0.454545454545455;30;25;0.0454545454545455;0.454545454545455
Control.ERR205724;51;59;0.431372549019608;29;22;0.0686274509803921;0.431372549019608
Control.ERR205724;59;59;0.525423728813559;28;31;0.0254237288135594;0.474576271186441
Control.ERR205724;51;59;0.450980392156863;28;23;0.0490196078431372;0.450980392156863
Control.ERR205724;54;59;0.5;27;27;0;0.5
Control.ERR205724;52;59;0.480769230769231;27;25;0.0192307692307692;0.480769230769231
Control.ERR205724;54;59;0.611111111111111;21;33;0.111111111111111;0.388888888888889
Control.ERR205724;55;59;0.581818181818182;23;32;0.0818181818181818;0.418181818181818
Control.ERR205724;59;59;0.508474576271186;29;30;0.00847457627118642;0.491525423728814
Control.ERR205724;61;59;0.459016393442623;33;28;0.040983606557377;0.459016393442623
Control.ERR205724;58;59;0.568965517241379;25;33;0.0689655172413793;0.431034482758621
Control.ERR205724;55;59;0.381818181818182;34;21;0.118181818181818;0.381818181818182
Control.ERR205724;64;59;0.46875;34;30;0.03125;0.46875
Control.ERR205724;61;59;0.590163934426229;25;36;0.0901639344262295;0.409836065573771
Control.ERR205724;57;59;0.456140350877193;31;26;0.043859649122807;0.456140350877193
Control.ERR205724;51;59;0.647058823529412;18;33;0.147058823529412;0.352941176470588
Control.ERR205724;58;59;0.586206896551724;24;34;0.0862068965517241;0.413793103448276
Control.ERR205724;58;59;0.620689655172414;22;36;0.120689655172414;0.379310344827586
Control.ERR205724;51;59;0.431372549019608;29;22;0.0686274509803921;0.431372549019608
Control.ERR205724;63;59;0.507936507936508;31;32;0.00793650793650791;0.492063492063492
Control.ERR205724;56;59;0.517857142857143;27;29;0.0178571428571429;0.482142857142857
Control.ERR205724;60;59;0.533333333333333;28;32;0.0333333333333333;0.466666666666667
Control.ERR205724;63;59;0.492063492063492;32;31;0.00793650793650796;0.492063492063492
Control.ERR205724;54;59;0.518518518518518;26;28;0.0185185185185185;0.481481481481481
Control.ERR205724;51;59;0.549019607843137;23;28;0.0490196078431373;0.450980392156863
Control.ERR205724;65;59;0.569230769230769;28;37;0.0692307692307692;0.430769230769231
Control.ERR205724;65;59;0.446153846153846;36;29;0.0538461538461538;0.446153846153846
Control.ERR205724;65;59;0.538461538461538;30;35;0.0384615384615384;0.461538461538462
Control.ERR205724;65;59;0.523076923076923;31;34;0.0230769230769231;0.476923076923077
Control.ERR205724;52;59;0.480769230769231;27;25;0.0192307692307692;0.480769230769231
Control.ERR205724;51;59;0.470588235294118;27;24;0.0294117647058824;0.470588235294118
Control.ERR205724;57;59;0.508771929824561;28;29;0.00877192982456143;0.491228070175439
Control.ERR205724;60;59;0.55;27;33;0.05;0.45
Control.ERR205724;58;59;0.53448275862069;27;31;0.0344827586206896;0.46551724137931
Control.ERR205724;51;59;0.450980392156863;28;23;0.0490196078431372;0.450980392156863
Control.ERR205724;51;59;0.529411764705882;24;27;0.0294117647058824;0.470588235294118
Control.ERR205724;55;59;0.490909090909091;28;27;0.00909090909090909;0.490909090909091
Control.ERR205724;59;59;0.457627118644068;32;27;0.0423728813559322;0.457627118644068
Control.ERR205724;57;59;0.526315789473684;27;30;0.0263157894736842;0.473684210526316
Control.ERR205724;59;59;0.440677966101695;33;26;0.0593220338983051;0.440677966101695
Control.ERR205724;54;59;0.62962962962963;20;34;0.12962962962963;0.37037037037037
Control.ERR205724;57;59;0.421052631578947;33;24;0.0789473684210527;0.421052631578947
Control.ERR205724;59;59;0.508474576271186;29;30;0.00847457627118642;0.491525423728814
Control.ERR205724;59;59;0.542372881355932;27;32;0.0423728813559322;0.457627118644068
Control.ERR205724;59;59;0.457627118644068;32;27;0.0423728813559322;0.457627118644068
Control.ERR205724;63;59;0.46031746031746;34;29;0.0396825396825397;0.46031746031746
Control.ERR205724;65;59;0.538461538461538;30;35;0.0384615384615384;0.461538461538462
Control.ERR205724;57;59;0.473684210526316;30;27;0.0263157894736842;0.473684210526316
Control.ERR205724;61;59;0.524590163934426;29;32;0.0245901639344263;0.475409836065574
Control.ERR205724;61;59;0.557377049180328;27;34;0.0573770491803278;0.442622950819672
Control.ERR205724;60;59;0.483333333333333;31;29;0.0166666666666667;0.483333333333333
Control.ERR205724;52;59;0.615384615384615;20;32;0.115384615384615;0.384615384615385
Control.ERR205724;51;59;0.450980392156863;28;23;0.0490196078431372;0.450980392156863
Control.ERR205724;55;59;0.636363636363636;20;35;0.136363636363636;0.363636363636364
Control.ERR205724;55;59;0.454545454545455;30;25;0.0454545454545455;0.454545454545455
Control.ERR205724;50;59;0.48;26;24;0.02;0.48
Control.ERR205724;58;59;0.46551724137931;31;27;0.0344827586206897;0.46551724137931
Control.ERR205724;57;59;0.596491228070175;23;34;0.0964912280701754;0.403508771929825
Control.ERR205724;57;59;0.491228070175439;29;28;0.00877192982456143;0.491228070175439
Control.ERR205724;55;59;0.490909090909091;28;27;0.00909090909090909;0.490909090909091
Control.ERR205724;56;59;0.482142857142857;29;27;0.0178571428571428;0.482142857142857
Control.ERR205724;60;59;0.483333333333333;31;29;0.0166666666666667;0.483333333333333
Control.ERR205724;61;59;0.459016393442623;33;28;0.040983606557377;0.459016393442623
Control.ERR205724;53;59;0.622641509433962;20;33;0.122641509433962;0.377358490566038
Control.ERR205724;53;59;0.471698113207547;28;25;0.0283018867924528;0.471698113207547
Control.ERR205724;56;59;0.464285714285714;30;26;0.0357142857142857;0.464285714285714
Control.ERR205724;57;59;0.56140350877193;25;32;0.0614035087719298;0.43859649122807
Control.ERR205724;59;59;0.474576271186441;31;28;0.0254237288135593;0.474576271186441
Control.ERR205724;53;59;0.566037735849057;23;30;0.0660377358490566;0.433962264150943
Control.ERR205724;52;59;0.596153846153846;21;31;0.0961538461538461;0.403846153846154
Control.ERR205724;55;59;0.345454545454545;36;19;0.154545454545455;0.345454545454545
Control.ERR205724;60;59;0.483333333333333;31;29;0.0166666666666667;0.483333333333333
Control.ERR205724;56;59;0.535714285714286;26;30;0.0357142857142857;0.464285714285714
Control.ERR205724;52;59;0.461538461538462;28;24;0.0384615384615384;0.461538461538462
Control.ERR205724;63;59;0.444444444444444;35;28;0.0555555555555556;0.444444444444444
Control.ERR205724;54;59;0.555555555555556;24;30;0.0555555555555556;0.444444444444444
Control.ERR205724;52;59;0.480769230769231;27;25;0.0192307692307692;0.480769230769231
Control.ERR205724;64;59;0.578125;27;37;0.078125;0.421875
Control.ERR205724;55;59;0.527272727272727;26;29;0.0272727272727272;0.472727272727273
Control.ERR205724;61;59;0.508196721311475;30;31;0.00819672131147542;0.491803278688525
Control.ERR205724;53;59;0.547169811320755;24;29;0.0471698113207547;0.452830188679245
Control.ERR205724;59;59;0.525423728813559;28;31;0.0254237288135594;0.474576271186441
Control.ERR205724;55;59;0.563636363636364;24;31;0.0636363636363636;0.436363636363636
Control.ERR205724;54;59;0.444444444444444;30;24;0.0555555555555556;0.444444444444444
Control.ERR205724;53;59;0.377358490566038;33;20;0.122641509433962;0.377358490566038
Control.ERR205724;57;59;0.508771929824561;28;29;0.00877192982456143;0.491228070175439
Control.ERR205724;63;59;0.492063492063492;32;31;0.00793650793650796;0.492063492063492
Control.ERR205724;49;59;0.530612244897959;23;26;0.0306122448979592;0.469387755102041
Control.ERR205724;64;59;0.46875;34;30;0.03125;0.46875
Control.ERR205724;61;59;0.459016393442623;33;28;0.040983606557377;0.459016393442623
Control.ERR205724;50;59;0.62;19;31;0.12;0.38
Control.ERR205724;53;59;0.60377358490566;21;32;0.10377358490566;0.39622641509434
Control.ERR205724;58;59;0.413793103448276;34;24;0.0862068965517241;0.413793103448276
Control.ERR205724;64;59;0.390625;39;25;0.109375;0.390625
Control.ERR205724;62;59;0.5;31;31;0;0.5
Control.ERR205724;56;59;0.482142857142857;29;27;0.0178571428571428;0.482142857142857
Control.ERR205724;52;59;0.480769230769231;27;25;0.0192307692307692;0.480769230769231
Control.ERR205724;65;59;0.584615384615385;27;38;0.0846153846153846;0.415384615384615
Control.ERR205724;63;59;0.619047619047619;24;39;0.119047619047619;0.380952380952381
Control.ERR205724;59;59;0.508474576271186;29;30;0.00847457627118642;0.491525423728814
Control.ERR205724;55;59;0.436363636363636;31;24;0.0636363636363637;0.436363636363636
Control.ERR205724;63;59;0.412698412698413;37;26;0.0873015873015873;0.412698412698413
Control.ERR205724;54;59;0.537037037037037;25;29;0.0370370370370371;0.462962962962963
Control.ERR205724;55;59;0.472727272727273;29;26;0.0272727272727273;0.472727272727273
Control.ERR205724;56;59;0.428571428571429;32;24;0.0714285714285715;0.428571428571429
Control.ERR205724;49;59;0.469387755102041;26;23;0.0306122448979592;0.469387755102041
Control.ERR205724;54;59;0.5;27;27;0;0.5
Control.ERR205724;52;59;0.596153846153846;21;31;0.0961538461538461;0.403846153846154
Control.ERR205724;49;59;0.489795918367347;25;24;0.0102040816326531;0.489795918367347
Control.ERR205724;55;59;0.6;22;33;0.1;0.4
Control.ERR205724;53;59;0.490566037735849;27;26;0.00943396226415094;0.490566037735849
Control.ERR205724;58;59;0.448275862068966;32;26;0.0517241379310345;0.448275862068966
Control.ERR205724;53;59;0.471698113207547;28;25;0.0283018867924528;0.471698113207547
Control.ERR205724;51;59;0.450980392156863;28;23;0.0490196078431372;0.450980392156863
Control.ERR205724;54;59;0.481481481481481;28;26;0.0185185185185185;0.481481481481481
Control.ERR205724;55;59;0.472727272727273;29;26;0.0272727272727273;0.472727272727273
Control.ERR205724;49;59;0.387755102040816;30;19;0.112244897959184;0.387755102040816
Control.ERR205724;51;59;0.549019607843137;23;28;0.0490196078431373;0.450980392156863
Control.ERR205724;52;59;0.5;26;26;0;0.5
Control.ERR205724;54;59;0.518518518518518;26;28;0.0185185185185185;0.481481481481481
Control.ERR205724;55;59;0.363636363636364;35;20;0.136363636363636;0.363636363636364
Control.ERR205724;50;59;0.54;23;27;0.04;0.46
Control.ERR205724;50;59;0.58;21;29;0.08;0.42
Control.ERR205724;50;59;0.56;22;28;0.0600000000000001;0.44
Control.ERR205724;62;59;0.532258064516129;29;33;0.032258064516129;0.467741935483871
Control.ERR205724;64;59;0.484375;33;31;0.015625;0.484375
Control.ERR205724;56;59;0.446428571428571;31;25;0.0535714285714285;0.446428571428571
Control.ERR205724;57;59;0.578947368421053;24;33;0.0789473684210527;0.421052631578947
Control.ERR205724;49;59;0.469387755102041;26;23;0.0306122448979592;0.469387755102041
Control.ERR205724;57;59;0.508771929824561;28;29;0.00877192982456143;0.491228070175439
Control.ERR205724;59;59;0.406779661016949;35;24;0.0932203389830508;0.406779661016949
Control.ERR205724;57;59;0.403508771929825;34;23;0.0964912280701755;0.403508771929825
Control.ERR205724;54;59;0.462962962962963;29;25;0.037037037037037;0.462962962962963
Control.ERR205724;57;59;0.473684210526316;30;27;0.0263157894736842;0.473684210526316
Control.ERR205724;58;59;0.46551724137931;31;27;0.0344827586206897;0.46551724137931
Control.ERR205724;59;59;0.474576271186441;31;28;0.0254237288135593;0.474576271186441
Control.ERR205724;49;59;0.469387755102041;26;23;0.0306122448979592;0.469387755102041
Control.ERR205724;50;59;0.44;28;22;0.06;0.44
Control.ERR205724;56;59;0.464285714285714;30;26;0.0357142857142857;0.464285714285714
Control.ERR205724;60;59;0.466666666666667;32;28;0.0333333333333333;0.466666666666667
Control.ERR205724;57;59;0.526315789473684;27;30;0.0263157894736842;0.473684210526316
Control.ERR205724;56;59;0.607142857142857;22;34;0.107142857142857;0.392857142857143
Control.ERR205724;62;59;0.403225806451613;37;25;0.0967741935483871;0.403225806451613
Control.ERR205724;64;59;0.40625;38;26;0.09375;0.40625
Control.ERR205724;54;59;0.555555555555556;24;30;0.0555555555555556;0.444444444444444
Control.ERR205724;62;59;0.5;31;31;0;0.5
Control.ERR205724;59;59;0.610169491525424;23;36;0.110169491525424;0.389830508474576
Control.ERR205724;62;59;0.548387096774194;28;34;0.0483870967741935;0.451612903225806
Control.ERR205724;62;59;0.338709677419355;41;21;0.161290322580645;0.338709677419355
Control.ERR205724;57;59;0.526315789473684;27;30;0.0263157894736842;0.473684210526316
Control.ERR205724;57;59;0.508771929824561;28;29;0.00877192982456143;0.491228070175439
Control.ERR205724;52;59;0.480769230769231;27;25;0.0192307692307692;0.480769230769231
Control.ERR205724;60;59;0.45;33;27;0.05;0.45
Control.ERR205724;57;59;0.614035087719298;22;35;0.114035087719298;0.385964912280702
Control.ERR205724;58;59;0.431034482758621;33;25;0.0689655172413793;0.431034482758621
Control.ERR205724;62;59;0.451612903225806;34;28;0.0483870967741936;0.451612903225806
Control.ERR205724;65;59;0.476923076923077;34;31;0.0230769230769231;0.476923076923077
Control.ERR205724;64;59;0.59375;26;38;0.09375;0.40625
Control.ERR205724;58;59;0.517241379310345;28;30;0.0172413793103449;0.482758620689655
Control.ERR205724;59;59;0.542372881355932;27;32;0.0423728813559322;0.457627118644068
Control.ERR205724;65;59;0.661538461538462;22;43;0.161538461538462;0.338461538461538
Control.ERR205724;56;59;0.375;35;21;0.125;0.375
Control.ERR205724;51;59;0.450980392156863;28;23;0.0490196078431372;0.450980392156863
Control.ERR205724;62;59;0.516129032258065;30;32;0.0161290322580645;0.483870967741935
Control.ERR205724;53;59;0.433962264150943;30;23;0.0660377358490566;0.433962264150943
Control.ERR205724;55;59;0.436363636363636;31;24;0.0636363636363637;0.436363636363636
Control.ERR205724;57;59;0.403508771929825;34;23;0.0964912280701755;0.403508771929825
Control.ERR205724;55;59;0.454545454545455;30;25;0.0454545454545455;0.454545454545455
Control.ERR205724;51;59;0.470588235294118;27;24;0.0294117647058824;0.470588235294118
Control.ERR205724;59;59;0.525423728813559;28;31;0.0254237288135594;0.474576271186441
Control.ERR205724;60;59;0.433333333333333;34;26;0.0666666666666667;0.433333333333333
Control.ERR205724;64;59;0.53125;30;34;0.03125;0.46875
Control.ERR205724;49;59;0.673469387755102;16;33;0.173469387755102;0.326530612244898
Control.ERR205724;64;59;0.5625;28;36;0.0625;0.4375
Control.ERR205724;61;59;0.409836065573771;36;25;0.0901639344262295;0.409836065573771
Control.ERR205724;58;59;0.5;29;29;0;0.5
Control.ERR205724;58;59;0.586206896551724;24;34;0.0862068965517241;0.413793103448276
Control.ERR205724;57;59;0.508771929824561;28;29;0.00877192982456143;0.491228070175439
Control.ERR205724;56;59;0.464285714285714;30;26;0.0357142857142857;0.464285714285714
Control.ERR205724;52;59;0.423076923076923;30;22;0.0769230769230769;0.423076923076923
Control.ERR205724;58;59;0.53448275862069;27;31;0.0344827586206896;0.46551724137931
Control.ERR205724;65;59;0.461538461538462;35;30;0.0384615384615384;0.461538461538462
Control.ERR205724;55;59;0.545454545454545;25;30;0.0454545454545454;0.454545454545455
Control.ERR205724;63;59;0.507936507936508;31;32;0.00793650793650791;0.492063492063492
Control.ERR205724;57;59;0.578947368421053;24;33;0.0789473684210527;0.421052631578947
Control.ERR205724;56;59;0.589285714285714;23;33;0.0892857142857143;0.410714285714286
Control.ERR205724;54;59;0.592592592592593;22;32;0.0925925925925926;0.407407407407407
Control.ERR205724;62;59;0.467741935483871;33;29;0.0322580645161291;0.467741935483871
Control.ERR205724;58;59;0.586206896551724;24;34;0.0862068965517241;0.413793103448276
Control.ERR205724;62;59;0.483870967741935;32;30;0.0161290322580645;0.483870967741935
Control.ERR205724;63;59;0.53968253968254;29;34;0.0396825396825397;0.46031746031746
Control.ERR205724;63;59;0.53968253968254;29;34;0.0396825396825397;0.46031746031746
Control.ERR205724;58;59;0.603448275862069;23;35;0.103448275862069;0.396551724137931
Control.ERR205724;54;59;0.518518518518518;26;28;0.0185185185185185;0.481481481481481
Control.ERR205724;63;59;0.444444444444444;35;28;0.0555555555555556;0.444444444444444
Control.ERR205724;57;59;0.403508771929825;34;23;0.0964912280701755;0.403508771929825
Control.ERR205724;63;59;0.476190476190476;33;30;0.0238095238095238;0.476190476190476
Control.ERR205724;62;59;0.532258064516129;29;33;0.032258064516129;0.467741935483871
Control.ERR205724;54;59;0.5;27;27;0;0.5
Control.ERR205724;49;59;0.591836734693878;20;29;0.0918367346938775;0.408163265306122
Control.ERR205724;61;59;0.60655737704918;24;37;0.10655737704918;0.39344262295082
Control.ERR205724;58;59;0.431034482758621;33;25;0.0689655172413793;0.431034482758621
Control.ERR205724;54;59;0.555555555555556;24;30;0.0555555555555556;0.444444444444444
Control.ERR205724;54;59;0.537037037037037;25;29;0.0370370370370371;0.462962962962963
Control.ERR205724;53;59;0.584905660377358;22;31;0.0849056603773585;0.415094339622642
Control.ERR205724;64;59;0.515625;31;33;0.015625;0.484375
Control.ERR205724;54;59;0.462962962962963;29;25;0.037037037037037;0.462962962962963
Control.ERR205724;58;59;0.482758620689655;30;28;0.0172413793103448;0.482758620689655
Control.ERR205724;57;59;0.56140350877193;25;32;0.0614035087719298;0.43859649122807
Control.ERR205724;62;59;0.483870967741935;32;30;0.0161290322580645;0.483870967741935
Control.ERR205724;53;59;0.547169811320755;24;29;0.0471698113207547;0.452830188679245
Control.ERR205724;64;59;0.421875;37;27;0.078125;0.421875
Control.ERR205724;58;59;0.431034482758621;33;25;0.0689655172413793;0.431034482758621
Control.ERR205724;59;59;0.457627118644068;32;27;0.0423728813559322;0.457627118644068
Control.ERR205724;51;59;0.392156862745098;31;20;0.107843137254902;0.392156862745098
Control.ERR205724;53;59;0.509433962264151;26;27;0.00943396226415094;0.490566037735849
Control.ERR205724;52;59;0.5;26;26;0;0.5
Control.ERR205724;59;59;0.525423728813559;28;31;0.0254237288135594;0.474576271186441
Control.ERR205724;63;59;0.444444444444444;35;28;0.0555555555555556;0.444444444444444
Control.ERR205724;53;59;0.584905660377358;22;31;0.0849056603773585;0.415094339622642
Control.ERR205724;56;59;0.571428571428571;24;32;0.0714285714285714;0.428571428571429
Control.ERR205724;56;59;0.464285714285714;30;26;0.0357142857142857;0.464285714285714
Control.ERR205724;60;59;0.533333333333333;28;32;0.0333333333333333;0.466666666666667
Control.ERR205724;63;59;0.571428571428571;27;36;0.0714285714285714;0.428571428571429
Control.ERR205724;63;59;0.571428571428571;27;36;0.0714285714285714;0.428571428571429
Control.ERR205724;49;59;0.510204081632653;24;25;0.0102040816326531;0.489795918367347
Control.ERR205724;63;59;0.571428571428571;27;36;0.0714285714285714;0.428571428571429
Control.ERR205724;62;59;0.419354838709677;36;26;0.0806451612903226;0.419354838709677
Control.ERR205724;56;59;0.482142857142857;29;27;0.0178571428571428;0.482142857142857
Control.ERR205724;56;59;0.482142857142857;29;27;0.0178571428571428;0.482142857142857
Control.ERR205724;55;59;0.436363636363636;31;24;0.0636363636363637;0.436363636363636
Control.ERR205724;50;59;0.66;17;33;0.16;0.34
Control.ERR205724;57;59;0.43859649122807;32;25;0.0614035087719298;0.43859649122807
Control.ERR205724;57;59;0.526315789473684;27;30;0.0263157894736842;0.473684210526316
Control.ERR205724;63;59;0.444444444444444;35;28;0.0555555555555556;0.444444444444444
Control.ERR205724;63;59;0.476190476190476;33;30;0.0238095238095238;0.476190476190476
Control.ERR205724;53;59;0.452830188679245;29;24;0.0471698113207547;0.452830188679245
Control.ERR205724;59;59;0.457627118644068;32;27;0.0423728813559322;0.457627118644068
Control.ERR205724;58;59;0.5;29;29;0;0.5
Control.ERR205724;50;59;0.54;23;27;0.04;0.46
Control.ERR205724;58;59;0.53448275862069;27;31;0.0344827586206896;0.46551724137931
Control.ERR205724;58;59;0.482758620689655;30;28;0.0172413793103448;0.482758620689655
Control.ERR205724;63;59;0.492063492063492;32;31;0.00793650793650796;0.492063492063492
Control.ERR205724;61;59;0.426229508196721;35;26;0.0737704918032787;0.426229508196721
Control.ERR205724;50;59;0.36;32;18;0.14;0.36
Control.ERR205724;50;59;0.48;26;24;0.02;0.48
Control.ERR205724;65;59;0.569230769230769;28;37;0.0692307692307692;0.430769230769231
Control.ERR205724;62;59;0.483870967741935;32;30;0.0161290322580645;0.483870967741935
Control.ERR205724;61;59;0.524590163934426;29;32;0.0245901639344263;0.475409836065574
Control.ERR205724;57;59;0.43859649122807;32;25;0.0614035087719298;0.43859649122807
Control.ERR205724;65;59;0.615384615384615;25;40;0.115384615384615;0.384615384615385
Control.ERR205724;63;59;0.349206349206349;41;22;0.150793650793651;0.349206349206349
Control.ERR205724;63;59;0.571428571428571;27;36;0.0714285714285714;0.428571428571429
Control.ERR205724;57;59;0.368421052631579;36;21;0.131578947368421;0.368421052631579
Control.ERR205724;51;59;0.509803921568627;25;26;0.00980392156862742;0.490196078431373
Control.ERR205724;60;59;0.5;30;30;0;0.5
Control.ERR205724;54;59;0.444444444444444;30;24;0.0555555555555556;0.444444444444444
Control.ERR205724;50;59;0.54;23;27;0.04;0.46
Control.ERR205724;57;59;0.596491228070175;23;34;0.0964912280701754;0.403508771929825
Control.ERR205724;55;59;0.527272727272727;26;29;0.0272727272727272;0.472727272727273
Control.ERR205724;57;59;0.385964912280702;35;22;0.114035087719298;0.385964912280702
Control.ERR205724;57;59;0.491228070175439;29;28;0.00877192982456143;0.491228070175439
Control.ERR205724;58;59;0.448275862068966;32;26;0.0517241379310345;0.448275862068966
Control.ERR205724;57;59;0.666666666666667;19;38;0.166666666666667;0.333333333333333
Control.ERR205724;50;59;0.62;19;31;0.12;0.38
Control.ERR205724;62;59;0.387096774193548;38;24;0.112903225806452;0.387096774193548
Control.ERR205724;59;59;0.508474576271186;29;30;0.00847457627118642;0.491525423728814
Control.ERR205724;59;59;0.508474576271186;29;30;0.00847457627118642;0.491525423728814
Control.ERR205724;58;59;0.5;29;29;0;0.5
Control.ERR205724;57;59;0.596491228070175;23;34;0.0964912280701754;0.403508771929825
Control.ERR205724;50;59;0.64;18;32;0.14;0.36
Control.ERR205724;57;59;0.385964912280702;35;22;0.114035087719298;0.385964912280702
Control.ERR205724;64;59;0.46875;34;30;0.03125;0.46875
Control.ERR205724;54;59;0.537037037037037;25;29;0.0370370370370371;0.462962962962963
Control.ERR205724;50;59;0.42;29;21;0.08;0.42
Control.ERR205724;55;59;0.563636363636364;24;31;0.0636363636363636;0.436363636363636
Control.ERR205724;63;59;0.492063492063492;32;31;0.00793650793650796;0.492063492063492
Control.ERR205724;56;59;0.517857142857143;27;29;0.0178571428571429;0.482142857142857
Control.ERR205724;51;59;0.431372549019608;29;22;0.0686274509803921;0.431372549019608
Control.ERR205724;59;59;0.457627118644068;32;27;0.0423728813559322;0.457627118644068
Control.ERR205724;59;59;0.542372881355932;27;32;0.0423728813559322;0.457627118644068
Control.ERR205724;58;59;0.448275862068966;32;26;0.0517241379310345;0.448275862068966
Control.ERR205724;55;59;0.509090909090909;27;28;0.00909090909090904;0.490909090909091
Control.ERR205724;53;59;0.471698113207547;28;25;0.0283018867924528;0.471698113207547
Control.ERR205724;55;59;0.454545454545455;30;25;0.0454545454545455;0.454545454545455
Control.ERR205724;61;59;0.491803278688525;31;30;0.00819672131147542;0.491803278688525
Control.ERR205724;57;59;0.333333333333333;38;19;0.166666666666667;0.333333333333333
Control.ERR205724;56;59;0.464285714285714;30;26;0.0357142857142857;0.464285714285714
Control.ERR205724;57;59;0.526315789473684;27;30;0.0263157894736842;0.473684210526316
Control.ERR205724;65;59;0.538461538461538;30;35;0.0384615384615384;0.461538461538462
Control.ERR205724;55;59;0.545454545454545;25;30;0.0454545454545454;0.454545454545455
Control.ERR205724;62;59;0.483870967741935;32;30;0.0161290322580645;0.483870967741935
Control.ERR205724;56;59;0.464285714285714;30;26;0.0357142857142857;0.464285714285714
Control.ERR205724;52;59;0.403846153846154;31;21;0.0961538461538461;0.403846153846154
Control.ERR205724;54;59;0.537037037037037;25;29;0.0370370370370371;0.462962962962963
Control.ERR205724;59;59;0.440677966101695;33;26;0.0593220338983051;0.440677966101695
Control.ERR205724;57;59;0.526315789473684;27;30;0.0263157894736842;0.473684210526316
Control.ERR205724;57;59;0.614035087719298;22;35;0.114035087719298;0.385964912280702
Control.ERR205724;65;59;0.507692307692308;32;33;0.00769230769230766;0.492307692307692
Control.ERR205724;56;59;0.428571428571429;32;24;0.0714285714285715;0.428571428571429
Control.ERR205724;63;59;0.46031746031746;34;29;0.0396825396825397;0.46031746031746
Control.ERR205724;63;59;0.428571428571429;36;27;0.0714285714285715;0.428571428571429
Control.ERR205724;50;59;0.5;25;25;0;0.5
Control.ERR205724;58;59;0.53448275862069;27;31;0.0344827586206896;0.46551724137931
Control.ERR205724;65;59;0.4;39;26;0.1;0.4
Control.ERR205724;50;59;0.52;24;26;0.02;0.48
Control.ERR205724;51;59;0.450980392156863;28;23;0.0490196078431372;0.450980392156863
Control.ERR205724;65;59;0.384615384615385;40;25;0.115384615384615;0.384615384615385
Control.ERR205724;53;59;0.547169811320755;24;29;0.0471698113207547;0.452830188679245
Control.ERR205724;49;59;0.510204081632653;24;25;0.0102040816326531;0.489795918367347
Control.ERR205724;58;59;0.46551724137931;31;27;0.0344827586206897;0.46551724137931
Control.ERR205724;61;59;0.491803278688525;31;30;0.00819672131147542;0.491803278688525
Control.ERR205724;58;59;0.5;29;29;0;0.5
Control.ERR205724;54;59;0.537037037037037;25;29;0.0370370370370371;0.462962962962963
Control.ERR205724;64;59;0.546875;29;35;0.046875;0.453125
Control.ERR205724;62;59;0.548387096774194;28;34;0.0483870967741935;0.451612903225806
Control.ERR205724;59;59;0.525423728813559;28;31;0.0254237288135594;0.474576271186441
Control.ERR205724;54;59;0.5;27;27;0;0.5
Control.ERR205724;63;59;0.53968253968254;29;34;0.0396825396825397;0.46031746031746
Control.ERR205724;60;59;0.516666666666667;29;31;0.0166666666666667;0.483333333333333
Control.ERR205724;62;59;0.564516129032258;27;35;0.0645161290322581;0.435483870967742
Control.ERR205724;61;59;0.590163934426229;25;36;0.0901639344262295;0.409836065573771
Control.ERR205724;56;59;0.392857142857143;34;22;0.107142857142857;0.392857142857143
Control.ERR205724;58;59;0.517241379310345;28;30;0.0172413793103449;0.482758620689655
Control.ERR205724;63;59;0.412698412698413;37;26;0.0873015873015873;0.412698412698413
Control.ERR205724;52;59;0.5;26;26;0;0.5
Control.ERR205724;50;59;0.56;22;28;0.0600000000000001;0.44
Control.ERR205724;55;59;0.418181818181818;32;23;0.0818181818181818;0.418181818181818
Control.ERR205724;54;59;0.5;27;27;0;0.5
Control.ERR205724;57;59;0.596491228070175;23;34;0.0964912280701754;0.403508771929825
Control.ERR205724;65;59;0.476923076923077;34;31;0.0230769230769231;0.476923076923077
Control.ERR205724;59;59;0.508474576271186;29;30;0.00847457627118642;0.491525423728814
Control.ERR205724;60;59;0.433333333333333;34;26;0.0666666666666667;0.433333333333333
Control.ERR205724;61;59;0.639344262295082;22;39;0.139344262295082;0.360655737704918
Control.ERR205724;60;59;0.466666666666667;32;28;0.0333333333333333;0.466666666666667
Control.ERR205724;51;59;0.392156862745098;31;20;0.107843137254902;0.392156862745098
Control.ERR205724;57;59;0.491228070175439;29;28;0.00877192982456143;0.491228070175439
Control.ERR205724;65;59;0.430769230769231;37;28;0.0692307692307692;0.430769230769231
Control.ERR205724;54;59;0.555555555555556;24;30;0.0555555555555556;0.444444444444444
Control.ERR205724;60;59;0.433333333333333;34;26;0.0666666666666667;0.433333333333333
Control.ERR205724;54;59;0.592592592592593;22;32;0.0925925925925926;0.407407407407407
Control.ERR205724;58;59;0.448275862068966;32;26;0.0517241379310345;0.448275862068966
Control.ERR205724;61;59;0.524590163934426;29;32;0.0245901639344263;0.475409836065574
Control.ERR205724;59;59;0.474576271186441;31;28;0.0254237288135593;0.474576271186441
Control.ERR205724;59;59;0.440677966101695;33;26;0.0593220338983051;0.440677966101695
Control.ERR205724;61;59;0.573770491803279;26;35;0.0737704918032787;0.426229508196721
Control.ERR205724;55;59;0.545454545454545;25;30;0.0454545454545454;0.454545454545455
Control.ERR205724;64;59;0.65625;22;42;0.15625;0.34375
Control.ERR205724;65;59;0.523076923076923;31;34;0.0230769230769231;0.476923076923077
Control.ERR205724;61;59;0.491803278688525;31;30;0.00819672131147542;0.491803278688525
Control.ERR205724;49;59;0.510204081632653;24;25;0.0102040816326531;0.489795918367347
Control.ERR205724;56;59;0.625;21;35;0.125;0.375
Control.ERR205724;55;59;0.6;22;33;0.1;0.4
Control.ERR205724;56;59;0.464285714285714;30;26;0.0357142857142857;0.464285714285714
Control.ERR205724;55;59;0.490909090909091;28;27;0.00909090909090909;0.490909090909091
Control.ERR205724;63;59;0.523809523809524;30;33;0.0238095238095238;0.476190476190476
Control.ERR205724;53;59;0.60377358490566;21;32;0.10377358490566;0.39622641509434
Control.ERR205724;64;59;0.515625;31;33;0.015625;0.484375
Control.ERR205724;59;59;0.474576271186441;31;28;0.0254237288135593;0.474576271186441
Control.ERR205724;55;59;0.381818181818182;34;21;0.118181818181818;0.381818181818182
Control.ERR205724;63;59;0.444444444444444;35;28;0.0555555555555556;0.444444444444444
Control.ERR205724;64;59;0.453125;35;29;0.046875;0.453125
Control.ERR205724;64;59;0.59375;26;38;0.09375;0.40625
Control.ERR205724;59;59;0.457627118644068;32;27;0.0423728813559322;0.457627118644068
Control.ERR205724;54;59;0.537037037037037;25;29;0.0370370370370371;0.462962962962963
Control.ERR205724;54;59;0.5;27;27;0;0.5
Control.ERR205724;49;59;0.428571428571429;28;21;0.0714285714285715;0.428571428571429
Control.ERR205724;49;59;0.469387755102041;26;23;0.0306122448979592;0.469387755102041
Control.ERR205724;61;59;0.540983606557377;28;33;0.0409836065573771;0.459016393442623
Control.ERR205724;65;59;0.384615384615385;40;25;0.115384615384615;0.384615384615385
Control.ERR205724;64;59;0.546875;29;35;0.046875;0.453125
Control.ERR205724;61;59;0.475409836065574;32;29;0.0245901639344263;0.475409836065574
Control.ERR205724;64;59;0.390625;39;25;0.109375;0.390625
Control.ERR205724;61;59;0.459016393442623;33;28;0.040983606557377;0.459016393442623
Control.ERR205724;59;59;0.474576271186441;31;28;0.0254237288135593;0.474576271186441
Control.ERR205724;62;59;0.5;31;31;0;0.5
Control.ERR205724;56;59;0.553571428571429;25;31;0.0535714285714286;0.446428571428571
Control.ERR205724;63;59;0.444444444444444;35;28;0.0555555555555556;0.444444444444444
Control.ERR205724;56;59;0.410714285714286;33;23;0.0892857142857143;0.410714285714286
Control.ERR205724;63;59;0.492063492063492;32;31;0.00793650793650796;0.492063492063492
Control.ERR205724;51;59;0.411764705882353;30;21;0.0882352941176471;0.411764705882353
Control.ERR205724;64;59;0.53125;30;34;0.03125;0.46875
Control.ERR205724;57;59;0.508771929824561;28;29;0.00877192982456143;0.491228070175439
Control.ERR205724;54;59;0.444444444444444;30;24;0.0555555555555556;0.444444444444444
Control.ERR205724;59;59;0.508474576271186;29;30;0.00847457627118642;0.491525423728814
Control.ERR205724;49;59;0.510204081632653;24;25;0.0102040816326531;0.489795918367347
Control.ERR205724;57;59;0.473684210526316;30;27;0.0263157894736842;0.473684210526316
Control.ERR205724;59;59;0.491525423728814;30;29;0.00847457627118642;0.491525423728814
Control.ERR205724;59;59;0.457627118644068;32;27;0.0423728813559322;0.457627118644068
Control.ERR205724;61;59;0.426229508196721;35;26;0.0737704918032787;0.426229508196721
Control.ERR205724;59;59;0.491525423728814;30;29;0.00847457627118642;0.491525423728814
Control.ERR205724;55;59;0.4;33;22;0.1;0.4
Control.ERR205724;60;59;0.466666666666667;32;28;0.0333333333333333;0.466666666666667
Control.ERR205724;55;59;0.545454545454545;25;30;0.0454545454545454;0.454545454545455
Control.ERR205724;62;59;0.5;31;31;0;0.5
Control.ERR205724;60;59;0.533333333333333;28;32;0.0333333333333333;0.466666666666667
Control.ERR205724;60;59;0.466666666666667;32;28;0.0333333333333333;0.466666666666667
Control.ERR205724;52;59;0.519230769230769;25;27;0.0192307692307693;0.480769230769231
Control.ERR205724;63;59;0.476190476190476;33;30;0.0238095238095238;0.476190476190476
Control.ERR205724;56;59;0.464285714285714;30;26;0.0357142857142857;0.464285714285714
Control.ERR205724;49;59;0.469387755102041;26;23;0.0306122448979592;0.469387755102041
Control.ERR205724;51;59;0.549019607843137;23;28;0.0490196078431373;0.450980392156863
Control.ERR205724;51;59;0.509803921568627;25;26;0.00980392156862742;0.490196078431373
Control.ERR205724;57;59;0.631578947368421;21;36;0.131578947368421;0.368421052631579
Control.ERR205724;63;59;0.476190476190476;33;30;0.0238095238095238;0.476190476190476
Control.ERR205724;51;59;0.450980392156863;28;23;0.0490196078431372;0.450980392156863
Control.ERR205724;52;59;0.403846153846154;31;21;0.0961538461538461;0.403846153846154
Control.ERR205724;64;59;0.5;32;32;0;0.5
Control.ERR205724;58;59;0.46551724137931;31;27;0.0344827586206897;0.46551724137931
Control.ERR205724;64;59;0.515625;31;33;0.015625;0.484375
Control.ERR205724;51;59;0.588235294117647;21;30;0.0882352941176471;0.411764705882353
Control.ERR205724;62;59;0.629032258064516;23;39;0.129032258064516;0.370967741935484
Control.ERR205724;59;59;0.491525423728814;30;29;0.00847457627118642;0.491525423728814
Control.ERR205724;55;59;0.4;33;22;0.1;0.4
Control.ERR205724;55;59;0.545454545454545;25;30;0.0454545454545454;0.454545454545455
Control.ERR205724;49;59;0.510204081632653;24;25;0.0102040816326531;0.489795918367347
Control.ERR205724;61;59;0.557377049180328;27;34;0.0573770491803278;0.442622950819672
Control.ERR205724;61;59;0.491803278688525;31;30;0.00819672131147542;0.491803278688525
Control.ERR205724;55;59;0.6;22;33;0.1;0.4
Control.ERR205724;60;59;0.483333333333333;31;29;0.0166666666666667;0.483333333333333
Control.ERR205724;54;59;0.462962962962963;29;25;0.037037037037037;0.462962962962963
Control.ERR205724;58;59;0.5;29;29;0;0.5
Control.ERR205724;56;59;0.535714285714286;26;30;0.0357142857142857;0.464285714285714
Control.ERR205724;56;59;0.428571428571429;32;24;0.0714285714285715;0.428571428571429
Control.ERR205724;53;59;0.433962264150943;30;23;0.0660377358490566;0.433962264150943
Control.ERR205724;52;59;0.461538461538462;28;24;0.0384615384615384;0.461538461538462
Control.ERR205724;51;59;0.450980392156863;28;23;0.0490196078431372;0.450980392156863
Control.ERR205724;60;59;0.566666666666667;26;34;0.0666666666666667;0.433333333333333
Control.ERR205724;60;59;0.566666666666667;26;34;0.0666666666666667;0.433333333333333
Control.ERR205724;58;59;0.448275862068966;32;26;0.0517241379310345;0.448275862068966
Control.ERR205724;59;59;0.508474576271186;29;30;0.00847457627118642;0.491525423728814
Control.ERR205724;55;59;0.381818181818182;34;21;0.118181818181818;0.381818181818182
Control.ERR205724;54;59;0.518518518518518;26;28;0.0185185185185185;0.481481481481481
Control.ERR205724;60;59;0.416666666666667;35;25;0.0833333333333333;0.416666666666667
Control.ERR205724;54;59;0.481481481481481;28;26;0.0185185185185185;0.481481481481481
Control.ERR205724;55;59;0.545454545454545;25;30;0.0454545454545454;0.454545454545455
Control.ERR205724;60;59;0.516666666666667;29;31;0.0166666666666667;0.483333333333333
Control.ERR205724;55;59;0.418181818181818;32;23;0.0818181818181818;0.418181818181818
Control.ERR205724;59;59;0.525423728813559;28;31;0.0254237288135594;0.474576271186441
Control.ERR205724;56;59;0.428571428571429;32;24;0.0714285714285715;0.428571428571429
Control.ERR205724;64;59;0.46875;34;30;0.03125;0.46875
Control.ERR205724;56;59;0.5;28;28;0;0.5
Control.ERR205724;59;59;0.542372881355932;27;32;0.0423728813559322;0.457627118644068
Control.ERR205724;54;59;0.5;27;27;0;0.5
Control.ERR205724;58;59;0.396551724137931;35;23;0.103448275862069;0.396551724137931
Control.ERR205724;60;59;0.45;33;27;0.05;0.45
Control.ERR205724;64;59;0.484375;33;31;0.015625;0.484375
Control.ERR205724;57;59;0.526315789473684;27;30;0.0263157894736842;0.473684210526316
Control.ERR205724;58;59;0.482758620689655;30;28;0.0172413793103448;0.482758620689655
Control.ERR205724;55;59;0.472727272727273;29;26;0.0272727272727273;0.472727272727273
Control.ERR205724;65;59;0.492307692307692;33;32;0.00769230769230766;0.492307692307692
Control.ERR205724;61;59;0.524590163934426;29;32;0.0245901639344263;0.475409836065574
Control.ERR205724;61;59;0.524590163934426;29;32;0.0245901639344263;0.475409836065574
Control.ERR205724;51;59;0.450980392156863;28;23;0.0490196078431372;0.450980392156863
Control.ERR205724;50;59;0.52;24;26;0.02;0.48
Control.ERR205724;58;59;0.413793103448276;34;24;0.0862068965517241;0.413793103448276
Control.ERR205724;58;59;0.655172413793103;20;38;0.155172413793103;0.344827586206897
Control.ERR205724;53;59;0.566037735849057;23;30;0.0660377358490566;0.433962264150943
Control.ERR205724;59;59;0.440677966101695;33;26;0.0593220338983051;0.440677966101695
Control.ERR205724;61;59;0.491803278688525;31;30;0.00819672131147542;0.491803278688525
Control.ERR205724;61;59;0.557377049180328;27;34;0.0573770491803278;0.442622950819672
Control.ERR205724;52;59;0.5;26;26;0;0.5
Control.ERR205724;52;59;0.519230769230769;25;27;0.0192307692307693;0.480769230769231
Control.ERR205724;57;59;0.56140350877193;25;32;0.0614035087719298;0.43859649122807
Control.ERR205724;63;59;0.507936507936508;31;32;0.00793650793650791;0.492063492063492
Control.ERR205724;63;59;0.507936507936508;31;32;0.00793650793650791;0.492063492063492
Control.ERR205724;60;59;0.483333333333333;31;29;0.0166666666666667;0.483333333333333
Control.ERR205724;59;59;0.525423728813559;28;31;0.0254237288135594;0.474576271186441
Control.ERR205724;62;59;0.5;31;31;0;0.5
Control.ERR205724;51;59;0.647058823529412;18;33;0.147058823529412;0.352941176470588
Control.ERR205724;59;59;0.474576271186441;31;28;0.0254237288135593;0.474576271186441
Control.ERR205724;65;59;0.630769230769231;24;41;0.130769230769231;0.369230769230769
Control.ERR205724;56;59;0.5;28;28;0;0.5
Control.ERR205724;49;59;0.530612244897959;23;26;0.0306122448979592;0.469387755102041
Control.ERR205724;60;59;0.6;24;36;0.1;0.4
Control.ERR205724;64;59;0.5;32;32;0;0.5
Control.ERR205724;59;59;0.525423728813559;28;31;0.0254237288135594;0.474576271186441
Control.ERR205724;57;59;0.526315789473684;27;30;0.0263157894736842;0.473684210526316
Control.ERR205724;52;59;0.365384615384615;33;19;0.134615384615385;0.365384615384615
Control.ERR205724;60;59;0.45;33;27;0.05;0.45
Control.ERR205724;62;59;0.5;31;31;0;0.5
Control.ERR205724;62;59;0.548387096774194;28;34;0.0483870967741935;0.451612903225806
Control.ERR205724;55;59;0.381818181818182;34;21;0.118181818181818;0.381818181818182
Control.ERR205724;52;59;0.5;26;26;0;0.5
Control.ERR205724;52;59;0.519230769230769;25;27;0.0192307692307693;0.480769230769231
Control.ERR205724;63;59;0.603174603174603;25;38;0.103174603174603;0.396825396825397
Control.ERR205724;56;59;0.517857142857143;27;29;0.0178571428571429;0.482142857142857
Control.ERR205724;62;59;0.564516129032258;27;35;0.0645161290322581;0.435483870967742
Control.ERR205724;58;59;0.53448275862069;27;31;0.0344827586206896;0.46551724137931
Control.ERR205724;50;59;0.5;25;25;0;0.5
Control.ERR205724;63;59;0.428571428571429;36;27;0.0714285714285715;0.428571428571429
Control.ERR205724;64;59;0.359375;41;23;0.140625;0.359375
Control.ERR205724;56;59;0.571428571428571;24;32;0.0714285714285714;0.428571428571429
Control.ERR205724;49;59;0.510204081632653;24;25;0.0102040816326531;0.489795918367347
Control.ERR205724;62;59;0.532258064516129;29;33;0.032258064516129;0.467741935483871
Control.ERR205724;52;59;0.480769230769231;27;25;0.0192307692307692;0.480769230769231
Control.ERR205724;50;59;0.46;27;23;0.04;0.46
Control.ERR205724;54;59;0.518518518518518;26;28;0.0185185185185185;0.481481481481481
Control.ERR205724;53;59;0.60377358490566;21;32;0.10377358490566;0.39622641509434
Control.ERR205724;62;59;0.5;31;31;0;0.5
Control.ERR205724;65;59;0.461538461538462;35;30;0.0384615384615384;0.461538461538462
Control.ERR205724;55;59;0.436363636363636;31;24;0.0636363636363637;0.436363636363636
Control.ERR205724;60;59;0.416666666666667;35;25;0.0833333333333333;0.416666666666667
Control.ERR205724;54;59;0.425925925925926;31;23;0.0740740740740741;0.425925925925926
Control.ERR205724;54;59;0.407407407407407;32;22;0.0925925925925926;0.407407407407407
Control.ERR205724;53;59;0.471698113207547;28;25;0.0283018867924528;0.471698113207547
Control.ERR205724;51;59;0.490196078431373;26;25;0.00980392156862747;0.490196078431373
Control.ERR205724;61;59;0.508196721311475;30;31;0.00819672131147542;0.491803278688525
Control.ERR205724;52;59;0.403846153846154;31;21;0.0961538461538461;0.403846153846154
Control.ERR205724;54;59;0.462962962962963;29;25;0.037037037037037;0.462962962962963
Control.ERR205724;51;59;0.529411764705882;24;27;0.0294117647058824;0.470588235294118
Control.ERR205724;57;59;0.491228070175439;29;28;0.00877192982456143;0.491228070175439
Control.ERR205724;51;59;0.470588235294118;27;24;0.0294117647058824;0.470588235294118
Control.ERR205724;58;59;0.396551724137931;35;23;0.103448275862069;0.396551724137931
Control.ERR205724;51;59;0.568627450980392;22;29;0.0686274509803921;0.431372549019608
Control.ERR205724;54;59;0.5;27;27;0;0.5
Control.ERR205724;63;59;0.349206349206349;41;22;0.150793650793651;0.349206349206349
Control.ERR205724;57;59;0.526315789473684;27;30;0.0263157894736842;0.473684210526316
Control.ERR205724;57;59;0.526315789473684;27;30;0.0263157894736842;0.473684210526316
Control.ERR205724;54;59;0.462962962962963;29;25;0.037037037037037;0.462962962962963
Control.ERR205724;51;59;0.568627450980392;22;29;0.0686274509803921;0.431372549019608
Control.ERR205724;56;59;0.428571428571429;32;24;0.0714285714285715;0.428571428571429
Control.ERR205724;60;59;0.45;33;27;0.05;0.45
Control.ERR205724;64;59;0.5625;28;36;0.0625;0.4375
Control.ERR205724;59;59;0.508474576271186;29;30;0.00847457627118642;0.491525423728814
Control.ERR205724;55;59;0.509090909090909;27;28;0.00909090909090904;0.490909090909091
Control.ERR205724;55;59;0.509090909090909;27;28;0.00909090909090904;0.490909090909091
Control.ERR205724;57;59;0.456140350877193;31;26;0.043859649122807;0.456140350877193
Control.ERR205724;49;59;0.489795918367347;25;24;0.0102040816326531;0.489795918367347
Control.ERR205724;54;59;0.518518518518518;26;28;0.0185185185185185;0.481481481481481
Control.ERR205724;63;59;0.428571428571429;36;27;0.0714285714285715;0.428571428571429
Control.ERR205724;51;59;0.490196078431373;26;25;0.00980392156862747;0.490196078431373
Control.ERR205724;59;59;0.457627118644068;32;27;0.0423728813559322;0.457627118644068
Control.ERR205724;58;59;0.517241379310345;28;30;0.0172413793103449;0.482758620689655
Control.ERR205724;57;59;0.543859649122807;26;31;0.043859649122807;0.456140350877193
Control.ERR205724;55;59;0.4;33;22;0.1;0.4
Control.ERR205724;60;59;0.516666666666667;29;31;0.0166666666666667;0.483333333333333
Control.ERR205724;57;59;0.456140350877193;31;26;0.043859649122807;0.456140350877193
Control.ERR205724;56;59;0.5;28;28;0;0.5
Control.ERR205724;54;59;0.444444444444444;30;24;0.0555555555555556;0.444444444444444
Control.ERR205724;61;59;0.491803278688525;31;30;0.00819672131147542;0.491803278688525
Control.ERR205724;55;59;0.327272727272727;37;18;0.172727272727273;0.327272727272727
Control.ERR205724;59;59;0.525423728813559;28;31;0.0254237288135594;0.474576271186441
Control.ERR205724;54;59;0.5;27;27;0;0.5
Control.ERR205724;64;59;0.5;32;32;0;0.5
Control.ERR205724;62;59;0.338709677419355;41;21;0.161290322580645;0.338709677419355
Control.ERR205724;56;59;0.553571428571429;25;31;0.0535714285714286;0.446428571428571
Control.ERR205724;60;59;0.466666666666667;32;28;0.0333333333333333;0.466666666666667
Control.ERR205724;57;59;0.456140350877193;31;26;0.043859649122807;0.456140350877193
Control.ERR205724;65;59;0.584615384615385;27;38;0.0846153846153846;0.415384615384615
Control.ERR205724;61;59;0.491803278688525;31;30;0.00819672131147542;0.491803278688525
Control.ERR205724;56;59;0.535714285714286;26;30;0.0357142857142857;0.464285714285714
Control.ERR205724;53;59;0.566037735849057;23;30;0.0660377358490566;0.433962264150943
Control.ERR205724;49;59;0.510204081632653;24;25;0.0102040816326531;0.489795918367347
Control.ERR205724;57;59;0.649122807017544;20;37;0.149122807017544;0.350877192982456
Control.ERR205724;64;59;0.40625;38;26;0.09375;0.40625
Control.ERR205724;49;59;0.551020408163265;22;27;0.0510204081632653;0.448979591836735
Control.ERR205724;52;59;0.519230769230769;25;27;0.0192307692307693;0.480769230769231
Control.ERR205724;52;59;0.596153846153846;21;31;0.0961538461538461;0.403846153846154
Control.ERR205724;54;59;0.5;27;27;0;0.5
Control.ERR205724;53;59;0.528301886792453;25;28;0.0283018867924528;0.471698113207547
Control.ERR205724;51;59;0.411764705882353;30;21;0.0882352941176471;0.411764705882353
Control.ERR205724;57;59;0.508771929824561;28;29;0.00877192982456143;0.491228070175439
Control.ERR205724;61;59;0.557377049180328;27;34;0.0573770491803278;0.442622950819672
Control.ERR205724;64;59;0.46875;34;30;0.03125;0.46875
Control.ERR205724;57;59;0.526315789473684;27;30;0.0263157894736842;0.473684210526316
Control.ERR205724;64;59;0.515625;31;33;0.015625;0.484375
Control.ERR205724;50;59;0.54;23;27;0.04;0.46
Control.ERR205724;62;59;0.532258064516129;29;33;0.032258064516129;0.467741935483871
Control.ERR205724;55;59;0.527272727272727;26;29;0.0272727272727272;0.472727272727273
Control.ERR205724;55;59;0.472727272727273;29;26;0.0272727272727273;0.472727272727273
Control.ERR205724;52;59;0.5;26;26;0;0.5
Control.ERR205724;52;59;0.5;26;26;0;0.5
Control.ERR205724;64;59;0.484375;33;31;0.015625;0.484375
Control.ERR205724;58;59;0.568965517241379;25;33;0.0689655172413793;0.431034482758621
Control.ERR205724;61;59;0.475409836065574;32;29;0.0245901639344263;0.475409836065574
Control.ERR205724;57;59;0.543859649122807;26;31;0.043859649122807;0.456140350877193
Control.ERR205724;59;59;0.389830508474576;36;23;0.110169491525424;0.389830508474576
Control.ERR205724;56;59;0.375;35;21;0.125;0.375
Control.ERR205724;54;59;0.537037037037037;25;29;0.0370370370370371;0.462962962962963
Control.ERR205724;52;59;0.461538461538462;28;24;0.0384615384615384;0.461538461538462
Control.ERR205724;53;59;0.528301886792453;25;28;0.0283018867924528;0.471698113207547
Control.ERR205724;64;59;0.390625;39;25;0.109375;0.390625
Control.ERR205724;49;59;0.448979591836735;27;22;0.0510204081632653;0.448979591836735
Control.ERR205724;52;59;0.403846153846154;31;21;0.0961538461538461;0.403846153846154
Control.ERR205724;54;59;0.537037037037037;25;29;0.0370370370370371;0.462962962962963
Control.ERR205724;60;59;0.516666666666667;29;31;0.0166666666666667;0.483333333333333
Control.ERR205724;56;59;0.589285714285714;23;33;0.0892857142857143;0.410714285714286
Control.ERR205724;60;59;0.483333333333333;31;29;0.0166666666666667;0.483333333333333
Control.ERR205724;59;59;0.525423728813559;28;31;0.0254237288135594;0.474576271186441
Control.ERR205724;56;59;0.464285714285714;30;26;0.0357142857142857;0.464285714285714
Control.ERR205724;65;59;0.584615384615385;27;38;0.0846153846153846;0.415384615384615
Control.ERR205724;59;59;0.525423728813559;28;31;0.0254237288135594;0.474576271186441
Control.ERR205724;58;59;0.482758620689655;30;28;0.0172413793103448;0.482758620689655
Control.ERR205724;58;59;0.482758620689655;30;28;0.0172413793103448;0.482758620689655
Control.ERR205724;64;59;0.578125;27;37;0.078125;0.421875
Control.ERR205724;57;59;0.421052631578947;33;24;0.0789473684210527;0.421052631578947
Control.ERR205724;55;59;0.563636363636364;24;31;0.0636363636363636;0.436363636363636
Control.ERR205724;53;59;0.433962264150943;30;23;0.0660377358490566;0.433962264150943
Control.ERR205724;59;59;0.542372881355932;27;32;0.0423728813559322;0.457627118644068
Control.ERR205724;52;59;0.519230769230769;25;27;0.0192307692307693;0.480769230769231
Control.ERR205724;56;59;0.5;28;28;0;0.5
Control.ERR205724;61;59;0.508196721311475;30;31;0.00819672131147542;0.491803278688525
Control.ERR205724;58;59;0.46551724137931;31;27;0.0344827586206897;0.46551724137931
Control.ERR205724;55;59;0.545454545454545;25;30;0.0454545454545454;0.454545454545455
Control.ERR205724;56;59;0.535714285714286;26;30;0.0357142857142857;0.464285714285714
Control.ERR205724;54;59;0.537037037037037;25;29;0.0370370370370371;0.462962962962963
Control.ERR205724;55;59;0.6;22;33;0.1;0.4
Control.ERR205724;60;59;0.466666666666667;32;28;0.0333333333333333;0.466666666666667
Control.ERR205724;61;59;0.426229508196721;35;26;0.0737704918032787;0.426229508196721
Control.ERR205724;59;59;0.491525423728814;30;29;0.00847457627118642;0.491525423728814
Control.ERR205724;61;59;0.459016393442623;33;28;0.040983606557377;0.459016393442623
Control.ERR205724;55;59;0.345454545454545;36;19;0.154545454545455;0.345454545454545
Control.ERR205724;53;59;0.566037735849057;23;30;0.0660377358490566;0.433962264150943
Control.ERR205724;61;59;0.442622950819672;34;27;0.0573770491803279;0.442622950819672
Control.ERR205724;56;59;0.428571428571429;32;24;0.0714285714285715;0.428571428571429
Control.ERR205724;51;59;0.549019607843137;23;28;0.0490196078431373;0.450980392156863
Control.ERR205724;51;59;0.509803921568627;25;26;0.00980392156862742;0.490196078431373
Control.ERR205724;62;59;0.419354838709677;36;26;0.0806451612903226;0.419354838709677
Control.ERR205724;62;59;0.564516129032258;27;35;0.0645161290322581;0.435483870967742
Control.ERR205724;62;59;0.435483870967742;35;27;0.0645161290322581;0.435483870967742
Control.ERR205724;58;59;0.586206896551724;24;34;0.0862068965517241;0.413793103448276
Control.ERR205724;57;59;0.456140350877193;31;26;0.043859649122807;0.456140350877193
Control.ERR205724;51;59;0.588235294117647;21;30;0.0882352941176471;0.411764705882353
Control.ERR205724;63;59;0.523809523809524;30;33;0.0238095238095238;0.476190476190476
Control.ERR205724;60;59;0.466666666666667;32;28;0.0333333333333333;0.466666666666667
Control.ERR205724;57;59;0.526315789473684;27;30;0.0263157894736842;0.473684210526316
Control.ERR205724;51;59;0.588235294117647;21;30;0.0882352941176471;0.411764705882353
Control.ERR205724;58;59;0.672413793103448;19;39;0.172413793103448;0.327586206896552
Control.ERR205724;60;59;0.45;33;27;0.05;0.45
Control.ERR205724;63;59;0.46031746031746;34;29;0.0396825396825397;0.46031746031746
Control.ERR205724;55;59;0.418181818181818;32;23;0.0818181818181818;0.418181818181818
Control.ERR205724;57;59;0.543859649122807;26;31;0.043859649122807;0.456140350877193
Control.ERR205724;57;59;0.56140350877193;25;32;0.0614035087719298;0.43859649122807
Control.ERR205724;54;59;0.574074074074074;23;31;0.0740740740740741;0.425925925925926
Control.ERR205724;55;59;0.454545454545455;30;25;0.0454545454545455;0.454545454545455
Control.ERR205724;53;59;0.490566037735849;27;26;0.00943396226415094;0.490566037735849
Control.ERR205724;56;59;0.464285714285714;30;26;0.0357142857142857;0.464285714285714
Control.ERR205724;64;59;0.484375;33;31;0.015625;0.484375
Control.ERR205724;58;59;0.551724137931034;26;32;0.0517241379310345;0.448275862068966
Control.ERR205724;55;59;0.509090909090909;27;28;0.00909090909090904;0.490909090909091
Control.ERR205724;59;59;0.508474576271186;29;30;0.00847457627118642;0.491525423728814
Control.ERR205724;62;59;0.483870967741935;32;30;0.0161290322580645;0.483870967741935
Control.ERR205724;58;59;0.413793103448276;34;24;0.0862068965517241;0.413793103448276
Control.ERR205724;51;59;0.568627450980392;22;29;0.0686274509803921;0.431372549019608
Control.ERR205724;57;59;0.473684210526316;30;27;0.0263157894736842;0.473684210526316
Control.ERR205724;58;59;0.448275862068966;32;26;0.0517241379310345;0.448275862068966
Control.ERR205724;53;59;0.452830188679245;29;24;0.0471698113207547;0.452830188679245
Control.ERR205724;65;59;0.384615384615385;40;25;0.115384615384615;0.384615384615385
Control.ERR205724;53;59;0.566037735849057;23;30;0.0660377358490566;0.433962264150943
Control.ERR205724;55;59;0.454545454545455;30;25;0.0454545454545455;0.454545454545455
Control.ERR205724;58;59;0.362068965517241;37;21;0.137931034482759;0.362068965517241
Control.ERR205724;57;59;0.456140350877193;31;26;0.043859649122807;0.456140350877193
Control.ERR205724;58;59;0.551724137931034;26;32;0.0517241379310345;0.448275862068966
Control.ERR205724;55;59;0.490909090909091;28;27;0.00909090909090909;0.490909090909091
Control.ERR205724;62;59;0.516129032258065;30;32;0.0161290322580645;0.483870967741935
Control.ERR205724;58;59;0.586206896551724;24;34;0.0862068965517241;0.413793103448276
Control.ERR205724;62;59;0.516129032258065;30;32;0.0161290322580645;0.483870967741935
Control.ERR205724;56;59;0.625;21;35;0.125;0.375
Control.ERR205724;53;59;0.584905660377358;22;31;0.0849056603773585;0.415094339622642
Control.ERR205724;54;59;0.5;27;27;0;0.5
Control.ERR205724;60;59;0.5;30;30;0;0.5
Control.ERR205724;51;59;0.568627450980392;22;29;0.0686274509803921;0.431372549019608
Control.ERR205724;57;59;0.543859649122807;26;31;0.043859649122807;0.456140350877193
Control.ERR205724;65;59;0.461538461538462;35;30;0.0384615384615384;0.461538461538462
Control.ERR205724;50;59;0.58;21;29;0.08;0.42
Control.ERR205724;56;59;0.482142857142857;29;27;0.0178571428571428;0.482142857142857
Control.ERR205724;62;59;0.532258064516129;29;33;0.032258064516129;0.467741935483871
Control.ERR205724;59;59;0.694915254237288;18;41;0.194915254237288;0.305084745762712
Control.ERR205724;58;59;0.517241379310345;28;30;0.0172413793103449;0.482758620689655
Control.ERR205724;59;59;0.491525423728814;30;29;0.00847457627118642;0.491525423728814
Control.ERR205724;62;59;0.580645161290323;26;36;0.0806451612903226;0.419354838709677
Control.ERR205724;53;59;0.528301886792453;25;28;0.0283018867924528;0.471698113207547
Control.ERR205724;59;59;0.474576271186441;31;28;0.0254237288135593;0.474576271186441
Control.ERR205724;64;59;0.53125;30;34;0.03125;0.46875
Control.ERR205724;64;59;0.59375;26;38;0.09375;0.40625
Control.ERR205724;56;59;0.678571428571429;18;38;0.178571428571429;0.321428571428571
Control.ERR205724;51;59;0.568627450980392;22;29;0.0686274509803921;0.431372549019608
Control.ERR205724;64;59;0.515625;31;33;0.015625;0.484375
Control.ERR205724;54;59;0.425925925925926;31;23;0.0740740740740741;0.425925925925926
Control.ERR205724;61;59;0.508196721311475;30;31;0.00819672131147542;0.491803278688525
Control.ERR205724;59;59;0.440677966101695;33;26;0.0593220338983051;0.440677966101695
Control.ERR205724;52;59;0.442307692307692;29;23;0.0576923076923077;0.442307692307692
Control.ERR205724;64;59;0.453125;35;29;0.046875;0.453125
Control.ERR205724;49;59;0.551020408163265;22;27;0.0510204081632653;0.448979591836735
Control.ERR205724;51;59;0.372549019607843;32;19;0.127450980392157;0.372549019607843
Control.ERR205724;49;59;0.530612244897959;23;26;0.0306122448979592;0.469387755102041
Control.ERR205724;57;59;0.491228070175439;29;28;0.00877192982456143;0.491228070175439
Control.ERR205724;50;59;0.54;23;27;0.04;0.46
Control.ERR205724;62;59;0.548387096774194;28;34;0.0483870967741935;0.451612903225806
Control.ERR205724;58;59;0.5;29;29;0;0.5
Control.ERR205724;55;59;0.581818181818182;23;32;0.0818181818181818;0.418181818181818
Control.ERR205724;61;59;0.524590163934426;29;32;0.0245901639344263;0.475409836065574
Control.ERR205724;57;59;0.543859649122807;26;31;0.043859649122807;0.456140350877193
Control.ERR205724;53;59;0.433962264150943;30;23;0.0660377358490566;0.433962264150943
Control.ERR205724;60;59;0.483333333333333;31;29;0.0166666666666667;0.483333333333333
Control.ERR205724;56;59;0.535714285714286;26;30;0.0357142857142857;0.464285714285714
Control.ERR205724;49;59;0.469387755102041;26;23;0.0306122448979592;0.469387755102041
Control.ERR205724;56;59;0.464285714285714;30;26;0.0357142857142857;0.464285714285714
Control.ERR205724;62;59;0.532258064516129;29;33;0.032258064516129;0.467741935483871
Control.ERR205724;57;59;0.421052631578947;33;24;0.0789473684210527;0.421052631578947
Control.ERR205724;54;59;0.425925925925926;31;23;0.0740740740740741;0.425925925925926
Control.ERR205724;49;59;0.571428571428571;21;28;0.0714285714285714;0.428571428571429
Control.ERR205724;59;59;0.440677966101695;33;26;0.0593220338983051;0.440677966101695
Control.ERR205724;63;59;0.53968253968254;29;34;0.0396825396825397;0.46031746031746
Control.ERR205724;61;59;0.459016393442623;33;28;0.040983606557377;0.459016393442623
Control.ERR205724;63;59;0.492063492063492;32;31;0.00793650793650796;0.492063492063492
Control.ERR205724;54;59;0.5;27;27;0;0.5
Control.ERR205724;56;59;0.392857142857143;34;22;0.107142857142857;0.392857142857143
Control.ERR205724;60;59;0.416666666666667;35;25;0.0833333333333333;0.416666666666667
Control.ERR205724;56;59;0.482142857142857;29;27;0.0178571428571428;0.482142857142857
Control.ERR205724;60;59;0.383333333333333;37;23;0.116666666666667;0.383333333333333
Control.ERR205724;59;59;0.474576271186441;31;28;0.0254237288135593;0.474576271186441
Control.ERR205724;58;59;0.431034482758621;33;25;0.0689655172413793;0.431034482758621
Control.ERR205724;62;59;0.564516129032258;27;35;0.0645161290322581;0.435483870967742
Control.ERR205724;52;59;0.596153846153846;21;31;0.0961538461538461;0.403846153846154
Control.ERR205724;53;59;0.60377358490566;21;32;0.10377358490566;0.39622641509434
Control.ERR205724;64;59;0.515625;31;33;0.015625;0.484375
Control.ERR205724;64;59;0.578125;27;37;0.078125;0.421875
Control.ERR205724;55;59;0.545454545454545;25;30;0.0454545454545454;0.454545454545455
Control.ERR205724;63;59;0.53968253968254;29;34;0.0396825396825397;0.46031746031746
Control.ERR205724;57;59;0.473684210526316;30;27;0.0263157894736842;0.473684210526316
Control.ERR205724;57;59;0.491228070175439;29;28;0.00877192982456143;0.491228070175439
Control.ERR205724;51;59;0.450980392156863;28;23;0.0490196078431372;0.450980392156863
Control.ERR205724;53;59;0.60377358490566;21;32;0.10377358490566;0.39622641509434
Control.ERR205724;55;59;0.563636363636364;24;31;0.0636363636363636;0.436363636363636
Control.ERR205724;55;59;0.545454545454545;25;30;0.0454545454545454;0.454545454545455
Control.ERR205724;61;59;0.442622950819672;34;27;0.0573770491803279;0.442622950819672
Control.ERR205724;64;59;0.5625;28;36;0.0625;0.4375
Control.ERR205724;55;59;0.345454545454545;36;19;0.154545454545455;0.345454545454545
Control.ERR205724;52;59;0.5;26;26;0;0.5
Control.ERR205724;55;59;0.490909090909091;28;27;0.00909090909090909;0.490909090909091
Control.ERR205724;63;59;0.444444444444444;35;28;0.0555555555555556;0.444444444444444
Control.ERR205724;59;59;0.491525423728814;30;29;0.00847457627118642;0.491525423728814
Control.ERR205724;62;59;0.387096774193548;38;24;0.112903225806452;0.387096774193548
Control.ERR205724;60;59;0.383333333333333;37;23;0.116666666666667;0.383333333333333
Control.ERR205724;55;59;0.363636363636364;35;20;0.136363636363636;0.363636363636364
Control.ERR205724;63;59;0.523809523809524;30;33;0.0238095238095238;0.476190476190476
Control.ERR205724;55;59;0.563636363636364;24;31;0.0636363636363636;0.436363636363636
Control.ERR205724;54;59;0.518518518518518;26;28;0.0185185185185185;0.481481481481481
Control.ERR205724;61;59;0.573770491803279;26;35;0.0737704918032787;0.426229508196721
Control.ERR205724;55;59;0.545454545454545;25;30;0.0454545454545454;0.454545454545455
Control.ERR205724;55;59;0.472727272727273;29;26;0.0272727272727273;0.472727272727273
Control.ERR205724;58;59;0.5;29;29;0;0.5
Control.ERR205724;65;59;0.430769230769231;37;28;0.0692307692307692;0.430769230769231
Control.ERR205724;50;59;0.44;28;22;0.06;0.44
Control.ERR205724;52;59;0.557692307692308;23;29;0.0576923076923077;0.442307692307692
Control.ERR205724;55;59;0.490909090909091;28;27;0.00909090909090909;0.490909090909091
Control.ERR205724;57;59;0.473684210526316;30;27;0.0263157894736842;0.473684210526316
Control.ERR205724;58;59;0.482758620689655;30;28;0.0172413793103448;0.482758620689655
Control.ERR205724;54;59;0.444444444444444;30;24;0.0555555555555556;0.444444444444444
Control.ERR205724;57;59;0.385964912280702;35;22;0.114035087719298;0.385964912280702
Control.ERR205724;53;59;0.471698113207547;28;25;0.0283018867924528;0.471698113207547
Control.ERR205724;51;59;0.549019607843137;23;28;0.0490196078431373;0.450980392156863
Control.ERR205724;57;59;0.508771929824561;28;29;0.00877192982456143;0.491228070175439
Control.ERR205724;63;59;0.428571428571429;36;27;0.0714285714285715;0.428571428571429
Control.ERR205724;64;59;0.5;32;32;0;0.5
Control.ERR205724;58;59;0.413793103448276;34;24;0.0862068965517241;0.413793103448276
Control.ERR205724;52;59;0.461538461538462;28;24;0.0384615384615384;0.461538461538462
Control.ERR205724;56;59;0.482142857142857;29;27;0.0178571428571428;0.482142857142857
Control.ERR205724;58;59;0.53448275862069;27;31;0.0344827586206896;0.46551724137931
Control.ERR205724;63;59;0.507936507936508;31;32;0.00793650793650791;0.492063492063492
Control.ERR205724;52;59;0.442307692307692;29;23;0.0576923076923077;0.442307692307692
Control.ERR205724;54;59;0.481481481481481;28;26;0.0185185185185185;0.481481481481481
Control.ERR205724;57;59;0.491228070175439;29;28;0.00877192982456143;0.491228070175439
Control.ERR205724;52;59;0.423076923076923;30;22;0.0769230769230769;0.423076923076923
Control.ERR205724;56;59;0.5;28;28;0;0.5
Control.ERR205724;63;59;0.492063492063492;32;31;0.00793650793650796;0.492063492063492
Control.ERR205724;52;59;0.480769230769231;27;25;0.0192307692307692;0.480769230769231
Control.ERR205724;54;59;0.537037037037037;25;29;0.0370370370370371;0.462962962962963
Control.ERR205724;51;59;0.450980392156863;28;23;0.0490196078431372;0.450980392156863
Control.ERR205724;53;59;0.528301886792453;25;28;0.0283018867924528;0.471698113207547
Control.ERR205724;54;59;0.444444444444444;30;24;0.0555555555555556;0.444444444444444
Control.ERR205724;54;59;0.481481481481481;28;26;0.0185185185185185;0.481481481481481
Control.ERR205724;54;59;0.351851851851852;35;19;0.148148148148148;0.351851851851852
Control.ERR205724;55;59;0.454545454545455;30;25;0.0454545454545455;0.454545454545455
Control.ERR205724;53;59;0.39622641509434;32;21;0.10377358490566;0.39622641509434
Control.ERR205724;58;59;0.482758620689655;30;28;0.0172413793103448;0.482758620689655
Control.ERR205724;53;59;0.509433962264151;26;27;0.00943396226415094;0.490566037735849
Control.ERR205724;55;59;0.472727272727273;29;26;0.0272727272727273;0.472727272727273
Control.ERR205724;55;59;0.527272727272727;26;29;0.0272727272727272;0.472727272727273
Control.ERR205724;61;59;0.426229508196721;35;26;0.0737704918032787;0.426229508196721
Control.ERR205724;58;59;0.517241379310345;28;30;0.0172413793103449;0.482758620689655
Control.ERR205724;55;59;0.436363636363636;31;24;0.0636363636363637;0.436363636363636
Control.ERR205724;55;59;0.545454545454545;25;30;0.0454545454545454;0.454545454545455
Control.ERR205724;55;59;0.490909090909091;28;27;0.00909090909090909;0.490909090909091
Control.ERR205724;59;59;0.525423728813559;28;31;0.0254237288135594;0.474576271186441
Control.ERR205724;59;59;0.440677966101695;33;26;0.0593220338983051;0.440677966101695
Control.ERR205724;58;59;0.396551724137931;35;23;0.103448275862069;0.396551724137931
Control.ERR205724;61;59;0.508196721311475;30;31;0.00819672131147542;0.491803278688525
Control.ERR205724;55;59;0.454545454545455;30;25;0.0454545454545455;0.454545454545455
Control.ERR205724;54;59;0.574074074074074;23;31;0.0740740740740741;0.425925925925926
Control.ERR205724;63;59;0.571428571428571;27;36;0.0714285714285714;0.428571428571429
Control.ERR205724;60;59;0.45;33;27;0.05;0.45
Control.ERR205724;59;59;0.474576271186441;31;28;0.0254237288135593;0.474576271186441
Control.ERR205724;60;59;0.516666666666667;29;31;0.0166666666666667;0.483333333333333
Control.ERR205724;61;59;0.475409836065574;32;29;0.0245901639344263;0.475409836065574
Control.ERR205724;58;59;0.46551724137931;31;27;0.0344827586206897;0.46551724137931
Control.ERR205724;58;59;0.431034482758621;33;25;0.0689655172413793;0.431034482758621
Control.ERR205724;49;59;0.653061224489796;17;32;0.153061224489796;0.346938775510204
Control.ERR205724;54;59;0.537037037037037;25;29;0.0370370370370371;0.462962962962963
Control.ERR205724;60;59;0.416666666666667;35;25;0.0833333333333333;0.416666666666667
Control.ERR205724;57;59;0.421052631578947;33;24;0.0789473684210527;0.421052631578947
Control.ERR205724;58;59;0.637931034482759;21;37;0.137931034482759;0.362068965517241
Control.ERR205724;62;59;0.451612903225806;34;28;0.0483870967741936;0.451612903225806
Control.ERR205724;50;59;0.46;27;23;0.04;0.46
Control.ERR205724;55;59;0.527272727272727;26;29;0.0272727272727272;0.472727272727273
Control.ERR205724;53;59;0.490566037735849;27;26;0.00943396226415094;0.490566037735849
Control.ERR205724;65;59;0.523076923076923;31;34;0.0230769230769231;0.476923076923077
Control.ERR205724;62;59;0.483870967741935;32;30;0.0161290322580645;0.483870967741935
Control.ERR205724;62;59;0.403225806451613;37;25;0.0967741935483871;0.403225806451613
Control.ERR205724;49;59;0.448979591836735;27;22;0.0510204081632653;0.448979591836735
Control.ERR205724;52;59;0.461538461538462;28;24;0.0384615384615384;0.461538461538462
Control.ERR205724;63;59;0.555555555555556;28;35;0.0555555555555556;0.444444444444444
Control.ERR205724;59;59;0.491525423728814;30;29;0.00847457627118642;0.491525423728814
Control.ERR205724;62;59;0.548387096774194;28;34;0.0483870967741935;0.451612903225806
Control.ERR205724;64;59;0.5;32;32;0;0.5
Control.ERR205724;54;59;0.388888888888889;33;21;0.111111111111111;0.388888888888889
Control.ERR205724;59;59;0.542372881355932;27;32;0.0423728813559322;0.457627118644068
Control.ERR205724;55;59;0.490909090909091;28;27;0.00909090909090909;0.490909090909091
Control.ERR205724;61;59;0.508196721311475;30;31;0.00819672131147542;0.491803278688525
Control.ERR205724;59;59;0.474576271186441;31;28;0.0254237288135593;0.474576271186441
Control.ERR205724;53;59;0.490566037735849;27;26;0.00943396226415094;0.490566037735849
Control.ERR205724;53;59;0.641509433962264;19;34;0.141509433962264;0.358490566037736
Control.ERR205724;65;59;0.384615384615385;40;25;0.115384615384615;0.384615384615385
Control.ERR205724;57;59;0.526315789473684;27;30;0.0263157894736842;0.473684210526316
Control.ERR205724;53;59;0.490566037735849;27;26;0.00943396226415094;0.490566037735849
Control.ERR205724;65;59;0.523076923076923;31;34;0.0230769230769231;0.476923076923077
Control.ERR205724;49;59;0.448979591836735;27;22;0.0510204081632653;0.448979591836735
Control.ERR205724;50;59;0.44;28;22;0.06;0.44
Control.ERR205724;57;59;0.456140350877193;31;26;0.043859649122807;0.456140350877193
Control.ERR205724;56;59;0.410714285714286;33;23;0.0892857142857143;0.410714285714286
Control.ERR205724;59;59;0.491525423728814;30;29;0.00847457627118642;0.491525423728814
Control.ERR205724;62;59;0.629032258064516;23;39;0.129032258064516;0.370967741935484
Control.ERR205724;57;59;0.473684210526316;30;27;0.0263157894736842;0.473684210526316
Control.ERR205724;62;59;0.532258064516129;29;33;0.032258064516129;0.467741935483871
Control.ERR205724;65;59;0.553846153846154;29;36;0.0538461538461539;0.446153846153846
Control.ERR205724;63;59;0.46031746031746;34;29;0.0396825396825397;0.46031746031746
Control.ERR205724;59;59;0.644067796610169;21;38;0.144067796610169;0.355932203389831
Control.ERR205724;58;59;0.551724137931034;26;32;0.0517241379310345;0.448275862068966
Control.ERR205724;56;59;0.571428571428571;24;32;0.0714285714285714;0.428571428571429
Control.ERR205724;51;59;0.450980392156863;28;23;0.0490196078431372;0.450980392156863
Control.ERR205724;59;59;0.593220338983051;24;35;0.0932203389830508;0.406779661016949
Control.ERR205724;52;59;0.596153846153846;21;31;0.0961538461538461;0.403846153846154
Control.ERR205724;57;59;0.403508771929825;34;23;0.0964912280701755;0.403508771929825
Control.ERR205724;62;59;0.596774193548387;25;37;0.0967741935483871;0.403225806451613
Control.ERR205724;55;59;0.4;33;22;0.1;0.4
Control.ERR205724;62;59;0.596774193548387;25;37;0.0967741935483871;0.403225806451613
Control.ERR205724;53;59;0.660377358490566;18;35;0.160377358490566;0.339622641509434
Control.ERR205724;63;59;0.349206349206349;41;22;0.150793650793651;0.349206349206349
Control.ERR205724;51;59;0.588235294117647;21;30;0.0882352941176471;0.411764705882353
Control.ERR205724;52;59;0.5;26;26;0;0.5
Control.ERR205724;58;59;0.568965517241379;25;33;0.0689655172413793;0.431034482758621
Control.ERR205724;65;59;0.430769230769231;37;28;0.0692307692307692;0.430769230769231
Control.ERR205724;59;59;0.559322033898305;26;33;0.059322033898305;0.440677966101695
Control.ERR205724;65;59;0.4;39;26;0.1;0.4
Control.ERR205724;65;59;0.507692307692308;32;33;0.00769230769230766;0.492307692307692
Control.ERR205724;51;59;0.450980392156863;28;23;0.0490196078431372;0.450980392156863
Control.ERR205724;55;59;0.527272727272727;26;29;0.0272727272727272;0.472727272727273
Control.ERR205724;63;59;0.492063492063492;32;31;0.00793650793650796;0.492063492063492
Control.ERR205724;63;59;0.412698412698413;37;26;0.0873015873015873;0.412698412698413
Control.ERR205724;58;59;0.53448275862069;27;31;0.0344827586206896;0.46551724137931
Control.ERR205724;59;59;0.474576271186441;31;28;0.0254237288135593;0.474576271186441
Control.ERR205724;65;59;0.492307692307692;33;32;0.00769230769230766;0.492307692307692
Control.ERR205724;54;59;0.388888888888889;33;21;0.111111111111111;0.388888888888889
Control.ERR205724;63;59;0.492063492063492;32;31;0.00793650793650796;0.492063492063492
Control.ERR205724;53;59;0.358490566037736;34;19;0.141509433962264;0.358490566037736
Control.ERR205724;56;59;0.571428571428571;24;32;0.0714285714285714;0.428571428571429
Control.ERR205724;52;59;0.461538461538462;28;24;0.0384615384615384;0.461538461538462
Control.ERR205724;61;59;0.475409836065574;32;29;0.0245901639344263;0.475409836065574
Control.ERR205724;65;59;0.461538461538462;35;30;0.0384615384615384;0.461538461538462
Control.ERR205724;60;59;0.566666666666667;26;34;0.0666666666666667;0.433333333333333
Control.ERR205724;59;59;0.525423728813559;28;31;0.0254237288135594;0.474576271186441
Control.ERR205724;59;59;0.559322033898305;26;33;0.059322033898305;0.440677966101695
Control.ERR205724;56;59;0.410714285714286;33;23;0.0892857142857143;0.410714285714286
Control.ERR205724;54;59;0.388888888888889;33;21;0.111111111111111;0.388888888888889
Control.ERR205724;52;59;0.461538461538462;28;24;0.0384615384615384;0.461538461538462
Control.ERR205724;53;59;0.320754716981132;36;17;0.179245283018868;0.320754716981132
Control.ERR205724;51;59;0.431372549019608;29;22;0.0686274509803921;0.431372549019608
Control.ERR205724;50;59;0.44;28;22;0.06;0.44
Control.ERR205724;65;59;0.415384615384615;38;27;0.0846153846153846;0.415384615384615
Control.ERR205724;62;59;0.596774193548387;25;37;0.0967741935483871;0.403225806451613
Control.ERR205724;59;59;0.440677966101695;33;26;0.0593220338983051;0.440677966101695
Control.ERR205724;50;59;0.52;24;26;0.02;0.48
Control.ERR205724;62;59;0.612903225806452;24;38;0.112903225806452;0.387096774193548
Control.ERR205724;60;59;0.466666666666667;32;28;0.0333333333333333;0.466666666666667
Control.ERR205724;55;59;0.545454545454545;25;30;0.0454545454545454;0.454545454545455
Control.ERR205724;51;59;0.607843137254902;20;31;0.107843137254902;0.392156862745098
Control.ERR205724;56;59;0.571428571428571;24;32;0.0714285714285714;0.428571428571429
Control.ERR205724;62;59;0.564516129032258;27;35;0.0645161290322581;0.435483870967742
Control.ERR205724;54;59;0.444444444444444;30;24;0.0555555555555556;0.444444444444444
Control.ERR205724;64;59;0.421875;37;27;0.078125;0.421875
Control.ERR205724;62;59;0.564516129032258;27;35;0.0645161290322581;0.435483870967742
Control.ERR205724;63;59;0.555555555555556;28;35;0.0555555555555556;0.444444444444444
Control.ERR205724;65;59;0.476923076923077;34;31;0.0230769230769231;0.476923076923077
Control.ERR205724;55;59;0.563636363636364;24;31;0.0636363636363636;0.436363636363636
Control.ERR205724;64;59;0.453125;35;29;0.046875;0.453125
Control.ERR205724;59;59;0.440677966101695;33;26;0.0593220338983051;0.440677966101695
Control.ERR205724;56;59;0.589285714285714;23;33;0.0892857142857143;0.410714285714286
Control.ERR205724;63;59;0.476190476190476;33;30;0.0238095238095238;0.476190476190476
Control.ERR205724;60;59;0.4;36;24;0.1;0.4
Control.ERR205724;57;59;0.508771929824561;28;29;0.00877192982456143;0.491228070175439
Control.ERR205724;50;59;0.44;28;22;0.06;0.44
Control.ERR205724;57;59;0.473684210526316;30;27;0.0263157894736842;0.473684210526316
Control.ERR205724;52;59;0.5;26;26;0;0.5
Control.ERR205724;58;59;0.724137931034483;16;42;0.224137931034483;0.275862068965517
Control.ERR205724;63;59;0.634920634920635;23;40;0.134920634920635;0.365079365079365
Control.ERR205724;54;59;0.481481481481481;28;26;0.0185185185185185;0.481481481481481
Control.ERR205724;57;59;0.473684210526316;30;27;0.0263157894736842;0.473684210526316
Control.ERR205724;58;59;0.620689655172414;22;36;0.120689655172414;0.379310344827586
Control.ERR205724;53;59;0.471698113207547;28;25;0.0283018867924528;0.471698113207547
Control.ERR205724;51;59;0.529411764705882;24;27;0.0294117647058824;0.470588235294118
Control.ERR205724;53;59;0.60377358490566;21;32;0.10377358490566;0.39622641509434
Control.ERR205724;63;59;0.619047619047619;24;39;0.119047619047619;0.380952380952381
Control.ERR205724;60;59;0.55;27;33;0.05;0.45
Control.ERR205724;60;59;0.483333333333333;31;29;0.0166666666666667;0.483333333333333
Control.ERR205724;55;59;0.363636363636364;35;20;0.136363636363636;0.363636363636364
Control.ERR205724;52;59;0.538461538461538;24;28;0.0384615384615384;0.461538461538462
Control.ERR205724;53;59;0.509433962264151;26;27;0.00943396226415094;0.490566037735849
Control.ERR205724;52;59;0.538461538461538;24;28;0.0384615384615384;0.461538461538462
Control.ERR205724;59;59;0.440677966101695;33;26;0.0593220338983051;0.440677966101695
Control.ERR205724;65;59;0.492307692307692;33;32;0.00769230769230766;0.492307692307692
Control.ERR205724;60;59;0.5;30;30;0;0.5
Control.ERR205724;65;59;0.523076923076923;31;34;0.0230769230769231;0.476923076923077
Control.ERR205724;55;59;0.490909090909091;28;27;0.00909090909090909;0.490909090909091
Control.ERR205724;58;59;0.431034482758621;33;25;0.0689655172413793;0.431034482758621
Control.ERR205724;52;59;0.519230769230769;25;27;0.0192307692307693;0.480769230769231
Control.ERR205724;61;59;0.508196721311475;30;31;0.00819672131147542;0.491803278688525
Control.ERR205724;57;59;0.456140350877193;31;26;0.043859649122807;0.456140350877193
Control.ERR205724;58;59;0.5;29;29;0;0.5
Control.ERR205724;59;59;0.576271186440678;25;34;0.076271186440678;0.423728813559322
Control.ERR205724;64;59;0.484375;33;31;0.015625;0.484375
Control.ERR205724;51;59;0.470588235294118;27;24;0.0294117647058824;0.470588235294118
Control.ERR205724;55;59;0.418181818181818;32;23;0.0818181818181818;0.418181818181818
Control.ERR205724;58;59;0.482758620689655;30;28;0.0172413793103448;0.482758620689655
Control.ERR205724;65;59;0.584615384615385;27;38;0.0846153846153846;0.415384615384615
Control.ERR205724;51;59;0.450980392156863;28;23;0.0490196078431372;0.450980392156863
Control.ERR205724;54;59;0.462962962962963;29;25;0.037037037037037;0.462962962962963
Control.ERR205724;52;59;0.480769230769231;27;25;0.0192307692307692;0.480769230769231
Control.ERR205724;58;59;0.551724137931034;26;32;0.0517241379310345;0.448275862068966
Control.ERR205724;56;59;0.446428571428571;31;25;0.0535714285714285;0.446428571428571
Control.ERR205724;58;59;0.482758620689655;30;28;0.0172413793103448;0.482758620689655
Control.ERR205724;55;59;0.472727272727273;29;26;0.0272727272727273;0.472727272727273
Control.ERR205724;53;59;0.547169811320755;24;29;0.0471698113207547;0.452830188679245
Control.ERR205724;64;59;0.53125;30;34;0.03125;0.46875
Control.ERR205724;65;59;0.430769230769231;37;28;0.0692307692307692;0.430769230769231
Control.ERR205724;60;59;0.4;36;24;0.1;0.4
Control.ERR205724;56;59;0.446428571428571;31;25;0.0535714285714285;0.446428571428571
Control.ERR205724;50;59;0.5;25;25;0;0.5
Control.ERR205724;54;59;0.518518518518518;26;28;0.0185185185185185;0.481481481481481
Control.ERR205724;65;59;0.523076923076923;31;34;0.0230769230769231;0.476923076923077
Control.ERR205724;63;59;0.46031746031746;34;29;0.0396825396825397;0.46031746031746
Control.ERR205724;62;59;0.612903225806452;24;38;0.112903225806452;0.387096774193548
Control.ERR205724;53;59;0.471698113207547;28;25;0.0283018867924528;0.471698113207547
Control.ERR205724;57;59;0.43859649122807;32;25;0.0614035087719298;0.43859649122807
Control.ERR205724;64;59;0.640625;23;41;0.140625;0.359375
Control.ERR205724;52;59;0.615384615384615;20;32;0.115384615384615;0.384615384615385
Control.ERR205724;55;59;0.509090909090909;27;28;0.00909090909090904;0.490909090909091
Control.ERR205724;58;59;0.413793103448276;34;24;0.0862068965517241;0.413793103448276
Control.ERR205724;56;59;0.517857142857143;27;29;0.0178571428571429;0.482142857142857
Control.ERR205724;63;59;0.634920634920635;23;40;0.134920634920635;0.365079365079365
Control.ERR205724;49;59;0.448979591836735;27;22;0.0510204081632653;0.448979591836735
Control.ERR205724;57;59;0.456140350877193;31;26;0.043859649122807;0.456140350877193
Control.ERR205724;65;59;0.430769230769231;37;28;0.0692307692307692;0.430769230769231
Control.ERR205724;65;59;0.569230769230769;28;37;0.0692307692307692;0.430769230769231
Control.ERR205724;60;59;0.5;30;30;0;0.5
Control.ERR205724;57;59;0.508771929824561;28;29;0.00877192982456143;0.491228070175439
Control.ERR205724;60;59;0.583333333333333;25;35;0.0833333333333334;0.416666666666667
Control.ERR205724;65;59;0.538461538461538;30;35;0.0384615384615384;0.461538461538462
Control.ERR205724;65;59;0.476923076923077;34;31;0.0230769230769231;0.476923076923077
Control.ERR205724;51;59;0.450980392156863;28;23;0.0490196078431372;0.450980392156863
Control.ERR205724;58;59;0.448275862068966;32;26;0.0517241379310345;0.448275862068966
Control.ERR205724;51;59;0.470588235294118;27;24;0.0294117647058824;0.470588235294118
Control.ERR205724;57;59;0.473684210526316;30;27;0.0263157894736842;0.473684210526316
Control.ERR205724;65;59;0.461538461538462;35;30;0.0384615384615384;0.461538461538462
Control.ERR205724;65;59;0.430769230769231;37;28;0.0692307692307692;0.430769230769231
Control.ERR205724;55;59;0.581818181818182;23;32;0.0818181818181818;0.418181818181818
Control.ERR205724;60;59;0.45;33;27;0.05;0.45
Control.ERR205724;52;59;0.423076923076923;30;22;0.0769230769230769;0.423076923076923
Control.ERR205724;56;59;0.464285714285714;30;26;0.0357142857142857;0.464285714285714
Control.ERR205724;56;59;0.446428571428571;31;25;0.0535714285714285;0.446428571428571
Control.ERR205724;54;59;0.388888888888889;33;21;0.111111111111111;0.388888888888889
Control.ERR205724;51;59;0.509803921568627;25;26;0.00980392156862742;0.490196078431373
Control.ERR205724;57;59;0.43859649122807;32;25;0.0614035087719298;0.43859649122807
Control.ERR205724;57;59;0.43859649122807;32;25;0.0614035087719298;0.43859649122807
Control.ERR205724;59;59;0.508474576271186;29;30;0.00847457627118642;0.491525423728814
Control.ERR205724;50;59;0.5;25;25;0;0.5
Control.ERR205724;61;59;0.540983606557377;28;33;0.0409836065573771;0.459016393442623
Control.ERR205724;52;59;0.365384615384615;33;19;0.134615384615385;0.365384615384615
Control.ERR205724;55;59;0.454545454545455;30;25;0.0454545454545455;0.454545454545455
Control.ERR205724;59;59;0.576271186440678;25;34;0.076271186440678;0.423728813559322
Control.ERR205724;57;59;0.473684210526316;30;27;0.0263157894736842;0.473684210526316
Control.ERR205724;53;59;0.641509433962264;19;34;0.141509433962264;0.358490566037736
Control.ERR205724;64;59;0.5625;28;36;0.0625;0.4375
Control.ERR205724;60;59;0.533333333333333;28;32;0.0333333333333333;0.466666666666667
Control.ERR205724;60;59;0.633333333333333;22;38;0.133333333333333;0.366666666666667
Control.ERR205724;56;59;0.589285714285714;23;33;0.0892857142857143;0.410714285714286
Control.ERR205724;59;59;0.508474576271186;29;30;0.00847457627118642;0.491525423728814
Control.ERR205724;55;59;0.472727272727273;29;26;0.0272727272727273;0.472727272727273
Control.ERR205724;66;59;0.424242424242424;38;28;0.0757575757575757;0.424242424242424
Control.ERR205724;58;59;0.46551724137931;31;27;0.0344827586206897;0.46551724137931
Control.ERR205724;57;59;0.473684210526316;30;27;0.0263157894736842;0.473684210526316
Control.ERR205724;59;59;0.508474576271186;29;30;0.00847457627118642;0.491525423728814
Control.ERR205724;66;59;0.439393939393939;37;29;0.0606060606060606;0.439393939393939
Control.ERR205724;60;59;0.633333333333333;22;38;0.133333333333333;0.366666666666667
Control.ERR205724;55;59;0.418181818181818;32;23;0.0818181818181818;0.418181818181818
Control.ERR205724;57;59;0.526315789473684;27;30;0.0263157894736842;0.473684210526316
Control.ERR205724;57;59;0.456140350877193;31;26;0.043859649122807;0.456140350877193
Control.ERR205724;57;59;0.491228070175439;29;28;0.00877192982456143;0.491228070175439
Control.ERR205724;53;59;0.641509433962264;19;34;0.141509433962264;0.358490566037736
Control.ERR205724;58;59;0.482758620689655;30;28;0.0172413793103448;0.482758620689655
Control.ERR205724;55;59;0.290909090909091;39;16;0.209090909090909;0.290909090909091
Control.ERR205724;60;59;0.483333333333333;31;29;0.0166666666666667;0.483333333333333
Control.ERR205724;62;59;0.451612903225806;34;28;0.0483870967741936;0.451612903225806
Control.ERR205724;51;59;0.568627450980392;22;29;0.0686274509803921;0.431372549019608
Control.ERR205724;56;59;0.571428571428571;24;32;0.0714285714285714;0.428571428571429
Control.ERR205724;63;59;0.412698412698413;37;26;0.0873015873015873;0.412698412698413
Control.ERR205724;51;59;0.470588235294118;27;24;0.0294117647058824;0.470588235294118
Control.ERR205724;57;59;0.473684210526316;30;27;0.0263157894736842;0.473684210526316
Control.ERR205724;60;59;0.466666666666667;32;28;0.0333333333333333;0.466666666666667
Control.ERR205724;60;59;0.433333333333333;34;26;0.0666666666666667;0.433333333333333
Control.ERR205724;50;59;0.5;25;25;0;0.5
Control.ERR205724;66;59;0.560606060606061;29;37;0.0606060606060606;0.439393939393939
Control.ERR205724;59;59;0.440677966101695;33;26;0.0593220338983051;0.440677966101695
Control.ERR205724;53;59;0.433962264150943;30;23;0.0660377358490566;0.433962264150943
Control.ERR205724;60;59;0.633333333333333;22;38;0.133333333333333;0.366666666666667
Control.ERR205724;50;59;0.6;20;30;0.1;0.4
Control.ERR205724;57;59;0.526315789473684;27;30;0.0263157894736842;0.473684210526316
Control.ERR205724;56;59;0.589285714285714;23;33;0.0892857142857143;0.410714285714286
Control.ERR205724;51;59;0.647058823529412;18;33;0.147058823529412;0.352941176470588
Control.ERR205724;57;59;0.508771929824561;28;29;0.00877192982456143;0.491228070175439
Control.ERR205724;56;59;0.517857142857143;27;29;0.0178571428571429;0.482142857142857
Control.ERR205724;60;59;0.466666666666667;32;28;0.0333333333333333;0.466666666666667
Control.ERR205724;54;59;0.685185185185185;17;37;0.185185185185185;0.314814814814815
Control.ERR205724;55;59;0.563636363636364;24;31;0.0636363636363636;0.436363636363636
Control.ERR205724;61;59;0.622950819672131;23;38;0.122950819672131;0.377049180327869
Control.ERR205724;50;59;0.34;33;17;0.16;0.34
Control.ERR205724;62;59;0.387096774193548;38;24;0.112903225806452;0.387096774193548
Control.ERR205724;57;59;0.43859649122807;32;25;0.0614035087719298;0.43859649122807
Control.ERR205724;54;59;0.611111111111111;21;33;0.111111111111111;0.388888888888889
Control.ERR205724;65;59;0.523076923076923;31;34;0.0230769230769231;0.476923076923077
Control.ERR205724;53;59;0.547169811320755;24;29;0.0471698113207547;0.452830188679245
Control.ERR205724;64;59;0.546875;29;35;0.046875;0.453125
Control.ERR205724;66;59;0.409090909090909;39;27;0.0909090909090909;0.409090909090909
Control.ERR205724;56;59;0.517857142857143;27;29;0.0178571428571429;0.482142857142857
Control.ERR205724;58;59;0.53448275862069;27;31;0.0344827586206896;0.46551724137931
Control.ERR205724;56;59;0.464285714285714;30;26;0.0357142857142857;0.464285714285714
Control.ERR205724;59;59;0.457627118644068;32;27;0.0423728813559322;0.457627118644068
Control.ERR205724;65;59;0.538461538461538;30;35;0.0384615384615384;0.461538461538462
Control.ERR205724;56;59;0.285714285714286;40;16;0.214285714285714;0.285714285714286
Control.ERR205724;53;59;0.528301886792453;25;28;0.0283018867924528;0.471698113207547
Control.ERR205724;66;59;0.53030303030303;31;35;0.0303030303030303;0.46969696969697
Control.ERR205724;52;59;0.519230769230769;25;27;0.0192307692307693;0.480769230769231
Control.ERR205724;59;59;0.491525423728814;30;29;0.00847457627118642;0.491525423728814
Control.ERR205724;62;59;0.483870967741935;32;30;0.0161290322580645;0.483870967741935
Control.ERR205724;57;59;0.43859649122807;32;25;0.0614035087719298;0.43859649122807
Control.ERR205724;58;59;0.46551724137931;31;27;0.0344827586206897;0.46551724137931
Control.ERR205724;58;59;0.448275862068966;32;26;0.0517241379310345;0.448275862068966
Control.ERR205724;57;59;0.543859649122807;26;31;0.043859649122807;0.456140350877193
Control.ERR205724;58;59;0.568965517241379;25;33;0.0689655172413793;0.431034482758621
Control.ERR205724;57;59;0.350877192982456;37;20;0.149122807017544;0.350877192982456
Control.ERR205724;58;59;0.53448275862069;27;31;0.0344827586206896;0.46551724137931
Control.ERR205724;59;59;0.627118644067797;22;37;0.127118644067797;0.372881355932203
Control.ERR205724;55;59;0.545454545454545;25;30;0.0454545454545454;0.454545454545455
Control.ERR205724;52;59;0.461538461538462;28;24;0.0384615384615384;0.461538461538462
Control.ERR205724;54;59;0.666666666666667;18;36;0.166666666666667;0.333333333333333
Control.ERR205724;61;59;0.508196721311475;30;31;0.00819672131147542;0.491803278688525
Control.ERR205724;64;59;0.5;32;32;0;0.5
Control.ERR205724;60;59;0.416666666666667;35;25;0.0833333333333333;0.416666666666667
Control.ERR205724;63;59;0.507936507936508;31;32;0.00793650793650791;0.492063492063492
Control.ERR205724;50;59;0.44;28;22;0.06;0.44
Control.ERR205724;64;59;0.515625;31;33;0.015625;0.484375
Control.ERR205724;59;59;0.610169491525424;23;36;0.110169491525424;0.389830508474576
Control.ERR205724;61;59;0.39344262295082;37;24;0.10655737704918;0.39344262295082
Control.ERR205724;63;59;0.507936507936508;31;32;0.00793650793650791;0.492063492063492
Control.ERR205724;65;59;0.569230769230769;28;37;0.0692307692307692;0.430769230769231
Control.ERR205724;62;59;0.338709677419355;41;21;0.161290322580645;0.338709677419355
Control.ERR205724;62;59;0.5;31;31;0;0.5
Control.ERR205724;63;59;0.476190476190476;33;30;0.0238095238095238;0.476190476190476
Control.ERR205724;59;59;0.457627118644068;32;27;0.0423728813559322;0.457627118644068
Control.ERR205724;54;59;0.555555555555556;24;30;0.0555555555555556;0.444444444444444
Control.ERR205724;59;59;0.440677966101695;33;26;0.0593220338983051;0.440677966101695
Control.ERR205724;65;59;0.492307692307692;33;32;0.00769230769230766;0.492307692307692
Control.ERR205724;57;59;0.491228070175439;29;28;0.00877192982456143;0.491228070175439
Control.ERR205724;59;59;0.542372881355932;27;32;0.0423728813559322;0.457627118644068
Control.ERR205724;65;59;0.507692307692308;32;33;0.00769230769230766;0.492307692307692
Control.ERR205724;58;59;0.53448275862069;27;31;0.0344827586206896;0.46551724137931
Control.ERR205724;61;59;0.459016393442623;33;28;0.040983606557377;0.459016393442623
Control.ERR205724;58;59;0.53448275862069;27;31;0.0344827586206896;0.46551724137931
Control.ERR205724;65;59;0.461538461538462;35;30;0.0384615384615384;0.461538461538462
Control.ERR205724;64;59;0.5;32;32;0;0.5
Control.ERR205724;66;59;0.454545454545455;36;30;0.0454545454545455;0.454545454545455
Control.ERR205724;60;59;0.533333333333333;28;32;0.0333333333333333;0.466666666666667
Control.ERR205724;52;59;0.557692307692308;23;29;0.0576923076923077;0.442307692307692
Control.ERR205724;60;59;0.65;21;39;0.15;0.35
Control.ERR205724;58;59;0.551724137931034;26;32;0.0517241379310345;0.448275862068966
Control.ERR205724;55;59;0.454545454545455;30;25;0.0454545454545455;0.454545454545455
Control.ERR205724;60;59;0.533333333333333;28;32;0.0333333333333333;0.466666666666667
Control.ERR205724;63;59;0.428571428571429;36;27;0.0714285714285715;0.428571428571429
Control.ERR205724;54;59;0.481481481481481;28;26;0.0185185185185185;0.481481481481481
Control.ERR205724;57;59;0.56140350877193;25;32;0.0614035087719298;0.43859649122807
Control.ERR205724;60;59;0.433333333333333;34;26;0.0666666666666667;0.433333333333333
Control.ERR205724;60;59;0.4;36;24;0.1;0.4
Control.ERR205724;52;59;0.519230769230769;25;27;0.0192307692307693;0.480769230769231
Control.ERR205724;64;59;0.40625;38;26;0.09375;0.40625
Control.ERR205724;64;59;0.546875;29;35;0.046875;0.453125
Control.ERR205724;63;59;0.507936507936508;31;32;0.00793650793650791;0.492063492063492
Control.ERR205724;57;59;0.596491228070175;23;34;0.0964912280701754;0.403508771929825
Control.ERR205724;53;59;0.509433962264151;26;27;0.00943396226415094;0.490566037735849
Control.ERR205724;61;59;0.409836065573771;36;25;0.0901639344262295;0.409836065573771
Control.ERR205724;51;59;0.568627450980392;22;29;0.0686274509803921;0.431372549019608
Control.ERR205724;60;59;0.55;27;33;0.05;0.45
Control.ERR205724;64;59;0.5;32;32;0;0.5
Control.ERR205724;62;59;0.67741935483871;20;42;0.17741935483871;0.32258064516129
Control.ERR205724;61;59;0.426229508196721;35;26;0.0737704918032787;0.426229508196721
Control.ERR205724;63;59;0.571428571428571;27;36;0.0714285714285714;0.428571428571429
Control.ERR205724;59;59;0.440677966101695;33;26;0.0593220338983051;0.440677966101695
Control.ERR205724;61;59;0.540983606557377;28;33;0.0409836065573771;0.459016393442623
Control.ERR205724;59;59;0.491525423728814;30;29;0.00847457627118642;0.491525423728814
Control.ERR205724;65;59;0.630769230769231;24;41;0.130769230769231;0.369230769230769
Control.ERR205724;61;59;0.475409836065574;32;29;0.0245901639344263;0.475409836065574
Control.ERR205724;63;59;0.523809523809524;30;33;0.0238095238095238;0.476190476190476
Control.ERR205724;54;59;0.62962962962963;20;34;0.12962962962963;0.37037037037037
Control.ERR205724;59;59;0.627118644067797;22;37;0.127118644067797;0.372881355932203
Control.ERR205724;53;59;0.471698113207547;28;25;0.0283018867924528;0.471698113207547
Control.ERR205724;51;59;0.529411764705882;24;27;0.0294117647058824;0.470588235294118
Control.ERR205724;50;59;0.56;22;28;0.0600000000000001;0.44
Control.ERR205724;62;59;0.532258064516129;29;33;0.032258064516129;0.467741935483871
Control.ERR205724;53;59;0.452830188679245;29;24;0.0471698113207547;0.452830188679245
Control.ERR205724;61;59;0.508196721311475;30;31;0.00819672131147542;0.491803278688525
Control.ERR205724;58;59;0.620689655172414;22;36;0.120689655172414;0.379310344827586
Control.ERR205724;56;59;0.553571428571429;25;31;0.0535714285714286;0.446428571428571
Control.ERR205724;56;59;0.482142857142857;29;27;0.0178571428571428;0.482142857142857
Control.ERR205724;63;59;0.634920634920635;23;40;0.134920634920635;0.365079365079365
Control.ERR205724;61;59;0.491803278688525;31;30;0.00819672131147542;0.491803278688525
Control.ERR205724;57;59;0.526315789473684;27;30;0.0263157894736842;0.473684210526316
Control.ERR205724;63;59;0.428571428571429;36;27;0.0714285714285715;0.428571428571429
Control.ERR205724;62;59;0.435483870967742;35;27;0.0645161290322581;0.435483870967742
Control.ERR205724;52;59;0.538461538461538;24;28;0.0384615384615384;0.461538461538462
Control.ERR205724;58;59;0.448275862068966;32;26;0.0517241379310345;0.448275862068966
Control.ERR205724;63;59;0.523809523809524;30;33;0.0238095238095238;0.476190476190476
Control.ERR205724;63;59;0.444444444444444;35;28;0.0555555555555556;0.444444444444444
Control.ERR205724;62;59;0.467741935483871;33;29;0.0322580645161291;0.467741935483871
Control.ERR205724;51;59;0.549019607843137;23;28;0.0490196078431373;0.450980392156863
Control.ERR205724;53;59;0.566037735849057;23;30;0.0660377358490566;0.433962264150943
Control.ERR205724;59;59;0.322033898305085;40;19;0.177966101694915;0.322033898305085
Control.ERR205724;52;59;0.538461538461538;24;28;0.0384615384615384;0.461538461538462
Control.ERR205724;63;59;0.444444444444444;35;28;0.0555555555555556;0.444444444444444
Control.ERR205724;65;59;0.384615384615385;40;25;0.115384615384615;0.384615384615385
Control.ERR205724;61;59;0.557377049180328;27;34;0.0573770491803278;0.442622950819672
Control.ERR205724;62;59;0.483870967741935;32;30;0.0161290322580645;0.483870967741935
Control.ERR205724;51;59;0.392156862745098;31;20;0.107843137254902;0.392156862745098
Control.ERR205724;58;59;0.53448275862069;27;31;0.0344827586206896;0.46551724137931
Control.ERR205724;55;59;0.527272727272727;26;29;0.0272727272727272;0.472727272727273
Control.ERR205724;66;59;0.621212121212121;25;41;0.121212121212121;0.378787878787879
Control.ERR205724;62;59;0.516129032258065;30;32;0.0161290322580645;0.483870967741935
Control.ERR205724;57;59;0.596491228070175;23;34;0.0964912280701754;0.403508771929825
Control.ERR205724;55;59;0.454545454545455;30;25;0.0454545454545455;0.454545454545455
Control.ERR205724;50;59;0.44;28;22;0.06;0.44
Control.ERR205724;52;59;0.576923076923077;22;30;0.0769230769230769;0.423076923076923
Control.ERR205724;64;59;0.625;24;40;0.125;0.375
Control.ERR205724;60;59;0.5;30;30;0;0.5
Control.ERR205724;59;59;0.474576271186441;31;28;0.0254237288135593;0.474576271186441
Control.ERR205724;56;59;0.553571428571429;25;31;0.0535714285714286;0.446428571428571
Control.ERR205724;60;59;0.466666666666667;32;28;0.0333333333333333;0.466666666666667
Control.ERR205724;56;59;0.446428571428571;31;25;0.0535714285714285;0.446428571428571
Control.ERR205724;55;59;0.509090909090909;27;28;0.00909090909090904;0.490909090909091
Control.ERR205724;54;59;0.481481481481481;28;26;0.0185185185185185;0.481481481481481
Control.ERR205724;53;59;0.471698113207547;28;25;0.0283018867924528;0.471698113207547
Control.ERR205724;60;59;0.55;27;33;0.05;0.45
Control.ERR205724;61;59;0.524590163934426;29;32;0.0245901639344263;0.475409836065574
Control.ERR205724;55;59;0.618181818181818;21;34;0.118181818181818;0.381818181818182
Control.ERR205724;64;59;0.65625;22;42;0.15625;0.34375
Control.ERR205724;62;59;0.5;31;31;0;0.5
Control.ERR205724;65;59;0.507692307692308;32;33;0.00769230769230766;0.492307692307692
Control.ERR205724;62;59;0.596774193548387;25;37;0.0967741935483871;0.403225806451613
Control.ERR205724;60;59;0.566666666666667;26;34;0.0666666666666667;0.433333333333333
Control.ERR205724;58;59;0.586206896551724;24;34;0.0862068965517241;0.413793103448276
Control.ERR205724;52;59;0.596153846153846;21;31;0.0961538461538461;0.403846153846154
Control.ERR205724;64;59;0.46875;34;30;0.03125;0.46875
Control.ERR205724;51;59;0.450980392156863;28;23;0.0490196078431372;0.450980392156863
Control.ERR205724;52;59;0.576923076923077;22;30;0.0769230769230769;0.423076923076923
Control.ERR205724;58;59;0.586206896551724;24;34;0.0862068965517241;0.413793103448276
Control.ERR205724;59;59;0.525423728813559;28;31;0.0254237288135594;0.474576271186441
Control.ERR205724;64;59;0.578125;27;37;0.078125;0.421875
Control.ERR205724;59;59;0.457627118644068;32;27;0.0423728813559322;0.457627118644068
Control.ERR205724;62;59;0.387096774193548;38;24;0.112903225806452;0.387096774193548
Control.ERR205724;52;59;0.538461538461538;24;28;0.0384615384615384;0.461538461538462
Control.ERR205724;55;59;0.581818181818182;23;32;0.0818181818181818;0.418181818181818
Control.ERR205724;61;59;0.524590163934426;29;32;0.0245901639344263;0.475409836065574
Control.ERR205724;62;59;0.596774193548387;25;37;0.0967741935483871;0.403225806451613
Control.ERR205724;59;59;0.457627118644068;32;27;0.0423728813559322;0.457627118644068
Control.ERR205724;60;59;0.4;36;24;0.1;0.4
Control.ERR205724;54;59;0.407407407407407;32;22;0.0925925925925926;0.407407407407407
Control.ERR205724;58;59;0.5;29;29;0;0.5
Control.ERR205724;62;59;0.516129032258065;30;32;0.0161290322580645;0.483870967741935
Control.ERR205724;58;59;0.448275862068966;32;26;0.0517241379310345;0.448275862068966
Control.ERR205724;56;59;0.375;35;21;0.125;0.375
Control.ERR205724;56;59;0.535714285714286;26;30;0.0357142857142857;0.464285714285714
Control.ERR205724;60;59;0.45;33;27;0.05;0.45
Control.ERR205724;60;59;0.566666666666667;26;34;0.0666666666666667;0.433333333333333
Control.ERR205724;51;59;0.509803921568627;25;26;0.00980392156862742;0.490196078431373
Control.ERR205724;61;59;0.622950819672131;23;38;0.122950819672131;0.377049180327869
Control.ERR205724;55;59;0.581818181818182;23;32;0.0818181818181818;0.418181818181818
Control.ERR205724;53;59;0.377358490566038;33;20;0.122641509433962;0.377358490566038
Control.ERR205724;51;59;0.450980392156863;28;23;0.0490196078431372;0.450980392156863
Control.ERR205724;64;59;0.5625;28;36;0.0625;0.4375
Control.ERR205724;65;59;0.523076923076923;31;34;0.0230769230769231;0.476923076923077
Control.ERR205724;52;59;0.403846153846154;31;21;0.0961538461538461;0.403846153846154
Control.ERR205724;55;59;0.581818181818182;23;32;0.0818181818181818;0.418181818181818
Control.ERR205724;62;59;0.5;31;31;0;0.5
Control.ERR205724;66;59;0.484848484848485;34;32;0.0151515151515151;0.484848484848485
Control.ERR205724;56;59;0.5;28;28;0;0.5
Control.ERR205724;50;59;0.52;24;26;0.02;0.48
Control.ERR205724;61;59;0.508196721311475;30;31;0.00819672131147542;0.491803278688525
Control.ERR205724;54;59;0.537037037037037;25;29;0.0370370370370371;0.462962962962963
Control.ERR205724;56;59;0.446428571428571;31;25;0.0535714285714285;0.446428571428571
Control.ERR205724;61;59;0.508196721311475;30;31;0.00819672131147542;0.491803278688525
Control.ERR205724;53;59;0.377358490566038;33;20;0.122641509433962;0.377358490566038
Control.ERR205724;64;59;0.53125;30;34;0.03125;0.46875
Control.ERR205724;63;59;0.555555555555556;28;35;0.0555555555555556;0.444444444444444
Control.ERR205724;53;59;0.433962264150943;30;23;0.0660377358490566;0.433962264150943
Control.ERR205724;59;59;0.576271186440678;25;34;0.076271186440678;0.423728813559322
Control.ERR205724;54;59;0.5;27;27;0;0.5
Control.ERR205724;56;59;0.607142857142857;22;34;0.107142857142857;0.392857142857143
Control.ERR205724;65;59;0.492307692307692;33;32;0.00769230769230766;0.492307692307692
Control.ERR205724;63;59;0.428571428571429;36;27;0.0714285714285715;0.428571428571429
Control.ERR205724;57;59;0.403508771929825;34;23;0.0964912280701755;0.403508771929825
Control.ERR205724;60;59;0.483333333333333;31;29;0.0166666666666667;0.483333333333333
Control.ERR205724;59;59;0.440677966101695;33;26;0.0593220338983051;0.440677966101695
Control.ERR205724;52;59;0.403846153846154;31;21;0.0961538461538461;0.403846153846154
Control.ERR205724;53;59;0.433962264150943;30;23;0.0660377358490566;0.433962264150943
Control.ERR205724;61;59;0.508196721311475;30;31;0.00819672131147542;0.491803278688525
Control.ERR205724;61;59;0.508196721311475;30;31;0.00819672131147542;0.491803278688525
Control.ERR205724;57;59;0.491228070175439;29;28;0.00877192982456143;0.491228070175439
Control.ERR205724;64;59;0.453125;35;29;0.046875;0.453125
Control.ERR205724;51;59;0.470588235294118;27;24;0.0294117647058824;0.470588235294118
Control.ERR205724;55;59;0.509090909090909;27;28;0.00909090909090904;0.490909090909091
Control.ERR205724;57;59;0.385964912280702;35;22;0.114035087719298;0.385964912280702
Control.ERR205724;51;59;0.568627450980392;22;29;0.0686274509803921;0.431372549019608
Control.ERR205724;56;59;0.5;28;28;0;0.5
Control.ERR205724;66;59;0.560606060606061;29;37;0.0606060606060606;0.439393939393939
Control.ERR205724;61;59;0.524590163934426;29;32;0.0245901639344263;0.475409836065574
Control.ERR205724;57;59;0.526315789473684;27;30;0.0263157894736842;0.473684210526316
Control.ERR205724;56;59;0.339285714285714;37;19;0.160714285714286;0.339285714285714
Control.ERR205724;61;59;0.491803278688525;31;30;0.00819672131147542;0.491803278688525
Control.ERR205724;61;59;0.377049180327869;38;23;0.122950819672131;0.377049180327869
Control.ERR205724;56;59;0.5;28;28;0;0.5
Control.ERR205724;59;59;0.508474576271186;29;30;0.00847457627118642;0.491525423728814
Control.ERR205724;67;59;0.537313432835821;31;36;0.0373134328358209;0.462686567164179
Control.ERR205724;58;59;0.5;29;29;0;0.5
Control.ERR205724;61;59;0.39344262295082;37;24;0.10655737704918;0.39344262295082
Control.ERR205724;59;59;0.457627118644068;32;27;0.0423728813559322;0.457627118644068
Control.ERR205724;62;59;0.564516129032258;27;35;0.0645161290322581;0.435483870967742
Control.ERR205724;65;59;0.492307692307692;33;32;0.00769230769230766;0.492307692307692
Control.ERR205724;60;59;0.533333333333333;28;32;0.0333333333333333;0.466666666666667
Control.ERR205724;59;59;0.525423728813559;28;31;0.0254237288135594;0.474576271186441
Control.ERR205724;61;59;0.39344262295082;37;24;0.10655737704918;0.39344262295082
Control.ERR205724;56;59;0.517857142857143;27;29;0.0178571428571429;0.482142857142857
Control.ERR205724;56;59;0.571428571428571;24;32;0.0714285714285714;0.428571428571429
Control.ERR205724;57;59;0.508771929824561;28;29;0.00877192982456143;0.491228070175439
Control.ERR205724;54;59;0.574074074074074;23;31;0.0740740740740741;0.425925925925926
Control.ERR205724;58;59;0.53448275862069;27;31;0.0344827586206896;0.46551724137931
Control.ERR205724;55;59;0.436363636363636;31;24;0.0636363636363637;0.436363636363636
Control.ERR205724;64;59;0.59375;26;38;0.09375;0.40625
Control.ERR205724;59;59;0.576271186440678;25;34;0.076271186440678;0.423728813559322
Control.ERR205724;61;59;0.459016393442623;33;28;0.040983606557377;0.459016393442623
Control.ERR205724;55;59;0.563636363636364;24;31;0.0636363636363636;0.436363636363636
Control.ERR205724;60;59;0.583333333333333;25;35;0.0833333333333334;0.416666666666667
Control.ERR205724;65;59;0.476923076923077;34;31;0.0230769230769231;0.476923076923077
Control.ERR205724;52;59;0.653846153846154;18;34;0.153846153846154;0.346153846153846
Control.ERR205724;55;59;0.527272727272727;26;29;0.0272727272727272;0.472727272727273
Control.ERR205724;59;59;0.440677966101695;33;26;0.0593220338983051;0.440677966101695
Control.ERR205724;66;59;0.515151515151515;32;34;0.0151515151515151;0.484848484848485
Control.ERR205724;58;59;0.396551724137931;35;23;0.103448275862069;0.396551724137931
Control.ERR205724;65;59;0.476923076923077;34;31;0.0230769230769231;0.476923076923077
Control.ERR205724;66;59;0.545454545454545;30;36;0.0454545454545454;0.454545454545455
Control.ERR205724;52;59;0.423076923076923;30;22;0.0769230769230769;0.423076923076923
Control.ERR205724;62;59;0.580645161290323;26;36;0.0806451612903226;0.419354838709677
Control.ERR205724;60;59;0.45;33;27;0.05;0.45
Control.ERR205724;64;59;0.46875;34;30;0.03125;0.46875
Control.ERR205724;66;59;0.560606060606061;29;37;0.0606060606060606;0.439393939393939
Control.ERR205724;53;59;0.358490566037736;34;19;0.141509433962264;0.358490566037736
Control.ERR205724;67;59;0.626865671641791;25;42;0.126865671641791;0.373134328358209
Control.ERR205724;61;59;0.409836065573771;36;25;0.0901639344262295;0.409836065573771
Control.ERR205724;59;59;0.508474576271186;29;30;0.00847457627118642;0.491525423728814
Control.ERR205724;58;59;0.327586206896552;39;19;0.172413793103448;0.327586206896552
Control.ERR205724;58;59;0.517241379310345;28;30;0.0172413793103449;0.482758620689655
Control.ERR205724;60;59;0.55;27;33;0.05;0.45
Control.ERR205724;52;59;0.461538461538462;28;24;0.0384615384615384;0.461538461538462
Control.ERR205724;66;59;0.515151515151515;32;34;0.0151515151515151;0.484848484848485
Control.ERR205724;59;59;0.508474576271186;29;30;0.00847457627118642;0.491525423728814
Control.ERR205724;57;59;0.56140350877193;25;32;0.0614035087719298;0.43859649122807
Control.ERR205724;64;59;0.4375;36;28;0.0625;0.4375
Control.ERR205724;60;59;0.483333333333333;31;29;0.0166666666666667;0.483333333333333
Control.ERR205724;54;59;0.574074074074074;23;31;0.0740740740740741;0.425925925925926
Control.ERR205724;53;59;0.377358490566038;33;20;0.122641509433962;0.377358490566038
Control.ERR205724;56;59;0.571428571428571;24;32;0.0714285714285714;0.428571428571429
Control.ERR205724;65;59;0.584615384615385;27;38;0.0846153846153846;0.415384615384615
Control.ERR205724;53;59;0.566037735849057;23;30;0.0660377358490566;0.433962264150943
Control.ERR205724;61;59;0.573770491803279;26;35;0.0737704918032787;0.426229508196721
Control.ERR205724;61;59;0.524590163934426;29;32;0.0245901639344263;0.475409836065574
Control.ERR205724;51;59;0.568627450980392;22;29;0.0686274509803921;0.431372549019608
Control.ERR205724;55;59;0.654545454545455;19;36;0.154545454545455;0.345454545454545
Control.ERR205724;58;59;0.482758620689655;30;28;0.0172413793103448;0.482758620689655
Control.ERR205724;62;59;0.516129032258065;30;32;0.0161290322580645;0.483870967741935
Control.ERR205724;59;59;0.322033898305085;40;19;0.177966101694915;0.322033898305085
Control.ERR205724;54;59;0.481481481481481;28;26;0.0185185185185185;0.481481481481481
Control.ERR205724;56;59;0.553571428571429;25;31;0.0535714285714286;0.446428571428571
Control.ERR205724;53;59;0.622641509433962;20;33;0.122641509433962;0.377358490566038
Control.ERR205724;62;59;0.580645161290323;26;36;0.0806451612903226;0.419354838709677
Control.ERR205724;59;59;0.508474576271186;29;30;0.00847457627118642;0.491525423728814
Control.ERR205724;56;59;0.5;28;28;0;0.5
Control.ERR205724;52;59;0.384615384615385;32;20;0.115384615384615;0.384615384615385
Control.ERR205724;51;59;0.549019607843137;23;28;0.0490196078431373;0.450980392156863
Control.ERR205724;61;59;0.442622950819672;34;27;0.0573770491803279;0.442622950819672
Control.ERR205724;55;59;0.563636363636364;24;31;0.0636363636363636;0.436363636363636
Control.ERR205724;67;59;0.417910447761194;39;28;0.082089552238806;0.417910447761194
Control.ERR205724;64;59;0.640625;23;41;0.140625;0.359375
Control.ERR205724;60;59;0.5;30;30;0;0.5
Control.ERR205724;63;59;0.444444444444444;35;28;0.0555555555555556;0.444444444444444
Control.ERR205724;64;59;0.421875;37;27;0.078125;0.421875
Control.ERR205724;59;59;0.423728813559322;34;25;0.076271186440678;0.423728813559322
Control.ERR205724;62;59;0.467741935483871;33;29;0.0322580645161291;0.467741935483871
Control.ERR205724;67;59;0.522388059701492;32;35;0.0223880597014925;0.477611940298507
Control.ERR205724;60;59;0.55;27;33;0.05;0.45
Control.ERR205724;53;59;0.60377358490566;21;32;0.10377358490566;0.39622641509434
Control.ERR205724;60;59;0.533333333333333;28;32;0.0333333333333333;0.466666666666667
Control.ERR205724;59;59;0.525423728813559;28;31;0.0254237288135594;0.474576271186441
Control.ERR205724;55;59;0.472727272727273;29;26;0.0272727272727273;0.472727272727273
Control.ERR205724;57;59;0.596491228070175;23;34;0.0964912280701754;0.403508771929825
Control.ERR205724;62;59;0.5;31;31;0;0.5
Control.ERR205724;58;59;0.5;29;29;0;0.5
Control.ERR205724;61;59;0.491803278688525;31;30;0.00819672131147542;0.491803278688525
Control.ERR205724;56;59;0.446428571428571;31;25;0.0535714285714285;0.446428571428571
Control.ERR205724;60;59;0.533333333333333;28;32;0.0333333333333333;0.466666666666667
Control.ERR205724;53;59;0.415094339622642;31;22;0.0849056603773585;0.415094339622642
Control.ERR205724;54;59;0.444444444444444;30;24;0.0555555555555556;0.444444444444444
Control.ERR205724;61;59;0.442622950819672;34;27;0.0573770491803279;0.442622950819672
Control.ERR205724;58;59;0.53448275862069;27;31;0.0344827586206896;0.46551724137931
Control.ERR205724;59;59;0.491525423728814;30;29;0.00847457627118642;0.491525423728814
Control.ERR205724;62;59;0.403225806451613;37;25;0.0967741935483871;0.403225806451613
Control.ERR205724;57;59;0.491228070175439;29;28;0.00877192982456143;0.491228070175439
Control.ERR205724;64;59;0.5625;28;36;0.0625;0.4375
Control.ERR205724;51;59;0.490196078431373;26;25;0.00980392156862747;0.490196078431373
Control.ERR205724;61;59;0.475409836065574;32;29;0.0245901639344263;0.475409836065574
Control.ERR205724;67;59;0.552238805970149;30;37;0.0522388059701493;0.447761194029851
Control.ERR205724;53;59;0.490566037735849;27;26;0.00943396226415094;0.490566037735849
Control.ERR205724;57;59;0.43859649122807;32;25;0.0614035087719298;0.43859649122807
Control.ERR205724;55;59;0.490909090909091;28;27;0.00909090909090909;0.490909090909091
Control.ERR205724;54;59;0.481481481481481;28;26;0.0185185185185185;0.481481481481481
Control.ERR205724;55;59;0.436363636363636;31;24;0.0636363636363637;0.436363636363636
Control.ERR205724;60;59;0.5;30;30;0;0.5
Control.ERR205724;60;59;0.616666666666667;23;37;0.116666666666667;0.383333333333333
Control.ERR205724;65;59;0.476923076923077;34;31;0.0230769230769231;0.476923076923077
Control.ERR205724;57;59;0.596491228070175;23;34;0.0964912280701754;0.403508771929825
Control.ERR205724;57;59;0.56140350877193;25;32;0.0614035087719298;0.43859649122807
Control.ERR205724;58;59;0.46551724137931;31;27;0.0344827586206897;0.46551724137931
Control.ERR205724;54;59;0.518518518518518;26;28;0.0185185185185185;0.481481481481481
Control.ERR205724;62;59;0.435483870967742;35;27;0.0645161290322581;0.435483870967742
Control.ERR205724;63;59;0.523809523809524;30;33;0.0238095238095238;0.476190476190476
Control.ERR205724;52;59;0.480769230769231;27;25;0.0192307692307692;0.480769230769231
Control.ERR205724;53;59;0.433962264150943;30;23;0.0660377358490566;0.433962264150943
Control.ERR205724;62;59;0.403225806451613;37;25;0.0967741935483871;0.403225806451613
Control.ERR205724;57;59;0.543859649122807;26;31;0.043859649122807;0.456140350877193
Control.ERR205724;52;59;0.384615384615385;32;20;0.115384615384615;0.384615384615385
Control.ERR205724;54;59;0.444444444444444;30;24;0.0555555555555556;0.444444444444444
Control.ERR205724;60;59;0.516666666666667;29;31;0.0166666666666667;0.483333333333333
Control.ERR205724;62;59;0.548387096774194;28;34;0.0483870967741935;0.451612903225806
Control.ERR205724;66;59;0.515151515151515;32;34;0.0151515151515151;0.484848484848485
Control.ERR205724;55;59;0.4;33;22;0.1;0.4
Control.ERR205724;55;59;0.545454545454545;25;30;0.0454545454545454;0.454545454545455
Control.ERR205724;65;59;0.507692307692308;32;33;0.00769230769230766;0.492307692307692
Control.ERR205724;58;59;0.413793103448276;34;24;0.0862068965517241;0.413793103448276
Control.ERR205724;62;59;0.5;31;31;0;0.5
Control.ERR205724;51;59;0.568627450980392;22;29;0.0686274509803921;0.431372549019608
Control.ERR205724;55;59;0.418181818181818;32;23;0.0818181818181818;0.418181818181818
Control.ERR205724;57;59;0.596491228070175;23;34;0.0964912280701754;0.403508771929825
Control.ERR205724;58;59;0.448275862068966;32;26;0.0517241379310345;0.448275862068966
Control.ERR205724;53;59;0.509433962264151;26;27;0.00943396226415094;0.490566037735849
Control.ERR205724;57;59;0.473684210526316;30;27;0.0263157894736842;0.473684210526316
Control.ERR205724;54;59;0.5;27;27;0;0.5
Control.ERR205724;56;59;0.446428571428571;31;25;0.0535714285714285;0.446428571428571
Control.ERR205724;55;59;0.6;22;33;0.1;0.4
Control.ERR205724;59;59;0.525423728813559;28;31;0.0254237288135594;0.474576271186441
Control.ERR205724;63;59;0.492063492063492;32;31;0.00793650793650796;0.492063492063492
Control.ERR205724;53;59;0.528301886792453;25;28;0.0283018867924528;0.471698113207547
Control.ERR205724;63;59;0.507936507936508;31;32;0.00793650793650791;0.492063492063492
Control.ERR205724;62;59;0.483870967741935;32;30;0.0161290322580645;0.483870967741935
Control.ERR205724;56;59;0.535714285714286;26;30;0.0357142857142857;0.464285714285714
Control.ERR205724;55;59;0.563636363636364;24;31;0.0636363636363636;0.436363636363636
Control.ERR205724;58;59;0.655172413793103;20;38;0.155172413793103;0.344827586206897
Control.ERR205724;57;59;0.456140350877193;31;26;0.043859649122807;0.456140350877193
Control.ERR205724;53;59;0.39622641509434;32;21;0.10377358490566;0.39622641509434
Control.ERR205724;62;59;0.419354838709677;36;26;0.0806451612903226;0.419354838709677
Control.ERR205724;56;59;0.517857142857143;27;29;0.0178571428571429;0.482142857142857
Control.ERR205724;58;59;0.586206896551724;24;34;0.0862068965517241;0.413793103448276
Control.ERR205724;58;59;0.482758620689655;30;28;0.0172413793103448;0.482758620689655
Control.ERR205724;57;59;0.526315789473684;27;30;0.0263157894736842;0.473684210526316
Control.ERR205724;50;59;0.54;23;27;0.04;0.46
Control.ERR205724;62;59;0.435483870967742;35;27;0.0645161290322581;0.435483870967742
Control.ERR205724;64;59;0.5625;28;36;0.0625;0.4375
Control.ERR205724;57;59;0.456140350877193;31;26;0.043859649122807;0.456140350877193
Control.ERR205724;49;59;0.530612244897959;23;26;0.0306122448979592;0.469387755102041
Control.ERR205724;53;59;0.471698113207547;28;25;0.0283018867924528;0.471698113207547
Control.ERR205724;54;59;0.518518518518518;26;28;0.0185185185185185;0.481481481481481
Control.ERR205724;64;59;0.46875;34;30;0.03125;0.46875
Control.ERR205724;53;59;0.622641509433962;20;33;0.122641509433962;0.377358490566038
Control.ERR205724;54;59;0.481481481481481;28;26;0.0185185185185185;0.481481481481481
Control.ERR205724;58;59;0.586206896551724;24;34;0.0862068965517241;0.413793103448276
Control.ERR205724;64;59;0.5;32;32;0;0.5
Control.ERR205724;54;59;0.592592592592593;22;32;0.0925925925925926;0.407407407407407
Control.ERR205724;64;59;0.515625;31;33;0.015625;0.484375
Control.ERR205724;54;59;0.611111111111111;21;33;0.111111111111111;0.388888888888889
Control.ERR205724;60;59;0.55;27;33;0.05;0.45
Control.ERR205724;63;59;0.46031746031746;34;29;0.0396825396825397;0.46031746031746
Control.ERR205724;54;59;0.462962962962963;29;25;0.037037037037037;0.462962962962963
Control.ERR205724;59;59;0.406779661016949;35;24;0.0932203389830508;0.406779661016949
Control.ERR205724;57;59;0.456140350877193;31;26;0.043859649122807;0.456140350877193
Control.ERR205724;58;59;0.46551724137931;31;27;0.0344827586206897;0.46551724137931
Control.ERR205724;57;59;0.508771929824561;28;29;0.00877192982456143;0.491228070175439
Control.ERR205724;64;59;0.5;32;32;0;0.5
Control.ERR205724;51;59;0.490196078431373;26;25;0.00980392156862747;0.490196078431373
Control.ERR205724;51;59;0.509803921568627;25;26;0.00980392156862742;0.490196078431373
Control.ERR205724;51;59;0.490196078431373;26;25;0.00980392156862747;0.490196078431373
Control.ERR205724;56;59;0.482142857142857;29;27;0.0178571428571428;0.482142857142857
Control.ERR205724;52;59;0.403846153846154;31;21;0.0961538461538461;0.403846153846154
Control.ERR205724;50;59;0.44;28;22;0.06;0.44
Control.ERR205724;56;59;0.464285714285714;30;26;0.0357142857142857;0.464285714285714
Control.ERR205724;59;59;0.474576271186441;31;28;0.0254237288135593;0.474576271186441
Control.ERR205724;58;59;0.551724137931034;26;32;0.0517241379310345;0.448275862068966
Control.ERR205724;64;59;0.5;32;32;0;0.5
Control.ERR205724;53;59;0.490566037735849;27;26;0.00943396226415094;0.490566037735849
Control.ERR205724;62;59;0.532258064516129;29;33;0.032258064516129;0.467741935483871
Control.ERR205724;65;59;0.553846153846154;29;36;0.0538461538461539;0.446153846153846
Control.ERR205724;55;59;0.509090909090909;27;28;0.00909090909090904;0.490909090909091
Control.ERR205724;60;59;0.516666666666667;29;31;0.0166666666666667;0.483333333333333
Control.ERR205724;61;59;0.524590163934426;29;32;0.0245901639344263;0.475409836065574
Control.ERR205724;57;59;0.578947368421053;24;33;0.0789473684210527;0.421052631578947
Control.ERR205724;52;59;0.442307692307692;29;23;0.0576923076923077;0.442307692307692
Control.ERR205724;49;59;0.489795918367347;25;24;0.0102040816326531;0.489795918367347
Control.ERR205724;51;59;0.411764705882353;30;21;0.0882352941176471;0.411764705882353
Control.ERR205724;54;59;0.555555555555556;24;30;0.0555555555555556;0.444444444444444
Control.ERR205724;53;59;0.528301886792453;25;28;0.0283018867924528;0.471698113207547
Control.ERR205724;55;59;0.4;33;22;0.1;0.4
Control.ERR205724;62;59;0.483870967741935;32;30;0.0161290322580645;0.483870967741935
Control.ERR205724;53;59;0.471698113207547;28;25;0.0283018867924528;0.471698113207547
Control.ERR205724;65;59;0.553846153846154;29;36;0.0538461538461539;0.446153846153846
Control.ERR205724;53;59;0.471698113207547;28;25;0.0283018867924528;0.471698113207547
Control.ERR205724;60;59;0.516666666666667;29;31;0.0166666666666667;0.483333333333333
Control.ERR205724;54;59;0.5;27;27;0;0.5
Control.ERR205724;52;59;0.519230769230769;25;27;0.0192307692307693;0.480769230769231
Control.ERR205724;58;59;0.551724137931034;26;32;0.0517241379310345;0.448275862068966
Control.ERR205724;50;59;0.42;29;21;0.08;0.42
Control.ERR205724;54;59;0.648148148148148;19;35;0.148148148148148;0.351851851851852
Control.ERR205724;54;59;0.518518518518518;26;28;0.0185185185185185;0.481481481481481
Control.ERR205724;50;59;0.5;25;25;0;0.5
Control.ERR205724;56;59;0.446428571428571;31;25;0.0535714285714285;0.446428571428571
Control.ERR205724;65;59;0.6;26;39;0.1;0.4
Control.ERR205724;51;59;0.627450980392157;19;32;0.127450980392157;0.372549019607843
Control.ERR205724;61;59;0.459016393442623;33;28;0.040983606557377;0.459016393442623
Control.ERR205724;63;59;0.507936507936508;31;32;0.00793650793650791;0.492063492063492
Control.ERR205724;52;59;0.461538461538462;28;24;0.0384615384615384;0.461538461538462
Control.ERR205724;56;59;0.446428571428571;31;25;0.0535714285714285;0.446428571428571
Control.ERR205724;59;59;0.627118644067797;22;37;0.127118644067797;0.372881355932203
Control.ERR205724;55;59;0.418181818181818;32;23;0.0818181818181818;0.418181818181818
Control.ERR205724;65;59;0.430769230769231;37;28;0.0692307692307692;0.430769230769231
Control.ERR205724;51;59;0.490196078431373;26;25;0.00980392156862747;0.490196078431373
Control.ERR205724;58;59;0.53448275862069;27;31;0.0344827586206896;0.46551724137931
Control.ERR205724;53;59;0.433962264150943;30;23;0.0660377358490566;0.433962264150943
Control.ERR205724;59;59;0.559322033898305;26;33;0.059322033898305;0.440677966101695
Control.ERR205724;63;59;0.53968253968254;29;34;0.0396825396825397;0.46031746031746
Control.ERR205724;53;59;0.452830188679245;29;24;0.0471698113207547;0.452830188679245
Control.ERR205724;54;59;0.5;27;27;0;0.5
Control.ERR205724;56;59;0.607142857142857;22;34;0.107142857142857;0.392857142857143
Control.ERR205724;51;59;0.627450980392157;19;32;0.127450980392157;0.372549019607843
Control.ERR205724;55;59;0.454545454545455;30;25;0.0454545454545455;0.454545454545455
Control.ERR205724;61;59;0.540983606557377;28;33;0.0409836065573771;0.459016393442623
Control.ERR205724;62;59;0.516129032258065;30;32;0.0161290322580645;0.483870967741935
Control.ERR205724;56;59;0.5;28;28;0;0.5
Control.ERR205724;52;59;0.596153846153846;21;31;0.0961538461538461;0.403846153846154
Control.ERR205724;49;59;0.551020408163265;22;27;0.0510204081632653;0.448979591836735
Control.ERR205724;50;59;0.42;29;21;0.08;0.42
Control.ERR205724;50;59;0.44;28;22;0.06;0.44
Control.ERR205724;59;59;0.474576271186441;31;28;0.0254237288135593;0.474576271186441
Control.ERR205724;62;59;0.516129032258065;30;32;0.0161290322580645;0.483870967741935
Control.ERR205724;62;59;0.532258064516129;29;33;0.032258064516129;0.467741935483871
Control.ERR205724;54;59;0.537037037037037;25;29;0.0370370370370371;0.462962962962963
Control.ERR205724;54;59;0.481481481481481;28;26;0.0185185185185185;0.481481481481481
Control.ERR205724;51;59;0.470588235294118;27;24;0.0294117647058824;0.470588235294118
Control.ERR205724;56;59;0.5;28;28;0;0.5
Control.ERR205724;51;59;0.431372549019608;29;22;0.0686274509803921;0.431372549019608
Control.ERR205724;60;59;0.533333333333333;28;32;0.0333333333333333;0.466666666666667
Control.ERR205724;58;59;0.603448275862069;23;35;0.103448275862069;0.396551724137931
Control.ERR205724;58;59;0.551724137931034;26;32;0.0517241379310345;0.448275862068966
Control.ERR205724;65;59;0.446153846153846;36;29;0.0538461538461538;0.446153846153846
Control.ERR205724;60;59;0.5;30;30;0;0.5
Control.ERR205724;50;59;0.64;18;32;0.14;0.36
Control.ERR205724;52;59;0.557692307692308;23;29;0.0576923076923077;0.442307692307692
Control.ERR205724;63;59;0.571428571428571;27;36;0.0714285714285714;0.428571428571429
Control.ERR205724;60;59;0.466666666666667;32;28;0.0333333333333333;0.466666666666667
Control.ERR205724;64;59;0.421875;37;27;0.078125;0.421875
Control.ERR205724;64;59;0.40625;38;26;0.09375;0.40625
Control.ERR205724;64;59;0.578125;27;37;0.078125;0.421875
Control.ERR205724;64;59;0.390625;39;25;0.109375;0.390625
Control.ERR205724;64;59;0.46875;34;30;0.03125;0.46875
Control.ERR205724;58;59;0.53448275862069;27;31;0.0344827586206896;0.46551724137931
Control.ERR205724;54;59;0.481481481481481;28;26;0.0185185185185185;0.481481481481481
Control.ERR205724;53;59;0.452830188679245;29;24;0.0471698113207547;0.452830188679245
Control.ERR205724;49;59;0.510204081632653;24;25;0.0102040816326531;0.489795918367347
Control.ERR205724;63;59;0.507936507936508;31;32;0.00793650793650791;0.492063492063492
Control.ERR205724;58;59;0.53448275862069;27;31;0.0344827586206896;0.46551724137931
Control.ERR205724;59;59;0.491525423728814;30;29;0.00847457627118642;0.491525423728814
Control.ERR205724;56;59;0.428571428571429;32;24;0.0714285714285715;0.428571428571429
Control.ERR205724;52;59;0.480769230769231;27;25;0.0192307692307692;0.480769230769231
Control.ERR205724;52;59;0.538461538461538;24;28;0.0384615384615384;0.461538461538462
Control.ERR205724;53;59;0.452830188679245;29;24;0.0471698113207547;0.452830188679245
Control.ERR205724;52;59;0.442307692307692;29;23;0.0576923076923077;0.442307692307692
Control.ERR205724;59;59;0.474576271186441;31;28;0.0254237288135593;0.474576271186441
Control.ERR205724;56;59;0.5;28;28;0;0.5
Control.ERR205724;63;59;0.492063492063492;32;31;0.00793650793650796;0.492063492063492
Control.ERR205724;65;59;0.523076923076923;31;34;0.0230769230769231;0.476923076923077
Control.ERR205724;62;59;0.483870967741935;32;30;0.0161290322580645;0.483870967741935
Control.ERR205724;51;59;0.509803921568627;25;26;0.00980392156862742;0.490196078431373
Control.ERR205724;60;59;0.55;27;33;0.05;0.45
Control.ERR205724;62;59;0.483870967741935;32;30;0.0161290322580645;0.483870967741935
Control.ERR205724;56;59;0.535714285714286;26;30;0.0357142857142857;0.464285714285714
Control.ERR205724;51;59;0.607843137254902;20;31;0.107843137254902;0.392156862745098
Control.ERR205724;60;59;0.4;36;24;0.1;0.4
Control.ERR205724;59;59;0.440677966101695;33;26;0.0593220338983051;0.440677966101695
Control.ERR205724;64;59;0.578125;27;37;0.078125;0.421875
Control.ERR205724;50;59;0.54;23;27;0.04;0.46
Control.ERR205724;54;59;0.537037037037037;25;29;0.0370370370370371;0.462962962962963
Control.ERR205724;52;59;0.461538461538462;28;24;0.0384615384615384;0.461538461538462
Control.ERR205724;60;59;0.483333333333333;31;29;0.0166666666666667;0.483333333333333
Control.ERR205724;64;59;0.421875;37;27;0.078125;0.421875
Control.ERR205724;58;59;0.448275862068966;32;26;0.0517241379310345;0.448275862068966
Control.ERR205724;50;59;0.52;24;26;0.02;0.48
Control.ERR205724;53;59;0.452830188679245;29;24;0.0471698113207547;0.452830188679245
Control.ERR205724;65;59;0.430769230769231;37;28;0.0692307692307692;0.430769230769231
Control.ERR205724;62;59;0.564516129032258;27;35;0.0645161290322581;0.435483870967742
Control.ERR205724;64;59;0.515625;31;33;0.015625;0.484375
Control.ERR205724;58;59;0.517241379310345;28;30;0.0172413793103449;0.482758620689655
Control.ERR205724;57;59;0.508771929824561;28;29;0.00877192982456143;0.491228070175439
Control.ERR205724;60;59;0.466666666666667;32;28;0.0333333333333333;0.466666666666667
Control.ERR205724;58;59;0.379310344827586;36;22;0.120689655172414;0.379310344827586
Control.ERR205724;56;59;0.446428571428571;31;25;0.0535714285714285;0.446428571428571
Control.ERR205724;59;59;0.440677966101695;33;26;0.0593220338983051;0.440677966101695
Control.ERR205724;55;59;0.490909090909091;28;27;0.00909090909090909;0.490909090909091
Control.ERR205724;53;59;0.452830188679245;29;24;0.0471698113207547;0.452830188679245
Control.ERR205724;60;59;0.55;27;33;0.05;0.45
Control.ERR205724;51;59;0.549019607843137;23;28;0.0490196078431373;0.450980392156863
Control.ERR205724;60;59;0.45;33;27;0.05;0.45
Control.ERR205724;65;59;0.492307692307692;33;32;0.00769230769230766;0.492307692307692
Control.ERR205724;56;59;0.5;28;28;0;0.5
Control.ERR205724;58;59;0.482758620689655;30;28;0.0172413793103448;0.482758620689655
Control.ERR205724;54;59;0.518518518518518;26;28;0.0185185185185185;0.481481481481481
Control.ERR205724;61;59;0.540983606557377;28;33;0.0409836065573771;0.459016393442623
Control.ERR205724;64;59;0.546875;29;35;0.046875;0.453125
Control.ERR205724;59;59;0.525423728813559;28;31;0.0254237288135594;0.474576271186441
Control.ERR205724;58;59;0.396551724137931;35;23;0.103448275862069;0.396551724137931
Control.ERR205724;60;59;0.383333333333333;37;23;0.116666666666667;0.383333333333333
Control.ERR205724;56;59;0.535714285714286;26;30;0.0357142857142857;0.464285714285714
Control.ERR205724;55;59;0.454545454545455;30;25;0.0454545454545455;0.454545454545455
Control.ERR205724;53;59;0.490566037735849;27;26;0.00943396226415094;0.490566037735849
Control.ERR205724;55;59;0.472727272727273;29;26;0.0272727272727273;0.472727272727273
Control.ERR205724;57;59;0.43859649122807;32;25;0.0614035087719298;0.43859649122807
Control.ERR205724;59;59;0.576271186440678;25;34;0.076271186440678;0.423728813559322
Control.ERR205724;57;59;0.56140350877193;25;32;0.0614035087719298;0.43859649122807
Control.ERR205724;50;59;0.48;26;24;0.02;0.48
Control.ERR205724;51;59;0.490196078431373;26;25;0.00980392156862747;0.490196078431373
Control.ERR205724;52;59;0.576923076923077;22;30;0.0769230769230769;0.423076923076923
Control.ERR205724;56;59;0.375;35;21;0.125;0.375
Control.ERR205724;61;59;0.459016393442623;33;28;0.040983606557377;0.459016393442623
Control.ERR205724;51;59;0.470588235294118;27;24;0.0294117647058824;0.470588235294118
Control.ERR205724;49;59;0.551020408163265;22;27;0.0510204081632653;0.448979591836735
Control.ERR205724;61;59;0.557377049180328;27;34;0.0573770491803278;0.442622950819672
Control.ERR205724;52;59;0.480769230769231;27;25;0.0192307692307692;0.480769230769231
Control.ERR205724;58;59;0.431034482758621;33;25;0.0689655172413793;0.431034482758621
Control.ERR205724;57;59;0.491228070175439;29;28;0.00877192982456143;0.491228070175439
Control.ERR205724;64;59;0.59375;26;38;0.09375;0.40625
Control.ERR205724;53;59;0.547169811320755;24;29;0.0471698113207547;0.452830188679245
Control.ERR205724;62;59;0.5;31;31;0;0.5
Control.ERR205724;59;59;0.559322033898305;26;33;0.059322033898305;0.440677966101695
Control.ERR205724;60;59;0.416666666666667;35;25;0.0833333333333333;0.416666666666667
Control.ERR205724;61;59;0.524590163934426;29;32;0.0245901639344263;0.475409836065574
Control.ERR205724;61;59;0.508196721311475;30;31;0.00819672131147542;0.491803278688525
Control.ERR205724;60;59;0.483333333333333;31;29;0.0166666666666667;0.483333333333333
Control.ERR205724;60;59;0.433333333333333;34;26;0.0666666666666667;0.433333333333333
Control.ERR205724;62;59;0.483870967741935;32;30;0.0161290322580645;0.483870967741935
Control.ERR205724;54;59;0.62962962962963;20;34;0.12962962962963;0.37037037037037
Control.ERR205724;57;59;0.56140350877193;25;32;0.0614035087719298;0.43859649122807
Control.ERR205724;58;59;0.53448275862069;27;31;0.0344827586206896;0.46551724137931
Control.ERR205724;65;59;0.492307692307692;33;32;0.00769230769230766;0.492307692307692
Control.ERR205724;59;59;0.457627118644068;32;27;0.0423728813559322;0.457627118644068
Control.ERR205724;54;59;0.5;27;27;0;0.5
Control.ERR205724;49;59;0.653061224489796;17;32;0.153061224489796;0.346938775510204
Control.ERR205724;62;59;0.451612903225806;34;28;0.0483870967741936;0.451612903225806
Control.ERR205724;65;59;0.476923076923077;34;31;0.0230769230769231;0.476923076923077
Control.ERR205724;62;59;0.467741935483871;33;29;0.0322580645161291;0.467741935483871
Control.ERR205724;59;59;0.542372881355932;27;32;0.0423728813559322;0.457627118644068
Control.ERR205724;49;59;0.530612244897959;23;26;0.0306122448979592;0.469387755102041
Control.ERR205724;56;59;0.535714285714286;26;30;0.0357142857142857;0.464285714285714
Control.ERR205724;52;59;0.673076923076923;17;35;0.173076923076923;0.326923076923077
Control.ERR205724;57;59;0.614035087719298;22;35;0.114035087719298;0.385964912280702
Control.ERR205724;64;59;0.4375;36;28;0.0625;0.4375
Control.ERR205724;61;59;0.442622950819672;34;27;0.0573770491803279;0.442622950819672
Control.ERR205724;56;59;0.535714285714286;26;30;0.0357142857142857;0.464285714285714
Control.ERR205724;60;59;0.566666666666667;26;34;0.0666666666666667;0.433333333333333
Control.ERR205724;55;59;0.381818181818182;34;21;0.118181818181818;0.381818181818182
Control.ERR205724;51;59;0.588235294117647;21;30;0.0882352941176471;0.411764705882353
Control.ERR205724;60;59;0.533333333333333;28;32;0.0333333333333333;0.466666666666667
Control.ERR205724;57;59;0.508771929824561;28;29;0.00877192982456143;0.491228070175439
Control.ERR205724;62;59;0.451612903225806;34;28;0.0483870967741936;0.451612903225806
Control.ERR205724;56;59;0.5;28;28;0;0.5
Control.ERR205724;53;59;0.547169811320755;24;29;0.0471698113207547;0.452830188679245
Control.ERR205724;53;59;0.452830188679245;29;24;0.0471698113207547;0.452830188679245
Control.ERR205724;56;59;0.553571428571429;25;31;0.0535714285714286;0.446428571428571
Control.ERR205724;59;59;0.610169491525424;23;36;0.110169491525424;0.389830508474576
Control.ERR205724;50;59;0.58;21;29;0.08;0.42
Control.ERR205724;61;59;0.409836065573771;36;25;0.0901639344262295;0.409836065573771
Control.ERR205724;54;59;0.407407407407407;32;22;0.0925925925925926;0.407407407407407
Control.ERR205724;59;59;0.508474576271186;29;30;0.00847457627118642;0.491525423728814
Control.ERR205724;52;59;0.461538461538462;28;24;0.0384615384615384;0.461538461538462
Control.ERR205724;65;59;0.446153846153846;36;29;0.0538461538461538;0.446153846153846
Control.ERR205724;49;59;0.428571428571429;28;21;0.0714285714285715;0.428571428571429
Control.ERR205724;60;59;0.516666666666667;29;31;0.0166666666666667;0.483333333333333
Control.ERR205724;65;59;0.476923076923077;34;31;0.0230769230769231;0.476923076923077
Control.ERR205724;50;59;0.48;26;24;0.02;0.48
Control.ERR205724;55;59;0.454545454545455;30;25;0.0454545454545455;0.454545454545455
Control.ERR205724;53;59;0.547169811320755;24;29;0.0471698113207547;0.452830188679245
Control.ERR205724;55;59;0.490909090909091;28;27;0.00909090909090909;0.490909090909091
Control.ERR205724;55;59;0.654545454545455;19;36;0.154545454545455;0.345454545454545
Control.ERR205724;59;59;0.559322033898305;26;33;0.059322033898305;0.440677966101695
Control.ERR205724;56;59;0.571428571428571;24;32;0.0714285714285714;0.428571428571429
Control.ERR205724;54;59;0.518518518518518;26;28;0.0185185185185185;0.481481481481481
Control.ERR205724;52;59;0.576923076923077;22;30;0.0769230769230769;0.423076923076923
Control.ERR205724;64;59;0.484375;33;31;0.015625;0.484375
Control.ERR205724;55;59;0.454545454545455;30;25;0.0454545454545455;0.454545454545455
Control.ERR205724;62;59;0.5;31;31;0;0.5
Control.ERR205724;58;59;0.551724137931034;26;32;0.0517241379310345;0.448275862068966
Control.ERR205724;53;59;0.320754716981132;36;17;0.179245283018868;0.320754716981132
Control.ERR205724;55;59;0.636363636363636;20;35;0.136363636363636;0.363636363636364
Control.ERR205724;58;59;0.517241379310345;28;30;0.0172413793103449;0.482758620689655
Control.ERR205724;56;59;0.482142857142857;29;27;0.0178571428571428;0.482142857142857
Control.ERR205724;61;59;0.573770491803279;26;35;0.0737704918032787;0.426229508196721
Control.ERR205724;65;59;0.492307692307692;33;32;0.00769230769230766;0.492307692307692
Control.ERR205724;56;59;0.517857142857143;27;29;0.0178571428571429;0.482142857142857
Control.ERR205724;62;59;0.419354838709677;36;26;0.0806451612903226;0.419354838709677
Control.ERR205724;63;59;0.444444444444444;35;28;0.0555555555555556;0.444444444444444
Control.ERR205724;57;59;0.456140350877193;31;26;0.043859649122807;0.456140350877193
Control.ERR205724;60;59;0.533333333333333;28;32;0.0333333333333333;0.466666666666667
Control.ERR205724;64;59;0.53125;30;34;0.03125;0.46875
Control.ERR205724;60;59;0.5;30;30;0;0.5
Control.ERR205724;58;59;0.5;29;29;0;0.5
Control.ERR205724;57;59;0.456140350877193;31;26;0.043859649122807;0.456140350877193
Control.ERR205724;51;59;0.607843137254902;20;31;0.107843137254902;0.392156862745098
Control.ERR205724;64;59;0.5625;28;36;0.0625;0.4375
Control.ERR205724;63;59;0.428571428571429;36;27;0.0714285714285715;0.428571428571429
Control.ERR205724;62;59;0.548387096774194;28;34;0.0483870967741935;0.451612903225806
Control.ERR205724;59;59;0.474576271186441;31;28;0.0254237288135593;0.474576271186441
Control.ERR205724;64;59;0.5;32;32;0;0.5
Control.ERR205724;64;59;0.46875;34;30;0.03125;0.46875
Control.ERR205724;65;59;0.476923076923077;34;31;0.0230769230769231;0.476923076923077
Control.ERR205724;61;59;0.508196721311475;30;31;0.00819672131147542;0.491803278688525
Control.ERR205724;61;59;0.524590163934426;29;32;0.0245901639344263;0.475409836065574
Control.ERR205724;60;59;0.55;27;33;0.05;0.45
Control.ERR205724;56;59;0.375;35;21;0.125;0.375
Control.ERR205724;60;59;0.583333333333333;25;35;0.0833333333333334;0.416666666666667
Control.ERR205724;64;59;0.5;32;32;0;0.5
Control.ERR205724;62;59;0.435483870967742;35;27;0.0645161290322581;0.435483870967742
Control.ERR205724;55;59;0.563636363636364;24;31;0.0636363636363636;0.436363636363636
Control.ERR205724;54;59;0.518518518518518;26;28;0.0185185185185185;0.481481481481481
Control.ERR205724;65;59;0.446153846153846;36;29;0.0538461538461538;0.446153846153846
Control.ERR205724;54;59;0.574074074074074;23;31;0.0740740740740741;0.425925925925926
Control.ERR205724;61;59;0.491803278688525;31;30;0.00819672131147542;0.491803278688525
Control.ERR205724;60;59;0.55;27;33;0.05;0.45
Control.ERR205724;54;59;0.611111111111111;21;33;0.111111111111111;0.388888888888889
Control.ERR205724;58;59;0.431034482758621;33;25;0.0689655172413793;0.431034482758621
Control.ERR205724;49;59;0.489795918367347;25;24;0.0102040816326531;0.489795918367347
Control.ERR205724;56;59;0.535714285714286;26;30;0.0357142857142857;0.464285714285714
Control.ERR205724;57;59;0.56140350877193;25;32;0.0614035087719298;0.43859649122807
Control.ERR205724;56;59;0.517857142857143;27;29;0.0178571428571429;0.482142857142857
Control.ERR205724;57;59;0.491228070175439;29;28;0.00877192982456143;0.491228070175439
Control.ERR205724;58;59;0.551724137931034;26;32;0.0517241379310345;0.448275862068966
Control.ERR205724;57;59;0.578947368421053;24;33;0.0789473684210527;0.421052631578947
Control.ERR205724;58;59;0.517241379310345;28;30;0.0172413793103449;0.482758620689655
Control.ERR205724;61;59;0.491803278688525;31;30;0.00819672131147542;0.491803278688525
Control.ERR205724;61;59;0.475409836065574;32;29;0.0245901639344263;0.475409836065574
Control.ERR205724;61;59;0.540983606557377;28;33;0.0409836065573771;0.459016393442623
Control.ERR205724;57;59;0.526315789473684;27;30;0.0263157894736842;0.473684210526316
Control.ERR205724;56;59;0.482142857142857;29;27;0.0178571428571428;0.482142857142857
Control.ERR205724;61;59;0.540983606557377;28;33;0.0409836065573771;0.459016393442623
Control.ERR205724;58;59;0.586206896551724;24;34;0.0862068965517241;0.413793103448276
Control.ERR205724;62;59;0.451612903225806;34;28;0.0483870967741936;0.451612903225806
Control.ERR205724;59;59;0.474576271186441;31;28;0.0254237288135593;0.474576271186441
Control.ERR205724;64;59;0.4375;36;28;0.0625;0.4375
Control.ERR205724;53;59;0.490566037735849;27;26;0.00943396226415094;0.490566037735849
Control.ERR205724;62;59;0.580645161290323;26;36;0.0806451612903226;0.419354838709677
Control.ERR205724;61;59;0.409836065573771;36;25;0.0901639344262295;0.409836065573771
Control.ERR205724;56;59;0.535714285714286;26;30;0.0357142857142857;0.464285714285714
Control.ERR205724;56;59;0.428571428571429;32;24;0.0714285714285715;0.428571428571429
Control.ERR205724;56;59;0.5;28;28;0;0.5
Control.ERR205724;65;59;0.430769230769231;37;28;0.0692307692307692;0.430769230769231
Control.ERR205724;50;59;0.46;27;23;0.04;0.46
Control.ERR205724;52;59;0.480769230769231;27;25;0.0192307692307692;0.480769230769231
Control.ERR205724;62;59;0.467741935483871;33;29;0.0322580645161291;0.467741935483871
Control.ERR205724;60;59;0.466666666666667;32;28;0.0333333333333333;0.466666666666667
Control.ERR205724;59;59;0.559322033898305;26;33;0.059322033898305;0.440677966101695
Control.ERR205724;59;59;0.491525423728814;30;29;0.00847457627118642;0.491525423728814
Control.ERR205724;57;59;0.385964912280702;35;22;0.114035087719298;0.385964912280702
Control.ERR205724;58;59;0.310344827586207;40;18;0.189655172413793;0.310344827586207
Control.ERR205724;59;59;0.474576271186441;31;28;0.0254237288135593;0.474576271186441
Control.ERR205724;64;59;0.46875;34;30;0.03125;0.46875
Control.ERR205724;62;59;0.580645161290323;26;36;0.0806451612903226;0.419354838709677
Control.ERR205724;58;59;0.431034482758621;33;25;0.0689655172413793;0.431034482758621
Control.ERR205724;54;59;0.351851851851852;35;19;0.148148148148148;0.351851851851852
Control.ERR205724;52;59;0.538461538461538;24;28;0.0384615384615384;0.461538461538462
Control.ERR205724;51;59;0.509803921568627;25;26;0.00980392156862742;0.490196078431373
Control.ERR205724;60;59;0.483333333333333;31;29;0.0166666666666667;0.483333333333333
Control.ERR205724;63;59;0.507936507936508;31;32;0.00793650793650791;0.492063492063492
Control.ERR205724;53;59;0.490566037735849;27;26;0.00943396226415094;0.490566037735849
Control.ERR205724;60;59;0.55;27;33;0.05;0.45
Control.ERR205724;53;59;0.547169811320755;24;29;0.0471698113207547;0.452830188679245
Control.ERR205724;49;59;0.448979591836735;27;22;0.0510204081632653;0.448979591836735
Control.ERR205724;54;59;0.574074074074074;23;31;0.0740740740740741;0.425925925925926
Control.ERR205724;61;59;0.557377049180328;27;34;0.0573770491803278;0.442622950819672
Control.ERR205724;54;59;0.444444444444444;30;24;0.0555555555555556;0.444444444444444
Control.ERR205724;62;59;0.483870967741935;32;30;0.0161290322580645;0.483870967741935
Control.ERR205724;59;59;0.406779661016949;35;24;0.0932203389830508;0.406779661016949
Control.ERR205724;49;59;0.448979591836735;27;22;0.0510204081632653;0.448979591836735
Control.ERR205724;60;59;0.516666666666667;29;31;0.0166666666666667;0.483333333333333
Control.ERR205724;64;59;0.484375;33;31;0.015625;0.484375
Control.ERR205724;49;59;0.469387755102041;26;23;0.0306122448979592;0.469387755102041
Control.ERR205724;59;59;0.576271186440678;25;34;0.076271186440678;0.423728813559322
Control.ERR205724;58;59;0.603448275862069;23;35;0.103448275862069;0.396551724137931
Control.ERR205724;64;59;0.5;32;32;0;0.5
Control.ERR205724;53;59;0.415094339622642;31;22;0.0849056603773585;0.415094339622642
Control.ERR205724;57;59;0.421052631578947;33;24;0.0789473684210527;0.421052631578947
Control.ERR205724;54;59;0.574074074074074;23;31;0.0740740740740741;0.425925925925926
Control.ERR205724;57;59;0.526315789473684;27;30;0.0263157894736842;0.473684210526316
Control.ERR205724;63;59;0.428571428571429;36;27;0.0714285714285715;0.428571428571429
Control.ERR205724;62;59;0.451612903225806;34;28;0.0483870967741936;0.451612903225806
Control.ERR205724;57;59;0.526315789473684;27;30;0.0263157894736842;0.473684210526316
Control.ERR205724;58;59;0.431034482758621;33;25;0.0689655172413793;0.431034482758621
Control.ERR205724;50;59;0.6;20;30;0.1;0.4
Control.ERR205724;59;59;0.457627118644068;32;27;0.0423728813559322;0.457627118644068
Control.ERR205724;58;59;0.551724137931034;26;32;0.0517241379310345;0.448275862068966
Control.ERR205724;55;59;0.545454545454545;25;30;0.0454545454545454;0.454545454545455
Control.ERR205724;55;59;0.490909090909091;28;27;0.00909090909090909;0.490909090909091
Control.ERR205724;59;59;0.525423728813559;28;31;0.0254237288135594;0.474576271186441
Control.ERR205724;61;59;0.442622950819672;34;27;0.0573770491803279;0.442622950819672
Control.ERR205724;57;59;0.508771929824561;28;29;0.00877192982456143;0.491228070175439
Control.ERR205724;52;59;0.442307692307692;29;23;0.0576923076923077;0.442307692307692
Control.ERR205724;60;59;0.633333333333333;22;38;0.133333333333333;0.366666666666667
Control.ERR205724;49;59;0.36734693877551;31;18;0.13265306122449;0.36734693877551
Control.ERR205724;57;59;0.526315789473684;27;30;0.0263157894736842;0.473684210526316
Control.ERR205724;54;59;0.574074074074074;23;31;0.0740740740740741;0.425925925925926
Control.ERR205724;56;59;0.517857142857143;27;29;0.0178571428571429;0.482142857142857
Control.ERR205724;53;59;0.528301886792453;25;28;0.0283018867924528;0.471698113207547
Control.ERR205724;50;59;0.56;22;28;0.0600000000000001;0.44
Control.ERR205724;58;59;0.551724137931034;26;32;0.0517241379310345;0.448275862068966
Control.ERR205724;52;59;0.442307692307692;29;23;0.0576923076923077;0.442307692307692
Control.ERR205724;60;59;0.483333333333333;31;29;0.0166666666666667;0.483333333333333
Control.ERR205724;65;59;0.646153846153846;23;42;0.146153846153846;0.353846153846154
Control.ERR205724;57;59;0.403508771929825;34;23;0.0964912280701755;0.403508771929825
Control.ERR205724;61;59;0.540983606557377;28;33;0.0409836065573771;0.459016393442623
Control.ERR205724;57;59;0.508771929824561;28;29;0.00877192982456143;0.491228070175439
Control.ERR205724;50;59;0.5;25;25;0;0.5
Control.ERR205724;59;59;0.440677966101695;33;26;0.0593220338983051;0.440677966101695
Control.ERR205724;62;59;0.467741935483871;33;29;0.0322580645161291;0.467741935483871
Control.ERR205724;50;59;0.52;24;26;0.02;0.48
Control.ERR205724;57;59;0.526315789473684;27;30;0.0263157894736842;0.473684210526316
Control.ERR205724;59;59;0.440677966101695;33;26;0.0593220338983051;0.440677966101695
Control.ERR205724;57;59;0.491228070175439;29;28;0.00877192982456143;0.491228070175439
Control.ERR205724;65;59;0.523076923076923;31;34;0.0230769230769231;0.476923076923077
Control.ERR205724;59;59;0.542372881355932;27;32;0.0423728813559322;0.457627118644068
Control.ERR205724;58;59;0.379310344827586;36;22;0.120689655172414;0.379310344827586
Control.ERR205724;65;59;0.523076923076923;31;34;0.0230769230769231;0.476923076923077
Control.ERR205724;60;59;0.466666666666667;32;28;0.0333333333333333;0.466666666666667
Control.ERR205724;65;59;0.553846153846154;29;36;0.0538461538461539;0.446153846153846
Control.ERR205724;52;59;0.461538461538462;28;24;0.0384615384615384;0.461538461538462
Control.ERR205724;59;59;0.559322033898305;26;33;0.059322033898305;0.440677966101695
Control.ERR205724;55;59;0.527272727272727;26;29;0.0272727272727272;0.472727272727273
Control.ERR205724;55;59;0.6;22;33;0.1;0.4
Control.ERR205724;57;59;0.649122807017544;20;37;0.149122807017544;0.350877192982456
Control.ERR205724;58;59;0.448275862068966;32;26;0.0517241379310345;0.448275862068966
Control.ERR205724;63;59;0.428571428571429;36;27;0.0714285714285715;0.428571428571429
Control.ERR205724;60;59;0.466666666666667;32;28;0.0333333333333333;0.466666666666667
Control.ERR205724;56;59;0.517857142857143;27;29;0.0178571428571429;0.482142857142857
Control.ERR205724;60;59;0.45;33;27;0.05;0.45
Control.ERR205724;58;59;0.53448275862069;27;31;0.0344827586206896;0.46551724137931
Control.ERR205724;55;59;0.6;22;33;0.1;0.4
Control.ERR205724;59;59;0.457627118644068;32;27;0.0423728813559322;0.457627118644068
Control.ERR205724;63;59;0.492063492063492;32;31;0.00793650793650796;0.492063492063492
Control.ERR205724;53;59;0.490566037735849;27;26;0.00943396226415094;0.490566037735849
Control.ERR205724;65;59;0.523076923076923;31;34;0.0230769230769231;0.476923076923077
Control.ERR205724;59;59;0.457627118644068;32;27;0.0423728813559322;0.457627118644068
Control.ERR205724;55;59;0.636363636363636;20;35;0.136363636363636;0.363636363636364
Control.ERR205724;57;59;0.491228070175439;29;28;0.00877192982456143;0.491228070175439
Control.ERR205724;62;59;0.483870967741935;32;30;0.0161290322580645;0.483870967741935
Control.ERR205724;59;59;0.389830508474576;36;23;0.110169491525424;0.389830508474576
Control.ERR205724;61;59;0.524590163934426;29;32;0.0245901639344263;0.475409836065574
Control.ERR205724;56;59;0.517857142857143;27;29;0.0178571428571429;0.482142857142857
Control.ERR205724;59;59;0.525423728813559;28;31;0.0254237288135594;0.474576271186441
Control.ERR205724;57;59;0.491228070175439;29;28;0.00877192982456143;0.491228070175439
Control.ERR205724;64;59;0.5625;28;36;0.0625;0.4375
Control.ERR205724;58;59;0.5;29;29;0;0.5
Control.ERR205724;61;59;0.524590163934426;29;32;0.0245901639344263;0.475409836065574
Control.ERR205724;59;59;0.440677966101695;33;26;0.0593220338983051;0.440677966101695
Control.ERR205724;58;59;0.379310344827586;36;22;0.120689655172414;0.379310344827586
Control.ERR205724;56;59;0.535714285714286;26;30;0.0357142857142857;0.464285714285714
Control.ERR205724;61;59;0.459016393442623;33;28;0.040983606557377;0.459016393442623
Control.ERR205724;59;59;0.627118644067797;22;37;0.127118644067797;0.372881355932203
Control.ERR205724;61;59;0.557377049180328;27;34;0.0573770491803278;0.442622950819672
Control.ERR205724;56;59;0.5;28;28;0;0.5
Control.ERR205724;56;59;0.428571428571429;32;24;0.0714285714285715;0.428571428571429
Control.ERR205724;63;59;0.507936507936508;31;32;0.00793650793650791;0.492063492063492
Control.ERR205724;61;59;0.508196721311475;30;31;0.00819672131147542;0.491803278688525
Control.ERR205724;55;59;0.527272727272727;26;29;0.0272727272727272;0.472727272727273
Control.ERR205724;58;59;0.551724137931034;26;32;0.0517241379310345;0.448275862068966
Control.ERR205724;53;59;0.60377358490566;21;32;0.10377358490566;0.39622641509434
Control.ERR205724;62;59;0.483870967741935;32;30;0.0161290322580645;0.483870967741935
Control.ERR205724;62;59;0.564516129032258;27;35;0.0645161290322581;0.435483870967742
Control.ERR205724;50;59;0.5;25;25;0;0.5
Control.ERR205724;54;59;0.555555555555556;24;30;0.0555555555555556;0.444444444444444
Control.ERR205724;54;59;0.462962962962963;29;25;0.037037037037037;0.462962962962963
Control.ERR205724;57;59;0.543859649122807;26;31;0.043859649122807;0.456140350877193
Control.ERR205724;65;59;0.553846153846154;29;36;0.0538461538461539;0.446153846153846
Control.ERR205724;56;59;0.535714285714286;26;30;0.0357142857142857;0.464285714285714
Control.ERR205724;64;59;0.625;24;40;0.125;0.375
Control.ERR205724;52;59;0.538461538461538;24;28;0.0384615384615384;0.461538461538462
Control.ERR205724;50;59;0.62;19;31;0.12;0.38
Control.ERR205724;57;59;0.526315789473684;27;30;0.0263157894736842;0.473684210526316
Control.ERR205724;59;59;0.491525423728814;30;29;0.00847457627118642;0.491525423728814
Control.ERR205724;60;59;0.383333333333333;37;23;0.116666666666667;0.383333333333333
Control.ERR205724;53;59;0.39622641509434;32;21;0.10377358490566;0.39622641509434
Control.ERR205724;49;59;0.63265306122449;18;31;0.13265306122449;0.36734693877551
Control.ERR205724;57;59;0.543859649122807;26;31;0.043859649122807;0.456140350877193
Control.ERR205724;60;59;0.533333333333333;28;32;0.0333333333333333;0.466666666666667
Control.ERR205724;64;59;0.578125;27;37;0.078125;0.421875
Control.ERR205724;59;59;0.474576271186441;31;28;0.0254237288135593;0.474576271186441
Control.ERR205724;56;59;0.607142857142857;22;34;0.107142857142857;0.392857142857143
Control.ERR205724;54;59;0.537037037037037;25;29;0.0370370370370371;0.462962962962963
Control.ERR205724;55;59;0.418181818181818;32;23;0.0818181818181818;0.418181818181818
Control.ERR205724;57;59;0.526315789473684;27;30;0.0263157894736842;0.473684210526316
Control.ERR205724;55;59;0.6;22;33;0.1;0.4
Control.ERR205724;51;59;0.529411764705882;24;27;0.0294117647058824;0.470588235294118
Control.ERR205724;56;59;0.482142857142857;29;27;0.0178571428571428;0.482142857142857
Control.ERR205724;65;59;0.584615384615385;27;38;0.0846153846153846;0.415384615384615
Control.ERR205724;60;59;0.45;33;27;0.05;0.45
Control.ERR205724;64;59;0.46875;34;30;0.03125;0.46875
Control.ERR205724;59;59;0.440677966101695;33;26;0.0593220338983051;0.440677966101695
Control.ERR205724;54;59;0.537037037037037;25;29;0.0370370370370371;0.462962962962963
Control.ERR205724;63;59;0.650793650793651;22;41;0.150793650793651;0.349206349206349
Control.ERR205724;55;59;0.418181818181818;32;23;0.0818181818181818;0.418181818181818
Control.ERR205724;49;59;0.612244897959184;19;30;0.112244897959184;0.387755102040816
Control.ERR205724;62;59;0.403225806451613;37;25;0.0967741935483871;0.403225806451613
Control.ERR205724;64;59;0.453125;35;29;0.046875;0.453125
Control.ERR205724;60;59;0.433333333333333;34;26;0.0666666666666667;0.433333333333333
Control.ERR205724;60;59;0.4;36;24;0.1;0.4
Control.ERR205724;51;59;0.470588235294118;27;24;0.0294117647058824;0.470588235294118
Control.ERR205724;56;59;0.482142857142857;29;27;0.0178571428571428;0.482142857142857
Control.ERR205724;55;59;0.654545454545455;19;36;0.154545454545455;0.345454545454545
Control.ERR205724;57;59;0.614035087719298;22;35;0.114035087719298;0.385964912280702
Control.ERR205724;60;59;0.5;30;30;0;0.5
Control.ERR205724;59;59;0.440677966101695;33;26;0.0593220338983051;0.440677966101695
Control.ERR205724;51;59;0.490196078431373;26;25;0.00980392156862747;0.490196078431373
Control.ERR205724;51;59;0.705882352941177;15;36;0.205882352941177;0.294117647058824
Control.ERR205724;56;59;0.464285714285714;30;26;0.0357142857142857;0.464285714285714
Control.ERR205724;51;59;0.431372549019608;29;22;0.0686274509803921;0.431372549019608
Control.ERR205724;59;59;0.474576271186441;31;28;0.0254237288135593;0.474576271186441
Control.ERR205724;50;59;0.5;25;25;0;0.5
Control.ERR205724;53;59;0.509433962264151;26;27;0.00943396226415094;0.490566037735849
Control.ERR205724;53;59;0.377358490566038;33;20;0.122641509433962;0.377358490566038
Control.ERR205724;63;59;0.396825396825397;38;25;0.103174603174603;0.396825396825397
Control.ERR205724;63;59;0.634920634920635;23;40;0.134920634920635;0.365079365079365
Control.ERR205724;60;59;0.5;30;30;0;0.5
Control.ERR205724;64;59;0.4375;36;28;0.0625;0.4375
Control.ERR205724;56;59;0.553571428571429;25;31;0.0535714285714286;0.446428571428571
Control.ERR205724;60;59;0.533333333333333;28;32;0.0333333333333333;0.466666666666667
Control.ERR205724;61;59;0.39344262295082;37;24;0.10655737704918;0.39344262295082
Control.ERR205724;61;59;0.327868852459016;41;20;0.172131147540984;0.327868852459016
Control.ERR205724;57;59;0.473684210526316;30;27;0.0263157894736842;0.473684210526316
Control.ERR205724;63;59;0.46031746031746;34;29;0.0396825396825397;0.46031746031746
Control.ERR205724;54;59;0.574074074074074;23;31;0.0740740740740741;0.425925925925926
Control.ERR205724;56;59;0.482142857142857;29;27;0.0178571428571428;0.482142857142857
Control.ERR205724;63;59;0.476190476190476;33;30;0.0238095238095238;0.476190476190476
Control.ERR205724;49;59;0.653061224489796;17;32;0.153061224489796;0.346938775510204
Control.ERR205724;65;59;0.461538461538462;35;30;0.0384615384615384;0.461538461538462
Control.ERR205724;57;59;0.456140350877193;31;26;0.043859649122807;0.456140350877193
Control.ERR205724;65;59;0.4;39;26;0.1;0.4
Control.ERR205724;61;59;0.639344262295082;22;39;0.139344262295082;0.360655737704918
Control.ERR205724;56;59;0.5;28;28;0;0.5
Control.ERR205724;52;59;0.519230769230769;25;27;0.0192307692307693;0.480769230769231
Control.ERR205724;60;59;0.4;36;24;0.1;0.4
Control.ERR205724;64;59;0.609375;25;39;0.109375;0.390625
Control.ERR205724;62;59;0.5;31;31;0;0.5
Control.ERR205724;56;59;0.410714285714286;33;23;0.0892857142857143;0.410714285714286
Control.ERR205724;64;59;0.4375;36;28;0.0625;0.4375
Control.ERR205724;59;59;0.508474576271186;29;30;0.00847457627118642;0.491525423728814
Control.ERR205724;49;59;0.448979591836735;27;22;0.0510204081632653;0.448979591836735
Control.ERR205724;54;59;0.481481481481481;28;26;0.0185185185185185;0.481481481481481
Control.ERR205724;62;59;0.548387096774194;28;34;0.0483870967741935;0.451612903225806
Control.ERR205724;60;59;0.566666666666667;26;34;0.0666666666666667;0.433333333333333
Control.ERR205724;58;59;0.551724137931034;26;32;0.0517241379310345;0.448275862068966
Control.ERR205724;59;59;0.457627118644068;32;27;0.0423728813559322;0.457627118644068
Control.ERR205724;54;59;0.537037037037037;25;29;0.0370370370370371;0.462962962962963
Control.ERR205724;63;59;0.53968253968254;29;34;0.0396825396825397;0.46031746031746
Control.ERR205724;64;59;0.515625;31;33;0.015625;0.484375
Control.ERR205724;62;59;0.274193548387097;45;17;0.225806451612903;0.274193548387097
Control.ERR205724;59;59;0.508474576271186;29;30;0.00847457627118642;0.491525423728814
Control.ERR205724;62;59;0.451612903225806;34;28;0.0483870967741936;0.451612903225806
Control.ERR205724;54;59;0.37037037037037;34;20;0.12962962962963;0.37037037037037
Control.ERR205724;58;59;0.517241379310345;28;30;0.0172413793103449;0.482758620689655
Control.ERR205724;53;59;0.528301886792453;25;28;0.0283018867924528;0.471698113207547
Control.ERR205724;53;59;0.509433962264151;26;27;0.00943396226415094;0.490566037735849
Control.ERR205724;53;59;0.547169811320755;24;29;0.0471698113207547;0.452830188679245
Control.ERR205724;62;59;0.370967741935484;39;23;0.129032258064516;0.370967741935484
Control.ERR205724;58;59;0.431034482758621;33;25;0.0689655172413793;0.431034482758621
Control.ERR205724;50;59;0.34;33;17;0.16;0.34
Control.ERR205724;56;59;0.482142857142857;29;27;0.0178571428571428;0.482142857142857
Control.ERR205724;63;59;0.476190476190476;33;30;0.0238095238095238;0.476190476190476
Control.ERR205724;58;59;0.517241379310345;28;30;0.0172413793103449;0.482758620689655
Control.ERR205724;52;59;0.423076923076923;30;22;0.0769230769230769;0.423076923076923
Control.ERR205724;55;59;0.509090909090909;27;28;0.00909090909090904;0.490909090909091
Control.ERR205724;55;59;0.454545454545455;30;25;0.0454545454545455;0.454545454545455
Control.ERR205724;54;59;0.481481481481481;28;26;0.0185185185185185;0.481481481481481
Control.ERR205724;57;59;0.578947368421053;24;33;0.0789473684210527;0.421052631578947
Control.ERR205724;54;59;0.611111111111111;21;33;0.111111111111111;0.388888888888889
Control.ERR205724;57;59;0.456140350877193;31;26;0.043859649122807;0.456140350877193
Control.ERR205724;55;59;0.527272727272727;26;29;0.0272727272727272;0.472727272727273
Control.ERR205724;65;59;0.476923076923077;34;31;0.0230769230769231;0.476923076923077
Control.ERR205724;53;59;0.547169811320755;24;29;0.0471698113207547;0.452830188679245
Control.ERR205724;60;59;0.55;27;33;0.05;0.45
Control.ERR205724;62;59;0.548387096774194;28;34;0.0483870967741935;0.451612903225806
Control.ERR205724;57;59;0.508771929824561;28;29;0.00877192982456143;0.491228070175439
Control.ERR205724;58;59;0.5;29;29;0;0.5
Control.ERR205724;61;59;0.475409836065574;32;29;0.0245901639344263;0.475409836065574
Control.ERR205724;49;59;0.693877551020408;15;34;0.193877551020408;0.306122448979592
Control.ERR205724;61;59;0.491803278688525;31;30;0.00819672131147542;0.491803278688525
Control.ERR205724;59;59;0.423728813559322;34;25;0.076271186440678;0.423728813559322
Control.ERR205724;61;59;0.39344262295082;37;24;0.10655737704918;0.39344262295082
Control.ERR205724;65;59;0.523076923076923;31;34;0.0230769230769231;0.476923076923077
Control.ERR205724;59;59;0.440677966101695;33;26;0.0593220338983051;0.440677966101695
Control.ERR205724;65;59;0.446153846153846;36;29;0.0538461538461538;0.446153846153846
Control.ERR205724;61;59;0.459016393442623;33;28;0.040983606557377;0.459016393442623
Control.ERR205724;61;59;0.442622950819672;34;27;0.0573770491803279;0.442622950819672
Control.ERR205724;63;59;0.587301587301587;26;37;0.0873015873015873;0.412698412698413
Control.ERR205724;63;59;0.46031746031746;34;29;0.0396825396825397;0.46031746031746
Control.ERR205724;56;59;0.553571428571429;25;31;0.0535714285714286;0.446428571428571
Control.ERR205724;50;59;0.46;27;23;0.04;0.46
Control.ERR205724;51;59;0.509803921568627;25;26;0.00980392156862742;0.490196078431373
Control.ERR205724;58;59;0.517241379310345;28;30;0.0172413793103449;0.482758620689655
Control.ERR205724;53;59;0.60377358490566;21;32;0.10377358490566;0.39622641509434
Control.ERR205724;65;59;0.461538461538462;35;30;0.0384615384615384;0.461538461538462
Control.ERR205724;60;59;0.416666666666667;35;25;0.0833333333333333;0.416666666666667
Control.ERR205724;66;59;0.560606060606061;29;37;0.0606060606060606;0.439393939393939
Control.ERR205724;60;59;0.45;33;27;0.05;0.45
Control.ERR205724;62;59;0.532258064516129;29;33;0.032258064516129;0.467741935483871
Control.ERR205724;64;59;0.484375;33;31;0.015625;0.484375
Control.ERR205724;62;59;0.483870967741935;32;30;0.0161290322580645;0.483870967741935
Control.ERR205724;57;59;0.578947368421053;24;33;0.0789473684210527;0.421052631578947
Control.ERR205724;59;59;0.508474576271186;29;30;0.00847457627118642;0.491525423728814
Control.ERR205724;54;59;0.574074074074074;23;31;0.0740740740740741;0.425925925925926
Control.ERR205724;57;59;0.526315789473684;27;30;0.0263157894736842;0.473684210526316
Control.ERR205724;52;59;0.461538461538462;28;24;0.0384615384615384;0.461538461538462
Control.ERR205724;51;59;0.529411764705882;24;27;0.0294117647058824;0.470588235294118
Control.ERR205724;55;59;0.563636363636364;24;31;0.0636363636363636;0.436363636363636
Control.ERR205724;57;59;0.543859649122807;26;31;0.043859649122807;0.456140350877193
Control.ERR205724;53;59;0.433962264150943;30;23;0.0660377358490566;0.433962264150943
Control.ERR205724;64;59;0.59375;26;38;0.09375;0.40625
Control.ERR205724;61;59;0.557377049180328;27;34;0.0573770491803278;0.442622950819672
Control.ERR205724;52;59;0.557692307692308;23;29;0.0576923076923077;0.442307692307692
Control.ERR205724;56;59;0.517857142857143;27;29;0.0178571428571429;0.482142857142857
Control.ERR205724;58;59;0.655172413793103;20;38;0.155172413793103;0.344827586206897
Control.ERR205724;62;59;0.467741935483871;33;29;0.0322580645161291;0.467741935483871
Control.ERR205724;62;59;0.435483870967742;35;27;0.0645161290322581;0.435483870967742
Control.ERR205724;55;59;0.527272727272727;26;29;0.0272727272727272;0.472727272727273
Control.ERR205724;63;59;0.555555555555556;28;35;0.0555555555555556;0.444444444444444
Control.ERR205724;62;59;0.370967741935484;39;23;0.129032258064516;0.370967741935484
Control.ERR205724;59;59;0.559322033898305;26;33;0.059322033898305;0.440677966101695
Control.ERR205724;52;59;0.461538461538462;28;24;0.0384615384615384;0.461538461538462
Control.ERR205724;60;59;0.516666666666667;29;31;0.0166666666666667;0.483333333333333
Control.ERR205724;53;59;0.452830188679245;29;24;0.0471698113207547;0.452830188679245
Control.ERR205724;59;59;0.525423728813559;28;31;0.0254237288135594;0.474576271186441
Control.ERR205724;52;59;0.442307692307692;29;23;0.0576923076923077;0.442307692307692
Control.ERR205724;62;59;0.564516129032258;27;35;0.0645161290322581;0.435483870967742
Control.ERR205724;51;59;0.431372549019608;29;22;0.0686274509803921;0.431372549019608
Control.ERR205724;50;59;0.54;23;27;0.04;0.46
Control.ERR205724;53;59;0.641509433962264;19;34;0.141509433962264;0.358490566037736
Control.ERR205724;60;59;0.516666666666667;29;31;0.0166666666666667;0.483333333333333
Control.ERR205724;63;59;0.46031746031746;34;29;0.0396825396825397;0.46031746031746
Control.ERR205724;60;59;0.6;24;36;0.1;0.4
Control.ERR205724;60;59;0.533333333333333;28;32;0.0333333333333333;0.466666666666667
Control.ERR205724;61;59;0.557377049180328;27;34;0.0573770491803278;0.442622950819672
Control.ERR205724;62;59;0.516129032258065;30;32;0.0161290322580645;0.483870967741935
Control.ERR205724;59;59;0.491525423728814;30;29;0.00847457627118642;0.491525423728814
Control.ERR205724;51;59;0.509803921568627;25;26;0.00980392156862742;0.490196078431373
Control.ERR205724;58;59;0.46551724137931;31;27;0.0344827586206897;0.46551724137931
Control.ERR205724;54;59;0.481481481481481;28;26;0.0185185185185185;0.481481481481481
Control.ERR205724;52;59;0.596153846153846;21;31;0.0961538461538461;0.403846153846154
Control.ERR205724;65;59;0.553846153846154;29;36;0.0538461538461539;0.446153846153846
Control.ERR205724;54;59;0.444444444444444;30;24;0.0555555555555556;0.444444444444444
Control.ERR205724;61;59;0.508196721311475;30;31;0.00819672131147542;0.491803278688525
Control.ERR205724;66;59;0.424242424242424;38;28;0.0757575757575757;0.424242424242424
Control.ERR205724;60;59;0.466666666666667;32;28;0.0333333333333333;0.466666666666667
Control.ERR205724;57;59;0.614035087719298;22;35;0.114035087719298;0.385964912280702
Control.ERR205724;57;59;0.578947368421053;24;33;0.0789473684210527;0.421052631578947
Control.ERR205724;58;59;0.46551724137931;31;27;0.0344827586206897;0.46551724137931
Control.ERR205724;65;59;0.523076923076923;31;34;0.0230769230769231;0.476923076923077
Control.ERR205724;56;59;0.428571428571429;32;24;0.0714285714285715;0.428571428571429
Control.ERR205724;62;59;0.483870967741935;32;30;0.0161290322580645;0.483870967741935
Control.ERR205724;61;59;0.459016393442623;33;28;0.040983606557377;0.459016393442623
Control.ERR205724;58;59;0.568965517241379;25;33;0.0689655172413793;0.431034482758621
Control.ERR205724;56;59;0.482142857142857;29;27;0.0178571428571428;0.482142857142857
Control.ERR205724;52;59;0.480769230769231;27;25;0.0192307692307692;0.480769230769231
Control.ERR205724;57;59;0.543859649122807;26;31;0.043859649122807;0.456140350877193
Control.ERR205724;56;59;0.303571428571429;39;17;0.196428571428571;0.303571428571429
Control.ERR205724;57;59;0.526315789473684;27;30;0.0263157894736842;0.473684210526316
Control.ERR205724;54;59;0.5;27;27;0;0.5
Control.ERR205724;58;59;0.5;29;29;0;0.5
Control.ERR205724;54;59;0.555555555555556;24;30;0.0555555555555556;0.444444444444444
Control.ERR205724;55;59;0.363636363636364;35;20;0.136363636363636;0.363636363636364
Control.ERR205724;59;59;0.525423728813559;28;31;0.0254237288135594;0.474576271186441
Control.ERR205724;63;59;0.476190476190476;33;30;0.0238095238095238;0.476190476190476
Control.ERR205724;65;59;0.553846153846154;29;36;0.0538461538461539;0.446153846153846
Control.ERR205724;53;59;0.584905660377358;22;31;0.0849056603773585;0.415094339622642
Control.ERR205724;65;59;0.492307692307692;33;32;0.00769230769230766;0.492307692307692
Control.ERR205724;51;59;0.411764705882353;30;21;0.0882352941176471;0.411764705882353
Control.ERR205724;59;59;0.542372881355932;27;32;0.0423728813559322;0.457627118644068
Control.ERR205724;59;59;0.525423728813559;28;31;0.0254237288135594;0.474576271186441
Control.ERR205724;61;59;0.491803278688525;31;30;0.00819672131147542;0.491803278688525
Control.ERR205724;61;59;0.540983606557377;28;33;0.0409836065573771;0.459016393442623
Control.ERR205724;57;59;0.543859649122807;26;31;0.043859649122807;0.456140350877193
Control.ERR205724;59;59;0.525423728813559;28;31;0.0254237288135594;0.474576271186441
Control.ERR205724;65;59;0.538461538461538;30;35;0.0384615384615384;0.461538461538462
Control.ERR205724;63;59;0.555555555555556;28;35;0.0555555555555556;0.444444444444444
Control.ERR205724;54;59;0.388888888888889;33;21;0.111111111111111;0.388888888888889
Control.ERR205724;57;59;0.473684210526316;30;27;0.0263157894736842;0.473684210526316
Control.ERR205724;61;59;0.508196721311475;30;31;0.00819672131147542;0.491803278688525
Control.ERR205724;65;59;0.492307692307692;33;32;0.00769230769230766;0.492307692307692
Control.ERR205724;64;59;0.53125;30;34;0.03125;0.46875
Control.ERR205724;56;59;0.482142857142857;29;27;0.0178571428571428;0.482142857142857
Control.ERR205724;64;59;0.515625;31;33;0.015625;0.484375
Control.ERR205724;57;59;0.43859649122807;32;25;0.0614035087719298;0.43859649122807
Control.ERR205724;54;59;0.611111111111111;21;33;0.111111111111111;0.388888888888889
Control.ERR205724;56;59;0.482142857142857;29;27;0.0178571428571428;0.482142857142857
Control.ERR205724;64;59;0.46875;34;30;0.03125;0.46875
Control.ERR205724;65;59;0.584615384615385;27;38;0.0846153846153846;0.415384615384615
Control.ERR205724;57;59;0.631578947368421;21;36;0.131578947368421;0.368421052631579
Control.ERR205724;58;59;0.53448275862069;27;31;0.0344827586206896;0.46551724137931
Control.ERR205724;62;59;0.419354838709677;36;26;0.0806451612903226;0.419354838709677
Control.ERR205724;61;59;0.639344262295082;22;39;0.139344262295082;0.360655737704918
Control.ERR205724;63;59;0.412698412698413;37;26;0.0873015873015873;0.412698412698413
Control.ERR205724;55;59;0.527272727272727;26;29;0.0272727272727272;0.472727272727273
Control.ERR205724;63;59;0.555555555555556;28;35;0.0555555555555556;0.444444444444444
Control.ERR205724;64;59;0.4375;36;28;0.0625;0.4375
Control.ERR205724;52;59;0.557692307692308;23;29;0.0576923076923077;0.442307692307692
Control.ERR205724;60;59;0.666666666666667;20;40;0.166666666666667;0.333333333333333
Control.ERR205724;51;59;0.647058823529412;18;33;0.147058823529412;0.352941176470588
Control.ERR205724;58;59;0.603448275862069;23;35;0.103448275862069;0.396551724137931
Control.ERR205724;54;59;0.592592592592593;22;32;0.0925925925925926;0.407407407407407
Control.ERR205724;50;59;0.54;23;27;0.04;0.46
Control.ERR205724;63;59;0.46031746031746;34;29;0.0396825396825397;0.46031746031746
Control.ERR205724;52;59;0.384615384615385;32;20;0.115384615384615;0.384615384615385
Control.ERR205724;54;59;0.425925925925926;31;23;0.0740740740740741;0.425925925925926
Control.ERR205724;54;59;0.481481481481481;28;26;0.0185185185185185;0.481481481481481
Control.ERR205724;62;59;0.403225806451613;37;25;0.0967741935483871;0.403225806451613
Control.ERR205724;63;59;0.365079365079365;40;23;0.134920634920635;0.365079365079365
Control.ERR205724;52;59;0.538461538461538;24;28;0.0384615384615384;0.461538461538462
Control.ERR205724;58;59;0.568965517241379;25;33;0.0689655172413793;0.431034482758621
Control.ERR205724;55;59;0.490909090909091;28;27;0.00909090909090909;0.490909090909091
Control.ERR205724;60;59;0.433333333333333;34;26;0.0666666666666667;0.433333333333333
Control.ERR205724;59;59;0.525423728813559;28;31;0.0254237288135594;0.474576271186441
Control.ERR205724;54;59;0.537037037037037;25;29;0.0370370370370371;0.462962962962963
Control.ERR205724;55;59;0.490909090909091;28;27;0.00909090909090909;0.490909090909091
Control.ERR205724;59;59;0.508474576271186;29;30;0.00847457627118642;0.491525423728814
Control.ERR205724;64;59;0.53125;30;34;0.03125;0.46875
Control.ERR205724;61;59;0.409836065573771;36;25;0.0901639344262295;0.409836065573771
Control.ERR205724;63;59;0.587301587301587;26;37;0.0873015873015873;0.412698412698413
Control.ERR205724;63;59;0.492063492063492;32;31;0.00793650793650796;0.492063492063492
Control.ERR205724;60;59;0.533333333333333;28;32;0.0333333333333333;0.466666666666667
Control.ERR205724;63;59;0.444444444444444;35;28;0.0555555555555556;0.444444444444444
Control.ERR205724;63;59;0.444444444444444;35;28;0.0555555555555556;0.444444444444444
Control.ERR205724;57;59;0.43859649122807;32;25;0.0614035087719298;0.43859649122807
Control.ERR205724;56;59;0.642857142857143;20;36;0.142857142857143;0.357142857142857
Control.ERR205724;65;59;0.476923076923077;34;31;0.0230769230769231;0.476923076923077
Control.ERR205724;52;59;0.5;26;26;0;0.5
Control.ERR205724;62;59;0.467741935483871;33;29;0.0322580645161291;0.467741935483871
Control.ERR205724;62;59;0.612903225806452;24;38;0.112903225806452;0.387096774193548
Control.ERR205724;61;59;0.508196721311475;30;31;0.00819672131147542;0.491803278688525
Control.ERR205724;57;59;0.578947368421053;24;33;0.0789473684210527;0.421052631578947
Control.ERR205724;57;59;0.350877192982456;37;20;0.149122807017544;0.350877192982456
Control.ERR205724;60;59;0.55;27;33;0.05;0.45
Control.ERR205724;57;59;0.526315789473684;27;30;0.0263157894736842;0.473684210526316
Control.ERR205724;53;59;0.584905660377358;22;31;0.0849056603773585;0.415094339622642
Control.ERR205724;50;59;0.42;29;21;0.08;0.42
Control.ERR205724;57;59;0.385964912280702;35;22;0.114035087719298;0.385964912280702
Control.ERR205724;54;59;0.518518518518518;26;28;0.0185185185185185;0.481481481481481
Control.ERR205724;57;59;0.56140350877193;25;32;0.0614035087719298;0.43859649122807
Control.ERR205724;65;59;0.446153846153846;36;29;0.0538461538461538;0.446153846153846
Control.ERR205724;63;59;0.507936507936508;31;32;0.00793650793650791;0.492063492063492
Control.ERR205724;62;59;0.580645161290323;26;36;0.0806451612903226;0.419354838709677
Control.ERR205724;57;59;0.508771929824561;28;29;0.00877192982456143;0.491228070175439
Control.ERR205724;64;59;0.5;32;32;0;0.5
Control.ERR205724;60;59;0.583333333333333;25;35;0.0833333333333334;0.416666666666667
Control.ERR205724;60;59;0.466666666666667;32;28;0.0333333333333333;0.466666666666667
Control.ERR205724;61;59;0.491803278688525;31;30;0.00819672131147542;0.491803278688525
Control.ERR205724;56;59;0.571428571428571;24;32;0.0714285714285714;0.428571428571429
Control.ERR205724;62;59;0.516129032258065;30;32;0.0161290322580645;0.483870967741935
Control.ERR205724;53;59;0.433962264150943;30;23;0.0660377358490566;0.433962264150943
Control.ERR205724;55;59;0.509090909090909;27;28;0.00909090909090904;0.490909090909091
Control.ERR205724;54;59;0.537037037037037;25;29;0.0370370370370371;0.462962962962963
Control.ERR205724;53;59;0.471698113207547;28;25;0.0283018867924528;0.471698113207547
Control.ERR205724;58;59;0.551724137931034;26;32;0.0517241379310345;0.448275862068966
Control.ERR205724;56;59;0.535714285714286;26;30;0.0357142857142857;0.464285714285714
Control.ERR205724;58;59;0.448275862068966;32;26;0.0517241379310345;0.448275862068966
Control.ERR205724;63;59;0.365079365079365;40;23;0.134920634920635;0.365079365079365
Control.ERR205724;63;59;0.444444444444444;35;28;0.0555555555555556;0.444444444444444
Control.ERR205724;69;59;0.536231884057971;32;37;0.0362318840579711;0.463768115942029
Control.ERR205724;60;59;0.5;30;30;0;0.5
Control.ERR205724;64;59;0.546875;29;35;0.046875;0.453125
Control.ERR205724;71;59;0.577464788732394;30;41;0.0774647887323944;0.422535211267606
Control.ERR205724;67;59;0.537313432835821;31;36;0.0373134328358209;0.462686567164179
Control.ERR205724;64;59;0.359375;41;23;0.140625;0.359375
Control.ERR205724;62;59;0.467741935483871;33;29;0.0322580645161291;0.467741935483871
Control.ERR205724;57;59;0.526315789473684;27;30;0.0263157894736842;0.473684210526316
Control.ERR205724;67;59;0.492537313432836;34;33;0.0074626865671642;0.492537313432836
Control.ERR205724;63;59;0.523809523809524;30;33;0.0238095238095238;0.476190476190476
Control.ERR205724;58;59;0.5;29;29;0;0.5
Control.ERR205724;57;59;0.491228070175439;29;28;0.00877192982456143;0.491228070175439
Control.ERR205724;70;59;0.5;35;35;0;0.5
Control.ERR205724;62;59;0.516129032258065;30;32;0.0161290322580645;0.483870967741935
Control.ERR205724;66;59;0.5;33;33;0;0.5
Control.ERR205724;56;59;0.553571428571429;25;31;0.0535714285714286;0.446428571428571
Control.ERR205724;54;59;0.537037037037037;25;29;0.0370370370370371;0.462962962962963
Control.ERR205724;64;59;0.546875;29;35;0.046875;0.453125
Control.ERR205724;68;59;0.455882352941176;37;31;0.0441176470588235;0.455882352941176
Control.ERR205724;57;59;0.456140350877193;31;26;0.043859649122807;0.456140350877193
Control.ERR205724;53;59;0.415094339622642;31;22;0.0849056603773585;0.415094339622642
Control.ERR205724;61;59;0.409836065573771;36;25;0.0901639344262295;0.409836065573771
Control.ERR205724;54;59;0.611111111111111;21;33;0.111111111111111;0.388888888888889
Control.ERR205724;54;59;0.444444444444444;30;24;0.0555555555555556;0.444444444444444
Control.ERR205724;61;59;0.442622950819672;34;27;0.0573770491803279;0.442622950819672
Control.ERR205724;56;59;0.5;28;28;0;0.5
Control.ERR205724;61;59;0.442622950819672;34;27;0.0573770491803279;0.442622950819672
Control.ERR205724;63;59;0.380952380952381;39;24;0.119047619047619;0.380952380952381
Control.ERR205724;64;59;0.53125;30;34;0.03125;0.46875
Control.ERR205724;66;59;0.439393939393939;37;29;0.0606060606060606;0.439393939393939
Control.ERR205724;66;59;0.575757575757576;28;38;0.0757575757575758;0.424242424242424
Control.ERR205724;61;59;0.557377049180328;27;34;0.0573770491803278;0.442622950819672
Control.ERR205724;67;59;0.567164179104478;29;38;0.0671641791044776;0.432835820895522
Control.ERR205724;61;59;0.524590163934426;29;32;0.0245901639344263;0.475409836065574
Control.ERR205724;57;59;0.473684210526316;30;27;0.0263157894736842;0.473684210526316
Control.ERR205724;55;59;0.454545454545455;30;25;0.0454545454545455;0.454545454545455
Control.ERR205724;62;59;0.467741935483871;33;29;0.0322580645161291;0.467741935483871
Control.ERR205724;60;59;0.55;27;33;0.05;0.45
Control.ERR205724;64;59;0.359375;41;23;0.140625;0.359375
Control.ERR205724;62;59;0.467741935483871;33;29;0.0322580645161291;0.467741935483871
Control.ERR205724;61;59;0.540983606557377;28;33;0.0409836065573771;0.459016393442623
Control.ERR205724;61;59;0.508196721311475;30;31;0.00819672131147542;0.491803278688525
Control.ERR205724;71;59;0.507042253521127;35;36;0.00704225352112675;0.492957746478873
Control.ERR205724;56;59;0.535714285714286;26;30;0.0357142857142857;0.464285714285714
Control.ERR205724;58;59;0.517241379310345;28;30;0.0172413793103449;0.482758620689655
Control.ERR205724;71;59;0.422535211267606;41;30;0.0774647887323944;0.422535211267606
Control.ERR205724;54;59;0.555555555555556;24;30;0.0555555555555556;0.444444444444444
Control.ERR205724;56;59;0.5;28;28;0;0.5
Control.ERR205724;64;59;0.53125;30;34;0.03125;0.46875
Control.ERR205724;56;59;0.428571428571429;32;24;0.0714285714285715;0.428571428571429
Control.ERR205724;54;59;0.518518518518518;26;28;0.0185185185185185;0.481481481481481
Control.ERR205724;53;59;0.547169811320755;24;29;0.0471698113207547;0.452830188679245
Control.ERR205724;66;59;0.636363636363636;24;42;0.136363636363636;0.363636363636364
Control.ERR205724;60;59;0.533333333333333;28;32;0.0333333333333333;0.466666666666667
Control.ERR205724;62;59;0.564516129032258;27;35;0.0645161290322581;0.435483870967742
Control.ERR205724;69;59;0.536231884057971;32;37;0.0362318840579711;0.463768115942029
Control.ERR205724;69;59;0.420289855072464;40;29;0.0797101449275363;0.420289855072464
Control.ERR205724;66;59;0.5;33;33;0;0.5
Control.ERR205724;54;59;0.444444444444444;30;24;0.0555555555555556;0.444444444444444
Control.ERR205724;60;59;0.5;30;30;0;0.5
Control.ERR205724;60;59;0.566666666666667;26;34;0.0666666666666667;0.433333333333333
Control.ERR205724;61;59;0.475409836065574;32;29;0.0245901639344263;0.475409836065574
Control.ERR205724;59;59;0.593220338983051;24;35;0.0932203389830508;0.406779661016949
Control.ERR205724;56;59;0.607142857142857;22;34;0.107142857142857;0.392857142857143
Control.ERR205724;67;59;0.402985074626866;40;27;0.0970149253731343;0.402985074626866
Control.ERR205724;58;59;0.568965517241379;25;33;0.0689655172413793;0.431034482758621
Control.ERR205724;64;59;0.515625;31;33;0.015625;0.484375
Control.ERR205724;60;59;0.55;27;33;0.05;0.45
Control.ERR205724;57;59;0.43859649122807;32;25;0.0614035087719298;0.43859649122807
Control.ERR205724;62;59;0.451612903225806;34;28;0.0483870967741936;0.451612903225806
Control.ERR205724;66;59;0.424242424242424;38;28;0.0757575757575757;0.424242424242424
Control.ERR205724;60;59;0.616666666666667;23;37;0.116666666666667;0.383333333333333
Control.ERR205724;55;59;0.6;22;33;0.1;0.4
Control.ERR205724;60;59;0.6;24;36;0.1;0.4
Control.ERR205724;66;59;0.560606060606061;29;37;0.0606060606060606;0.439393939393939
Control.ERR205724;66;59;0.484848484848485;34;32;0.0151515151515151;0.484848484848485
Control.ERR205724;62;59;0.451612903225806;34;28;0.0483870967741936;0.451612903225806
Control.ERR205724;61;59;0.508196721311475;30;31;0.00819672131147542;0.491803278688525
Control.ERR205724;63;59;0.571428571428571;27;36;0.0714285714285714;0.428571428571429
Control.ERR205724;56;59;0.392857142857143;34;22;0.107142857142857;0.392857142857143
Control.ERR205724;55;59;0.581818181818182;23;32;0.0818181818181818;0.418181818181818
Control.ERR205724;59;59;0.542372881355932;27;32;0.0423728813559322;0.457627118644068
Control.ERR205724;67;59;0.417910447761194;39;28;0.082089552238806;0.417910447761194
Control.ERR205724;64;59;0.546875;29;35;0.046875;0.453125
Control.ERR205724;64;59;0.515625;31;33;0.015625;0.484375
Control.ERR205724;68;59;0.514705882352941;33;35;0.0147058823529411;0.485294117647059
Control.ERR205724;58;59;0.53448275862069;27;31;0.0344827586206896;0.46551724137931
Control.ERR205724;60;59;0.5;30;30;0;0.5
Control.ERR205724;70;59;0.5;35;35;0;0.5
Control.ERR205724;64;59;0.515625;31;33;0.015625;0.484375
Control.ERR205724;66;59;0.439393939393939;37;29;0.0606060606060606;0.439393939393939
Control.ERR205724;66;59;0.53030303030303;31;35;0.0303030303030303;0.46969696969697
Control.ERR205724;55;59;0.527272727272727;26;29;0.0272727272727272;0.472727272727273
Control.ERR205724;64;59;0.46875;34;30;0.03125;0.46875
Control.ERR205724;64;59;0.40625;38;26;0.09375;0.40625
Control.ERR205724;54;59;0.5;27;27;0;0.5
Control.ERR205724;54;59;0.425925925925926;31;23;0.0740740740740741;0.425925925925926
Control.ERR205724;61;59;0.491803278688525;31;30;0.00819672131147542;0.491803278688525
Control.ERR205724;71;59;0.52112676056338;34;37;0.0211267605633803;0.47887323943662
Control.ERR205724;53;59;0.415094339622642;31;22;0.0849056603773585;0.415094339622642
Control.ERR205724;59;59;0.423728813559322;34;25;0.076271186440678;0.423728813559322
Control.ERR205724;61;59;0.491803278688525;31;30;0.00819672131147542;0.491803278688525
Control.ERR205724;63;59;0.666666666666667;21;42;0.166666666666667;0.333333333333333
Control.ERR205724;53;59;0.452830188679245;29;24;0.0471698113207547;0.452830188679245
Control.ERR205724;67;59;0.567164179104478;29;38;0.0671641791044776;0.432835820895522
Control.ERR205724;61;59;0.508196721311475;30;31;0.00819672131147542;0.491803278688525
Control.ERR205724;64;59;0.453125;35;29;0.046875;0.453125
Control.ERR205724;69;59;0.434782608695652;39;30;0.0652173913043478;0.434782608695652
Control.ERR205724;69;59;0.463768115942029;37;32;0.036231884057971;0.463768115942029
Control.ERR205724;56;59;0.5;28;28;0;0.5
Control.ERR205724;57;59;0.385964912280702;35;22;0.114035087719298;0.385964912280702
Control.ERR205724;60;59;0.483333333333333;31;29;0.0166666666666667;0.483333333333333
Control.ERR205724;68;59;0.573529411764706;29;39;0.0735294117647058;0.426470588235294
Control.ERR205724;60;59;0.516666666666667;29;31;0.0166666666666667;0.483333333333333
Control.ERR205724;57;59;0.56140350877193;25;32;0.0614035087719298;0.43859649122807
Control.ERR205724;56;59;0.553571428571429;25;31;0.0535714285714286;0.446428571428571
Control.ERR205724;69;59;0.434782608695652;39;30;0.0652173913043478;0.434782608695652
Control.ERR205724;71;59;0.633802816901408;26;45;0.133802816901408;0.366197183098592
Control.ERR205724;67;59;0.388059701492537;41;26;0.111940298507463;0.388059701492537
Control.ERR205724;64;59;0.515625;31;33;0.015625;0.484375
Control.ERR205724;67;59;0.462686567164179;36;31;0.0373134328358209;0.462686567164179
Control.ERR205724;67;59;0.462686567164179;36;31;0.0373134328358209;0.462686567164179
Control.ERR205724;63;59;0.428571428571429;36;27;0.0714285714285715;0.428571428571429
Control.ERR205724;53;59;0.39622641509434;32;21;0.10377358490566;0.39622641509434
Control.ERR205724;53;59;0.566037735849057;23;30;0.0660377358490566;0.433962264150943
Control.ERR205724;55;59;0.472727272727273;29;26;0.0272727272727273;0.472727272727273
Control.ERR205724;56;59;0.571428571428571;24;32;0.0714285714285714;0.428571428571429
Control.ERR205724;58;59;0.448275862068966;32;26;0.0517241379310345;0.448275862068966
Control.ERR205724;56;59;0.625;21;35;0.125;0.375
Control.ERR205724;62;59;0.483870967741935;32;30;0.0161290322580645;0.483870967741935
Control.ERR205724;60;59;0.483333333333333;31;29;0.0166666666666667;0.483333333333333
Control.ERR205724;64;59;0.40625;38;26;0.09375;0.40625
Control.ERR205724;56;59;0.625;21;35;0.125;0.375
Control.ERR205724;65;59;0.353846153846154;42;23;0.146153846153846;0.353846153846154
Control.ERR205724;60;59;0.55;27;33;0.05;0.45
Control.ERR205724;62;59;0.548387096774194;28;34;0.0483870967741935;0.451612903225806
Control.ERR205724;67;59;0.432835820895522;38;29;0.0671641791044776;0.432835820895522
Control.ERR205724;67;59;0.552238805970149;30;37;0.0522388059701493;0.447761194029851
Control.ERR205724;63;59;0.507936507936508;31;32;0.00793650793650791;0.492063492063492
Control.ERR205724;67;59;0.462686567164179;36;31;0.0373134328358209;0.462686567164179
Control.ERR205724;64;59;0.46875;34;30;0.03125;0.46875
Control.ERR205724;64;59;0.625;24;40;0.125;0.375
Control.ERR205724;67;59;0.507462686567164;33;34;0.0074626865671642;0.492537313432836
Control.ERR205724;71;59;0.492957746478873;36;35;0.00704225352112675;0.492957746478873
Control.ERR205724;68;59;0.411764705882353;40;28;0.0882352941176471;0.411764705882353
Control.ERR205724;60;59;0.533333333333333;28;32;0.0333333333333333;0.466666666666667
Control.ERR205724;66;59;0.454545454545455;36;30;0.0454545454545455;0.454545454545455
Control.ERR205724;67;59;0.567164179104478;29;38;0.0671641791044776;0.432835820895522
Control.ERR205724;66;59;0.606060606060606;26;40;0.106060606060606;0.393939393939394
Control.ERR205724;68;59;0.470588235294118;36;32;0.0294117647058824;0.470588235294118
Control.ERR205724;71;59;0.535211267605634;33;38;0.0352112676056338;0.464788732394366
Control.ERR205724;67;59;0.507462686567164;33;34;0.0074626865671642;0.492537313432836
Control.ERR205724;67;59;0.492537313432836;34;33;0.0074626865671642;0.492537313432836
Control.ERR205724;62;59;0.370967741935484;39;23;0.129032258064516;0.370967741935484
Control.ERR205724;70;59;0.514285714285714;34;36;0.0142857142857142;0.485714285714286
Control.ERR205724;55;59;0.490909090909091;28;27;0.00909090909090909;0.490909090909091
Control.ERR205724;61;59;0.459016393442623;33;28;0.040983606557377;0.459016393442623
Control.ERR205724;71;59;0.436619718309859;40;31;0.0633802816901409;0.436619718309859
Control.ERR205724;65;59;0.415384615384615;38;27;0.0846153846153846;0.415384615384615
Control.ERR205724;57;59;0.456140350877193;31;26;0.043859649122807;0.456140350877193
Control.ERR205724;63;59;0.571428571428571;27;36;0.0714285714285714;0.428571428571429
Control.ERR205724;64;59;0.453125;35;29;0.046875;0.453125
Control.ERR205724;58;59;0.448275862068966;32;26;0.0517241379310345;0.448275862068966
Control.ERR205724;55;59;0.618181818181818;21;34;0.118181818181818;0.381818181818182
Control.ERR205724;56;59;0.553571428571429;25;31;0.0535714285714286;0.446428571428571
Control.ERR205724;56;59;0.535714285714286;26;30;0.0357142857142857;0.464285714285714
Control.ERR205724;61;59;0.459016393442623;33;28;0.040983606557377;0.459016393442623
Control.ERR205724;54;59;0.462962962962963;29;25;0.037037037037037;0.462962962962963
Control.ERR205724;64;59;0.546875;29;35;0.046875;0.453125
Control.ERR205724;70;59;0.414285714285714;41;29;0.0857142857142857;0.414285714285714
Control.ERR205724;64;59;0.484375;33;31;0.015625;0.484375
Control.ERR205724;61;59;0.475409836065574;32;29;0.0245901639344263;0.475409836065574
Control.ERR205724;58;59;0.551724137931034;26;32;0.0517241379310345;0.448275862068966
Control.ERR205724;53;59;0.433962264150943;30;23;0.0660377358490566;0.433962264150943
Control.ERR205724;61;59;0.524590163934426;29;32;0.0245901639344263;0.475409836065574
