Sample;coverage;median_coverage;ALTF;RDR;RDA;Complexity;MAF
Control.ERR205789;77;61;0.480519480519481;40;37;0.0194805194805195;0.480519480519481
Control.ERR205789;77;61;0.506493506493506;38;39;0.00649350649350644;0.493506493506494
Control.ERR205789;61;61;0.491803278688525;31;30;0.00819672131147542;0.491803278688525
Control.ERR205789;61;61;0.540983606557377;28;33;0.0409836065573771;0.459016393442623
Control.ERR205789;63;61;0.555555555555556;28;35;0.0555555555555556;0.444444444444444
Control.ERR205789;63;61;0.603174603174603;25;38;0.103174603174603;0.396825396825397
Control.ERR205789;68;61;0.558823529411765;30;38;0.0588235294117647;0.441176470588235
Control.ERR205789;61;61;0.524590163934426;29;32;0.0245901639344263;0.475409836065574
Control.ERR205789;64;61;0.5;32;32;0;0.5
Control.ERR205789;63;61;0.428571428571429;36;27;0.0714285714285715;0.428571428571429
Control.ERR205789;62;61;0.483870967741935;32;30;0.0161290322580645;0.483870967741935
Control.ERR205789;64;61;0.53125;30;34;0.03125;0.46875
Control.ERR205789;71;61;0.549295774647887;32;39;0.0492957746478874;0.450704225352113
Control.ERR205789;68;61;0.5;34;34;0;0.5
Control.ERR205789;66;61;0.560606060606061;29;37;0.0606060606060606;0.439393939393939
Control.ERR205789;71;61;0.47887323943662;37;34;0.0211267605633803;0.47887323943662
Control.ERR205789;60;61;0.55;27;33;0.05;0.45
Control.ERR205789;67;61;0.432835820895522;38;29;0.0671641791044776;0.432835820895522
Control.ERR205789;75;61;0.56;33;42;0.0600000000000001;0.44
Control.ERR205789;69;61;0.492753623188406;35;34;0.00724637681159418;0.492753623188406
Control.ERR205789;65;61;0.507692307692308;32;33;0.00769230769230766;0.492307692307692
Control.ERR205789;73;61;0.410958904109589;43;30;0.089041095890411;0.410958904109589
Control.ERR205789;62;61;0.532258064516129;29;33;0.032258064516129;0.467741935483871
Control.ERR205789;73;61;0.547945205479452;33;40;0.047945205479452;0.452054794520548
Control.ERR205789;68;61;0.573529411764706;29;39;0.0735294117647058;0.426470588235294
Control.ERR205789;74;61;0.486486486486487;38;36;0.0135135135135135;0.486486486486487
Control.ERR205789;68;61;0.470588235294118;36;32;0.0294117647058824;0.470588235294118
Control.ERR205789;65;61;0.461538461538462;35;30;0.0384615384615384;0.461538461538462
Control.ERR205789;74;61;0.594594594594595;30;44;0.0945945945945946;0.405405405405405
Control.ERR205789;69;61;0.478260869565217;36;33;0.0217391304347826;0.478260869565217
Control.ERR205789;73;61;0.589041095890411;30;43;0.089041095890411;0.410958904109589
Control.ERR205789;70;61;0.528571428571429;33;37;0.0285714285714286;0.471428571428571
Control.ERR205789;70;61;0.4;42;28;0.1;0.4
Control.ERR205789;71;61;0.563380281690141;31;40;0.0633802816901409;0.436619718309859
Control.ERR205789;64;61;0.453125;35;29;0.046875;0.453125
Control.ERR205789;69;61;0.521739130434783;33;36;0.0217391304347826;0.478260869565217
Control.ERR205789;63;61;0.476190476190476;33;30;0.0238095238095238;0.476190476190476
Control.ERR205789;75;61;0.466666666666667;40;35;0.0333333333333333;0.466666666666667
Control.ERR205789;71;61;0.394366197183099;43;28;0.105633802816901;0.394366197183099
Control.ERR205789;65;61;0.461538461538462;35;30;0.0384615384615384;0.461538461538462
Control.ERR205789;76;61;0.526315789473684;36;40;0.0263157894736842;0.473684210526316
Control.ERR205789;73;61;0.493150684931507;37;36;0.00684931506849318;0.493150684931507
Control.ERR205789;57;61;0.56140350877193;25;32;0.0614035087719298;0.43859649122807
Control.ERR205789;62;61;0.435483870967742;35;27;0.0645161290322581;0.435483870967742
Control.ERR205789;66;61;0.424242424242424;38;28;0.0757575757575757;0.424242424242424
Control.ERR205789;66;61;0.5;33;33;0;0.5
Control.ERR205789;65;61;0.461538461538462;35;30;0.0384615384615384;0.461538461538462
Control.ERR205789;67;61;0.522388059701492;32;35;0.0223880597014925;0.477611940298507
Control.ERR205789;71;61;0.535211267605634;33;38;0.0352112676056338;0.464788732394366
Control.ERR205789;63;61;0.53968253968254;29;34;0.0396825396825397;0.46031746031746
Control.ERR205789;64;61;0.46875;34;30;0.03125;0.46875
Control.ERR205789;60;61;0.433333333333333;34;26;0.0666666666666667;0.433333333333333
Control.ERR205789;74;61;0.459459459459459;40;34;0.0405405405405405;0.459459459459459
Control.ERR205789;68;61;0.426470588235294;39;29;0.0735294117647059;0.426470588235294
Control.ERR205789;67;61;0.537313432835821;31;36;0.0373134328358209;0.462686567164179
Control.ERR205789;74;61;0.472972972972973;39;35;0.027027027027027;0.472972972972973
Control.ERR205789;76;61;0.486842105263158;39;37;0.0131578947368421;0.486842105263158
Control.ERR205789;61;61;0.426229508196721;35;26;0.0737704918032787;0.426229508196721
Control.ERR205789;68;61;0.411764705882353;40;28;0.0882352941176471;0.411764705882353
Control.ERR205789;68;61;0.514705882352941;33;35;0.0147058823529411;0.485294117647059
Control.ERR205789;69;61;0.492753623188406;35;34;0.00724637681159418;0.492753623188406
Control.ERR205789;72;61;0.472222222222222;38;34;0.0277777777777778;0.472222222222222
Control.ERR205789;70;61;0.6;28;42;0.1;0.4
Control.ERR205789;63;61;0.46031746031746;34;29;0.0396825396825397;0.46031746031746
Control.ERR205789;67;61;0.611940298507463;26;41;0.111940298507463;0.388059701492537
Control.ERR205789;77;61;0.506493506493506;38;39;0.00649350649350644;0.493506493506494
Control.ERR205789;62;61;0.548387096774194;28;34;0.0483870967741935;0.451612903225806
Control.ERR205789;59;61;0.457627118644068;32;27;0.0423728813559322;0.457627118644068
Control.ERR205789;65;61;0.569230769230769;28;37;0.0692307692307692;0.430769230769231
Control.ERR205789;68;61;0.544117647058823;31;37;0.0441176470588235;0.455882352941176
Control.ERR205789;62;61;0.419354838709677;36;26;0.0806451612903226;0.419354838709677
Control.ERR205789;65;61;0.415384615384615;38;27;0.0846153846153846;0.415384615384615
Control.ERR205789;70;61;0.528571428571429;33;37;0.0285714285714286;0.471428571428571
Control.ERR205789;73;61;0.520547945205479;35;38;0.0205479452054794;0.479452054794521
Control.ERR205789;61;61;0.524590163934426;29;32;0.0245901639344263;0.475409836065574
Control.ERR205789;64;61;0.421875;37;27;0.078125;0.421875
Control.ERR205789;71;61;0.492957746478873;36;35;0.00704225352112675;0.492957746478873
Control.ERR205789;58;61;0.517241379310345;28;30;0.0172413793103449;0.482758620689655
Control.ERR205789;67;61;0.492537313432836;34;33;0.0074626865671642;0.492537313432836
Control.ERR205789;59;61;0.491525423728814;30;29;0.00847457627118642;0.491525423728814
Control.ERR205789;66;61;0.515151515151515;32;34;0.0151515151515151;0.484848484848485
Control.ERR205789;73;61;0.479452054794521;38;35;0.0205479452054795;0.479452054794521
Control.ERR205789;62;61;0.516129032258065;30;32;0.0161290322580645;0.483870967741935
Control.ERR205789;64;61;0.5;32;32;0;0.5
Control.ERR205789;65;61;0.507692307692308;32;33;0.00769230769230766;0.492307692307692
Control.ERR205789;66;61;0.515151515151515;32;34;0.0151515151515151;0.484848484848485
Control.ERR205789;65;61;0.507692307692308;32;33;0.00769230769230766;0.492307692307692
Control.ERR205789;73;61;0.465753424657534;39;34;0.0342465753424658;0.465753424657534
Control.ERR205789;66;61;0.575757575757576;28;38;0.0757575757575758;0.424242424242424
Control.ERR205789;77;61;0.441558441558442;43;34;0.0584415584415585;0.441558441558442
Control.ERR205789;65;61;0.661538461538462;22;43;0.161538461538462;0.338461538461538
Control.ERR205789;66;61;0.46969696969697;35;31;0.0303030303030303;0.46969696969697
Control.ERR205789;76;61;0.447368421052632;42;34;0.0526315789473684;0.447368421052632
Control.ERR205789;63;61;0.53968253968254;29;34;0.0396825396825397;0.46031746031746
Control.ERR205789;69;61;0.579710144927536;29;40;0.0797101449275363;0.420289855072464
Control.ERR205789;78;61;0.564102564102564;34;44;0.0641025641025641;0.435897435897436
Control.ERR205789;70;61;0.5;35;35;0;0.5
Control.ERR205789;64;61;0.5625;28;36;0.0625;0.4375
Control.ERR205789;72;61;0.513888888888889;35;37;0.0138888888888888;0.486111111111111
Control.ERR205789;73;61;0.452054794520548;40;33;0.0479452054794521;0.452054794520548
Control.ERR205789;78;61;0.448717948717949;43;35;0.0512820512820513;0.448717948717949
Control.ERR205789;59;61;0.457627118644068;32;27;0.0423728813559322;0.457627118644068
Control.ERR205789;67;61;0.492537313432836;34;33;0.0074626865671642;0.492537313432836
Control.ERR205789;69;61;0.565217391304348;30;39;0.0652173913043478;0.434782608695652
Control.ERR205789;65;61;0.553846153846154;29;36;0.0538461538461539;0.446153846153846
Control.ERR205789;66;61;0.560606060606061;29;37;0.0606060606060606;0.439393939393939
Control.ERR205789;63;61;0.412698412698413;37;26;0.0873015873015873;0.412698412698413
Control.ERR205789;67;61;0.537313432835821;31;36;0.0373134328358209;0.462686567164179
Control.ERR205789;66;61;0.545454545454545;30;36;0.0454545454545454;0.454545454545455
Control.ERR205789;59;61;0.542372881355932;27;32;0.0423728813559322;0.457627118644068
Control.ERR205789;78;61;0.448717948717949;43;35;0.0512820512820513;0.448717948717949
Control.ERR205789;65;61;0.384615384615385;40;25;0.115384615384615;0.384615384615385
Control.ERR205789;59;61;0.593220338983051;24;35;0.0932203389830508;0.406779661016949
Control.ERR205789;73;61;0.561643835616438;32;41;0.0616438356164384;0.438356164383562
Control.ERR205789;61;61;0.459016393442623;33;28;0.040983606557377;0.459016393442623
Control.ERR205789;66;61;0.560606060606061;29;37;0.0606060606060606;0.439393939393939
Control.ERR205789;59;61;0.457627118644068;32;27;0.0423728813559322;0.457627118644068
Control.ERR205789;77;61;0.428571428571429;44;33;0.0714285714285715;0.428571428571429
Control.ERR205789;75;61;0.48;39;36;0.02;0.48
Control.ERR205789;66;61;0.636363636363636;24;42;0.136363636363636;0.363636363636364
Control.ERR205789;76;61;0.394736842105263;46;30;0.105263157894737;0.394736842105263
Control.ERR205789;70;61;0.557142857142857;31;39;0.0571428571428572;0.442857142857143
Control.ERR205789;72;61;0.444444444444444;40;32;0.0555555555555556;0.444444444444444
Control.ERR205789;68;61;0.426470588235294;39;29;0.0735294117647059;0.426470588235294
Control.ERR205789;74;61;0.5;37;37;0;0.5
Control.ERR205789;74;61;0.5;37;37;0;0.5
Control.ERR205789;72;61;0.666666666666667;24;48;0.166666666666667;0.333333333333333
Control.ERR205789;59;61;0.423728813559322;34;25;0.076271186440678;0.423728813559322
Control.ERR205789;76;61;0.460526315789474;41;35;0.0394736842105263;0.460526315789474
Control.ERR205789;72;61;0.513888888888889;35;37;0.0138888888888888;0.486111111111111
Control.ERR205789;72;61;0.388888888888889;44;28;0.111111111111111;0.388888888888889
Control.ERR205789;76;61;0.381578947368421;47;29;0.118421052631579;0.381578947368421
Control.ERR205789;68;61;0.455882352941176;37;31;0.0441176470588235;0.455882352941176
Control.ERR205789;65;61;0.507692307692308;32;33;0.00769230769230766;0.492307692307692
Control.ERR205789;66;61;0.590909090909091;27;39;0.0909090909090909;0.409090909090909
Control.ERR205789;71;61;0.507042253521127;35;36;0.00704225352112675;0.492957746478873
Control.ERR205789;75;61;0.4;45;30;0.1;0.4
Control.ERR205789;66;61;0.484848484848485;34;32;0.0151515151515151;0.484848484848485
Control.ERR205789;60;61;0.516666666666667;29;31;0.0166666666666667;0.483333333333333
Control.ERR205789;77;61;0.428571428571429;44;33;0.0714285714285715;0.428571428571429
Control.ERR205789;69;61;0.449275362318841;38;31;0.0507246376811594;0.449275362318841
Control.ERR205789;63;61;0.412698412698413;37;26;0.0873015873015873;0.412698412698413
Control.ERR205789;72;61;0.444444444444444;40;32;0.0555555555555556;0.444444444444444
Control.ERR205789;63;61;0.476190476190476;33;30;0.0238095238095238;0.476190476190476
Control.ERR205789;59;61;0.593220338983051;24;35;0.0932203389830508;0.406779661016949
Control.ERR205789;71;61;0.563380281690141;31;40;0.0633802816901409;0.436619718309859
Control.ERR205789;69;61;0.550724637681159;31;38;0.0507246376811594;0.449275362318841
Control.ERR205789;63;61;0.412698412698413;37;26;0.0873015873015873;0.412698412698413
Control.ERR205789;64;61;0.59375;26;38;0.09375;0.40625
Control.ERR205789;68;61;0.529411764705882;32;36;0.0294117647058824;0.470588235294118
Control.ERR205789;63;61;0.444444444444444;35;28;0.0555555555555556;0.444444444444444
Control.ERR205789;70;61;0.371428571428571;44;26;0.128571428571429;0.371428571428571
Control.ERR205789;77;61;0.402597402597403;46;31;0.0974025974025974;0.402597402597403
Control.ERR205789;68;61;0.529411764705882;32;36;0.0294117647058824;0.470588235294118
Control.ERR205789;62;61;0.596774193548387;25;37;0.0967741935483871;0.403225806451613
Control.ERR205789;65;61;0.523076923076923;31;34;0.0230769230769231;0.476923076923077
Control.ERR205789;71;61;0.394366197183099;43;28;0.105633802816901;0.394366197183099
Control.ERR205789;50;61;0.46;27;23;0.04;0.46
Control.ERR205789;49;61;0.408163265306122;29;20;0.0918367346938775;0.408163265306122
Control.ERR205789;57;61;0.631578947368421;21;36;0.131578947368421;0.368421052631579
Control.ERR205789;51;61;0.529411764705882;24;27;0.0294117647058824;0.470588235294118
Control.ERR205789;45;61;0.466666666666667;24;21;0.0333333333333333;0.466666666666667
Control.ERR205789;52;61;0.461538461538462;28;24;0.0384615384615384;0.461538461538462
Control.ERR205789;49;61;0.489795918367347;25;24;0.0102040816326531;0.489795918367347
Control.ERR205789;46;61;0.41304347826087;27;19;0.0869565217391304;0.41304347826087
Control.ERR205789;53;61;0.584905660377358;22;31;0.0849056603773585;0.415094339622642
Control.ERR205789;53;61;0.433962264150943;30;23;0.0660377358490566;0.433962264150943
Control.ERR205789;52;61;0.538461538461538;24;28;0.0384615384615384;0.461538461538462
Control.ERR205789;54;61;0.5;27;27;0;0.5
Control.ERR205789;54;61;0.62962962962963;20;34;0.12962962962963;0.37037037037037
Control.ERR205789;51;61;0.372549019607843;32;19;0.127450980392157;0.372549019607843
Control.ERR205789;58;61;0.396551724137931;35;23;0.103448275862069;0.396551724137931
Control.ERR205789;52;61;0.365384615384615;33;19;0.134615384615385;0.365384615384615
Control.ERR205789;56;61;0.410714285714286;33;23;0.0892857142857143;0.410714285714286
Control.ERR205789;45;61;0.666666666666667;15;30;0.166666666666667;0.333333333333333
Control.ERR205789;48;61;0.4375;27;21;0.0625;0.4375
Control.ERR205789;52;61;0.557692307692308;23;29;0.0576923076923077;0.442307692307692
Control.ERR205789;52;61;0.519230769230769;25;27;0.0192307692307693;0.480769230769231
Control.ERR205789;48;61;0.520833333333333;23;25;0.0208333333333334;0.479166666666667
Control.ERR205789;51;61;0.431372549019608;29;22;0.0686274509803921;0.431372549019608
Control.ERR205789;52;61;0.538461538461538;24;28;0.0384615384615384;0.461538461538462
Control.ERR205789;59;61;0.576271186440678;25;34;0.076271186440678;0.423728813559322
Control.ERR205789;57;61;0.543859649122807;26;31;0.043859649122807;0.456140350877193
Control.ERR205789;55;61;0.490909090909091;28;27;0.00909090909090909;0.490909090909091
Control.ERR205789;48;61;0.541666666666667;22;26;0.0416666666666666;0.458333333333333
Control.ERR205789;49;61;0.408163265306122;29;20;0.0918367346938775;0.408163265306122
Control.ERR205789;58;61;0.379310344827586;36;22;0.120689655172414;0.379310344827586
Control.ERR205789;61;61;0.540983606557377;28;33;0.0409836065573771;0.459016393442623
Control.ERR205789;68;61;0.470588235294118;36;32;0.0294117647058824;0.470588235294118
Control.ERR205789;75;61;0.533333333333333;35;40;0.0333333333333333;0.466666666666667
Control.ERR205789;75;61;0.493333333333333;38;37;0.00666666666666665;0.493333333333333
Control.ERR205789;58;61;0.362068965517241;37;21;0.137931034482759;0.362068965517241
Control.ERR205789;65;61;0.446153846153846;36;29;0.0538461538461538;0.446153846153846
Control.ERR205789;69;61;0.449275362318841;38;31;0.0507246376811594;0.449275362318841
Control.ERR205789;75;61;0.506666666666667;37;38;0.00666666666666671;0.493333333333333
Control.ERR205789;65;61;0.415384615384615;38;27;0.0846153846153846;0.415384615384615
Control.ERR205789;70;61;0.614285714285714;27;43;0.114285714285714;0.385714285714286
Control.ERR205789;61;61;0.639344262295082;22;39;0.139344262295082;0.360655737704918
Control.ERR205789;64;61;0.5625;28;36;0.0625;0.4375
Control.ERR205789;58;61;0.431034482758621;33;25;0.0689655172413793;0.431034482758621
Control.ERR205789;75;61;0.453333333333333;41;34;0.0466666666666667;0.453333333333333
Control.ERR205789;74;61;0.486486486486487;38;36;0.0135135135135135;0.486486486486487
Control.ERR205789;59;61;0.610169491525424;23;36;0.110169491525424;0.389830508474576
Control.ERR205789;59;61;0.508474576271186;29;30;0.00847457627118642;0.491525423728814
Control.ERR205789;57;61;0.421052631578947;33;24;0.0789473684210527;0.421052631578947
Control.ERR205789;65;61;0.523076923076923;31;34;0.0230769230769231;0.476923076923077
Control.ERR205789;64;61;0.515625;31;33;0.015625;0.484375
Control.ERR205789;63;61;0.555555555555556;28;35;0.0555555555555556;0.444444444444444
Control.ERR205789;67;61;0.522388059701492;32;35;0.0223880597014925;0.477611940298507
Control.ERR205789;66;61;0.515151515151515;32;34;0.0151515151515151;0.484848484848485
Control.ERR205789;66;61;0.409090909090909;39;27;0.0909090909090909;0.409090909090909
Control.ERR205789;70;61;0.471428571428571;37;33;0.0285714285714286;0.471428571428571
Control.ERR205789;57;61;0.491228070175439;29;28;0.00877192982456143;0.491228070175439
Control.ERR205789;69;61;0.405797101449275;41;28;0.0942028985507246;0.405797101449275
Control.ERR205789;72;61;0.486111111111111;37;35;0.0138888888888889;0.486111111111111
Control.ERR205789;68;61;0.544117647058823;31;37;0.0441176470588235;0.455882352941176
Control.ERR205789;69;61;0.536231884057971;32;37;0.0362318840579711;0.463768115942029
Control.ERR205789;69;61;0.507246376811594;34;35;0.00724637681159424;0.492753623188406
Control.ERR205789;69;61;0.507246376811594;34;35;0.00724637681159424;0.492753623188406
Control.ERR205789;57;61;0.543859649122807;26;31;0.043859649122807;0.456140350877193
Control.ERR205789;70;61;0.485714285714286;36;34;0.0142857142857143;0.485714285714286
Control.ERR205789;75;61;0.653333333333333;26;49;0.153333333333333;0.346666666666667
Control.ERR205789;74;61;0.472972972972973;39;35;0.027027027027027;0.472972972972973
Control.ERR205789;74;61;0.472972972972973;39;35;0.027027027027027;0.472972972972973
Control.ERR205789;70;61;0.542857142857143;32;38;0.0428571428571428;0.457142857142857
Control.ERR205789;61;61;0.557377049180328;27;34;0.0573770491803278;0.442622950819672
Control.ERR205789;72;61;0.555555555555556;32;40;0.0555555555555556;0.444444444444444
Control.ERR205789;63;61;0.46031746031746;34;29;0.0396825396825397;0.46031746031746
Control.ERR205789;70;61;0.485714285714286;36;34;0.0142857142857143;0.485714285714286
Control.ERR205789;71;61;0.577464788732394;30;41;0.0774647887323944;0.422535211267606
Control.ERR205789;68;61;0.588235294117647;28;40;0.0882352941176471;0.411764705882353
Control.ERR205789;66;61;0.515151515151515;32;34;0.0151515151515151;0.484848484848485
Control.ERR205789;67;61;0.522388059701492;32;35;0.0223880597014925;0.477611940298507
Control.ERR205789;63;61;0.412698412698413;37;26;0.0873015873015873;0.412698412698413
Control.ERR205789;72;61;0.583333333333333;30;42;0.0833333333333334;0.416666666666667
Control.ERR205789;73;61;0.575342465753425;31;42;0.0753424657534246;0.424657534246575
Control.ERR205789;64;61;0.5;32;32;0;0.5
Control.ERR205789;65;61;0.415384615384615;38;27;0.0846153846153846;0.415384615384615
Control.ERR205789;59;61;0.508474576271186;29;30;0.00847457627118642;0.491525423728814
Control.ERR205789;76;61;0.592105263157895;31;45;0.0921052631578947;0.407894736842105
Control.ERR205789;77;61;0.467532467532468;41;36;0.0324675324675325;0.467532467532468
Control.ERR205789;78;61;0.538461538461538;36;42;0.0384615384615384;0.461538461538462
Control.ERR205789;66;61;0.515151515151515;32;34;0.0151515151515151;0.484848484848485
Control.ERR205789;63;61;0.555555555555556;28;35;0.0555555555555556;0.444444444444444
Control.ERR205789;64;61;0.59375;26;38;0.09375;0.40625
Control.ERR205789;70;61;0.485714285714286;36;34;0.0142857142857143;0.485714285714286
Control.ERR205789;70;61;0.414285714285714;41;29;0.0857142857142857;0.414285714285714
Control.ERR205789;70;61;0.571428571428571;30;40;0.0714285714285714;0.428571428571429
Control.ERR205789;68;61;0.485294117647059;35;33;0.0147058823529412;0.485294117647059
Control.ERR205789;68;61;0.441176470588235;38;30;0.0588235294117647;0.441176470588235
Control.ERR205789;62;61;0.612903225806452;24;38;0.112903225806452;0.387096774193548
Control.ERR205789;70;61;0.442857142857143;39;31;0.0571428571428572;0.442857142857143
Control.ERR205789;69;61;0.463768115942029;37;32;0.036231884057971;0.463768115942029
Control.ERR205789;69;61;0.463768115942029;37;32;0.036231884057971;0.463768115942029
Control.ERR205789;61;61;0.573770491803279;26;35;0.0737704918032787;0.426229508196721
Control.ERR205789;69;61;0.507246376811594;34;35;0.00724637681159424;0.492753623188406
Control.ERR205789;61;61;0.557377049180328;27;34;0.0573770491803278;0.442622950819672
Control.ERR205789;78;61;0.41025641025641;46;32;0.0897435897435898;0.41025641025641
Control.ERR205789;67;61;0.462686567164179;36;31;0.0373134328358209;0.462686567164179
Control.ERR205789;70;61;0.585714285714286;29;41;0.0857142857142857;0.414285714285714
Control.ERR205789;61;61;0.590163934426229;25;36;0.0901639344262295;0.409836065573771
Control.ERR205789;63;61;0.555555555555556;28;35;0.0555555555555556;0.444444444444444
Control.ERR205789;73;61;0.479452054794521;38;35;0.0205479452054795;0.479452054794521
Control.ERR205789;62;61;0.467741935483871;33;29;0.0322580645161291;0.467741935483871
Control.ERR205789;64;61;0.546875;29;35;0.046875;0.453125
Control.ERR205789;73;61;0.534246575342466;34;39;0.0342465753424658;0.465753424657534
Control.ERR205789;68;61;0.485294117647059;35;33;0.0147058823529412;0.485294117647059
Control.ERR205789;60;61;0.35;39;21;0.15;0.35
Control.ERR205789;72;61;0.513888888888889;35;37;0.0138888888888888;0.486111111111111
Control.ERR205789;65;61;0.523076923076923;31;34;0.0230769230769231;0.476923076923077
Control.ERR205789;74;61;0.5;37;37;0;0.5
Control.ERR205789;76;61;0.407894736842105;45;31;0.0921052631578947;0.407894736842105
Control.ERR205789;78;61;0.487179487179487;40;38;0.0128205128205128;0.487179487179487
Control.ERR205789;76;61;0.578947368421053;32;44;0.0789473684210527;0.421052631578947
Control.ERR205789;80;61;0.525;38;42;0.025;0.475
Control.ERR205789;79;61;0.481012658227848;41;38;0.0189873417721519;0.481012658227848
Control.ERR205789;79;61;0.493670886075949;40;39;0.00632911392405061;0.493670886075949
Control.ERR205789;61;61;0.557377049180328;27;34;0.0573770491803278;0.442622950819672
Control.ERR205789;68;61;0.529411764705882;32;36;0.0294117647058824;0.470588235294118
Control.ERR205789;60;61;0.533333333333333;28;32;0.0333333333333333;0.466666666666667
Control.ERR205789;60;61;0.483333333333333;31;29;0.0166666666666667;0.483333333333333
Control.ERR205789;75;61;0.466666666666667;40;35;0.0333333333333333;0.466666666666667
Control.ERR205789;70;61;0.457142857142857;38;32;0.0428571428571429;0.457142857142857
Control.ERR205789;70;61;0.557142857142857;31;39;0.0571428571428572;0.442857142857143
Control.ERR205789;76;61;0.513157894736842;37;39;0.0131578947368421;0.486842105263158
Control.ERR205789;68;61;0.558823529411765;30;38;0.0588235294117647;0.441176470588235
Control.ERR205789;68;61;0.529411764705882;32;36;0.0294117647058824;0.470588235294118
Control.ERR205789;69;61;0.536231884057971;32;37;0.0362318840579711;0.463768115942029
Control.ERR205789;72;61;0.513888888888889;35;37;0.0138888888888888;0.486111111111111
Control.ERR205789;65;61;0.646153846153846;23;42;0.146153846153846;0.353846153846154
Control.ERR205789;61;61;0.491803278688525;31;30;0.00819672131147542;0.491803278688525
Control.ERR205789;65;61;0.476923076923077;34;31;0.0230769230769231;0.476923076923077
Control.ERR205789;70;61;0.585714285714286;29;41;0.0857142857142857;0.414285714285714
Control.ERR205789;64;61;0.484375;33;31;0.015625;0.484375
Control.ERR205789;67;61;0.522388059701492;32;35;0.0223880597014925;0.477611940298507
Control.ERR205789;73;61;0.534246575342466;34;39;0.0342465753424658;0.465753424657534
Control.ERR205789;72;61;0.444444444444444;40;32;0.0555555555555556;0.444444444444444
Control.ERR205789;76;61;0.552631578947368;34;42;0.0526315789473685;0.447368421052632
Control.ERR205789;74;61;0.459459459459459;40;34;0.0405405405405405;0.459459459459459
Control.ERR205789;73;61;0.575342465753425;31;42;0.0753424657534246;0.424657534246575
Control.ERR205789;69;61;0.536231884057971;32;37;0.0362318840579711;0.463768115942029
Control.ERR205789;66;61;0.621212121212121;25;41;0.121212121212121;0.378787878787879
Control.ERR205789;76;61;0.539473684210526;35;41;0.0394736842105263;0.460526315789474
Control.ERR205789;76;61;0.473684210526316;40;36;0.0263157894736842;0.473684210526316
Control.ERR205789;72;61;0.458333333333333;39;33;0.0416666666666667;0.458333333333333
Control.ERR205789;60;61;0.383333333333333;37;23;0.116666666666667;0.383333333333333
Control.ERR205789;72;61;0.541666666666667;33;39;0.0416666666666666;0.458333333333333
Control.ERR205789;75;61;0.506666666666667;37;38;0.00666666666666671;0.493333333333333
Control.ERR205789;69;61;0.565217391304348;30;39;0.0652173913043478;0.434782608695652
Control.ERR205789;67;61;0.402985074626866;40;27;0.0970149253731343;0.402985074626866
Control.ERR205789;65;61;0.507692307692308;32;33;0.00769230769230766;0.492307692307692
Control.ERR205789;65;61;0.384615384615385;40;25;0.115384615384615;0.384615384615385
Control.ERR205789;75;61;0.453333333333333;41;34;0.0466666666666667;0.453333333333333
Control.ERR205789;68;61;0.632352941176471;25;43;0.132352941176471;0.367647058823529
Control.ERR205789;60;61;0.466666666666667;32;28;0.0333333333333333;0.466666666666667
Control.ERR205789;74;61;0.608108108108108;29;45;0.108108108108108;0.391891891891892
Control.ERR205789;71;61;0.52112676056338;34;37;0.0211267605633803;0.47887323943662
Control.ERR205789;75;61;0.493333333333333;38;37;0.00666666666666665;0.493333333333333
Control.ERR205789;73;61;0.506849315068493;36;37;0.00684931506849318;0.493150684931507
Control.ERR205789;72;61;0.555555555555556;32;40;0.0555555555555556;0.444444444444444
Control.ERR205789;66;61;0.515151515151515;32;34;0.0151515151515151;0.484848484848485
Control.ERR205789;58;61;0.551724137931034;26;32;0.0517241379310345;0.448275862068966
Control.ERR205789;69;61;0.608695652173913;27;42;0.108695652173913;0.391304347826087
Control.ERR205789;72;61;0.513888888888889;35;37;0.0138888888888888;0.486111111111111
Control.ERR205789;67;61;0.462686567164179;36;31;0.0373134328358209;0.462686567164179
Control.ERR205789;70;61;0.514285714285714;34;36;0.0142857142857142;0.485714285714286
Control.ERR205789;69;61;0.565217391304348;30;39;0.0652173913043478;0.434782608695652
Control.ERR205789;72;61;0.444444444444444;40;32;0.0555555555555556;0.444444444444444
Control.ERR205789;62;61;0.483870967741935;32;30;0.0161290322580645;0.483870967741935
Control.ERR205789;75;61;0.44;42;33;0.06;0.44
Control.ERR205789;68;61;0.397058823529412;41;27;0.102941176470588;0.397058823529412
Control.ERR205789;67;61;0.537313432835821;31;36;0.0373134328358209;0.462686567164179
Control.ERR205789;59;61;0.491525423728814;30;29;0.00847457627118642;0.491525423728814
Control.ERR205789;62;61;0.483870967741935;32;30;0.0161290322580645;0.483870967741935
Control.ERR205789;69;61;0.681159420289855;22;47;0.181159420289855;0.318840579710145
Control.ERR205789;66;61;0.590909090909091;27;39;0.0909090909090909;0.409090909090909
Control.ERR205789;70;61;0.457142857142857;38;32;0.0428571428571429;0.457142857142857
Control.ERR205789;72;61;0.5;36;36;0;0.5
Control.ERR205789;71;61;0.507042253521127;35;36;0.00704225352112675;0.492957746478873
Control.ERR205789;67;61;0.432835820895522;38;29;0.0671641791044776;0.432835820895522
Control.ERR205789;65;61;0.584615384615385;27;38;0.0846153846153846;0.415384615384615
Control.ERR205789;69;61;0.492753623188406;35;34;0.00724637681159418;0.492753623188406
Control.ERR205789;68;61;0.602941176470588;27;41;0.102941176470588;0.397058823529412
Control.ERR205789;57;61;0.596491228070175;23;34;0.0964912280701754;0.403508771929825
Control.ERR205789;64;61;0.46875;34;30;0.03125;0.46875
Control.ERR205789;59;61;0.474576271186441;31;28;0.0254237288135593;0.474576271186441
Control.ERR205789;57;61;0.508771929824561;28;29;0.00877192982456143;0.491228070175439
Control.ERR205789;66;61;0.46969696969697;35;31;0.0303030303030303;0.46969696969697
Control.ERR205789;60;61;0.55;27;33;0.05;0.45
Control.ERR205789;58;61;0.53448275862069;27;31;0.0344827586206896;0.46551724137931
Control.ERR205789;68;61;0.5;34;34;0;0.5
Control.ERR205789;73;61;0.547945205479452;33;40;0.047945205479452;0.452054794520548
Control.ERR205789;60;61;0.35;39;21;0.15;0.35
Control.ERR205789;62;61;0.5;31;31;0;0.5
Control.ERR205789;63;61;0.492063492063492;32;31;0.00793650793650796;0.492063492063492
Control.ERR205789;74;61;0.472972972972973;39;35;0.027027027027027;0.472972972972973
Control.ERR205789;74;61;0.5;37;37;0;0.5
Control.ERR205789;68;61;0.426470588235294;39;29;0.0735294117647059;0.426470588235294
Control.ERR205789;63;61;0.396825396825397;38;25;0.103174603174603;0.396825396825397
Control.ERR205789;73;61;0.479452054794521;38;35;0.0205479452054795;0.479452054794521
Control.ERR205789;66;61;0.439393939393939;37;29;0.0606060606060606;0.439393939393939
Control.ERR205789;68;61;0.441176470588235;38;30;0.0588235294117647;0.441176470588235
Control.ERR205789;64;61;0.578125;27;37;0.078125;0.421875
Control.ERR205789;66;61;0.545454545454545;30;36;0.0454545454545454;0.454545454545455
Control.ERR205789;57;61;0.456140350877193;31;26;0.043859649122807;0.456140350877193
Control.ERR205789;58;61;0.517241379310345;28;30;0.0172413793103449;0.482758620689655
Control.ERR205789;69;61;0.420289855072464;40;29;0.0797101449275363;0.420289855072464
Control.ERR205789;70;61;0.457142857142857;38;32;0.0428571428571429;0.457142857142857
Control.ERR205789;58;61;0.482758620689655;30;28;0.0172413793103448;0.482758620689655
Control.ERR205789;59;61;0.593220338983051;24;35;0.0932203389830508;0.406779661016949
Control.ERR205789;62;61;0.483870967741935;32;30;0.0161290322580645;0.483870967741935
Control.ERR205789;63;61;0.507936507936508;31;32;0.00793650793650791;0.492063492063492
Control.ERR205789;68;61;0.441176470588235;38;30;0.0588235294117647;0.441176470588235
Control.ERR205789;72;61;0.555555555555556;32;40;0.0555555555555556;0.444444444444444
Control.ERR205789;72;61;0.513888888888889;35;37;0.0138888888888888;0.486111111111111
Control.ERR205789;62;61;0.5;31;31;0;0.5
Control.ERR205789;69;61;0.565217391304348;30;39;0.0652173913043478;0.434782608695652
Control.ERR205789;69;61;0.536231884057971;32;37;0.0362318840579711;0.463768115942029
Control.ERR205789;68;61;0.544117647058823;31;37;0.0441176470588235;0.455882352941176
Control.ERR205789;71;61;0.507042253521127;35;36;0.00704225352112675;0.492957746478873
Control.ERR205789;64;61;0.5625;28;36;0.0625;0.4375
Control.ERR205789;70;61;0.485714285714286;36;34;0.0142857142857143;0.485714285714286
Control.ERR205789;66;61;0.409090909090909;39;27;0.0909090909090909;0.409090909090909
Control.ERR205789;68;61;0.544117647058823;31;37;0.0441176470588235;0.455882352941176
Control.ERR205789;64;61;0.453125;35;29;0.046875;0.453125
Control.ERR205789;74;61;0.472972972972973;39;35;0.027027027027027;0.472972972972973
Control.ERR205789;64;61;0.5;32;32;0;0.5
Control.ERR205789;65;61;0.569230769230769;28;37;0.0692307692307692;0.430769230769231
Control.ERR205789;65;61;0.446153846153846;36;29;0.0538461538461538;0.446153846153846
Control.ERR205789;73;61;0.534246575342466;34;39;0.0342465753424658;0.465753424657534
Control.ERR205789;75;61;0.6;30;45;0.1;0.4
Control.ERR205789;61;61;0.409836065573771;36;25;0.0901639344262295;0.409836065573771
Control.ERR205789;68;61;0.455882352941176;37;31;0.0441176470588235;0.455882352941176
Control.ERR205789;67;61;0.492537313432836;34;33;0.0074626865671642;0.492537313432836
Control.ERR205789;65;61;0.507692307692308;32;33;0.00769230769230766;0.492307692307692
Control.ERR205789;58;61;0.46551724137931;31;27;0.0344827586206897;0.46551724137931
Control.ERR205789;59;61;0.508474576271186;29;30;0.00847457627118642;0.491525423728814
Control.ERR205789;69;61;0.391304347826087;42;27;0.108695652173913;0.391304347826087
Control.ERR205789;72;61;0.458333333333333;39;33;0.0416666666666667;0.458333333333333
Control.ERR205789;69;61;0.478260869565217;36;33;0.0217391304347826;0.478260869565217
Control.ERR205789;68;61;0.529411764705882;32;36;0.0294117647058824;0.470588235294118
Control.ERR205789;70;61;0.5;35;35;0;0.5
Control.ERR205789;65;61;0.492307692307692;33;32;0.00769230769230766;0.492307692307692
Control.ERR205789;71;61;0.535211267605634;33;38;0.0352112676056338;0.464788732394366
Control.ERR205789;71;61;0.535211267605634;33;38;0.0352112676056338;0.464788732394366
Control.ERR205789;74;61;0.486486486486487;38;36;0.0135135135135135;0.486486486486487
Control.ERR205789;67;61;0.537313432835821;31;36;0.0373134328358209;0.462686567164179
Control.ERR205789;68;61;0.470588235294118;36;32;0.0294117647058824;0.470588235294118
Control.ERR205789;63;61;0.412698412698413;37;26;0.0873015873015873;0.412698412698413
Control.ERR205789;60;61;0.583333333333333;25;35;0.0833333333333334;0.416666666666667
Control.ERR205789;72;61;0.5;36;36;0;0.5
Control.ERR205789;65;61;0.507692307692308;32;33;0.00769230769230766;0.492307692307692
Control.ERR205789;75;61;0.56;33;42;0.0600000000000001;0.44
Control.ERR205789;57;61;0.368421052631579;36;21;0.131578947368421;0.368421052631579
Control.ERR205789;75;61;0.48;39;36;0.02;0.48
Control.ERR205789;66;61;0.621212121212121;25;41;0.121212121212121;0.378787878787879
Control.ERR205789;67;61;0.611940298507463;26;41;0.111940298507463;0.388059701492537
Control.ERR205789;68;61;0.5;34;34;0;0.5
Control.ERR205789;57;61;0.43859649122807;32;25;0.0614035087719298;0.43859649122807
Control.ERR205789;74;61;0.432432432432432;42;32;0.0675675675675675;0.432432432432432
Control.ERR205789;65;61;0.492307692307692;33;32;0.00769230769230766;0.492307692307692
Control.ERR205789;70;61;0.442857142857143;39;31;0.0571428571428572;0.442857142857143
Control.ERR205789;73;61;0.424657534246575;42;31;0.0753424657534247;0.424657534246575
Control.ERR205789;57;61;0.491228070175439;29;28;0.00877192982456143;0.491228070175439
Control.ERR205789;60;61;0.45;33;27;0.05;0.45
Control.ERR205789;68;61;0.411764705882353;40;28;0.0882352941176471;0.411764705882353
Control.ERR205789;66;61;0.424242424242424;38;28;0.0757575757575757;0.424242424242424
Control.ERR205789;72;61;0.458333333333333;39;33;0.0416666666666667;0.458333333333333
Control.ERR205789;64;61;0.5;32;32;0;0.5
Control.ERR205789;57;61;0.473684210526316;30;27;0.0263157894736842;0.473684210526316
Control.ERR205789;72;61;0.444444444444444;40;32;0.0555555555555556;0.444444444444444
Control.ERR205789;61;61;0.491803278688525;31;30;0.00819672131147542;0.491803278688525
Control.ERR205789;70;61;0.514285714285714;34;36;0.0142857142857142;0.485714285714286
Control.ERR205789;67;61;0.492537313432836;34;33;0.0074626865671642;0.492537313432836
Control.ERR205789;72;61;0.5;36;36;0;0.5
Control.ERR205789;73;61;0.534246575342466;34;39;0.0342465753424658;0.465753424657534
Control.ERR205789;70;61;0.557142857142857;31;39;0.0571428571428572;0.442857142857143
Control.ERR205789;74;61;0.513513513513513;36;38;0.0135135135135135;0.486486486486487
Control.ERR205789;72;61;0.513888888888889;35;37;0.0138888888888888;0.486111111111111
Control.ERR205789;66;61;0.545454545454545;30;36;0.0454545454545454;0.454545454545455
Control.ERR205789;66;61;0.439393939393939;37;29;0.0606060606060606;0.439393939393939
Control.ERR205789;69;61;0.463768115942029;37;32;0.036231884057971;0.463768115942029
Control.ERR205789;73;61;0.520547945205479;35;38;0.0205479452054794;0.479452054794521
Control.ERR205789;58;61;0.5;29;29;0;0.5
Control.ERR205789;75;61;0.373333333333333;47;28;0.126666666666667;0.373333333333333
Control.ERR205789;72;61;0.472222222222222;38;34;0.0277777777777778;0.472222222222222
Control.ERR205789;74;61;0.581081081081081;31;43;0.081081081081081;0.418918918918919
Control.ERR205789;67;61;0.477611940298507;35;32;0.0223880597014925;0.477611940298507
Control.ERR205789;67;61;0.567164179104478;29;38;0.0671641791044776;0.432835820895522
Control.ERR205789;65;61;0.446153846153846;36;29;0.0538461538461538;0.446153846153846
Control.ERR205789;71;61;0.507042253521127;35;36;0.00704225352112675;0.492957746478873
Control.ERR205789;64;61;0.5;32;32;0;0.5
Control.ERR205789;70;61;0.528571428571429;33;37;0.0285714285714286;0.471428571428571
Control.ERR205789;67;61;0.447761194029851;37;30;0.0522388059701492;0.447761194029851
Control.ERR205789;67;61;0.582089552238806;28;39;0.082089552238806;0.417910447761194
Control.ERR205789;60;61;0.483333333333333;31;29;0.0166666666666667;0.483333333333333
Control.ERR205789;67;61;0.537313432835821;31;36;0.0373134328358209;0.462686567164179
Control.ERR205789;61;61;0.475409836065574;32;29;0.0245901639344263;0.475409836065574
Control.ERR205789;75;61;0.506666666666667;37;38;0.00666666666666671;0.493333333333333
Control.ERR205789;73;61;0.616438356164384;28;45;0.116438356164384;0.383561643835616
Control.ERR205789;61;61;0.508196721311475;30;31;0.00819672131147542;0.491803278688525
Control.ERR205789;73;61;0.452054794520548;40;33;0.0479452054794521;0.452054794520548
Control.ERR205789;66;61;0.5;33;33;0;0.5
Control.ERR205789;63;61;0.571428571428571;27;36;0.0714285714285714;0.428571428571429
Control.ERR205789;57;61;0.508771929824561;28;29;0.00877192982456143;0.491228070175439
Control.ERR205789;72;61;0.388888888888889;44;28;0.111111111111111;0.388888888888889
Control.ERR205789;66;61;0.575757575757576;28;38;0.0757575757575758;0.424242424242424
Control.ERR205789;63;61;0.523809523809524;30;33;0.0238095238095238;0.476190476190476
Control.ERR205789;75;61;0.573333333333333;32;43;0.0733333333333334;0.426666666666667
Control.ERR205789;73;61;0.452054794520548;40;33;0.0479452054794521;0.452054794520548
Control.ERR205789;66;61;0.606060606060606;26;40;0.106060606060606;0.393939393939394
Control.ERR205789;72;61;0.388888888888889;44;28;0.111111111111111;0.388888888888889
Control.ERR205789;58;61;0.551724137931034;26;32;0.0517241379310345;0.448275862068966
Control.ERR205789;59;61;0.593220338983051;24;35;0.0932203389830508;0.406779661016949
Control.ERR205789;66;61;0.575757575757576;28;38;0.0757575757575758;0.424242424242424
Control.ERR205789;63;61;0.523809523809524;30;33;0.0238095238095238;0.476190476190476
Control.ERR205789;59;61;0.457627118644068;32;27;0.0423728813559322;0.457627118644068
Control.ERR205789;74;61;0.554054054054054;33;41;0.0540540540540541;0.445945945945946
Control.ERR205789;69;61;0.521739130434783;33;36;0.0217391304347826;0.478260869565217
Control.ERR205789;57;61;0.315789473684211;39;18;0.184210526315789;0.315789473684211
Control.ERR205789;72;61;0.569444444444444;31;41;0.0694444444444444;0.430555555555556
Control.ERR205789;69;61;0.405797101449275;41;28;0.0942028985507246;0.405797101449275
Control.ERR205789;66;61;0.439393939393939;37;29;0.0606060606060606;0.439393939393939
Control.ERR205789;67;61;0.522388059701492;32;35;0.0223880597014925;0.477611940298507
Control.ERR205789;62;61;0.435483870967742;35;27;0.0645161290322581;0.435483870967742
Control.ERR205789;64;61;0.484375;33;31;0.015625;0.484375
Control.ERR205789;60;61;0.533333333333333;28;32;0.0333333333333333;0.466666666666667
Control.ERR205789;72;61;0.513888888888889;35;37;0.0138888888888888;0.486111111111111
Control.ERR205789;72;61;0.541666666666667;33;39;0.0416666666666666;0.458333333333333
Control.ERR205789;70;61;0.514285714285714;34;36;0.0142857142857142;0.485714285714286
Control.ERR205789;73;61;0.479452054794521;38;35;0.0205479452054795;0.479452054794521
Control.ERR205789;67;61;0.402985074626866;40;27;0.0970149253731343;0.402985074626866
Control.ERR205789;61;61;0.491803278688525;31;30;0.00819672131147542;0.491803278688525
Control.ERR205789;74;61;0.608108108108108;29;45;0.108108108108108;0.391891891891892
Control.ERR205789;68;61;0.397058823529412;41;27;0.102941176470588;0.397058823529412
Control.ERR205789;74;61;0.432432432432432;42;32;0.0675675675675675;0.432432432432432
Control.ERR205789;64;61;0.59375;26;38;0.09375;0.40625
Control.ERR205789;73;61;0.506849315068493;36;37;0.00684931506849318;0.493150684931507
Control.ERR205789;66;61;0.5;33;33;0;0.5
Control.ERR205789;74;61;0.459459459459459;40;34;0.0405405405405405;0.459459459459459
Control.ERR205789;59;61;0.525423728813559;28;31;0.0254237288135594;0.474576271186441
Control.ERR205789;74;61;0.459459459459459;40;34;0.0405405405405405;0.459459459459459
Control.ERR205789;74;61;0.513513513513513;36;38;0.0135135135135135;0.486486486486487
Control.ERR205789;65;61;0.446153846153846;36;29;0.0538461538461538;0.446153846153846
Control.ERR205789;60;61;0.483333333333333;31;29;0.0166666666666667;0.483333333333333
Control.ERR205789;59;61;0.423728813559322;34;25;0.076271186440678;0.423728813559322
Control.ERR205789;57;61;0.491228070175439;29;28;0.00877192982456143;0.491228070175439
Control.ERR205789;67;61;0.507462686567164;33;34;0.0074626865671642;0.492537313432836
Control.ERR205789;71;61;0.464788732394366;38;33;0.0352112676056338;0.464788732394366
Control.ERR205789;67;61;0.522388059701492;32;35;0.0223880597014925;0.477611940298507
Control.ERR205789;73;61;0.438356164383562;41;32;0.0616438356164384;0.438356164383562
Control.ERR205789;65;61;0.507692307692308;32;33;0.00769230769230766;0.492307692307692
Control.ERR205789;66;61;0.484848484848485;34;32;0.0151515151515151;0.484848484848485
Control.ERR205789;63;61;0.523809523809524;30;33;0.0238095238095238;0.476190476190476
Control.ERR205789;71;61;0.549295774647887;32;39;0.0492957746478874;0.450704225352113
Control.ERR205789;66;61;0.454545454545455;36;30;0.0454545454545455;0.454545454545455
Control.ERR205789;61;61;0.491803278688525;31;30;0.00819672131147542;0.491803278688525
Control.ERR205789;60;61;0.483333333333333;31;29;0.0166666666666667;0.483333333333333
Control.ERR205789;66;61;0.515151515151515;32;34;0.0151515151515151;0.484848484848485
Control.ERR205789;68;61;0.529411764705882;32;36;0.0294117647058824;0.470588235294118
Control.ERR205789;58;61;0.568965517241379;25;33;0.0689655172413793;0.431034482758621
Control.ERR205789;65;61;0.507692307692308;32;33;0.00769230769230766;0.492307692307692
Control.ERR205789;60;61;0.5;30;30;0;0.5
Control.ERR205789;61;61;0.540983606557377;28;33;0.0409836065573771;0.459016393442623
Control.ERR205789;66;61;0.560606060606061;29;37;0.0606060606060606;0.439393939393939
Control.ERR205789;64;61;0.40625;38;26;0.09375;0.40625
Control.ERR205789;65;61;0.492307692307692;33;32;0.00769230769230766;0.492307692307692
Control.ERR205789;64;61;0.5;32;32;0;0.5
Control.ERR205789;67;61;0.597014925373134;27;40;0.0970149253731343;0.402985074626866
Control.ERR205789;64;61;0.40625;38;26;0.09375;0.40625
Control.ERR205789;64;61;0.46875;34;30;0.03125;0.46875
Control.ERR205789;68;61;0.558823529411765;30;38;0.0588235294117647;0.441176470588235
Control.ERR205789;70;61;0.514285714285714;34;36;0.0142857142857142;0.485714285714286
Control.ERR205789;64;61;0.40625;38;26;0.09375;0.40625
Control.ERR205789;64;61;0.5625;28;36;0.0625;0.4375
Control.ERR205789;60;61;0.533333333333333;28;32;0.0333333333333333;0.466666666666667
Control.ERR205789;60;61;0.416666666666667;35;25;0.0833333333333333;0.416666666666667
Control.ERR205789;65;61;0.492307692307692;33;32;0.00769230769230766;0.492307692307692
Control.ERR205789;67;61;0.567164179104478;29;38;0.0671641791044776;0.432835820895522
Control.ERR205789;63;61;0.428571428571429;36;27;0.0714285714285715;0.428571428571429
Control.ERR205789;63;61;0.523809523809524;30;33;0.0238095238095238;0.476190476190476
Control.ERR205789;72;61;0.472222222222222;38;34;0.0277777777777778;0.472222222222222
Control.ERR205789;61;61;0.442622950819672;34;27;0.0573770491803279;0.442622950819672
Control.ERR205789;61;61;0.639344262295082;22;39;0.139344262295082;0.360655737704918
Control.ERR205789;65;61;0.461538461538462;35;30;0.0384615384615384;0.461538461538462
Control.ERR205789;71;61;0.436619718309859;40;31;0.0633802816901409;0.436619718309859
Control.ERR205789;61;61;0.360655737704918;39;22;0.139344262295082;0.360655737704918
Control.ERR205789;65;61;0.476923076923077;34;31;0.0230769230769231;0.476923076923077
Control.ERR205789;63;61;0.587301587301587;26;37;0.0873015873015873;0.412698412698413
Control.ERR205789;70;61;0.557142857142857;31;39;0.0571428571428572;0.442857142857143
Control.ERR205789;71;61;0.464788732394366;38;33;0.0352112676056338;0.464788732394366
Control.ERR205789;61;61;0.409836065573771;36;25;0.0901639344262295;0.409836065573771
Control.ERR205789;67;61;0.507462686567164;33;34;0.0074626865671642;0.492537313432836
Control.ERR205789;70;61;0.5;35;35;0;0.5
Control.ERR205789;66;61;0.393939393939394;40;26;0.106060606060606;0.393939393939394
Control.ERR205789;60;61;0.466666666666667;32;28;0.0333333333333333;0.466666666666667
Control.ERR205789;70;61;0.457142857142857;38;32;0.0428571428571429;0.457142857142857
Control.ERR205789;74;61;0.540540540540541;34;40;0.0405405405405406;0.459459459459459
Control.ERR205789;69;61;0.550724637681159;31;38;0.0507246376811594;0.449275362318841
Control.ERR205789;74;61;0.554054054054054;33;41;0.0540540540540541;0.445945945945946
Control.ERR205789;65;61;0.492307692307692;33;32;0.00769230769230766;0.492307692307692
Control.ERR205789;57;61;0.526315789473684;27;30;0.0263157894736842;0.473684210526316
Control.ERR205789;61;61;0.590163934426229;25;36;0.0901639344262295;0.409836065573771
Control.ERR205789;72;61;0.5;36;36;0;0.5
Control.ERR205789;74;61;0.513513513513513;36;38;0.0135135135135135;0.486486486486487
Control.ERR205789;71;61;0.47887323943662;37;34;0.0211267605633803;0.47887323943662
Control.ERR205789;70;61;0.485714285714286;36;34;0.0142857142857143;0.485714285714286
Control.ERR205789;64;61;0.421875;37;27;0.078125;0.421875
Control.ERR205789;61;61;0.39344262295082;37;24;0.10655737704918;0.39344262295082
Control.ERR205789;65;61;0.492307692307692;33;32;0.00769230769230766;0.492307692307692
Control.ERR205789;66;61;0.575757575757576;28;38;0.0757575757575758;0.424242424242424
Control.ERR205789;66;61;0.590909090909091;27;39;0.0909090909090909;0.409090909090909
Control.ERR205789;62;61;0.451612903225806;34;28;0.0483870967741936;0.451612903225806
Control.ERR205789;62;61;0.5;31;31;0;0.5
Control.ERR205789;58;61;0.620689655172414;22;36;0.120689655172414;0.379310344827586
Control.ERR205789;62;61;0.596774193548387;25;37;0.0967741935483871;0.403225806451613
Control.ERR205789;61;61;0.442622950819672;34;27;0.0573770491803279;0.442622950819672
Control.ERR205789;72;61;0.555555555555556;32;40;0.0555555555555556;0.444444444444444
Control.ERR205789;75;61;0.44;42;33;0.06;0.44
Control.ERR205789;75;61;0.573333333333333;32;43;0.0733333333333334;0.426666666666667
Control.ERR205789;73;61;0.410958904109589;43;30;0.089041095890411;0.410958904109589
Control.ERR205789;68;61;0.470588235294118;36;32;0.0294117647058824;0.470588235294118
Control.ERR205789;75;61;0.586666666666667;31;44;0.0866666666666667;0.413333333333333
Control.ERR205789;63;61;0.555555555555556;28;35;0.0555555555555556;0.444444444444444
Control.ERR205789;62;61;0.548387096774194;28;34;0.0483870967741935;0.451612903225806
Control.ERR205789;68;61;0.485294117647059;35;33;0.0147058823529412;0.485294117647059
Control.ERR205789;66;61;0.5;33;33;0;0.5
Control.ERR205789;68;61;0.544117647058823;31;37;0.0441176470588235;0.455882352941176
Control.ERR205789;65;61;0.523076923076923;31;34;0.0230769230769231;0.476923076923077
Control.ERR205789;66;61;0.545454545454545;30;36;0.0454545454545454;0.454545454545455
Control.ERR205789;57;61;0.456140350877193;31;26;0.043859649122807;0.456140350877193
Control.ERR205789;60;61;0.4;36;24;0.1;0.4
Control.ERR205789;65;61;0.507692307692308;32;33;0.00769230769230766;0.492307692307692
Control.ERR205789;70;61;0.457142857142857;38;32;0.0428571428571429;0.457142857142857
Control.ERR205789;63;61;0.571428571428571;27;36;0.0714285714285714;0.428571428571429
Control.ERR205789;72;61;0.625;27;45;0.125;0.375
Control.ERR205789;67;61;0.492537313432836;34;33;0.0074626865671642;0.492537313432836
Control.ERR205789;68;61;0.529411764705882;32;36;0.0294117647058824;0.470588235294118
Control.ERR205789;62;61;0.516129032258065;30;32;0.0161290322580645;0.483870967741935
Control.ERR205789;65;61;0.569230769230769;28;37;0.0692307692307692;0.430769230769231
Control.ERR205789;57;61;0.421052631578947;33;24;0.0789473684210527;0.421052631578947
Control.ERR205789;62;61;0.516129032258065;30;32;0.0161290322580645;0.483870967741935
Control.ERR205789;69;61;0.434782608695652;39;30;0.0652173913043478;0.434782608695652
Control.ERR205789;65;61;0.553846153846154;29;36;0.0538461538461539;0.446153846153846
Control.ERR205789;69;61;0.507246376811594;34;35;0.00724637681159424;0.492753623188406
Control.ERR205789;74;61;0.472972972972973;39;35;0.027027027027027;0.472972972972973
Control.ERR205789;71;61;0.408450704225352;42;29;0.0915492957746479;0.408450704225352
Control.ERR205789;60;61;0.333333333333333;40;20;0.166666666666667;0.333333333333333
Control.ERR205789;58;61;0.413793103448276;34;24;0.0862068965517241;0.413793103448276
Control.ERR205789;62;61;0.387096774193548;38;24;0.112903225806452;0.387096774193548
Control.ERR205789;61;61;0.442622950819672;34;27;0.0573770491803279;0.442622950819672
Control.ERR205789;61;61;0.459016393442623;33;28;0.040983606557377;0.459016393442623
Control.ERR205789;58;61;0.46551724137931;31;27;0.0344827586206897;0.46551724137931
Control.ERR205789;62;61;0.516129032258065;30;32;0.0161290322580645;0.483870967741935
Control.ERR205789;57;61;0.543859649122807;26;31;0.043859649122807;0.456140350877193
Control.ERR205789;69;61;0.449275362318841;38;31;0.0507246376811594;0.449275362318841
Control.ERR205789;66;61;0.439393939393939;37;29;0.0606060606060606;0.439393939393939
Control.ERR205789;58;61;0.396551724137931;35;23;0.103448275862069;0.396551724137931
Control.ERR205789;63;61;0.587301587301587;26;37;0.0873015873015873;0.412698412698413
Control.ERR205789;67;61;0.477611940298507;35;32;0.0223880597014925;0.477611940298507
Control.ERR205789;57;61;0.456140350877193;31;26;0.043859649122807;0.456140350877193
Control.ERR205789;60;61;0.516666666666667;29;31;0.0166666666666667;0.483333333333333
Control.ERR205789;73;61;0.342465753424658;48;25;0.157534246575342;0.342465753424658
Control.ERR205789;61;61;0.409836065573771;36;25;0.0901639344262295;0.409836065573771
Control.ERR205789;58;61;0.396551724137931;35;23;0.103448275862069;0.396551724137931
Control.ERR205789;68;61;0.470588235294118;36;32;0.0294117647058824;0.470588235294118
Control.ERR205789;70;61;0.414285714285714;41;29;0.0857142857142857;0.414285714285714
Control.ERR205789;69;61;0.521739130434783;33;36;0.0217391304347826;0.478260869565217
Control.ERR205789;61;61;0.426229508196721;35;26;0.0737704918032787;0.426229508196721
Control.ERR205789;71;61;0.366197183098592;45;26;0.133802816901408;0.366197183098592
Control.ERR205789;74;61;0.459459459459459;40;34;0.0405405405405405;0.459459459459459
Control.ERR205789;64;61;0.46875;34;30;0.03125;0.46875
Control.ERR205789;74;61;0.445945945945946;41;33;0.0540540540540541;0.445945945945946
Control.ERR205789;68;61;0.411764705882353;40;28;0.0882352941176471;0.411764705882353
Control.ERR205789;59;61;0.542372881355932;27;32;0.0423728813559322;0.457627118644068
Control.ERR205789;59;61;0.508474576271186;29;30;0.00847457627118642;0.491525423728814
Control.ERR205789;58;61;0.517241379310345;28;30;0.0172413793103449;0.482758620689655
Control.ERR205789;72;61;0.513888888888889;35;37;0.0138888888888888;0.486111111111111
Control.ERR205789;75;61;0.506666666666667;37;38;0.00666666666666671;0.493333333333333
Control.ERR205789;58;61;0.413793103448276;34;24;0.0862068965517241;0.413793103448276
Control.ERR205789;57;61;0.508771929824561;28;29;0.00877192982456143;0.491228070175439
Control.ERR205789;68;61;0.485294117647059;35;33;0.0147058823529412;0.485294117647059
Control.ERR205789;71;61;0.450704225352113;39;32;0.0492957746478873;0.450704225352113
Control.ERR205789;72;61;0.486111111111111;37;35;0.0138888888888889;0.486111111111111
Control.ERR205789;69;61;0.405797101449275;41;28;0.0942028985507246;0.405797101449275
Control.ERR205789;57;61;0.350877192982456;37;20;0.149122807017544;0.350877192982456
Control.ERR205789;71;61;0.563380281690141;31;40;0.0633802816901409;0.436619718309859
Control.ERR205789;73;61;0.479452054794521;38;35;0.0205479452054795;0.479452054794521
Control.ERR205789;75;61;0.546666666666667;34;41;0.0466666666666666;0.453333333333333
Control.ERR205789;74;61;0.540540540540541;34;40;0.0405405405405406;0.459459459459459
Control.ERR205789;65;61;0.492307692307692;33;32;0.00769230769230766;0.492307692307692
Control.ERR205789;67;61;0.447761194029851;37;30;0.0522388059701492;0.447761194029851
Control.ERR205789;68;61;0.352941176470588;44;24;0.147058823529412;0.352941176470588
Control.ERR205789;57;61;0.596491228070175;23;34;0.0964912280701754;0.403508771929825
Control.ERR205789;61;61;0.622950819672131;23;38;0.122950819672131;0.377049180327869
Control.ERR205789;63;61;0.555555555555556;28;35;0.0555555555555556;0.444444444444444
Control.ERR205789;69;61;0.492753623188406;35;34;0.00724637681159418;0.492753623188406
Control.ERR205789;66;61;0.560606060606061;29;37;0.0606060606060606;0.439393939393939
Control.ERR205789;66;61;0.454545454545455;36;30;0.0454545454545455;0.454545454545455
Control.ERR205789;65;61;0.461538461538462;35;30;0.0384615384615384;0.461538461538462
Control.ERR205789;67;61;0.492537313432836;34;33;0.0074626865671642;0.492537313432836
Control.ERR205789;70;61;0.571428571428571;30;40;0.0714285714285714;0.428571428571429
Control.ERR205789;73;61;0.493150684931507;37;36;0.00684931506849318;0.493150684931507
Control.ERR205789;61;61;0.442622950819672;34;27;0.0573770491803279;0.442622950819672
Control.ERR205789;70;61;0.557142857142857;31;39;0.0571428571428572;0.442857142857143
Control.ERR205789;78;61;0.538461538461538;36;42;0.0384615384615384;0.461538461538462
Control.ERR205789;75;61;0.4;45;30;0.1;0.4
Control.ERR205789;69;61;0.579710144927536;29;40;0.0797101449275363;0.420289855072464
Control.ERR205789;73;61;0.575342465753425;31;42;0.0753424657534246;0.424657534246575
Control.ERR205789;72;61;0.472222222222222;38;34;0.0277777777777778;0.472222222222222
Control.ERR205789;74;61;0.472972972972973;39;35;0.027027027027027;0.472972972972973
Control.ERR205789;71;61;0.591549295774648;29;42;0.0915492957746479;0.408450704225352
Control.ERR205789;69;61;0.492753623188406;35;34;0.00724637681159418;0.492753623188406
Control.ERR205789;64;61;0.390625;39;25;0.109375;0.390625
Control.ERR205789;73;61;0.520547945205479;35;38;0.0205479452054794;0.479452054794521
Control.ERR205789;78;61;0.397435897435897;47;31;0.102564102564103;0.397435897435897
Control.ERR205789;79;61;0.481012658227848;41;38;0.0189873417721519;0.481012658227848
Control.ERR205789;62;61;0.532258064516129;29;33;0.032258064516129;0.467741935483871
Control.ERR205789;64;61;0.546875;29;35;0.046875;0.453125
Control.ERR205789;69;61;0.579710144927536;29;40;0.0797101449275363;0.420289855072464
Control.ERR205789;71;61;0.422535211267606;41;30;0.0774647887323944;0.422535211267606
Control.ERR205789;60;61;0.466666666666667;32;28;0.0333333333333333;0.466666666666667
Control.ERR205789;61;61;0.540983606557377;28;33;0.0409836065573771;0.459016393442623
Control.ERR205789;64;61;0.484375;33;31;0.015625;0.484375
Control.ERR205789;80;61;0.45;44;36;0.05;0.45
Control.ERR205789;71;61;0.47887323943662;37;34;0.0211267605633803;0.47887323943662
Control.ERR205789;67;61;0.537313432835821;31;36;0.0373134328358209;0.462686567164179
Control.ERR205789;69;61;0.492753623188406;35;34;0.00724637681159418;0.492753623188406
Control.ERR205789;77;61;0.532467532467532;36;41;0.0324675324675324;0.467532467532468
Control.ERR205789;63;61;0.507936507936508;31;32;0.00793650793650791;0.492063492063492
Control.ERR205789;63;61;0.523809523809524;30;33;0.0238095238095238;0.476190476190476
Control.ERR205789;66;61;0.545454545454545;30;36;0.0454545454545454;0.454545454545455
Control.ERR205789;70;61;0.385714285714286;43;27;0.114285714285714;0.385714285714286
Control.ERR205789;68;61;0.544117647058823;31;37;0.0441176470588235;0.455882352941176
Control.ERR205789;64;61;0.4375;36;28;0.0625;0.4375
Control.ERR205789;66;61;0.560606060606061;29;37;0.0606060606060606;0.439393939393939
Control.ERR205789;68;61;0.573529411764706;29;39;0.0735294117647058;0.426470588235294
Control.ERR205789;71;61;0.394366197183099;43;28;0.105633802816901;0.394366197183099
Control.ERR205789;71;61;0.492957746478873;36;35;0.00704225352112675;0.492957746478873
Control.ERR205789;75;61;0.52;36;39;0.02;0.48
Control.ERR205789;80;61;0.5;40;40;0;0.5
Control.ERR205789;69;61;0.507246376811594;34;35;0.00724637681159424;0.492753623188406
Control.ERR205789;69;61;0.536231884057971;32;37;0.0362318840579711;0.463768115942029
Control.ERR205789;62;61;0.483870967741935;32;30;0.0161290322580645;0.483870967741935
Control.ERR205789;67;61;0.552238805970149;30;37;0.0522388059701493;0.447761194029851
Control.ERR205789;72;61;0.388888888888889;44;28;0.111111111111111;0.388888888888889
Control.ERR205789;74;61;0.486486486486487;38;36;0.0135135135135135;0.486486486486487
Control.ERR205789;72;61;0.458333333333333;39;33;0.0416666666666667;0.458333333333333
Control.ERR205789;72;61;0.416666666666667;42;30;0.0833333333333333;0.416666666666667
Control.ERR205789;63;61;0.523809523809524;30;33;0.0238095238095238;0.476190476190476
Control.ERR205789;63;61;0.507936507936508;31;32;0.00793650793650791;0.492063492063492
Control.ERR205789;63;61;0.46031746031746;34;29;0.0396825396825397;0.46031746031746
Control.ERR205789;70;61;0.557142857142857;31;39;0.0571428571428572;0.442857142857143
Control.ERR205789;63;61;0.507936507936508;31;32;0.00793650793650791;0.492063492063492
Control.ERR205789;68;61;0.558823529411765;30;38;0.0588235294117647;0.441176470588235
Control.ERR205789;71;61;0.661971830985915;24;47;0.161971830985915;0.338028169014085
Control.ERR205789;79;61;0.569620253164557;34;45;0.069620253164557;0.430379746835443
Control.ERR205789;71;61;0.605633802816901;28;43;0.105633802816901;0.394366197183099
Control.ERR205789;70;61;0.371428571428571;44;26;0.128571428571429;0.371428571428571
Control.ERR205789;67;61;0.492537313432836;34;33;0.0074626865671642;0.492537313432836
Control.ERR205789;78;61;0.474358974358974;41;37;0.0256410256410257;0.474358974358974
Control.ERR205789;76;61;0.5;38;38;0;0.5
Control.ERR205789;80;61;0.55;36;44;0.05;0.45
Control.ERR205789;78;61;0.564102564102564;34;44;0.0641025641025641;0.435897435897436
Control.ERR205789;74;61;0.418918918918919;43;31;0.0810810810810811;0.418918918918919
Control.ERR205789;76;61;0.513157894736842;37;39;0.0131578947368421;0.486842105263158
Control.ERR205789;57;61;0.56140350877193;25;32;0.0614035087719298;0.43859649122807
Control.ERR205789;59;61;0.593220338983051;24;35;0.0932203389830508;0.406779661016949
Control.ERR205789;61;61;0.475409836065574;32;29;0.0245901639344263;0.475409836065574
Control.ERR205789;62;61;0.580645161290323;26;36;0.0806451612903226;0.419354838709677
Control.ERR205789;65;61;0.507692307692308;32;33;0.00769230769230766;0.492307692307692
Control.ERR205789;73;61;0.479452054794521;38;35;0.0205479452054795;0.479452054794521
Control.ERR205789;59;61;0.542372881355932;27;32;0.0423728813559322;0.457627118644068
Control.ERR205789;62;61;0.612903225806452;24;38;0.112903225806452;0.387096774193548
Control.ERR205789;58;61;0.586206896551724;24;34;0.0862068965517241;0.413793103448276
Control.ERR205789;57;61;0.456140350877193;31;26;0.043859649122807;0.456140350877193
Control.ERR205789;58;61;0.53448275862069;27;31;0.0344827586206896;0.46551724137931
Control.ERR205789;58;61;0.431034482758621;33;25;0.0689655172413793;0.431034482758621
Control.ERR205789;61;61;0.491803278688525;31;30;0.00819672131147542;0.491803278688525
Control.ERR205789;64;61;0.5;32;32;0;0.5
Control.ERR205789;65;61;0.569230769230769;28;37;0.0692307692307692;0.430769230769231
Control.ERR205789;61;61;0.524590163934426;29;32;0.0245901639344263;0.475409836065574
Control.ERR205789;57;61;0.543859649122807;26;31;0.043859649122807;0.456140350877193
Control.ERR205789;61;61;0.540983606557377;28;33;0.0409836065573771;0.459016393442623
Control.ERR205789;57;61;0.491228070175439;29;28;0.00877192982456143;0.491228070175439
Control.ERR205789;58;61;0.568965517241379;25;33;0.0689655172413793;0.431034482758621
Control.ERR205789;57;61;0.368421052631579;36;21;0.131578947368421;0.368421052631579
Control.ERR205789;61;61;0.524590163934426;29;32;0.0245901639344263;0.475409836065574
Control.ERR205789;64;61;0.59375;26;38;0.09375;0.40625
Control.ERR205789;70;61;0.528571428571429;33;37;0.0285714285714286;0.471428571428571
Control.ERR205789;64;61;0.421875;37;27;0.078125;0.421875
Control.ERR205789;75;61;0.466666666666667;40;35;0.0333333333333333;0.466666666666667
Control.ERR205789;70;61;0.485714285714286;36;34;0.0142857142857143;0.485714285714286
Control.ERR205789;60;61;0.483333333333333;31;29;0.0166666666666667;0.483333333333333
Control.ERR205789;73;61;0.410958904109589;43;30;0.089041095890411;0.410958904109589
Control.ERR205789;66;61;0.515151515151515;32;34;0.0151515151515151;0.484848484848485
Control.ERR205789;70;61;0.571428571428571;30;40;0.0714285714285714;0.428571428571429
Control.ERR205789;73;61;0.479452054794521;38;35;0.0205479452054795;0.479452054794521
Control.ERR205789;64;61;0.59375;26;38;0.09375;0.40625
Control.ERR205789;59;61;0.491525423728814;30;29;0.00847457627118642;0.491525423728814
Control.ERR205789;73;61;0.479452054794521;38;35;0.0205479452054795;0.479452054794521
Control.ERR205789;63;61;0.507936507936508;31;32;0.00793650793650791;0.492063492063492
Control.ERR205789;67;61;0.507462686567164;33;34;0.0074626865671642;0.492537313432836
Control.ERR205789;62;61;0.419354838709677;36;26;0.0806451612903226;0.419354838709677
Control.ERR205789;67;61;0.477611940298507;35;32;0.0223880597014925;0.477611940298507
Control.ERR205789;75;61;0.533333333333333;35;40;0.0333333333333333;0.466666666666667
Control.ERR205789;73;61;0.561643835616438;32;41;0.0616438356164384;0.438356164383562
Control.ERR205789;69;61;0.434782608695652;39;30;0.0652173913043478;0.434782608695652
Control.ERR205789;64;61;0.484375;33;31;0.015625;0.484375
Control.ERR205789;70;61;0.571428571428571;30;40;0.0714285714285714;0.428571428571429
Control.ERR205789;71;61;0.464788732394366;38;33;0.0352112676056338;0.464788732394366
Control.ERR205789;71;61;0.492957746478873;36;35;0.00704225352112675;0.492957746478873
Control.ERR205789;59;61;0.559322033898305;26;33;0.059322033898305;0.440677966101695
Control.ERR205789;58;61;0.482758620689655;30;28;0.0172413793103448;0.482758620689655
Control.ERR205789;70;61;0.542857142857143;32;38;0.0428571428571428;0.457142857142857
Control.ERR205789;75;61;0.453333333333333;41;34;0.0466666666666667;0.453333333333333
Control.ERR205789;60;61;0.566666666666667;26;34;0.0666666666666667;0.433333333333333
Control.ERR205789;65;61;0.461538461538462;35;30;0.0384615384615384;0.461538461538462
Control.ERR205789;68;61;0.470588235294118;36;32;0.0294117647058824;0.470588235294118
Control.ERR205789;67;61;0.567164179104478;29;38;0.0671641791044776;0.432835820895522
Control.ERR205789;70;61;0.471428571428571;37;33;0.0285714285714286;0.471428571428571
Control.ERR205789;63;61;0.571428571428571;27;36;0.0714285714285714;0.428571428571429
Control.ERR205789;67;61;0.507462686567164;33;34;0.0074626865671642;0.492537313432836
Control.ERR205789;67;61;0.417910447761194;39;28;0.082089552238806;0.417910447761194
Control.ERR205789;74;61;0.567567567567568;32;42;0.0675675675675675;0.432432432432432
Control.ERR205789;73;61;0.424657534246575;42;31;0.0753424657534247;0.424657534246575
Control.ERR205789;70;61;0.528571428571429;33;37;0.0285714285714286;0.471428571428571
Control.ERR205789;68;61;0.558823529411765;30;38;0.0588235294117647;0.441176470588235
Control.ERR205789;64;61;0.46875;34;30;0.03125;0.46875
Control.ERR205789;58;61;0.551724137931034;26;32;0.0517241379310345;0.448275862068966
Control.ERR205789;59;61;0.423728813559322;34;25;0.076271186440678;0.423728813559322
Control.ERR205789;66;61;0.560606060606061;29;37;0.0606060606060606;0.439393939393939
Control.ERR205789;74;61;0.432432432432432;42;32;0.0675675675675675;0.432432432432432
Control.ERR205789;73;61;0.589041095890411;30;43;0.089041095890411;0.410958904109589
Control.ERR205789;59;61;0.474576271186441;31;28;0.0254237288135593;0.474576271186441
Control.ERR205789;59;61;0.610169491525424;23;36;0.110169491525424;0.389830508474576
Control.ERR205789;65;61;0.523076923076923;31;34;0.0230769230769231;0.476923076923077
Control.ERR205789;64;61;0.34375;42;22;0.15625;0.34375
Control.ERR205789;70;61;0.442857142857143;39;31;0.0571428571428572;0.442857142857143
Control.ERR205789;62;61;0.483870967741935;32;30;0.0161290322580645;0.483870967741935
Control.ERR205789;72;61;0.486111111111111;37;35;0.0138888888888889;0.486111111111111
Control.ERR205789;70;61;0.457142857142857;38;32;0.0428571428571429;0.457142857142857
Control.ERR205789;71;61;0.549295774647887;32;39;0.0492957746478874;0.450704225352113
Control.ERR205789;71;61;0.549295774647887;32;39;0.0492957746478874;0.450704225352113
Control.ERR205789;72;61;0.527777777777778;34;38;0.0277777777777778;0.472222222222222
Control.ERR205789;62;61;0.67741935483871;20;42;0.17741935483871;0.32258064516129
Control.ERR205789;65;61;0.369230769230769;41;24;0.130769230769231;0.369230769230769
Control.ERR205789;69;61;0.434782608695652;39;30;0.0652173913043478;0.434782608695652
Control.ERR205789;71;61;0.450704225352113;39;32;0.0492957746478873;0.450704225352113
Control.ERR205789;69;61;0.623188405797101;26;43;0.123188405797101;0.376811594202899
Control.ERR205789;65;61;0.6;26;39;0.1;0.4
Control.ERR205789;75;61;0.426666666666667;43;32;0.0733333333333333;0.426666666666667
Control.ERR205789;68;61;0.470588235294118;36;32;0.0294117647058824;0.470588235294118
Control.ERR205789;60;61;0.466666666666667;32;28;0.0333333333333333;0.466666666666667
Control.ERR205789;71;61;0.464788732394366;38;33;0.0352112676056338;0.464788732394366
Control.ERR205789;67;61;0.477611940298507;35;32;0.0223880597014925;0.477611940298507
Control.ERR205789;64;61;0.453125;35;29;0.046875;0.453125
Control.ERR205789;70;61;0.542857142857143;32;38;0.0428571428571428;0.457142857142857
Control.ERR205789;60;61;0.483333333333333;31;29;0.0166666666666667;0.483333333333333
Control.ERR205789;67;61;0.537313432835821;31;36;0.0373134328358209;0.462686567164179
Control.ERR205789;75;61;0.506666666666667;37;38;0.00666666666666671;0.493333333333333
Control.ERR205789;71;61;0.338028169014085;47;24;0.161971830985915;0.338028169014085
Control.ERR205789;66;61;0.53030303030303;31;35;0.0303030303030303;0.46969696969697
Control.ERR205789;73;61;0.520547945205479;35;38;0.0205479452054794;0.479452054794521
Control.ERR205789;63;61;0.476190476190476;33;30;0.0238095238095238;0.476190476190476
Control.ERR205789;75;61;0.6;30;45;0.1;0.4
Control.ERR205789;75;61;0.573333333333333;32;43;0.0733333333333334;0.426666666666667
Control.ERR205789;74;61;0.486486486486487;38;36;0.0135135135135135;0.486486486486487
Control.ERR205789;67;61;0.462686567164179;36;31;0.0373134328358209;0.462686567164179
Control.ERR205789;67;61;0.552238805970149;30;37;0.0522388059701493;0.447761194029851
Control.ERR205789;74;61;0.513513513513513;36;38;0.0135135135135135;0.486486486486487
Control.ERR205789;63;61;0.476190476190476;33;30;0.0238095238095238;0.476190476190476
Control.ERR205789;73;61;0.438356164383562;41;32;0.0616438356164384;0.438356164383562
Control.ERR205789;64;61;0.421875;37;27;0.078125;0.421875
Control.ERR205789;70;61;0.414285714285714;41;29;0.0857142857142857;0.414285714285714
Control.ERR205789;60;61;0.45;33;27;0.05;0.45
Control.ERR205789;66;61;0.439393939393939;37;29;0.0606060606060606;0.439393939393939
Control.ERR205789;66;61;0.515151515151515;32;34;0.0151515151515151;0.484848484848485
Control.ERR205789;74;61;0.5;37;37;0;0.5
Control.ERR205789;66;61;0.5;33;33;0;0.5
Control.ERR205789;73;61;0.438356164383562;41;32;0.0616438356164384;0.438356164383562
Control.ERR205789;70;61;0.571428571428571;30;40;0.0714285714285714;0.428571428571429
Control.ERR205789;75;61;0.52;36;39;0.02;0.48
Control.ERR205789;68;61;0.514705882352941;33;35;0.0147058823529411;0.485294117647059
Control.ERR205789;69;61;0.420289855072464;40;29;0.0797101449275363;0.420289855072464
Control.ERR205789;64;61;0.515625;31;33;0.015625;0.484375
Control.ERR205789;66;61;0.606060606060606;26;40;0.106060606060606;0.393939393939394
Control.ERR205789;73;61;0.561643835616438;32;41;0.0616438356164384;0.438356164383562
Control.ERR205789;57;61;0.56140350877193;25;32;0.0614035087719298;0.43859649122807
Control.ERR205789;64;61;0.546875;29;35;0.046875;0.453125
Control.ERR205789;71;61;0.492957746478873;36;35;0.00704225352112675;0.492957746478873
Control.ERR205789;71;61;0.535211267605634;33;38;0.0352112676056338;0.464788732394366
Control.ERR205789;74;61;0.445945945945946;41;33;0.0540540540540541;0.445945945945946
Control.ERR205789;66;61;0.46969696969697;35;31;0.0303030303030303;0.46969696969697
Control.ERR205789;69;61;0.594202898550725;28;41;0.0942028985507246;0.405797101449275
Control.ERR205789;71;61;0.464788732394366;38;33;0.0352112676056338;0.464788732394366
Control.ERR205789;59;61;0.508474576271186;29;30;0.00847457627118642;0.491525423728814
Control.ERR205789;64;61;0.46875;34;30;0.03125;0.46875
Control.ERR205789;70;61;0.528571428571429;33;37;0.0285714285714286;0.471428571428571
Control.ERR205789;62;61;0.467741935483871;33;29;0.0322580645161291;0.467741935483871
Control.ERR205789;59;61;0.406779661016949;35;24;0.0932203389830508;0.406779661016949
Control.ERR205789;67;61;0.477611940298507;35;32;0.0223880597014925;0.477611940298507
Control.ERR205789;71;61;0.563380281690141;31;40;0.0633802816901409;0.436619718309859
Control.ERR205789;66;61;0.590909090909091;27;39;0.0909090909090909;0.409090909090909
Control.ERR205789;65;61;0.492307692307692;33;32;0.00769230769230766;0.492307692307692
Control.ERR205789;67;61;0.462686567164179;36;31;0.0373134328358209;0.462686567164179
Control.ERR205789;60;61;0.433333333333333;34;26;0.0666666666666667;0.433333333333333
Control.ERR205789;58;61;0.551724137931034;26;32;0.0517241379310345;0.448275862068966
Control.ERR205789;68;61;0.588235294117647;28;40;0.0882352941176471;0.411764705882353
Control.ERR205789;66;61;0.484848484848485;34;32;0.0151515151515151;0.484848484848485
Control.ERR205789;57;61;0.456140350877193;31;26;0.043859649122807;0.456140350877193
Control.ERR205789;59;61;0.440677966101695;33;26;0.0593220338983051;0.440677966101695
Control.ERR205789;70;61;0.557142857142857;31;39;0.0571428571428572;0.442857142857143
Control.ERR205789;74;61;0.513513513513513;36;38;0.0135135135135135;0.486486486486487
Control.ERR205789;63;61;0.507936507936508;31;32;0.00793650793650791;0.492063492063492
Control.ERR205789;68;61;0.455882352941176;37;31;0.0441176470588235;0.455882352941176
Control.ERR205789;72;61;0.5;36;36;0;0.5
Control.ERR205789;72;61;0.472222222222222;38;34;0.0277777777777778;0.472222222222222
Control.ERR205789;57;61;0.543859649122807;26;31;0.043859649122807;0.456140350877193
Control.ERR205789;59;61;0.525423728813559;28;31;0.0254237288135594;0.474576271186441
Control.ERR205789;66;61;0.53030303030303;31;35;0.0303030303030303;0.46969696969697
Control.ERR205789;71;61;0.577464788732394;30;41;0.0774647887323944;0.422535211267606
Control.ERR205789;73;61;0.520547945205479;35;38;0.0205479452054794;0.479452054794521
Control.ERR205789;73;61;0.438356164383562;41;32;0.0616438356164384;0.438356164383562
Control.ERR205789;66;61;0.515151515151515;32;34;0.0151515151515151;0.484848484848485
Control.ERR205789;68;61;0.544117647058823;31;37;0.0441176470588235;0.455882352941176
Control.ERR205789;66;61;0.545454545454545;30;36;0.0454545454545454;0.454545454545455
Control.ERR205789;72;61;0.388888888888889;44;28;0.111111111111111;0.388888888888889
Control.ERR205789;61;61;0.540983606557377;28;33;0.0409836065573771;0.459016393442623
Control.ERR205789;66;61;0.560606060606061;29;37;0.0606060606060606;0.439393939393939
Control.ERR205789;70;61;0.528571428571429;33;37;0.0285714285714286;0.471428571428571
Control.ERR205789;66;61;0.46969696969697;35;31;0.0303030303030303;0.46969696969697
Control.ERR205789;69;61;0.594202898550725;28;41;0.0942028985507246;0.405797101449275
Control.ERR205789;69;61;0.536231884057971;32;37;0.0362318840579711;0.463768115942029
Control.ERR205789;75;61;0.48;39;36;0.02;0.48
Control.ERR205789;62;61;0.564516129032258;27;35;0.0645161290322581;0.435483870967742
Control.ERR205789;72;61;0.5;36;36;0;0.5
Control.ERR205789;63;61;0.53968253968254;29;34;0.0396825396825397;0.46031746031746
Control.ERR205789;65;61;0.461538461538462;35;30;0.0384615384615384;0.461538461538462
Control.ERR205789;65;61;0.569230769230769;28;37;0.0692307692307692;0.430769230769231
Control.ERR205789;68;61;0.455882352941176;37;31;0.0441176470588235;0.455882352941176
Control.ERR205789;59;61;0.491525423728814;30;29;0.00847457627118642;0.491525423728814
Control.ERR205789;79;61;0.569620253164557;34;45;0.069620253164557;0.430379746835443
Control.ERR205789;69;61;0.449275362318841;38;31;0.0507246376811594;0.449275362318841
Control.ERR205789;60;61;0.416666666666667;35;25;0.0833333333333333;0.416666666666667
Control.ERR205789;69;61;0.463768115942029;37;32;0.036231884057971;0.463768115942029
Control.ERR205789;63;61;0.523809523809524;30;33;0.0238095238095238;0.476190476190476
Control.ERR205789;75;61;0.56;33;42;0.0600000000000001;0.44
Control.ERR205789;71;61;0.450704225352113;39;32;0.0492957746478873;0.450704225352113
Control.ERR205789;72;61;0.583333333333333;30;42;0.0833333333333334;0.416666666666667
Control.ERR205789;60;61;0.466666666666667;32;28;0.0333333333333333;0.466666666666667
Control.ERR205789;71;61;0.507042253521127;35;36;0.00704225352112675;0.492957746478873
Control.ERR205789;63;61;0.46031746031746;34;29;0.0396825396825397;0.46031746031746
Control.ERR205789;76;61;0.407894736842105;45;31;0.0921052631578947;0.407894736842105
Control.ERR205789;64;61;0.546875;29;35;0.046875;0.453125
Control.ERR205789;66;61;0.606060606060606;26;40;0.106060606060606;0.393939393939394
Control.ERR205789;69;61;0.521739130434783;33;36;0.0217391304347826;0.478260869565217
Control.ERR205789;63;61;0.523809523809524;30;33;0.0238095238095238;0.476190476190476
Control.ERR205789;73;61;0.397260273972603;44;29;0.102739726027397;0.397260273972603
Control.ERR205789;67;61;0.611940298507463;26;41;0.111940298507463;0.388059701492537
Control.ERR205789;62;61;0.435483870967742;35;27;0.0645161290322581;0.435483870967742
Control.ERR205789;59;61;0.627118644067797;22;37;0.127118644067797;0.372881355932203
Control.ERR205789;65;61;0.492307692307692;33;32;0.00769230769230766;0.492307692307692
Control.ERR205789;65;61;0.523076923076923;31;34;0.0230769230769231;0.476923076923077
Control.ERR205789;67;61;0.477611940298507;35;32;0.0223880597014925;0.477611940298507
Control.ERR205789;63;61;0.53968253968254;29;34;0.0396825396825397;0.46031746031746
Control.ERR205789;63;61;0.396825396825397;38;25;0.103174603174603;0.396825396825397
Control.ERR205789;65;61;0.430769230769231;37;28;0.0692307692307692;0.430769230769231
Control.ERR205789;68;61;0.573529411764706;29;39;0.0735294117647058;0.426470588235294
Control.ERR205789;65;61;0.461538461538462;35;30;0.0384615384615384;0.461538461538462
Control.ERR205789;71;61;0.464788732394366;38;33;0.0352112676056338;0.464788732394366
Control.ERR205789;59;61;0.610169491525424;23;36;0.110169491525424;0.389830508474576
Control.ERR205789;74;61;0.391891891891892;45;29;0.108108108108108;0.391891891891892
Control.ERR205789;68;61;0.529411764705882;32;36;0.0294117647058824;0.470588235294118
Control.ERR205789;58;61;0.46551724137931;31;27;0.0344827586206897;0.46551724137931
Control.ERR205789;62;61;0.5;31;31;0;0.5
Control.ERR205789;66;61;0.424242424242424;38;28;0.0757575757575757;0.424242424242424
Control.ERR205789;64;61;0.53125;30;34;0.03125;0.46875
Control.ERR205789;70;61;0.585714285714286;29;41;0.0857142857142857;0.414285714285714
Control.ERR205789;70;61;0.5;35;35;0;0.5
Control.ERR205789;63;61;0.53968253968254;29;34;0.0396825396825397;0.46031746031746
Control.ERR205789;66;61;0.454545454545455;36;30;0.0454545454545455;0.454545454545455
Control.ERR205789;62;61;0.532258064516129;29;33;0.032258064516129;0.467741935483871
Control.ERR205789;68;61;0.470588235294118;36;32;0.0294117647058824;0.470588235294118
Control.ERR205789;69;61;0.449275362318841;38;31;0.0507246376811594;0.449275362318841
Control.ERR205789;68;61;0.426470588235294;39;29;0.0735294117647059;0.426470588235294
Control.ERR205789;61;61;0.491803278688525;31;30;0.00819672131147542;0.491803278688525
Control.ERR205789;67;61;0.462686567164179;36;31;0.0373134328358209;0.462686567164179
Control.ERR205789;71;61;0.436619718309859;40;31;0.0633802816901409;0.436619718309859
Control.ERR205789;65;61;0.538461538461538;30;35;0.0384615384615384;0.461538461538462
Control.ERR205789;59;61;0.440677966101695;33;26;0.0593220338983051;0.440677966101695
Control.ERR205789;67;61;0.462686567164179;36;31;0.0373134328358209;0.462686567164179
Control.ERR205789;61;61;0.508196721311475;30;31;0.00819672131147542;0.491803278688525
Control.ERR205789;66;61;0.424242424242424;38;28;0.0757575757575757;0.424242424242424
Control.ERR205789;70;61;0.471428571428571;37;33;0.0285714285714286;0.471428571428571
Control.ERR205789;74;61;0.513513513513513;36;38;0.0135135135135135;0.486486486486487
Control.ERR205789;70;61;0.542857142857143;32;38;0.0428571428571428;0.457142857142857
Control.ERR205789;58;61;0.448275862068966;32;26;0.0517241379310345;0.448275862068966
Control.ERR205789;69;61;0.608695652173913;27;42;0.108695652173913;0.391304347826087
Control.ERR205789;73;61;0.465753424657534;39;34;0.0342465753424658;0.465753424657534
Control.ERR205789;61;61;0.508196721311475;30;31;0.00819672131147542;0.491803278688525
Control.ERR205789;67;61;0.447761194029851;37;30;0.0522388059701492;0.447761194029851
Control.ERR205789;63;61;0.46031746031746;34;29;0.0396825396825397;0.46031746031746
Control.ERR205789;58;61;0.53448275862069;27;31;0.0344827586206896;0.46551724137931
Control.ERR205789;71;61;0.492957746478873;36;35;0.00704225352112675;0.492957746478873
Control.ERR205789;64;61;0.5625;28;36;0.0625;0.4375
Control.ERR205789;70;61;0.457142857142857;38;32;0.0428571428571429;0.457142857142857
Control.ERR205789;62;61;0.532258064516129;29;33;0.032258064516129;0.467741935483871
Control.ERR205789;58;61;0.46551724137931;31;27;0.0344827586206897;0.46551724137931
Control.ERR205789;57;61;0.473684210526316;30;27;0.0263157894736842;0.473684210526316
Control.ERR205789;71;61;0.563380281690141;31;40;0.0633802816901409;0.436619718309859
Control.ERR205789;67;61;0.597014925373134;27;40;0.0970149253731343;0.402985074626866
Control.ERR205789;66;61;0.575757575757576;28;38;0.0757575757575758;0.424242424242424
Control.ERR205789;66;61;0.484848484848485;34;32;0.0151515151515151;0.484848484848485
Control.ERR205789;69;61;0.536231884057971;32;37;0.0362318840579711;0.463768115942029
Control.ERR205789;70;61;0.457142857142857;38;32;0.0428571428571429;0.457142857142857
Control.ERR205789;68;61;0.367647058823529;43;25;0.132352941176471;0.367647058823529
Control.ERR205789;67;61;0.597014925373134;27;40;0.0970149253731343;0.402985074626866
Control.ERR205789;70;61;0.457142857142857;38;32;0.0428571428571429;0.457142857142857
Control.ERR205789;75;61;0.44;42;33;0.06;0.44
Control.ERR205789;68;61;0.441176470588235;38;30;0.0588235294117647;0.441176470588235
Control.ERR205789;59;61;0.491525423728814;30;29;0.00847457627118642;0.491525423728814
Control.ERR205789;68;61;0.338235294117647;45;23;0.161764705882353;0.338235294117647
Control.ERR205789;70;61;0.6;28;42;0.1;0.4
Control.ERR205789;73;61;0.479452054794521;38;35;0.0205479452054795;0.479452054794521
Control.ERR205789;66;61;0.439393939393939;37;29;0.0606060606060606;0.439393939393939
Control.ERR205789;75;61;0.426666666666667;43;32;0.0733333333333333;0.426666666666667
Control.ERR205789;64;61;0.515625;31;33;0.015625;0.484375
Control.ERR205789;69;61;0.536231884057971;32;37;0.0362318840579711;0.463768115942029
Control.ERR205789;75;61;0.466666666666667;40;35;0.0333333333333333;0.466666666666667
Control.ERR205789;57;61;0.491228070175439;29;28;0.00877192982456143;0.491228070175439
Control.ERR205789;61;61;0.508196721311475;30;31;0.00819672131147542;0.491803278688525
Control.ERR205789;68;61;0.544117647058823;31;37;0.0441176470588235;0.455882352941176
Control.ERR205789;64;61;0.5625;28;36;0.0625;0.4375
Control.ERR205789;70;61;0.428571428571429;40;30;0.0714285714285715;0.428571428571429
Control.ERR205789;72;61;0.597222222222222;29;43;0.0972222222222222;0.402777777777778
Control.ERR205789;67;61;0.597014925373134;27;40;0.0970149253731343;0.402985074626866
Control.ERR205789;57;61;0.578947368421053;24;33;0.0789473684210527;0.421052631578947
Control.ERR205789;66;61;0.5;33;33;0;0.5
Control.ERR205789;71;61;0.507042253521127;35;36;0.00704225352112675;0.492957746478873
Control.ERR205789;66;61;0.46969696969697;35;31;0.0303030303030303;0.46969696969697
Control.ERR205789;67;61;0.507462686567164;33;34;0.0074626865671642;0.492537313432836
Control.ERR205789;63;61;0.412698412698413;37;26;0.0873015873015873;0.412698412698413
Control.ERR205789;67;61;0.537313432835821;31;36;0.0373134328358209;0.462686567164179
Control.ERR205789;70;61;0.528571428571429;33;37;0.0285714285714286;0.471428571428571
Control.ERR205789;64;61;0.5;32;32;0;0.5
Control.ERR205789;65;61;0.461538461538462;35;30;0.0384615384615384;0.461538461538462
Control.ERR205789;59;61;0.474576271186441;31;28;0.0254237288135593;0.474576271186441
Control.ERR205789;60;61;0.633333333333333;22;38;0.133333333333333;0.366666666666667
Control.ERR205789;65;61;0.569230769230769;28;37;0.0692307692307692;0.430769230769231
Control.ERR205789;64;61;0.40625;38;26;0.09375;0.40625
Control.ERR205789;58;61;0.5;29;29;0;0.5
Control.ERR205789;66;61;0.378787878787879;41;25;0.121212121212121;0.378787878787879
Control.ERR205789;65;61;0.538461538461538;30;35;0.0384615384615384;0.461538461538462
Control.ERR205789;63;61;0.412698412698413;37;26;0.0873015873015873;0.412698412698413
Control.ERR205789;70;61;0.542857142857143;32;38;0.0428571428571428;0.457142857142857
Control.ERR205789;62;61;0.580645161290323;26;36;0.0806451612903226;0.419354838709677
Control.ERR205789;69;61;0.521739130434783;33;36;0.0217391304347826;0.478260869565217
Control.ERR205789;66;61;0.5;33;33;0;0.5
Control.ERR205789;60;61;0.5;30;30;0;0.5
Control.ERR205789;69;61;0.492753623188406;35;34;0.00724637681159418;0.492753623188406
Control.ERR205789;57;61;0.456140350877193;31;26;0.043859649122807;0.456140350877193
Control.ERR205789;65;61;0.6;26;39;0.1;0.4
Control.ERR205789;69;61;0.507246376811594;34;35;0.00724637681159424;0.492753623188406
